CommitID,NMF,TotalAddLines,TotalDeleteLines,LC,LC_1,FileAdd,FileDelete,NAD,NUC,AGE,NMS,NMD,Entropy ,MLMF,NDVE,EXP,REXP,CommitComplexity,LastCommitComplexity,CFC,CommitTokenCount,LastCommitTokenCount,NCC,CommitMethodNum,LastCommitMethodNum,NFC,NIR,a2a,Tag
fea5840c49c196a1b6dbb6e22da28d7de09071b6,1,0,1,1,1,0,0,0,5,0,1,1,0,658,1,195,38,102,102,0,4259,4265,6,33,33,0,0,100,NoArch
59d0569757d702eb483edc7b603bdc421b9e9506,7,131,0,131,131,1,0,1,7,217,3,5,0.909910321,852,1,196,39,150,143,7,5500,4499,1001,46,41,5,0,99.33732489,NoArch
ad295e28ee8989ba7a90f8f815eb05440068ecec,8,551,551,0,1102,0,0,0,4,107,3,6,2.871725283,551,2,197,40,32,32,0,1925,1925,0,21,21,0,0,100,NoArch
c6a3da46300a10a888deea7b0c20bd1fe78f0fa3,0,0,0,0,0,0,0,0,0,0,0,0,0,0,0,5,0,0,0,0,0,0,0,0,0,0,0,100,NoArch
9ada8b0eb97a52ff0fff5ec15642ce3cba9cf3c2,0,0,0,0,0,0,0,0,0,0,0,0,0,0,0,198,41,0,0,0,0,0,0,0,0,0,0,100,NoArch
f78cbfdb63fe5c8c3508b1073ba50fdcf0856925,5,92,29,63,121,0,0,0,3,317,1,4,1.949774049,983,1,199,42,87,80,7,6667,6248,419,51,46,5,1,100,NoArch
b503b7dcab2f444e479786c5b0328d08b8b5d976,1,3,0,3,3,0,0,0,5,83,1,1,0,650,1,200,42,134,133,1,4041,4018,23,30,30,0,1,100,NoArch
53c95f98d8a3143e3090b91bb8f6e592fe92643f,40,413,335,78,748,3,0,3,6,221,5,27,4.233788257,5431,1,201,42,564,558,6,27727,27624,103,236,228,8,0,99.95336365,NoArch
2549c3153d5583d80031d83c8d17a06f37a05075,1,1,0,1,1,0,0,0,4,27,1,1,0,432,3,8,1,57,57,0,2060,2042,18,30,30,0,1,100,NoArch
e212736195d6e6d92d4adc30ffd4972d588ce209,6,7,288,281,295,0,3,3,8,252,2,3,1.909416069,1165,2,202,36,146,190,44,4356,5568,1212,13,22,9,1,99.95336093,NoArch
2040cc7d79b65de0d61802f62e10b5723e623049,4,22,19,3,41,0,0,0,11,147,2,3,1.028045297,3397,1,203,36,378,376,2,22739,22688,51,168,168,0,1,99.98250423,NoArch
1d9655667b7856b408b4d772543adf52712437dc,1,4,7,3,11,0,0,0,5,1,1,1,0,433,3,9,2,57,57,0,2029,2060,31,30,30,0,1,100,NoArch
7526116b1d7881014aabca9f4cb614db13230e99,7,291,2,289,293,3,0,3,6,59,2,3,2.006979351,1625,1,10,2,221,199,22,9500,7752,1748,102,92,10,1,99.95337724,NoArch
6b7523033c84dfe62a76621294f0746ffde7aed6,4,146,0,146,146,4,0,4,1,0,1,2,1.954239046,0,1,20,1,5,0,5,413,0,413,5,0,5,1,99.9476074,NoArch
98f0505b584235a0a76ce4e31ddb36686e42ffa6,7,77,10,67,87,0,0,0,13,118,2,5,2.424507825,4007,2,204,37,902,879,23,24041,23596,445,252,249,3,1,100,NoArch
c2c8d6ce2a8b78c8948d42ea0fb51f1e91b02bd1,3,15,18,3,33,0,0,0,14,36,1,3,0.760732746,3096,2,205,38,658,661,3,19368,19381,13,159,159,0,1,100,NoArch
a69beb90ff04cc3f3a16358a52d63e76e5bb6339,1,0,2,2,2,0,0,0,6,0,1,1,0,370,1,206,39,61,61,0,2616,2630,14,9,9,0,0,100,NoArch
3d2d204523b1ded8b9f3ae68fad5bf8a59f31554,0,0,0,0,0,0,0,0,0,0,0,0,0,0,0,46,1,0,0,0,0,0,0,0,0,0,1,100,NoArch
bee8487619ee5d8be18014814fa398788debdccf,11,184,3,181,187,3,0,3,5,182,1,5,3.042199454,3015,1,47,2,538,517,21,15755,15281,474,203,185,18,0,99.96510005,NoArch
6a1a2195027080b15ba6c008846e69290ea28aed,1,10,2,8,12,0,0,0,4,0,1,1,0,662,2,48,3,120,118,2,3706,3679,27,28,28,0,0,100,NoArch
17945e4c6d734699ff3bbf8c6e13a7fb8f31a0fb,2,27,3,24,30,0,0,0,12,54,1,2,0.948078244,1129,3,21,2,93,91,2,7401,7230,171,60,59,1,1,100,NoArch
2e782448cbe5729ef548f6a3c65cb42f1968166f,0,0,0,0,0,0,0,0,0,0,0,0,0,0,0,22,3,0,0,0,0,0,0,0,0,0,1,100,NoArch
fee8af3b53898874153eb52344e9d22af1848bb3,23,419,571,152,990,1,2,3,3,148,3,13,3.191743508,4356,1,207,38,500,495,5,21564,22216,652,259,275,16,1,99.93606881,NoArch
0f6e93f5eceae5368e43bf996716d1628c852a46,3,15,68,53,83,0,0,0,3,328,1,2,0.617723855,793,2,49,3,100,99,1,3287,3229,58,70,69,1,0,100,NoArch
5823c88f598b3f0588cef0ce87f5d06bd399b0f4,3,5,90,85,95,0,1,1,15,113,2,3,0.380909126,2371,1,50,4,515,517,2,14171,14557,386,127,129,2,0,99.9883802,NoArch
f227e61764874c882068d74c301b59a553d61574,2,22,3,19,25,0,0,0,13,18,1,2,0.998845536,1666,3,23,4,191,188,3,11094,10990,104,96,95,1,1,100,NoArch
3df7e141b9f357fb00ed6f365d7f3591a900dd4e,39,397,220,177,617,1,0,1,6,82,3,6,4.95346006,7259,1,208,28,813,773,40,30525,29121,1404,451,432,19,0,99.84314181,NoArch
600cf2eabed2104c330cc4785e7defa23b61c169,1,142,0,142,142,1,0,1,1,0,1,1,0,0,1,209,29,21,0,21,718,0,718,11,0,11,0,99.98838425,NoArch
aaeee58a7e4e88651f437204d24ce1089b48de0e,17,166,58,108,224,0,0,0,5,232,2,6,2.979572439,2477,1,210,29,282,260,22,14266,13712,554,139,132,7,0,100,NoArch
3119e418ba9fc9b61f6d094357a5fe2a9c8419ba,2,81,0,81,81,1,0,1,2,186,1,2,0.228538144,347,1,51,5,50,46,4,1677,1305,372,29,28,1,1,99.97677524,NoArch
d93cc61a8e696a8771702d11da16f8c7bf8f3372,1,1,1,0,2,0,0,0,2,377,1,1,0,41,2,52,6,2,2,0,115,115,0,2,2,0,0,100,NoArch
48f1207a1d393304aab147a75ba5dc670f7768b2,17,431,498,67,929,0,1,1,4,309,2,9,2.404609312,4635,1,211,23,633,604,29,27030,27456,426,218,223,5,0,99.9883883,NoArch
4232f049e296d16b902fb2ecdfb7a6826464eeed,1,31,9,22,40,0,0,0,3,0,1,1,0,415,1,212,24,107,101,6,2721,2600,121,29,29,0,0,100,NoArch
d5d6ded40a44dc8a3e46e39cafaedbabd3602967,1,2,2,0,4,0,0,0,5,86,1,1,0,699,1,213,23,167,167,0,4161,4165,4,25,25,0,0,100,NoArch
03ac282be3a5ede0058e4013fd1f8d58c3ef3e28,19,485,171,314,656,3,0,3,7,1,3,11,3.643311804,3578,1,214,23,434,389,45,18313,16654,1659,205,192,13,0,99.76125313,NoArch
643257023959231bfaf4abe4d8ce42dfc999e959,1,0,1,1,1,0,0,0,2,381,1,1,0,113,1,215,24,14,14,0,554,554,0,9,9,0,0,100,NoArch
410cc30152408668641856a91cf6b1e10cda57ae,3,84,2,82,86,1,0,1,3,184,1,2,1.22487796,342,2,53,7,34,31,3,2078,1717,361,22,20,2,1,99.98248277,NoArch
507915d42b2db2f4b40c34b8256b05c0c106b541,1,39,0,39,39,0,0,0,5,239,1,1,0,168,1,216,24,34,24,10,1016,786,230,12,11,1,1,100,NoArch
eeff8cbaac04e2c1ba668b5e9244d196a7a47e64,8,647,850,203,1497,0,1,1,7,133,1,2,2.589137538,2255,3,6,0,258,275,17,9351,9690,339,106,112,6,1,99.95329013,NoArch
f58b14a86a8b6131ba6cb04b80121d623aa3c4f9,1,4,1,3,5,0,0,0,6,226,1,1,0,138,3,11,3,16,15,1,766,746,20,5,5,0,1,100,NoArch
04bcd8f5da2cbf56296442b87fad26c5d5e36350,3,43,2,41,45,0,0,0,14,155,1,3,1.278286323,1901,3,24,4,256,249,7,12302,12054,248,119,117,2,1,100,NoArch
c3447b41b18dd58b69323c00c5daba89d6b2066c,2,21,8,13,29,0,0,0,5,58,2,2,0.79732651,533,1,217,17,97,93,4,2489,2377,112,15,15,0,1,100,NoArch
63b2f17bd2f3879fba45705822dcf4542e6a3e3f,1,0,1,1,1,0,0,0,4,0,1,1,0,591,2,25,5,122,122,0,3932,3938,6,21,21,0,0,100,NoArch
49daa4e030f1b3e5dd8fdf873c517c9810020790,4,32,18,14,50,0,0,0,10,226,2,3,1.932238192,2636,2,218,17,454,455,1,13172,13054,118,129,129,0,0,100,NoArch
d40d2579c83d46e59c830c9f27c241e1069123d0,0,0,0,0,0,0,0,0,0,0,0,0,0,0,0,219,18,0,0,0,0,0,0,0,0,0,0,100,NoArch
dad12d4c2e345aefee4db2612320ea062b8b7293,5,103,4,99,107,1,0,1,4,236,1,5,1.713048322,1197,2,54,8,109,102,7,7837,7378,459,81,75,6,0,99.98832321,NoArch
ffbfba37dabf7af843998a2698364093e23de875,1,1,3,2,4,0,0,0,3,0,1,1,0,372,2,55,9,40,40,0,2743,2758,15,20,20,0,0,99.48825308,NoArch
34516f05d511491d4c6dcfac2f16ee4843e3b2fe,1,1,31,30,32,0,0,0,5,0,1,1,0,541,2,56,10,26,27,1,2951,3150,199,26,27,1,0,100,NoArch
09972d2858a91298db9fcdd82dc23ff190454b04,8,60,14,46,74,0,0,0,6,202,2,7,2.762507376,4597,1,220,19,677,666,11,18609,18338,271,217,216,1,1,100,NoArch
2fef498067edceecbcead92d4a94a1ccf867c220,1,1,1,0,2,0,0,0,6,0,1,1,0,511,2,57,11,26,26,0,2951,2951,0,26,26,0,0,100,NoArch
2504e330a6c312061123b189097663546c4f36cb,1,0,122,122,122,0,1,1,2,396,1,1,0,122,1,221,20,0,11,11,0,533,533,0,6,6,1,99.98841251,NoArch
d23008ea8437c68b357754793096c5269fe7baf3,1,17,1,16,18,0,0,0,8,84,1,1,0,703,2,222,20,108,102,6,3640,3540,100,41,40,1,1,100,NoArch
5c3b89e62c09b6ee5e8f76ff1fc8fae1cd99ddc8,0,0,0,0,0,0,0,0,0,0,0,0,0,0,0,223,21,0,0,0,0,0,0,0,0,0,0,100,NoArch
f8cad43dd49ea10f5db5ba4ea337942b4194e487,1,12,5,7,17,0,0,0,7,2,1,1,0,141,3,12,4,18,16,2,796,766,30,5,5,0,1,100,NoArch
7456a2e26ae80c239dd77563125fc3c617058c68,3,12,16,4,28,0,0,0,7,147,2,3,1.448815636,835,4,13,0,105,105,0,4135,4175,40,37,37,0,0,100,NoArch
6c0c4787940badd423dab3e1f3b027056a07f300,1,2,2,0,4,0,0,0,3,140,1,1,0,90,2,26,6,15,15,0,363,363,0,7,7,0,1,100,NoArch
797b183088e6af4ee52ee36eaa17ab2365a7ab82,10,389,93,296,482,1,0,1,6,249,3,7,2.511838119,2637,1,224,21,471,408,63,16750,15210,1540,125,86,39,2,99.07239951,NoArch
7f732e3b7007a330147204213daf5a4e3d8927b9,0,0,0,0,0,0,0,0,0,0,0,0,0,0,0,225,21,0,0,0,0,0,0,0,0,0,0,100,NoArch
4b8965a83fbe9722baa97fd70913b36b03f2f129,3,26,51,25,77,0,0,0,3,133,2,3,0.346563258,589,1,226,19,63,67,4,3068,3181,113,24,24,0,0,100,NoArch
7ac3e21db0ee27a40e2bf037209d6d54a5e215e4,1,51,54,3,105,0,0,0,3,2,1,1,0,189,1,227,20,23,24,1,1133,1168,35,3,3,0,0,100,NoArch
4a6d55f30d927ff5156078b6ddb3644e05fa25e4,37,288,496,208,784,0,1,1,7,292,3,23,4.142141717,6094,1,228,21,678,659,19,31543,32355,812,292,309,17,0,94.73189087,Arch
96a967d26765201b6d6547bd7ced9f68ac6bfdd3,5,18,12,6,30,0,0,0,4,99,2,4,2.060754663,1251,1,229,22,173,172,1,6304,6234,70,85,85,0,0,99.95291902,NoArch
f201e488773687a246372581fb3c83c49c3ea346,14,1080,1335,255,2415,3,2,5,8,80,1,2,3.155563113,2792,2,7,1,286,315,29,11596,12419,823,124,139,15,1,95.33857251,Arch
e88330ec5a28f56b056b102c5082c8e649ced512,0,0,0,0,0,0,0,0,0,0,0,0,0,0,0,230,22,0,0,0,0,0,0,0,0,0,0,100,NoArch
dcb5a890f3785df013ff9207f1b098995fc8f750,2,10,4,6,14,0,0,0,8,213,1,2,0.591672779,494,1,231,23,58,56,2,2329,2297,32,13,12,1,0,100,NoArch
4cc00eec7b6f4a78dcb31d5a644245f9f42ef8a1,0,0,0,0,0,0,0,0,0,0,0,0,0,0,0,0,0,0,0,0,0,0,0,0,0,0,0,100,NoArch
acfb2502ef6eb67cc1417e33492e2c81a84a9b86,0,0,0,0,0,0,0,0,0,0,0,0,0,0,0,3,0,0,0,0,0,0,0,0,0,0,0,100,NoArch
98de7dd6fcbc15081ac77d323f7b06f8ebfdf2cc,18,139,168,29,307,0,0,0,16,265,4,14,3.917013303,6987,2,27,3,1308,1314,6,41161,41665,504,343,343,0,0,96.71343767,Arch
a70866b585bc5c6438055818563986e81216afef,2,41,44,3,85,0,0,0,3,344,1,2,0.368115005,725,2,28,4,51,52,1,4562,4600,38,17,17,0,0,100,NoArch
b9a79c91a7372a5f5020312f3857801c5c4c8f98,8,60,28,32,88,0,0,0,6,227,3,8,2.852572292,2615,2,29,5,402,402,0,15737,15485,252,119,119,0,0,100,NoArch
ed02714c48f8e021cebaeb94aa815566d7168d1a,0,0,0,0,0,0,0,0,0,0,0,0,0,0,0,4,1,0,0,0,0,0,0,0,0,0,0,100,NoArch
1cd666bfd952b9c2984ac704fe50ed8e6b73ec56,1,42,20,22,62,0,0,0,9,66,1,1,0,464,1,232,16,92,84,8,2609,2462,147,7,6,1,1,100,NoArch
be71a3bda4819ff6047359e30263366f2012ef47,3,12,10,2,22,0,0,0,8,234,2,2,1.292727215,691,2,233,16,100,100,0,3599,3586,13,30,30,0,2,100,NoArch
c70233b88268c1ada45a647caf4a8e880d344b6f,1,1,0,1,1,0,0,0,3,167,1,1,0,101,1,234,17,10,10,0,501,492,9,4,4,0,1,100,NoArch
83f5452710cee198a7265be056a3eda4755e9599,1,1,0,1,1,0,0,0,4,0,1,1,0,102,1,235,18,10,10,0,510,501,9,4,4,0,0,100,NoArch
70bdf3016c9a1f5865aaa3081b9ba812b2d33e5f,2,32,4,28,36,0,0,0,10,269,2,2,0.811278124,829,1,236,19,130,123,7,5810,5580,230,17,17,0,0,100,NoArch
29905f4449fa82f6b757b8ef3e39e020b7151004,2,14,3,11,17,0,0,0,2,426,1,1,0.672294817,356,1,237,20,34,31,3,1267,1192,75,19,18,1,0,100,NoArch
4f096cdcfac5ca103f34d69ad92b15613db186f7,14,349,105,244,454,1,0,1,7,183,2,10,2.504970919,4129,2,58,4,543,517,26,22249,21070,1179,233,217,16,0,99.44278011,NoArch
de3669605eb93cbf9a3420623b731270d897c1f0,0,0,0,0,0,0,0,0,0,0,0,0,0,0,0,59,5,0,0,0,0,0,0,0,0,0,0,100,NoArch
2170fea2e0b9423970181e8256a34e388fd2b486,4,44,9,35,53,1,0,1,6,0,1,1,1.161948015,168,2,60,6,11,7,4,614,566,48,11,7,4,0,99.96967124,NoArch
005861ec81666548ccc61c4e90b2e921f1ebdb08,1,18,40,22,58,0,0,0,5,0,1,1,0,377,2,61,7,36,40,4,2850,2798,52,19,20,1,0,100,NoArch
5aaef29f511e815578bf579b54db130931ed03a1,5,108,14,94,122,1,0,1,6,170,1,4,1.969694897,1368,1,62,8,186,179,7,7940,7631,309,63,60,3,1,94.69122427,Arch
4ae41309e4481481b9a14af1d25c1bcf001f7225,9,152,100,52,252,0,0,0,6,167,4,9,2.718598594,2941,2,30,6,432,427,5,17662,17676,14,116,114,2,0,100,NoArch
ba27ecd8bb201643319a549ee249571436f1b221,4,14,25,11,39,0,0,0,3,354,2,4,1.842904212,555,1,238,21,44,44,0,3032,3020,12,23,23,0,1,100,NoArch
307a0450f90309c29e7b78d765befdfd57830473,4,38,25,13,63,0,0,0,6,73,2,3,1.663555571,1475,2,31,7,269,269,0,8577,8563,14,95,93,2,0,99.98531787,NoArch
6d4c115c26677a8e954a86216d3824dbf72d7b6b,4,72,24,48,96,0,0,0,6,329,1,3,1.269659458,2088,1,239,22,210,203,7,13806,13496,310,109,107,2,1,100,NoArch
690dd8414395698bde59327d729588f8b6e321e3,1,0,9,9,9,0,0,0,7,0,1,1,0,1283,1,240,23,91,92,1,9297,9356,59,46,47,1,0,100,NoArch
572ce67744317dec56790f6024dc1bcdd3c0fc39,4,96,9,87,105,0,0,0,6,241,1,2,1.724193782,1124,3,1,1,205,205,0,5618,5618,0,89,89,0,0,100,NoArch
a020528481a76cb8bd2f7aeb9b2caf31de9038a6,5,82,81,1,163,0,0,0,7,63,1,3,1.795111922,1840,1,241,24,303,302,1,8843,8833,10,126,126,0,0,100,NoArch
4d3fe068c26f5b1f7290ea27afc848cecdb52659,2,33,15,18,48,0,0,0,2,436,1,2,0.994984828,290,2,32,6,45,46,1,1168,1218,50,27,27,0,0,100,NoArch
486e0864038d090873a5a098d908f7172159501c,1,0,18,18,18,0,0,0,3,0,1,1,0,238,2,33,7,38,38,0,858,858,0,24,24,0,0,100,NoArch
e7b9afa9e2bf23719d18dd6bcd50c7376df6c18d,2,33,3,30,36,0,0,0,6,112,1,2,0.503258335,304,1,242,23,51,41,10,1732,1581,151,26,24,2,1,92.53663524,Arch
0d8a79e6dd6e50ee86e3ecdfccbc2b73efb81016,6,65,4,61,69,0,0,0,9,240,2,5,1.786945367,1860,1,243,23,231,219,12,11125,10802,323,84,79,5,1,96.87715991,Arch
3c2c30df269c114acfa92eb6908a7894ec0b45f6,6,38,115,77,153,0,0,0,7,272,3,6,2.484008451,3167,2,34,8,366,370,4,18046,18168,122,116,116,0,0,99.77050724,NoArch
2ec1a9da1df4cc7582903d75b0675c331590e3c5,2,3,2,1,5,0,0,0,2,438,2,2,0.970950594,927,1,244,22,62,62,0,6532,6521,11,34,34,0,0,100,NoArch
56d133b6854d9cb9b1250d81c9134ac4e6ca528b,0,0,0,0,0,0,0,0,0,0,0,0,0,0,0,245,23,0,0,0,0,0,0,0,0,0,0,100,NoArch
7c13fb72742ce1deaf96c7e605e515b973c819f8,1,3,0,3,3,0,0,0,3,65,1,1,0,188,1,246,24,26,25,1,1049,1031,18,15,15,0,0,100,NoArch
d56d11d7ac4962506bbf3326717160472f12db77,0,0,0,0,0,0,0,0,0,0,0,0,0,0,0,2,2,0,0,0,0,0,0,0,0,0,0,100,NoArch
696b59e923160de6fddd9f50334f4ba0d327a051,24,1487,4,1483,1491,22,0,22,2,36,3,11,4.211678525,199,2,8,1,130,26,104,4683,707,3976,85,15,70,1,99.35631108,NoArch
598c7ad7eccdc2d27c684ad0355c012af3804ea0,1,1,3,2,4,0,0,0,2,441,1,1,0,105,1,247,21,8,9,1,670,686,16,3,3,0,0,100,NoArch
0903437c733e0f3d526fbb82082ac7a53c8b2c0c,3,22,10,12,32,0,0,0,5,173,1,2,0.73806367,846,5,5,2,98,95,3,4427,4351,76,36,36,0,1,100,NoArch
8bc50b04b13a143a8b79b5bcc3787ee87fe0eab7,0,0,0,0,0,0,0,0,0,0,0,0,0,0,0,6,3,0,0,0,0,0,0,0,0,0,0,100,NoArch
91b4846ec974aa0ea9bbfe1eda6f1c6e16375d6a,1,10,7,3,17,0,0,0,3,29,1,1,0,217,1,248,16,22,21,1,888,876,12,3,3,0,0,100,NoArch
332f1b45a6e551050752c21e23bbed55e21a951c,38,1740,355,1385,2095,1,0,1,9,91,5,14,3.253866124,8243,2,249,17,1236,970,266,51002,42794,8208,499,448,51,0,94.78129713,Arch
0de08872db3fa32578874646dab9518752e19a3c,0,0,0,0,0,0,0,0,0,0,0,0,0,0,0,7,4,0,0,0,0,0,0,0,0,0,0,100,NoArch
a8f53d1380952825fb74d82e09a125c020c56615,4,302,92,210,394,0,0,0,8,0,2,3,0.931306032,1856,1,250,18,348,306,42,12211,10942,1269,79,74,5,0,100,NoArch
031f11ffa7853777c254cd06828950857b0fedff,2,11,0,11,11,0,0,0,5,1,1,2,0.845350937,900,1,251,19,169,167,2,5377,5329,48,30,30,0,0,100,NoArch
741c3aa9893d109d0b14dad1fcbf751dc2f09cab,12,620,507,113,1127,2,0,2,9,74,1,3,3.000552079,2385,5,9,1,284,271,13,11952,11273,679,139,121,18,1,93.5795524,Arch
f32830cddeb243b3d494dcd4579b0ef7150bbb22,15,1540,260,1280,1800,4,0,4,10,19,1,7,2.854700015,3805,1,252,19,814,633,181,26048,20042,6006,210,149,61,0,99.56318989,NoArch
5360ef22762d0560f93553daade07c377a3ff829,0,0,0,0,0,0,0,0,0,0,0,0,0,0,0,10,2,0,0,0,0,0,0,0,0,0,1,100,NoArch
e97086a1c565c56d683ad10b621c8988b5408c45,4,319,0,319,319,4,0,4,1,0,1,2,1.557721287,0,1,63,5,11,0,11,1520,0,1520,10,0,10,0,99.94734071,NoArch
d65d7c66ebab5774fba982e6f53c03073c55b42e,9,301,143,158,444,0,0,0,17,32,1,5,2.291137748,5603,1,253,16,1130,1087,43,34017,32830,1187,302,292,10,0,100,NoArch
36c3d623232982c76ec0a44898f0b621158a92d9,1,3,3,0,6,0,0,0,8,0,1,1,0,1122,1,254,17,218,219,1,6984,6994,10,41,41,0,0,100,NoArch
502c3af515f936cfa4511259621e340da77d3d47,1,3,2,1,5,0,0,0,2,469,1,1,0,243,2,11,3,38,38,0,1158,1145,13,21,21,0,1,100,NoArch
bed93d9f273a386c5e29cd5b305f05189e637f5b,4,9,27,18,36,0,0,0,2,468,1,3,1.816340114,714,2,12,4,93,95,2,3142,3263,121,61,63,2,0,100,NoArch
f677bcb3737d56cdcffc3473fa6fcb50c7de186d,1,4,2,2,6,0,0,0,4,98,1,1,0,437,2,4,0,108,107,1,2729,2721,8,29,29,0,0,100,NoArch
a5c3f455df0fbbfaeacc8f1351c730c3a5e0e25c,2,169,114,55,283,1,0,1,3,49,1,1,0.981683534,174,2,5,1,40,36,4,1397,1194,203,11,7,4,0,99.98830546,NoArch
4d4cf4d322db069851e03183ac20a982017ce9cc,3,195,53,142,248,0,0,0,9,9,1,1,1.203875027,2246,1,255,14,428,393,35,13785,13124,661,66,65,1,0,100,NoArch
79be615e94c8f11bf32b09255c2b87dc9cc7e760,18,603,1136,533,1739,0,3,3,10,90,1,4,3.412288594,2961,2,0,0,259,320,61,11737,13768,2031,146,153,7,1,93.62348178,Arch
cb2544fda749a74b2ba7c93dfed48892bb8523ae,2,5,1,4,6,0,0,0,7,238,2,2,0.918295834,498,4,256,14,34,34,0,2202,2178,24,29,29,0,0,100,NoArch
7572ae590bee45881ff32671b9868f0fe2083564,2,6,34,28,40,0,1,1,3,37,1,2,0.721928095,112,3,1,1,7,8,1,282,293,11,4,5,1,1,99.98916694,NoArch
3f742349af9b52d001c27ee19dd708b615cec9fb,0,0,0,0,0,0,0,0,0,0,0,0,0,0,0,2,2,0,0,0,0,0,0,0,0,0,0,100,NoArch
aec5212a93eaea503b916d92ff6167609ab73e63,1,2,2,0,4,0,0,0,11,0,1,1,0,258,5,3,3,26,26,0,1323,1323,0,11,11,0,0,100,NoArch
2f1f50f22571471371335173982ed6d6716523ab,2,29,5,24,34,0,0,0,6,373,2,2,0.989992792,1168,2,14,0,195,188,7,6104,5896,208,59,59,0,0,100,NoArch
de6fbfd72682c66bcee03412fa2fad019c72590e,1,1,1,0,2,0,0,0,7,0,1,1,0,1109,3,64,1,193,192,1,5713,5709,4,57,57,0,1,100,NoArch
7c38f181739e19dcf3a936f9cee3ab8112e14225,3,79,45,34,124,0,0,0,5,95,1,2,0.832037841,556,2,65,2,51,45,6,3275,3051,224,41,38,3,1,100,NoArch
08d17ea0c758ce444bc6402ad930304f48259d6b,4,397,1,396,398,1,0,1,4,328,2,2,1.210988558,679,2,66,3,168,109,59,4649,3043,1606,81,54,27,0,93.69478799,Arch
86adc223e36df6af5049d5ca19751baff6e85b27,0,0,0,0,0,0,0,0,0,0,0,0,0,0,0,4,4,0,0,0,0,0,0,0,0,0,0,100,NoArch
baafc8c97a83096a41a90bdbda1269d4435853d1,1,3,2,1,5,0,0,0,2,280,1,1,0,113,2,5,5,7,7,0,542,527,15,7,7,0,0,100,NoArch
241381f7814d7c1b9d44b3747584b23757b270da,10,270,200,70,470,1,0,1,12,9,1,2,2.587822402,1873,2,6,6,204,197,7,9831,9699,132,95,94,1,1,97.37972036,Arch
561a0319d889ef38a70c8bc78e4ba96e6f63678c,1,1,1,0,2,0,0,0,2,489,1,1,0,52,2,6,0,5,5,0,162,162,0,5,5,0,0,100,NoArch
2bef64fafd3a0e6ab941b0c2af50c45a540da005,6,115,22,93,137,1,0,1,13,6,1,1,2.137165947,1097,2,7,7,159,147,12,5391,5044,347,99,90,9,1,99.98922994,NoArch
8b71dbf5b560fe5210dc9509fbf3aa9e3e8b5128,1,8,3,5,11,0,0,0,3,224,1,1,0,186,2,7,1,22,22,0,814,814,0,7,7,0,0,100,NoArch
0d5f6534e0ac0bfa658848fa367ad9034bf9bd04,1,13,1,12,14,0,0,0,2,0,1,1,0,54,1,8,8,8,5,3,243,162,81,4,3,1,1,99.92460553,NoArch
22dc0bcd1344678aad1ec4b1094e022ecb4af2f3,2,8,1,7,9,0,0,0,18,71,2,2,0.764204507,2421,4,15,1,548,546,2,14864,14839,25,136,136,0,0,100,NoArch
9524b0db1bbf781be26e814ed922aaafcda69314,1,5,2,3,7,0,0,0,7,0,1,1,0,214,2,16,2,39,35,4,1070,1037,33,12,12,0,0,100,NoArch
53d69d2e5a7b31a292f0365b0c70a3ad804adb48,1,1,1,0,2,0,0,0,8,0,1,1,0,217,2,17,3,39,39,0,1070,1070,0,12,12,0,0,100,NoArch
f2c9d1b5a4ea878cedf12aab00d7af6e3ca441de,1,2,4,2,6,0,0,0,3,432,1,1,0,725,2,257,7,174,174,0,4871,4874,3,16,16,0,1,100,NoArch
7c4bdd3e76993fd74b4b1f6dd1236407b729a9e4,10,1347,0,1347,1347,10,0,10,1,0,3,4,2.961386784,0,1,13,4,172,0,172,5091,0,5091,79,0,79,1,99.84398537,NoArch
88a44799a9bb10da203c343ce5cd9e82d1e360ce,0,0,0,0,0,0,0,0,0,0,0,0,0,0,0,14,5,0,0,0,0,0,0,0,0,0,1,100,NoArch
6698b05d64dafa81e706beb8a2813b1c77b3b610,2,74,23,51,97,0,0,0,6,102,1,2,0.734128043,524,2,258,6,72,67,5,2940,2670,270,22,19,3,1,100,NoArch
70faee971324ca45cec59b3854ca1fd0196641a8,0,0,0,0,0,0,0,0,0,0,0,0,0,0,0,259,7,0,0,0,0,0,0,0,0,0,0,100,NoArch
94f9d1a5cfbedf611f75e8de9994cbceb66fc9bf,4,8,7,1,15,0,0,0,6,343,3,3,1.889246429,1644,1,260,8,320,320,0,9474,9451,23,114,114,0,0,99.98387877,NoArch
2d63639b4bff47a4b6d90209db210dbcafcd5dfb,0,0,0,0,0,0,0,0,0,0,0,0,0,0,0,261,9,0,0,0,0,0,0,0,0,0,0,100,NoArch
243608768436eca5c72e16cf1c3fb870df831585,0,0,0,0,0,0,0,0,0,0,0,0,0,0,0,262,10,0,0,0,0,0,0,0,0,0,0,100,NoArch
9ea04a67afb00600c1c6cfb28d95736a6f12f347,9,112,37,75,149,0,0,0,5,318,2,7,2.360470577,3405,2,67,4,318,301,17,20899,20462,437,153,153,0,1,100,NoArch
2e1de086fb0b33725a07909e5236115cffe07883,0,0,0,0,0,0,0,0,0,0,0,0,0,0,0,0,0,0,0,0,0,0,0,0,0,0,1,100,NoArch
b1123c21a194a5d95d0dbedd9b57af90c643fc6e,5,36,19,17,55,0,0,0,14,7,1,2,1.705702055,802,3,9,9,85,85,0,4017,3817,200,44,43,1,0,99.903283,NoArch
e59b726527e0a70ea6e5b8bda283cb9037ec0a3a,1,2,2,0,4,0,0,0,2,501,1,1,0,71,2,68,5,6,6,0,252,243,9,3,3,0,1,100,NoArch
d89dabd2fc1616241e3600a86c137efcae76d192,7,137,1,136,138,1,0,1,8,243,2,6,1.837163234,1248,2,69,6,98,89,9,7919,7154,765,77,69,8,0,99.98925655,NoArch
9c1b90ec0a40f72d2a21b703a7f7e657170a1a8f,2,1,2,1,3,0,0,0,3,94,2,2,0.918295834,597,1,263,11,83,83,0,3168,3173,5,36,36,0,0,100,NoArch
a92a558bb33565fb4c0f02b06c36f876aa722a7b,0,0,0,0,0,0,0,0,0,0,0,0,0,0,0,15,5,0,0,0,0,0,0,0,0,0,0,100,NoArch
08631678af55c3e091dd7ae19ed23aa3c3342f88,0,0,0,0,0,0,0,0,0,0,0,0,0,0,0,264,12,0,0,0,0,0,0,0,0,0,0,100,NoArch
d6bedc9bfc20d671551a974be7bb17dca0d70ab5,1,9,8,1,17,0,0,0,15,5,1,1,0,210,5,265,12,25,26,1,1074,1061,13,9,9,0,0,100,NoArch
4a9a04baf552aeb6ca1360a79063b1dfd00492d6,2,23,3,20,26,0,0,0,5,342,1,2,0.840358672,687,1,266,13,98,94,4,2544,2475,69,44,43,1,1,100,NoArch
fdb88ce018b71b5f1417c08d360f6665fc1d2af3,2,123,0,123,123,2,0,2,1,0,1,2,0.909950305,0,1,16,5,6,0,6,485,0,485,4,0,4,1,99.94095228,NoArch
20246b243f4375fce0d91caf0bdd8040783352fc,2,33,0,33,33,0,0,0,19,79,1,2,0.532835063,2732,4,267,13,612,601,11,17006,16805,201,152,150,2,0,100,NoArch
74e28001af99cfcba5bf6826a8e33c0a193e2745,10,202,31,171,233,1,0,1,4,251,1,3,2.767274577,1763,2,18,4,252,231,21,9931,8933,998,126,113,13,0,99.96781634,NoArch
52644b9e8d090411b32d0a433317ee38cb57cf51,1,26,4,22,30,0,0,0,2,510,1,1,0,72,1,268,13,11,5,6,318,197,121,3,2,1,1,100,NoArch
964928b306364cf8cae362a2eab5d18340983af2,2,4,2,2,6,0,0,0,5,16,1,1,0.918295834,476,2,10,10,80,79,1,1983,1971,12,66,66,0,0,100,NoArch
ab4c65e76709303018f65f0721a14d8b7f08e802,2,227,0,227,227,2,0,2,1,0,1,1,0.896351167,0,1,70,6,21,0,21,1153,0,1153,11,0,11,0,99.97319179,NoArch
20c85a5f827b66a506b36db1a887b3d33f9e3d93,1,10,9,1,19,0,0,0,6,79,1,1,0,303,3,17,4,47,47,0,1273,1269,4,21,21,0,1,100,NoArch
b0edfd892a2acd2ebaee7899b9f053211ad15ddf,12,39,39,0,78,0,0,0,6,239,1,4,2.851440342,2639,2,8,2,254,254,0,11268,11268,0,135,135,0,0,100,NoArch
f6d9d17ebfe85df321c24f1157fe9a031c6a0186,1,2,1,1,3,0,0,0,6,124,1,1,0,445,3,18,5,90,90,0,2004,1992,12,35,35,0,1,100,NoArch
2075aad042c9843df4990c770a771713fa25b48d,3,34,12,22,46,0,0,0,4,350,1,3,1.129009334,531,2,269,12,53,51,2,3185,3067,118,22,21,1,1,100,NoArch
cff6afbfbe76eac5479cad119c35203a05df052a,1,6,2,4,8,0,0,0,2,522,1,1,0,128,2,71,6,25,24,1,364,349,15,8,8,0,1,100,NoArch
4da367c2b19c956719d34d47d3ec51023795f8a8,5,95,64,31,159,0,0,0,15,137,2,5,1.635932318,3622,3,270,13,526,523,3,22808,22619,189,155,154,1,0,99.68877442,NoArch
61eae25d773873d9fc478af6057c0c5fdb26179f,7,33,28,5,61,0,0,0,6,116,2,4,2.192473853,2781,1,271,14,489,492,3,15662,15604,58,82,82,0,0,99.69364721,NoArch
8ef96e9beb72e382657782b90fa872a18b881765,9,263,139,124,402,0,0,0,9,353,3,8,2.273139553,2659,1,272,15,419,397,22,14872,14165,707,155,142,13,2,100,NoArch
140239d383d9d654a8fbf531bbd037e2a3a29fdb,1,71,14,57,85,0,0,0,2,86,1,1,0,222,1,19,6,33,26,7,1212,900,312,9,7,2,1,100,NoArch
ddebabeea3c4405e02ba4ba5b6b42bd23fe4d6ce,4,165,3,162,168,1,0,1,4,196,1,4,0.868497554,1464,1,19,4,189,161,28,10672,9950,722,107,80,27,0,99.98924616,NoArch
1e1b05a00406a2aefcec0dbac0e5f8e5a9cbe780,11,532,82,450,614,1,0,1,16,149,3,8,2.335857455,4389,2,273,16,553,499,54,20023,18221,1802,214,194,20,1,99.94623367,NoArch
e5d991decfb92db1d31cd691e3657364f037f9aa,0,0,0,0,0,0,0,0,0,0,0,0,0,0,0,3,0,0,0,0,0,0,0,0,0,0,0,100,NoArch
1cebd758545c2b75ffd17e67ce0486302089011e,11,109,201,92,310,0,1,1,17,208,4,9,2.51100452,5655,2,274,17,678,693,15,30897,31065,168,253,248,5,0,98.34812497,NoArch
83234b88ccb8057cbfb29122187d610886894ba0,4,157,5,152,162,1,0,1,7,191,2,3,1.523474665,1018,2,20,5,95,77,18,5559,4793,766,78,68,10,0,99.9803835,NoArch
313dad701c7b29fc156a756944f1209a06e22283,1,1,1,0,2,0,0,0,8,0,1,1,0,641,2,21,6,36,36,0,2842,2844,2,34,34,0,0,100,NoArch
b9ce9c9ad74328405260b078c172ca1c29509168,5,300,0,300,300,5,0,5,1,0,1,1,2.242411191,0,1,22,7,16,0,16,1089,0,1089,12,0,12,0,99.94610221,NoArch
c81022ff1923e9ea03cbaa5f0a26fe85529e2e62,3,181,9,172,190,0,0,0,4,12,1,2,0.615018229,244,1,23,8,48,22,26,1849,1119,730,37,11,26,0,100,NoArch
85cdf7400f16ef11fb490ad8b2ab4ab89f79633a,1,2,2,0,4,0,0,0,3,0,1,1,0,71,2,275,18,8,8,0,366,356,10,6,6,0,0,100,NoArch
1788a5c1525883d6f4f9b1bb72f76e0e1e965efd,3,13,1,12,14,0,0,0,4,169,3,3,1.094914318,649,1,276,19,120,118,2,3887,3798,89,32,32,0,0,99.9951038,NoArch
53d8dd91f4764e59b774d4672f0aec98dcc28cc9,4,128,2,126,130,2,0,2,2,12,1,3,1.3879348,227,1,72,5,30,21,9,1678,1153,525,19,11,8,0,99.97552379,NoArch
5556316a73b2e9aae3eaf9471ab745a02ee313c4,13,126,30,96,156,1,0,1,9,187,3,8,2.62129964,4214,1,24,6,465,455,10,24913,24532,381,230,221,9,1,99.99021239,NoArch
b701d98a3ce94a8cacf6a4d5b45bfe52866d82b5,1,3,2,1,5,0,0,0,2,1,1,1,0,76,2,25,7,4,4,0,369,367,2,4,4,0,0,100,NoArch
2892855723e1a84fba1d041cb948ebe9acb6b310,1,15,1,14,16,0,0,0,3,0,1,1,0,73,2,26,8,7,5,2,321,277,44,7,5,2,0,100,NoArch
8849993a3bd2adf664d8a9fe076d9a63fbdbb232,1,21,0,21,21,0,0,0,2,2,1,1,0,64,1,27,9,6,4,2,375,214,161,6,4,2,0,100,NoArch
83da1129c72f0285baf59a88f7b7e133c9b3270a,1,1,1,0,2,0,0,0,4,2,1,1,0,87,2,28,10,7,7,0,319,321,2,7,7,0,0,100,NoArch
22b9563835b8b5d9ccf3eba03c555edbf8056368,1,1,0,1,1,0,0,0,2,545,1,1,0,857,2,29,11,58,58,0,4946,4930,16,42,42,0,0,100,NoArch
5e788618d459e75cef536b03f47d7b57a9938397,8,119,11,108,130,1,0,1,6,35,2,4,2.667804844,2321,1,30,12,295,288,7,15119,14590,529,132,126,6,1,99.98532146,NoArch
43c70b76ecac13433c5ba48d4bd5c273fd2a1119,4,79,10,69,89,1,0,1,4,62,1,4,1.373576112,446,1,31,13,87,80,7,2382,2096,286,39,36,3,0,99.9804334,NoArch
ac174e4edae3c8e912b7edff8e646739279bda6c,65,621,452,169,1073,0,0,0,7,216,2,12,5.349348992,9690,2,32,14,1224,1210,14,52973,51423,1550,647,636,11,0,99.99510907,NoArch
8577edf8c9e6d9ec8a1dfd8cde0bd200709d266e,12,218,5,213,223,2,0,2,5,253,2,7,2.961379857,3005,2,73,3,390,366,24,16382,15524,858,150,137,13,0,99.96577184,NoArch
38b239c10197f5fc11ae2cce8dfbc50b9b06b06c,3,32,23,9,55,0,0,0,4,0,1,3,1.112924711,1390,2,74,3,168,166,2,7697,7629,68,48,47,1,0,100,NoArch
43bd48f655ae1e33b94470d767a7c95b61917ee8,1,6,0,6,6,0,0,0,4,0,1,1,0,313,2,75,4,17,17,0,2079,2016,63,15,15,0,0,99.99022292,NoArch
1b9134cc82f91cadcf2bf088afd07857708559d4,1,1,2,1,3,0,0,0,5,0,1,1,0,434,3,20,2,69,69,0,1973,1978,5,20,20,0,0,100,NoArch
ed4a311c9cf98be7582fa832e861f63ad2934295,22,805,243,562,1048,4,0,4,10,230,4,13,3.320605116,7550,1,277,8,1146,1099,47,47871,44979,2892,336,320,16,0,99.92176804,NoArch
27626d6194a56569383f0c95cf30b4de789a9f63,6,175,77,98,252,1,0,1,6,137,1,2,2.038009911,1766,2,76,5,255,243,12,8749,8212,537,94,88,6,0,99.98533007,NoArch
24f0794e18aed721b910f6b66469abf588c9a805,2,10,3,7,13,0,0,0,2,562,1,2,0.961236605,257,2,77,6,21,20,1,1320,1303,17,19,18,1,1,100,NoArch
0e99a7d207628a999f66636330c296cf850e9c7a,1,16,3,13,19,0,0,0,3,167,1,1,0,144,2,78,7,22,21,1,678,660,18,10,9,1,1,100,NoArch
d35f046bf209e951867e024eef682907c4799be2,5,109,32,77,141,0,0,0,18,69,1,2,2.013435611,1223,3,21,1,143,133,10,6896,6411,485,55,53,2,1,99.9951105,NoArch
4ff798a9b6f2d605cd7588e9d152da5d960fd875,1,1,1,0,2,0,0,0,9,0,1,1,0,303,4,22,2,51,51,0,1915,1909,6,11,11,0,1,100,NoArch
e755675eb63c297e778a995ce04afa942930e002,0,0,0,0,0,0,0,0,0,0,0,0,0,0,0,278,3,0,0,0,0,0,0,0,0,0,0,100,NoArch
fb0b88f22e4a9d8690f305efcb322e1b0bb7a69d,4,194,1,193,195,3,0,3,4,40,1,2,1.643854599,240,1,35,0,39,31,8,2266,1691,575,12,7,5,0,99.96578523,NoArch
bbce67a2cd3a004d9867d2c373db076a7495d4a8,1,4,2,2,6,0,0,0,2,582,1,1,0,137,1,279,2,31,29,2,908,870,38,6,6,0,0,100,NoArch
94ea161f2338759f66a31796e6f951ea0832e4d3,0,0,0,0,0,0,0,0,0,0,0,0,0,0,0,4,0,0,0,0,0,0,0,0,0,0,0,100,NoArch
f136d5f4e31ddcb43084f7092808687874fc8447,0,0,0,0,0,0,0,0,0,0,0,0,0,0,0,13,0,0,0,0,0,0,0,0,0,0,1,100,NoArch
d4f9ddb62acae3020b0edb72c0a88d5aa0bb8cde,0,0,0,0,0,0,0,0,0,0,0,0,0,0,0,14,1,0,0,0,0,0,0,0,0,0,0,100,NoArch
f5b81d9dae128940aae15be32da76c00e749b4b9,7,143,90,53,233,0,1,1,10,203,4,5,2.221840437,1692,1,280,3,274,254,20,9539,9102,437,64,62,2,0,99.95601603,NoArch
af5c4128f2f73066bc07818959c4e0ef85f8a786,1,0,1,1,1,0,0,0,3,0,1,1,0,422,1,281,4,46,46,0,2495,2502,7,10,10,0,0,100,NoArch
3a024c3f752c8050d6870937e7fed944f5cb4749,0,0,0,0,0,0,0,0,0,0,0,0,0,0,0,5,1,0,0,0,0,0,0,0,0,0,0,100,NoArch
d03b4dc3c593a48720f6361e3f7a849928e5b7ae,3,81,3,78,84,1,0,1,5,194,2,2,1.458618551,503,2,5,0,69,60,9,2995,2689,306,22,17,5,0,99.99022483,NoArch
3e4432942dc817b2d990d6839cdefd56f2bf07f5,3,223,0,223,223,1,0,1,8,24,1,3,0.860732838,1277,1,33,1,165,130,35,10477,9388,1089,81,48,33,0,99.99022674,NoArch
4ce68202aa2044b34e20053b1c7416fdb78d8e4f,1,2,2,0,4,0,0,0,7,231,1,1,0,368,1,282,5,61,61,0,2620,2616,4,9,9,0,0,100,NoArch
563118be286f2b882d35a2d2594b2426085071c6,0,0,0,0,0,0,0,0,0,0,0,0,0,0,0,6,2,0,0,0,0,0,0,0,0,0,0,100,NoArch
b5a925c91bd2a78f66a6755b2bec2e58e4ee2834,2,26,17,9,43,0,0,0,12,307,1,1,0.952265625,1391,1,283,6,306,306,0,7101,7113,12,87,87,0,0,100,NoArch
29dd712f37bd796b4ce5d2fff6e7ec09e33308e4,2,5,5,0,10,0,0,0,13,0,1,1,0.721928095,1400,1,284,7,306,306,0,7095,7101,6,87,87,0,0,100,NoArch
19df11408474887ece06f1c0f0802442f13a4be7,0,0,0,0,0,0,0,0,0,0,0,0,0,0,0,7,3,0,0,0,0,0,0,0,0,0,0,100,NoArch
2b413feb56833ac08086f496cfdb2fc5a91a8924,8,159,17,142,176,2,0,2,7,313,3,6,2.221439326,892,1,285,8,124,109,15,4269,3839,430,81,72,9,0,99.93161057,NoArch
dfec261355d12d4b4e06b1461c9e6923b9e85892,2,4,3,1,7,0,0,0,2,594,1,2,0.985228136,122,2,8,4,0,0,0,148,148,0,0,0,0,0,100,NoArch
048c047f2c4fb96c7bcacf949afeb8d80d83fd2e,1,4,2,2,6,0,0,0,11,9,1,1,0,494,2,79,6,94,94,0,2714,2707,7,7,7,0,1,100,NoArch
1eb33fbf9e9750fbf092f18f8c04744a40f5452a,0,0,0,0,0,0,0,0,0,0,0,0,0,0,0,286,9,0,0,0,0,0,0,0,0,0,0,100,NoArch
23147b12c56c0b89a60e4fd0d68b9e27e7bf4405,1,2,1,1,3,0,0,0,10,32,1,1,0,303,4,23,2,51,51,0,1917,1915,2,11,11,0,1,100,NoArch
07a4e5164e007d363760e9079db1fb7fb76b8cf5,2,14,4,10,18,0,0,0,6,94,1,1,0.764204507,478,3,287,9,82,80,2,2042,1983,59,66,66,0,0,100,NoArch
ba4c83cfd430cc668bcd396a1e687e84153c6a2c,0,0,0,0,0,0,0,0,0,0,0,0,0,0,0,288,10,0,0,0,0,0,0,0,0,0,0,100,NoArch
f513524e11a2ee8f5af5ff52442611173d8281c5,0,0,0,0,0,0,0,0,0,0,0,0,0,0,0,289,11,0,0,0,0,0,0,0,0,0,0,100,NoArch
336f42766d1bb430294623480c5f0888a476b472,0,0,0,0,0,0,0,0,0,0,0,0,0,0,0,290,12,0,0,0,0,0,0,0,0,0,0,100,NoArch
a0c331a7613b6210e42b201f8c491f9e94c0e382,9,684,52,632,736,1,0,1,8,316,3,7,1.217757242,4128,2,291,13,532,450,82,18853,16255,2598,178,157,21,0,99.99023342,NoArch
8fb8262c708013090631044993bd49969c9e113c,1,7,8,1,15,0,0,0,2,0,1,1,0,590,1,292,14,69,69,0,2199,2203,4,20,20,0,0,100,NoArch
5700276259938b3e6551077911e7f19123beb202,2,183,37,146,220,0,0,0,2,610,1,1,0.721928095,278,2,15,2,58,36,22,2797,1861,936,11,7,4,1,98.67159749,NoArch
743e5eca454f56c4e21dc47ee5e8d8edcd4f457c,0,0,0,0,0,0,0,0,0,0,0,0,0,0,0,293,15,0,0,0,0,0,0,0,0,0,0,100,NoArch
4cb4092f9aa247584d5e2b48a5b4b1c2fa185508,22,352,349,3,701,2,3,5,8,337,5,11,3.575227807,5377,1,294,16,701,687,14,32816,32493,323,232,238,6,0,99.92241672,NoArch
3b81ea17379c110bce1b6c077e5f81028d7e7b4b,1,21,1,20,22,0,0,0,3,185,1,1,0,118,1,295,17,22,16,6,697,558,139,12,11,1,0,100,NoArch
f4d2145139c37b67cc3206a47fd8c4f0d11f3366,2,17,15,2,32,0,0,0,7,6,1,2,0.954434003,529,3,296,17,72,71,1,2353,2316,37,35,35,0,0,100,NoArch
0246ad5cc3e2d153290cb8e768e2c5ad15698327,1,1,1,0,2,0,0,0,6,0,1,1,0,306,1,297,18,41,40,1,1186,1182,4,18,18,0,0,100,NoArch
a0d787f98524ccda12f33503e3df4513481ee7f1,3,59,16,43,75,0,0,0,4,166,1,2,1.542833137,445,2,80,1,41,36,5,2353,2158,195,27,24,3,1,100,NoArch
061c7b56eb618b4b9facf94527a15ef11f8d1687,1,1,1,0,2,0,0,0,5,0,1,1,0,307,2,81,2,22,22,0,1564,1567,3,22,22,0,0,100,NoArch
11109e7c4ae18b811bb30c39b7fe059e036cfb6f,0,0,0,0,0,0,0,0,0,0,0,0,0,0,0,82,3,0,0,0,0,0,0,0,0,0,0,100,NoArch
0ac32af81894268c7f040eb6d56aa49ea685251a,1,8,8,0,16,0,0,0,6,1,1,1,0,307,2,83,4,22,22,0,1564,1564,0,22,22,0,0,100,NoArch
d51bdceb6e87007069d959fce977c87a78d883fb,0,0,0,0,0,0,0,0,0,0,0,0,0,0,0,298,19,0,0,0,0,0,0,0,0,0,0,100,NoArch
e19941123b338fa13929f5d686d115c59e7f96f3,1,7,0,7,7,0,0,0,3,289,1,1,0,474,2,84,5,83,82,1,2345,2328,17,41,41,0,0,100,NoArch
555aa0ff44575d10ec844a61ff9a15687b726896,1,3,1,2,4,0,0,0,5,123,1,1,0,807,2,85,6,44,43,1,5309,5300,9,25,25,0,0,100,NoArch
c4bac0e7b6d6bda9fa15267c7f706a92d67e41e3,37,2455,22,2433,2477,27,0,27,13,86,3,18,4.965817202,3811,1,34,1,641,452,189,28619,18734,9885,319,206,113,2,99.63322233,NoArch
c8eac7eb5b5bcf545661bf94764df3ee35d82e4e,3,21,5,16,26,0,0,0,6,36,2,2,1.419556299,581,2,6,1,73,69,4,3083,2995,88,23,22,1,0,100,NoArch
03940264dd656fc9e59efa512cc01ad30acfa2ef,3,155,7,148,162,0,0,0,4,513,1,1,0.510824898,498,1,299,19,110,71,39,3078,2244,834,22,19,3,2,100,NoArch
45031b3476b6e21bb2f51ee3fa0262cf0195c699,1,14,0,14,14,0,0,0,5,266,1,1,0,774,1,300,20,196,193,3,4729,4579,150,45,45,0,0,100,NoArch
318e9498ffd09b22f8b107d55d071414811e8dc2,13,77,73,4,150,0,0,0,14,0,3,8,3.500513238,1443,1,35,2,129,129,0,5895,5854,41,72,72,0,2,99.89914029,NoArch
8e907c1b78aff58491026ff16d4da6d4e268e227,9,426,3,423,429,6,0,6,10,21,2,5,2.510633463,1388,1,36,3,276,248,28,10331,8769,1562,73,57,16,1,97.62762022,Arch
2c7fc49f3a02d886e9aa55ab5e2797bdbc825c71,1,10,2,8,12,0,0,0,14,36,1,1,0,1032,3,301,19,234,232,2,5398,5378,20,51,49,2,0,100,NoArch
c350f78632782cccf67af446e032f8b600f2b9ae,2,8,7,1,15,0,0,0,2,2,1,2,0.566509507,278,1,37,3,26,25,1,1069,1062,7,21,21,0,1,99.97972219,NoArch
9f07162b5e86e7c6bf596c1f2c4beba215067137,1,2,3,1,5,0,0,0,3,0,1,1,0,139,1,38,4,16,16,0,447,447,0,12,12,0,1,100,NoArch
8761a355ca9a1b25d318c940a3df1d5ddd7bc6a0,3,10,5,5,15,0,0,0,4,2,2,2,1.370950594,382,1,39,5,45,43,2,1508,1473,35,22,22,0,1,100,NoArch
aec9d012b1e0aac2b929c2179de271b9d1dcdec9,1,3,1,2,4,0,0,0,5,0,1,1,0,137,1,40,6,17,16,1,453,447,6,12,12,0,1,100,NoArch
bac1de3efe55525e230aa5a4b854e0eb4492cf0b,2,56,5,51,61,1,0,1,6,2,1,2,0.643639413,788,2,86,7,199,196,3,4846,4729,117,48,45,3,1,97.34500148,Arch
ec88f36e05a89c8298ed1db00be9001b3ddb175c,1,10,4,6,14,0,0,0,2,632,1,1,0,288,1,302,20,50,47,3,1575,1535,40,42,42,0,0,100,NoArch
e0e09f29a0864f463b9a832d2b2de2a0a61bce38,9,248,8,240,256,1,0,1,7,100,2,4,2.758680147,1549,2,41,7,218,196,22,9404,7995,1409,118,105,13,0,99.91806044,NoArch
15c14870901b12cc8f7572c256ab2ca7798e04bd,7,43,7,36,50,0,0,0,11,353,2,7,2.505362308,2394,1,303,20,470,461,9,14814,14615,199,92,89,3,1,100,NoArch
1f1767d12189177c133fc5c90d601343f4a4e9a7,1,1,1,0,2,0,0,0,11,71,1,1,0,631,2,304,21,94,94,0,3386,3386,0,37,37,0,1,100,NoArch
88a4811d22f3c3d2cfe1177bdcd1dad93961e5ec,1,1,1,0,2,0,0,0,11,71,1,1,0,720,2,305,22,110,110,0,3626,3627,1,43,43,0,1,100,NoArch
0cd8bfbb71d5541acfbfd5e938cdfdec8e809703,1,2,2,0,4,0,0,0,12,0,1,1,0,720,2,306,23,110,110,0,3627,3626,1,43,43,0,0,100,NoArch
6806330fd09997d40dcf8d7a2dd3cda627f6a4d5,1,9,0,9,9,0,0,0,8,195,1,1,0,658,2,307,24,135,133,2,4090,4029,61,30,30,0,1,100,NoArch
73ca00839ac4fdc183fdc03189e664f2d4b7a217,2,5,5,0,10,0,0,0,3,321,1,1,0.881290899,249,1,308,23,22,22,0,1158,1147,11,10,10,0,1,100,NoArch
3020eef0d69ce852b2325653212541cc7600d5d8,11,11,11,0,22,0,0,0,4,536,1,6,3.459431619,2098,1,309,23,295,295,0,12412,12412,0,44,44,0,0,100,NoArch
68ffe2aa5d9769e289d1aaa9f60e383c7f80d664,5,91,7,84,98,1,0,1,10,127,2,4,1.770106794,1865,2,42,8,239,228,11,10410,9903,507,115,110,5,0,99.98074238,NoArch
0d1ede80e31b3a8c4ab4f58fb1964703520ff8b6,2,13,1,12,14,0,0,0,4,330,1,2,0.985228136,460,2,24,1,60,58,2,1961,1918,43,44,42,2,1,100,NoArch
126c04f44bf757e6235f2f1e0951c344e241fafc,4,159,13,146,172,0,0,0,4,297,2,3,1.4970548,1492,3,7,1,139,123,16,9539,8608,931,52,48,4,0,100,NoArch
b9488a3547019c8fdefef4ceab603894ab903e98,4,164,14,150,178,1,0,1,6,49,1,2,1.630706318,293,2,43,9,42,26,16,2398,1533,865,23,14,9,0,99.99037351,NoArch
4523c19ae41eed702ee6c964fc58cb02ff1647f8,2,3,3,0,6,0,0,0,2,644,1,1,0.918295834,54,1,310,23,1,1,0,100,100,0,1,1,0,0,100,NoArch
708001f94b6c31b7cc48379a25910c92159339ec,0,0,0,0,0,0,0,0,0,0,0,0,0,0,0,311,24,0,0,0,0,0,0,0,0,0,0,100,NoArch
c372360f3511816a6bc140fa5e67b94cf29f95d9,8,344,116,228,460,1,0,1,10,33,1,5,2.726834217,2741,1,44,10,372,356,16,19366,17817,1549,157,146,11,0,99.99037536,NoArch
bb1c90360f72ae71faf07889452488976e83f054,14,569,178,391,747,5,0,5,11,42,2,5,3.539252206,1995,2,45,11,223,185,38,11227,9885,1342,157,125,32,0,99.92305103,NoArch
941a3bd4d2e4c99bfd2aa570ce332d3bcbc7aa94,1,2,1,1,3,0,0,0,7,0,1,1,0,179,2,46,12,15,15,0,732,732,0,14,14,0,0,100,NoArch
ca61027ca151ffac4f35281effbd1fb1e12de5f5,11,94,47,47,141,0,0,0,11,91,2,8,2.993972539,4078,2,47,13,487,486,1,25485,25144,341,210,208,2,0,100,NoArch
3e20ac02ef719cba70985aef6ddf3922728cdd29,23,389,128,261,517,1,0,1,12,59,2,9,3.809333223,6307,2,48,14,765,730,35,37872,36463,1409,355,334,21,0,99.97116355,NoArch
e93b77fef3bfb58ce5d8ad197d9ddd596f6408c0,2,73,2,71,75,1,0,1,2,332,1,2,0.300391417,92,1,36,0,10,6,4,881,577,304,9,6,3,0,99.99039016,NoArch
bdb40c339e26d51edafe2437ec5cad54acfd072b,7,82,27,55,109,0,0,0,13,34,2,6,2.530766474,3590,2,49,14,390,387,3,22201,21870,331,217,214,3,0,100,NoArch
1c3c12ab1093b68af4f62e2c1967a4b8371aa718,2,0,3,3,3,0,0,0,14,2,1,2,0.918295834,1970,2,312,10,227,227,0,14105,14120,15,80,80,0,0,100,NoArch
286406b6eb4af618ba740d23cf8366204a7739e8,6,189,62,127,251,0,0,0,14,24,2,4,1.481168577,1732,2,50,13,165,151,14,9455,8468,987,121,108,13,0,100,NoArch
e2d4782f86b25f4e9572ac8e6a9b081f36d7f28e,3,84,5,79,89,0,0,0,8,328,2,2,1.397767404,1026,1,313,11,100,97,3,7285,6821,464,29,28,1,1,100,NoArch
c2179b50771cc701b19912feb9c9f0ff6db7773d,2,20,1,19,21,0,0,0,6,346,1,2,0.998363673,897,2,25,1,132,130,2,4764,4642,122,73,71,2,1,100,NoArch
92e20d77e4c0d7586845b278c9d09bb283501760,7,64,13,51,77,0,0,0,15,2,2,5,2.522421988,2967,2,51,9,414,402,12,16724,16413,311,177,173,4,0,100,NoArch
0cd098a64df6c088e0de56d2a2b88025f8587f40,3,34,8,26,42,0,0,0,7,150,1,1,1.148834854,2397,1,314,6,433,428,5,14000,13850,150,66,66,0,0,100,NoArch
591ee0f6fecc53ff2f787966e1ab839674aff014,2,72,18,54,90,1,0,1,2,338,1,1,0.764204507,68,2,37,1,6,4,2,395,236,159,4,2,2,0,100,NoArch
936aba9ae55955a5905e1ca5a28f3686f747b30d,2,28,0,28,28,1,0,1,2,338,1,2,0.749595257,293,1,38,2,61,58,3,1642,1517,125,19,18,1,1,99.99039201,NoArch
5523f72a5b3a4657c65cb5529b4e34dee28079f7,1,5,2,3,7,0,0,0,2,0,1,1,0,22,1,39,3,2,2,0,112,90,22,1,1,0,0,96.23324882,Arch
e65112769fd27dcabe358d7fdff02d446a96e244,3,31,12,19,43,0,0,0,7,146,2,3,1.035581811,1439,1,315,5,251,246,5,8877,8785,92,50,50,0,0,100,NoArch
6c64d706ad5005b0f74324e097db34e6f50c9ab6,1,3,11,8,14,0,0,0,9,124,1,1,0,717,3,87,0,121,122,1,4884,4943,59,21,21,0,0,100,NoArch
2d654099ed5c5053b5327ad75e3f627152058684,6,145,139,6,284,2,0,2,16,181,1,4,2.554528818,3222,2,88,1,297,300,3,21843,22230,387,131,134,3,1,100,NoArch
aa1c5fac588478346440a1936b63db4dbdc0b8bc,3,41,43,2,84,0,0,0,6,10,2,3,1.074059102,666,2,316,6,87,86,1,3677,3781,104,26,25,1,0,99.94956005,NoArch
6ff018494c1cd14891aabb9364855280ddcef145,1,1,1,0,2,0,0,0,4,0,1,1,0,300,2,317,7,59,59,0,1554,1554,0,18,18,0,0,100,NoArch
e654a11aec549da0f2d9a16b29dab97f28a72a21,1,2,4,2,6,0,0,0,13,21,1,1,0,220,2,52,8,24,24,0,1425,1425,0,4,4,0,0,100,NoArch
636b12a813efe9167bb6f59f96453667878fdbdd,1,6,6,0,12,0,0,0,2,159,1,1,0,157,1,318,7,20,20,0,459,453,6,10,10,0,0,100,NoArch
fc22a293b8b12f3ac6de48bb7920aace8aebf43b,5,143,30,113,173,0,0,0,17,192,1,3,1.747207875,3449,2,319,7,426,410,16,23901,23064,837,159,155,4,1,100,NoArch
6b6a9abcdb6527dd9605d82da852d797674df129,1,5,0,5,5,0,0,0,7,158,1,1,0,301,2,6,0,53,52,1,1864,1841,23,18,18,0,0,100,NoArch
52fc4660de1f91591dfe9c89ea759f7ef5b5f6ec,3,27,3,24,30,0,0,0,11,229,1,3,1.346602752,805,1,89,2,131,128,3,5276,5156,120,30,28,2,1,100,NoArch
1c5d77df25fbe171b9b3bf43fbb91a61375f2834,2,20,10,10,30,0,0,0,20,178,1,2,0.836640742,2765,4,320,8,614,612,2,17040,17006,34,154,152,2,1,100,NoArch
21e45d9a5737c366d9cc0c5fe53b192de50beb95,21,910,15,895,925,13,0,13,11,116,3,7,4.148660379,1823,1,53,8,321,254,67,12965,9546,3419,165,115,50,0,100,NoArch
80b425a22c26483a97f4a90853818a401ae76def,3,82,28,54,110,0,0,0,9,465,2,3,1.296481704,626,1,321,9,115,108,7,3620,3283,337,32,29,3,0,99.77039816,NoArch
97644807afab251d866969a5c6efb49d1459cd43,0,0,0,0,0,0,0,0,0,0,0,0,0,0,0,54,9,0,0,0,0,0,0,0,0,0,0,99.9888043,NoArch
22684e7c057cac4f05aa19ab202b878386a05300,1,2,1,1,3,0,0,0,13,56,1,1,0,720,2,322,10,111,110,1,3638,3627,11,43,43,0,0,100,NoArch
4321ae36f8d32fac224cf31760634589f7c1ec13,2,6,8,2,14,0,0,0,4,0,1,2,0.985228136,310,1,323,11,39,38,1,1409,1470,61,9,8,1,0,100,NoArch
3b92512f34c123ae594f982c093b72e5b818bbc7,1,114,0,114,114,1,0,1,1,0,1,1,0,0,1,90,3,4,0,4,647,0,647,4,0,4,0,100,NoArch
7692016d9ccf62846af1261b0d388c40e06554bc,6,326,35,291,361,1,0,1,8,328,3,6,1.950435328,847,1,324,12,170,137,33,5786,4132,1654,59,47,12,0,99.9776086,NoArch
ee823bc99017a0ee14d6c44f80ed8b9ae590f2d5,4,145,0,145,145,4,0,4,1,0,1,2,1.952084195,0,1,91,4,8,0,8,403,0,403,5,0,5,0,99.74367547,NoArch
c8acb14da151ce1f628b6a2807d3fcd86282c327,5,182,0,182,182,5,0,5,1,0,1,2,2.275911189,0,1,92,5,8,0,8,455,0,455,5,0,5,0,99.91684222,NoArch
71dedc91913e139ad1bbd574566e8566b1e49ee0,1,2,2,0,4,0,0,0,2,692,1,1,0,104,2,40,4,2,2,0,568,568,0,2,2,0,1,99.93910203,NoArch
b2f42425c4b737cc32c32b852c6540e929872a22,2,4,2,2,6,0,0,0,9,75,2,2,0.918295834,589,1,325,13,94,93,1,4051,4033,18,20,20,0,0,100,NoArch
548b606c1835086f3e66faa77dec917436786d77,3,0,4,4,4,0,0,0,3,460,1,3,1.5,308,2,55,10,7,7,0,1482,1509,27,7,7,0,0,100,NoArch
9e8b61dc9c17f7194b873777d7d0aefd3ad6dc64,4,69,41,28,110,1,0,1,16,13,1,2,1.975216896,1170,2,56,11,211,211,0,6922,6925,3,54,52,2,0,100,NoArch
586e6c029809ebae047e4b86f2d26ea8c322a7b7,2,4,1,3,5,0,0,0,14,98,2,2,0.970950594,938,2,326,14,151,150,1,4751,4708,43,55,55,0,0,99.98340708,NoArch
87b22351faf6b35dc87927ccecc1bdeeffe1b701,4,260,0,260,260,4,0,4,1,0,1,2,1.877168822,0,1,93,6,16,0,16,1060,0,1060,15,0,15,0,100,NoArch
ce52a6fb32ab38e1f760cfc1b2e493e007963f96,1,7,6,1,13,0,0,0,2,0,1,1,0,102,1,94,7,4,4,0,516,531,15,4,4,0,0,99.96130245,NoArch
948b23f36ff480fa27f1c4ed90f903671af62a7b,1,0,2,2,2,0,0,0,3,0,1,1,0,103,1,95,8,4,4,0,500,516,16,4,4,0,0,100,NoArch
1ed2b8b5ca410bd272e46c7f767df8474e7c534d,3,44,46,2,90,0,0,0,4,0,1,2,1.071316359,228,1,96,9,14,14,0,984,982,2,13,13,0,0,100,NoArch
6f52a48aa4f7a2eddffa47c2c8c00c7f57634190,0,0,0,0,0,0,0,0,0,0,0,0,0,0,0,57,12,0,0,0,0,0,0,0,0,0,0,100,NoArch
560fb0e825bafcd78d7cecc1a207bab7a4e06b75,1,2,2,0,4,0,0,0,3,2,1,1,0,118,3,41,5,3,3,0,575,575,0,3,3,0,0,100,NoArch
1b5629609771626bb9e8368054e290e9df66b9e9,0,0,0,0,0,0,0,0,0,0,0,0,0,0,0,58,12,0,0,0,0,0,0,0,0,0,0,100,NoArch
5db4397ad1965f9972d9c516fe64b0b499af1b31,0,0,0,0,0,0,0,0,0,0,0,0,0,0,0,97,10,0,0,0,0,0,0,0,0,0,0,100,NoArch
8946b6c722e19ed10831cfd5f331098f12105934,0,0,0,0,0,0,0,0,0,0,0,0,0,0,0,98,11,0,0,0,0,0,0,0,0,0,0,100,NoArch
528b0b148ce6095593c73247843825b97af200aa,1,22,10,12,32,0,0,0,8,80,1,1,0,225,3,327,15,36,32,4,1227,1171,56,17,17,0,0,100,NoArch
f69c0c39d38ee993d5654c7ce0d73a2426690ae6,1,34,4,30,38,0,0,0,2,5,1,1,0,185,1,328,16,18,12,6,1185,1057,128,15,10,5,0,100,NoArch
6a95ccc368f663f9a38e96649ef8a1309a341d48,1,20,5,15,25,0,0,0,3,366,1,1,0,248,1,329,17,42,39,3,1238,1178,60,20,18,2,0,99.98894661,NoArch
782216612d60c2f6ffe29c92f103dbda46453444,1,73,23,50,96,0,0,0,3,0,1,1,0,215,1,330,18,31,18,13,1643,1185,458,18,15,3,0,100,NoArch
affd57f78aeee0ac0b065ced1f549e9a94f9c5ca,1,31,30,1,61,0,0,0,2,696,1,1,0,112,1,331,19,14,13,1,625,617,8,6,6,0,0,100,NoArch
946e4516f3d77bbef47168aff2b67f274bf0cd8d,0,0,0,0,0,0,0,0,0,0,0,0,0,0,0,99,12,0,0,0,0,0,0,0,0,0,0,100,NoArch
e82717c7a7f1fe50e6fd261841c90d430dff1361,0,0,0,0,0,0,0,0,0,0,0,0,0,0,0,100,13,0,0,0,0,0,0,0,0,0,0,100,NoArch
93283e9e612ae5506c9c2a23acac71edc1fbf2e7,1,1,0,1,1,0,0,0,2,699,1,1,0,409,2,7,1,70,70,0,2832,2817,15,10,10,0,0,100,NoArch
bc59f8a0a54bb2b5eaf47c922bd09d9110102afc,0,0,0,0,0,0,0,0,0,0,0,0,0,0,0,8,2,0,0,0,0,0,0,0,0,0,0,100,NoArch
29c8d5d8dfc367b2a70f133789d3260dc4631a03,18,913,132,781,1045,2,0,2,11,188,1,10,2.816964763,4652,1,332,20,827,712,115,28644,24593,4051,248,229,19,0,100,NoArch
e208f007acbb97832308cd65691eed4cfbcbc53c,4,87,50,37,137,0,0,0,10,113,1,3,1.208120246,938,6,26,1,121,114,7,4500,4243,257,86,84,2,1,99.84484956,NoArch
d3ea4c6fc4cbc81884acf622effa9f8a11d76a71,0,0,0,0,0,0,0,0,0,0,0,0,0,0,0,101,14,0,0,0,0,0,0,0,0,0,0,100,NoArch
ab5a4d141dc3e7f20d1bb39ef40c8ddf99fbf312,3,73,56,17,129,0,0,0,5,327,2,2,1.47680908,1052,1,333,21,191,188,3,4483,4252,231,107,104,3,0,100,NoArch
a8405f9db9fef01de04d3b40357f9670800c2ea5,26,1538,1538,0,3076,0,0,0,4,79,5,11,4.595937547,1538,2,334,22,100,100,0,5518,5518,0,71,71,0,0,100,NoArch
aa045fab0035c22bf54e1ef2585df83074d75e4f,0,0,0,0,0,0,0,0,0,0,0,0,0,0,0,27,2,0,0,0,0,0,0,0,0,0,1,100,NoArch
a9f80f9442a6a6e03701bb3b2f20458243998917,4,200,8,192,208,3,0,3,10,0,2,2,1.786218075,242,1,28,3,55,40,15,1988,1276,712,25,17,8,1,99.96668147,NoArch
0dc89332ea8534d79c38748b40d0aa76deb0d5a1,0,0,0,0,0,0,0,0,0,0,0,0,0,0,0,29,4,0,0,0,0,0,0,0,0,0,0,100,NoArch
3d4c14288f9b13ed0e3318b0611588aef96b2d92,6,36,7,29,43,0,0,0,5,577,1,5,2.375093604,798,2,102,15,94,88,6,3842,3671,171,53,52,1,1,100,NoArch
4bb3916e3c2d9bf108a12d72e08c19a986e82dc4,1,83,0,83,83,1,0,1,1,0,1,1,0,0,1,103,16,3,0,3,411,0,411,3,0,3,0,99.93900072,NoArch
6030e5a7e576b9ac28e07141c9e30077e1c07091,6,178,89,89,267,0,0,0,9,158,1,5,1.148179973,3298,1,335,23,450,428,22,14265,13642,623,130,123,7,0,100,NoArch
19df038cb0e49c1ad73f138a69c18c3084cc5664,1,8,0,8,8,0,0,0,2,3,1,1,0,99,1,30,5,9,8,1,493,454,39,5,5,0,1,100,NoArch
7b90486f309b9159d71d89b5182f9130db551059,21,437,60,377,497,2,0,2,17,86,2,13,3.450007596,5390,2,59,9,751,709,42,34192,32003,2189,316,276,40,0,99.88366295,NoArch
8053fe55ab6a048ccd6553e0eb1c43c9e988d9c1,4,148,166,18,314,0,0,0,9,12,1,1,0.311755222,3071,1,336,24,536,533,3,17510,17296,214,77,76,1,0,100,NoArch
a3775ab91e128b4321432d0697f0d8b95f9bfcea,2,13,1,12,14,0,0,0,6,228,1,2,0.591672779,1329,1,337,23,274,269,5,7496,7388,108,58,58,0,0,100,NoArch
a82f7b1c0e25e16f28c869eb697ff5d96b1e0e9f,3,80,0,80,80,0,0,0,2,714,2,2,1.494015835,137,2,9,0,10,10,0,327,327,0,7,7,0,0,100,NoArch
e4f39c0b4ede20ea0a9a6699c12a823b1b038d3c,2,10,10,0,20,0,0,0,3,0,1,1,0.970950594,107,2,10,1,0,0,0,95,95,0,0,0,0,0,100,NoArch
49aa1969c1dab0fdd2910231476b754689f9a9ad,5,83,38,45,121,0,0,0,5,466,1,4,1.77093938,1378,3,42,5,109,112,3,9210,9333,123,42,42,0,0,99.97784302,NoArch
34b20b435d67f620c7bf66eb1a02969281e32e66,5,15,11,4,26,0,0,0,6,401,2,4,1.958739237,1898,2,43,6,177,177,0,11075,11117,42,53,53,0,0,100,NoArch
21ab695a01483c47761c773f89ccff2db110c775,7,50,12,38,62,0,0,0,12,245,2,4,1.848967084,3387,1,338,24,581,574,7,20118,19869,249,121,119,2,0,100,NoArch
5ca32fbf9b8f126e155be8f398fec10b338d4334,15,141,63,78,204,1,0,1,18,204,2,6,3.132561829,2876,1,60,8,381,375,6,16258,15912,346,124,120,4,0,99.97231297,NoArch
1f2ce381f635d56dfb9008d26c558c277d235227,6,185,35,150,220,0,0,0,10,252,2,3,1.459425518,4138,1,339,25,623,588,35,21608,20600,1008,155,147,8,0,100,NoArch
8c323819311989086f22ff11ed19af36978c86a1,3,29,32,3,61,0,0,0,13,0,2,3,1.149431892,1370,1,340,25,229,224,5,8209,8271,62,54,54,0,0,100,NoArch
97ed354101388b2fb298064db698aae9508655ee,5,79,65,14,144,0,0,0,16,42,1,5,1.914116595,700,1,61,9,79,75,4,4085,4005,80,42,40,2,0,100,NoArch
ddb4669d1dfffc9651f30081838795c87ec642c1,1,3,1,2,4,0,0,0,3,134,1,1,0,456,2,62,10,84,84,0,3000,2993,7,36,36,0,0,100,NoArch
b593ce2cf4aa9ebaa8917e01819a11314b13caf9,5,43,15,28,58,0,0,0,6,265,2,5,1.742748991,726,1,63,11,140,126,14,3824,3578,246,59,58,1,0,100,NoArch
e867e657e20243147bb75d49484e768194a4bba0,1,80,0,80,80,1,0,1,1,0,1,1,0,0,1,31,5,5,0,5,287,0,287,5,0,5,0,100,NoArch
4532786a75cb019ac856484e05c0cb494171b5b6,10,224,41,183,265,3,0,3,15,83,2,6,2.55829713,2234,2,64,9,199,183,16,15506,14625,881,106,96,10,0,99.95572528,NoArch
00f89421b3aaa46814a1afaa190d3cca76d9efc7,0,0,0,0,0,0,0,0,0,0,0,0,0,0,0,104,5,0,0,0,0,0,0,0,0,0,1,100,NoArch
a54c945896eed394195206f26f936412dcd284c5,0,0,0,0,0,0,0,0,0,0,0,0,0,0,0,105,6,0,0,0,0,0,0,0,0,0,0,100,NoArch
cde230d377299976f4301365a18d1cfae52cd00e,1,30,2,28,32,0,0,0,3,532,1,1,0,111,3,32,6,27,23,4,769,623,146,9,6,3,1,96.21525415,Arch
3310d3f900aed59caeeb36ad0bd348d0351f13ad,3,4,4,0,8,0,0,0,12,60,1,3,1.5,1085,2,65,6,158,158,0,5401,5401,0,67,67,0,0,100,NoArch
b711b2447a8b6dfd874b7fd3dc49b9bd524e2858,0,0,0,0,0,0,0,0,0,0,0,0,0,0,0,66,7,0,0,0,0,0,0,0,0,0,0,100,NoArch
8d59717d84bc55daefbf996ff035454bffa0c5c6,1,15,9,6,24,0,0,0,3,315,1,1,0,70,3,67,7,9,7,2,359,310,49,3,3,0,0,100,NoArch
8aa79b7e2c47072184b4b36a6a415f3be1c945a7,30,962,890,72,1852,1,0,1,9,482,3,17,3.935130687,8666,2,106,2,1261,1246,15,42632,42587,45,529,521,8,0,95.01735577,Arch
a351932b5016f0f96d000540a8a7a9c0511b1327,30,892,964,72,1856,0,1,1,10,0,3,17,3.932199116,8738,2,107,3,1246,1261,15,42587,42632,45,521,529,8,0,95.01735577,Arch
4d1d9a0df8784771f057d4347fc78fe1214ef2a0,1,8,4,4,12,0,0,0,4,421,1,1,0,330,2,108,4,54,52,2,2227,2205,22,11,11,0,1,100,NoArch
ed0e4a3689b2d04591f9fda07082043e90ffd049,1,17,23,6,40,0,0,0,5,0,1,1,0,334,2,109,5,54,54,0,2165,2227,62,11,11,0,1,100,NoArch
cfbf14244933b8c88c832c0e3bf71fc8a7d60046,39,1097,911,186,2008,1,0,1,11,87,4,25,4.119508832,11203,2,110,6,1581,1548,33,56241,55501,740,660,648,12,0,95.05277045,Arch
4a3435bdc037e29828301cb594c3ba1a7922faf3,0,0,0,0,0,0,0,0,0,0,0,0,0,0,0,111,7,0,0,0,0,0,0,0,0,0,0,100,NoArch
b0d3e935dffc0362341bbd5811558559f6874708,1,8,5,3,13,0,0,0,3,456,1,1,0,139,2,112,8,7,7,0,838,816,22,6,6,0,0,100,NoArch
08400505a11611e6cc398079efe68c1a5b624bb4,1,8,15,7,23,0,0,0,4,18,1,1,0,76,3,341,0,7,9,2,310,359,49,3,3,0,0,100,NoArch
0064c8c9a277b2dcafbe58ff53b1ad2d405fe9e7,3,34,31,3,65,0,0,0,9,174,2,3,1.578410607,1036,2,44,0,184,188,4,5848,5921,73,58,58,0,0,100,NoArch
103bb588d0ac99f4a75e3e8d494e7bf49c0caa8c,1,20,2,18,22,0,0,0,5,80,1,1,0,191,2,45,1,24,24,0,877,908,31,5,5,0,0,100,NoArch
18003f7546b6360da93164cbdb3f68a52a806da7,1,2,21,19,23,0,0,0,6,0,1,1,0,209,2,46,2,24,24,0,885,877,8,5,5,0,0,100,NoArch
9c1a2ba977a19158a3137be2cc7ebb3c84220430,1,1,0,1,1,0,0,0,7,0,1,1,0,190,2,47,3,24,24,0,893,885,8,5,5,0,0,100,NoArch
f2d1e92da5c80dff5a505319a48b57bc73b394a1,66,589,571,18,1160,1,1,2,21,430,4,45,2.378229503,21724,2,113,9,3480,3474,6,122892,122832,60,1055,1049,6,0,99.95265899,NoArch
58fa35ce3a984a93211bf31af832c7e1eead57d8,16,196,140,56,336,0,0,0,12,454,2,10,3.345761088,4538,2,114,10,600,585,15,24614,24544,70,300,294,6,0,99.94874828,NoArch
6d67a11607739c98a4f50f873fcad1fdbb8b30b9,1,17,1,16,18,0,0,0,2,774,1,1,0,71,2,115,11,2,1,1,374,277,97,2,1,1,0,100,NoArch
de20fffee97cb32bc96658eb5b5a860a0e52ecb9,2,1,1,0,2,0,0,0,6,33,1,2,1,462,2,116,12,76,76,0,2169,2171,2,40,40,0,1,100,NoArch
c618f5abd69e5769d020f1f815e0edcc28d04f3c,1,12,16,4,28,0,0,0,6,5,1,1,0,185,2,117,13,14,14,0,929,932,3,14,14,0,0,99.988182,NoArch
302f7f694f9ca5b537ef712c999a09a733078254,1,0,1,1,1,0,0,0,7,0,1,1,0,181,2,118,14,14,14,0,920,929,9,14,14,0,0,100,NoArch
d372f44e44b4ec5f142fb9e3477feadfe6fafee4,7,101,14,87,115,0,0,0,9,104,1,6,1.520886926,1649,1,119,15,170,158,12,9172,8931,241,116,109,7,0,100,NoArch
f492f5b0643e6dc73c77edf27850d93c23f17902,0,0,0,0,0,0,0,0,0,0,0,0,0,0,0,120,16,0,0,0,0,0,0,0,0,0,0,100,NoArch
0ec2666616cbe78975e2ea1d1fbab437f7d04072,1,3,1,2,4,0,0,0,4,5,1,1,0,144,2,121,17,10,10,0,675,669,6,10,10,0,0,100,NoArch
6e7d4ef47e7d9c481387da7ffd81c20c49561657,11,26,407,381,433,0,1,1,10,325,3,7,1.977710829,3606,2,122,18,534,593,59,16274,17991,1717,191,217,26,0,99.97241814,NoArch
63a11065303e373549db690476633f855e398675,4,26,96,70,122,0,0,0,6,412,2,4,1.74343338,1875,2,48,4,280,279,1,10930,10995,65,73,73,0,0,100,NoArch
d8c9b4efa90a27b7b3ee71f3b664c032ef067f99,3,38,11,27,49,0,0,0,9,232,2,3,0.648804039,1022,2,49,5,174,174,0,5977,6009,32,55,55,0,0,100,NoArch
b69eaaa1cbaaef0da4e4e15c113bb80e1df1aa76,3,67,38,29,105,0,0,0,3,538,1,1,1.305278025,581,2,50,6,120,120,0,3073,3092,19,28,28,0,0,100,NoArch
6a4a23e6aa92472006f5f4080d2b35d973810853,9,52,10,42,62,0,0,0,11,403,4,5,2.905038702,3460,1,342,1,436,427,9,12174,12016,158,165,160,5,0,100,NoArch
6870547b6ea33dc88420a644947a937bf5d32922,5,44,38,6,82,0,0,0,13,105,3,4,2.095044125,1632,2,51,7,282,284,2,8895,8934,39,78,78,0,0,100,NoArch
308d369236e983c701e56f8581537b17f37ea464,3,149,9,140,158,1,0,1,12,239,1,2,1.448993441,920,1,343,2,89,84,5,5831,5079,752,28,25,3,1,99.98423645,NoArch
59f739db7e203e4dc88d50cb8d35249202b01999,2,2,3,1,5,0,0,0,14,274,2,2,0.970950594,736,1,344,3,132,132,0,3455,3455,0,44,44,0,0,100,NoArch
b962989d35ac712b638cd94a93b92d52ba95a74f,1,1,0,1,1,0,0,0,2,0,1,1,0,57,1,345,4,2,2,0,232,227,5,2,2,0,0,100,NoArch
d73fa1e6a6c26a194c49c10033da62a52d3b9c2a,7,16,16,0,32,0,0,0,7,564,1,4,2.75,1593,2,123,17,287,280,7,10200,10151,49,63,63,0,1,100,NoArch
ea6c178de7ca3a31b5b2e4e8e5fd384d787dff69,2,36,18,18,54,0,0,0,7,261,2,2,0.935711051,1074,3,33,0,140,138,2,5503,5449,54,53,53,0,1,100,NoArch
6ac5d567986573da83001d807711faf510895c85,4,242,0,242,242,4,0,4,1,0,1,3,1.845739537,0,1,124,18,9,0,9,1033,0,1033,7,0,7,0,99.96455437,NoArch
2ea8a2fc7dde85fd1dcb1cc850c26557c6b7256a,0,0,0,0,0,0,0,0,0,0,0,0,0,0,0,68,0,0,0,0,0,0,0,0,0,0,0,100,NoArch
5623e9d5a532e8d1b29d030a6cbe2a86edc6ac44,1,0,2,2,2,0,0,0,2,5,1,1,0,112,2,69,1,4,4,0,658,674,16,2,2,0,0,100,NoArch
618a9e85dc08432d33b76471b2723dfcdf26542c,1,2,1,1,3,0,0,0,4,155,1,1,0,213,3,8,0,28,27,1,1402,1390,12,5,5,0,0,100,NoArch
572f669c67c2b715341e7aec28c1519eef6f0f1e,9,246,34,212,280,2,0,2,10,119,1,5,2.17856558,3868,1,346,5,566,544,22,22767,21798,969,142,132,10,0,99.98032193,NoArch
9ce32c869b3a9287b6af7631684dcab3570c221d,0,0,0,0,0,0,0,0,0,0,0,0,0,0,0,52,8,0,0,0,0,0,0,0,0,0,1,100,NoArch
4efb9dfea2bf8db700e4064018f6dccbf256bb62,18,631,173,458,804,4,0,4,19,122,2,9,3.454257504,5591,2,70,2,713,650,63,35530,33273,2257,345,314,31,0,99.96459899,NoArch
33559bec4dd4f68edff6b5ca6fc5f5d76dc08f52,1,7,2,5,9,0,0,0,12,24,1,1,0,2133,2,347,6,267,266,1,7310,7263,47,75,75,0,0,100,NoArch
0057514af070ec15a03484bbbe9ed031cc0cc45a,4,20,9,11,29,0,0,0,12,595,1,4,1.664761722,1115,1,348,7,187,184,3,7349,7279,70,41,41,0,1,100,NoArch
aad0a39d7402272bd9702b6a66d1c5650ca65dd7,3,32,11,21,43,0,0,0,14,54,1,2,1.528869986,675,1,71,3,132,130,2,4304,4151,153,30,29,1,0,99.98427673,NoArch
c339e1914141a4b0f36f84a1db2363aff4a2ebad,9,396,311,85,707,1,1,2,10,207,3,5,2.522367759,4084,1,349,8,598,581,17,20686,20156,530,190,178,12,0,99.96856334,NoArch
319f4067fd13dbfaeeb4ade1966d324d9107de0b,1,0,1,1,1,0,0,0,10,1,1,1,0,1437,3,34,1,274,274,0,8798,8805,7,47,47,0,0,100,NoArch
dad4d03f7cea32d47e6344ff3490587b0cdd7e59,2,7,1,6,8,0,0,0,8,14,2,2,0.543564443,1092,3,35,2,142,140,2,5534,5503,31,53,53,0,1,100,NoArch
68a16a2d3b95d7e4714ab72167f5ced71c99a097,14,238,156,82,394,0,0,0,20,135,2,7,2.913376989,3715,2,72,4,495,484,11,19879,19479,400,254,239,15,1,99.99214084,NoArch
f9a65a595b30f075b9ff21b4e39b6ed4569c1a9c,1,52,0,52,52,1,0,1,1,0,1,1,0,0,1,73,5,7,0,7,139,0,139,5,0,5,1,99.97248968,NoArch
eea873b2fb9700556bfac8f21499bf524ac8b1c6,1,108,0,108,108,1,0,1,1,0,1,1,0,0,1,74,6,15,0,15,575,0,575,5,0,5,0,99.98427982,NoArch
3dd4bdce57885ff383814dc92c44b83782b4d5a5,2,64,1,63,65,0,0,0,12,231,2,2,0.333522004,714,3,53,5,109,99,10,4157,3824,333,50,40,10,1,100,NoArch
20c9825445cb6d61204fb7d7bca05cac71574b9c,0,0,0,0,0,0,0,0,0,0,0,0,0,0,0,350,8,0,0,0,0,0,0,0,0,0,0,100,NoArch
0b0fd2c7c160a0b122c483707e0dadc352655ec8,1,1,1,0,2,0,0,0,18,0,1,1,0,747,2,75,7,50,50,0,3214,3216,2,48,48,0,0,100,NoArch
d55233653b5442cc976ad7818b3938535d314cc5,3,65,20,45,85,0,0,0,6,421,1,3,1.297695667,1187,2,351,9,187,174,13,6326,5986,340,50,48,2,1,100,NoArch
73a56c9ac196f69d5dd5b0b2c53508284e253f50,1,34,11,23,45,0,0,0,2,813,1,1,0,143,1,352,10,29,26,3,1028,892,136,3,3,0,1,100,NoArch
e58dc2a851e67d0599f99242c4ede149a2cf9b7d,3,5,2,3,7,0,0,0,2,61,1,1,1.556656707,466,1,76,8,25,25,0,2289,2280,9,19,19,0,0,99.96856334,NoArch
d73d726c4275c30f9d1f8e719753996f0fdf5ddd,2,27,21,6,48,0,0,0,11,231,2,2,0.41381685,1546,3,353,11,298,294,4,9303,9280,23,64,64,0,0,100,NoArch
8b67fd6f0c0335a2577bd5cf0b6031fac5ed77de,1,88,0,88,88,1,0,1,1,0,1,1,0,0,1,54,3,7,0,7,403,0,403,4,0,4,1,95.08330121,Arch
37dd5455220d5e678b533dbe53f1b97568eee84e,1,7,11,4,18,0,0,0,6,192,1,1,0,687,3,55,4,137,137,0,3084,3096,12,43,43,0,1,100,NoArch
c2e8ddb5b1f3f83971f0ed4b5c9d72629e11285b,2,24,0,24,24,0,0,0,18,168,2,2,0.918295834,1818,3,56,5,219,216,3,12251,12129,122,80,79,1,1,99.9293619,NoArch
80aaf70d228caac6ce4aa1844042bbb05d14c222,19,636,39,597,675,6,0,6,21,137,2,9,3.527604242,3727,1,77,9,616,552,64,22779,19954,2825,267,231,36,0,96.82657511,Arch
8145f1ad9b0c02c176b8ee411b8b29a3fca102be,2,2,2,0,4,0,0,0,20,0,1,1,1,871,1,78,10,61,61,0,3710,3714,4,59,59,0,0,100,NoArch
a6a97cf6a8fe2f9bd3329f5ccc2ef785a3c5591c,1,8,8,0,16,0,0,0,3,0,1,1,0,124,1,79,11,11,11,0,496,496,0,11,11,0,0,100,NoArch
d9735e0455cec645ffb8fd1ae4278751f128e5ea,8,51,33,18,84,0,0,0,19,172,1,2,2.602483097,2048,6,11,0,265,260,5,10401,10331,70,135,132,3,1,100,NoArch
1c11fe1dcb804699697ba594c2042cb0fe75abe3,1,1,1,0,2,0,0,0,2,819,1,1,0,149,1,354,11,4,4,0,902,902,0,4,4,0,0,100,NoArch
555490929505e9a34ce29413aed22a0696a4425e,3,1,1,0,2,0,0,0,4,139,2,2,0,237,1,355,12,35,34,1,1158,1152,6,9,9,0,0,99.96345029,NoArch
b6cf9c5d1ed8030ea01ca67986da07abb496e027,0,0,0,0,0,0,0,0,0,0,0,0,0,0,0,12,1,0,0,0,0,0,0,0,0,0,1,100,NoArch
2b7e854caf10db4bcc04a435c80da45f821f49d8,8,428,150,278,578,2,0,2,21,80,2,6,2.688397049,1521,2,80,12,196,151,45,8725,6847,1878,134,114,20,1,99.98172849,NoArch
c7c02f2be0af27f7cdf76448e457fab0c23c94c3,9,86,49,37,135,0,0,0,10,0,2,5,2.736669637,1202,1,81,13,176,168,8,6515,6162,353,93,90,3,0,99.98173099,NoArch
c5c9dcf2b4e91651e1d5f800728f29ee1b9a0f50,0,0,0,0,0,0,0,0,0,0,0,0,0,0,0,356,12,0,0,0,0,0,0,0,0,0,1,100,NoArch
9fdcd8096317921c18d56b6862147300982eec05,1,24,13,11,37,0,0,0,3,740,1,1,0,235,1,357,13,44,39,5,1564,1479,85,8,7,1,0,100,NoArch
ab9e714d3288380d3c831121b50292494cbc6864,1,1,1,0,2,0,0,0,11,47,1,1,0,717,2,358,14,113,113,0,3566,3570,4,29,29,0,1,100,NoArch
553172edd7a45177b01ce00ac20224d88b89f0c3,3,7,4,3,11,0,0,0,5,132,2,3,1.095795255,535,2,359,13,83,82,1,2749,2725,24,49,49,0,1,100,NoArch
52493ca73b73e3669f5e65be831b9cf4490347b9,1,3,0,3,3,0,0,0,3,752,1,1,0,566,2,360,14,71,70,1,2522,2501,21,33,33,0,1,100,NoArch
aa6df4b73705627f72805017e4ff1ccafe5f2114,3,134,7,127,141,1,0,1,7,66,2,2,0.90033833,996,1,361,15,203,185,18,5144,4600,544,60,56,4,2,99.99086591,NoArch
8bae4ecd405ede275bd884ceb8d88b1b8c139788,3,96,17,79,113,1,0,1,2,275,2,3,1.110562503,478,1,57,5,97,94,3,2774,2479,295,46,45,1,2,99.99086758,NoArch
71903add7ddf6fdc8c243057a39228e8d32fa7a1,1,3,2,1,5,0,0,0,2,0,1,1,0,56,1,58,6,1,1,0,177,170,7,1,1,0,0,100,NoArch
26eef72f9e1302b98e7bff6c6750f7611b5713f9,1,0,1,1,1,0,0,0,3,0,1,1,0,57,1,59,7,1,1,0,170,177,7,1,1,0,0,100,NoArch
fd26842edd1265f122791a21a6bf51965c98cb66,9,170,61,109,231,1,0,1,11,0,2,4,2.800228777,1054,1,82,14,153,134,19,6141,5541,600,75,66,9,0,99.96348866,NoArch
aa59039de5ec32ac96397b7a4bb1efc98e3e117a,1,2,1,1,3,0,0,0,4,0,1,1,0,56,1,60,8,1,1,0,179,170,9,1,1,0,0,100,NoArch
fc3f1d040e3bfb080e90fe67ef925631b364c688,0,0,0,0,0,0,0,0,0,0,0,0,0,0,0,0,0,0,0,0,0,0,0,0,0,0,0,100,NoArch
0e3eb30a39843d003c11dcdf92c965aca6e7830d,2,27,32,5,59,0,0,0,5,0,1,2,0.474345438,168,1,61,9,11,10,1,672,707,35,5,5,0,0,100,NoArch
616256ab6ac147cda3c4fffbdf6ea6cfed14a4e4,1,2,1,1,3,0,0,0,6,45,1,1,0,186,2,362,16,23,23,0,1119,1115,4,3,3,0,1,100,NoArch
3b064013e9299b1dc23685b60fc3e797bec217b3,9,451,254,197,705,2,1,3,13,264,2,4,2.380881093,3738,1,363,17,400,372,28,15047,13616,1431,135,130,5,0,99.94982439,NoArch
125a9be89bc0f2496cd108872b01bb0720f910b1,8,121,14,107,135,3,0,3,8,16,2,3,2.558740275,999,1,83,15,159,157,2,5151,4884,267,71,68,3,1,99.96808462,NoArch
59b92c377daaa3622fe384eaf9ac3562952d9584,6,272,23,249,295,2,0,2,14,0,1,3,1.683444554,2732,2,364,18,342,320,22,10999,10429,570,106,95,11,0,99.97265767,NoArch
b2d423be30f7242502edc92d527c0d6d575ebabf,3,22,10,12,32,0,0,0,12,6,1,1,1.400074515,667,3,13,2,115,112,3,2978,2886,92,76,74,2,1,100,NoArch
6dd357741cef1f6e57b05cdd73786366bf34339c,1,2,1,1,3,0,0,0,15,49,1,1,0,646,4,14,3,122,121,1,3080,3063,17,41,41,0,1,100,NoArch
94cc117ae95965e4fb6b7bbd463f942a9d5aa7a2,1,78,78,0,156,0,0,0,16,0,1,1,0,647,4,15,4,123,122,1,3092,3080,12,41,41,0,1,100,NoArch
9ca1bcef57311256a93f03eb977be1d56c8d10e3,4,23,6,17,29,0,0,0,6,586,2,2,1.968655135,1223,1,365,19,153,153,0,7539,7427,112,43,42,1,1,100,NoArch
06ebe7d5dda5f94d2bc49d0982fbe712e0e7553c,1,7,3,4,10,0,0,0,11,117,1,1,0,333,3,366,20,61,60,1,2075,2047,28,14,14,0,0,100,NoArch
4afbf601a76bdfee1ec9919a5a8fd12dee7139a4,2,16,1,15,17,0,0,0,3,584,1,2,0.787126586,210,1,367,21,33,29,4,1295,1207,88,10,9,1,1,100,NoArch
a28c4e2713fb1e4bad761492cfeb5031eb56589f,1,1,0,1,1,0,0,0,12,239,1,1,0,496,2,368,22,94,94,0,2714,2714,0,7,7,0,1,100,NoArch
9312f51c09e9dc19119d260a3dc01afa2d94d032,5,53,11,42,64,0,0,0,22,84,2,4,1.714083601,4320,3,369,23,921,910,11,26934,26719,215,247,243,4,1,100,NoArch
0964f2bf80f1862f49a647863af84b4d7ff659af,3,25,8,17,33,0,0,0,5,222,2,2,1.179191089,554,1,370,24,115,112,3,2702,2536,166,30,30,0,1,100,NoArch
9317052aff3279f03df91fa97391b9eb96f336ee,2,59,4,55,63,0,0,0,9,8,1,1,0.901598235,434,2,371,25,86,73,13,1914,1673,241,67,59,8,0,100,NoArch
ce6918a50a5e633ee45109a2cf3207a6e3698484,0,0,0,0,0,0,0,0,0,0,0,0,0,0,0,372,26,0,0,0,0,0,0,0,0,0,0,100,NoArch
d2e9da37a7f3dff84a8fd8c590816aa0d0fd8295,7,256,17,239,273,1,0,1,15,377,2,5,1.092780847,1881,1,373,27,377,346,31,10945,10239,706,95,81,14,1,99.99088838,NoArch
e3980a01690722582efe588e1b06079629b898ad,1,2,4,2,6,0,0,0,5,308,1,1,0,430,1,374,28,53,54,1,2671,2676,5,17,17,0,0,100,NoArch
870489502d59155224c6a8b86326d68bf1f3cd01,1,0,1,1,1,0,0,0,6,0,1,1,0,428,1,375,29,53,53,0,2662,2671,9,17,17,0,0,100,NoArch
4f9fd2710e40c2355303825f7b8d76657f53482f,8,16,19,3,35,0,0,0,22,308,2,5,2.533214928,4325,1,376,30,472,472,0,17574,17632,58,226,226,0,0,100,NoArch
2103852c6f7598c947d734a8051a686c5f553bdb,0,0,0,0,0,0,0,0,0,0,0,0,0,0,0,9,0,0,0,0,0,0,0,0,0,0,0,100,NoArch
38398a81954e319cf46017d94aea6507fd7f11d7,2,162,162,0,324,0,0,0,6,14,1,2,0.898653376,163,2,377,31,11,11,0,672,672,0,5,5,0,0,100,NoArch
decc76d0a9bb26bbcc54f80b0c90a68c63704605,21,800,191,609,991,7,0,7,6,20,2,11,3.97468713,1529,1,84,14,266,188,78,10337,7491,2846,143,88,55,0,94.79911264,Arch
ed46eb7f7e1ea4131c5b1968898bd05546bbbb96,6,65,10,55,75,1,0,1,23,9,2,5,1.923049878,1341,2,85,15,134,130,4,6646,6497,149,91,87,4,1,96.89752896,Arch
c0aa3e6a7ae319a4dd53e363403d7d874b5bd583,11,561,141,420,702,0,0,0,24,87,2,8,2.504076007,3457,2,86,15,521,464,57,22106,19186,2920,261,226,35,1,99.96761059,NoArch
7a6cc507a53b15c434ee773f42244ccbebde868c,1,1,1,0,2,0,0,0,14,125,1,1,0,428,1,378,29,90,90,0,2844,2844,0,34,34,0,1,100,NoArch
d36cdede14ef0588487211ee5b866ec140d37b76,1,2,2,0,4,0,0,0,12,26,1,1,0,1442,3,379,30,278,278,0,8825,8827,2,47,47,0,0,100,NoArch
6c39b0c409b6a270a21f18dd89ca89d95fc33e1c,4,19,23,4,42,0,0,0,9,79,1,2,1.801463832,944,2,380,31,172,172,0,5326,5350,24,77,77,0,0,100,NoArch
26991ec3deef801e452ac6ad0a65dee86d889419,16,315,52,263,367,0,0,0,23,38,2,10,3.570715592,3011,1,87,15,528,477,51,19108,17333,1775,212,186,26,0,99.93527807,NoArch
fc534ccee467c4ce802d2933241d651800b4de23,2,101,46,55,147,0,0,0,13,13,1,1,0.937365215,575,3,381,31,120,106,14,2578,2389,189,91,80,11,0,100,NoArch
0437a1dcdf2d42a3de56cbd1ec2d87dd16ace715,1,0,1,1,1,0,0,0,5,0,1,1,0,138,2,382,32,21,21,0,889,894,5,13,13,0,0,100,NoArch
fb121ab4faf2c8d2475f35106321466a0ba9a382,4,137,2,135,139,1,0,1,7,272,1,2,1.286549988,620,2,125,0,77,63,14,3852,3189,663,51,38,13,1,99.9815234,NoArch
eef753ddc7c1bd48a43aa26bca159f037f57a161,7,186,98,88,284,1,0,1,20,56,1,2,2.013685956,1544,4,16,5,223,220,3,7551,7350,201,138,130,8,1,98.63027006,NoArch
d6f0f7e7ffb99d1c570d62d597e740414c43dd7d,0,0,0,0,0,0,0,0,0,0,0,0,0,0,0,17,6,0,0,0,0,0,0,0,0,0,1,100,NoArch
2e7b16a1323fd3451685526e654be64fa783789f,3,12,0,12,12,0,0,0,7,81,1,1,1.584962501,560,3,18,7,45,45,0,3173,3173,0,27,27,0,1,100,NoArch
de5b1577dc19253ddb1aa3386fd481cb70ad0638,1,1,1,0,2,0,0,0,12,0,1,1,0,409,3,19,8,82,81,1,1388,1381,7,73,73,0,1,100,NoArch
120856b34a01f20c9d703f8df76d819b3cb25239,0,0,0,0,0,0,0,0,0,0,0,0,0,0,0,20,9,0,0,0,0,0,0,0,0,0,1,100,NoArch
26eadcd0374e37d00b0cf84095bc8f9e4e5eb751,1,8,2,6,10,0,0,0,3,774,1,1,0,119,2,36,0,9,8,1,496,463,33,4,4,0,1,100,NoArch
007618bc5f0246c41101e8fd0d1bf5dc0e09286b,1,4,8,4,12,0,0,0,4,0,1,1,0,125,2,37,1,8,9,1,463,496,33,4,4,0,1,100,NoArch
fb38c3f572327d9c2fa043c104b10e846643c046,2,311,35,276,346,0,0,0,7,10,1,2,0.954964886,639,2,88,13,145,95,50,5917,3993,1924,96,63,33,1,100,NoArch
f1e05045c9045bcf4dbd0984cb583c573e5d39e7,2,50,7,43,57,0,0,0,8,0,1,2,0.856405239,915,2,89,13,153,145,8,6192,5917,275,100,96,4,1,100,NoArch
5f89ef78237a65fe0291b7b42cd720157947e0a4,1,0,1,1,1,0,0,0,9,0,1,1,0,480,2,383,32,88,88,0,2668,2673,5,36,36,0,0,100,NoArch
a4db39f96a1f620cb705e7252d6fb56240cb4dec,1,3,18,15,21,0,0,0,2,854,1,1,0,80,1,384,32,7,9,2,194,287,93,7,9,2,0,99.14512518,NoArch
30fd4af9f8ab1a77b81216fa1115f83e4a3b9091,1,16,5,11,21,0,0,0,5,399,1,1,0,423,2,385,32,73,70,3,2171,2111,60,19,18,1,0,100,NoArch
74b01972282f2e4bda83f12292a7f6d56d7c09fe,0,0,0,0,0,0,0,0,0,0,0,0,0,0,0,11,0,0,0,0,0,0,0,0,0,0,0,100,NoArch
e03d74d510e7e4b2c986bccce6f8eb3db1b3be9d,1,5,1,4,6,0,0,0,2,855,1,1,0,60,2,38,2,4,3,1,245,220,25,2,2,0,1,100,NoArch
dd2b395bf99a69fa7299a63f22dfa2b0423a82d4,6,209,6,203,215,1,0,1,16,421,3,3,1.698896017,1774,1,386,33,347,315,32,11182,9780,1402,75,69,6,1,99.9898898,NoArch
ff41a634d15b566241ac4cdc2488e7ce1694d096,2,50,16,34,66,0,0,0,8,207,2,2,0.113274303,1252,2,387,34,127,126,1,7267,7146,121,50,48,2,1,100,NoArch
f1563888cd2d704e1a0eddae42f5f3d8d3cc34a3,0,0,0,0,0,0,0,0,0,0,0,0,0,0,0,90,13,0,0,0,0,0,0,0,0,0,0,100,NoArch
5d7e24030a4321c2cc8bc1eda25afc097d3e82da,0,0,0,0,0,0,0,0,0,0,0,0,0,0,0,91,14,0,0,0,0,0,0,0,0,0,0,100,NoArch
5378d6733dfddc8dadbf9a0b3cd67de1a82e64e6,1,6,2,4,8,0,0,0,9,143,1,1,0,696,2,62,5,171,170,1,5172,5150,22,19,19,0,1,100,NoArch
71053e9f96e78c335d0dbbc5d6edd468d93aae1a,1,1,1,0,2,0,0,0,4,366,1,1,0,191,3,5,0,22,22,0,815,814,1,7,7,0,0,100,NoArch
dea385a903b3e1ad02519c96327c7687b1016d3e,16,297,138,159,435,1,0,1,15,213,1,7,2.949043171,4092,1,388,32,679,651,28,23671,22419,1252,195,196,1,0,99.77793479,NoArch
92a13e03f146240899e4e500701ed4a826ba099d,1,4,2,2,6,0,0,0,3,459,1,1,0,74,1,389,33,6,6,0,315,301,14,2,2,0,0,100,NoArch
8ca7f63237c7c961ed2d130f3aa75e3c487a40f5,2,32,1,31,33,0,0,0,5,472,2,2,0.98337619,280,1,390,34,24,20,4,795,728,67,12,10,2,1,100,NoArch
e76860606ce2d72b7fae7ea01df69a9886eca64e,1,1,1,0,2,0,0,0,6,0,1,1,0,245,1,391,35,20,20,0,710,710,0,8,8,0,0,100,NoArch
71f11a476d9a0bb94b91e3fc825279a77d8ee0b2,1,9,0,9,9,0,0,0,9,36,1,1,0,311,3,39,3,50,48,2,1512,1482,30,24,22,2,1,100,NoArch
cc82d4de3f431a8ea378e18ea0ca7d82b730e786,1,2,2,0,4,0,0,0,2,862,1,1,0,1644,2,6,1,311,311,0,10716,10724,8,56,56,0,0,100,NoArch
4adee186da5c4efa88f1cfd78f72c502264b3938,3,44,124,80,168,0,1,1,7,582,1,1,1.11123166,581,1,392,36,56,71,15,2915,3190,275,19,28,9,0,99.98992037,NoArch
2083fa7c0d4d12d91ea445b267387178692b8c59,2,31,26,5,57,0,0,0,6,381,1,2,0.949452015,838,1,393,35,202,198,4,5123,5069,54,31,31,0,1,100,NoArch
e6baf37d271ce801da7560b7672de77451d789e3,1,14,0,14,14,0,0,0,8,0,1,1,0,425,1,394,35,55,53,2,2775,2670,105,17,17,0,1,100,NoArch
7d5ed9aa1b21ccc787da11e10a7503a32114e004,1,1,1,0,2,0,0,0,4,43,1,1,0,569,3,7,2,71,71,0,2526,2522,4,33,33,0,0,100,NoArch
40c174512617a35f94f21ea6540cc2a2a7895976,1,37,1,36,38,0,0,0,2,866,1,1,0,422,2,8,3,32,31,1,2586,2378,208,23,22,1,0,100,NoArch
8b45a9ef4eb39590de0ec10a69920b566d9576fa,1,1,1,0,2,0,0,0,13,97,1,1,0,806,4,9,4,130,130,0,5567,5567,0,15,15,0,0,100,NoArch
19421f5dfe27d2e68ca77599c8b605a2cb2ad874,14,367,25,342,392,1,0,1,10,217,2,9,2.05077561,3081,1,395,28,516,455,61,17532,15282,2250,194,179,15,0,94.79733287,Arch
2476520483719d49498354730c6f9749637a1803,0,0,0,0,0,0,0,0,0,0,0,0,0,0,0,396,27,0,0,0,0,0,0,0,0,0,0,100,NoArch
9f3212b0da38ec4b8841f66d0df687d2a4e8dc57,1,1,1,0,2,0,0,0,2,877,1,1,0,923,2,10,5,145,145,0,5685,5683,2,44,44,0,0,100,NoArch
40e12fd530597f5f88c1e933c647e473c90294c4,3,58,9,49,67,0,0,0,4,396,1,3,0.882607845,703,1,397,20,131,118,13,4443,4087,356,25,24,1,2,100,NoArch
62e0b02f70eeaf6e8a50dcad12648c8fbe932cec,3,12,4,8,16,0,0,0,16,426,2,3,1.561278124,2901,1,398,20,345,344,1,11093,11012,81,113,113,0,0,100,NoArch
f7ffd3b3c97ac7e3eedd8229fd21b76ef055e0a7,1,0,6,6,6,0,0,0,9,25,1,1,0,339,2,399,21,53,54,1,1947,1979,32,20,20,0,0,100,NoArch
82d09d3d55914d08ca49f5568f89b28d877a3695,4,125,94,31,219,0,0,0,7,148,1,3,1.191443958,2999,2,400,22,510,498,12,15721,15579,142,130,130,0,0,100,NoArch
9c432430dcf34e9788d33f80d6e7f10f76d230b1,5,87,53,34,140,0,0,0,14,120,1,4,1.514738472,3159,1,401,23,576,573,3,19401,19122,279,115,113,2,0,100,NoArch
539ba292c1d839e8f96b20e793a5385fcad8eaf3,1,22,11,11,33,0,0,0,9,249,1,1,0,427,3,402,24,94,90,4,2426,2373,53,18,18,0,0,100,NoArch
e9e259bed5364aef7a16485d5e43778904752e67,2,4,4,0,8,0,0,0,4,6,1,1,0.811278124,223,1,403,25,31,30,1,937,939,2,18,18,0,0,100,NoArch
c0a444602c1171371ac4cb5b6b5ec2f7237596f0,2,130,17,113,147,0,0,0,16,63,1,1,0.516715311,955,2,16,0,188,170,18,6309,5660,649,51,50,1,1,100,NoArch
3ec46593009792f9ba5287bcab864ca6beb78dd1,30,1777,149,1628,1926,8,1,9,24,124,2,10,3.704166659,5071,1,92,5,984,739,245,38951,29071,9880,483,348,135,0,99.78649068,NoArch
128b2aaba51c2f6e651fad02f29319d81d026197,16,202,27,175,229,1,0,1,25,350,3,13,2.999368841,5686,1,404,23,746,717,29,32005,31092,913,274,268,6,0,99.80236388,NoArch
38987d27060df58d156df7a9bb845fb38f5d63fa,1,1,1,0,2,0,0,0,17,30,1,1,0,1068,3,405,24,242,242,0,5608,5603,5,52,52,0,1,100,NoArch
8b50dabd0d1827a6b1bb1530d09c330d466967e8,7,172,6,166,178,2,0,2,25,6,3,4,2.152427241,1568,2,93,6,202,186,16,8555,7860,695,146,136,10,0,99.96518375,NoArch
be7e7fac6cc8b611a69862f78573c414c472049c,3,205,2,203,207,2,0,2,2,0,2,3,1.115399358,77,1,94,7,25,6,19,1357,303,1054,15,2,13,0,99.98066736,NoArch
3733004d45796a80dadc18563a13b44b0a9ebc6b,0,0,0,0,0,0,0,0,0,0,0,0,0,0,0,95,8,0,0,0,0,0,0,0,0,0,0,100,NoArch
fe3f759025de588fcf92586272acc1b8893a989a,0,0,0,0,0,0,0,0,0,0,0,0,0,0,0,406,24,0,0,0,0,0,0,0,0,0,0,100,NoArch
c76dc9535467e3b1a49894c05ce5d2007c7f9ff5,16,610,17,593,627,6,0,6,21,149,2,3,2.798043244,2397,2,407,25,340,301,39,14310,11928,2382,164,152,12,1,99.95363215,NoArch
1f718f0470d124e3ffa86c99c548f7a402e57aae,0,0,0,0,0,0,0,0,0,0,0,0,0,0,0,408,26,0,0,0,0,0,0,0,0,0,0,100,NoArch
4a883380f52345d34f70b6764014b99a603588c1,8,430,77,353,507,0,0,0,3,0,1,2,2.119300755,1296,1,96,8,218,218,0,7391,7391,0,107,107,0,0,100,NoArch
1bc87718ac5f6d7cc415ad8a6edee88f819e0f86,1,1,0,1,1,0,0,0,6,48,1,1,0,165,2,409,26,27,27,0,931,923,8,7,7,0,0,100,NoArch
5efd453b6c72cd967d8ca4d465c94e34a28d991f,3,29,19,10,48,0,0,0,16,6,1,1,0.497150184,829,3,21,0,145,145,0,3594,3562,32,96,96,0,0,100,NoArch
f88d6146848ceff3e6d554513f086b5410cd9a6e,1,5,2,3,7,0,0,0,6,24,1,1,0,164,2,410,22,25,24,1,759,746,13,11,10,1,0,100,NoArch
c93ec5e1977f1d13ff62e55382e1b2329137f3d1,3,54,14,40,68,0,0,0,14,179,2,3,1.506478624,1325,2,411,23,232,219,13,7883,7626,257,89,86,3,0,100,NoArch
067388cb4deb08b127b6e460a4f8268d16f9ea2d,1,3,3,0,6,0,0,0,2,900,1,1,0,60,2,12,0,0,0,0,53,53,0,0,0,0,0,100,NoArch
69a433f80cb5a4bb5517e1f2b796fdd43b26002b,1,1,0,1,1,0,0,0,15,0,1,1,0,513,2,412,24,77,77,0,2752,2741,11,14,14,0,0,100,NoArch
9497bfbdc39f534ced1aece785520bc9af2efd69,1,6,2,4,8,0,0,0,17,16,1,1,0,568,2,413,25,116,115,1,3689,3662,27,38,37,1,0,100,NoArch
10757922eaacd297874a8a6a15bf1b629782434b,3,8,6,2,14,0,0,0,26,251,1,1,1.287054028,968,2,97,6,64,64,0,4128,4094,34,60,60,0,0,100,NoArch
051dd473cdcdd4b808594f6caaac10185e5cb240,1,1,1,0,2,0,0,0,6,0,1,1,0,130,2,98,7,6,6,0,592,592,0,5,5,0,0,100,NoArch
b933e1921ab80c22a4faf8cb412bb46aa523f9b8,3,149,27,122,176,0,0,0,7,613,1,2,1.513050288,509,2,63,0,48,32,16,2149,1485,664,25,20,5,1,100,NoArch
8fa9aca98ad137da9f7cb157fbda309f3fa580dc,1,0,1,1,1,0,0,0,8,0,1,1,0,298,2,414,26,26,26,0,978,983,5,10,10,0,0,100,NoArch
2f97dfd5abb9c32082ebc10cffe1a6196ad664c2,12,35,11,24,46,0,0,0,8,341,2,5,3.370113042,2424,1,415,27,281,276,5,10870,10707,163,144,143,1,0,98.01311654,NoArch
9857d2800847b45fb87455679599e4eefb780c16,1,1,6,5,7,0,0,0,2,903,1,1,0,47,1,416,28,3,3,0,128,160,32,3,3,0,0,100,NoArch
bb3be24c813cf79a106f8e179c2daea980793621,1,1,1,0,2,0,0,0,17,20,1,1,0,2160,2,417,28,275,275,0,7505,7504,1,76,76,0,0,100,NoArch
bc056d9b94a0226695f063571151ab1ce12f89e7,3,75,6,69,81,1,0,1,19,307,2,3,1.466594698,1433,3,418,26,164,158,6,9025,8726,299,110,108,2,1,97.92002646,Arch
cfe01a80c7ed8112f33cc66891f4ade96bdd650c,1,0,1,1,1,0,0,0,3,2,1,1,0,42,2,64,1,3,3,0,117,128,11,3,3,0,0,99.98239824,NoArch
ea4cc5188ee309850e072e2a4473dd02764e29e1,1,1,2,1,3,0,0,0,11,24,1,1,0,742,1,419,24,128,128,0,4186,4180,6,13,13,0,1,100,NoArch
ec5426ef0ddf70cc5c6d03e8711951238e11f072,1,1,1,0,2,0,0,0,12,0,1,1,0,741,1,420,25,128,128,0,4186,4186,0,13,13,0,0,100,NoArch
7940d096be5e40b13018c0995949339d461ee371,2,5,5,0,10,0,0,0,2,906,1,1,0.970950594,112,1,421,26,12,11,1,286,271,15,8,7,1,1,100,NoArch
a1e8949e008cd8c1ba8c19174df25b0726adfaff,1,2,0,2,2,0,0,0,3,487,1,1,0,128,2,422,27,11,11,0,784,767,17,3,3,0,1,100,NoArch
9fe8b346499a98fef2ca75bd459a0b2821ba979b,2,22,1,21,23,0,0,0,3,592,1,2,0.558629373,529,1,423,28,61,59,2,2811,2657,154,12,11,1,1,99.92963012,NoArch
0f538437ecc12e1693d9f8fd0d9b98dbf21023ee,1,17,13,4,30,0,0,0,2,906,1,1,0,64,2,13,1,0,0,0,79,79,0,0,0,0,0,100,NoArch
9edcf52f84a2620101f4400f6a4b70d000f9c352,1,1,1,0,2,0,0,0,3,386,1,1,0,180,1,424,29,4,4,0,1101,1101,0,4,4,0,0,100,NoArch
49e075ea40d0f2810d13c9eb9032758aa4109bec,1,2,1,1,3,0,0,0,4,0,1,1,0,180,1,425,30,4,4,0,1103,1101,2,4,4,0,0,100,NoArch
bad19958a727b7fa53f193686ab6a9449f0c9901,6,94,17,77,111,0,0,0,8,612,1,4,2.012077728,2428,2,9,0,317,306,11,12637,12302,335,105,99,6,0,99.95603043,NoArch
6cdb104beb5ecff0585e61abf049549ec2a9e841,1,1,1,0,2,0,0,0,2,909,1,1,0,243,2,10,1,15,15,0,1382,1382,0,7,7,0,0,100,NoArch
f6ad925b5574a2646c9420d59818c13627bd76d6,2,27,17,10,44,0,0,0,6,22,1,2,0.510787823,1334,2,426,31,112,112,0,7428,7358,70,64,64,0,0,100,NoArch
458d966a2c51567ae079af0960bd764cb4394860,3,27,14,13,41,0,0,0,8,534,2,3,1.486573115,885,1,427,32,164,161,3,3828,3726,102,64,61,3,0,100,NoArch
23c607b8029d7f0a3699d993d30a85601dbeb1a9,7,326,103,223,429,1,0,1,11,520,1,4,1.683864888,1322,1,428,33,237,207,30,8600,7288,1312,98,90,8,0,99.63261331,NoArch
9c4a7b185c94eb4f8d2ad930e85cc7538e2f9563,1,1,1,0,2,0,0,0,12,90,1,1,0,717,2,126,0,113,113,0,3568,3566,2,29,29,0,1,100,NoArch
2e6f81c6d6024e6fd8c378df38b73e238aa630df,1,41,6,35,47,0,0,0,13,0,1,1,0,717,2,127,1,113,113,0,3568,3568,0,29,29,0,1,100,NoArch
41051107e76628b0be05537aeb7106ad2ef93058,16,941,263,678,1204,4,0,4,27,73,2,6,3.525353939,5958,1,99,7,789,717,72,29364,25813,3551,384,340,44,0,94.97418915,Arch
88a7db7aa7f0c342b34cdcd20f65adde9662e528,0,0,0,0,0,0,0,0,0,0,0,0,0,0,0,1,0,0,0,0,0,0,0,0,0,0,0,100,NoArch
3ab1b11fc01ce672105cc18fe9be099e37a0f8af,9,242,79,163,321,1,0,1,7,104,2,4,2.088598295,2012,1,100,8,315,292,23,10921,10029,892,162,152,10,0,99.90334014,NoArch
77cfd16f2c6f8a710ab70157d3ad05f0d581aadb,3,88,21,67,109,0,0,0,13,326,1,2,0.864232976,815,6,22,1,92,89,3,4560,4283,277,36,34,2,1,99.98925771,NoArch
135a41dab404c571e8a51051fa0f47abbfb3cee3,3,37,7,30,44,0,0,0,4,742,2,3,1.570573045,1987,3,11,2,192,186,6,11520,11341,179,98,95,3,0,100,NoArch
8d3beea1abca63be77b606c78336277cfbb25e7a,10,234,231,3,465,0,0,0,16,6,2,6,2.346574894,3561,1,101,9,505,486,19,19309,19035,274,265,263,2,0,99.96777485,NoArch
7bbf6cc13fc4ed6674fb5b82970b8a0380988ccf,0,0,0,0,0,0,0,0,0,0,0,0,0,0,0,429,32,0,0,0,0,0,0,0,0,0,0,100,NoArch
78a53ad7ffdef8cd2af66eed3c46a3773af76b5e,1,1,1,0,2,0,0,0,12,0,1,1,0,415,2,102,10,44,44,0,2500,2497,3,38,38,0,0,100,NoArch
6105973060fe8d247748ea3bd5fd1a8d219c3e3d,4,304,92,212,396,0,0,0,12,23,3,4,1.25164874,1739,1,430,33,344,321,23,10821,9248,1573,110,104,6,0,94.64064269,Arch
03af68b8d31591b8a45adea5444b66116a1a449c,3,9,7,2,16,0,0,0,19,107,1,2,1.419736718,2988,3,431,34,394,393,1,11786,11769,17,121,121,0,1,100,NoArch
b020db60814148b50e222fcf3334a6be4a6cb394,7,143,82,61,225,0,0,0,15,105,1,4,2.217307235,3924,1,432,34,679,663,16,23044,22771,273,160,157,3,0,92.98725972,Arch
c9de8b2061f0f15fbf3fbaab86c4597bf9ef4493,1,1,0,1,1,0,0,0,14,0,1,1,0,777,1,433,35,138,138,0,4401,4397,4,13,13,0,0,100,NoArch
93af731852de04fd34567a18daf49d0198540b48,4,126,0,126,126,2,0,2,9,74,1,3,1.498580635,623,1,128,2,84,76,8,4502,3982,520,34,30,4,1,99.95959596,NoArch
082a1f9b333c6c3816c438c4630b834d3ff5c5ae,1,3,0,3,3,0,0,0,3,397,1,1,0,124,1,434,36,10,8,2,719,700,19,1,1,0,0,100,NoArch
94a63f8dcb38dc5ff0a90dc8b3a37912a3e69db4,1,3,3,0,6,0,0,0,2,923,1,1,0,151,2,17,1,23,23,0,703,703,0,11,11,0,1,100,NoArch
2e6a5e85870c99ae45904da37f0928ff3ce81ef5,18,162,69,93,231,0,0,0,28,84,2,9,3.745545137,7031,1,103,11,844,832,12,41901,41150,751,447,443,4,0,100,NoArch
4f65d1dc7c15eabd1c73ebeeb7b6f1b4fb6cedcf,2,12,10,2,22,0,0,0,18,0,1,2,0.945660305,1277,2,104,12,66,66,0,9927,9922,5,44,44,0,0,100,NoArch
35e2f856d96b97587091fc8f06f8a6713a37bcfc,1,23,1,22,24,0,0,0,6,2,1,1,0,591,1,435,31,92,89,3,4346,4177,169,19,19,0,0,95.93070105,Arch
6237582a0ebe3ae0571bcc4e7aa79f67258e06cc,0,0,0,0,0,0,0,0,0,0,0,0,0,0,0,129,3,0,0,0,0,0,0,0,0,0,1,100,NoArch
2b8430e423bd6cca5fcf74803269801bb79d5f90,5,70,10,60,80,0,0,0,8,603,2,3,2.047218456,1225,2,12,3,153,143,10,5214,4782,432,71,70,1,0,100,NoArch
ce32c5f26b593b50dc8710a9a68d4a658ed32e15,3,44,12,32,56,0,0,0,7,1,1,2,1.151932211,332,1,130,4,44,42,2,1609,1440,169,13,12,1,1,99.9642538,NoArch
b519e24bc192d48fd9f1999fee9dfb4b8adea538,2,10,5,5,15,0,0,0,3,463,1,1,0.918295834,293,2,13,4,39,39,0,1267,1228,39,26,26,0,0,100,NoArch
e0e35d45b44a89e032209c0637fa6a00a7057efd,2,19,22,3,41,0,0,0,20,6,1,2,0.461216041,2836,2,436,32,338,337,1,10925,10936,11,109,107,2,0,100,NoArch
98e2484e50f46bbd4dd75b41360a0883cda5986f,9,165,117,48,282,0,0,0,29,51,2,7,2.4608239,4059,2,105,12,576,560,16,23623,23330,293,296,284,12,0,100,NoArch
d4f5dee045296201c5f0c4a413a38902935daf7b,1,0,1,1,1,0,0,0,4,0,1,1,0,92,2,14,5,11,11,0,402,404,2,3,3,0,0,100,NoArch
ab0d80ccb04d32a75d7e66c394156a223cb962cf,1,3,0,3,3,0,0,0,5,0,1,1,0,91,2,15,6,11,11,0,416,402,14,3,3,0,0,100,NoArch
6c457e2536c352717905f428a95588b6c0e0dc8a,4,220,104,116,324,0,0,0,15,175,1,4,0.2510355,1848,1,437,33,305,281,24,10756,9838,918,75,70,5,0,99.98659278,NoArch
126adc209dad152f8103eab9c27a84c78e866dab,1,2,1,1,3,0,0,0,8,0,1,1,0,722,1,438,34,114,114,0,5262,5253,9,22,22,0,0,100,NoArch
6e59609750ec4cfafa6304de3683794b135e4fb8,0,0,0,0,0,0,0,0,0,0,0,0,0,0,0,106,13,0,0,0,0,0,0,0,0,0,0,100,NoArch
a3f831b06c7dc6da6571cfbf6ba3e69e2fe88167,4,284,25,259,309,3,0,3,6,0,1,2,1.753464238,94,2,16,7,40,11,29,1365,416,949,29,3,26,0,99.96872068,NoArch
b8fe6cab89e78426141fd69d5bf38f0aa232dd82,4,321,219,102,540,0,0,0,16,2,1,3,1.770760729,3476,1,439,35,652,631,21,22504,21844,660,122,116,6,0,100,NoArch
c10b503ffd1e88465e55f606bbef526d9926dfa5,0,0,0,0,0,0,0,0,0,0,0,0,0,0,0,440,36,0,0,0,0,0,0,0,0,0,1,100,NoArch
211b6a24c71704ddcf049a8f6b72cb634ffd577e,1,2,1,1,3,0,0,0,2,927,1,1,0,255,1,441,37,52,52,0,1699,1690,9,11,11,0,1,100,NoArch
9b69e7d19024a7e88e6b34533f27572f385fae2f,9,100,13,87,113,1,0,1,30,95,2,4,2.785630462,2201,2,107,10,227,219,8,10074,9665,409,177,173,4,1,99.8927566,NoArch
a40d1c8bdda25e0c62290e8a45097b505a3d61ab,1,1,1,0,2,0,0,0,2,929,1,1,0,191,1,442,33,9,9,0,1033,1030,3,7,7,0,0,100,NoArch
6517c9b5c8638bb384efa1bb7ca0e24fb4db937d,5,110,15,95,125,0,0,0,22,44,1,1,1.356297933,1406,3,443,34,230,205,25,7044,6589,455,129,122,7,1,95.21392636,Arch
543ed9cdf84afe0b5aa5561be4b2314fe3f98251,3,9,11,2,20,0,0,0,23,0,1,1,0.921928095,857,2,444,34,108,109,1,4447,4453,6,37,37,0,0,100,NoArch
ab343e06e977c3b9e379dfd133c2248b1216faf7,2,3,2,1,5,0,0,0,13,32,1,2,0.970950594,585,1,445,35,92,92,0,3373,3369,4,14,14,0,0,100,NoArch
84e769a0dd26b37c70be6c30fad092acfa51732e,1,0,4,4,4,0,0,0,13,137,1,1,0,713,3,446,36,121,122,1,4868,4891,23,21,21,0,0,100,NoArch
90ac2ecdaf537761fba1a0d1b9c90abc24f30bc9,4,13,8,5,21,0,0,0,14,12,1,2,1.91735702,1688,1,447,37,272,271,1,11339,11274,65,73,73,0,0,100,NoArch
62d8c8ae8c97a59c04b5ef424280c1941c614457,0,0,0,0,0,0,0,0,0,0,0,0,0,0,0,131,5,0,0,0,0,0,0,0,0,0,1,100,NoArch
b73f060eb8e3249ef4e4178ccf71dd9ea830645f,0,0,0,0,0,0,0,0,0,0,0,0,0,0,0,132,6,0,0,0,0,0,0,0,0,0,1,100,NoArch
153cecfe0810db352d497259436fa819dd11bd92,0,0,0,0,0,0,0,0,0,0,0,0,0,0,0,133,7,0,0,0,0,0,0,0,0,0,1,100,NoArch
9d43e5592b578ff5f0dcebd8e87326210e38136a,0,0,0,0,0,0,0,0,0,0,0,0,0,0,0,134,8,0,0,0,0,0,0,0,0,0,1,100,NoArch
a2617ab7a4852b451abb0c8bb56961b6e7df8fee,7,64,67,3,131,0,0,0,18,454,2,7,2.231715355,2693,3,135,9,497,499,2,15305,15425,120,134,135,1,0,99.96895925,NoArch
ae8d40dd85350e93bdcc52491819a7e1c8b3e879,1,3,0,3,3,0,0,0,2,940,1,1,0,94,2,136,10,16,15,1,391,379,12,11,11,0,1,100,NoArch
172ef551ef356af4c62a9958cd5f0eb01cc5e4f2,2,114,25,89,139,0,0,0,15,4,1,2,0.448128219,967,1,448,38,186,168,18,6322,5732,590,44,41,3,0,99.98226715,NoArch
6729284dfb311ce1bf2655e1bb87b5bd7c00db99,3,14,11,3,25,0,0,0,16,21,1,3,1.541315277,1120,1,449,39,187,187,0,6554,6538,16,45,45,0,0,100,NoArch
854b4a9ec76b4795ad3548b0a0c54757f7765918,2,8,4,4,12,0,0,0,10,93,2,2,0.979868757,599,2,137,11,101,99,2,3448,3424,24,70,70,0,1,100,NoArch
6531a498c2528f316b7e178a0b4c4a0daf8abd1d,17,245,48,197,293,2,0,2,31,79,2,9,3.520615593,4422,1,108,11,637,613,24,24688,23782,906,286,273,13,2,99.96454844,NoArch
7dacb2b6da2b25d10b02486f8cb4ec79949e7613,1,1,0,1,1,0,0,0,5,15,1,1,0,403,1,450,38,47,47,0,1021,1014,7,34,34,0,0,100,NoArch
c44bdbb447c4e3a6255cfd8f5c2fe8e5823ae830,1,9,13,4,22,0,0,0,2,942,1,1,0,129,1,451,37,18,20,2,604,602,2,4,4,0,0,100,NoArch
09f003666d3b9b492d48b3c9b8baae85e749fdcb,1,0,1,1,1,0,0,0,3,0,1,1,0,125,1,452,38,18,18,0,597,604,7,4,4,0,0,100,NoArch
62027eb8427bd1b72f78550a4b79d5423177013a,1,1,2,1,3,0,0,0,2,942,1,1,0,146,1,453,39,24,24,0,936,946,10,7,7,0,0,100,NoArch
8642ca9d6c68fd931b23553fc7caa6cb0e993cfc,3,192,172,20,364,0,0,0,5,197,1,2,1.12987224,455,1,454,40,34,30,4,2932,2790,142,13,9,4,0,100,NoArch
e0771639e2633bf4f66ae4c98b269feaee680661,9,205,29,176,234,2,0,2,32,90,2,5,2.855080808,2549,2,109,10,371,342,29,13751,13064,687,204,188,16,1,99.97342075,NoArch
755eff51b9741b674486851ac38cb3663b489965,1,15,1,14,16,0,0,0,21,17,1,1,0,2157,3,18,1,279,277,2,7641,7551,90,77,77,0,1,100,NoArch
2d3b79984c93d379ca1e8b9eeda72a1f0024d1c2,3,122,66,56,188,0,0,0,33,47,2,2,0.743379437,1487,2,110,11,164,156,8,7419,7117,302,118,113,5,0,100,NoArch
6c3d45e6065cae40d9d23203370b1a79dadd7794,2,27,24,3,51,0,0,0,2,944,1,2,0.787126586,787,1,455,37,44,46,2,4688,4600,88,25,25,0,0,100,NoArch
73b4d15917efcee75333050997112fe513c2b8f2,1,0,7,7,7,0,0,0,3,0,1,1,0,118,1,456,38,8,8,0,610,677,67,3,3,0,0,100,NoArch
b57a6046f1f6d7d1a72b75ef7a84bbdd9b09c40c,5,173,48,125,221,0,0,0,17,13,1,5,1.737039353,2665,3,457,38,493,466,27,15676,14688,988,131,126,5,0,100,NoArch
b3616b5ba4d6d954d833377c4977d474c5df8aea,1,41,23,18,64,0,0,0,16,5,1,1,0,391,1,458,39,65,60,5,2331,2167,164,5,5,0,0,100,NoArch
5a98077c7915b3a586f6f211fb020ab52e1f5d1c,1,10,5,5,15,0,0,0,3,4,1,1,0,234,2,459,40,12,11,1,1238,1205,33,10,9,1,0,100,NoArch
0ad6bfbfc5345d3241fbb8b717beb57ff1bf318e,1,1,1,0,2,0,0,0,18,2,1,1,0,1510,3,460,39,293,293,0,9330,9330,0,48,48,0,1,100,NoArch
1e6a243e50bd30d816f4c0affde4007331bea1a6,24,466,75,391,541,3,0,3,34,175,3,12,3.664436855,5541,1,111,12,865,811,54,32976,31021,1955,376,350,26,0,95.50031619,Arch
09968fc63abe8487bb79f6bfb74e69afc94a22c7,0,0,0,0,0,0,0,0,0,0,0,0,0,0,0,17,8,0,0,0,0,0,0,0,0,0,0,100,NoArch
c71a4053ad5e82eb0c7183f02ac6bd861353cc54,3,10,23,13,33,0,0,0,14,0,2,3,1.462093384,557,2,112,13,93,92,1,3118,3133,15,22,23,1,0,100,NoArch
d836025c40961a9bfacb8da3aaed83a5122b4608,1,8,10,2,18,0,0,0,14,36,1,1,0,752,2,138,12,113,113,0,3568,3568,0,29,29,0,1,100,NoArch
23297e83eba3b9c65a10d8f023996db7aab3f05f,14,506,38,468,544,7,0,7,19,261,3,7,3.311702727,2621,4,139,13,517,487,30,14779,13257,1522,151,133,18,0,99.77365812,NoArch
0c1b0d752bb350462f024baaa7d3e930fabe5154,2,22,5,17,27,0,0,0,15,87,2,2,0.380946586,1404,2,140,14,230,228,2,6771,6687,84,60,60,0,0,100,NoArch
c1e892e1b710c919c1099c4941d201ae27a98ddf,1,4,3,1,7,0,0,0,13,116,1,1,0,497,2,461,35,95,94,1,2722,2714,8,7,7,0,0,100,NoArch
17541e15667015e36429133a87c2a8128d6c15a5,8,35,10,25,45,0,0,0,8,41,2,3,2.885181431,1552,1,113,14,187,184,3,8932,8773,159,88,87,1,0,99.91390907,NoArch
b86dc146bf627cc793936b1a29bdd0017f19ee87,4,15,1,14,16,0,0,0,2,948,1,1,1.977217001,132,2,14,0,0,0,0,288,288,0,0,0,0,0,100,NoArch
eaec3ec80fee4ad8a2308882537ecc0406b25ea0,4,9,4,5,13,0,0,0,3,0,1,1,1.987773371,146,2,15,1,0,0,0,288,288,0,0,0,0,0,100,NoArch
f2c67adad5949127ccc7740a250829cc7e90214e,0,0,0,0,0,0,0,0,0,0,0,0,0,0,0,40,0,0,0,0,0,0,0,0,0,0,1,100,NoArch
454723b2373c3ce8757ad04224e185be33b1c3f2,1,1,0,1,1,0,0,0,6,178,1,1,0,147,2,141,15,10,10,0,680,674,6,10,10,0,0,100,NoArch
0a78f5ff666892074fef4b32bf6369bd57c9b025,16,612,360,252,972,1,0,1,18,304,3,6,1.972604749,3435,1,462,33,555,502,53,21037,19572,1465,166,161,5,0,99.93544917,NoArch
6167e0259be5cf72401779b19c879904ed58cb64,12,157,91,66,248,0,0,0,16,536,1,3,2.715244715,3568,2,142,14,549,542,7,16542,16286,256,225,221,4,1,99.9838675,NoArch
df741a1ba7281a125d33ac5352c823b5c08b61c6,1,15,33,18,48,0,0,0,3,3,1,1,0,213,2,463,34,29,30,1,1086,1180,94,4,4,0,0,100,NoArch
a597f42c6185e034f16973ea42fc01513d1fe68c,4,14,3,11,17,0,0,0,7,431,2,4,1.851226816,1677,1,464,35,230,226,4,10196,10143,53,117,116,1,0,100,NoArch
a7a16569bf23935e1bdac2623b485af46819cb7d,1,0,5,5,5,0,0,0,4,0,1,1,0,195,2,465,36,28,29,1,1056,1086,30,4,4,0,0,100,NoArch
23db1420c05001eb99e2566bfdcd3e718072caff,2,108,5,103,113,1,0,1,4,186,1,1,0.400930682,421,2,41,1,53,46,7,3092,2495,597,12,10,2,1,99.97850502,NoArch
02ce65a8a522b99d5444ee425d3b89e5d9b79adb,3,76,22,54,98,0,0,0,3,560,1,2,0.388508824,624,2,42,2,127,114,13,3934,3620,314,25,23,2,1,100,NoArch
f05bc4b82121ab006275772dccf8f50e63ad4c5a,1,54,50,4,104,0,0,0,2,0,1,1,0,104,1,43,3,7,7,0,598,598,0,2,2,0,1,100,NoArch
cdf4bc144df02890926a60e294c0ac6de986a8ab,4,0,329,329,329,0,4,4,2,956,1,2,1.908498792,329,2,44,4,0,18,18,0,1448,1448,0,11,11,1,99.94624812,NoArch
9ef62480937a26c553ff3c723b5f87a2ed6001ab,1,7,6,1,13,0,0,0,4,1,1,1,0,392,2,466,37,73,73,0,2199,2185,14,11,11,0,0,100,NoArch
5b6acbbd6069d17614a18494808c51a4ed02d051,21,348,552,204,900,2,4,6,22,499,3,5,3.66853287,5588,1,467,38,640,647,7,26423,27230,807,217,224,7,0,99.94620185,NoArch
55cc72b8c1cd7be219ea3414b128b35ac4bcc2ae,1,1,1,0,2,0,0,0,9,0,1,1,0,518,2,468,39,106,106,0,2525,2523,2,46,46,0,0,100,NoArch
ca878f0e77bdd83cae6bad6220ac3f8784981686,0,0,0,0,0,0,0,0,0,0,0,0,0,0,0,469,40,0,0,0,0,0,0,0,0,0,0,100,NoArch
3ea9f5ac6b4de00a5c9f00f854db23efb904d22d,1,1,1,0,2,0,0,0,14,9,1,1,0,498,2,470,41,95,95,0,2722,2722,0,7,7,0,1,100,NoArch
481cfc1b3242ad426bc0b131e7d75a860f65912b,7,37,21,16,58,0,0,0,10,79,1,1,1.995237891,1324,1,471,42,206,200,6,6801,6651,150,77,74,3,0,100,NoArch
2a2e43304007b678b2351c75030b9f8c270ab624,1,0,2,2,2,0,0,0,2,960,1,1,0,51,1,472,43,0,0,0,137,146,9,0,0,0,0,100,NoArch
f5532d48cf9d8198305ede750f142996efe5c8f5,2,55,7,48,62,0,0,0,4,289,1,2,0.637387499,242,2,16,2,45,45,0,840,840,0,25,25,0,0,100,NoArch
302e48db749d78aaca1923b4784addc43e82aa66,13,203,55,148,258,0,0,0,19,154,2,5,2.211203898,3807,1,473,44,660,640,20,23300,22318,982,149,142,7,0,99.97847495,NoArch
6c23d7824ddb01bbba1f2ff6acd261ed88f75444,1,29,29,0,58,0,0,0,5,0,1,1,0,158,2,474,45,20,20,0,476,476,0,17,17,0,0,100,NoArch
2f2980506c3fb458896cb7c0fe413ae15649a89c,1,12,8,4,20,0,0,0,5,1,1,1,0,393,2,45,5,74,73,1,2228,2199,29,11,11,0,1,100,NoArch
caaa1862e12f331ed9222fa740eb09dbc0b6601a,2,22,3,19,25,0,0,0,4,2,1,1,0.970950594,286,2,46,6,58,54,4,1846,1749,97,15,14,1,1,98.72296601,NoArch
f0be6796a3e4ff007bb7c1716110e93a4072667a,6,459,0,459,459,6,0,6,1,0,1,2,2.480658564,0,1,47,7,24,0,24,2010,0,2010,15,0,15,1,99.93091878,NoArch
29f89a4698e57fb62a6a5bf90d18d94544b7b674,11,358,228,130,586,1,0,1,9,36,2,4,2.939853928,2691,2,114,12,336,323,13,14373,14064,309,199,181,18,0,95.72761194,Arch
ded332f7d333ccd0a6ddc8efe594c5022711d04e,4,42,27,15,69,0,0,0,23,102,1,2,1.385367798,2726,2,475,44,343,339,4,10121,10076,45,96,93,3,1,100,NoArch
9baa155055709444636adac0c665c39575610eb5,3,17,5,12,22,0,0,0,5,446,1,2,1.090652803,468,2,115,12,71,70,1,2398,2336,62,34,34,0,1,100,NoArch
a376a2e11329d179f49a1312044d478e4539fba0,0,0,0,0,0,0,0,0,0,0,0,0,0,0,0,476,44,0,0,0,0,0,0,0,0,0,0,100,NoArch
e6d5d809c96b1a1c8885fdd4c0e40edcc9e3e1ae,0,0,0,0,0,0,0,0,0,0,0,0,0,0,0,477,45,0,0,0,0,0,0,0,0,0,0,100,NoArch
ae6eaeefcb6f9011551d4905a72db8638d74b148,19,961,684,277,1645,2,0,2,19,113,2,9,2.408137921,5208,1,478,46,807,779,28,31520,29701,1819,248,240,8,0,96.53127247,Arch
9a28d71ccb43c9ed131679f81464fc1d92595949,3,152,52,100,204,0,0,0,3,179,1,2,1.316963321,721,1,479,46,119,97,22,4794,4399,395,27,21,6,0,100,NoArch
ef3112973f50e058e54a06c4048fd78d7bfb071b,2,18,2,16,20,0,0,0,14,67,2,2,0.881290899,376,1,116,13,42,39,3,2289,2138,151,15,14,1,1,100,NoArch
da703137130168a9a21b072ee711052fc85edc43,5,115,37,78,152,1,0,1,11,10,3,3,1.8208349,767,2,143,15,107,101,6,4452,4065,387,53,52,1,0,99.99087258,NoArch
607b1f49c5f17fbf577e5f15abf5c440eba64e49,9,84,34,50,118,1,0,1,4,430,2,4,2.489163876,910,3,144,15,120,117,3,4465,4331,134,53,50,3,0,99.8860165,NoArch
96f58be71d1e23acbfd189dc006eb27e6f025172,18,297,81,216,378,2,0,2,30,55,3,12,3.614844885,4855,2,117,13,825,797,28,30668,29817,851,323,304,19,1,99.96356681,NoArch
8b77d818fbc3ed464e736d6d64b102aa7581ac65,0,0,0,0,0,0,0,0,0,0,0,0,0,0,0,480,45,0,0,0,0,0,0,0,0,0,0,100,NoArch
f634980f67da679f9e7f8a020da110fc76ad153e,14,150,152,2,302,0,0,0,31,31,1,8,3.453529772,6183,2,118,13,874,875,1,39050,39097,47,333,330,3,0,100,NoArch
947e196dbc3ec0476d3ea320ece84f677519bd7f,1,2,2,0,4,0,0,0,3,371,1,1,0,99,1,481,46,14,14,0,266,264,2,8,8,0,1,100,NoArch
68071cf7e139aabe777bd778fab2494ab989812d,1,68,0,68,68,0,0,0,20,3,1,1,0,786,1,482,46,147,143,4,5699,5224,475,47,45,2,0,100,NoArch
d155a37525d874b598c60501cb06593a0a5bebed,2,57,3,54,60,0,0,0,10,525,1,2,0.881290899,383,2,483,47,64,57,7,2378,2072,306,25,24,1,1,99.98178755,NoArch
5680fe2681bbfad4f673c7267f147069cc7a0a22,1,43,2,41,45,0,0,0,6,6,1,1,0,158,2,17,3,20,20,0,476,476,0,17,17,0,0,100,NoArch
91429e8b683ea679fca27c1096d077304492c6cf,1,2,2,0,4,0,0,0,7,0,1,1,0,199,2,484,48,20,20,0,476,476,0,17,17,0,0,100,NoArch
41b3def550fe6dc21e801008b1881b03b087afa5,5,116,4,112,120,2,0,2,10,153,1,4,1.688224443,972,1,145,15,108,103,5,5010,4702,308,70,66,4,1,99.98179004,NoArch
826deb6f823705116b4f05b40264f286c77de180,11,548,0,548,548,11,0,11,1,0,1,2,3.294866927,0,1,146,16,45,0,45,1886,0,1886,23,0,23,0,99.85931473,NoArch
6106919f22c14ff856eabd5a00c65f051edbd0c3,1,17,0,17,17,0,0,0,7,446,1,1,0,446,3,485,49,95,90,5,2068,2004,64,35,35,0,1,100,NoArch
a0d1f98cb0552ad1b83435499c23d19a1e4e2f22,1,1,0,1,1,0,0,0,2,968,1,1,0,54,1,486,50,3,3,0,218,212,6,2,2,0,0,100,NoArch
425bccd31f1c7a7c9a1ac66b921ffd24ddaf7c94,5,22,1,21,23,0,0,0,11,68,2,2,2.136872696,1416,1,487,48,132,128,4,8305,8175,130,63,61,2,0,100,NoArch
d063914fa23c2a07683c6a44791f9530a0a20e8d,1,1,2,1,3,0,0,0,12,0,1,1,0,382,2,488,49,58,58,0,2157,2165,8,22,22,0,0,100,NoArch
a9aee17a452ce8331d077e2b3e5ae2a50d8f2e59,1,2,1,1,3,0,0,0,2,968,1,1,0,105,1,489,50,11,11,0,464,470,6,9,9,0,0,100,NoArch
efec17afdd883853d0866f1525049034a7ea6639,1,2,1,1,3,0,0,0,2,969,1,1,0,200,1,490,50,18,18,0,858,848,10,5,5,0,1,100,NoArch
60d73be576c929e9e45fbed90ba668a4d88a7329,13,212,77,135,289,0,0,0,13,22,2,9,2.965288131,4032,1,119,12,616,591,25,24036,23115,921,341,333,8,0,100,NoArch
08076ec8bed0cdde17709706b2c009be547138dc,7,95,25,70,120,0,0,0,23,186,3,7,1.610271706,4023,1,491,49,835,819,16,24954,24522,432,203,199,4,5,100,NoArch
240bfcff30f02d294764068c32683f00c455085f,5,87,26,61,113,0,0,0,12,338,2,4,0.897013834,1959,2,492,50,414,393,21,12310,11913,397,82,81,1,1,100,NoArch
5f92d475df51ae624de948bd6972fda2e3efbc1d,9,164,38,126,202,1,0,1,35,36,2,5,2.574470162,2576,2,120,13,343,325,18,14161,13536,625,179,171,8,0,99.92761819,NoArch
9d9ffc5356e6d6921a2cd07e933f23dc51643a2b,0,0,0,0,0,0,0,0,0,0,0,0,0,0,0,8,0,0,0,0,0,0,0,0,0,0,0,100,NoArch
224f9f04a25e36066f4c6b52a42150e63b7d7708,7,318,125,193,443,2,1,3,14,3,2,6,1.97476532,975,1,121,13,139,115,24,6872,5621,1251,83,67,16,0,99.89583805,NoArch
5d8d76a4726cb3e94144423b5e2bc1325b298627,3,48,4,44,52,0,0,0,11,139,2,3,1.419556299,2833,2,493,49,419,412,7,20294,19969,325,88,86,2,1,100,NoArch
a3dcb81ce728e3683d0d3e780e904a8646750d24,3,95,1,94,96,0,0,0,24,404,2,2,0.768746129,2590,4,494,50,592,588,4,15460,15413,47,175,174,1,1,100,NoArch
25670091448e9d19a640f5d70284862c7c77c9a5,0,0,0,0,0,0,0,0,0,0,0,0,0,0,0,495,51,0,0,0,0,0,0,0,0,0,0,100,NoArch
0a3757253ec02da1aebff4f2056dc8e65b76e614,0,0,0,0,0,0,0,0,0,0,0,0,0,0,0,496,52,0,0,0,0,0,0,0,0,0,0,100,NoArch
df76f227b0c1f348141f931f319d5d20454b0e46,2,26,24,2,50,0,0,0,6,0,1,1,0.242292189,388,1,497,53,51,51,0,1132,1132,0,47,47,0,0,100,NoArch
e88c5b9ae54d5d81f79e0954ceb2613677dfa090,1,4,3,1,7,0,0,0,9,46,1,1,0,625,3,498,54,89,89,0,2233,2219,14,39,39,0,0,100,NoArch
52b9974dafc975447cfa1f260b94d1b1b2c80d08,13,50,316,266,366,0,0,0,5,924,1,3,3.220097233,913,1,499,55,81,81,0,2371,3404,1033,43,43,0,0,99.90015884,NoArch
0084fcd3a229e83ac24d162fc6966be5a32f2fc7,3,8,7,1,15,0,0,0,2,9,1,2,1.530124965,261,2,500,56,14,14,0,1201,1201,0,8,8,0,0,100,NoArch
00975881e9f3288577b5b969b57ccb2d51b76d4f,32,2770,0,2770,2770,32,0,32,1,0,1,10,4.798521647,0,1,501,57,161,0,161,9363,0,9363,89,0,89,0,95.15716649,Arch
c88fa71d8b5c0a94cc4196d62d6374696bf2c3b5,6,16,12,4,28,0,0,0,2,0,1,5,2.495602924,877,1,502,58,57,57,0,3422,3422,0,19,19,0,0,100,NoArch
bbb2bf2de9425153cb93e0b83cb5770afb9184da,0,0,0,0,0,0,0,0,0,0,0,0,0,0,0,503,59,0,0,0,0,0,0,0,0,0,0,100,NoArch
420e6f4242082fe8eeacebe6eef8cbece8756292,0,0,0,0,0,0,0,0,0,0,0,0,0,0,0,504,60,0,0,0,0,0,0,0,0,0,0,100,NoArch
bf3cc6cddda75e6336763c30b9d07b42a8c3c398,0,0,0,0,0,0,0,0,0,0,0,0,0,0,0,505,61,0,0,0,0,0,0,0,0,0,0,100,NoArch
b9ffe207ae073b2f7ab498cd7b8fd4175b36ab24,3,3,3,0,6,0,0,0,2,0,1,2,1.584962501,209,1,506,60,15,15,0,700,700,0,9,9,0,0,100,NoArch
34198650ccfeb90b0756fb5373f596c08c31cb8a,2,20,3,17,23,0,0,0,3,0,1,2,0.558629373,449,1,507,61,27,20,7,2149,1993,156,6,6,0,0,100,NoArch
ed73f1bc940e319befa613232ea38e7b98c15a68,2,15,4,11,19,0,0,0,4,0,1,2,0.297472249,315,1,508,62,42,36,6,1353,1269,84,6,6,0,0,100,NoArch
5414eab9caaa148be3e12a3e03e779ab4c38794a,1,16,2,14,18,0,0,0,3,0,1,1,0,130,1,509,63,15,8,7,499,376,123,2,2,0,0,100,NoArch
b78e0b02ea3f7ccf65a17a3326223d985b918e34,1,1,1,0,2,0,0,0,2,0,1,1,0,113,1,510,64,8,7,1,328,318,10,2,2,0,0,100,NoArch
b5b1947639ca420817480a76e9470a353793b1dc,0,0,0,0,0,0,0,0,0,0,0,0,0,0,0,511,65,0,0,0,0,0,0,0,0,0,0,100,NoArch
81dbeea64a659c5d84c2156f23edd503b409a974,1,4,2,2,6,0,0,0,3,910,1,1,0,257,2,512,66,58,58,0,1116,1102,14,41,41,0,1,100,NoArch
df4c203c761b7f44588053858a1dcf802d10b0d3,1,12,6,6,18,0,0,0,3,2,1,1,0,113,1,513,67,8,8,0,328,328,0,2,2,0,0,100,NoArch
c0cf68a2abea7ffaa34c9b71124e3117cbdec75c,0,0,0,0,0,0,0,0,0,0,0,0,0,0,0,514,68,0,0,0,0,0,0,0,0,0,0,100,NoArch
9207511cce00e3d96a3aa3188bed259ed7dacbf7,0,0,0,0,0,0,0,0,0,0,0,0,0,0,0,515,69,0,0,0,0,0,0,0,0,0,0,100,NoArch
bcdb915c4342bf1f9cf90e37a14c248cb944d145,13,720,440,280,1160,5,1,6,15,274,2,6,2.922134711,2329,2,48,8,323,301,22,14101,12879,1222,101,89,12,2,99.87698501,NoArch
d59da58e8afcbce2614151a0d10113162bff98a3,5,157,99,58,256,0,0,0,21,133,1,4,2.043467446,3352,3,516,62,642,630,12,21193,20762,431,154,152,2,0,100,NoArch
6d1554ea8ec653e3aba3e27baceee4973137c91e,1,1,2,1,3,0,0,0,4,814,1,1,0,182,3,19,1,17,17,0,1075,1080,5,6,6,0,1,100,NoArch
5eb835d0a90a774ddf4dde025645c3ca0693493a,0,0,0,0,0,0,0,0,0,0,0,0,0,0,0,49,9,0,0,0,0,0,0,0,0,0,0,100,NoArch
fd174c808918936b51b006c96146a4e98103d797,3,220,0,220,220,3,0,3,1,0,1,1,1.550619316,0,1,50,10,11,0,11,885,0,885,8,0,8,0,99.95530477,NoArch
e50709d169b0b5d2fd90a71bcaa5a757915b3070,2,9,4,5,13,0,0,0,17,124,1,2,0.961236605,978,1,517,57,167,165,2,5785,5755,30,18,18,0,0,100,NoArch
7ae4e73d205828157d4124cbd87a9a16439afe67,8,205,77,128,282,2,1,3,4,91,1,5,2.388052033,888,1,518,58,146,128,18,4919,4221,698,60,58,2,0,99.84922939,NoArch
f87b7e63eff64dbb6393964195b3a29b19e4bbe4,8,159,52,107,211,0,0,0,36,125,2,5,2.539543005,3355,2,122,8,480,463,17,18187,17329,858,247,240,7,0,100,NoArch
9e8dccdeb2d8024aef655d32c2b39d40248c3ec6,5,57,17,40,74,0,0,0,11,241,2,4,1.45167991,990,2,123,9,86,82,4,6224,5861,363,67,65,2,0,100,NoArch
10eb1f0c18d148cc3a5ec4e3193e5b4dbdc6834f,2,2,2,0,4,0,0,0,5,0,1,1,1,287,2,124,10,13,13,0,1654,1658,4,13,13,0,0,100,NoArch
d95d7ba4fedcbf21a525c7b6f21ff086b04fd69d,5,634,36,598,670,3,0,3,6,95,1,2,1.873885001,968,1,147,6,240,173,67,7760,4600,3160,110,66,44,1,99.96093096,NoArch
399c9ef15f87681dfdefa916e4e07d5ea8dce369,3,308,0,308,308,3,0,3,1,0,1,1,1.550227242,0,1,148,6,31,0,31,1204,0,1204,25,0,25,0,99.96096146,NoArch
ffa668ddec06c2b30399b78d1421e16d92b4d757,1,34,0,34,34,1,0,1,1,0,1,1,0,0,1,149,7,0,0,0,48,0,48,0,0,0,0,99.9777047,NoArch
99b9ceeb8a69112e53003450e5c3fd14bcc31e84,1,6,1,5,7,0,0,0,6,7,1,1,0,215,4,150,8,29,28,1,1432,1410,22,5,5,0,1,100,NoArch
87dbc6e7472fd334241b357d9d8af9813e14af5d,0,0,0,0,0,0,0,0,0,0,0,0,0,0,0,151,9,0,0,0,0,0,0,0,0,0,0,100,NoArch
ac65332e013a162787d6b1fcc9e8a00575475fc5,1,52,5,47,57,0,0,0,25,23,1,1,0,2296,4,152,10,550,541,9,14570,14328,242,131,128,3,0,100,NoArch
7eec1b676ab3824df60bd899cced1d71aee47aa8,4,19,3,16,22,0,0,0,26,66,2,4,1.563279036,3624,4,153,10,774,772,2,20877,20797,80,236,236,0,2,100,NoArch
2543785c4a6906dfb7d38852653ee7fbce5acc91,2,25,1,24,26,0,0,0,3,498,2,2,0.391243564,156,2,154,11,19,17,2,617,434,183,18,17,1,1,99.98328039,NoArch
c001d20cc1d38a5983d9edf9d92ec39ab067ddd0,0,0,0,0,0,0,0,0,0,0,0,0,0,0,0,51,8,0,0,0,0,0,0,0,0,0,0,100,NoArch
6e05bbdc4ff66ba7d4e1d043f9c041f57269fedd,9,180,31,149,211,0,0,0,37,41,2,7,2.254787896,4328,2,125,11,511,491,20,27265,26289,976,251,243,8,0,100,NoArch
da0773710be57810f232ed4ea75ff61acf150f83,1,2,2,0,4,0,0,0,3,44,1,1,0,99,1,519,41,19,17,2,505,497,8,5,5,0,1,100,NoArch
0b3a036b3316d4c31d122ca7c2f6f78945a7b3fc,1,1,1,0,2,0,0,0,13,192,1,1,0,692,3,520,41,104,104,0,3703,3703,0,47,47,0,1,100,NoArch
98418abd4b759bb8e26f980d2082ea884c5fb889,2,40,1,39,41,0,0,0,3,929,1,2,0.901170196,459,1,521,41,91,79,12,2726,2519,207,29,27,2,2,100,NoArch
ee81981c1aab32aea49ed18efbe99d54dfac1c74,0,0,0,0,0,0,0,0,0,0,0,0,0,0,0,522,42,0,0,0,0,0,0,0,0,0,0,100,NoArch
c0fbf7a37fd531412b2401620fa7f8473ef26dd4,1,7,2,5,9,0,0,0,20,35,1,1,0,603,2,126,9,92,91,1,3304,3268,36,41,41,0,0,100,NoArch
2bb0a53681afac797d4c61c1865aca4fb0cd5975,5,69,16,53,85,0,0,0,38,26,2,4,2.088079703,4376,2,127,8,565,557,8,19672,19387,285,234,230,4,0,100,NoArch
59803fff98435c54acabb03889c4cf18e72b475b,1,3,0,3,3,0,0,0,3,371,1,1,0,295,1,523,42,47,46,1,1730,1711,19,5,5,0,0,100,NoArch
f5bada46d750db319940fc6cb96b10b8dc2535de,1,9,1,8,10,0,0,0,2,170,1,1,0,221,1,524,41,24,23,1,634,578,56,13,13,0,1,100,NoArch
d59246ea7b7ba05b12bffe7874386eb6072117df,1,4,0,4,4,0,0,0,2,1010,1,1,0,457,2,128,9,28,27,1,3453,3440,13,24,23,1,0,100,NoArch
90871d8f304010080fb49dd6b4caf815688bfd57,2,32,5,27,37,0,0,0,5,465,1,2,0.974024864,241,1,129,9,33,30,3,1240,1027,213,29,26,3,2,99.99442649,NoArch
f6428c53ab657b8220bf352a7194529eddaaca09,1,18,1,17,19,0,0,0,4,469,1,1,0,121,3,18,0,0,0,0,420,420,0,0,0,0,0,100,NoArch
bb8765a22de815b44a6c4b6a9e0be9337777b5c8,8,71,112,41,183,0,0,0,20,276,2,8,2.63326149,4380,3,155,8,639,659,20,27457,27822,365,187,187,0,0,100,NoArch
dc46f5679e619be8fe280d2b115b5c734b1e7fec,2,0,0,0,0,0,0,0,1,0,1,1,0,69,1,156,9,6,6,0,313,313,0,6,6,0,0,100,NoArch
ffb9eeb3e0ea379d3e9e88e351ae27937ed20191,5,55,143,88,198,0,1,1,9,395,2,4,1.592142202,1348,2,157,10,158,169,11,7846,8254,408,66,68,2,1,99.97770221,NoArch
465083a674c44526e35865799cc5d8a3c46e99f9,1,15,1,14,16,0,0,0,10,1,1,1,0,161,3,158,11,25,24,1,761,710,51,16,16,0,0,100,NoArch
b37dbff60aa37624f3fabfcfd31ed301aeaef7b3,6,78,15,63,93,0,0,0,39,54,2,5,2.080534303,4069,2,130,8,477,466,11,24579,24081,498,283,278,5,0,100,NoArch
292ec4031ee036fa0121dd7e6ef50ea3e143edcd,1,5,1,4,6,0,0,0,6,51,1,1,0,351,1,525,9,61,60,1,2450,2429,21,10,10,0,0,100,NoArch
d01423ed8042caeea60eba66f06eaeb66996146a,1,20,17,3,37,0,0,0,21,38,1,1,0,1545,3,526,10,304,300,4,9610,9569,41,49,49,0,0,100,NoArch
cee9de1957bd25d9c1333abbe2f2be45e9e120ff,2,20,0,20,20,0,0,0,2,1022,2,2,1,271,1,527,11,38,34,4,1304,1244,60,23,19,4,0,100,NoArch
9a83d903a2ac00269f51dfcfeaddfbda7c7c3502,1,1,0,1,1,0,0,0,8,55,1,1,0,463,3,528,12,95,95,0,2072,2068,4,35,35,0,0,100,NoArch
10bd3561d40b91f56e76fac3a1881fc98bcd6787,1,2,2,0,4,0,0,0,3,460,1,1,0,830,1,529,13,134,134,0,4991,4995,4,22,22,0,0,100,NoArch
77535e4928803bbdd718efb7541dbd07d318848b,9,96,61,35,157,0,0,0,14,482,2,6,2.227036472,2128,1,530,14,368,355,13,12241,12150,91,98,95,3,0,99.9832664,NoArch
161e9729b4d981f869d7e9919168bc9a47786b88,0,0,0,0,0,0,0,0,0,0,0,0,0,0,0,531,15,0,0,0,0,0,0,0,0,0,0,100,NoArch
debf6fbfa2501bf6df3b5e3cae9873bf524a536f,0,0,0,0,0,0,0,0,0,0,0,0,0,0,0,532,16,0,0,0,0,0,0,0,0,0,0,100,NoArch
feb2517653032eca3f0bfd3fb22e39df98c2b056,12,274,50,224,324,0,0,0,22,644,1,6,2.984782983,1619,1,533,17,250,218,32,10070,8699,1371,104,83,21,2,94.78333799,Arch
860bb91342365c531114ea3e6b424216f7358a4f,4,35,9,26,44,0,0,0,7,298,2,2,1.863586948,548,2,534,18,87,83,4,2761,2541,220,38,37,1,0,100,NoArch
56bbde09564042015424c08998cdb2af6c8bdec2,1,5,1,4,6,0,0,0,6,0,1,1,0,250,2,535,19,39,38,1,1555,1540,15,8,8,0,0,100,NoArch
98062c748282de1bb198b6e2685840a87f4e5a96,1,5,3,2,8,0,0,0,2,546,1,1,0,164,2,536,20,38,37,1,1137,1129,8,8,8,0,1,100,NoArch
5d6d49e773e32b1de353d3728380ce97dbbd1f97,3,30,4,26,34,0,0,0,5,509,1,1,0.911239223,269,3,19,1,0,0,0,635,635,0,0,0,0,0,100,NoArch
c48363e94269d46912e7453fc9e8ca1161378269,1,4,2,2,6,0,0,0,6,0,1,1,0,143,3,20,2,0,0,0,420,420,0,0,0,0,0,100,NoArch
e255b54b7336558647da007bc0d2010cecb9b593,2,32,21,11,53,0,0,0,4,411,1,2,0.135036203,792,2,159,12,134,131,3,3648,3619,29,52,52,0,0,100,NoArch
5992123906141884a848ef817e0d81b9fdb33e6d,0,0,0,0,0,0,0,0,0,0,0,0,0,0,0,160,13,0,0,0,0,0,0,0,0,0,0,100,NoArch
bbd48b767eea44ff50b8f237b61ce5ee1714f909,1,1,2,1,3,0,0,0,7,29,1,1,0,531,2,537,21,93,93,0,2388,2395,7,61,61,0,0,100,NoArch
4ef845a6b876101024b94c9645af4b498632fdb4,0,0,0,0,0,0,0,0,0,0,0,0,0,0,0,538,22,0,0,0,0,0,0,0,0,0,1,100,NoArch
588c300b0815b9e97b387e9832ef1211c29ae8e8,1,0,7,7,7,0,0,0,9,11,1,1,0,572,3,539,22,114,117,3,3730,3776,46,21,21,0,0,100,NoArch
0aedce6c629f6f477e9773e116d947a2b1f77b50,1,1,1,0,2,0,0,0,27,30,1,1,0,2346,4,540,23,551,550,1,14602,14596,6,131,131,0,1,100,NoArch
d0f9db29c328c95bd80cc9eccea3d830e60721b2,14,178,115,63,293,1,0,1,13,47,3,6,3.18089864,1871,3,161,14,268,260,8,9447,9214,233,100,94,6,0,99.95518709,NoArch
84520f590bda71f6c72bf615543b0d7d5f32f783,1,2,2,0,4,0,0,0,2,1028,1,1,0,114,2,131,9,7,7,0,456,456,0,4,4,0,0,100,NoArch
7d792c240cf568960c4f289da94ac61fc73aade5,2,7,2,5,9,0,0,0,11,8,2,2,0.503258335,396,3,541,24,70,68,2,2181,2156,25,26,25,1,0,100,NoArch
4bfd189bbc95f827bdb2b24e9465ecb30dcf5237,2,42,14,28,56,0,0,0,7,62,2,2,0.99631652,978,3,21,3,112,112,0,3545,3545,0,41,41,0,0,100,NoArch
eb88768b73dc540194b0f8c2dceb44872a120276,1,9,10,1,19,0,0,0,8,258,1,1,0,664,2,162,15,83,83,0,3748,3771,23,13,13,0,1,100,NoArch
ffb6306a227fcdf418e4438906cf7ddb835753f6,3,127,21,106,148,2,0,2,2,343,1,2,1.547434654,163,2,163,16,30,23,7,1114,801,313,9,5,4,1,99.97200291,NoArch
597daad36b4753e59bfd565065ea97ad964ed46b,1,3,0,3,3,0,0,0,3,1,1,1,0,71,1,164,17,7,6,1,215,206,9,4,4,0,0,100,NoArch
443beb1cf463cd42b83d5e247670d591d47c7e80,0,0,0,0,0,0,0,0,0,0,0,0,0,0,0,542,23,0,0,0,0,0,0,0,0,0,0,100,NoArch
f7ce4c814ccaa2bc292b5ad22943fb9a17162f85,1,32,18,14,50,0,0,0,5,68,1,1,0,356,1,543,24,77,69,8,1847,1710,137,28,28,0,0,100,NoArch
17b9b729bc7d54f823b44e549a80d986b8918363,2,62,23,39,85,0,0,0,15,11,1,2,0.220283267,1291,3,544,25,241,235,6,8973,8708,265,42,42,0,0,100,NoArch
96948120dc1b0c0c25f3589c988317dc3fb10d30,4,167,19,148,186,0,0,0,20,344,2,3,0.545075865,2046,3,545,26,417,382,35,12681,11862,819,96,81,15,0,100,NoArch
1bd4da978471e8e19c063775144b3002ab308421,1,1,0,1,1,0,0,0,6,2,1,1,0,370,1,546,27,77,77,0,1858,1847,11,28,28,0,0,100,NoArch
0ddeb575cfbfcb226f48e0e7905e03a8812eb6fc,4,85,69,16,154,0,0,0,3,571,1,1,1.58157527,503,2,547,28,50,47,3,1750,1638,112,23,20,3,1,100,NoArch
a3a936b69e4f07893d05ec75f708144700ff8c95,5,108,12,96,120,1,0,1,7,441,3,5,1.884809487,967,1,548,29,232,213,19,6343,5610,733,40,36,4,4,99.94954874,NoArch
3ad0469e149e2accba0c1b6aab5bf71679f33610,1,9,3,6,12,0,0,0,4,36,1,1,0,298,1,549,30,48,47,1,1775,1730,45,6,5,1,0,100,NoArch
d40eb75cb6810398fe74e676c0b508286677ef89,4,34,7,27,41,0,0,0,22,75,1,3,1.402670235,2815,1,550,31,525,524,1,16695,16605,90,85,85,0,1,100,NoArch
f0aad11003a81e42ec4168210b0d5544f8f5c4fb,1,1,1,0,2,0,0,0,11,90,1,1,0,201,1,551,32,12,12,0,1237,1237,0,7,7,0,0,100,NoArch
01f4f43275701268fa1d4c15f122c3a68c34871c,1,14,4,10,18,0,0,0,2,1044,1,1,0,72,2,22,4,0,0,0,171,171,0,0,0,0,0,100,NoArch
957dd5d98751556bf2d596bdc79995f4b6d2c2b9,3,129,3,126,132,1,0,1,6,95,1,3,0.470820053,226,1,165,10,39,30,9,1548,968,580,16,8,8,2,99.91015779,NoArch
6a2af61f1edf8e351acf59f5ae13725d7115ffb3,40,959,167,792,1126,6,0,6,40,233,2,19,4.378421115,8196,2,132,6,1136,1023,113,50444,46068,4376,568,523,45,0,96.05497728,Arch
c338c36cf06ecdf7dbfae62ed253e1366b0b645d,3,441,108,333,549,0,0,0,23,8,1,3,1.120668045,2070,2,133,6,285,236,49,16594,14539,2055,128,119,9,1,100,NoArch
92ae40b38620bfe45463d07d728f31f3a1dea4fb,1,6,0,6,6,0,0,0,15,79,1,1,0,369,3,134,7,70,68,2,2317,2278,39,17,17,0,0,100,NoArch
a027a3c87b4eda59c04b8580eaf80332c8d553d3,1,7,3,4,10,0,0,0,13,2,1,1,0,373,1,135,7,28,28,0,2293,2277,16,26,26,0,0,100,NoArch
059cf50e810a65285dc7c49eba6492914c11216a,2,38,20,18,58,0,0,0,9,153,1,2,0.929363626,1465,3,18,0,259,255,4,9229,9102,127,61,61,0,1,100,NoArch
e55aa79d1eaab148c41e9e31ac43ab515a5961ef,1,0,1,1,1,0,0,0,19,3,1,1,0,257,2,552,27,31,31,0,1595,1600,5,7,7,0,0,100,NoArch
a40421f009b7815ba573bdb99179717e1f8fce8e,2,5,3,2,8,0,0,0,2,2,2,2,0.811278124,342,2,553,28,48,48,0,1913,1892,21,14,14,0,0,100,NoArch
cb0cf4f922b0dea2bb7e11f6a739620f9c9f1794,3,25,7,18,32,0,0,0,17,17,2,2,1.574918037,1176,3,554,29,211,210,1,7684,7578,106,49,49,0,0,100,NoArch
08a4d43063adffa3ab343d6b8547b22a70dec81d,3,11,21,10,32,0,0,0,5,75,1,3,1.419736718,470,1,555,30,57,57,0,1860,1852,8,8,8,0,0,100,NoArch
9ff4c8a84057ac8d87dae96a25f6384253bf9568,0,0,0,0,0,0,0,0,0,0,0,0,0,0,0,556,31,0,0,0,0,0,0,0,0,0,0,100,NoArch
c3aebf5e5b2d3c8c10ab7888c42a4fefede34d5e,0,0,0,0,0,0,0,0,0,0,0,0,0,0,0,557,32,0,0,0,0,0,0,0,0,0,0,100,NoArch
87b477b258d59badc15331b3eacc933670620541,1,1,1,0,2,0,0,0,5,107,1,1,0,141,2,558,33,13,13,0,854,850,4,5,5,0,0,100,NoArch
8c78a534ec03e4d154386993c49c0f7ca3101730,23,264,77,187,341,1,0,1,41,39,2,12,3.998621736,7633,2,136,8,1105,1062,43,38826,37441,1385,454,442,12,0,99.97643871,NoArch
3f3dabcfac5c985868bf2a562660e9e1d3573093,1,1,1,0,2,0,0,0,26,0,1,1,0,2176,3,137,8,281,281,0,7674,7674,0,77,77,0,0,100,NoArch
40c606e3b7e90345ef0a9bac9835ac9f3c936b3a,2,39,8,31,47,0,0,0,12,8,2,2,0.878674493,739,1,559,34,137,135,2,5073,4847,226,28,27,1,1,100,NoArch
7f7694ebda686830d734d65dfcf0ef5c9ab8e212,7,163,12,151,175,2,0,2,42,4,2,3,2.448307518,2649,2,138,9,407,387,20,15097,14373,724,183,170,13,0,99.95878717,NoArch
74f0d361cb734d92b211994b6624a6338e25b99e,1,5,3,2,8,0,0,0,2,0,1,1,0,52,2,560,35,4,4,0,272,269,3,3,3,0,0,100,NoArch
6b506c4adcc1da6208c74a9adcabdf83660efbc9,5,42,11,31,53,0,0,0,6,628,3,5,1.848915581,3887,2,561,36,550,542,8,27390,27271,119,150,150,0,0,100,NoArch
dfc209e3c19173f05278d208b6bd05ed7d1782f8,3,75,13,62,88,0,0,0,10,240,1,3,0.726260038,2075,3,19,1,339,329,10,12292,11963,329,91,87,4,1,100,NoArch
f8fbe10db857d1303109095516b3012f7f895101,6,16,12,4,28,0,0,0,10,472,2,5,2.372326013,1316,2,562,37,150,149,1,5505,5470,35,51,51,0,0,100,NoArch
63c2da8816c746fb6d2532cdade8dba432fd186d,3,42,4,38,46,0,0,0,43,379,2,2,1.536240826,1543,2,139,9,170,164,6,8546,8205,341,159,155,4,0,99.81200799,NoArch
467e94e597c87981f8c6cd116993f5ccc53ec0e9,6,76,34,42,110,0,0,0,13,472,4,6,1.972819315,2268,1,563,38,228,225,3,13247,13033,214,137,136,1,0,100,NoArch
3bc8506a6eebe6dc4df5ad0d1ea2112bb202c02b,1,17,5,12,22,0,0,0,7,87,1,1,0,347,1,564,39,84,79,5,1876,1841,35,17,17,0,1,100,NoArch
9ea2300bc989a7ae6ab773b9cb42f47fdbf2f69d,2,382,85,297,467,0,0,0,13,149,1,2,0.698189954,692,3,0,0,139,86,53,5374,4179,1195,73,48,25,1,100,NoArch
1d304970f287434b038b99a628f18b043c91e00a,1,2,2,0,4,0,0,0,14,0,1,1,0,531,3,1,1,93,93,0,2359,2359,0,27,27,0,0,100,NoArch
9b88ac081eb75794e07ca525eb7ab48a60e2875d,1,1,0,1,1,0,0,0,5,78,1,1,0,181,3,20,0,17,17,0,1086,1075,11,6,6,0,1,100,NoArch
676d2a72f5f179e4094b5ddce9c3641dcccbe425,1,7,0,7,7,0,0,0,28,38,1,1,0,2346,4,565,28,553,551,2,14643,14602,41,131,131,0,1,100,NoArch
56a02878e2dfc7f706bcc2e3587b4c198e3c5533,1,8,1,7,9,0,0,0,8,189,1,1,0,128,1,566,29,7,6,1,1132,1122,10,4,4,0,1,100,NoArch
a83b01beae1458778a0270fb43798357993a9f6d,7,44,49,5,93,0,0,0,11,307,1,4,2.556921429,2454,1,567,30,359,359,0,13760,13782,22,104,104,0,1,100,NoArch
60c8f64356b9f517909d422175ba0e1f414f9f5d,18,206,15,191,221,2,0,2,44,106,3,13,3.506576989,7700,1,140,9,1005,985,20,45789,44872,917,427,417,10,0,99.97068996,NoArch
5084e1d688b03d07179693b78ffa2767e6d42ef9,1,1,1,0,2,0,0,0,5,17,1,1,0,134,1,568,29,15,15,0,501,501,0,2,2,0,0,100,NoArch
0f1081a7dafbbef3f45f38a8e7a8bfaf447c5643,1,1,1,0,2,0,0,0,6,14,1,1,0,540,1,569,30,124,124,0,3616,3616,0,20,20,0,0,100,NoArch
06f9c51a6b2aee4438416e0fe84e86031186fde8,1,9,8,1,17,0,0,0,22,83,1,1,0,859,1,570,30,147,147,0,5728,5728,0,47,47,0,0,100,NoArch
64eb7a3c66c994ebda4ff52b27ecb7b11c68dee4,1,3,2,1,5,0,0,0,6,17,1,1,0,198,1,571,31,23,23,0,798,800,2,3,3,0,0,100,NoArch
b458490052507ef76395580f4f1369b9bb38f7dc,1,0,8,8,8,0,0,0,45,0,1,1,0,936,2,141,10,82,83,1,4017,4041,24,74,75,1,0,100,NoArch
f8d82db81fe16607df677528e71ef14afed06818,3,130,6,124,136,0,0,0,29,453,2,3,0.517010875,3046,1,572,32,691,677,14,19825,19093,732,165,153,12,1,100,NoArch
b3552bceaf71536e13cac966bc84982475e9c897,1,4,4,0,8,0,0,0,7,15,1,1,0,238,1,573,31,9,10,1,764,795,31,7,7,0,0,100,NoArch
582a579c22d9d2bda2d483be22e9f5b696b41ea5,25,1120,634,486,1754,4,1,5,21,341,3,13,3.195957796,7388,1,574,29,1222,1108,114,43178,40679,2499,424,394,30,1,99.84766815,NoArch
7508dd05ca8f694a8f73327ee802bc7a6bff0796,3,23,0,23,23,0,0,0,13,349,2,2,1.477746834,428,2,142,10,34,32,2,2015,1900,115,30,28,2,0,100,NoArch
081e9b1141b60dd14af33c1fbacca6c7b8b71294,0,0,0,0,0,0,0,0,0,0,0,0,0,0,0,143,11,0,0,0,0,0,0,0,0,0,0,100,NoArch
a163d38f5e491dd3305b69f2c05ee7a7421cf083,13,492,30,462,522,3,0,3,19,226,2,5,2.838283521,2122,1,144,12,298,251,47,12097,9779,2318,176,160,16,1,95.89910326,Arch
2640a4b0da27cd8344f3b8f70be25ac001c0f483,4,95,24,71,119,0,0,0,27,394,2,3,1.805822042,2855,1,575,29,419,407,12,11829,11254,575,120,120,0,1,100,NoArch
87e6ff32ed08c0d4420b0ef77b520d0a2902dccf,1,1,1,0,2,0,0,0,28,0,1,1,0,2196,3,576,28,287,286,1,7819,7813,6,77,77,0,0,100,NoArch
65d303cfec7d9b180f298390951fa49c23dad6b2,5,36,12,24,48,0,0,0,7,245,2,3,1.290852083,1029,2,577,29,99,98,1,5346,5279,67,37,37,0,0,100,NoArch
dbd8b8cd20a3e867d8db40f8eb2b4eba9d4147a9,1,1,1,0,2,0,0,0,7,138,1,1,0,420,2,9,0,50,50,0,1093,1093,0,37,37,0,0,100,NoArch
6bef2d486db4fbee62e94861272ed4825714f215,8,192,89,103,281,0,0,0,17,148,4,7,1.474853786,3129,3,578,28,519,507,12,17201,16756,445,189,184,5,3,100,NoArch
ce468db02727d19e7e41d51c861e2cba79f27f79,1,1,1,0,2,0,0,0,7,314,1,1,0,960,2,579,29,128,128,0,4988,4988,0,34,34,0,1,100,NoArch
31643df1db6689596f3be09678372f4eacda1cad,1,12,6,6,18,0,0,0,5,500,1,1,0,236,1,580,28,46,44,2,902,872,30,6,6,0,0,100,NoArch
ae4a425c45225a7705f0ee7b96bfc0fe4f608237,3,8,9,1,17,0,0,0,14,159,3,3,1.379280487,642,2,581,29,44,44,0,3267,3273,6,39,39,0,0,100,NoArch
29ec54a0989585ae9d998d02a4023887dde2990a,2,36,16,20,52,0,0,0,7,51,1,1,0.998932655,406,1,582,30,54,48,6,2582,2487,95,12,10,2,0,100,NoArch
b230f7f47307ba7d331b6bd86020ad5f2adab012,2,41,40,1,81,0,0,0,4,384,1,1,0.99107606,832,3,583,31,133,135,2,5425,5452,27,23,19,4,1,100,NoArch
ff0fa2ef8136c0bd5baec4de9e963d1dbefc4657,2,8,13,5,21,0,0,0,10,7,1,2,0.453716339,613,1,584,32,86,87,1,3810,3844,34,27,27,0,0,100,NoArch
091e5d2b2f8f3e3573427da0cc3d044ed82d04b5,1,1,1,0,2,0,0,0,2,201,1,1,0,52,2,585,33,4,4,0,140,140,0,4,4,0,1,100,NoArch
1110c6f59e4b4a882f0add06b5270b2c8ceb955d,0,0,0,0,0,0,0,0,0,0,0,0,0,0,0,586,34,0,0,0,0,0,0,0,0,0,0,100,NoArch
3a19a452b660df7add5115ac08a54f2794bc11c2,0,0,0,0,0,0,0,0,0,0,0,0,0,0,0,587,35,0,0,0,0,0,0,0,0,0,0,100,NoArch
107c812f1d09f4f9e503b0e763de80c6fe55e79b,0,0,0,0,0,0,0,0,0,0,0,0,0,0,0,588,36,0,0,0,0,0,0,0,0,0,0,100,NoArch
3129ce6fa9147489afd2e892f3835f90b1944ecc,0,0,0,0,0,0,0,0,0,0,0,0,0,0,0,589,37,0,0,0,0,0,0,0,0,0,0,100,NoArch
812ad92208cc4d15a5b0125ca01fef844f98555a,0,0,0,0,0,0,0,0,0,0,0,0,0,0,0,590,31,0,0,0,0,0,0,0,0,0,0,100,NoArch
f991560c7cd27874dcf3f273d745369f4c622f96,0,0,0,0,0,0,0,0,0,0,0,0,0,0,0,591,31,0,0,0,0,0,0,0,0,0,0,100,NoArch
9574076fb5c1faed08eed7c472dfddb1f89f6d05,3,27,2,25,29,0,0,0,37,35,1,3,1.31625222,2688,2,145,5,331,329,2,18529,18336,193,150,148,2,0,100,NoArch
e2f7b4dad6f9c873226ec8bcbe2a2ecb877c9504,4,19,6,13,25,0,0,0,18,104,2,2,1.634850917,900,1,146,6,110,108,2,5277,5191,86,50,49,1,0,100,NoArch
96aab5137d88eb19f9bd64fd9c7ca4736103f19d,1,3,4,1,7,0,0,0,2,1106,1,1,0,55,2,147,7,5,5,0,183,185,2,4,4,0,0,100,NoArch
77f1b7a28b294f1063eac4f53c4ae099532e4eb8,0,0,0,0,0,0,0,0,0,0,0,0,0,0,0,20,0,0,0,0,0,0,0,0,0,0,0,100,NoArch
fdd0f53a2411791b11c555f62f540ce791076551,4,49,12,37,61,0,0,0,3,687,1,2,1.604017605,252,1,148,8,49,38,11,1427,1224,203,14,10,4,0,100,NoArch
a2bc9ca42a9b5cc7209c9e20ea9d43d8a8d3e12d,9,119,33,86,152,0,0,0,38,233,2,5,2.745562617,3025,2,149,9,502,482,20,18113,17502,611,191,184,7,0,100,NoArch
9923736f48f78103091601ec6b864f0edee27a28,1,1,1,0,2,0,0,0,6,202,1,1,0,981,2,150,8,64,64,0,5720,5715,5,47,47,0,0,100,NoArch
43728e861d5436375bb955bd35aafd12acb5e350,11,184,29,155,213,0,0,0,14,108,2,4,2.622261837,2245,1,151,9,398,371,27,14517,13505,1012,212,202,10,0,100,NoArch
5a13e4cf755ecd88e645a9c59681f3f334f00865,2,80,24,56,104,0,0,0,15,0,1,2,0.921467669,1121,3,152,10,192,182,10,7604,7315,289,120,117,3,0,100,NoArch
2a563cefc03bf1002e6b26f4ea9b3eb257f4fb4d,1,1,0,1,1,0,0,0,16,0,1,1,0,559,2,153,11,111,111,0,3109,3103,6,40,40,0,0,100,NoArch
6bbd530255bba3f68deeae45eaadc6a5a0a0104e,3,54,2,52,56,1,0,1,15,73,2,3,0.498538986,325,2,154,12,48,44,4,1730,1451,279,31,30,1,0,99.99050693,NoArch
ac424623dfdc6af38cac2f484ac13ce9cf720f8e,12,320,27,293,347,1,0,1,39,75,2,6,2.964459351,4164,1,155,10,741,684,57,26577,24609,1968,267,243,24,0,98.82969347,NoArch
af324cf96338bff39079681c89e60b957b117c9a,1,5,2,3,7,0,0,0,7,74,1,1,0,2241,2,592,11,417,417,0,16657,16651,6,70,70,0,0,100,NoArch
a3a05d25df6ca5ccf8a28fb7b6e916d0078a9abd,7,564,7,557,571,3,0,3,16,187,2,4,1.891842878,600,1,156,11,143,60,83,5967,2651,3316,94,48,46,0,98.81677141,NoArch
bd23bcdc5d03267e3e4edee739f5eced0986f3b8,2,15,26,11,41,0,0,0,13,56,1,2,0.712064055,411,1,157,12,58,58,0,1744,1844,100,20,20,0,1,95.87164152,Arch
4707cc5df669b50fa85abdddcc73ca8c44fac567,1,0,1,1,1,0,0,0,2,0,1,1,0,342,2,593,3,65,65,0,2193,2198,5,30,30,0,0,100,NoArch
b5509908c6d293c94e3c1ba576ce26cef3539c96,26,130,57,73,187,1,0,1,17,771,3,11,3.435049356,3261,1,594,4,452,444,8,14617,14125,492,204,202,2,1,99.97904091,NoArch
d734b36943f86b9f8a67e32d607cc3900bdbcc5f,2,77,1,76,78,0,0,0,8,1039,2,2,0.552495114,560,2,859,31,115,105,10,2603,2285,318,52,51,1,1,99.96007346,NoArch
93ab0d1744abf983ef55d6a78c904b163cc3f83b,1,2,2,0,4,0,0,0,6,383,1,1,0,296,2,860,32,52,52,0,1383,1383,0,22,22,0,1,100,NoArch
e6327384d8cd4faf1a9488de37a0bd8dfd4f39e4,1,22,1,21,23,0,0,0,3,230,1,1,0,132,1,861,33,29,25,4,773,652,121,19,17,2,0,100,NoArch
17b80b3a85bbdad26371c18c6b3dd6f598594500,1,0,1,1,1,0,0,0,51,11,1,1,0,1082,2,862,34,229,229,0,7041,7046,5,52,52,0,0,100,NoArch
25ff5fe1d1dbbe64a21fc83695e159ef84c0487e,12,0,905,905,905,0,12,12,2,252,1,6,3.497275711,905,1,863,35,0,44,44,0,3527,3527,0,28,28,0,99.88799104,NoArch
ccf4f741c0bd2ecda154b9d4e82d47243568093d,0,0,0,0,0,0,0,0,0,0,0,0,0,0,0,864,36,0,0,0,0,0,0,0,0,0,0,100,NoArch
891dcfef047348b08ac3760da90b932da5ab96e7,0,0,0,0,0,0,0,0,0,0,0,0,0,0,0,865,37,0,0,0,0,0,0,0,0,0,1,100,NoArch
6b34a67feef9c44ab5201957128020f114ae0ca8,1,153,0,153,153,1,0,1,1,0,1,1,0,0,1,866,38,12,0,12,796,0,796,5,0,5,1,99.97996153,NoArch
b95c5bab39593f9cc22854e0a006979f07d0040f,6,33,9,24,42,0,0,0,17,693,2,5,2.381329699,1979,1,867,39,311,302,9,11269,11150,119,114,112,2,1,100,NoArch
bbd07a4aeb1fc323ebb8b0588f6f09455d0089d5,1,4,5,1,9,0,0,0,21,134,1,1,0,913,3,868,40,165,165,0,6047,6027,20,35,35,0,0,100,NoArch
0bff1c1e0b9e584f175841c4c00f63ad08523fe4,3,20,5,15,25,0,0,0,16,136,1,3,1.541315277,1022,4,869,41,154,152,2,5673,5650,23,47,46,1,0,100,NoArch
a56ee982c2c7e4104c4ac2bcd07f753207063181,1,1,1,0,2,0,0,0,27,17,1,1,0,554,2,219,5,123,122,1,3413,3407,6,41,41,0,0,100,NoArch
8591419867b481dd1cd2845ef9ec5b54d738023d,3,67,7,60,74,0,0,0,6,609,3,3,1.154051886,502,1,870,16,65,54,11,2644,2196,448,30,24,6,0,100,NoArch
ca966860b9c4d567e3564d9d4df9da4f7b3298c0,1,8,1,7,9,0,0,0,14,160,1,1,0,817,3,871,17,151,150,1,5730,5673,57,27,27,0,1,100,NoArch
a4bdf49deabfac611ca40adec5b386d6d4e67d19,2,1,37,36,38,0,0,0,3,716,1,2,0.297472249,233,1,872,18,26,28,2,765,868,103,16,18,2,1,100,NoArch
506ba1c65b5ecd148f5a3c7f52243c5dc610c2e5,1,0,5,5,5,0,0,0,6,59,1,1,0,227,1,873,17,33,34,1,1456,1479,23,11,11,0,0,100,NoArch
eafd7781a5b23d1ea224b1625bd7718a13a66b6f,1,14,2,12,16,0,0,0,2,30,1,1,0,160,1,874,18,14,12,2,863,806,57,4,4,0,0,100,NoArch
54ba1cbefa35e1db431a958ec3d5cf1eb131cb0a,36,2971,0,2971,2971,36,0,36,1,0,1,3,4.305053528,0,1,875,19,229,0,229,12574,0,12574,90,0,90,0,97.69116381,Arch
a135dd0f04db150481274c5ea901b2dda8451131,0,0,0,0,0,0,0,0,0,0,0,0,0,0,0,876,20,0,0,0,0,0,0,0,0,0,0,100,NoArch
42efc962549964c075a823762d8d6edf0aa18edc,0,0,0,0,0,0,0,0,0,0,0,0,0,0,0,877,21,0,0,0,0,0,0,0,0,0,0,100,NoArch
e58fd86a9d532215a5ab1149c3afe6c6f9c9b9af,1,1,0,1,1,0,0,0,8,315,1,1,0,576,2,878,10,78,78,0,3466,3455,11,30,30,0,1,100,NoArch
587254825f43497f27e3093753238ade22c7b9d2,3,19,14,5,33,0,0,0,4,1355,2,3,1.234388884,504,1,879,11,41,38,3,2760,2779,19,32,33,1,0,99.9961762,NoArch
479f3701a962fd27f77b9d46ac7143d99cdab860,5,80,30,50,110,0,0,0,10,97,2,2,1.723513989,870,1,880,12,121,117,4,4706,4337,369,51,52,1,0,100,NoArch
ee91049b2de3fe71cf811ab921bd57145c4f7943,1,5,1,4,6,0,0,0,2,42,1,1,0,84,1,881,13,7,6,1,404,394,10,3,3,0,0,100,NoArch
7c3215724fb72012d4fe802b51b66043da3437da,2,13,5,8,18,0,0,0,24,384,1,1,0.918295834,1372,1,882,14,274,274,0,6643,6621,22,68,68,0,1,100,NoArch
9a99e171466e7c5fcdbf6c1f822a1e1476d79264,6,110,11,99,121,1,0,1,8,872,2,5,2.189315013,745,2,883,14,88,74,14,4558,4116,442,36,24,12,1,95.13497352,Arch
c56fb74cac9ad0c23fb68ee6045496ddb0cacd61,3,58,3,55,61,1,0,1,3,869,1,1,1.07302082,435,1,884,14,48,45,3,1876,1784,92,25,23,2,1,99.98065296,NoArch
901ee6ab27230e0afb38910067e3e0c5561b2af8,2,27,24,3,51,0,0,0,9,820,1,2,0.238684511,663,1,885,15,115,115,0,4134,4130,4,31,31,0,1,100,NoArch
719c0ce09a5393096f8dd9c96e505010bcf8a21c,3,21,2,19,23,0,0,0,5,1179,2,3,1.477746834,663,1,886,16,71,68,3,4106,4003,103,23,21,2,1,100,NoArch
64266eb3133bd1c4b459b5c91ff5a590db907c1e,0,0,0,0,0,0,0,0,0,0,0,0,0,0,0,887,17,0,0,0,0,0,0,0,0,0,0,100,NoArch
0b4cbac306de607f09e7e29884ee9492cc9a7ee5,1,11,1,10,12,0,0,0,11,11,1,1,0,318,3,888,18,51,49,2,1553,1462,91,15,15,0,0,99.97581854,NoArch
51c23135addc7e8b45a84dfb1dc1a5b9a6817972,9,1251,0,1251,1251,9,0,9,1,0,1,2,2.801054094,0,1,889,19,127,0,127,6355,0,6355,64,0,64,0,95.27127462,Arch
faf239b1156980491e0c667f43080f942858508c,9,76,143,67,219,0,0,0,1,0,1,2,2.151565557,1251,1,890,20,116,127,11,6128,6355,227,62,64,2,0,97.49811178,Arch
175df8a19292e93fbd4f6d5324a2599391228d49,0,0,0,0,0,0,0,0,0,0,0,0,0,0,0,891,21,0,0,0,0,0,0,0,0,0,0,100,NoArch
9259595a53317dc08c385bb144044edbc034f96f,4,231,6,225,237,1,0,1,19,497,1,2,1.51967734,797,1,892,22,148,118,30,3991,3264,727,29,16,13,3,99.989995,NoArch
47324cc66ae244a7b2a86c133271f785d39dbcb7,0,0,0,0,0,0,0,0,0,0,0,0,0,0,0,893,23,0,0,0,0,0,0,0,0,0,0,100,NoArch
136feb70f80ea276822fb4bd14c4a9c6fe7a925b,1,1,1,0,2,0,0,0,2,0,1,1,0,103,1,894,24,8,8,0,307,305,2,7,7,0,0,100,NoArch
b54a29dc166bcfa6c44253040f7a7f5787ed2d43,2,13,4,9,17,0,0,0,25,99,1,2,0.997502546,682,2,895,25,131,127,4,2404,2353,51,104,102,2,1,100,NoArch
f7e721aa8314ec146a7eac145d20bfb6cfc115b8,0,0,0,0,0,0,0,0,0,0,0,0,0,0,0,896,26,0,0,0,0,0,0,0,0,0,1,100,NoArch
9e8dec3e2a01d43a46c99605fee26f93d7cd9ab8,0,0,0,0,0,0,0,0,0,0,0,0,0,0,0,897,27,0,0,0,0,0,0,0,0,0,0,100,NoArch
75c12c12bf9bd0864d0bdc46b7fcf57fe1c458c5,0,0,0,0,0,0,0,0,0,0,0,0,0,0,0,898,28,0,0,0,0,0,0,0,0,0,0,100,NoArch
b67ada08cf9328347979e1862189008ae9ed2eb0,0,0,0,0,0,0,0,0,0,0,0,0,0,0,0,899,29,0,0,0,0,0,0,0,0,0,0,100,NoArch
77cab515ccf008d2258513da02059c93bbb9adf8,0,0,0,0,0,0,0,0,0,0,0,0,0,0,0,900,30,0,0,0,0,0,0,0,0,0,0,100,NoArch
fcc76bd00f6c16e634c0bbf7de6c4860ea83dee9,2,15,9,6,24,0,0,0,26,2,1,2,0.979868757,691,2,901,31,132,131,1,2433,2404,29,104,104,0,1,100,NoArch
7b6dccf26da481bedf568e67912c42c19acbf1b3,1,1,1,0,2,0,0,0,14,0,1,1,0,192,2,902,32,29,29,0,707,707,0,14,14,0,0,100,NoArch
81813a17672abd2a93e59c92d5371c34be68c53c,0,0,0,0,0,0,0,0,0,0,0,0,0,0,0,903,33,0,0,0,0,0,0,0,0,0,0,100,NoArch
36866315e33274c4c3a99213b91642de8fdf957c,30,4,2,2,6,0,0,0,1,0,1,10,0.918295834,2143,1,904,34,125,125,0,8045,8032,13,109,109,0,0,95.05917905,Arch
f383fdb37ce547cea06542fe40cb2d72962a8dcf,0,0,0,0,0,0,0,0,0,0,0,0,0,0,0,905,35,0,0,0,0,0,0,0,0,0,0,100,NoArch
1ef920115ee69b5310538b5b799710d2ae2f9cae,1,0,2,2,2,0,0,0,2,0,1,1,0,56,1,906,36,4,4,0,171,184,13,4,4,0,0,100,NoArch
ee8087d8478d059b26474a8aaaea653166c1ed4a,0,0,0,0,0,0,0,0,0,0,0,0,0,0,0,907,37,0,0,0,0,0,0,0,0,0,0,100,NoArch
7b44017ab18b473961b27a2dd13023c01c0dc13d,10,97,13,84,110,1,0,1,33,654,3,9,2.682965534,4117,1,908,38,801,793,8,24456,24071,385,214,213,1,1,99.97464889,NoArch
50b1c2aecdfb997f2235717e71d1d8979358666e,3,6,3,3,9,0,0,0,6,265,2,3,1.435520504,391,1,909,39,60,59,1,2047,2011,36,17,17,0,0,100,NoArch
bc13890dcad1e26bb5f4335d3c14eb96c9e2415b,0,0,0,0,0,0,0,0,0,0,0,0,0,0,0,910,40,0,0,0,0,0,0,0,0,0,0,100,NoArch
03349e837faa79ee6657970a11dde3dbd226cd77,3,26,9,17,35,0,0,0,8,389,2,3,1.513696779,539,1,911,41,84,81,3,2910,2755,155,29,28,1,1,100,NoArch
0f55c195b0dc511bc67261fe8fd487e2eb709801,38,856,95,761,951,5,0,5,52,158,3,16,4.538227596,10242,2,220,0,1690,1573,117,62962,59010,3952,762,707,55,0,99.28220058,NoArch
cfaa3934c176529ce590e99768033eba856ced67,1,0,1,1,1,0,0,0,7,0,1,1,0,170,3,221,1,34,34,0,1048,1053,5,10,10,0,0,100,NoArch
ab6519421719da29628965bed95fc9a7370f8376,2,0,19,19,19,0,0,0,5,414,2,2,0.981940787,670,2,912,42,49,53,4,4229,4325,96,34,36,2,1,100,NoArch
33a48bf65b32d599c7ff06b3a81feb6001512c27,1,21,0,21,21,0,0,0,2,428,1,1,0,204,1,913,43,25,23,2,1422,1261,161,6,6,0,1,100,NoArch
7dfc16e9620ef53ad98bebed523d5986e2749814,11,316,492,176,808,4,5,9,2,669,1,4,3.392703396,492,1,914,44,17,26,9,1059,2048,989,13,17,4,1,99.86579183,NoArch
cb47c8b0adfa5181e6ce54d37bd6981c880247e3,1,3,0,3,3,0,0,0,6,447,1,1,0,211,2,915,45,19,19,0,1010,987,23,7,7,0,1,99.86510791,NoArch
39a2b2dfb93ee3662d9692da81d30756e8035a44,4,6,2,4,8,0,0,0,22,534,1,4,1.905639062,1521,1,916,46,277,276,1,9329,9318,11,89,89,0,1,100,NoArch
6ff1659d383915fc97b666d8ddca7e3133e4d07d,3,178,0,178,178,3,0,3,1,0,1,3,1.543854733,0,1,917,47,11,0,11,553,0,553,8,0,8,1,99.95482608,NoArch
946e34203cc289d9a2c8b466886b31686235c2f7,0,0,0,0,0,0,0,0,0,0,0,0,0,0,0,918,48,0,0,0,0,0,0,0,0,0,0,100,NoArch
998fabf9def66e795c8ac7d8230a49373053d2d5,3,3,10,7,13,0,0,0,13,433,1,3,1.548580607,460,2,222,2,64,66,2,2085,2118,33,30,32,2,0,99.99498345,NoArch
323a656a91e3877251b00d81b04736755ef6e9f6,2,27,44,17,71,0,0,0,11,534,1,1,0.935940715,475,2,919,41,33,38,5,1363,1445,82,14,17,3,1,100,NoArch
cafa2d749023e32861aa29a285c77bdbe88de2cb,2,90,0,90,90,0,0,0,4,841,1,1,0.088072259,535,1,920,42,14,13,1,3581,3071,510,12,11,1,1,100,NoArch
cb104f9da0e27b09b568cf485a427a7d0cf57f9f,2,5,10,5,15,0,0,0,27,140,1,1,0.970950594,720,4,921,43,139,140,1,2883,2893,10,104,106,2,0,100,NoArch
8262c8087db80c7abebb6cd10b2f926b5a63ecc9,1,1,1,0,2,0,0,0,20,19,1,1,0,611,2,922,44,104,104,0,2803,2803,0,11,11,0,1,100,NoArch
ef009a7181a8a13d00453baf1e2b2ace5e839f94,10,611,447,164,1058,3,0,3,21,58,1,3,2.568251262,1638,2,223,3,225,216,9,9714,8986,728,89,90,1,0,97.08622493,Arch
c1cfeced3a061df0835a3b1a9b06fd5fb98490b9,1,41,0,41,41,0,0,0,7,12,1,1,0,309,2,224,4,69,59,10,2237,1951,286,13,12,1,0,100,NoArch
0a362e56ab6de1c2dece6192cfe367a3d1949469,1,1,0,1,1,0,0,0,9,438,1,1,0,671,2,2,0,106,106,0,4348,4343,5,33,33,0,1,100,NoArch
c246154abb00e821d36cc1903801e6ca09335afc,3,9,7,2,16,0,0,0,22,0,1,2,1.579434003,861,3,225,5,150,150,0,5351,5342,9,37,36,1,0,100,NoArch
c85e6710b4790999d7fd88a663c39fabb52746cd,0,0,0,0,0,0,0,0,0,0,0,0,0,0,0,226,6,0,0,0,0,0,0,0,0,0,0,100,NoArch
7e59b9271edff7f06dd81987ead69a58060a3056,7,177,42,135,219,1,0,1,10,158,3,4,1.819737702,973,1,923,45,118,102,16,6333,5542,791,39,31,8,1,99.98193315,NoArch
7b609fa004bae7d6c5d609fe81e703dded6c5759,2,19,2,17,21,0,0,0,2,1592,2,2,0.863120569,381,1,924,46,41,39,2,857,818,39,24,23,1,1,100,NoArch
91ee98c3c1aeddaa53577c7fea4dbf62cbdedfab,3,22,6,16,28,0,0,0,23,420,1,1,1.357130501,674,1,925,47,111,108,3,3816,3699,117,36,35,1,1,100,NoArch
a10a20ea6f27bccc903170f75d1992be881d8474,2,6,3,3,9,0,0,0,16,168,2,2,0.99107606,400,1,926,48,61,59,2,2496,2458,38,13,13,0,1,100,NoArch
db878c9056894f45f88e6cc9fc1ab5978e55039a,0,0,0,0,0,0,0,0,0,0,0,0,0,0,0,227,7,0,0,0,0,0,0,0,0,0,0,100,NoArch
761b2a963b6fef46c8f3a3acd896b28433f8c860,0,0,0,0,0,0,0,0,0,0,0,0,0,0,0,927,49,0,0,0,0,0,0,0,0,0,0,100,NoArch
3d406b45ad133be9dfe3f6c033466a7665210d4f,0,0,0,0,0,0,0,0,0,0,0,0,0,0,0,928,50,0,0,0,0,0,0,0,0,0,0,100,NoArch
1762cbb4a84d7a9500ea444dd5c4e07b74671caf,1,9,0,9,9,1,0,1,1,0,1,1,0,0,1,929,51,0,0,0,32,0,32,0,0,0,0,99.99096658,NoArch
6f027af4de08444c49a12bfadf083616b3cec8c9,0,0,0,0,0,0,0,0,0,0,0,0,0,0,0,930,52,0,0,0,0,0,0,0,0,0,0,100,NoArch
86e8240ef9e390f04691fcfeb4bd967c20266cf8,0,0,0,0,0,0,0,0,0,0,0,0,0,0,0,931,53,0,0,0,0,0,0,0,0,0,0,100,NoArch
be378460ab0c43053e399379d727aaaa7e3ee1c5,0,0,0,0,0,0,0,0,0,0,0,0,0,0,0,932,54,0,0,0,0,0,0,0,0,0,0,100,NoArch
bcbe22c2e83dfb84d185742c36ffcb2b951276c5,0,0,0,0,0,0,0,0,0,0,0,0,0,0,0,933,55,0,0,0,0,0,0,0,0,0,0,100,NoArch
95d9dfca2e9862c10e364a0c6ad983c93fe27a88,0,0,0,0,0,0,0,0,0,0,0,0,0,0,0,934,56,0,0,0,0,0,0,0,0,0,0,100,NoArch
69565e2ae13942c34b5e3919ea1c4585ff1172e2,0,0,0,0,0,0,0,0,0,0,0,0,0,0,0,935,57,0,0,0,0,0,0,0,0,0,0,100,NoArch
82d2344bff42aab96c1075be36d83cae1b614b39,0,0,0,0,0,0,0,0,0,0,0,0,0,0,0,1430,34,0,0,0,0,0,0,0,0,0,0,100,NoArch
eada27952b9e6e82ba6cd30a57b8e297dda75fb7,0,0,0,0,0,0,0,0,0,0,0,0,0,0,0,1430,34,0,0,0,0,0,0,0,0,0,0,100,NoArch
490f39f0f3e3bb7fd26158ba36a25565c4a839ed,1,105,57,48,162,0,0,0,10,693,1,1,0,0,3,26,1,54,0,54,2750,0,2750,24,0,24,1,100,NoArch
e03eb83daccde81d8c2e7405dab088422a4c2f22,1,6,3,3,9,0,0,0,60,19,1,1,0,0,7,27,2,321,0,321,8786,0,8786,71,0,71,1,100,NoArch
9cc56f5391c43a07e90a9add3c041340982670f0,0,0,0,0,0,0,0,0,0,0,0,0,0,0,0,26,1,0,0,0,0,0,0,0,0,0,1,100,NoArch
90c3689729c15d94e548c90f55e6488a165552ab,17,710,121,589,831,12,0,12,27,122,3,7,3.595865256,0,1,382,10,420,0,420,15369,0,15369,116,0,116,1,99.88289419,NoArch
0294c9c15412f181fe6c2ae9d727fb61044369be,1,1,1,0,2,0,0,0,4,2,1,1,0,0,1,383,11,24,0,24,925,0,925,12,0,12,1,100,NoArch
554e705ff432b6b1dba8abb8601641c0c8ff6b38,5,238,5,233,243,3,0,3,5,0,2,3,1.860009069,0,1,384,12,61,0,61,2613,0,2613,31,0,31,1,99.96658731,NoArch
74c91868f03afe21bba7b94e2e44aba6833fd5ec,2,1,5,4,6,1,0,1,31,198,1,1,0.650022422,0,2,18,0,393,0,393,12829,0,12829,65,0,65,1,100,NoArch
0de3ced3db86655fa66472070fc944f3f07e4d19,20,122,944,822,1066,0,12,12,26,60,3,7,3.861246845,738,0,18,0,361,63,298,13106,2632,10474,87,35,52,1,99.85364834,NoArch
744dcdcc69f3e9a802f8ef674955cd5780e5da55,23,1030,124,906,1154,17,0,17,27,124,3,10,4.048369428,0,1,1431,30,549,0,549,21213,0,21213,160,0,160,1,99.85364834,NoArch
127167629f039cee1dc9380b2fb227f938fe5249,20,122,944,822,1066,0,12,12,26,60,3,7,3.861246845,738,0,1431,30,361,63,298,13106,2632,10474,87,35,52,1,99.85364834,NoArch
ee3a16818ba85b388213e73ba76460a5fa2ee008,33,1525,138,1387,1663,24,0,24,27,429,4,13,4.501545193,0,1,1432,31,618,0,618,22942,0,22942,214,0,214,0,99.71158669,NoArch
26328e22efcef035910cca333d3e532e11df7ead,49,2530,2951,421,5481,0,0,0,48,1590,4,26,4.916662684,0,3,268,3,3869,0,3869,133635,0,133635,1057,0,1057,0,100,NoArch
0032edbe754df56d47da125944612af8bca46278,2,51,40,11,91,0,0,0,13,0,1,2,0.832332269,0,2,269,4,92,0,92,3617,0,3617,52,0,52,0,100,NoArch
9538b165e4d58af016b494e70eda49d71e22f1cd,1,6,0,6,6,1,0,1,6,0,1,1,0,0,2,270,5,24,0,24,1818,0,1818,18,0,18,0,100,NoArch
30b7ccb98eb0fdd720a1b2a20d7c865f570dad20,0,0,0,0,0,0,0,0,0,0,0,0,0,0,0,271,6,0,0,0,0,0,0,0,0,0,0,100,NoArch
65cd319a6b07c9be6dfd8bd76ba993a91f62cb88,3,13,52,39,65,0,0,0,49,0,2,3,1.520233418,0,6,272,7,824,0,824,22799,0,22799,184,0,184,0,100,NoArch
37736a09ae5e900f03b17f45a398ce11b827652c,1,7,7,0,14,0,0,0,10,0,1,1,0,0,2,273,8,114,0,114,2943,0,2943,31,0,31,0,100,NoArch
38bb94a599abd8a1eb2cf8a7fa5d4af0a55d9f5d,1,0,9,9,9,0,0,0,11,0,1,1,0,0,2,274,9,112,0,112,2894,0,2894,30,0,30,0,100,NoArch
1e60b389d163ed2919673fd5858758ab93484d32,1,3,1,2,4,0,0,0,3,790,1,1,0,0,2,275,10,3,0,3,358,0,358,3,0,3,0,100,NoArch
b35dc1f7dae5de2f81cbf49e3548544c1ae6042d,1,0,2,2,2,0,0,0,4,0,1,1,0,0,2,276,11,3,0,3,340,0,340,3,0,3,0,100,NoArch
b59df6d59d048e5d944efc20370c71a949c9fd32,3,7,2,5,9,1,0,1,10,0,1,3,1.530493057,0,3,277,12,429,0,429,15206,0,15206,97,0,97,0,100,NoArch
abd5ca15d25b1362f134a3182bf34dc7c6d41793,1,7,7,0,14,0,0,0,6,0,1,1,0,0,3,278,13,88,0,88,2698,0,2698,21,0,21,0,100,NoArch
8c1f81d1732c67ed29cb0fb8e1c6f50d8a9abe26,3,189,192,3,381,0,0,0,35,507,1,3,1.132312086,0,2,279,14,310,0,310,15968,0,15968,110,0,110,0,100,NoArch
f1bc43b26ad914cbf80661d586cc35c20e40283c,2,13,10,3,23,0,0,0,27,97,1,2,0.666578358,0,2,280,15,418,0,418,13929,0,13929,115,0,115,0,100,NoArch
137b2ff1386ef37c71487c8ac24d27d71ffdd6e4,2,4,4,0,8,0,0,0,50,0,1,2,0.811278124,0,6,281,16,746,0,746,21689,0,21689,163,0,163,0,100,NoArch
d5fe3f01f2d24ef9521811150485fcec6da91d29,8,26,78,52,104,0,0,0,12,339,2,2,2.603936659,0,2,282,17,290,0,290,11486,0,11486,99,0,99,0,100,NoArch
5d58f5e5fa692775b7fe757e648bdee60dc7b7e2,2,4,6,2,10,0,0,0,4,0,1,1,0.721928095,0,2,283,18,110,0,110,3946,0,3946,18,0,18,0,100,NoArch
06e4cd9198e2a7648146b858710c8aa8bfe00d38,3,33,35,2,68,0,0,0,8,115,1,2,0.450352214,0,2,284,19,94,0,94,4825,0,4825,36,0,36,0,100,NoArch
0907d71b6417fa0e4065c142f20c1eea8205bc53,1,0,1,1,1,0,0,0,12,0,1,1,0,0,2,285,20,112,0,112,2883,0,2883,30,0,30,0,100,NoArch
0c0183e8a919f3565d44c734df77b5a79059ef38,0,0,0,0,0,0,0,0,0,0,0,0,0,0,0,286,21,0,0,0,0,0,0,0,0,0,1,100,NoArch
1ddf1b875c12c52fbcc649cde1f2f1ba5951a366,0,0,0,0,0,0,0,0,0,0,0,0,0,0,0,287,22,0,0,0,0,0,0,0,0,0,1,100,NoArch
a085d59c0d495cc8c82141e1ac67b34065202caa,0,0,0,0,0,0,0,0,0,0,0,0,0,0,0,1433,27,0,0,0,0,0,0,0,0,0,0,100,NoArch
06ad1ba48ec34ea44b14266a687bc946743cb135,2,20,1,19,21,1,0,1,16,106,1,2,0.791858353,0,3,1434,28,287,0,287,8243,0,8243,58,0,58,1,100,NoArch
8e89bb7c10802168bca10e99a73c592dccde302a,89,3460,4343,883,7803,1,17,18,47,243,5,44,5.723614562,1192,1,1432,26,4937,106,4831,178753,3884,174869,1377,78,1299,1,99.71158669,NoArch
b3b631f8a0d347ca07d8737cfdbad9de0cc9c1c6,89,4348,3465,883,7813,24,0,24,50,734,5,44,5.722406298,0,2,288,23,5023,0,5023,181243,0,181243,1457,0,1457,1,99.71158669,NoArch
35ef1f3883c99ff2fd0fcadb6291c1d973eba926,0,0,0,0,0,0,0,0,0,0,0,0,0,0,0,1435,29,0,0,0,0,0,0,0,0,0,0,100,NoArch
96445d28d141ab8b030dee9fb2fad4af35addba1,3,24,5,19,29,0,0,0,10,6,1,2,1.073551999,0,1,1436,30,100,0,100,3364,0,3364,23,0,23,0,100,NoArch
8f397b68d35a30ba41648ee5c02abf451477a849,1,7,3,4,10,0,0,0,15,254,1,1,0,0,4,1437,31,105,0,105,2627,0,2627,42,0,42,0,100,NoArch
0a0c1cbdb4e2d85d16da2a36904df26a19ef32c3,1,10,0,10,10,1,0,1,8,39,1,1,0,0,2,1438,32,8,0,8,871,0,871,5,0,5,0,100,NoArch
2a24578022f52d050b3901e8087e0e393cda8aef,81,3452,3803,351,7255,0,12,12,47,315,5,42,5.560174708,738,1,1433,27,5025,63,4962,180817,2632,178185,1408,35,1373,0,99.85375841,NoArch
3e8e2f4f511789985647fcfb160b4e81b919ce27,3,24,5,19,29,0,0,0,10,0,1,2,1.073551999,0,1,1434,28,100,0,100,3364,0,3364,23,0,23,0,100,NoArch
f9edf28f116716f5f7fd2ac15f3d17db3d95d381,1,7,3,4,10,0,0,0,15,254,1,1,0,0,4,1435,29,105,0,105,2627,0,2627,42,0,42,0,100,NoArch
c8a4852ad9fe67f48a0350e015e201e391a7d977,1,10,0,10,10,1,0,1,8,39,1,1,0,0,2,1436,30,8,0,8,871,0,871,5,0,5,0,100,NoArch
9676af058261fca3dc0c83a735b03c4c608d9918,77,3771,3452,319,7223,15,0,15,50,695,5,39,5.530002504,0,2,1439,33,4850,0,4850,174830,0,174830,1372,0,1372,0,99.85375841,NoArch
9e406dc5cba78b1581d92f72a030664ccd39b24e,76,3444,3762,318,7206,0,12,12,47,268,5,38,5.525449415,738,1,1437,31,4817,63,4754,174197,2632,171565,1340,35,1305,0,99.85375841,NoArch
832db56a8c9683bd85f6b43d80580f042cc525c3,77,3786,3464,322,7250,15,0,15,50,726,5,39,5.541380364,0,2,19,1,4880,0,4880,175825,0,175825,1377,0,1377,1,99.85375841,NoArch
b64e2f2aa2a7e2dbaa565c869478a635f062d9bb,76,3444,3762,318,7206,0,12,12,47,268,5,38,5.525449415,738,1,19,1,4817,63,4754,174197,2632,171565,1340,35,1305,1,99.85375841,NoArch
5876a799d21dc4332f75a9a8a1d655d33bdba333,76,3767,3449,318,7216,15,0,15,50,695,5,38,5.52425678,0,2,1440,28,4844,0,4844,174637,0,174637,1369,0,1369,0,99.85375841,NoArch
ddd41bea697b68d394615e5e35e0b46cca943450,3,240,19,221,259,2,0,2,61,5,1,2,1.486576277,0,1,1441,29,332,0,332,9475,0,9475,77,0,77,1,99.97914146,NoArch
a6ad147d1fb6748951d619d458742d7d1ad74bb0,79,3463,4002,539,7465,0,14,14,60,252,5,40,5.602737175,867,1,1438,26,5138,66,5072,182983,3030,179953,1411,38,1373,0,99.83290166,NoArch
349521707bca39afd449e664fcfe8308e3cfa4ee,3,240,19,221,259,2,0,2,61,5,1,2,1.486576277,0,1,1439,27,332,0,332,9475,0,9475,77,0,77,1,99.97908387,NoArch
fd7a44f717f8030a88e049b10d77b435c418431f,76,3768,3450,318,7218,15,0,15,51,695,5,38,5.524108922,0,2,1442,26,4844,0,4844,174638,0,174638,1369,0,1369,1,99.85381949,NoArch
b846e7c2987bb33eb7d2753a50442f026f0f40ba,76,3444,3762,318,7206,0,12,12,48,268,5,38,5.525449415,738,1,1440,24,4817,63,4754,174198,2632,171566,1340,35,1305,1,99.85381949,NoArch
878746ab8a666334a33628195b52245ebeabbc2d,77,3781,3457,324,7238,15,0,15,51,704,5,39,5.537260388,0,2,1443,27,4882,0,4882,176176,0,176176,1380,0,1380,1,99.85381949,NoArch
1b82180269b8f3d03bf4a6d4c1c5b24f68310ec6,76,3444,3762,318,7206,0,12,12,48,268,5,38,5.525449415,738,1,1441,25,4817,63,4754,174198,2632,171566,1340,35,1305,1,99.85381949,NoArch
c4215e1c7c3dc35005e913e5c6a994c48019fc3e,76,3767,3449,318,7216,15,0,15,51,695,5,38,5.52425678,0,2,43,1,4844,0,4844,174638,0,174638,1369,0,1369,1,99.85381949,NoArch
a9906aca33b2f78710e344b3a82c90a3c68952ea,76,3444,3762,318,7206,0,12,12,48,268,5,38,5.525449415,738,1,43,1,4817,63,4754,174198,2632,171566,1340,35,1305,1,99.85381949,NoArch
fc67705036e160150774b008136dd8ac22faaffb,0,0,0,0,0,0,0,0,0,0,0,0,0,0,0,101,0,0,0,0,0,0,0,0,0,0,0,100,NoArch
79b4284ca030d868f1594d66cb747aca13fc5ffd,81,3792,3457,335,7249,18,0,18,51,660,5,41,5.55005072,0,2,1444,16,5045,0,5045,181683,0,181683,1416,0,1416,1,99.85381949,NoArch
c5e93cd7b325dc6fa56a4ff4ec7cb1718f14a3a3,76,3444,3762,318,7206,0,12,12,48,268,5,38,5.525449415,738,1,1442,14,4817,63,4754,174198,2632,171566,1340,35,1305,1,99.85381949,NoArch
e3155819dafe194b0e06e82a3062043181779ecd,0,0,0,0,0,0,0,0,0,0,0,0,0,0,0,1443,15,0,0,0,0,0,0,0,0,0,1,100,NoArch
40f12a580024cb32f7674bd619648d343ca03f42,77,3769,3453,316,7222,15,0,15,51,691,5,39,5.529367048,0,2,1445,17,4949,0,4949,177250,0,177250,1411,0,1411,0,99.85381949,NoArch
881410d4dbea4934b7167d2478570406505b251f,76,3444,3762,318,7206,0,12,12,48,268,5,38,5.525449415,738,1,1444,16,4817,63,4754,174198,2632,171566,1340,35,1305,0,99.85381949,NoArch
373dcf15d00663b88246f9878076208b11722e73,76,3767,3449,318,7216,15,0,15,51,695,5,38,5.52425678,0,2,1446,18,4844,0,4844,174638,0,174638,1369,0,1369,0,99.85381949,NoArch
2f6fe3d8dd48e8e3de4d36b45eb65e5d55e48537,76,3444,3762,318,7206,0,12,12,48,268,5,38,5.525449415,738,1,1445,17,4817,63,4754,174198,2632,171566,1340,35,1305,0,99.85381949,NoArch
a39a06851e77325e5021f4747581fd2664cb1047,77,3805,3475,330,7280,15,0,15,51,701,5,39,5.548360523,0,2,289,21,4895,0,4895,175822,0,175822,1412,0,1412,0,99.85381949,NoArch
a8f8785460845ae534d3cf7865820d48ed42644e,15,114,141,27,255,0,0,0,7,1588,2,15,3.301110341,0,2,290,22,80,0,80,7949,0,7949,57,0,57,0,100,NoArch
5bd9cf5962701ab82e0fc4ead9053b0838e51eca,5,5,5,0,10,0,0,0,3,2042,1,2,2.321928095,0,2,21,0,0,0,0,381,0,381,0,0,0,0,100,NoArch
623d4dad4a6aed53cc35c115f41ac21f16b09909,1,126,62,64,188,0,0,0,17,519,1,1,0,0,4,20,2,106,0,106,3453,0,3453,13,0,13,1,100,NoArch
22aaf630add2abc749c00ce70dd647cb54a1cd94,97,3616,3919,303,7535,0,12,12,48,276,6,55,5.697022115,738,1,20,2,4947,63,4884,183925,2632,181293,1439,35,1404,1,99.85381949,NoArch
5e5f102527e107602b1590c1842a9d7cb77226b8,98,3925,3622,303,7547,15,0,15,51,879,6,56,5.69776098,0,2,1447,19,5148,0,5148,190316,0,190316,1525,0,1525,1,99.85381949,NoArch
e437212b358551387caf79aeee62f97c888d1841,97,3616,3919,303,7535,0,12,12,48,276,6,55,5.697022115,738,1,1446,18,4947,63,4884,183925,2632,181293,1439,35,1404,1,99.85381949,NoArch
54dc8595fefc2c66492e6a51ca1fba624f30f6d8,98,3930,3623,307,7553,15,0,15,51,886,6,56,5.701701556,0,2,1448,20,4992,0,4992,184741,0,184741,1473,0,1473,0,99.85381949,NoArch
afc70f0cdb24d934133bb72e291e9220357ff5cf,97,3616,3919,303,7535,0,12,12,48,276,6,55,5.697022115,738,1,1447,19,4947,63,4884,183925,2632,181293,1439,35,1404,0,99.85381949,NoArch
93b280e2353cc9477db7918c06812c30443ea071,97,3924,3621,303,7545,15,0,15,51,899,6,55,5.695739395,0,2,28,3,4975,0,4975,184152,0,184152,1469,0,1469,0,99.85381949,NoArch
6130fc80c2b3eca16b1efc27af3a0924cc75b0f1,97,3616,3919,303,7535,0,12,12,48,276,6,55,5.697022115,738,1,27,2,4947,63,4884,183925,2632,181293,1439,35,1404,0,99.85381949,NoArch
8aa2857dfb2a04431461f75eb1338da3a8df7776,98,3931,3626,305,7557,15,0,15,51,879,6,56,5.703749629,0,2,29,3,5191,0,5191,189371,0,189371,1518,0,1518,1,99.85381949,NoArch
0e19e0da56af879177b67341f6f2e7ab4852618a,97,3616,3919,303,7535,0,12,12,48,276,6,55,5.697022115,738,1,28,2,4947,63,4884,183925,2632,181293,1439,35,1404,1,99.85381949,NoArch
e3818e3cce49fe9e26623eb74b9e68d3f8253bbb,97,3924,3621,303,7545,15,0,15,51,899,6,55,5.695739395,0,2,30,4,4975,0,4975,184152,0,184152,1469,0,1469,0,99.85381949,NoArch
6ec2147cd489b2f0482007f45b181d2755638d0b,97,3616,3919,303,7535,0,12,12,48,276,6,55,5.697022115,738,1,29,3,4947,63,4884,183925,2632,181293,1439,35,1404,0,99.85381949,NoArch
45d7caf561bb648e66d05266e015a1aa13d410c6,99,3948,3622,326,7570,16,0,16,51,876,6,57,5.710654035,0,2,385,4,5269,0,5269,195763,0,195763,1633,0,1633,1,99.85381949,NoArch
a940ecfe3d480f4e596023a0cf59ca9771a69cc3,97,3616,3919,303,7535,0,12,12,48,276,6,55,5.697022115,738,1,382,1,4947,63,4884,183925,2632,181293,1439,35,1404,1,99.85381949,NoArch
0d5fd8de5fbae92c9be08679dadb98624d3d662e,101,3967,3631,336,7598,17,0,17,51,919,6,58,5.727278442,0,2,44,1,5134,0,5134,194371,0,194371,1554,0,1554,1,99.85381949,NoArch
4fdb81a1284bdc9a7b3b167238c191bf8b234bd7,97,3616,3919,303,7535,0,12,12,48,276,6,55,5.697022115,738,1,44,1,4947,63,4884,183925,2632,181293,1439,35,1404,1,99.85381949,NoArch
da48ab7ad2a754d0cfb89a4aed3201e007fd6aa5,99,3988,3623,365,7611,16,0,16,51,882,6,57,5.724665243,0,2,27,0,5124,0,5124,189715,0,189715,1512,0,1512,1,99.84126321,NoArch
b7f5988a2cf2b14cde961e9c2bd26723e1d78c1a,0,0,0,0,0,0,0,0,0,0,0,0,0,0,0,45,2,0,0,0,0,0,0,0,0,0,1,100,NoArch
a8bbe0d9cbae607c0f07e7e69d9d24e4194c3232,99,3618,3983,365,7601,0,12,12,48,284,6,57,5.725958339,738,1,45,2,5084,63,5021,189078,2632,186446,1476,35,1441,1,99.84126321,NoArch
8b7048815a3c1acfd24729d0a3ad08a95358050b,100,3989,3624,365,7613,16,0,16,51,878,6,58,5.726665004,0,2,386,1,5164,0,5164,191250,0,191250,1534,0,1534,1,99.84126321,NoArch
4e4347b369f640cb57d9baaa7ef22d0940646169,99,3618,3983,365,7601,0,12,12,48,284,6,57,5.725958339,738,1,383,1,5084,63,5021,189078,2632,186446,1476,35,1441,1,99.84126321,NoArch
4263b9643f46d4f953d863ef247c72399dea879e,103,4036,3657,379,7693,16,0,16,51,861,6,59,5.764749864,0,2,387,2,5283,0,5283,196427,0,196427,1566,0,1566,1,99.84126321,NoArch
73893822e5a7e44b3df0a2f7e89d603ddbe1160f,99,3618,3983,365,7601,0,12,12,48,284,6,57,5.725958339,738,1,384,2,5084,63,5021,189078,2632,186446,1476,35,1441,1,99.84126321,NoArch
28895e691068335d396846db5380fd3a96b9ead9,109,4307,3629,678,7936,21,0,21,51,816,6,60,5.859065009,0,2,28,1,5510,0,5510,201525,0,201525,1600,0,1600,1,99.7954071,NoArch
546b23b1fc37e445f0b47f857ba68e0a404132cb,89,3502,3358,144,6860,0,5,5,48,339,6,53,5.512900496,233,1,30,3,5077,13,5064,186410,835,185575,1465,9,1456,1,99.94162532,NoArch
b4ea5dfe03137b61ed244a49a31e29f337f3adec,89,3363,3507,144,6870,6,0,6,51,993,6,53,5.511562802,0,2,291,2,5071,0,5071,185189,0,185189,1474,0,1474,0,99.94162532,NoArch
ea1184f3afe2abd2339a8a167b8fe9f978b863c5,88,3500,3294,206,6794,0,5,5,48,332,6,52,5.485074119,233,1,27,0,5073,13,5060,185720,835,184885,1460,9,1451,1,99.95412653,NoArch
8d7f53a296ee99b8b809f2cf0c7b500802f233eb,11,319,6,313,325,6,0,6,26,277,2,4,3.086111059,0,1,28,1,519,0,519,16273,0,16273,120,0,120,1,99.95412653,NoArch
c30e01d94a20a842a01f68dc3c74f9ee6e37616f,77,2980,3499,519,6479,0,0,0,51,1119,5,48,5.313297401,0,2,292,3,4536,0,4536,167816,0,167816,1343,0,1343,0,100,NoArch
be69022ce3eef7ffe80633f19e7bdb71a4bf8e12,4,100,44,56,144,1,0,1,4,1192,2,2,1.704500694,0,2,293,4,26,0,26,1838,0,1838,23,0,23,1,98.49524815,NoArch
31ac0d6a6c37cb6bbf919bc3cb5c506501a441b3,1,0,4,4,4,0,0,0,2,0,1,1,0,0,1,294,5,5,0,5,123,0,123,5,0,5,0,100,NoArch
772ee3cdacf864e22bba5a250204a69273f94eab,9,209,185,24,394,0,0,0,33,576,3,7,2.303134071,0,1,295,6,506,0,506,17290,0,17290,144,0,144,2,99.95805565,NoArch
71670558800f1bbdd779736628c6d706d1f61f0f,0,0,0,0,0,0,0,0,0,0,0,0,0,0,0,296,7,0,0,0,0,0,0,0,0,0,0,100,NoArch
5bebdc553a06af20cf7371bfedb55e342e15b97e,2,22,1,21,23,1,0,1,2,70,2,2,0.987692509,0,1,388,3,20,0,20,730,0,730,8,0,8,1,99.98601268,NoArch
ccee0cf53ff7ff0f61de3f36c0fb31ae66672826,87,3722,3279,443,7001,0,0,0,48,348,6,53,5.509440417,-4,1,385,3,4926,5,4921,183503,123,183380,1464,5,1459,1,98.45503763,NoArch
feab0b09b7191e3e62782256f7fcb6df4a0cdc04,88,3286,3730,444,7016,1,0,1,51,1065,6,54,5.512729211,0,2,1449,0,4882,0,4882,180904,0,180904,1464,0,1464,0,98.45503763,NoArch
999bb5d82e2ecc2bfc237616e6a5ae8964b8d03b,0,0,0,0,0,0,0,0,0,0,0,0,0,0,0,101,0,0,0,0,0,0,0,0,0,0,1,100,NoArch
7b7318267215c7458b2cdd55254a4fc9d2ff2eba,88,3725,3281,444,7006,0,1,1,48,345,6,54,5.513997358,61,1,102,0,4931,5,4926,183774,123,183651,1467,5,1462,1,98.45503763,NoArch
a3aa366b224f708ccdb2a661480f4e5c6bfae3d9,89,3287,3743,456,7030,1,0,1,51,1058,6,55,5.522488351,0,2,22,0,4888,0,4888,181533,0,181533,1470,0,1470,0,98.45503763,NoArch
ab42429b803dad529dce1cd53cf4978e18cc3576,1,0,14,14,14,0,0,0,4,0,1,1,0,0,3,23,1,5,0,5,537,0,537,5,0,5,0,100,NoArch
3774aed54e1991f9943a4da0027f4cec9a2e992f,1,27,1,26,28,0,0,0,5,2,1,1,0,0,3,24,2,7,0,7,708,0,708,7,0,7,0,100,NoArch
4cfb7c15bf39924721e6978487c0154f9d2f69e8,1,14,25,11,39,0,0,0,6,0,1,1,0,0,3,25,3,9,0,9,601,0,601,9,0,9,0,100,NoArch
586cbda3064604ef16630d3f7d33f8dda5551d4c,1,20,4,16,24,0,0,0,11,1617,1,1,0,0,2,389,3,53,0,53,1582,0,1582,17,0,17,0,100,NoArch
7bf030d96adbee025a75d2f74dc1b4a81eccb4c9,89,3758,3303,455,7061,0,1,1,48,352,6,55,5.536799352,61,1,386,3,4938,5,4933,184482,123,184359,1474,5,1469,0,98.45503763,NoArch
685ee056a0812b9b32b4af9d89a5a0baf8d7bc77,90,3301,3756,455,7057,1,0,1,51,1049,6,56,5.533843588,0,2,390,4,4944,0,4944,183087,0,183087,1490,0,1490,0,98.45503763,NoArch
bb64811bcb04934aaf8e173b3c0212d383d934be,89,3758,3303,455,7061,0,1,1,48,352,6,55,5.536799352,61,1,387,4,4938,5,4933,184482,123,184359,1474,5,1469,0,98.45503763,NoArch
a17e946ac8a0fe3c9e70285fd7d7446c164952f0,90,3306,3757,451,7063,1,0,1,51,1057,6,56,5.538114553,0,2,1450,1,4906,0,4906,182012,0,182012,1475,0,1475,1,98.45503763,NoArch
e2192fbaaed6858682ca53dc71080c882111ee8d,0,0,0,0,0,0,0,0,0,0,0,0,0,0,0,1451,2,0,0,0,0,0,0,0,0,0,0,100,NoArch
0b0a4d3652d6417ebc84eb572807f873ac4b3cab,89,3734,3271,463,7005,0,1,1,48,352,6,55,5.518754281,61,1,1448,0,4902,5,4897,183807,123,183684,1434,5,1429,0,98.45503763,NoArch
e7efcb540f01dd0d02e0bb0c0b8be1f168654913,15,114,141,27,255,0,0,0,7,1645,2,15,3.301110341,0,1,1449,1,80,0,80,7949,0,7949,57,0,57,0,100,NoArch
822926d70eacaa173d0d5fb141b5e84a40439c67,5,5,5,0,10,0,0,0,3,2094,1,2,2.321928095,0,1,1450,2,0,0,0,381,0,381,0,0,0,0,100,NoArch
33dc84cf0c56c30c18476d1749e2582e5257a4b9,70,3170,3590,420,6760,1,0,1,51,869,5,40,5.36722896,0,2,391,5,5001,0,5001,178920,0,178920,1417,0,1417,0,98.45503763,NoArch
0598b5971d19d5d2bf654b63abaa4e7628d93682,69,3588,3152,436,6740,0,1,1,48,358,5,39,5.356900018,61,1,388,5,4822,5,4817,175234,123,175111,1377,5,1372,0,98.45503763,NoArch
dc4e5643969f1f42949989cbfacc866baa8a5b4a,0,0,0,0,0,0,0,0,0,0,0,0,0,0,0,1451,3,0,0,0,0,0,0,0,0,0,0,100,NoArch
f02e9917498ab7273f6d844de338dd25561355bd,1,2,3,1,5,0,0,0,2,22,1,1,0,0,2,1452,4,5,0,5,258,0,258,3,0,3,0,100,NoArch
12725d447cfb7d4ff4dc7970fec35df7c9af6986,1,6,2,4,8,0,0,0,4,779,1,1,0,0,1,1453,5,15,0,15,507,0,507,2,0,2,1,100,NoArch
6304274cf4f9abf4f100ad92a5c201f6b47da756,0,0,0,0,0,0,0,0,0,0,0,0,0,0,0,1454,6,0,0,0,0,0,0,0,0,0,0,100,NoArch
aa130888b6699d9af0c1eff6d0504e33103ed7c4,68,3157,3596,439,6753,1,0,1,51,883,5,38,5.357786992,0,2,1452,3,4789,0,4789,172813,0,172813,1389,0,1389,0,98.45503763,NoArch
f0697f65418f5ffaeda82063003373c0739988e4,61,3395,2932,463,6327,0,1,1,48,364,5,34,5.207602723,61,1,1455,7,4490,5,4485,163710,123,163587,1279,5,1274,2,98.45503763,NoArch
b83f1f04f459ebc4b258b5f3d43d46163b882a8d,63,2956,3415,459,6371,1,0,1,69,886,5,35,5.230727579,0,2,392,6,4923,0,4923,175353,0,175353,1373,0,1373,0,98.45503763,NoArch
90ca9de0dbecb7de185910d1ec4c79931a3accaf,61,3395,2932,463,6327,0,1,1,48,364,5,34,5.207602723,61,1,389,6,4490,5,4485,163710,123,163587,1279,5,1274,0,98.45503763,NoArch
3c3cfffabdd241828267f32dbc1fe02326ca39cf,4,92,40,52,132,1,0,1,5,1089,2,2,1.712283704,0,1,1456,8,27,0,27,1940,0,1940,24,0,24,1,98.45503763,NoArch
d6aafd58e064418348eba935a101431746b1dd59,57,2837,3352,515,6189,0,0,0,51,901,5,32,5.126639815,0,2,102,1,4414,0,4414,158906,0,158906,1252,0,1252,0,100,NoArch
87512d847d32b27da55f65941c83a73b41b736e4,57,3355,2840,515,6195,0,0,0,48,358,5,32,5.132704014,0,1,103,1,4463,0,4463,161803,0,161803,1260,0,1260,0,100,NoArch
a3d46d202c8f2db8612b35d9f73c3a262680c99d,58,3063,3352,289,6415,1,0,1,51,879,5,33,5.166005492,0,2,50,0,4442,0,4442,160138,0,160138,1264,0,1264,1,95.44083427,Arch
d223ceecab1ec879c87f179c7f8d3f54f59bb04a,58,3355,3066,289,6421,0,1,1,48,351,5,33,5.171867792,226,1,104,2,4463,28,4435,161803,1232,160571,1260,12,1248,0,95.44083427,Arch
4d74e6b1239808859fd4c948b846cebda7ad9718,58,3063,3352,289,6415,1,0,1,51,879,5,33,5.166005492,0,2,103,2,4442,0,4442,160138,0,160138,1264,0,1264,0,95.44083427,Arch
112f7905e44d49c14ba8ae091ba3176ce3fa7320,3,227,0,227,227,3,0,3,3,613,2,2,0.971583155,0,1,46,1,26,0,26,1320,0,1320,14,0,14,1,99.97998799,NoArch
d7334ad69b34d1c8a45b4fbc379ac82357f6fa81,1,0,1,1,1,0,0,0,2,0,1,1,0,0,1,47,2,12,0,12,753,0,753,8,0,8,0,100,NoArch
558518b551c27f2cc1020fb15dd485076f38556c,0,0,0,0,0,0,0,0,0,0,0,0,0,0,0,104,3,0,0,0,0,0,0,0,0,0,0,100,NoArch
83a0dc1abb5f8021bebaf4beb7d292ac4394af66,61,3355,3292,63,6647,0,2,2,48,352,5,35,5.243199422,288,1,105,3,4472,44,4428,162075,2249,159826,1264,22,1242,0,95.4320403,Arch
9737d5efe887b80a5f62de48e21f40d9d5fd3e7e,64,3388,3363,25,6751,4,0,4,51,835,5,38,5.288710516,0,2,1453,4,4728,0,4728,172263,0,172263,1329,0,1329,2,95.4320403,Arch
98c23ed8f94f8223144c10a90d4cd8f8396ffeb1,62,3367,3165,202,6532,1,1,2,48,342,5,37,5.226401227,226,1,1457,9,4727,28,4699,172776,1232,171544,1315,12,1303,1,95.43889845,Arch
2932ec1a36aedba2d33c7d1b0fd2c56f456d655b,1,0,1,1,1,0,0,0,2,0,1,1,0,0,1,1458,10,12,0,12,753,0,753,8,0,8,0,100,NoArch
5659bf9d365c070a84405cb6c277ee6690a3681b,3,99,11,88,110,0,0,0,22,205,2,3,1.006647721,0,1,1459,11,260,0,260,10814,0,10814,51,0,51,2,100,NoArch
329a01eb8cd00a2f8ad77847839753d341883bda,58,3063,3352,289,6415,1,0,1,51,879,5,33,5.166005492,0,2,1454,5,4442,0,4442,160138,0,160138,1264,0,1264,0,95.43889845,Arch
be61aab79a69a50b9a58d3ca7749914a0b5a3682,58,3355,3066,289,6421,0,1,1,48,351,5,33,5.171867792,226,1,1460,12,4463,28,4435,161803,1232,160571,1260,12,1248,0,95.43889845,Arch
288f295bc5208a99d8cefae0a50df254143f3802,60,3065,3354,289,6419,1,0,1,51,926,6,35,5.170943565,0,2,23,0,4498,0,4498,161995,0,161995,1273,0,1273,0,95.43889845,Arch
babe60e0b51b1f6ad4d003dd0724ae40cddd289d,1,15,24,9,39,0,0,0,13,184,1,1,0,0,2,1455,6,54,0,54,1528,0,1528,15,0,15,0,100,NoArch
a8991e5c450252a6db349d24070cea52607c90f3,59,3379,3081,298,6460,0,1,1,48,345,5,34,5.193833243,226,1,1461,13,4523,28,4495,163361,1232,162129,1277,12,1265,0,95.43889845,Arch
9c5419bd81b97eeeccc2f897a80dfb1538182464,1,15,24,9,39,0,0,0,13,184,1,1,0,0,2,1462,14,54,0,54,1528,0,1528,15,0,15,0,100,NoArch
3a2a39614629bbe1265495ef03caac0e9a0a02c8,63,3254,3503,249,6757,3,0,3,62,856,5,34,5.256768421,0,2,51,1,4826,0,4826,171645,0,171645,1369,0,1369,0,95.43068583,Arch
6a139373568f042d4b70995875fcfc4c8d35cc67,0,0,0,0,0,0,0,0,0,0,0,0,0,0,0,105,4,0,0,0,0,0,0,0,0,0,1,100,NoArch
9aec9340a211715ca69efb5cd2859e80eab20c47,63,3506,3257,249,6763,0,2,2,61,343,5,34,5.262320196,371,1,106,4,4845,42,4803,173194,1691,171503,1362,18,1344,1,95.43068583,Arch
ae2a108a72148ead8fcac3f4b378e6969bc3ee3a,66,3310,3524,214,6834,4,0,4,63,820,5,36,5.288693475,0,2,393,6,5072,0,5072,183393,0,183393,1501,0,1501,1,95.43068583,Arch
227519a779f0f18eca55995dcdc554d174b718ce,63,3506,3257,249,6763,0,2,2,62,344,5,34,5.262320196,371,1,390,6,4846,42,4804,173219,1691,171528,1362,18,1344,1,95.43068583,Arch
3fc21d87708b044d4cdd9fe0770c42c20b21bdaa,64,3270,3511,241,6781,3,0,3,63,849,5,34,5.272078341,0,2,297,6,4903,0,4903,173588,0,173588,1394,0,1394,1,95.43068583,Arch
6d19840a4449162dd849b2c5b0b32615c1db87ea,0,0,0,0,0,0,0,0,0,0,0,0,0,0,0,1456,7,0,0,0,0,0,0,0,0,0,0,100,NoArch
aa0a98dfc0291dc0db906bae509ea3efe233b539,5,130,5,125,135,3,0,3,18,752,2,4,1.970960264,0,3,1457,8,233,0,233,6559,0,6559,59,0,59,1,99.98001199,NoArch
cf3bf35e363b81d52ab755cef203d7555445424f,68,3511,3387,124,6898,1,4,5,62,323,5,38,5.336929742,466,1,1463,15,5065,48,5017,179355,1939,177416,1414,24,1390,1,95.41876371,Arch
d09928281c0d7b412b6445121f42d6761682c7b7,0,0,0,0,0,0,0,0,0,0,0,0,0,0,0,1464,16,0,0,0,0,0,0,0,0,0,0,100,NoArch
1e9c46fe7f852b4f055943d15ca802e679cbe392,5,130,5,125,135,3,0,3,18,752,2,4,1.970960264,0,3,1465,17,233,0,233,6559,0,6559,59,0,59,1,99.97672145,NoArch
c76275f9bb07893c0d729060563ac6f8df1e6091,67,3295,3522,227,6817,6,0,6,63,809,5,36,5.298706665,0,2,1458,9,4910,0,4910,179086,0,179086,1413,0,1413,1,95.43265095,Arch
620c2dc685b23f828bff99d273b72cf44823b1a2,1,0,2,2,2,0,0,0,14,0,1,1,0,0,3,1459,10,20,0,20,857,0,857,6,0,6,0,100,NoArch
3d01de8089ac4763b2677f37fbbd3aafc88e9e9d,1,6,2,4,8,0,0,0,10,758,1,1,0,0,2,394,6,43,0,43,1404,0,1404,13,0,13,0,100,NoArch
ad4e5dd4e51562697fb52404016bc83f8395c002,67,3527,3298,229,6825,1,2,3,62,357,5,36,5.305095566,371,1,391,6,4931,42,4889,180487,1691,178796,1403,18,1385,0,95.43265095,Arch
479d67347ebf28faf80a630f1507d3c3d2fe59f6,68,3297,3529,232,6826,6,0,6,63,788,5,36,5.305846898,0,2,298,6,4985,0,4985,180959,0,180959,1438,0,1438,1,95.43265095,Arch
e6b2a6ccf9d399affc98f42bfd829a99edffba85,65,3513,3259,254,6772,1,2,3,62,349,5,35,5.27095746,371,1,1466,18,4942,42,4900,176012,1691,174321,1393,18,1375,1,95.43265095,Arch
df10f9d635363246aa3c4afde9a723539fd65ad8,1,0,2,2,2,0,0,0,14,0,1,1,0,0,3,1467,19,20,0,20,857,0,857,6,0,6,0,100,NoArch
c214fa542d102e48ce252053c6323df44bb755e4,1,2,5,3,7,0,0,0,10,3,1,1,0,0,2,1468,20,75,0,75,1891,0,1891,25,0,25,1,100,NoArch
68c173e8290cf732fba974799aa285318c520cb8,68,3344,3510,166,6854,5,0,5,63,792,5,37,5.316068673,0,2,395,7,5329,0,5329,186667,0,186667,1536,0,1536,1,95.42073354,Arch
2762c3c652753af2e9b17ce9fb997575d4cb1840,63,3506,3257,249,6763,0,2,2,62,344,5,34,5.262320196,371,1,392,7,4846,42,4804,173219,1691,171528,1362,18,1344,1,95.43461439,Arch
9a3ee480380fa38d26d2e57166669ec350438269,65,3269,3516,247,6785,2,0,2,63,849,5,35,5.277235839,0,2,396,8,4882,0,4882,173284,0,173284,1384,0,1384,1,95.43461439,Arch
5278d4dad9d0015338e11489eb34748a80c3f134,1,0,2,2,2,0,0,0,2,1,1,1,0,0,1,397,9,2,0,2,119,0,119,2,0,2,0,100,NoArch
a8c823b166d2e5518cbd7af04642b43972b9cd07,65,3519,3272,247,6791,0,2,2,62,334,5,35,5.282751908,371,1,393,8,4900,42,4858,174841,1691,173150,1377,18,1359,0,95.43461439,Arch
261d9563351a30ea7f8426e26e73277fb442ef4f,68,3488,3517,29,7005,4,0,4,63,814,5,37,5.354541013,0,2,48,2,5075,0,5075,180507,0,180507,1447,0,1447,1,95.41902799,Arch
ac77b82936807de96c52733bb1a25f0363a603af,65,3519,3272,247,6791,0,2,2,62,334,5,35,5.282751908,371,1,46,0,4900,42,4858,174841,1691,173150,1377,18,1359,1,95.43621858,Arch
2d60da2b30993f858fe414b56f9029c7633aca70,69,3304,3522,218,6826,4,0,4,63,810,5,37,5.309302311,0,2,398,10,5372,0,5372,192219,0,192219,1657,0,1657,1,95.43621858,Arch
5276fab171c1d1f2cd5bfa06c9509de43be5d9d7,65,3519,3272,247,6791,0,2,2,62,334,5,35,5.282751908,371,1,394,9,4900,42,4858,174841,1691,173150,1377,18,1359,1,95.43621858,Arch
e36115cf625d44e5668bf977063449242224ac3c,65,3269,3516,247,6785,2,0,2,63,849,5,35,5.277235839,0,2,1460,11,4882,0,4882,173284,0,173284,1384,0,1384,0,95.43621858,Arch
5b5b82cd2507a941f23e5d644dc7b8f457c7c71f,65,3519,3272,247,6791,0,2,2,62,334,5,35,5.282751908,371,1,1469,21,4900,42,4858,174841,1691,173150,1377,18,1359,0,95.43621858,Arch
2335d25bc98ac08b543e49f1f203cd293d50bf6c,66,3270,3517,247,6787,2,0,2,63,845,5,35,5.279561993,0,2,1461,12,4957,0,4957,175175,0,175175,1409,0,1409,0,95.43621858,Arch
9e6ed6a735e3ad392da177ffe0e95d78978575fb,65,3519,3272,247,6791,0,2,2,62,334,5,35,5.282751908,371,1,1470,22,4900,42,4858,174841,1691,173150,1377,18,1359,0,95.43621858,Arch
af0176307a44011a36c0d74245dffa8e7925afba,67,3375,3591,216,6966,3,0,3,64,849,5,36,5.314625447,0,2,52,2,4894,0,4894,173890,0,173890,1389,0,1389,0,95.40229885,Arch
745f332a22ae7f084c9850ff987714c7d2f88863,3,68,97,29,165,0,0,0,50,99,2,2,0.740372592,0,1,49,3,325,0,325,8694,0,8694,74,0,74,1,98.42973815,NoArch
3b5910f23fbe5a98afbb0701090d9bcd6d5da14f,67,3594,3378,216,6972,0,3,3,62,322,5,36,5.319998809,432,1,47,1,4914,48,4866,175401,1914,173487,1379,20,1359,1,96.41829229,Arch
1c0b2bb06e38d6c222d5fc7fc90022fb04b72972,69,3388,3591,203,6979,5,0,5,64,855,5,38,5.325754221,0,2,399,11,4960,0,4960,175592,0,175592,1414,0,1414,0,96.41829229,Arch
69e87151b095bdd037bc076cdc7d9c9160f412ea,67,3594,3378,216,6972,0,3,3,62,322,5,36,5.319998809,432,1,395,10,4914,48,4866,175401,1914,173487,1379,20,1359,0,96.41829229,Arch
998e645f428490fcc61f7d329d039d92fbc52873,71,3418,3593,175,7011,6,0,6,64,805,5,38,5.344302466,0,2,400,12,4978,0,4978,176387,0,176387,1430,0,1430,0,96.42253392,Arch
ac044b7cb03bf118fd25c1e89030f466b7dd336f,67,3594,3378,216,6972,0,3,3,62,322,5,36,5.319998809,432,1,396,11,4914,48,4866,175401,1914,173487,1379,20,1359,0,96.43607786,Arch
9de6a7bc51767915a9005fc9d1167eac5ae9e599,67,3375,3591,216,6966,3,0,3,64,849,5,36,5.314625447,0,2,1462,13,4894,0,4894,173890,0,173890,1389,0,1389,0,96.43607786,Arch
e1a803950a6e6707e6d313c515db33429c7505fe,7,41,308,267,349,0,2,2,65,788,1,3,2.486584912,129,4,53,3,421,5,416,13653,229,13424,117,3,114,1,98.9736137,NoArch
a8c6cd03697637d87ea4a4b63dd346c1a0ff47f9,3,22,10,12,32,1,0,1,10,807,3,3,0.534954723,0,2,299,2,84,0,84,3273,0,3273,42,0,42,1,100,NoArch
3544f6baad3da0fbb72a9c9645d5db6f6c4d2da1,1,85,56,29,141,0,0,0,11,0,1,1,0,0,3,300,3,44,0,44,1076,0,1076,13,0,13,1,100,NoArch
47ac47d3422340cea6e0de63fc05b439becd0fa0,0,0,0,0,0,0,0,0,0,0,0,0,0,0,0,26,4,0,0,0,0,0,0,0,0,0,0,100,NoArch
61aae798005ecc414b5e1598608c8b707e959a98,0,0,0,0,0,0,0,0,0,0,0,0,0,0,0,27,5,0,0,0,0,0,0,0,0,0,0,100,NoArch
51799a3c4b09170010c1327572682e08cd65d85c,1,5,1,4,6,0,0,0,5,833,1,1,0,0,2,301,4,119,0,119,2897,0,2897,38,0,38,1,100,NoArch
b058cfa2efa82a14bd81d00c144a59d4dce2e3ef,6,792,687,105,1479,4,0,4,66,472,1,1,1.900381672,0,1,54,4,356,0,356,9746,0,9746,96,0,96,1,99.93529901,NoArch
07f0a07a1b45335a700d662dbc9c841b28fc0ea8,3,55,3,52,58,2,0,2,40,12,2,2,1.436879486,0,3,401,12,469,0,469,17209,0,17209,274,0,274,1,100,NoArch
09e7d40ec7a2503d3de320f2e5ac8c68a56ea44e,2,140,2,138,142,0,0,0,11,165,1,2,0.106792032,0,1,1752,21,90,0,90,5059,0,5059,23,0,23,1,100,NoArch
010591e606c8f7f52b0ad0b8fcce3f373c2d08d5,0,0,0,0,0,0,0,0,0,0,0,0,0,0,0,1751,20,0,0,0,0,0,0,0,0,0,1,100,NoArch
426eeb5c6cf17f03e0eca0f4e699511c52e52bf4,3,34,35,1,69,0,0,0,41,154,1,2,0.779625736,0,2,618,10,80,0,80,3011,0,3011,29,0,29,0,100,NoArch
dc672b74ee83319f610d68eefcd58f99ca547ca5,0,0,0,0,0,0,0,0,0,0,0,0,0,0,0,618,10,0,0,0,0,0,0,0,0,0,0,100,NoArch
c81c39e97ad747eb7736e5a5ded40d8f9e5244db,6,77,47,30,124,0,0,0,42,178,1,3,2.045258137,0,2,619,11,131,0,131,4884,0,4884,54,0,54,1,99.99343207,NoArch
ccd53b6060bcd6c71a36185bc7b7e3780c07f7d7,0,0,0,0,0,0,0,0,0,0,0,0,0,0,0,619,11,0,0,0,0,0,0,0,0,0,1,100,NoArch
586de273b7d21358eff47ee705669530da534690,1,11,6,5,17,0,0,0,3,85,1,1,0,0,3,119,10,99,0,99,3724,0,3724,11,0,11,1,100,NoArch
82138894696446693ff84b6f5f6daf5037677c43,0,0,0,0,0,0,0,0,0,0,0,0,0,0,0,109,1,0,0,0,0,0,0,0,0,0,0,100,NoArch
9c4c10343ddcf0b862e45669d0ed8d460c438f17,0,0,0,0,0,0,0,0,0,0,0,0,0,0,0,110,2,0,0,0,0,0,0,0,0,0,0,100,NoArch
55b330b7a04978a7cae82ee8d650bb50689cf600,0,0,0,0,0,0,0,0,0,0,0,0,0,0,0,181,6,0,0,0,0,0,0,0,0,0,1,100,NoArch
fd5d161805ef4732a4c22d28509a23ed17037c11,34,67,127,60,194,0,0,0,34,273,1,6,4.896005901,0,2,93,14,807,0,807,31352,0,31352,163,0,163,0,100,NoArch
55e3c1b7428aa024b2c00cdb8e202fb0cbc46d62,0,0,0,0,0,0,0,0,0,0,0,0,0,0,0,93,14,0,0,0,0,0,0,0,0,0,0,100,NoArch
82fd6299ea694c16f0a0cd056587e447fe7e9da2,1,2,0,2,2,1,0,1,4,9,1,1,0,0,3,120,6,99,0,99,3754,0,3754,11,0,11,1,99.96061829,NoArch
6f7905bb44add675e07d8780880b030767ea2a80,0,0,0,0,0,0,0,0,0,0,0,0,0,0,0,119,5,0,0,0,0,0,0,0,0,0,1,100,NoArch
0ed8c2d90e9a4b498714f0949c7fffb7ca8cf8a6,5,19,5,14,24,2,0,2,35,530,1,2,2.095437252,0,2,620,10,164,0,164,5546,0,5546,80,0,80,1,99.98688525,NoArch
0921822a04d24f041b05bcc6008af040e07e02d6,0,0,0,0,0,0,0,0,0,0,0,0,0,0,0,620,10,0,0,0,0,0,0,0,0,0,1,100,NoArch
b7ce0f580167f6aa799322155959a985701de225,1,2,2,0,4,0,0,0,7,359,1,1,0,0,3,181,6,26,0,26,706,0,706,12,0,12,1,100,NoArch
0dfd4a92370397393140f9ac920eaf65dbe43932,0,0,0,0,0,0,0,0,0,0,0,0,0,0,0,182,7,0,0,0,0,0,0,0,0,0,1,100,NoArch
e3e16ca0e1e1fc8353f44c7af5b48c17693aefae,1,7,4,3,11,0,0,0,6,939,1,1,0,0,3,183,8,9,0,9,477,0,477,4,0,4,0,100,NoArch
155f4623b177ae68a8f48de29e5be984e3c4500f,1,0,108,108,108,0,0,0,6,939,1,1,0,3,3,182,7,0,9,9,0,477,477,0,4,4,0,99.96391668,NoArch
4b0a81dbe9ce07c37d85383cbfe54bddbce86133,2,14,6,8,20,1,0,1,8,1,1,2,0.468995594,0,1,183,8,27,0,27,943,0,943,13,0,13,1,99.98358826,NoArch
e26e99d3c53286bf847b9bfbee3119e218086da1,3,115,13,102,128,1,0,1,8,318,1,2,0.698542967,0,2,184,9,36,0,36,1359,0,1359,17,0,17,0,99.95407577,NoArch
6233dcf77903851bbeda70b8f62f526d5c394e9f,3,13,115,102,128,0,1,1,9,313,1,2,0.698542967,108,1,184,9,27,9,18,943,477,466,13,4,9,0,99.95407577,NoArch
eae21b80d30fa54b98c46d883ce1bc2fd2b33812,3,115,13,102,128,1,0,1,9,318,1,2,0.698542967,0,2,185,10,36,0,36,1359,0,1359,17,0,17,0,99.95407577,NoArch
4e458cafcbf3297caeb21417f76aa88b466e0fde,4,15,116,101,131,0,1,1,9,240,1,3,0.839977293,108,2,185,7,46,9,37,1608,477,1131,15,4,11,1,99.95407577,NoArch
81d47735c34908cbe1e621e1e21f08484c085a67,3,115,13,102,128,1,0,1,9,318,1,2,0.698542967,0,2,186,8,36,0,36,1359,0,1359,17,0,17,1,99.95407577,NoArch
258a822cf2f4f0ff5e89a3bc19a980e39daf85fa,5,228,118,110,346,1,1,2,9,498,1,4,1.365397349,108,1,9,3,76,9,67,3682,477,3205,30,4,26,1,97.67866458,Arch
025b960508efbc386a76bfc2e56041a84999f431,1,1,0,1,1,1,0,1,76,95,1,1,0,0,9,111,3,224,0,224,6618,0,6618,65,0,65,0,100,NoArch
3dd860db27cdcd1cd2d2d2270aca213c6a8a7490,3,108,16,92,124,0,0,0,11,33,2,3,1.090744926,0,2,10,4,364,0,364,16195,0,16195,138,0,138,1,100,NoArch
9a778f1e076f11263d87a7d6da9e60dbfbcca027,7,131,122,9,253,1,0,1,75,265,2,6,1.921118192,0,2,9,3,616,0,616,23601,0,23601,217,0,217,1,99.96756722,NoArch
f4bcda92e9cdf7dcf1d95fb36da171cdd602e245,3,108,16,92,124,0,0,0,11,33,2,3,1.090744926,0,2,10,4,364,0,364,16195,0,16195,138,0,138,1,100,NoArch
2a2d7a267672672da39f0065c8eb2907d2f81257,5,15,116,101,131,1,1,2,76,227,2,4,0.861006969,108,5,1753,16,471,9,462,15500,477,15023,123,4,119,1,99.96756722,NoArch
30f82585d37b73e3f4d5d7d9429a8739104058d3,4,116,14,102,130,1,0,1,38,262,2,3,0.802471657,0,5,1752,15,256,0,256,9296,0,9296,62,0,62,0,99.96756722,NoArch
b07db6efa146a127276649aaa42e19d2317d6557,1,1,1,0,2,0,0,0,39,105,1,1,0,0,5,1753,16,220,0,220,7939,0,7939,45,0,45,1,100,NoArch
9ed6282c15bd4175cd6817a16de7d50d82da07bb,4,14,115,101,129,1,1,2,77,234,1,3,0.758618726,108,9,1754,17,252,9,243,7566,477,7089,78,4,74,0,99.96756722,NoArch
695befe5c6cf687b4e7b4a6c5ab919523091bc49,1,1,1,0,2,0,0,0,78,0,1,1,0,0,9,1755,18,225,0,225,6621,0,6621,65,0,65,0,100,NoArch
6abf8c018a3dc0c061020da86d0674a0a7ffe1f9,0,0,0,0,0,0,0,0,0,0,0,0,0,0,0,1756,19,0,0,0,0,0,0,0,0,0,0,100,NoArch
625afc7c571be89d9295c2df06ad07a1ee899e06,74,3674,1546,2128,5220,15,0,15,15,967,2,16,4.948043309,0,3,2,0,2050,0,2050,111318,0,111318,1023,0,1023,0,92.04522579,Arch
559bc37e01a172cb5f82d21351e92ecad132426d,0,0,0,0,0,0,0,0,0,0,0,0,0,0,0,3,1,0,0,0,0,0,0,0,0,0,0,100,NoArch
68528b05d279e3b0ed56861b133774cb2bf2a391,14,254,180,74,434,0,0,0,10,0,1,4,2.900585452,0,2,4,2,309,0,309,25052,0,25052,198,0,198,0,100,NoArch
dc69f07bdf3a2a05a9af4ec52e623dab2e2636bf,1,6,8,2,14,0,0,0,13,5,1,1,0,0,3,5,3,108,0,108,8538,0,8538,61,0,61,0,100,NoArch
088158a9acb8ce7c29c488d7cef1788e5315df92,0,0,0,0,0,0,0,0,0,0,0,0,0,0,0,121,7,0,0,0,0,0,0,0,0,0,1,100,NoArch
39c7ce7e2beb8bfd49b1bf1ccc3abbc7c1d2fe5b,78,1770,3869,2099,5639,2,5,7,76,570,2,19,5.063213901,1646,2,120,6,2149,227,1922,112207,11380,100827,988,163,825,1,92.00979899,Arch
fc362dbc73a1f67756159845e678bcbf5fbf7017,1,1,0,1,1,1,0,1,77,8,1,1,0,0,9,1754,17,225,0,225,6621,0,6621,65,0,65,0,100,NoArch
6aa8062a8041793ff6e6c94a70c2a74263487b67,0,0,0,0,0,0,0,0,0,0,0,0,0,0,0,1755,18,0,0,0,0,0,0,0,0,0,0,100,NoArch
cb003049b4cee722febd7c74e65479502bfea1bc,79,3865,1769,2096,5634,15,1,16,15,720,2,20,5.07444485,108,3,94,9,2213,9,2204,119817,477,119340,1066,4,1062,1,92.00979899,Arch
4c236bf6b2609894d0b2fdced32889207ad87b38,77,1770,3868,2098,5638,2,8,10,14,580,2,18,5.061645867,2292,2,94,9,1925,227,1698,105589,11380,94209,923,163,760,1,92.00979899,Arch
f99410a96d0d72de6c5086dcc585103a0e2d8050,85,4063,1766,2297,5829,21,1,22,38,729,5,24,5.1918078,108,5,1757,20,2598,9,2589,139586,477,139109,1254,4,1250,3,92.00979899,Arch
e323a7aa8d449b751030eaa75a1b37fd8253a0fa,77,1770,3868,2098,5638,2,8,10,14,580,2,18,5.061645867,2292,2,1756,19,1925,227,1698,105589,11380,94209,923,163,760,3,92.00979899,Arch
60172bd6b29fb1b1dd9856857a63e7c8dc9cf216,78,3868,1771,2097,5639,15,1,16,15,730,2,19,5.076579706,108,3,95,10,2134,9,2125,116520,477,116043,1059,4,1055,1,92.00979899,Arch
c94b0f672df09fb50fadb616d19781eecd46853f,77,1770,3868,2098,5638,2,8,10,14,580,2,18,5.061645867,2292,2,95,10,1925,227,1698,105589,11380,94209,923,163,760,1,92.00979899,Arch
9505ef0718da5c648d47b8651dba73543c6610a5,81,3902,1786,2116,5688,15,1,16,40,724,2,21,5.117423911,108,3,621,10,2601,9,2592,134305,477,133828,1194,4,1190,1,92.00671141,Arch
2ba76cf6f55738c2bbc4c3563c3f8489b781019e,77,1770,3868,2098,5638,2,8,10,14,580,2,18,5.061645867,2292,2,621,10,1925,227,1698,105589,11380,94209,923,163,760,1,92.01033522,Arch
59309896e3b2c1976679b4113fd0c7716f3a4307,80,3901,1774,2127,5675,16,1,17,15,776,2,21,5.105776342,108,3,622,10,2152,9,2143,118435,477,117958,1075,4,1071,1,92.01033522,Arch
3b12c703c8d07c01fa1e5a71993b7fb0ffa1fb54,77,1770,3868,2098,5638,2,8,10,14,580,2,18,5.061645867,2292,2,622,10,1925,227,1698,105589,11380,94209,923,163,760,1,92.01033522,Arch
775f18c46bd7c67836c52567f2a33f9f9dc07d45,78,3875,1777,2098,5652,15,1,16,15,731,2,19,5.083775618,108,3,96,9,2128,9,2119,116749,477,116272,1052,4,1048,0,92.01033522,Arch
1aa81660b99bb642e5d61a12724006a392b58972,77,1770,3868,2098,5638,2,8,10,14,580,2,18,5.061645867,2292,2,96,9,1925,227,1698,105589,11380,94209,923,163,760,0,92.01033522,Arch
b5ba05c1a044b86061c9d78d8c62787a2c85d6c3,77,3862,1764,2098,5626,15,1,16,15,731,2,18,5.064736824,108,3,1758,16,2105,9,2096,114900,477,114423,1043,4,1039,0,92.01033522,Arch
5fcef235646a8ae3761347608bb24df016b78c06,0,0,0,0,0,0,0,0,0,0,0,0,0,0,0,1759,17,0,0,0,0,0,0,0,0,0,0,100,NoArch
599b28592c22a1d9bcad759300a8e487e4c57bbe,3,154,43,111,197,2,0,2,50,43,2,2,1.137752605,0,4,623,9,429,0,429,19573,0,19573,308,0,308,1,100,NoArch
cc48824eab6d064dbeaaa7e693307cde1b296de1,77,1770,3868,2098,5638,2,8,10,14,580,2,18,5.061645867,2292,2,623,9,1925,227,1698,105589,11380,94209,923,163,760,1,92.01033522,Arch
3dfec855958bf4c4f7d81f4c0a293d0fbad3ec6d,84,3863,1774,2089,5637,15,1,16,41,742,3,25,5.08042868,108,2,1760,14,2447,9,2438,125867,477,125390,1165,4,1161,0,92.01033522,Arch
ceee36851c3b56525c137aaf0c8fc4353244363b,1,1,1,0,2,0,0,0,42,0,1,1,0,0,5,11,2,118,0,118,3737,0,3737,46,0,46,1,100,NoArch
a54f373cb3551e761ca6d03f779a745fb2bddf71,84,1780,3869,2089,5649,8,8,16,41,572,3,25,5.077316388,2292,2,11,2,2266,227,2039,116602,11380,105222,1045,163,882,1,92.01033522,Arch
1a254102a173c83f6ab3803a5e5f2309f73d8f82,86,3871,1775,2096,5646,16,1,17,42,725,3,27,5.090659937,108,2,186,5,2479,9,2470,126894,477,126417,1176,4,1172,1,92.01033522,Arch
8c23d529092ad20eb28958555a54f9e4bb628ee2,1,2,0,2,2,1,0,1,10,192,1,1,0,0,2,187,6,73,0,73,1963,0,1963,37,0,37,1,100,NoArch
7433ed1375c51cf9db81754772950514579a0315,85,1780,3871,2091,5651,8,8,16,41,584,3,26,5.080087371,2292,2,187,6,2339,227,2112,118561,11380,107181,1082,163,919,1,92.01033522,Arch
640bc3596431170d874f762735dd5f75c1c21c1c,1,2,0,2,2,1,0,1,10,192,1,1,0,0,2,188,7,73,0,73,1963,0,1963,37,0,37,1,100,NoArch
1f8ba923c7d042f75481c439386873b70c020c4f,0,0,0,0,0,0,0,0,0,0,0,0,0,0,0,1757,6,0,0,0,0,0,0,0,0,0,0,100,NoArch
ac20069a776df0ca9291b3241df9799664cc20d8,0,0,0,0,0,0,0,0,0,0,0,0,0,0,0,1758,7,0,0,0,0,0,0,0,0,0,0,100,NoArch
e6421f973aa5c52b630b25cda4050cde1c174968,7,1,10,9,11,0,0,0,42,682,2,7,2.663532755,0,2,1759,8,341,0,341,10957,0,10957,122,0,122,0,100,NoArch
f488ebe8cf0977980d6a399b5cd2b13c0c98dd87,78,3862,1786,2076,5648,15,1,16,40,731,2,19,5.081794761,108,3,112,3,2179,9,2170,117099,477,116622,1065,4,1061,1,91.98755617,Arch
2c01980a017550f6b5639d2a83a9c41b3b282317,1,2,1,1,3,0,0,0,4,398,1,1,0,0,2,188,7,13,0,13,565,0,565,5,0,5,0,100,NoArch
0d991e73438849a3f388e232f910fb5b6f4521aa,1,7,7,0,14,0,0,0,3,28,1,1,0,0,3,189,8,15,0,15,398,0,398,9,0,9,0,100,NoArch
0321a80f5701585df77ecee4674a5e229dee2047,1,19,2,17,21,0,0,0,79,33,1,1,0,0,9,624,3,230,0,230,6717,0,6717,66,0,66,0,100,NoArch
207bf0d5041da65aced9b36dc47b1e7435fc7ed8,79,1800,3877,2077,5677,3,8,11,39,573,3,20,5.08949107,2292,2,624,3,2017,227,1790,108466,11380,97086,952,163,789,0,91.98755617,Arch
0b024484d3e146af0fa8f192f7f9eac19d3bb386,1,0,22,22,22,0,0,0,40,169,1,1,0,0,6,1760,8,74,0,74,2199,0,2199,22,0,22,1,99.98702352,NoArch
5ca380df33a63b9f4642683c92c337f0f21b6962,82,3871,1779,2092,5650,15,1,16,28,736,3,22,5.085361816,108,3,1761,8,2328,9,2319,121060,477,120583,1112,4,1108,0,92.00055312,Arch
fc23455e3ea39e642355fc3a72a33df57057b075,78,1778,3877,2099,5655,2,8,10,14,584,3,19,5.072521751,2292,2,1761,9,1938,227,1711,106161,11380,94781,928,163,765,0,92.00055312,Arch
f257791d452177ac14b41de085e76b2c80c94eee,148,3871,8461,4590,12332,15,69,84,15,1690,5,46,6.505828114,6795,2,122,1,2118,649,1469,115465,31087,84378,1048,328,720,1,91.5979862,Arch
6f2bbb9f2736ec714ecb278f8645c20caf0d1ea0,1,35,0,35,35,1,0,1,8,30,1,1,0,0,5,12,3,30,0,30,3166,0,3166,16,0,16,1,100,NoArch
2a436f8db93d766df5af3665a43f46023e9b4986,148,8468,3878,4590,12346,72,8,80,14,425,5,46,6.504236405,2292,1,12,3,2582,227,2355,137064,11380,125684,1254,163,1091,1,91.5979862,Arch
74cf78654abb8650c7f7029517ae0e2a98ffcafe,149,3878,8462,4584,12340,16,71,87,15,1691,5,46,6.508838231,6797,2,123,2,2140,649,1491,116427,31087,85340,1054,328,726,1,91.5979862,Arch
c4719a279fcf8f68a665ba1766223fe91b1d9841,148,8468,3878,4590,12346,72,8,80,14,425,5,46,6.504236405,2292,1,121,1,2582,227,2355,137064,11380,125684,1254,163,1091,1,91.5979862,Arch
8b599f789721b2c0a6cfbd5ebde2b115bf302282,148,3872,8462,4590,12334,15,71,86,15,1690,5,46,6.505948853,6797,2,44,0,2122,649,1473,115760,31087,84673,1050,328,722,1,91.5979862,Arch
4a947157bbcf840ee3e7919f00a592c7123df2f4,148,8468,3878,4590,12346,72,8,80,14,425,5,46,6.504236405,2292,1,44,0,2582,227,2355,137064,11380,125684,1254,163,1091,1,91.5979862,Arch
e4445878946d2f5a4ab0afdbf3660543b3fa6a61,148,3953,8448,4495,12401,15,71,86,15,1682,5,46,6.508388788,6797,2,6,2,2133,649,1484,116390,31087,85303,1055,328,727,0,91.5979862,Arch
3d9e3468e7d0f82c8ea71d149046880474420200,7,93,52,41,145,0,0,0,16,41,1,2,2.329469091,0,4,7,3,237,0,237,17167,0,17167,127,0,127,0,100,NoArch
f64fb06878727e97dd4872dfccbc1600cbed1dec,1,2,2,0,4,0,0,0,10,7,1,1,0,0,3,45,1,18,0,18,667,0,667,4,0,4,0,100,NoArch
fbe9600444ba38714980715de5d7b0a317bd81f9,146,8395,3941,4454,12336,72,8,80,14,435,5,46,6.489945387,2345,1,45,1,2574,234,2340,136800,11807,124993,1248,166,1082,0,91.5979862,Arch
d65029770527eb3a2d71192cfabb66beeaf78c2f,146,3935,8389,4454,12324,15,71,86,16,1678,5,46,6.491645776,6797,2,46,2,2137,649,1488,117911,31087,86824,1059,328,731,0,91.5979862,Arch
5f2cb277fecf9ea0152b109895d642c59726c2fa,1,15,0,15,15,1,0,1,4,1797,1,1,0,0,2,124,3,14,0,14,513,0,513,13,0,13,1,100,NoArch
280e7e20dcf575827039da114f106ad40f3bb007,146,8395,3941,4454,12336,72,8,80,14,435,5,46,6.489945387,2345,1,122,2,2574,234,2340,136800,11807,124993,1248,166,1082,1,91.5979862,Arch
a2d227d60ce64ddec43279ec7d254ff79402bf7f,147,3971,8389,4418,12360,16,71,87,16,1677,5,47,6.501468336,6797,2,97,0,2159,649,1510,121672,31087,90585,1075,328,747,0,91.5979862,Arch
d4eb2b6b88cd02e54812a64c11438737095f29f8,146,8395,3941,4454,12336,72,8,80,14,435,5,46,6.489945387,2345,1,97,0,2574,234,2340,136800,11807,124993,1248,166,1082,0,91.5979862,Arch
b9e62f36b0f29151274abc73bfff571b019dac70,148,3935,8398,4463,12333,15,71,86,27,1676,6,48,6.496288377,6797,2,125,3,2297,649,1648,125278,31087,94191,1089,328,761,1,91.5979862,Arch
005bb7dcb809d443818351894f7614d3d84eed74,1,12,1,11,13,0,0,0,58,84,1,1,0,0,4,98,1,244,0,244,7889,0,7889,81,0,81,1,100,NoArch
507dc1d6f1022f9dd46b8405868523a067c7f526,148,8404,3941,4463,12345,74,8,82,26,425,6,48,6.494585738,2345,1,98,1,2735,234,2501,144215,11807,132408,1278,166,1112,1,91.5979862,Arch
218175f9d71099dae59203d8db3eaf3fb4c10907,149,3942,8399,4457,12341,15,71,86,27,1676,7,49,6.499877785,6797,2,37,0,2306,649,1657,125626,31087,94539,1091,328,763,1,91.5979862,Arch
83666de79f0fc33d862fb6c3414e969150d0b202,148,8404,3941,4463,12345,74,8,82,26,425,6,48,6.494585738,2345,1,37,0,2735,234,2501,144215,11807,132408,1278,166,1112,1,91.5979862,Arch
0b90e839b6db785d2370937fa85761a111df7e0c,149,4067,8517,4450,12584,15,71,86,27,1676,7,49,6.507850682,6797,2,1762,2,2358,649,1709,127455,31087,96368,1095,328,767,0,91.5979862,Arch
c17b016c36a376cf8ba75b2b6b5e61e7f9a686c5,0,0,0,0,0,0,0,0,0,0,0,0,0,0,0,1763,3,0,0,0,0,0,0,0,0,0,1,100,NoArch
d7394c3a72da3230d5738202ac99454748441686,149,8523,4073,4450,12596,74,8,82,26,425,7,49,6.506198634,2345,1,1762,5,2793,234,2559,146327,11807,134520,1283,166,1117,1,91.5979862,Arch
30d8705567167e296a28c70a8e4e842d54b3747f,150,4080,8518,4438,12598,15,71,86,59,1669,7,50,6.513126624,6797,2,99,2,2605,649,1956,135391,31087,104304,1178,328,850,0,91.5979862,Arch
fd15535b811e1849c6d6bc862c6e2c1153cdc2fc,149,8523,4073,4450,12596,74,8,82,26,425,7,49,6.506198634,2345,1,99,2,2793,234,2559,146327,11807,134520,1283,166,1117,0,91.5979862,Arch
2160ad99dd3557eea99951a89a14c796ce0eff57,149,4067,8517,4450,12584,15,71,86,27,1676,7,49,6.507850682,6797,2,126,4,2358,649,1709,127455,31087,96368,1095,328,767,1,91.5979862,Arch
98bf40c4e2f5fc1a5dc3a390ff497ca5ffeebee1,149,8523,4073,4450,12596,74,8,82,26,425,7,49,6.506198634,2345,1,123,2,2793,234,2559,146327,11807,134520,1283,166,1117,1,91.5979862,Arch
fe3d0f77ba149436b00619d14f71217910d5e210,149,4067,8517,4450,12584,15,71,86,27,1676,7,49,6.507850682,6797,2,127,5,2358,649,1709,127455,31087,96368,1095,328,767,1,91.5979862,Arch
c296bc1183a1e84b2815fc9f56865b5941e2d120,149,8523,4073,4450,12596,74,8,82,26,425,7,49,6.506198634,2345,1,124,3,2793,234,2559,146327,11807,134520,1283,166,1117,1,91.5979862,Arch
58dc76e1261d63aee27670ae41c26eabdfcbbfc3,149,4067,8517,4450,12584,15,71,86,27,1676,7,49,6.507850682,6797,2,1764,3,2358,649,1709,127455,31087,96368,1095,328,767,1,91.5979862,Arch
7922f7e31809ab67a3b4d2d3a2b08829c9e08437,149,8523,4073,4450,12596,74,8,82,26,425,7,49,6.506198634,2345,1,1763,3,2793,234,2559,146327,11807,134520,1283,166,1117,1,91.5979862,Arch
1d49bee88906119b50fb6631b9b3d917472164c9,149,4067,8517,4450,12584,15,71,86,27,1676,7,49,6.507850682,6797,2,128,6,2358,649,1709,127455,31087,96368,1095,328,767,1,91.5979862,Arch
c37d6582d2c843aa7315edd944d64e59f5e3870b,149,8523,4073,4450,12596,74,8,82,26,425,7,49,6.506198634,2345,1,125,4,2793,234,2559,146327,11807,134520,1283,166,1117,1,91.5979862,Arch
e4daf18f27534cb966dcf40d9c8aac965d631a34,149,4067,8517,4450,12584,15,71,86,27,1676,7,49,6.507850682,6797,2,47,3,2358,649,1709,127455,31087,96368,1095,328,767,0,91.5979862,Arch
f54105d075e9b54a26b6753d7fea6a88031c5ead,149,8523,4073,4450,12596,74,8,82,26,425,7,49,6.506198634,2345,1,46,2,2793,234,2559,146327,11807,134520,1283,166,1117,0,91.5979862,Arch
64df6cfcfac7b3bd651a6b768af6069c7237d99f,149,4067,8517,4450,12584,15,71,86,27,1676,7,49,6.507850682,6797,2,48,4,2358,649,1709,127455,31087,96368,1095,328,767,0,91.5979862,Arch
d10436dda474b1801b8df1bc7374a718a43a4e5d,149,8523,4073,4450,12596,74,8,82,26,425,7,49,6.506198634,2345,1,47,3,2793,234,2559,146327,11807,134520,1283,166,1117,0,91.5979862,Arch
03079283387857d515fc109652774d0983d7c647,149,4087,8517,4430,12604,15,71,86,27,1674,7,49,6.506398834,6797,2,49,5,2358,649,1709,127455,31087,96368,1095,328,767,0,91.5979862,Arch
bfca646699cd4e2b6f8da95e21dcc337350fc1ef,149,8523,4073,4450,12596,74,8,82,26,427,7,49,6.506198634,2345,1,48,4,2793,234,2559,146327,11807,134520,1283,166,1117,0,91.5979862,Arch
46f8206a346722ed0cd6aef303924e7b991dfbdd,149,4067,8517,4450,12584,15,71,86,27,1674,7,49,6.507850682,6797,2,1765,4,2358,649,1709,127455,31087,96368,1095,328,767,1,91.5979862,Arch
fba27c8e057475a5e03ffb6548d01cace92ffaae,149,8523,4073,4450,12596,74,8,82,26,427,7,49,6.506198634,2345,1,1764,4,2793,234,2559,146327,11807,134520,1283,166,1117,1,91.5979862,Arch
b43ce45503352635c2264ae315b6b5a787d7aab6,155,4866,8464,3598,13330,21,69,90,27,1561,7,51,6.584669805,6721,2,625,1,2446,646,1800,131614,30959,100655,1124,325,799,1,91.56981076,Arch
d9ec61d9e91fdea762f86c6ec2fe357a2274e437,0,0,0,0,0,0,0,0,0,0,0,0,0,0,0,626,2,0,0,0,0,0,0,0,0,0,1,100,NoArch
8054868f3119946078c4a118985d22bab4b64cb2,4,112,40,72,152,0,0,0,25,150,1,2,1.226830915,0,1,100,3,146,0,146,4226,0,4226,25,0,25,1,100,NoArch
3eac3a545272223658f614ecd60b016d3f61b64e,160,8369,5121,3248,13490,67,14,81,26,395,7,55,6.6229087,3112,1,100,3,2793,320,2473,146451,15863,130588,1283,193,1090,1,91.56981076,Arch
0d22b21934f716e265f494225446120c1c19fe0a,155,4866,8464,3598,13330,21,64,85,27,1561,7,51,6.584669805,6501,2,627,3,2446,646,1800,131614,30959,100655,1124,325,799,1,91.56981076,Arch
aaae6c5280db12189ee89ae00b0e9def8ce52232,10,69,39,30,108,0,0,0,19,730,2,3,2.916104105,0,1,1766,5,373,0,373,19301,0,19301,158,0,158,1,100,NoArch
34e675ca385e8ee56997af0b28370b9df5cb017f,160,8369,5121,3248,13490,67,14,81,26,395,7,55,6.6229087,3112,1,1765,5,2793,320,2473,146451,15863,130588,1283,193,1090,1,91.56981076,Arch
a6163261daf7dcb6b7b77e4b9f0e587c156b0a64,155,4865,8464,3599,13329,21,64,85,27,1561,7,51,6.584720821,6501,2,1767,6,2446,646,1800,131612,30959,100653,1124,325,799,0,91.56981076,Arch
059b7c7db0c302b32f04d8257e18c733e8f6fb14,0,0,0,0,0,0,0,0,0,0,0,0,0,0,0,129,7,0,0,0,0,0,0,0,0,0,1,100,NoArch
34d5c9c30c98e89dda7b0b771e7bbe4d342f4fcf,160,8369,5120,3249,13489,67,14,81,26,395,7,55,6.62296067,3111,1,126,5,2793,320,2473,146451,15861,130590,1283,193,1090,1,91.56981076,Arch
90960b1fdcd72578349e1184a1c7905c1340553b,155,4865,8464,3599,13329,21,64,85,27,1561,7,51,6.584720821,6501,2,628,4,2446,646,1800,131612,30959,100653,1124,325,799,1,91.56981076,Arch
2cbc828f90f68e48f257cb8aa6afdbbde59b53bf,1,2,12,10,14,0,0,0,10,20,1,1,0,0,3,8,2,73,0,73,3493,0,3493,44,0,44,0,100,NoArch
97170d2661821871fc980d5366dd2abc81021437,10,44,46,2,90,0,0,0,14,45,1,5,2.790348342,0,5,9,3,618,0,618,31183,0,31183,255,0,255,0,100,NoArch
6ca89f86c28e15cf3bb1aea92fd7183309c605c1,167,8774,5212,3562,13986,72,13,85,26,381,7,56,6.70960711,2293,1,44,0,2817,242,2575,147895,11242,136653,1302,148,1154,1,91.53230311,Arch
a3e82c0c28313da8950c5a19a2bc3bce77d113b3,155,4891,8502,3611,13393,21,64,85,27,1557,7,51,6.592853262,6501,2,44,0,2445,646,1799,131366,30959,100407,1123,325,798,1,91.56648926,Arch
4502c40fae052b34d43929f6068554dc1678ffb5,2,57,30,27,87,0,0,0,3,4,1,1,0.479832024,0,2,629,5,32,0,32,1751,0,1751,8,0,8,1,100,NoArch
e2bd6b3d46162796c97d23a6349bc4f04ff87862,2,12,3,9,15,1,0,1,3,3,1,1,0.996791632,0,1,630,6,42,0,42,1869,0,1869,8,0,8,1,100,NoArch
1431e7290b6d11746298a7ab74822b94132e7ca3,1,9,1,8,10,0,0,0,3,0,1,1,0,0,1,631,7,36,0,36,1506,0,1506,6,0,6,1,100,NoArch
a5ba442f85fd031daae76df6d78a9d3ab93f3659,4,32,10,22,42,0,0,0,38,720,2,2,1.895111013,0,3,632,8,223,0,223,11288,0,11288,103,0,103,1,100,NoArch
0f0e6e1268aefca5b338d7cbe382d37e7965b41c,160,8407,5190,3217,13597,67,11,78,26,395,7,55,6.629878545,2616,1,625,1,2793,328,2465,146451,16182,130269,1283,194,1089,1,91.56648926,Arch
6a1930420e04f70b77f7888f4d71dc276d748e33,1,1,0,1,1,1,0,1,9,0,1,1,0,0,4,360,8,20,0,20,1030,0,1030,5,0,5,0,99.97206801,NoArch
0e7c0482c35d5247aa37525f55dd1573074958aa,2,44,3,41,47,0,0,0,10,984,2,2,0.25387844,0,4,361,9,32,0,32,1487,0,1487,11,0,11,0,99.97206801,NoArch
26b5b749bd23bba29a23cd716c9093f8ca1cc288,2,8,1,7,9,1,0,1,32,1228,1,2,0.764204507,0,3,1035,3,311,0,311,12275,0,12275,179,0,179,1,100,NoArch
c201d5299017a0a1315a18d4034d72009aac9a9e,2,110,2,108,112,1,0,1,61,926,1,2,0.222284831,0,3,1036,4,221,0,221,13296,0,13296,143,0,143,1,100,NoArch
38d4aec876f946182ac7badc7dea8f5c949789a3,6,191,2,189,193,5,0,5,26,106,2,3,2.220107885,0,4,75,0,214,0,214,10630,0,10630,75,0,75,1,99.96858748,NoArch
7a5544f835dff0884eb1dc01889bf427b1e9cafe,1,1,1,0,2,0,0,0,20,1016,1,1,0,0,1,1037,2,50,0,50,1659,0,1659,12,0,12,1,100,NoArch
ea6ed432b731ea40e05c9ea662e552286b7ae448,2,39,12,27,51,0,0,0,77,764,1,1,0.997502546,0,4,1038,3,300,0,300,8560,0,8560,114,0,114,1,100,NoArch
944b522765c7eeaf834f71482004493954d09de7,5,112,4,108,116,4,0,4,82,290,2,3,1.404913477,0,6,1039,2,841,0,841,32621,0,32621,406,0,406,1,96.23811492,Arch
460712a92a774e178e57f60853dc01a9dc2491cb,2,45,30,15,75,0,0,0,38,2067,2,2,0.996791632,0,3,1040,3,70,0,70,3180,0,3180,20,0,20,1,100,NoArch
3cfa42c922f8bf4ffdd4206141f4b95ed10c45ce,3,44,0,44,44,3,0,3,74,434,1,3,1.022629779,0,2,1041,4,471,0,471,24628,0,24628,208,0,208,1,100,NoArch
eeece74d091c6442500deada22e79617c2013752,1,1,1,0,2,0,0,0,55,12,1,1,0,0,3,1042,5,168,0,168,5238,0,5238,54,0,54,0,100,NoArch
9af02451e164fa5de8f2a40e49eadac47d5821c5,2,46,3,43,49,0,0,0,8,2919,1,1,0.975525951,0,2,229,0,39,0,39,2094,0,2094,20,0,20,1,100,NoArch
30df07a3acd27ba0b0315e52c30419a41cd5cb70,3,11,7,4,18,0,0,0,101,131,2,2,1.351644115,0,2,230,1,301,0,301,9387,0,9387,88,0,88,1,100,NoArch
8016d9a56ee1f6f785aad45202f8e5f1022d1524,0,0,0,0,0,0,0,0,0,0,0,0,0,0,0,457,0,0,0,0,0,0,0,0,0,0,0,100,NoArch
7570b5e439b4648ee8494aeedcf679a18119fd69,0,0,0,0,0,0,0,0,0,0,0,0,0,0,0,458,1,0,0,0,0,0,0,0,0,0,0,100,NoArch
61346ae578c1b6e91140ca8652e46b99e6e24ba3,1,8,0,8,8,1,0,1,76,375,1,1,0,0,5,362,0,137,0,137,5518,0,5518,25,0,25,1,100,NoArch
0a7127eca4634b5bf2228d504e1d8876ae02a313,1,3,0,3,3,1,0,1,21,1103,1,1,0,0,4,363,1,50,0,50,1267,0,1267,15,0,15,1,100,NoArch
02df2869fc7681b7b16818e0a9d8641375c099b0,1,6,3,3,9,0,0,0,8,1248,1,1,0,0,3,364,2,28,0,28,742,0,742,4,0,4,0,100,NoArch
bed931a2b8ddddbe1b500f3eb3461c8a26452916,1,1,1,0,2,0,0,0,14,99,1,1,0,0,4,365,3,88,0,88,2934,0,2934,12,0,12,0,100,NoArch
53cc601141069652f6ccf6bb88e1a09ece58fd07,0,0,0,0,0,0,0,0,0,0,0,0,0,0,0,366,4,0,0,0,0,0,0,0,0,0,0,100,NoArch
1b437af8ba2d8bac517bdf797a4ffc9898aa0322,2,22,13,9,35,1,0,1,20,1014,1,1,0.422000517,0,4,367,5,133,0,133,3322,0,3322,39,0,39,1,100,NoArch
50a3ae44b7ac5bcf1ffcc0b815f56078fb4ad092,1,10,0,10,10,1,0,1,4,3141,1,1,0,0,2,368,6,35,0,35,713,0,713,15,0,15,1,100,NoArch
6e24c77b740bf41b31636a64f0963a94f21c2e5d,2,8,6,2,14,0,0,0,57,862,1,2,0.863120569,0,7,369,7,204,0,204,6312,0,6312,74,0,74,1,100,NoArch
f9170a0d81619d631cebbfb3a4d4b19cf50558d0,1,2,1,1,3,0,0,0,17,1746,1,1,0,0,4,370,8,46,0,46,1341,0,1341,24,0,24,1,100,NoArch
59a98723eed2dc581e2eb460c3ab91764ecad5fb,0,0,0,0,0,0,0,0,0,0,0,0,0,0,0,371,9,0,0,0,0,0,0,0,0,0,1,100,NoArch
6773da242c9b888ed37ce8a984c4b801e99ad800,0,0,0,0,0,0,0,0,0,0,0,0,0,0,0,372,10,0,0,0,0,0,0,0,0,0,0,100,NoArch
36abbb62d09af025071217b2a133a2bca8a64034,2,14,14,0,28,0,0,0,13,2472,2,2,0.371232327,0,2,373,11,40,0,40,1035,0,1035,33,0,33,0,100,NoArch
28d642f9c5e3560291c3129ddebc34a70faa1d6d,1,11,11,0,22,0,0,0,2,3801,1,1,0,0,2,374,12,5,0,5,107,0,107,3,0,3,0,100,NoArch
c057421a30165cabcfef139ce188bf31845ae39c,3,461,36,425,497,1,0,1,81,102,2,3,1.453310877,0,8,375,13,619,0,619,15524,0,15524,184,0,184,0,99.93873592,NoArch
1feb368cd429d85dfa9634c281cbdf51a24675e9,1,0,0,0,0,1,0,1,1,0,1,1,0,0,1,376,14,49,0,49,1251,0,1251,42,0,42,0,99.98637881,NoArch
20e9f5f1d83d6970f8fc28f231d18218764c7f16,1,48,43,5,91,0,0,0,17,0,1,1,0,0,3,377,15,57,0,57,1346,0,1346,22,0,22,0,100,NoArch
e0341b6f9a221c0dbbb21d0fa86f83ddd67400e7,1,0,1,1,1,0,0,0,11,84,1,1,0,0,4,378,16,20,0,20,1018,0,1018,5,0,5,0,99.97956751,NoArch
c7794fc9cd8c867411e435e6a0c787853d415e29,2,108,3,105,111,1,0,1,5,586,1,2,0.99853585,0,1,167,0,31,0,31,1165,0,1165,10,0,10,1,99.98637927,NoArch
e78e003a3d25893553146760d04ba83234355e54,0,0,0,0,0,0,0,0,0,0,0,0,0,0,0,379,17,0,0,0,0,0,0,0,0,0,0,100,NoArch
b7e78843101662c82389f28698e332deba4f1cb0,1,2,2,0,4,0,0,0,5,1107,1,1,0,0,4,380,18,22,0,22,910,0,910,5,0,5,1,100,NoArch
f79d509003c8754d59ea41db92511ada9278c220,0,0,0,0,0,0,0,0,0,0,0,0,0,0,0,381,19,0,0,0,0,0,0,0,0,0,0,100,NoArch
a63e6f3eb327135718dac7c553fe8c5217a5a21d,0,0,0,0,0,0,0,0,0,0,0,0,0,0,0,22,7,0,0,0,0,0,0,0,0,0,0,100,NoArch
b3f7f0e5b34d06181fc1755392409e82a9c7d477,1,10,4,6,14,0,0,0,74,204,1,1,0,0,9,23,8,140,0,140,4569,0,4569,31,0,31,0,100,NoArch
7400092996a434386edfcdb5af40166741dc52ea,0,0,0,0,0,0,0,0,0,0,0,0,0,0,0,24,9,0,0,0,0,0,0,0,0,0,0,100,NoArch
4d1cde5aa87dea85cd1f2718d6ac88f616514be8,1,12,2,10,14,0,0,0,48,637,1,1,0,0,9,1,1,64,0,64,2548,0,2548,20,0,20,1,100,NoArch
600077ef707531bd2926da784d0ac84cface2742,1,1,1,0,2,0,0,0,2,640,1,1,0,0,2,7,2,25,0,25,1107,0,1107,16,0,16,0,100,NoArch
57a499fd586c297751476f13615682aa72759a1e,7,196,3,193,199,5,0,5,22,606,2,2,2.416051205,0,1,87,1,70,0,70,2716,0,2716,26,0,26,1,99.97735108,NoArch
1ea499cb7de6fcda74c6f5be1958998a26ebcae5,0,0,0,0,0,0,0,0,0,0,0,0,0,0,0,25,8,0,0,0,0,0,0,0,0,0,0,100,NoArch
0d30b70e65170f6c93a3c2fc8d7b4dde90423b7d,0,0,0,0,0,0,0,0,0,0,0,0,0,0,0,26,8,0,0,0,0,0,0,0,0,0,0,100,NoArch
44ce31d6a27c5bf6772bdc36410ed593800436fc,0,0,0,0,0,0,0,0,0,0,0,0,0,0,0,27,7,0,0,0,0,0,0,0,0,0,0,100,NoArch
9c20cb35a81d773ad40e48a33885e081462fb34d,2,1,23,22,24,0,0,0,37,52,1,2,0.954434003,0,5,8,1,133,0,133,5193,0,5193,53,0,53,1,100,NoArch
e0099772d5c5bfb132780845fefdf21e96703b4b,2,22,0,22,22,2,0,2,38,0,1,2,0.945660305,0,5,9,2,137,0,137,5357,0,5357,53,0,53,1,100,NoArch
bf410ab9a7f0815b1eec3abe8c8ea2ecb76ed2c7,0,0,0,0,0,0,0,0,0,0,0,0,0,0,0,633,13,0,0,0,0,0,0,0,0,0,0,100,NoArch
31999f8bf338f3db16201ebb53286c82b932fa2c,1,4,1,3,5,0,0,0,28,383,1,1,0,0,6,634,14,421,0,421,10502,0,10502,96,0,96,0,100,NoArch
7a942960f5b87507f0ce343858c203b904c4ec5c,1,28,8,20,36,0,0,0,2,2396,1,1,0,0,2,635,15,45,0,45,1115,0,1115,20,0,20,0,100,NoArch
5ceae7248e69d1cf6cc905150cd86a1cbb6ef544,1,9,1,8,10,0,0,0,2,2396,1,1,0,0,2,636,16,53,0,53,1530,0,1530,40,0,40,0,100,NoArch
280414bf23327f930880415a3db54c3a68b5d7f5,1,2,2,0,4,0,0,0,3,0,1,1,0,0,2,637,17,53,0,53,1539,0,1539,40,0,40,0,100,NoArch
2ea66eac063b22a925ce5992c3b732dac3710191,0,0,0,0,0,0,0,0,0,0,0,0,0,0,0,638,18,0,0,0,0,0,0,0,0,0,0,100,NoArch
af090cbd476c5e74f356b9d685e8de14ca8c236a,1,1,0,1,1,1,0,1,71,29,1,1,0,0,8,639,19,144,0,144,4506,0,4506,53,0,53,0,100,NoArch
e746c09040bf08f652ded38a4f748d4c53423418,8,83,40,43,123,0,0,0,28,1186,2,6,2.116513578,0,3,640,12,643,0,643,26025,0,26025,121,0,121,1,100,NoArch
dd6b5237eda1b32c5493b84b8e92a19da8327e85,1,32,25,7,57,0,0,0,40,45,1,1,0,0,3,641,13,134,0,134,3947,0,3947,23,0,23,0,100,NoArch
fe6abda411306d2f69011794e92d373161380cbd,1,2,1,1,3,0,0,0,41,0,1,1,0,0,3,642,14,134,0,134,3946,0,3946,23,0,23,0,100,NoArch
baec1b843f04a05470a25b83634ab005cabf23b1,0,0,0,0,0,0,0,0,0,0,0,0,0,0,0,643,15,0,0,0,0,0,0,0,0,0,0,100,NoArch
34239a8a7c932555c710a95b3654118b958e5f85,0,0,0,0,0,0,0,0,0,0,0,0,0,0,0,644,16,0,0,0,0,0,0,0,0,0,0,100,NoArch
5740eeaeb0a75ddfcac17715aff6e290d1bfc5cb,0,0,0,0,0,0,0,0,0,0,0,0,0,0,0,645,17,0,0,0,0,0,0,0,0,0,0,100,NoArch
d413a6dbc777d2a8e8779cfbf5c871d26b76de79,0,0,0,0,0,0,0,0,0,0,0,0,0,0,0,646,18,0,0,0,0,0,0,0,0,0,0,100,NoArch
433c2c269990935f3e1ec8c8200792009aca051e,0,0,0,0,0,0,0,0,0,0,0,0,0,0,0,647,19,0,0,0,0,0,0,0,0,0,0,100,NoArch
d5c4794c0b0ce95f5ee80a6859089ae61a0c934c,0,0,0,0,0,0,0,0,0,0,0,0,0,0,0,648,20,0,0,0,0,0,0,0,0,0,0,100,NoArch
7229f99eb563f4def02bcb404a9faf133d2e3ff8,1,6,1,5,7,0,0,0,14,53,1,1,0,0,4,649,16,79,0,79,2711,0,2711,26,0,26,0,100,NoArch
4127f298e515107496ae2caadbf211e443748adb,0,0,0,0,0,0,0,0,0,0,0,0,0,0,0,650,17,0,0,0,0,0,0,0,0,0,0,100,NoArch
c377b50e8b3f5d579612ec5acf50d7222bc67cfa,2,10,1,9,11,1,0,1,6,3002,2,2,0.945660305,0,3,651,18,49,0,49,1749,0,1749,21,0,21,1,100,NoArch
06d2e9b333a0f89aa93787f4efb8d0d17435ec1b,0,0,0,0,0,0,0,0,0,0,0,0,0,0,0,652,19,0,0,0,0,0,0,0,0,0,0,100,NoArch
f239e036401916835516cc5908090fa0c2fcf45f,0,0,0,0,0,0,0,0,0,0,0,0,0,0,0,653,20,0,0,0,0,0,0,0,0,0,0,100,NoArch
847987eb20e6b6792dbda6cdded74bbb8be63126,0,0,0,0,0,0,0,0,0,0,0,0,0,0,0,654,21,0,0,0,0,0,0,0,0,0,0,100,NoArch
3a0394796aab3369e2a3d341130e5a625e415f9a,1,13,5,8,18,0,0,0,11,1433,1,1,0,0,3,655,22,41,0,41,1154,0,1154,16,0,16,1,100,NoArch
1d7378b9389e51f71412a06e54e6a95f664b87dc,0,0,0,0,0,0,0,0,0,0,0,0,0,0,0,656,23,0,0,0,0,0,0,0,0,0,0,100,NoArch
1c471e63fbde023d15527c40b11b14370ca10f0f,0,0,0,0,0,0,0,0,0,0,0,0,0,0,0,28,3,0,0,0,0,0,0,0,0,0,0,100,NoArch
20179968fdf118a9361537c4d357062b8dbcd483,8,248,4,244,252,7,0,7,16,27,2,2,2.739723859,0,1,88,0,168,0,168,5977,0,5977,31,0,31,1,99.96983257,NoArch
13d9b7f4695aef2fefa62c33983d7d0e2af49dfd,0,0,0,0,0,0,0,0,0,0,0,0,0,0,0,29,4,0,0,0,0,0,0,0,0,0,0,100,NoArch
92e824fd7c1c15d0d0917475977878019909233c,0,0,0,0,0,0,0,0,0,0,0,0,0,0,0,30,4,0,0,0,0,0,0,0,0,0,0,100,NoArch
207a2e2dc7c489a4dd88858a4a07b0b810ea7dc1,3,215,17,198,232,2,0,2,39,188,2,2,1.173308494,0,1,243,0,164,0,164,7098,0,7098,31,0,31,1,99.96735391,NoArch
51e4bd341d0914bfce725fd50f8f6d502942af8d,0,0,0,0,0,0,0,0,0,0,0,0,0,0,0,31,3,0,0,0,0,0,0,0,0,0,0,100,NoArch
442588f2e0a5602ab38767ff49ac5c0c07f6f873,0,0,0,0,0,0,0,0,0,0,0,0,0,0,0,32,4,0,0,0,0,0,0,0,0,0,0,100,NoArch
8d1fea65bad6de9696fc741de5de72aee7386884,0,0,0,0,0,0,0,0,0,0,0,0,0,0,0,33,5,0,0,0,0,0,0,0,0,0,0,100,NoArch
51e55056938173a2e2d61328f75d14a15b6b153a,0,0,0,0,0,0,0,0,0,0,0,0,0,0,0,34,6,0,0,0,0,0,0,0,0,0,0,100,NoArch
ff553c2ebef258b6b3d35e2e24b6b38e54d125bd,2,49,1,48,50,1,0,1,18,1708,1,2,0.327444919,0,4,244,1,71,0,71,4298,0,4298,17,0,17,1,100,NoArch
49ff640758942b7fb04ee4c1aa27e4b476e62924,0,0,0,0,0,0,0,0,0,0,0,0,0,0,0,35,7,0,0,0,0,0,0,0,0,0,0,100,NoArch
d5a037c07ebdab1fbeb84ddd84c3c5fa2b51bf51,0,0,0,0,0,0,0,0,0,0,0,0,0,0,0,36,5,0,0,0,0,0,0,0,0,0,0,100,NoArch
e4da1a1f1635b7597219f10a3e4e8d13b82a3b1f,2,11,2,9,13,0,0,0,33,790,1,2,0.619382195,0,4,245,1,116,0,116,3844,0,3844,20,0,20,1,100,NoArch
5ff29eb828b101a5c4e3baa5006fab916215fab5,1,6,1,5,7,0,0,0,4,1995,1,1,0,0,3,10,0,18,0,18,752,0,752,10,0,10,1,100,NoArch
e86d581210f2c562e32c2caf84cb1ab53f988d55,0,0,0,0,0,0,0,0,0,0,0,0,0,0,0,37,3,0,0,0,0,0,0,0,0,0,0,100,NoArch
f508bbed9a1261a19f3764b2eff88c8c05b003fc,0,0,0,0,0,0,0,0,0,0,0,0,0,0,0,657,0,0,0,0,0,0,0,0,0,0,0,100,NoArch
bdef24e5a28adcd5df8266f9f04a1c464eccb1c0,0,0,0,0,0,0,0,0,0,0,0,0,0,0,0,658,1,0,0,0,0,0,0,0,0,0,0,100,NoArch
a9cab01883cae2eff38abce30d846214a935b2f6,1,18,4,14,22,0,0,0,3,1270,1,1,0,0,3,659,2,68,0,68,1763,0,1763,21,0,21,0,99.9774017,NoArch
ac9eb62726f6591174305e1612902dfdb18d374a,2,28,10,18,38,1,0,1,36,530,1,2,0.561752608,0,7,660,3,243,0,243,7590,0,7590,88,0,88,0,100,NoArch
c672aa020aa04c71d21c9974b41b7cf66f3088f1,0,0,0,0,0,0,0,0,0,0,0,0,0,0,0,661,4,0,0,0,0,0,0,0,0,0,0,100,NoArch
e1c2196a9f32b80449d814d8be8cd0f8ff59b52e,1,2,2,0,4,0,0,0,40,960,1,1,0,0,2,1310,0,96,0,96,2571,0,2571,28,0,28,0,100,NoArch
8d05228c35fb7e993fa6012f49fbaf8143f6eb15,1,4,0,4,4,1,0,1,2,2496,1,1,0,0,2,1311,1,18,0,18,520,0,520,12,0,12,1,100,NoArch
4bdaa8bbd05872986c65237df20de9967831410a,3,43,0,43,43,3,0,3,49,1721,2,2,1.127631951,0,2,662,5,78,0,78,3671,0,3671,27,0,27,2,100,NoArch
8ee0e0ae8ec778c615a392f0103896886447d8a1,2,6,4,2,10,0,0,0,50,0,2,2,0.881290899,0,2,663,6,78,0,78,3610,0,3610,27,0,27,0,100,NoArch
e3930d75b9748c612113460108285aac741f776e,1,0,2,2,2,0,0,0,9,1006,1,1,0,0,4,664,7,18,0,18,1739,0,1739,16,0,16,0,100,NoArch
ad046a1973f4b998f275adbfb902935d8a3b5dcf,1,1,1,0,2,0,0,0,6,0,1,1,0,0,2,665,8,12,0,12,1029,0,1029,7,0,7,0,100,NoArch
99949c2fa63fd0fce27641969a91d7ab774ab00b,0,0,0,0,0,0,0,0,0,0,0,0,0,0,0,666,9,0,0,0,0,0,0,0,0,0,0,100,NoArch
47d6022fb21630855b568b053fcc5107e4da9eef,0,0,0,0,0,0,0,0,0,0,0,0,0,0,0,38,4,0,0,0,0,0,0,0,0,0,0,100,NoArch
1a620fa29da342e9d0bd5ba7166f3f73d56e3b0e,1,3,1,2,4,0,0,0,8,1348,1,1,0,0,5,0,0,73,0,73,2039,0,2039,8,0,8,1,100,NoArch
d89c487b8a6be48dec36a6f52480eac119401589,2,3,3,0,6,0,0,0,7,2379,2,2,0.918295834,0,2,39,4,15,0,15,916,0,916,12,0,12,0,100,NoArch
fa5db4b1561ff61d8b46682ce0bb09592b42ed6a,0,0,0,0,0,0,0,0,0,0,0,0,0,0,0,40,5,0,0,0,0,0,0,0,0,0,0,100,NoArch
a6b288e53f192a6824a78f3649cfc8d23e74d95f,1,1,3,2,4,0,0,0,9,2,1,1,0,0,5,1,1,73,0,73,2028,0,2028,8,0,8,1,100,NoArch
4df51a9df55d49348c170915a7804cc781b6ad23,0,0,0,0,0,0,0,0,0,0,0,0,0,0,0,41,5,0,0,0,0,0,0,0,0,0,0,100,NoArch
e96b56ddf022b8055ef8df552dce0d9c8e8d67d2,0,0,0,0,0,0,0,0,0,0,0,0,0,0,0,42,5,0,0,0,0,0,0,0,0,0,0,100,NoArch
327dbe8545436030b62a49a3ca526c9f07dbdc5b,0,0,0,0,0,0,0,0,0,0,0,0,0,0,0,43,5,0,0,0,0,0,0,0,0,0,0,100,NoArch
25e9b9b32b0f86d6e404084b0259e8b6c77b5bab,0,0,0,0,0,0,0,0,0,0,0,0,0,0,0,44,6,0,0,0,0,0,0,0,0,0,0,100,NoArch
b3351649d76edd4ff42e13b27d66b88419e3a974,0,0,0,0,0,0,0,0,0,0,0,0,0,0,0,45,7,0,0,0,0,0,0,0,0,0,0,100,NoArch
a4f720e84c2717c1f6cb8286ac15c5db79dbd684,3,19,3,16,22,1,0,1,96,276,2,2,1.497015106,0,6,1312,0,568,0,568,26194,0,26194,361,0,361,1,100,NoArch
100cf6eb25cb65fcc520823a2ad66f4ee60d23ab,0,0,0,0,0,0,0,0,0,0,0,0,0,0,0,46,7,0,0,0,0,0,0,0,0,0,0,100,NoArch
d8fbcd0c20d4e1878ab89b4027e3d4a26e21f0fe,2,27,12,15,39,1,0,1,39,142,1,2,0.619382195,0,5,11,0,139,0,139,5422,0,5422,54,0,54,1,100,NoArch
3da3216d4c378ee5decb754c96eb60aedaad9149,0,0,0,0,0,0,0,0,0,0,0,0,0,0,0,47,6,0,0,0,0,0,0,0,0,0,0,100,NoArch
12ece5cc7e141615bc47ef5052b5e55a6c44c72c,1,3,3,0,6,0,0,0,2,2543,1,1,0,0,2,246,0,8,0,8,222,0,222,4,0,4,0,100,NoArch
9e3a1b5ee533167da46a91b27b2f869709720222,0,0,0,0,0,0,0,0,0,0,0,0,0,0,0,48,6,0,0,0,0,0,0,0,0,0,0,100,NoArch
cc3f99579161dbd375f22ec8c3e92357f1fb57e2,1,132,1,131,133,0,0,0,6,252,1,1,0,0,2,49,7,26,0,26,1403,0,1403,5,0,5,1,100,NoArch
0507c7271a27d4e91d4bd3342aa2ca2f5d9f559f,2,14,76,62,90,1,0,1,9,126,1,2,0.623570208,0,2,50,8,82,0,82,3000,0,3000,10,0,10,1,100,NoArch
5408d1379837b5d165584efb4da607a67f0995d6,0,0,0,0,0,0,0,0,0,0,0,0,0,0,0,51,9,0,0,0,0,0,0,0,0,0,0,100,NoArch
c49437d8981b646524a5e626b1569191fbf46e6f,2,0,59,59,59,0,0,0,10,0,1,2,0.616166193,0,2,52,10,78,0,78,2756,0,2756,14,0,14,0,100,NoArch
e65f91380edede8e5bf70abc87f7c2d8033ab939,0,0,0,0,0,0,0,0,0,0,0,0,0,0,0,53,10,0,0,0,0,0,0,0,0,0,0,100,NoArch
9f5c4e0aeadc51571e43a09d97283483618d5c2d,0,0,0,0,0,0,0,0,0,0,0,0,0,0,0,54,7,0,0,0,0,0,0,0,0,0,0,100,NoArch
3ad86b702b7369a1c73bac7f6b1b2b3255697068,1,3,0,3,3,1,0,1,5,1149,1,1,0,0,3,667,0,15,0,15,521,0,521,2,0,2,0,100,NoArch
f5673ddb38b54dde6dd8369ee0bcf9df66efff4a,0,0,0,0,0,0,0,0,0,0,0,0,0,0,0,668,1,0,0,0,0,0,0,0,0,0,0,100,NoArch
f1972f0e14c0b838e03ff85c77eec127c1865c67,0,0,0,0,0,0,0,0,0,0,0,0,0,0,0,669,2,0,0,0,0,0,0,0,0,0,0,100,NoArch
33620a75b80d761af235a0d4818ae25fd58816e7,3,13,1,12,14,2,0,2,20,2246,1,3,1.431560284,0,4,670,3,249,0,249,7243,0,7243,60,0,60,1,100,NoArch
92a819a8d76d74dfc5ec35ff58603385adbf3514,0,0,0,0,0,0,0,0,0,0,0,0,0,0,0,671,4,0,0,0,0,0,0,0,0,0,0,100,NoArch
68a546b082cc00a6dded3f8a4d3037b4fdfefee6,1,13,9,4,22,0,0,0,5,847,1,1,0,0,4,0,0,66,0,66,2320,0,2320,11,0,11,1,100,NoArch
5429e26bcabff5b2deb9526e372064a8c9eab7c2,1,6,3,3,9,0,0,0,9,218,1,1,0,0,6,247,0,35,0,35,1166,0,1166,12,0,12,1,100,NoArch
ac78dd7325cd53925ac9a13f0a3cf620cda365d9,0,0,0,0,0,0,0,0,0,0,0,0,0,0,0,672,5,0,0,0,0,0,0,0,0,0,0,100,NoArch
9e94fdd61b942ce6be2076f82a766a08542d0b96,1,6,0,6,6,1,0,1,40,165,1,1,0,0,9,673,6,150,0,150,6280,0,6280,17,0,17,1,100,NoArch
397468db5dd547fb96b3d7db3b80d0e8f683ac94,1,1,1,0,2,0,0,0,37,116,1,1,0,0,7,248,1,202,0,202,6429,0,6429,71,0,71,1,100,NoArch
d421e26be0604892c85d2e192e9e6ac13690a9dc,1,1,1,0,2,0,0,0,13,255,1,1,0,0,4,674,7,49,0,49,1523,0,1523,9,0,9,1,100,NoArch
32245004dc6be0abec81aed3457f3fd65fdbd13e,0,0,0,0,0,0,0,0,0,0,0,0,0,0,0,675,8,0,0,0,0,0,0,0,0,0,0,100,NoArch
fdbddc70638dca598b1ca1285756353338c6c36b,4,92,22,70,114,2,0,2,12,635,1,3,1.449749696,0,2,1,0,94,0,94,3010,0,3010,36,0,36,0,100,NoArch
65a2c76015a39b15f621b775f426a756cceee613,4,22,92,70,114,0,0,0,13,0,1,3,1.449749696,0,2,2,1,87,0,87,2634,0,2634,34,0,34,0,100,NoArch
f6e1f67c2e6556585b43bf4c9ddf78566c10d8fb,4,92,22,70,114,2,0,2,14,0,1,3,1.449749696,0,2,3,2,94,0,94,3010,0,3010,36,0,36,1,100,NoArch
d9b159fbb74aaacecd4377c01a94bf3d70983d7f,2,28,4,24,32,1,0,1,22,1453,1,2,0.988699408,0,5,249,2,63,0,63,2986,0,2986,20,0,20,1,100,NoArch
1008b93b6bd1c925db2f3425e2aa3f42d26c8d05,0,0,0,0,0,0,0,0,0,0,0,0,0,0,0,55,1,0,0,0,0,0,0,0,0,0,0,100,NoArch
464e6997395dc03c44f5958dae5fa21fc5d40550,0,0,0,0,0,0,0,0,0,0,0,0,0,0,0,56,2,0,0,0,0,0,0,0,0,0,0,100,NoArch
de766416b3e7d09d0bfff6995360feaeb442a72d,3,65,14,51,79,1,0,1,12,1097,1,2,1.267938336,0,1,1313,0,159,0,159,6287,0,6287,83,0,83,1,100,NoArch
144ab39154fa280b1540c208e2391a9aa5f20eef,0,0,0,0,0,0,0,0,0,0,0,0,0,0,0,57,2,0,0,0,0,0,0,0,0,0,0,100,NoArch
71c73e4a2604e6f03a07d2c198544500eb91bc57,1,4,0,4,4,1,0,1,2,2645,1,1,0,0,2,1314,1,10,0,10,366,0,366,4,0,4,1,100,NoArch
9085c8578c026b0a7f41c2abdb2186ea2db389cd,0,0,0,0,0,0,0,0,0,0,0,0,0,0,0,58,3,0,0,0,0,0,0,0,0,0,0,100,NoArch
33d66d09609196f763524474645e49e0d0136153,1,3,1,2,4,0,0,0,6,480,1,1,0,0,2,59,4,311,0,311,9477,0,9477,109,0,109,0,100,NoArch
7c309b52b8d42011cf47c9d76f3e292cf7caf64d,1,16,2,14,18,0,0,0,48,357,1,1,0,0,4,60,5,116,0,116,3946,0,3946,22,0,22,0,100,NoArch
45c1a5ca5be23a7db38fb623b7e6f2d1933dd9e1,1,0,14,14,14,0,0,0,49,0,1,1,0,0,4,61,6,115,0,115,3833,0,3833,22,0,22,0,100,NoArch
c632ec3e8c8636824a7efe98fdd1d89d975dc16c,0,0,0,0,0,0,0,0,0,0,0,0,0,0,0,62,7,0,0,0,0,0,0,0,0,0,0,100,NoArch
5ef5d91a8cb181dd532c8e83b53e7f8c3f272f5a,0,0,0,0,0,0,0,0,0,0,0,0,0,0,0,63,8,0,0,0,0,0,0,0,0,0,0,100,NoArch
6f2bda483ffba734732de60628ce45d19ebaeda9,2,2,5,3,7,0,0,0,10,1457,2,2,0.985228136,0,5,676,2,134,0,134,3672,0,3672,61,0,61,1,100,NoArch
29b6bd0a90dce881a201f0ceec5d006febfc2e16,0,0,0,0,0,0,0,0,0,0,0,0,0,0,0,677,3,0,0,0,0,0,0,0,0,0,1,100,NoArch
3df773fdca372fca05eef60dc536999c7b7b5aa3,0,0,0,0,0,0,0,0,0,0,0,0,0,0,0,678,4,0,0,0,0,0,0,0,0,0,0,100,NoArch
6af5dd43d2aa810880fb03c890bf3f780bc73e7f,1,3,2,1,5,0,0,0,6,2665,1,1,0,0,3,250,1,31,0,31,1408,0,1408,4,0,4,1,100,NoArch
faeb3e2e94d1cf84d7cc549e838fc15fe38dbe5d,1,2,2,0,4,0,0,0,6,2,1,1,0,0,5,251,2,59,0,59,1982,0,1982,17,0,17,0,100,NoArch
6627bee4db9ea9f1513937bb5e3da63202c9acee,1,38,4,34,42,0,0,0,15,46,1,1,0,0,4,679,3,46,0,46,1135,0,1135,17,0,17,1,100,NoArch
1f6dea5acad04d421b9401088a5c4f727c67e871,1,3,4,1,7,0,0,0,16,0,1,1,0,0,4,680,4,46,0,46,1131,0,1131,17,0,17,0,100,NoArch
1705271ca56be4f0e7dffc97c848664e2d80158c,0,0,0,0,0,0,0,0,0,0,0,0,0,0,0,681,5,0,0,0,0,0,0,0,0,0,0,100,NoArch
1ae35cfba434df153da098afb51490d90a3dacf0,1,2,21,19,23,0,0,0,4,3326,1,1,0,0,3,252,2,10,0,10,312,0,312,5,0,5,1,100,NoArch
aaa6de9cef123a06946c575f87c0c11948d54ab0,1,27,16,11,43,0,0,0,7,251,1,1,0,0,5,682,6,48,0,48,1428,0,1428,19,0,19,2,97.6768501,Arch
6c30be6277eed5712040d21c01d80ed14b167ff8,2,15,11,4,26,0,0,0,10,189,1,1,0.619382195,0,5,683,7,87,0,87,2655,0,2655,28,0,28,0,100,NoArch
4347218d37056784095a255cd05d3d41389a74d3,0,0,0,0,0,0,0,0,0,0,0,0,0,0,0,684,8,0,0,0,0,0,0,0,0,0,0,100,NoArch
9aba4dff9143982a983a00ea044b2f929be8bb9a,1,1,1,0,2,0,0,0,43,918,1,1,0,0,7,685,9,82,0,82,2379,0,2379,23,0,23,1,100,NoArch
c12aac7c590412708655a56570e17f373f95a132,1,4,1,3,5,0,0,0,24,1421,1,1,0,0,6,686,10,32,0,32,1171,0,1171,5,0,5,1,100,NoArch
87e75e9ebca0b8dea94e46f812080fac168e6094,0,0,0,0,0,0,0,0,0,0,0,0,0,0,0,687,11,0,0,0,0,0,0,0,0,0,0,100,NoArch
1daf48050f1be39840374a55c1b36bfa98fe7c96,1,10,7,3,17,0,0,0,18,953,1,1,0,0,3,1315,1,69,0,69,1685,0,1685,25,0,25,0,100,NoArch
9511ef7a266cb785db1a2f13ad6ceca426f4018e,1,5,3,2,8,0,0,0,14,1759,1,1,0,0,3,1316,2,86,0,86,2810,0,2810,36,0,36,1,100,NoArch
53c8b7152c228a8c2678bdba0fcba0473b5220e4,0,0,0,0,0,0,0,0,0,0,0,0,0,0,0,64,6,0,0,0,0,0,0,0,0,0,0,100,NoArch
c97b70d3b798acafea448ba18dfad93c38d0af02,4,41,14,27,55,3,0,3,67,755,2,2,1.647867551,0,3,1317,3,377,0,377,18276,0,18276,199,0,199,1,100,NoArch
03d4e4fa81097e07607b60c439bb2f0b8f0833b8,0,0,0,0,0,0,0,0,0,0,0,0,0,0,0,65,7,0,0,0,0,0,0,0,0,0,0,100,NoArch
b06edc91415767b4377401bddacf7889bdeb52a3,0,0,0,0,0,0,0,0,0,0,0,0,0,0,0,66,8,0,0,0,0,0,0,0,0,0,0,100,NoArch
f5ac8ade53d25b0a1d45972281a9ab03ed757d5c,0,0,0,0,0,0,0,0,0,0,0,0,0,0,0,67,9,0,0,0,0,0,0,0,0,0,0,100,NoArch
05239840b7a6a4cec5112bbb6c7a4768b4aaf170,3,10,6,4,16,0,0,0,86,1036,1,3,1.329434003,0,2,1318,4,492,0,492,25576,0,25576,213,0,213,1,100,NoArch
915cabf8b784cd7a363d765c7a3f70cdef85d449,3,48,7,41,55,0,0,0,9,1527,1,2,1.567368721,0,3,1319,5,69,0,69,2331,0,2331,40,0,40,1,100,NoArch
b6d8e0fbfd356eac4cc27e809ad9c034ca027d49,2,91,20,71,111,0,0,0,4,748,1,1,0.93526914,0,3,12,0,58,0,58,2344,0,2344,13,0,13,1,100,NoArch
86b694872f46eb8c69480878eca4232cacae65d3,1,22,6,16,28,0,0,0,5,2187,1,1,0,0,3,688,9,19,0,19,426,0,426,10,0,10,1,99.99223321,NoArch
1da5667b895bcd94d115506921c504c97966af7f,1,3,0,3,3,1,0,1,6,110,1,1,0,0,4,689,10,67,0,67,2330,0,2330,11,0,11,1,100,NoArch
2ede9f90eb8e9a3ca4ec393b87353cd0d4be9422,1,101,85,16,186,0,0,0,30,445,1,1,0,0,7,690,11,104,0,104,3815,0,3815,24,0,24,1,100,NoArch
489ac889947c265565eeaa116c04fd31b8c80b65,1,10,3,7,13,0,0,0,14,633,1,1,0,0,4,691,12,69,0,69,2402,0,2402,15,0,15,1,100,NoArch
0fd50efe20914bb45fcb0bc29515d47138397f85,1,0,1,1,1,0,0,0,31,0,1,1,0,0,7,692,13,104,0,104,3810,0,3810,24,0,24,1,100,NoArch
958bd74711da157d88b9cd3246b1c66dd82ba128,0,0,0,0,0,0,0,0,0,0,0,0,0,0,0,693,14,0,0,0,0,0,0,0,0,0,0,100,NoArch
ce7a84f5d938c309b3cde12beb963092c1ee4642,1,4,4,0,8,0,0,0,32,0,1,1,0,0,7,694,15,104,0,104,3810,0,3810,24,0,24,0,100,NoArch
12e653ead331ffa48960d68fca19e01fe6ee6b98,2,89,25,64,114,0,0,0,3,1857,1,2,0.956035366,0,3,0,0,84,0,84,4169,0,4169,39,0,39,1,100,NoArch
40359e56376f60e63b2cfa4930cb187c11e5e54d,1,1,7,6,8,0,0,0,10,1709,1,1,0,0,5,65,0,82,0,82,2560,0,2560,20,0,20,0,100,NoArch
053ef5a200b6491bce296131fcb93b992f19bc2b,1,0,1,1,1,0,0,0,11,0,1,1,0,0,5,695,13,82,0,82,2553,0,2553,20,0,20,0,100,NoArch
8a39c85156b444e38d19fb8032916e71380e1357,0,0,0,0,0,0,0,0,0,0,0,0,0,0,0,696,14,0,0,0,0,0,0,0,0,0,0,100,NoArch
6da164259018c3a03f2e51b43516cb18cfdda6a7,2,2,2,0,4,0,0,0,4,0,1,2,0.811278124,0,4,697,15,84,0,84,4162,0,4162,39,0,39,0,100,NoArch
8d9582899a4fb15cf9cb3cb45a23c5689f5adf98,0,0,0,0,0,0,0,0,0,0,0,0,0,0,0,68,4,0,0,0,0,0,0,0,0,0,0,100,NoArch
5b9d08c6c5af301dd4dc0ba8dbb194be24257121,0,0,0,0,0,0,0,0,0,0,0,0,0,0,0,69,5,0,0,0,0,0,0,0,0,0,0,100,NoArch
a63f8352a6c660b248aec5316a6a987c428862a3,0,0,0,0,0,0,0,0,0,0,0,0,0,0,0,70,6,0,0,0,0,0,0,0,0,0,0,100,NoArch
d4c640b4cc85bd7a58c8065e7755c1b7c54567c7,1,7,0,7,7,1,0,1,33,8,1,1,0,0,7,698,16,105,0,105,3849,0,3849,24,0,24,0,100,NoArch
bf8fea668d23a2fc1bde471fad763ba63e112f11,1,1,1,0,2,0,0,0,6,9,1,1,0,0,3,699,17,20,0,20,430,0,430,10,0,10,0,100,NoArch
251181dd7d058bb1c03ff63b5b392909b4f97c2c,0,0,0,0,0,0,0,0,0,0,0,0,0,0,0,700,18,0,0,0,0,0,0,0,0,0,0,100,NoArch
e51c40dcbb164a8e16c1dc78df449d8c749d00ed,0,0,0,0,0,0,0,0,0,0,0,0,0,0,0,701,19,0,0,0,0,0,0,0,0,0,0,100,NoArch
9fca6223bafa26ed4a9ecaa1697d93f1509390aa,0,0,0,0,0,0,0,0,0,0,0,0,0,0,0,702,20,0,0,0,0,0,0,0,0,0,0,100,NoArch
3569c225420d916a3591d9c134109e1094870f5e,2,0,31,31,31,0,0,0,5,364,1,2,0.637387499,0,4,703,0,88,0,88,4311,0,4311,39,0,39,0,100,NoArch
0e61c85cf844d56042567d49b5db1e5c73059e11,0,0,0,0,0,0,0,0,0,0,0,0,0,0,0,704,1,0,0,0,0,0,0,0,0,0,1,100,NoArch
2d762c3a76001a08698fa3ed9efe26c8edab1751,0,0,0,0,0,0,0,0,0,0,0,0,0,0,0,705,2,0,0,0,0,0,0,0,0,0,1,100,NoArch
5353b61f59a09361813c99e25cc0c115035c8774,2,0,3,3,3,0,0,0,2,586,1,1,0.918295834,0,2,706,3,3,0,3,348,0,348,3,0,3,0,100,NoArch
2a5237b383fe4229adb274133116ff7857f0c835,0,0,0,0,0,0,0,0,0,0,0,0,0,0,0,707,4,0,0,0,0,0,0,0,0,0,0,100,NoArch
392af4b36edcab9096793c080085392eb5265b36,2,12,2,10,14,1,0,1,20,882,1,2,0.371232327,0,2,708,5,274,0,274,15816,0,15816,174,0,174,0,100,NoArch
01b9698286da1b2d9c77cfe63db9236551ce228c,0,0,0,0,0,0,0,0,0,0,0,0,0,0,0,709,6,0,0,0,0,0,0,0,0,0,0,100,NoArch
7add12478adc299e77a6bfc2cd2a816d41e1d730,0,0,0,0,0,0,0,0,0,0,0,0,0,0,0,710,7,0,0,0,0,0,0,0,0,0,0,100,NoArch
a29255fd7dcf6e273c4b3228b76eae4ab5643327,0,0,0,0,0,0,0,0,0,0,0,0,0,0,0,711,8,0,0,0,0,0,0,0,0,0,0,100,NoArch
ac2842b8682e386882f04f56bbea13b00ba34098,2,2,2,0,4,0,0,0,21,1744,2,2,0.811278124,0,4,0,0,197,0,197,5467,0,5467,62,0,62,0,99.9974112,NoArch
1a01c8bcdd9b9b038487c8cc7f692d65cfdfe39a,10,142,123,19,265,5,0,5,44,3360,4,10,1.203633506,0,7,1,1,450,0,450,37495,0,37495,280,0,280,0,100,NoArch
2fef247abfaa315c5b806c2606ed36ff47abff11,0,0,0,0,0,0,0,0,0,0,0,0,0,0,0,0,0,0,0,0,0,0,0,0,0,0,0,100,NoArch
6caf7910f741317a6eabd1b7ccee0d9345f654d3,1,82,60,22,142,0,0,0,24,4492,1,1,0,0,8,0,0,120,0,120,4419,0,4419,21,0,21,0,100,NoArch
73963a760286eeacc425f4cd366b7dd8dbf20795,3,187,74,113,261,0,0,0,10,4637,1,2,0.983390169,0,2,1,1,207,0,207,7348,0,7348,82,0,82,0,99.96117611,NoArch
d8e4ea6a67b4093f703387919a98f0026a9d6724,4,70,8,62,78,0,0,0,39,4876,2,3,1.755896189,0,7,2,2,145,0,145,7539,0,7539,86,0,86,0,100,NoArch
69116a277426a3953ab3484f1c79f83960f1ba9c,0,0,0,0,0,0,0,0,0,0,0,0,0,0,0,1,1,0,0,0,0,0,0,0,0,0,0,100,NoArch
cee209269f55e01e5182400f0478f2d1fb3dfdc0,0,0,0,0,0,0,0,0,0,0,0,0,0,0,0,2,2,0,0,0,0,0,0,0,0,0,0,100,NoArch
d42e1e9922dccd0d0a7d95e4500b85def20452f1,0,0,0,0,0,0,0,0,0,0,0,0,0,0,0,3,3,0,0,0,0,0,0,0,0,0,0,100,NoArch
db5457d37f76794a38fe421bb9ca91dbfebc6899,0,0,0,0,0,0,0,0,0,0,0,0,0,0,0,4,4,0,0,0,0,0,0,0,0,0,0,100,NoArch
185d7dbc310ff6c5c5d036e76a2cc832dcb77a95,0,0,0,0,0,0,0,0,0,0,0,0,0,0,0,71,0,0,0,0,0,0,0,0,0,0,0,100,NoArch
38d0447c78d55862842b32c04c90382cb0808e4d,1,44,45,1,89,0,0,0,13,1200,1,1,0,0,3,72,1,16,0,16,1906,0,1906,13,0,13,0,100,NoArch
7b5c17f4be63753772d1462edd3dd591c239faa6,1,96,100,4,196,0,0,0,3,1200,1,1,0,0,3,73,2,12,0,12,1691,0,1691,5,0,5,0,100,NoArch
7aa3f2da2b6bb50e1a252cccfc72bd1b305c9c2e,1,86,88,2,174,0,0,0,29,1200,1,1,0,0,4,74,3,30,0,30,4159,0,4159,19,0,19,0,100,NoArch
f318ee614c8cdc6f2c485d42ff2d670d67e6455a,3,233,4,229,237,2,0,2,12,3693,1,2,0.462297925,0,1,75,4,92,0,92,4039,0,4039,37,0,37,0,99.98706406,NoArch
72c4194a634a40265171b4288927f35dc329c552,2,305,119,186,424,0,0,0,13,0,1,2,0.767505869,0,1,76,5,79,0,79,3965,0,3965,27,0,27,0,100,NoArch
f25f4a51bf0de5255414c233f41ccc35cf00a073,1,113,58,55,171,0,0,0,50,3257,1,1,0,0,4,77,6,130,0,130,4193,0,4193,23,0,23,0,100,NoArch
5e3d67fab74b8abd33ed9cc1d3b828a85c9bcd9f,0,0,0,0,0,0,0,0,0,0,0,0,0,0,0,78,0,0,0,0,0,0,0,0,0,0,0,100,NoArch
401ea713ed2b45dccf040f19bb68cfc756bd230f,0,0,0,0,0,0,0,0,0,0,0,0,0,0,0,79,1,0,0,0,0,0,0,0,0,0,0,100,NoArch
3a02646ba6341b701161b9eb16f0bcdd8397fc7d,0,0,0,0,0,0,0,0,0,0,0,0,0,0,0,80,2,0,0,0,0,0,0,0,0,0,0,100,NoArch
3733309aaa0c506277d02f0dd918d1a5c0bfd60b,1,1,0,1,1,1,0,1,51,4663,1,1,0,0,5,81,3,77,0,77,6794,0,6794,50,0,50,0,100,NoArch
d005101883f27354c97425106fc9e89f80256195,0,0,0,0,0,0,0,0,0,0,0,0,0,0,0,82,4,0,0,0,0,0,0,0,0,0,0,100,NoArch
5fefe9161e04cc3618f8a2b8c4a1d083d33bad21,0,0,0,0,0,0,0,0,0,0,0,0,0,0,0,83,5,0,0,0,0,0,0,0,0,0,0,100,NoArch
efb481b4611e3844dca1caa3a8152ee54773f75e,0,0,0,0,0,0,0,0,0,0,0,0,0,0,0,84,6,0,0,0,0,0,0,0,0,0,0,100,NoArch
8aec6eb7b5dab3ea634ac385c53f92760ad9fe63,0,0,0,0,0,0,0,0,0,0,0,0,0,0,0,85,7,0,0,0,0,0,0,0,0,0,0,100,NoArch
6980f54e01fa711be443ad48bc27717744d50b67,0,0,0,0,0,0,0,0,0,0,0,0,0,0,0,86,8,0,0,0,0,0,0,0,0,0,0,100,NoArch
fab0ae2133bc3418a230d399795f97bc7eb6ac2b,0,0,0,0,0,0,0,0,0,0,0,0,0,0,0,87,9,0,0,0,0,0,0,0,0,0,0,100,NoArch
03b40aa269900098531821e6782f4966e5929307,0,0,0,0,0,0,0,0,0,0,0,0,0,0,0,88,10,0,0,0,0,0,0,0,0,0,0,100,NoArch
a761165b01496569d1712a89a7dd1f98672f522c,0,0,0,0,0,0,0,0,0,0,0,0,0,0,0,472,9,0,0,0,0,0,0,0,0,0,0,100,NoArch
21e1aecc26ec2f81a6074e5afb475e9d48a16e25,2,3,0,3,3,2,0,2,3,654,1,2,0.918295834,0,2,473,10,119,0,119,3349,0,3349,37,0,37,0,100,NoArch
dad812c80aeb9e629d1650e57cee81c6fe609c9e,4,17,16,1,33,0,0,0,9,1561,2,2,1.643790802,0,4,474,11,191,0,191,7208,0,7208,70,0,70,0,100,NoArch
11f1414fed14e737c033122086bc95bbfd24d286,0,0,0,0,0,0,0,0,0,0,0,0,0,0,0,475,12,0,0,0,0,0,0,0,0,0,0,100,NoArch
80968abfaab5ea7d2c733fdabc44f4d68b60cc11,0,0,0,0,0,0,0,0,0,0,0,0,0,0,0,476,13,0,0,0,0,0,0,0,0,0,0,100,NoArch
f178adea454d581738ac0998ce90281788363666,0,0,0,0,0,0,0,0,0,0,0,0,0,0,0,477,14,0,0,0,0,0,0,0,0,0,0,100,NoArch
ec74cbc6f12bc03fd4f9e26aa5ae8ed3ce266dc7,0,0,0,0,0,0,0,0,0,0,0,0,0,0,0,529,6,0,0,0,0,0,0,0,0,0,0,100,NoArch
d2561a8c6540d7751bec3f798003bfc5a3d1483e,1,7,3,4,10,0,0,0,5,503,1,1,0,0,3,478,15,10,0,10,749,0,749,8,0,8,0,100,NoArch
74367309be3f7460277f6ebf4b49331ab7225fc7,1,2,25,23,27,0,0,0,6,0,1,1,0,0,3,479,16,7,0,7,628,0,628,7,0,7,0,100,NoArch
e2970e4184694c0e9ad7544178b7963c86f426fd,0,0,0,0,0,0,0,0,0,0,0,0,0,0,0,530,7,0,0,0,0,0,0,0,0,0,0,100,NoArch
64f746bdd2f653d2a984edf29548e926a8417530,14,152,136,16,288,0,0,0,79,196,2,6,2.694837495,0,2,1297,5,1007,0,1007,36308,0,36308,507,0,507,1,100,NoArch
7ac63d08f725d722ee5776f4dea1d47429cca042,3,50,7,43,57,1,0,1,13,448,1,3,1.385751974,0,1,1298,5,271,0,271,14896,0,14896,159,0,159,1,100,NoArch
063653a71e2edfb336d01fb1afe33c1ae5ee4d82,1,0,3,3,3,0,0,0,6,0,1,1,0,0,1,1299,6,101,0,101,9733,0,9733,96,0,96,0,100,NoArch
4be00ae87165db5571771d22874e894ed6165896,2,70,0,70,70,2,0,2,9,1138,1,2,0.749595257,0,1,531,8,58,0,58,3862,0,3862,26,0,26,1,99.55696581,NoArch
c6eb8554277b43d4400da409178c9aa8d337bdd7,1,38,0,38,38,1,0,1,10,177,1,1,0,0,3,480,17,58,0,58,1443,0,1443,8,0,8,1,100,NoArch
9e9229024a0598c89c6ba7cf6c2a460a6bf0bf1a,8,963,2,961,965,6,0,6,15,228,2,3,2.086192499,0,1,220,2,812,0,812,21918,0,21918,208,0,208,1,99.43144995,NoArch
06df090f1f896927510d84c9faaefd5007814c40,3,33,3,30,36,1,0,1,10,1258,2,2,1.244918753,0,3,481,18,33,0,33,3145,0,3145,14,0,14,1,100,NoArch
61b8710b15a8c75610b5b7ebca4809862a2231fc,1,7,0,7,7,1,0,1,12,65,1,1,0,0,3,179,0,116,0,116,2812,0,2812,18,0,18,1,100,NoArch
2db6982fd7f9a88c74b45efd018cb849cc4eafbf,1,0,20,20,20,0,0,0,2,2,1,1,0,0,2,482,19,118,0,118,2478,0,2478,36,0,36,0,100,NoArch
9f8cf3ce0e9d89d19446cb6d71b897e118a7e7e8,2,64,5,59,69,1,0,1,4,294,1,2,0.698124573,0,1,69,1,60,0,60,3097,0,3097,22,0,22,1,99.98544692,NoArch
4a2478c0b0b8257829538ceb66d37bd0f44c0122,1,34,4,30,38,0,0,0,5,352,1,1,0,0,4,180,1,46,0,46,3143,0,3143,27,0,27,1,100,NoArch
16717e8afb5052384c2bfdc56922da2a2cb7d15a,1,72,57,15,129,0,0,0,39,314,1,1,0,0,3,532,9,110,0,110,3731,0,3731,22,0,22,1,100,NoArch
296459202fae7f31b7d728bd6a062882b70fec17,1,3,1,2,4,0,0,0,50,80,1,1,0,0,3,533,10,98,0,98,3608,0,3608,12,0,12,1,100,NoArch
7c5edcc97b0702602d5fd2dc2324031efefe6430,0,0,0,0,0,0,0,0,0,0,0,0,0,0,0,143,0,0,0,0,0,0,0,0,0,0,0,100,NoArch
5264fee8c304e50298ad1c918ec3ebae7cbc5958,2,28,1,27,29,1,0,1,7,526,2,2,0.735508582,0,2,221,3,34,0,34,1893,0,1893,22,0,22,1,100,NoArch
439765aa27ae435b394d60ac8d98bf2bb53eddb7,1,22,13,9,35,0,0,0,7,88,1,1,0,0,4,70,2,95,0,95,1977,0,1977,25,0,25,1,100,NoArch
3c5ce71bffa94f4bcaeaac33fb6dcc88e1da61fd,6,40,2,38,42,5,0,5,121,245,2,4,2.243158792,0,6,1300,3,808,0,808,33177,0,33177,427,0,427,1,100,NoArch
bbfad1a47f7ac3055cba2782296c85d760298f20,1,12,2,10,14,0,0,0,25,152,1,1,0,0,4,1301,4,355,0,355,11375,0,11375,109,0,109,1,100,NoArch
4331319e68c718f286fee4e8c183791c0ca9e7e3,2,6,4,2,10,0,0,0,34,217,2,2,0.970950594,0,3,1302,5,76,0,76,2613,0,2613,30,0,30,1,100,NoArch
da79305a37be73126ea18b7ed8da4343e2471133,1,15,3,12,18,0,0,0,14,199,1,1,0,0,4,222,2,45,0,45,1969,0,1969,8,0,8,1,100,NoArch
3d691c0f889d8f410304606dfdfb37ca600c1b32,2,1614,1478,136,3092,1,0,1,86,92,1,1,0.999517059,0,6,534,6,345,0,345,10466,0,10466,119,0,119,1,99.99418097,NoArch
7aeab23026a6f92085cb48b0756f06c431998d71,0,0,0,0,0,0,0,0,0,0,0,0,0,0,0,181,2,0,0,0,0,0,0,0,0,0,0,100,NoArch
98758817124cc348bcb6553591ff157cdc1cf747,1,4,2,2,6,0,0,0,20,100,1,1,0,0,7,71,2,120,0,120,2605,0,2605,10,0,10,1,100,NoArch
7050fa40a6a5359b308ff43e3d2430cb9ad80b8d,2,9,0,9,9,2,0,2,78,170,1,2,0.918295834,0,1,1303,6,223,0,223,8528,0,8528,93,0,93,1,100,NoArch
3b69cb2b7970ed12c3e15f7aa03c0b8645b086a6,1,7,0,7,7,1,0,1,18,0,1,1,0,0,1,1304,7,32,0,32,2422,0,2422,32,0,32,1,100,NoArch
dd00f5ddc0e29250cd89d417001c373d51a7c5cf,0,0,0,0,0,0,0,0,0,0,0,0,0,0,0,535,6,0,0,0,0,0,0,0,0,0,0,100,NoArch
ce6ca53ec5fe94b00b535d61294c3c32775b6f5f,5,51,39,12,90,2,0,2,8,1450,2,3,1.859180642,0,2,4,0,133,0,133,4880,0,4880,59,0,59,1,100,NoArch
ee5ba030217ef665b05e55a2fff878cb3b292447,1,4,2,2,6,0,0,0,4,38,1,1,0,0,1,1305,8,62,0,62,1719,0,1719,26,0,26,0,100,NoArch
4c810995097293a823238f1ea75c51d1947918ef,6,49,6,43,55,3,0,3,62,375,2,5,1.915034935,0,4,1306,9,291,0,291,23655,0,23655,159,0,159,1,100,NoArch
4dfac9b742a060c00557a99b552d7ad3b2efd202,1,1,1,0,2,0,0,0,4,372,1,1,0,0,1,1307,10,12,0,12,602,0,602,10,0,10,1,100,NoArch
861498e087d7bb15b039c8a5d702569410897637,3,43,1,42,44,2,0,2,11,402,1,2,1.520523353,0,1,1308,11,84,0,84,2519,0,2519,51,0,51,0,99.94764093,NoArch
fd44f59923e02e53b504ae5577063c2b45aa1bd9,7,200,15,185,215,2,0,2,4,180,1,1,1.960144253,0,2,5,1,39,0,39,2784,0,2784,23,0,23,1,99.97963814,NoArch
833584e76584d96f136cf082fc53eec98c050f8c,3,61,2,59,63,2,0,2,12,0,1,2,1.492643176,0,1,1309,11,50,0,50,2018,0,2018,18,0,18,0,99.98545878,NoArch
9a0741ec27e99a31aa23e42cd4bc0d9b0d7f7a71,3,8,4,4,12,1,0,1,10,445,2,2,1.28067213,0,4,57,0,93,0,93,4477,0,4477,22,0,22,1,100,NoArch
d47bd8b4ca2c6690ddbdd18c7fc0345f7267a4d2,2,24,17,7,41,1,0,1,53,129,1,2,0.759275785,0,4,1310,12,98,0,98,4397,0,4397,19,0,19,0,100,NoArch
e3215f9981fede15e083ee384a8fbfd45cfb9d47,4,53,12,41,65,1,0,1,114,864,1,4,1.768458491,0,3,483,3,368,0,368,10490,0,10490,88,0,88,1,100,NoArch
e4f7ef81eb8874378728dbbd13c6fcba2795b461,2,49,5,44,54,1,0,1,10,93,2,2,0.852405179,0,4,484,4,84,0,84,3090,0,3090,10,0,10,1,99.98837108,NoArch
dacf90005d7c36efa14c6b62263455cd4ae053e1,1,1,5,4,6,0,0,0,4,276,1,1,0,0,2,485,5,24,0,24,657,0,657,9,0,9,1,100,NoArch
d16825e290131476c93870dd2b31382591224948,1,16,1,15,17,0,0,0,8,42,1,1,0,0,1,1311,13,24,0,24,1356,0,1356,14,0,14,0,100,NoArch
ff5f7ce93367597fb528495e53f35a10df5cc0ac,1,22,9,13,31,0,0,0,8,0,1,1,0,0,4,58,1,70,0,70,2161,0,2161,22,0,22,1,100,NoArch
c4319f2cb34f8fae50d24b8526c6429e464d23a1,1,2,1,1,3,0,0,0,21,7,1,1,0,0,7,486,6,121,0,121,2621,0,2621,10,0,10,1,100,NoArch
96358e79b211acb4d08e838211ab6621e34471c8,1,5,3,2,8,0,0,0,54,0,1,1,0,0,4,1312,12,33,0,33,1746,0,1746,5,0,5,0,100,NoArch
bc0d56bd16d8c1206624baf4ff25bf611c921833,1,3,0,3,3,1,0,1,3,377,1,1,0,0,1,1313,13,12,0,12,715,0,715,7,0,7,1,100,NoArch
d315a7d5259c28e4babd4d5c061eade848958461,2,90,1,89,91,1,0,1,8,10,1,2,0.260145364,0,1,72,3,108,0,108,2264,0,2264,35,0,35,1,99.98837446,NoArch
295a4e2f9eb3e7e0513980202949ccc424dee2d4,3,53,4,49,57,0,0,0,14,68,2,3,1.182137707,0,3,536,5,125,0,125,5350,0,5350,35,0,35,1,99.82559154,NoArch
487a4caf8e6eeef6bbeed57da3bdf415a027530d,3,285,1,284,286,2,0,2,3,648,2,3,0.271564932,0,1,182,3,58,0,58,2530,0,2530,41,0,41,1,99.98837108,NoArch
2eb7704368dac1e869173dd2465f21a09d6d9e04,1,1,1,0,2,0,0,0,4,0,1,1,0,0,2,183,4,12,0,12,355,0,355,12,0,12,1,100,NoArch
65a8b0898061dffe77b32ab75b5ae4b9f5f43047,4,257,0,257,257,4,0,4,1,0,1,2,1.873551902,0,1,1314,14,25,0,25,1171,0,1171,14,0,14,1,99.97093784,NoArch
5c8e49a71c0126dfadbaf71733155f7b1fcd1b8c,1,42,0,42,42,1,0,1,1,0,1,1,0,0,1,1315,15,3,0,3,91,0,91,3,0,3,0,99.99418942,NoArch
f7e307b3e86d3145e2a5d519bf3e3ae694b16c59,0,0,0,0,0,0,0,0,0,0,0,0,0,0,0,1316,16,0,0,0,0,0,0,0,0,0,0,100,NoArch
0b18aed8bf54f1b1bebe2448f5f3dd6d592fd8b6,1,10,6,4,16,0,0,0,5,1121,1,1,0,0,3,223,2,14,0,14,687,0,687,4,0,4,1,100,NoArch
e753fc74025263238c921448e5c2171e5f62c5d8,6,468,316,152,784,2,0,2,16,206,2,3,2.229206412,0,1,537,5,222,0,222,10326,0,10326,58,0,58,1,98.17942269,NoArch
3909f0798d9ee32ffd27cac44f393a1b47528241,1,8,5,3,13,0,0,0,26,29,1,1,0,0,4,1317,17,355,0,355,11397,0,11397,109,0,109,1,100,NoArch
1a37c0ed32771a905af45bef249a3e72b679134a,4,71,56,15,127,0,0,0,16,0,1,1,1.964283654,0,4,538,6,175,0,175,6569,0,6569,36,0,36,0,99.71639605,NoArch
39649be7aa47165c7c4c179412f9d470443e6837,1,2,7,5,9,0,0,0,5,41,1,1,0,0,3,487,5,15,0,15,732,0,732,3,0,3,1,100,NoArch
43025ff2c4ceb0de499a31a4a9635cffe5db2eab,3,44,6,38,50,2,0,2,80,35,2,2,1.259756469,0,4,1318,18,543,0,543,18702,0,18702,275,0,275,0,100,NoArch
9a1486e914e939ab64a8b95eac444c94bafa599b,1,16,1,15,17,0,0,0,3,327,1,1,0,0,2,488,5,54,0,54,1519,0,1519,16,0,16,0,100,NoArch
ebdca4903d6ac63e593625dfd923c7b16b1c8252,1,1,0,1,1,1,0,1,10,2,1,1,0,0,1,1319,19,25,0,25,1459,0,1459,15,0,15,0,100,NoArch
f022dd5b8924986739aecbeb1e672e01018a03dd,4,104,1,103,105,3,0,3,25,435,1,4,0.574620022,0,2,1320,20,90,0,90,4207,0,4207,34,0,34,1,100,NoArch
1f69eb05959990310e3b0b546a0f8c06b535f955,1,0,1,1,1,0,0,0,2,15,1,1,0,0,1,184,3,23,0,23,1490,0,1490,16,0,16,0,100,NoArch
1a49ab292dccf77b245fd5a44802dcc97396a87a,7,78,9,69,87,2,0,2,17,456,2,2,2.279432366,0,4,185,4,97,0,97,6130,0,6130,33,0,33,1,99.92441659,NoArch
5f4f7d25cd0cfdb34193d99e4cee5a4f446aa3a9,1,4,2,2,6,0,0,0,5,0,1,1,0,0,4,186,5,4,0,4,262,0,262,3,0,3,1,100,NoArch
c2c1a6ba6ff3610be0efeadbe70fb98109f32b73,3,26,17,9,43,1,0,1,10,890,2,3,1.365201272,0,3,1321,21,153,0,153,4547,0,4547,36,0,36,1,95.65161207,Arch
91eda5cf342c28fcd8cc5667600322edf200b015,3,110,3,107,113,2,0,2,8,136,1,2,0.902829063,0,1,187,6,123,0,123,3758,0,3758,51,0,51,1,99.99337924,NoArch
fedc95adf6f9a8656df5c8723a4e6c373558d9eb,2,7,0,7,7,2,0,2,10,448,1,2,0.985228136,0,3,1322,22,92,0,92,2737,0,2737,47,0,47,1,100,NoArch
49cf4338edce349aefb8de088c5616cd58c02db6,6,538,267,271,805,2,0,2,30,31,1,2,2.366360332,0,1,188,7,312,0,312,8183,0,8183,126,0,126,1,99.97683193,NoArch
c738276bea35237efedc8b6c35dfaef0aa604ad3,3,47,3,44,50,0,0,0,16,482,2,3,1.243285615,0,2,224,2,90,0,90,3308,0,3308,35,0,35,1,100,NoArch
e67f2cfc12b55b06632b1e0e733a91a09a0a734d,1,1,1,0,2,0,0,0,115,31,1,1,0,0,12,225,3,261,0,261,7042,0,7042,67,0,67,1,100,NoArch
c4d63d75b1feb4d38260d8d9ff41cd11bb4574df,1,2,2,0,4,0,0,0,85,137,1,1,0,0,5,1323,20,283,0,283,7659,0,7659,48,0,48,0,100,NoArch
f79a8d7eb1763533b4075a64f6e4452bdf348641,1,7,9,2,16,0,0,0,122,50,1,1,0,0,6,1324,21,307,0,307,10099,0,10099,63,0,63,0,100,NoArch
2747744322eb4c285ce6ab6d1c8c80a2f4f186d5,5,46,106,60,152,0,1,1,81,1407,1,5,1.995216791,24,2,1325,22,507,0,507,30652,26,30626,271,0,271,1,99.99338099,NoArch
21d6160e88a6de725ff01df3607b5c8e76628612,1,30,4,26,34,0,0,0,60,344,1,1,0,0,3,1326,23,103,0,103,3402,0,3402,24,0,24,0,100,NoArch
41f016fda77c96ce6d282085b318021bfa42a1d2,1,1,1,0,2,0,0,0,116,1,1,1,0,0,12,226,3,261,0,261,7044,0,7044,67,0,67,1,100,NoArch
ec0cd45c763dbd5a5c634cef86c86203eea15ab6,1,3,3,0,6,0,0,0,34,316,1,1,0,0,8,489,6,114,0,114,2914,0,2914,42,0,42,1,100,NoArch
99fb33495d08513c90ccea76c247e7ac546de769,6,496,94,402,590,5,0,5,73,143,2,3,1.819860782,0,1,539,3,336,0,336,11374,0,11374,54,0,54,1,96.55107896,Arch
14585ed2de2c51a7683e392523db1a5c8c2621d5,30,1077,1059,18,2136,2,0,2,123,586,2,15,2.466249343,0,4,1327,19,2293,0,2293,104200,0,104200,977,0,977,1,99.97642135,NoArch
bd565683e0696acca674b45e3c312af0120e4a1a,7,106,7,99,113,2,0,2,3,786,1,5,1.450810452,0,1,1328,19,67,0,67,2266,0,2266,32,0,32,1,99.95286076,NoArch
fa666687a3873a0e419ae06486517f3f7216f2ac,2,17,2,15,19,1,0,1,8,519,2,2,0.981940787,0,2,490,7,27,0,27,1200,0,1200,9,0,9,1,100,NoArch
135ca71ff97b812d9a1baf26542a2a4f1b321d09,10,633,86,547,719,9,0,9,6,3,1,2,2.391009929,0,1,6,1,49,0,49,3521,0,3521,27,0,27,1,99.92934527,NoArch
d2905c6984108bc706350910eef0a90df8577d49,5,27,56,29,83,1,1,2,13,63,2,3,1.868367771,32,1,7,1,128,0,128,5925,69,5856,37,0,37,1,99.99411522,NoArch
04b092111f22123d41467eda8d08c0140fe4c486,1,1,1,0,2,0,0,0,8,636,1,1,0,0,2,59,1,195,0,195,3856,0,3856,41,0,41,1,100,NoArch
00a20518e13eb86b25f9c5a739f3c79813c640a9,1,45,1,44,46,0,0,0,46,3,1,1,0,0,4,1329,17,151,0,151,12527,0,12527,135,0,135,1,100,NoArch
cc0ba3f09068df3397adf5f7c55362bdffb96174,1,1,1,0,2,0,0,0,2,2,1,1,0,0,1,1330,18,3,0,3,344,0,344,2,0,2,1,100,NoArch
5297e9198f885585e99a12b7717e16888e9d5eaf,2,23,1,22,24,1,0,1,22,145,1,2,0.41381685,0,3,491,4,133,0,133,4347,0,4347,20,0,20,1,100,NoArch
96a349f62e117f12ce43949b723f3fbdeb631f31,34,392,0,392,392,34,0,34,1,0,1,7,2.72319443,0,1,1331,19,899,0,899,32598,0,32598,467,0,467,1,95.1316645,Arch
7707e2624f971df9d1ef9a2b56ef0aedca0bf134,1,1,4,3,5,0,0,0,9,2,1,1,0,0,4,157,0,20,0,20,652,0,652,3,0,3,1,100,NoArch
035df3e5199f02906cb3e0fc375b987f712e5adf,0,0,0,0,0,0,0,0,0,0,0,0,0,0,0,1332,16,0,0,0,0,0,0,0,0,0,1,100,NoArch
3378d284eb38373b80dd23d6f3d889af28763421,2,34,0,34,34,2,0,2,74,18,1,1,1,0,4,540,3,190,0,190,7613,0,7613,37,0,37,0,99.99497992,NoArch
e338af27dcfb9bd4936261b17447288879fc2229,5,31,6,25,37,3,0,3,18,780,2,4,2.039801005,0,3,356,0,93,0,93,5477,0,5477,47,0,47,1,95.47997439,Arch
a852efe7478d63914722f02504e7d5ffd840badb,4,9,4,5,13,0,0,0,19,0,1,3,1.833927218,0,3,357,1,73,0,73,5041,0,5041,29,0,29,1,100,NoArch
53e5857352897bc197a78d11b77d84cffe8ead0e,6,86,7,79,93,3,0,3,62,87,2,5,2.043461366,0,3,1333,16,277,0,277,9831,0,9831,109,0,109,1,100,NoArch
06a551954350575c4f34f5de9d348af3df430926,4,223,13,210,236,2,0,2,8,1081,3,3,1.436406898,0,1,189,5,133,0,133,4623,0,4623,30,0,30,1,99.69648612,NoArch
4b5ce65228ec89ac8a0391b8ea932942a8c10ac4,3,8,4,4,12,0,0,0,53,0,2,3,1.459147917,0,3,1334,17,139,0,139,4844,0,4844,61,0,61,1,100,NoArch
5917174ad9923a0ee9b042e82e63947a8253e1c2,12,40,94,54,134,2,2,4,36,284,2,6,2.987216554,66,1,8,2,894,0,894,26788,138,26650,216,0,216,1,99.96864712,NoArch
07a52b72a33e8996caafbe6e7f4baf40e5beaa98,1,17,21,4,38,0,0,0,75,9,1,1,0,0,4,541,2,135,0,135,5478,0,5478,24,0,24,0,100,NoArch
f5308ffba184a39204ae4e9e13c8af5e91513cbe,2,25,11,14,36,0,0,0,9,666,1,2,0.852405179,0,2,492,4,71,0,71,3286,0,3286,28,0,28,0,100,NoArch
37aff8bb1cb43cdc78e9d50ffce7590ba3cf2df8,2,9,3,6,12,0,0,0,20,196,2,2,0.650022422,0,3,493,5,97,0,97,4478,0,4478,43,0,43,0,100,NoArch
249687fddb0d8e7d8ec7e701c15aaf41171cbe1a,2,15,12,3,27,0,0,0,10,2,1,2,0.605186577,0,1,9,3,44,0,44,2880,0,2880,23,0,23,1,100,NoArch
d524892bd89d90f83873cdbbd0d1d7218e9621ad,0,0,0,0,0,0,0,0,0,0,0,0,0,0,0,542,3,0,0,0,0,0,0,0,0,0,0,100,NoArch
2f250cf141de8abe1ddf5d053dff35038a453fa9,4,64,5,59,69,2,0,2,38,851,2,3,1.463718141,0,3,5,0,248,0,248,12655,0,12655,117,0,117,1,100,NoArch
81ea77ebbfad05e2317325f6c038553ca810e584,7,404,246,158,650,0,0,0,124,529,1,7,1.945498492,0,2,1335,17,642,0,642,36296,0,36296,222,0,222,1,94.71890003,Arch
95f7b4e3a993754c5cf7b5daa1aac9542032e214,4,21,5,16,26,0,0,0,4,764,1,1,1.536791896,0,3,190,6,31,0,31,1445,0,1445,23,0,23,0,100,NoArch
0ce2bcecd1f999183041303ba2dd71ebdfd10927,1,20,14,6,34,0,0,0,76,2,1,1,0,0,4,543,4,135,0,135,5514,0,5514,24,0,24,0,100,NoArch
0ac8a97217ec6b1e2f9d5f68311201ddc0a22dc1,1,1,1,0,2,0,0,0,4,810,1,1,0,0,3,494,6,12,0,12,709,0,709,5,0,5,0,100,NoArch
e17d2e953c5a116c6f353573198b63db503da79d,1,16,4,12,20,0,0,0,2,1191,1,1,0,0,2,495,7,47,0,47,1248,0,1248,10,0,10,0,100,NoArch
5b56a16071a95964670498c167c9fad44a992e08,4,31,6,25,37,2,0,2,11,202,2,4,1.764006806,0,1,496,8,123,0,123,5614,0,5614,50,0,50,0,100,NoArch
8cbfb2417243b2abc19decc85af4e54660f827c8,7,18,14,4,32,2,0,2,15,480,2,5,2.324284096,0,2,497,9,213,0,213,8127,0,8127,115,0,115,1,99.81521965,NoArch
060e89c9c48d12051d562497d35b1c89203c5c71,1,10,7,3,17,0,0,0,86,212,1,1,0,0,4,1336,15,201,0,201,5328,0,5328,87,0,87,1,100,NoArch
4dd95344dd85a7e4eae700c1d79c4817440c570b,1,1,1,0,2,0,0,0,117,27,1,1,0,0,12,191,5,261,0,261,7044,0,7044,67,0,67,0,100,NoArch
a3ea2808722df79b1e8469ca05837fe68f93c6cc,2,2,2,0,4,0,0,0,14,600,1,2,1,0,3,498,9,93,0,93,2118,0,2118,50,0,50,1,100,NoArch
feb0f5cd0cd248806455c2984d3fa89d824020ec,5,198,41,157,239,2,0,2,8,227,1,2,1.740795377,0,3,192,4,80,0,80,3073,0,3073,45,0,45,1,100,NoArch
a97df555de4fc1a17fd1a13ae055f76295180fba,26,536,112,424,648,5,0,5,125,377,2,14,3.358961877,0,2,1337,14,1811,0,1811,68865,0,68865,832,0,832,1,99.98956676,NoArch
ca203ac499491de2ce46db535c18b5a8942f4470,4,181,4,177,185,2,0,2,11,456,3,4,0.866084366,0,1,499,10,112,0,112,4067,0,4067,24,0,24,1,94.26880719,Arch
deb8677902982e76e97b945b97f3734df34ee479,1,4,0,4,4,1,0,1,14,1174,1,1,0,0,5,500,11,48,0,48,2030,0,2030,11,0,11,1,100,NoArch
b12fe12446c6b174cd03f3b615c52a6444ea2eba,1,19,1,18,20,0,0,0,2,777,1,1,0,0,1,544,5,15,0,15,724,0,724,12,0,12,1,100,NoArch
26eababf9a40ca1345653a0d80bb69d3e01f5923,1,13,11,2,24,0,0,0,11,8,1,1,0,0,4,501,12,66,0,66,2002,0,2002,22,0,22,0,100,NoArch
39716e67e08111cfe4855bd02d7c7820895a4563,6,63,31,32,94,3,0,3,20,753,2,4,2.161813978,0,4,502,13,188,0,188,9214,0,9214,85,0,85,1,100,NoArch
df7ac9eafaac448e69791c1850f3e2576a379894,1,1,1,0,2,0,0,0,6,543,1,1,0,0,4,60,1,36,0,36,792,0,792,14,0,14,1,100,NoArch
023872e3024af7bf283031372fc0340d9560f51c,5,5,8,3,13,0,0,0,87,52,1,4,2.257756064,0,8,1338,11,671,0,671,21252,0,21252,202,0,202,0,100,NoArch
bcde842311354df4d7fb4c4f18776854fa70c900,1,3,1,2,4,0,0,0,2,1178,1,1,0,0,2,193,4,13,0,13,359,0,359,6,0,6,1,100,NoArch
0ba30b2178d54a4982817addb767e2ed94878734,1,14,2,12,16,0,0,0,16,11,1,1,0,0,4,503,13,58,0,58,1738,0,1738,13,0,13,0,100,NoArch
114310f860b496e92bdb6df6947ca9435d7b16f3,1,2,2,0,4,0,0,0,7,392,1,1,0,0,3,504,14,28,0,28,1162,0,1162,4,0,4,0,100,NoArch
890dee9cf49c8d65f44eb0720669a92f1552652b,2,26,10,16,36,0,0,0,21,5,1,1,0.503258335,0,3,505,15,70,0,70,2892,0,2892,11,0,11,1,100,NoArch
3119ce5609ef76651a4853e6a94a46fd0c3c0353,1,1,0,1,1,1,0,1,17,28,1,1,0,0,10,15,0,619,0,619,16311,0,16311,138,0,138,1,100,NoArch
e5b8a935e6e450850c46e7899bd737e53b190407,0,0,0,0,0,0,0,0,0,0,0,0,0,0,0,227,0,0,0,0,0,0,0,0,0,0,1,100,NoArch
0cb0603661fc3da40586e67c967e370fd33b3a4f,2,16,20,4,36,0,0,0,40,96,1,2,0.650022422,0,1,545,5,423,0,423,13231,0,13231,131,0,131,1,100,NoArch
b0fe9b789067ca541a6ee78bca17f3bd681f8e27,2,30,23,7,53,1,0,1,47,774,1,2,0.23181305,0,4,506,16,69,0,69,2704,0,2704,26,0,26,0,100,NoArch
63e8e7c533b78a00160772b561a6ebeb5e4318fa,13,53,9,44,62,11,0,11,41,793,1,4,2.691851667,0,1,546,6,613,0,613,19881,0,19881,179,0,179,1,100,NoArch
0af169af4255bfcce0acec49423b55cfbfae18ce,0,0,0,0,0,0,0,0,0,0,0,0,0,0,0,507,17,0,0,0,0,0,0,0,0,0,0,100,NoArch
e2ec1c2a2d7cab8d8603b0448bc238fa2ebc45d3,0,0,0,0,0,0,0,0,0,0,0,0,0,0,0,508,18,0,0,0,0,0,0,0,0,0,0,100,NoArch
4c5707d548cfa8f39d8cce290c742a84d2a7647b,0,0,0,0,0,0,0,0,0,0,0,0,0,0,0,509,19,0,0,0,0,0,0,0,0,0,0,100,NoArch
30fa71e52a501fd506afffdf9f600f79d51baea7,0,0,0,0,0,0,0,0,0,0,0,0,0,0,0,510,20,0,0,0,0,0,0,0,0,0,0,100,NoArch
be37f7d048eff52a6ca31b4557a7bb10c74de0b0,23,1969,58,1911,2027,17,0,17,28,209,2,10,3.967662873,0,1,1339,7,432,0,432,18206,0,18206,171,0,171,1,97.24396362,Arch
27bb1f5f1426fc1a6bad091a36cb552a6c095644,4,84,94,10,178,0,0,0,42,62,1,3,1.569443852,0,3,1340,8,231,0,231,6580,0,6580,102,0,102,1,100,NoArch
cc2d9f70e3e881446388b5fc50538b20b04cbb13,0,0,0,0,0,0,0,0,0,0,0,0,0,0,0,511,19,0,0,0,0,0,0,0,0,0,0,100,NoArch
0bd74108ed03cd172c915ce6caaeb35f19645e71,0,0,0,0,0,0,0,0,0,0,0,0,0,0,0,512,20,0,0,0,0,0,0,0,0,0,0,100,NoArch
e8109062c9e9cd60acd6124ba3617bfc01439f8c,2,33,1,32,34,1,0,1,97,22,2,2,0.908178347,0,6,1341,8,388,0,388,18377,0,18377,296,0,296,1,100,NoArch
3d370cd3d37d222d6e6021e107d408d7cb6d7a2b,1,10,6,4,16,0,0,0,4,0,1,1,0,0,1,1342,9,191,0,191,6081,0,6081,124,0,124,1,100,NoArch
de6ad4dd59ddd50f4a5f9c1d59fe3e2593f87b68,2,106,17,89,123,0,0,0,14,64,2,2,0.982718482,0,2,1343,10,232,0,232,8558,0,8558,154,0,154,1,100,NoArch
d79e95aaaf20a901f4a19952dc2109fa0773a343,3,176,3,173,179,2,0,2,98,0,2,2,1.505145989,0,6,1344,10,443,0,443,21943,0,21943,337,0,337,1,100,NoArch
f3f330de2234a63b30df2199fdabbf861f2050d2,4,59,2,57,61,3,0,3,126,143,2,3,1.660611732,0,2,1345,10,397,0,397,15618,0,15618,130,0,130,1,100,NoArch
34bf4dc72aa8f2a74abf76ca561c3aae6a2b43ac,1,4,1,3,5,0,0,0,6,0,1,1,0,0,1,1346,11,17,0,17,581,0,581,12,0,12,1,100,NoArch
9ecdc991b12ac7dd7ec6b5f0d7b66447a80b73b4,1,12,8,4,20,0,0,0,22,225,1,1,0,0,6,194,3,67,0,67,3329,0,3329,28,0,28,0,100,NoArch
8153b8f1a056b594c05902e943077c0e0c97cfa3,6,53,0,53,53,6,0,6,42,274,2,6,2.065244798,0,2,547,3,215,0,215,9147,0,9147,59,0,59,1,99.98731005,NoArch
7967bd909343f31e8b4abf166d57108d74311d8a,1,14,2,12,16,0,0,0,7,403,1,1,0,0,3,195,4,44,0,44,1365,0,1365,25,0,25,1,100,NoArch
7e3a8ac2bce12e1471106140f9bbfac57854d7e7,2,119,1,118,120,1,0,1,26,135,1,2,0.881290899,0,1,548,4,38,0,38,4351,0,4351,23,0,23,0,99.98731166,NoArch
30a8302883f1409d2cc3bb0ebe52702ffa71d8b3,0,0,0,0,0,0,0,0,0,0,0,0,0,0,0,549,5,0,0,0,0,0,0,0,0,0,0,100,NoArch
32e21e533238321b164f852eeb2814c444da54c8,1,13,2,11,15,0,0,0,30,211,1,1,0,0,3,513,15,197,0,197,6305,0,6305,37,0,37,0,100,NoArch
aecadd30052a0e9a98798e9a962eae0970d6ea5e,0,0,0,0,0,0,0,0,0,0,0,0,0,0,0,228,1,0,0,0,0,0,0,0,0,0,1,100,NoArch
9da7925c677b0430a0c989e4aebeefea86ff9058,2,5,5,0,10,0,0,0,68,207,1,2,0.970950594,0,3,1347,10,203,0,203,6289,0,6289,74,0,74,1,100,NoArch
df3da6f92d4159380b0ddf7dbb9e174e00cdd51b,0,0,0,0,0,0,0,0,0,0,0,0,0,0,0,514,15,0,0,0,0,0,0,0,0,0,1,100,NoArch
c786610bcc187d8a350437c4d01a59fc5d8d0cae,1,1,1,0,2,0,0,0,33,254,1,1,0,0,8,515,16,160,0,160,4093,0,4093,98,0,98,1,100,NoArch
b5031aed14f409d02f73657641c7e3b3778ddb83,1,7,0,7,7,1,0,1,28,207,1,1,0,0,5,516,17,83,0,83,2581,0,2581,33,0,33,1,100,NoArch
e4100bc86cde2fa6044ff55a571abe1b6117b482,1,2,5,3,7,0,0,0,8,741,1,1,0,0,3,550,6,18,0,18,1732,0,1732,10,0,10,0,100,NoArch
db83b793b4cc07bbd5394c7dcb34d265e6c4450a,2,25,0,25,25,2,0,2,48,219,1,2,0.998845536,0,3,551,7,38,0,38,1901,0,1901,26,0,26,0,100,NoArch
c1bf42fedec8e60dee784c9bcbcd311e72a020ea,11,249,6,243,255,8,0,8,22,927,2,4,2.49911354,0,4,196,3,442,0,442,22905,0,22905,224,0,224,1,99.98097593,NoArch
08c9bd01c47c5daff30081cd1bce29f14e39f39f,1,2,2,0,4,0,0,0,15,889,1,1,0,0,5,280,0,100,0,100,2740,0,2740,35,0,35,1,100,NoArch
8aff7ec3cdbd23d72757a95c382fa3e80fb2385d,0,0,0,0,0,0,0,0,0,0,0,0,0,0,0,197,4,0,0,0,0,0,0,0,0,0,1,100,NoArch
982fa9b8c7149b51b73405e8cb08b1ce82eb8fe6,3,112,34,78,146,2,0,2,2,10,1,1,1.530606459,0,1,1348,10,15,0,15,641,0,641,12,0,12,0,99.97781651,NoArch
200e778e06f021f02b4478ccc5f97f993817a12c,2,63,0,63,63,2,0,2,66,235,1,2,0.841236776,0,2,1349,11,202,0,202,17619,0,17619,170,0,170,0,100,NoArch
821bb40bbcff43bb819922c59d4c44c133078a5b,0,0,0,0,0,0,0,0,0,0,0,0,0,0,0,552,7,0,0,0,0,0,0,0,0,0,0,100,NoArch
8ce3ac4dd54f89ad6f958910c234081bfc67dbbe,3,24,10,14,34,0,0,0,14,144,1,3,1.261279687,0,1,1350,12,272,0,272,14984,0,14984,160,0,160,1,100,NoArch
ee1f72412d8dd299d3bdccff7df25124c2d227c3,5,160,74,86,234,0,0,0,38,346,1,4,1.395831091,0,3,1351,13,603,0,603,23722,0,23722,338,0,338,1,100,NoArch
0e4926ecd111945df0f5de8230ca5d0799ffdfa7,1,10,0,10,10,1,0,1,3,1271,1,1,0,0,2,198,5,11,0,11,642,0,642,3,0,3,0,100,NoArch
604e4cdb19015a337718a4da95cbeddb723a4f06,3,300,177,123,477,2,0,2,11,81,1,1,1.340243899,0,1,553,8,22,0,22,2366,0,2366,15,0,15,0,99.99366327,NoArch
c333a5406cee17a558e7d421820a4e75d2ac7b85,5,330,35,295,365,3,0,3,30,620,2,5,1.536527624,0,6,73,0,390,0,390,22506,0,22506,143,0,143,1,100,NoArch
2b11fe13f733672017d52c9dc78bc134edc0019c,7,171,1,170,172,6,0,6,29,66,2,3,2.583004573,0,3,74,1,301,0,301,12252,0,12252,92,0,92,1,99.96832837,NoArch
28bacc76f41b543fb849d16ebeae93aea27a3a50,1,4,7,3,11,0,0,0,12,2,1,1,0,0,2,554,9,8,0,8,843,0,843,6,0,6,0,100,NoArch
faadbb23522a6275151f7ebf6b267c74e3968c73,0,0,0,0,0,0,0,0,0,0,0,0,0,0,0,555,10,0,0,0,0,0,0,0,0,0,0,100,NoArch
9f9a1c741cc37201bab1f19a0742a47aedc91306,0,0,0,0,0,0,0,0,0,0,0,0,0,0,0,556,10,0,0,0,0,0,0,0,0,0,0,100,NoArch
3d9864c94c43301e84b496e97772928eebb6d36c,91,589,578,11,1167,0,0,0,86,719,1,13,5.719386055,0,2,557,10,3618,0,3618,131007,0,131007,869,0,869,0,100,NoArch
b269479a90b953d85df1eee446f01eb4d0ab10bd,11,68,43,25,111,2,0,2,20,0,1,3,3.044568123,0,2,558,11,329,0,329,20837,0,20837,119,0,119,0,100,NoArch
d7ed81cfe0b10d5562ad7793b4fe2402d2582b28,8,18,115,97,133,0,0,0,69,318,2,5,1.444426959,0,1,559,12,273,0,273,15395,0,15395,104,0,104,0,100,NoArch
91157710e5c6b0fd2f808d0c5697e458af866d38,106,777,772,5,1549,0,0,0,24,940,1,37,6.228706212,0,2,560,13,2141,0,2141,145638,0,145638,773,0,773,0,100,NoArch
bc534fa84edb3a1ec54d723d92b7754f43d2f248,39,351,344,7,695,0,0,0,25,687,3,9,4.562970826,0,1,561,14,832,0,832,38069,0,38069,292,0,292,0,100,NoArch
6a16e4e80352c0ca5e56737502d95f70688223bb,44,120,110,10,230,1,0,1,27,946,3,32,4.590632832,0,2,562,15,499,0,499,32928,0,32928,225,0,225,0,100,NoArch
cfc58bd559c4882d0a8d2c1fc26b4570eb42eb90,1,56,60,4,116,0,0,0,29,815,1,1,0,0,4,563,16,6,0,6,1468,0,1468,3,0,3,0,99.91440528,NoArch
653d5b58010b7c1f3370cbfe4e8f301b977946e0,31,655,640,15,1295,0,0,0,87,64,1,4,4.147865312,0,1,564,17,1808,0,1808,54131,0,54131,272,0,272,0,94.67818171,Arch
418f399606828a84e299518e12cbb8abca15b10a,280,2639,2611,28,5250,0,0,0,86,207,4,90,7.104122895,0,1,557,10,7009,0,7009,343596,0,343596,2141,0,2141,1,94.62381258,Arch
b762d088d543be2b21458967d2b30e6bc334d05a,1,7,0,7,7,1,0,1,7,657,1,1,0,0,3,517,6,16,0,16,504,0,504,6,0,6,1,100,NoArch
5da0f94709c66736ff34c8eef93f4f97fad5e905,6,226,44,182,270,4,0,4,18,170,2,3,2.446719687,0,4,518,7,169,0,169,10743,0,10743,80,0,80,1,99.96835243,NoArch
5a08d4efbb3f7f2969fa6140e767585a8239e170,1,18,0,18,18,1,0,1,13,300,1,1,0,0,3,519,8,138,0,138,4800,0,4800,40,0,40,1,100,NoArch
309af89512ed06b383127988a5192326359fb584,1,1,1,0,2,0,0,0,31,6,1,1,0,0,10,75,2,166,0,166,6060,0,6060,28,0,28,1,100,NoArch
83dde303106ea0f292723450588d4266b56e372e,38,466,576,110,1042,0,2,2,127,824,2,23,4.661556328,74,2,1352,13,1816,0,1816,85778,125,85653,692,0,692,1,95.16091821,Arch
9eada811cf2f4c8ee6673fa6f025e61896644f0e,2,3,6,3,9,0,0,0,13,201,1,2,0.99107606,0,1,1353,14,68,0,68,2337,0,2337,39,0,39,1,100,NoArch
2ed78cc1400c57239d64e8657767ec9959065865,334,3523,3562,39,7085,2,3,5,126,592,5,116,7.425498966,132,10,565,18,9346,4,9342,453923,232,453691,3018,4,3014,0,93.00339758,Arch
0776c6c0da3ab42464b6e7c6246981685e9ad0ca,349,3622,3735,113,7357,3,2,5,127,242,5,123,7.495769679,132,10,1354,13,10044,14,10030,487454,497,486957,3423,13,3410,1,92.98857486,Arch
dd8f38b8758606905ed3a47258e8c523cdad45e2,1,4,0,4,4,1,0,1,3,1280,1,1,0,0,3,520,9,58,0,58,2011,0,2011,38,0,38,1,100,NoArch
bca9d7a9d7839d4e5540ea766150e02405e44237,1,6,0,6,6,1,0,1,2,5336,1,1,0,0,2,521,9,0,0,0,203,0,203,0,0,0,1,100,NoArch
9a7f67af37a92e0ff207026f75d7b3b7429625eb,1,6,42,36,48,0,0,0,4,944,1,1,0,0,3,522,9,120,0,120,4855,0,4855,33,0,33,1,100,NoArch
4bee0d1a83a08c82994ac6bcb22383728134d6b7,1,6,1,5,7,0,0,0,8,2,1,1,0,0,1,1355,11,209,0,209,6635,0,6635,129,0,129,1,100,NoArch
fe125043f9ea03b9e5222f8a0f3e014b45158607,1,1,6,5,7,0,0,0,9,0,1,1,0,0,1,1356,12,208,0,208,6600,0,6600,129,0,129,0,100,NoArch
53fde8767c4614b2cdd2d410ed723eb0f870f715,1,10,1,9,11,0,0,0,10,338,1,1,0,0,3,1357,12,22,0,22,947,0,947,7,0,7,1,100,NoArch
e2532739205dc27753ab56a2bb1629fccea81a48,353,3727,3708,19,7435,3,1,4,126,584,5,127,7.513754842,56,10,517,4,10248,4,10244,494530,232,494298,3501,4,3497,0,92.98857486,Arch
9ce7fd4c03d539aea0fef52fa4728d6b79171090,0,0,0,0,0,0,0,0,0,0,0,0,0,0,0,518,5,0,0,0,0,0,0,0,0,0,0,100,NoArch
81c3f7d4e4c419bd05dde77fa404d53dacf732f2,3,36,2,34,38,1,0,1,23,0,1,2,0.848197879,0,3,519,6,37,0,37,2265,0,2265,15,0,15,0,100,NoArch
5448c31c043b1b2e18918616749fbd9f033923b4,1,39,1,38,40,0,0,0,31,3,1,1,0,0,4,520,7,10,0,10,1786,0,1786,3,0,3,0,100,NoArch
b715067449220f8625d45e54092bc28e22814b0c,1,0,1,1,1,0,0,0,32,0,1,1,0,0,4,521,8,10,0,10,1779,0,1779,3,0,3,0,100,NoArch
dae60556e28d22a4e0231099178e6e1ad4f68126,357,3720,3886,166,7606,6,2,8,127,253,5,129,7.533500492,132,10,76,3,10291,14,10277,497160,497,496663,3524,13,3511,1,92.97502029,Arch
b7fd5ab45f93df941eff1fdc25698eda86d5265f,7,47,1,46,48,6,0,6,30,11,2,3,1.886824181,0,4,77,4,303,0,303,12419,0,12419,90,0,90,1,99.99470367,NoArch
d8820ba4f56760e9d010ba700b1347571ce3ef11,5,34,28,6,62,1,0,1,4,121,1,4,1.980150562,0,1,1358,13,226,0,226,6790,0,6790,131,0,131,1,100,NoArch
7e15d0e6717abf1e77648bbbd4ee92143ea7202b,1,1,1,0,2,0,0,0,14,11,1,1,0,0,1,1359,14,39,0,39,1491,0,1491,16,0,16,1,100,NoArch
73ea6c5ce6b86e1b28d3eef94c8ba878e4babffa,365,3913,3872,41,7785,4,2,6,126,534,5,132,7.554992897,91,10,566,19,10625,8,10617,506636,501,506135,3635,8,3627,0,92.969431,Arch
40e0f9319b575932d5f07081eb1a6d1bf8318e32,7,146,197,51,343,1,2,3,34,896,1,3,2.257114993,168,1,567,20,43,15,28,3294,772,2522,14,6,8,0,99.97219519,NoArch
ea090bb3fe21bd768e609275f0ffc33515d0aced,5,51,70,19,121,0,1,1,15,654,2,2,1.588456685,51,1,568,21,147,3,144,4066,134,3932,24,3,21,0,99.98957175,NoArch
cc5172ceaffb018e3852c9ae3d9e3487cb65d80e,41,794,162,632,956,17,0,17,89,0,1,5,4.86977578,0,1,569,22,2133,0,2133,73277,0,73277,331,0,331,0,96.91716136,Arch
ed66e7d56758e60c96091b208c81c2f2b26bb61f,122,645,11949,11304,12594,1,63,64,90,977,1,7,6.443133141,7694,1,570,22,2006,1308,698,72364,47632,24732,352,641,289,0,95.32107749,Arch
796d2adc6b872ccc854ae45eaad1b1d2478f7b6f,453,15453,5008,10445,20461,93,3,96,127,290,5,135,7.729049839,209,10,558,10,11905,20,11885,554613,874,553739,4271,16,4255,0,93.52771181,Arch
35218f9aae467412e58d6aab071db669169fb589,452,4920,15589,10669,20509,5,84,89,126,643,5,135,7.727163063,11357,10,571,23,10611,1336,9275,509534,49121,460413,3653,660,2993,0,93.59469275,Arch
e73200b756fbd9a427d97716c12d0418e7fc0784,454,15455,5050,10405,20505,93,3,96,127,288,5,136,7.730321291,219,10,523,10,12132,20,12112,560063,876,559187,4320,16,4304,1,93.59469275,Arch
75666a606fd87438ae84bebb0b81f85ae1a5b5e3,1,1,1,0,2,0,0,0,4,1010,1,1,0,0,1,559,9,19,0,19,884,0,884,3,0,3,0,100,NoArch
80c31e9823e232ad88c0a486e08205c776e11416,453,5079,15621,10542,20700,5,84,89,126,640,5,136,7.725814236,11357,10,572,22,10870,1336,9534,515768,49121,466647,3707,660,3047,0,93.59469275,Arch
7e796ebfc60737ee31edd84b29484fce9896bfac,457,15611,5217,10394,20828,93,3,96,127,293,5,137,7.742573251,219,10,229,0,12262,20,12242,564783,876,563907,4355,16,4339,1,93.57745673,Arch
5f28bc4f2dbf800660d7b886308cd88991be03d8,3,178,0,178,178,3,0,3,1,0,1,2,1.526555449,0,1,560,8,8,0,8,755,0,755,6,0,6,0,99.98145155,NoArch
95dd295af2209e7da9b0a07a5c977e5983e05a1c,0,0,0,0,0,0,0,0,0,0,0,0,0,0,0,561,9,0,0,0,0,0,0,0,0,0,0,100,NoArch
a312f2a028a3b085ef4401cc26d930de7ffeeab0,459,5173,15930,10757,21103,5,87,92,126,628,5,139,7.759813655,11535,10,573,21,10983,1344,9639,520235,49866,470369,3735,666,3069,0,93.5587209,Arch
af70ff876270387875292bcf90844a7ad258376c,1,11,4,7,15,0,0,0,39,0,1,1,0,0,4,522,5,10,0,10,2133,0,2133,3,0,3,0,100,NoArch
323583f93239cb30a9a007334a33719adecd56c0,462,15820,5320,10500,21140,97,3,100,127,291,6,141,7.768104004,219,10,524,7,12341,20,12321,567692,876,566816,4383,16,4367,1,93.5587209,Arch
297d459deafdfb58b9f90dc8fa16192a18381518,458,5194,15782,10588,20976,5,84,89,126,634,6,139,7.748468876,11357,10,574,22,11052,1336,9716,522327,49111,473216,3757,660,3097,0,93.26970497,Arch
125fd894d1640f4f5671569e5d381439c6689356,0,0,0,0,0,0,0,0,0,0,0,0,0,0,0,575,23,0,0,0,0,0,0,0,0,0,0,100,NoArch
dd3086333048e43803778e521a21fe91f83d8b3c,1,1,1,0,2,0,0,0,8,8,1,1,0,0,1,576,24,18,0,18,872,0,872,3,0,3,0,100,NoArch
80f2052e2db6a2b2162a28e1e7393feaf6d3b263,1,2,2,0,4,0,0,0,2,0,1,1,0,0,1,577,25,3,0,3,271,0,271,1,0,1,0,100,NoArch
4549900cd74fd57168b67275558ec41dbe7ba729,462,15674,5341,10333,21015,94,3,97,127,291,6,142,7.757868363,219,10,61,0,12985,20,12965,584477,876,583601,4528,16,4512,1,93.26970497,Arch
9b2799ed2b28a774376a0ed1036a48283c3329ac,4,32,15,17,47,2,0,2,43,300,1,1,1.831647128,0,1,562,10,192,0,192,7423,0,7423,38,0,38,0,100,NoArch
fdf2fb536863364ba97202a4ddc161a3e5e7b165,461,5215,15814,10599,21029,5,84,89,126,629,6,142,7.755957459,11357,10,578,26,11704,1336,10368,540001,49111,490890,3908,660,3248,0,93.26970497,Arch
172bfb9719255d7b552c0531ddc38db89fda6b8f,466,15700,5368,10332,21068,94,3,97,127,287,6,145,7.765165762,219,10,62,1,13126,20,13106,588691,876,587815,4582,16,4566,0,93.26970497,Arch
7f75a2fc5a71f646d8647cf9b5e697f763e1edf2,16,288,240,48,528,4,0,4,128,484,2,9,2.619859052,0,6,1360,12,1438,0,1438,64704,0,64704,573,0,573,1,93.86001304,Arch
5e3ae2f85c8c03cd635d15b952ce66656b9e2ae8,4,71,0,71,71,4,0,4,99,86,1,1,1.192497445,0,6,1361,13,405,0,405,20863,0,20863,320,0,320,1,99.98991529,NoArch
73d6245f8d1a0ef3f11c5eb02fe29ec1a00a8b3a,1,1,3,2,4,0,0,0,34,48,1,1,0,0,8,525,8,159,0,159,4085,0,4085,98,0,98,0,100,NoArch
accf9a9c0b217a185542f39721102d08b8d0891a,1,3,0,3,3,1,0,1,23,108,1,1,0,0,7,526,9,123,0,123,2649,0,2649,10,0,10,0,100,NoArch
562a896819c7372263f824c9a2dfae0fab98571c,1,39,1,38,40,0,0,0,7,111,1,1,0,0,2,1362,14,9,0,9,767,0,767,9,0,9,1,99.98319271,NoArch
d99659bbd619488a3224f210c49a652c1053b3b1,1,6,2,4,8,0,0,0,12,723,1,1,0,0,3,6,0,28,0,28,1313,0,1313,6,0,6,1,100,NoArch
1fc6859ff963c888cbdb62ae5bc0379462c5e9df,481,5506,16258,10752,21764,5,85,90,126,606,6,147,7.810608139,11408,10,579,27,13185,1339,11846,594035,49338,544697,4621,663,3958,0,94.03714886,Arch
b15370faae90413f215b82c9d8a7ff5923507708,2,2,2,0,4,0,0,0,93,21,2,2,1,0,2,580,28,463,0,463,18166,0,18166,83,0,83,0,100,NoArch
270da39e6de519716b1937c6363ed6bd8e1230bd,483,16146,5641,10505,21787,102,3,105,128,287,6,148,7.818324898,219,10,281,0,14539,20,14519,641809,876,640933,5261,16,5245,1,94.03714886,Arch
e7354dc948df1f0acd1b6930ab326c3c3b73fd9b,1,29,0,29,29,1,0,1,6,147,1,1,0,0,2,563,10,69,0,69,2246,0,2246,8,0,8,0,100,NoArch
7313f77112c214a7c95a877a3324b956836b01b5,3,46,32,14,78,0,0,0,14,793,1,3,1.288819839,0,4,199,0,78,0,78,2299,0,2299,28,0,28,1,99.9899119,NoArch
5d3e6753c2d5a241351f0fcd4fc5682c90155f9b,1,15,16,1,31,0,0,0,23,1,1,1,0,0,3,527,10,63,0,63,1965,0,1965,14,0,14,1,100,NoArch
8ed5cafe27c6ba7e10ceaf205266e63f58ab429f,3,160,3,157,163,2,0,2,12,5,2,3,1.294379383,0,1,564,10,115,0,115,2853,0,2853,19,0,19,1,99.98318367,NoArch
82c9c7d40f5dbfe905b9c7c7f59ed44c3634a003,2,11,3,8,14,0,0,0,10,25,1,2,1,0,1,1363,11,235,0,235,7377,0,7377,146,0,146,0,100,NoArch
4deb6c3a90a4fdb6b5d7076be785a807a8cba86d,4,20,10,10,30,0,0,0,33,695,2,4,1.723231429,0,6,63,2,609,0,609,18757,0,18757,174,0,174,0,100,NoArch
92bc4555cdab318649c92d6449ab2ddc177c72c6,1,69,1,68,70,0,0,0,21,250,1,1,0,0,7,528,11,134,0,134,4697,0,4697,23,0,23,1,100,NoArch
c921f822aa88940b33d6d0160a06efe66003ada0,1,1,1,0,2,0,0,0,59,34,1,1,0,0,4,1364,12,26,0,26,1514,0,1514,5,0,5,0,100,NoArch
cb10f2c7a324eb84643da9ada4ebc16c847ab44e,0,0,0,0,0,0,0,0,0,0,0,0,0,0,0,565,10,0,0,0,0,0,0,0,0,0,0,100,NoArch
bcc70b2471708c7841537dcbebba32ac94b8cdf9,492,5563,16619,11056,22182,7,87,94,126,599,7,155,7.851114832,11554,10,581,26,14032,1346,12686,621014,49925,571089,4854,668,4186,0,94.00663012,Arch
e2077e5b8a1d7e7d26a77afc1044f571d08f59a5,3,160,3,157,163,2,0,2,20,5,2,3,1.294379383,0,1,582,27,128,0,128,3262,0,3262,21,0,21,1,99.98397487,NoArch
0ad59e8757cd183484053ae7d61995266b2f4760,1,29,0,29,29,1,0,1,12,14,1,1,0,0,2,583,28,69,0,69,2337,0,2337,8,0,8,0,100,NoArch
0a95718186dce28d7be6bd2367de9f9fa072a33b,1,6,2,4,8,0,0,0,13,38,1,1,0,0,2,584,29,28,0,28,1301,0,1301,6,0,6,1,100,NoArch
de89cfaeee151bdc3b8386f94cf53c1922b66dcd,1,8,12,4,20,0,0,0,13,0,1,1,0,0,2,585,30,69,0,69,2313,0,2313,8,0,8,0,100,NoArch
dea6d0726a531ffe6b1834407c74d12f51da4ea6,5,18,8,10,26,0,0,0,40,18,1,3,1.942156764,0,4,586,31,143,0,143,8146,0,8146,28,0,28,0,100,NoArch
4751b002da8ee29fef776d64ba591edf300b009c,492,16295,5700,10595,21995,102,3,105,128,287,7,153,7.843487649,219,10,566,11,15392,20,15372,668103,876,667227,5492,16,5476,0,94.02402205,Arch
d606a5c88a84f6b7a9391f5e82126400b22531b2,2,13,4,9,17,1,0,1,13,650,2,2,0.522559375,0,1,567,12,24,0,24,1534,0,1534,11,0,11,0,100,NoArch
e6b41fdcb526b3be440a435ddb28fb3c2d446dce,0,0,0,0,0,0,0,0,0,0,0,0,0,0,0,568,13,0,0,0,0,0,0,0,0,0,0,100,NoArch
a6f629f5ab246153f767f21363f64674b86bb456,491,5577,16438,10861,22015,7,85,92,126,595,7,153,7.841224566,11408,10,587,32,14066,1339,12727,621548,49338,572210,4860,663,4197,0,94.02402205,Arch
766fa3e212a9b7aa9fd002d04243b602b52eea0c,0,0,0,0,0,0,0,0,0,0,0,0,0,0,0,588,33,0,0,0,0,0,0,0,0,0,0,100,NoArch
9fadc0adc8ab0eb754d13c8c9e0c570aa38ad5db,493,16515,5702,10813,22217,103,3,106,128,289,7,154,7.84600204,219,10,569,13,15412,20,15392,669949,876,669073,5501,16,5485,1,94.02402205,Arch
c5c1104c103ac9fb5726b5f9021e75da5c73b32b,4,10,10,0,20,0,0,0,88,23,1,3,1.921928095,0,2,570,14,546,0,546,18143,0,18143,77,0,77,1,100,NoArch
19aff2d79a1f4dd6e3baee0192ab35b2988ce1a6,1,2,1,1,3,0,0,0,13,706,1,1,0,0,5,282,1,91,0,91,2393,0,2393,22,0,22,1,100,NoArch
44b4ba7ce44e5fbda77a6b28393e517a36cb1b4d,1,1,1,0,2,0,0,0,14,40,1,1,0,0,3,230,1,138,0,138,4800,0,4800,40,0,40,1,100,NoArch
16ac7f12b18b52a3b0054a46928d51c840af1178,492,5579,16441,10862,22020,7,84,91,126,595,7,153,7.842314682,10916,10,589,32,14157,1339,12818,623944,47622,576322,4882,663,4219,1,94.02402205,Arch
f05ca23766903308fff2bc45533e23934489dae3,0,0,0,0,0,0,0,0,0,0,0,0,0,0,0,590,33,0,0,0,0,0,0,0,0,0,1,100,NoArch
71aa117e76ef25685ca9b199468f2bf8205f91a5,493,16298,5702,10596,22000,101,3,104,128,287,7,153,7.844577944,219,10,283,2,15487,20,15467,670531,876,669655,5514,16,5498,1,94.02402205,Arch
552fc04bb2fd729c1883b41e60a6521e24797070,3,148,9,139,157,2,0,2,15,162,2,3,1.123424458,0,1,571,14,157,0,157,5413,0,5413,30,0,30,0,100,NoArch
e72047635037c893dee3d77aef013a34b731b332,1,9,1,8,10,0,0,0,11,0,1,1,0,0,1,572,15,16,0,16,1906,0,1906,13,0,13,0,100,NoArch
1cb8ea77bd878b694dbb739d2e08bcbe3e8c62df,493,5588,16457,10869,22045,7,85,92,126,592,7,153,7.844148512,11408,10,591,34,14188,1339,12849,625049,49338,575711,4888,663,4225,0,94.02402205,Arch
2831f0a5e180589e43dd5500463160df9b57ecf0,1,9,1,8,10,0,0,0,11,0,1,1,0,0,1,592,35,16,0,16,1906,0,1906,13,0,13,0,100,NoArch
6affb7514b8432fb6193a3923acb446483857480,493,16425,5737,10688,22162,100,3,103,129,287,7,153,7.854098117,219,10,1365,13,15527,20,15507,671829,876,670953,5520,16,5504,0,94.02402205,Arch
92b4fdad1ac56d7f111e6f016ccafcb7742b1232,18,40,40,0,80,0,0,0,89,733,3,16,3.98418372,0,3,573,15,1617,0,1617,53481,0,53481,451,0,451,0,100,NoArch
1a4b7cfd929bdfd1c53feef8099c1a67a24afeff,492,5614,16568,10954,22182,7,82,89,126,592,7,153,7.851852339,11154,10,593,28,14181,1305,12876,624515,48146,576369,4884,654,4230,0,94.02402205,Arch
fae480115e538de760a8c57e2d674ddc418cbc37,494,16465,5738,10727,22203,101,3,104,129,292,7,154,7.85893682,219,10,574,16,15549,20,15529,674164,876,673288,5531,16,5515,0,94.02402205,Arch
c53fc6c557a9641e932a80854f5811e339968059,492,5614,16568,10954,22182,7,85,92,126,592,7,153,7.851852339,11408,10,594,29,14183,1339,12844,624541,49350,575191,4884,663,4221,0,94.02402205,Arch
ab5e64e0414bcbe0e8a5c5b8575289db816acccb,1,0,1,1,1,0,0,0,42,0,1,1,0,0,4,595,30,10,0,10,2133,0,2133,3,0,3,0,100,NoArch
9c2dad75b62a100811fa4bcb0e1db4f1987f57f1,3,11,1,10,12,2,0,2,43,5,1,2,0.816689088,0,3,596,30,65,0,65,5555,0,5555,14,0,14,0,100,NoArch
38670427fe972560402e70037d8f874136e94050,1,4,4,0,8,0,0,0,15,44,1,1,0,0,4,597,31,28,0,28,4607,0,4607,13,0,13,0,100,NoArch
c1fe338d525ea4ec36894ff1732fb327e017400f,0,0,0,0,0,0,0,0,0,0,0,0,0,0,0,598,32,0,0,0,0,0,0,0,0,0,0,100,NoArch
19fcadac3c49eacaa75801e729d0b31579370376,493,16430,5751,10679,22181,100,3,103,129,292,7,153,7.856034142,219,10,575,17,15529,20,15509,671897,876,671021,5520,16,5504,0,94.02402205,Arch
daaebf35776142d5dffa69dec5fc67b8f9c30658,492,5628,16573,10945,22201,7,85,92,126,592,7,153,7.853788595,11408,10,599,33,14183,1339,12844,624597,49350,575247,4884,663,4221,0,94.02402205,Arch
3ea4bab7b71367c2ac8c32bb7a0e43cb6ea76a11,495,16498,5752,10746,22250,101,3,104,129,291,7,155,7.864478191,219,10,1366,9,15890,20,15870,683573,876,682697,5632,16,5616,1,93.89455727,Arch
8fb9d36acef3cb9a5d2510e9805cfbaeca54cbc9,1,86,0,86,86,1,0,1,27,272,1,1,0,0,3,576,18,32,0,32,4631,0,4631,27,0,27,0,100,NoArch
7073dbbd63383cf7c349d3e8aa7ca3cc446ed2c4,494,5629,16641,11012,22270,7,86,93,126,586,7,155,7.86223604,11460,10,600,34,14538,1342,13196,635994,49549,586445,4993,665,4328,0,93.89455727,Arch
13dee37713fd21e84c7c451e1b5533f5006cfc15,496,16501,5755,10746,22256,101,3,104,129,291,7,156,7.865943404,219,10,577,19,15922,20,15902,688204,876,687328,5659,16,5643,0,93.89455727,Arch
517ce6699f9d5dd3cd9b87f3c57e0aec81b8de28,494,5629,16641,11012,22270,7,86,93,126,586,7,155,7.86223604,11460,10,601,35,14538,1342,13196,635994,49549,586445,4993,665,4328,0,93.89455727,Arch
01e1972a7dd13c8cfbef73126a9e9f5d7f6a26fb,495,16588,5787,10801,22375,101,3,104,129,289,7,155,7.868645093,219,10,578,20,15897,20,15877,683718,876,682842,5634,16,5618,0,93.87058669,Arch
d5cf3fc7e9290ff2cf9fd1645f39c8bbca016c24,3,20,18,2,38,0,0,0,90,116,1,3,1.543719696,0,3,579,21,570,0,570,18765,0,18765,107,0,107,0,100,NoArch
7aae8785c3d1b444b8602aba860ffbd0ad6d648a,2,6,15,9,21,0,0,0,44,257,1,2,0.958711883,0,3,580,22,164,0,164,5327,0,5327,36,0,36,0,100,NoArch
d576297e23dd4e5482d5b420d89a69f7c4309517,3,33,21,12,54,1,0,1,25,311,1,2,1.224394445,0,2,1367,9,153,0,153,6485,0,6485,77,0,77,1,100,NoArch
78a2ca995c6ac70c637358c0327742af2f0ba2f7,497,5689,16760,11071,22449,7,86,93,126,583,7,155,7.876588965,11460,10,602,36,14687,1342,13345,642308,49549,592759,5069,665,4404,0,93.87058669,Arch
dfc20ae3c36d3d1aabbc04a703c0052c08085cf8,3,18,13,5,31,0,0,0,95,16,1,3,1.443585942,0,3,603,37,574,0,574,19288,0,19288,109,0,109,0,100,NoArch
cd0c5d19f1d9ee433f4218e97e734efd2cfb8409,3,9,15,6,24,0,0,0,49,37,2,3,1.5,0,1,604,38,252,0,252,8859,0,8859,59,0,59,0,100,NoArch
a4e9143f9bba3bf4ab07e0af5d46b30f135d687e,1,1,1,0,2,0,0,0,15,0,1,1,0,0,1,605,39,91,0,91,3527,0,3527,23,0,23,0,100,NoArch
524b8128aa1564fc0312caafe1bb371da904c441,498,16603,5797,10806,22400,102,3,105,129,288,7,155,7.878318602,219,10,144,0,16050,20,16030,690164,876,689288,5711,16,5695,0,93.87058669,Arch
224b54bf53afe90f38bf7b10d225bb0cb8fdbdb5,1,2,1,1,3,0,0,0,6,657,1,1,0,0,3,145,1,3,0,3,323,0,323,2,0,2,0,100,NoArch
ffa7650e7e145c3eb1a1e933210589cab120efe1,3,35,3,32,38,1,0,1,26,92,1,2,1.209175998,0,2,1368,10,175,0,175,6915,0,6915,61,0,61,0,100,NoArch
0ede8ff165e93afc86f8d45a64bdafc7e53527c8,0,0,0,0,0,0,0,0,0,0,0,0,0,0,0,529,6,0,0,0,0,0,0,0,0,0,0,100,NoArch
8ba47537b89e3e22731345d2053514080e4a48d7,1,12,0,12,12,1,0,1,21,116,1,1,0,0,2,581,23,36,0,36,2008,0,2008,15,0,15,0,100,NoArch
4cdeead8db102e2c75044bbaefe0602cefff84c7,499,5678,16783,11105,22461,7,86,93,126,580,7,156,7.880934331,11460,10,606,39,14770,1342,13428,644288,49549,594739,5087,665,4422,0,93.87058669,Arch
456e71338f53734a7a72fad88237a8080ab43cd6,500,16674,5801,10873,22475,102,3,105,129,286,7,156,7.88650567,219,10,582,24,16140,20,16120,692571,876,691695,5731,16,5715,0,93.87058669,Arch
3c9eaa308e3e2fd3c1c546504300360022e22932,499,5678,16783,11105,22461,7,86,93,126,580,7,156,7.880934331,11460,10,607,39,14772,1342,13430,644489,49549,594940,5087,665,4422,0,93.87058669,Arch
b89dddd7e351b2867a537ceda150e6f6d0728900,502,16817,5801,11016,22618,104,3,107,129,285,7,158,7.894012817,219,10,583,25,16149,20,16129,693363,876,692487,5737,16,5721,0,93.85518848,Arch
555dd2df1a438c2084b25562f54747ada9dfea23,499,5678,16783,11105,22461,7,86,93,126,580,7,156,7.880934331,11460,10,608,39,14772,1342,13430,644489,49549,594940,5087,665,4422,0,93.87259726,Arch
46192d68f0d906cdbbd8f045417e20e7027f8349,501,16719,5802,10917,22521,103,3,106,129,286,7,157,7.889294636,219,10,200,1,16145,20,16125,692901,876,692025,5734,16,5718,1,93.86336056,Arch
a3d2c08f3c492e294f4f18bf6925565a97295ce4,2,96,22,74,118,0,0,0,18,1001,1,2,0.931776983,0,1,1369,9,92,0,92,3848,0,3848,61,0,61,0,99.99664001,NoArch
4698249e22f268626ee8ed69f649620634dd0fbc,1,3,3,0,6,0,0,0,10,0,1,1,0,0,1,1370,10,25,0,25,2209,0,2209,25,0,25,0,100,NoArch
8751ed15c37e91e95dee53b992aa3a789816a8c3,2,114,22,92,136,0,0,0,19,0,1,2,0.923119984,0,1,1371,11,102,0,102,4671,0,4671,69,0,69,1,100,NoArch
990f2a23b898cc3b87cbc025bd458b9ab88b1921,1,3,3,0,6,0,0,0,20,0,1,1,0,0,3,1372,12,69,0,69,1735,0,1735,36,0,36,0,100,NoArch
d94188fabcb2e6ca73bb3fcd685aa71cdcf5f5e3,2,57,2,55,59,1,0,1,4,21,1,2,0.357646706,0,1,1373,13,46,0,46,1702,0,1702,31,0,31,0,99.98656095,NoArch
1638e3ebdf6ccb51ed01ef98745c3f888e65ffcd,0,0,0,0,0,0,0,0,0,0,0,0,0,0,0,584,26,0,0,0,0,0,0,0,0,0,0,100,NoArch
8cf99a503f801d153e1ae09ebb42694d23de9026,1,28,4,24,32,0,0,0,1,0,1,1,0,0,1,1374,14,5,0,5,411,0,411,5,0,5,0,99.98656185,NoArch
a00dc094f9716e7dfbd23b9c614a2248e4fe2a53,1,88,33,55,121,0,0,0,19,293,1,1,0,0,6,530,7,372,0,372,9279,0,9279,80,0,80,0,100,NoArch
4f17fa59ba7cf90775848f660a7595e3483df63e,4,177,29,148,206,0,0,0,20,580,2,3,1.297816316,0,2,531,8,469,0,469,11853,0,11853,106,0,106,0,99.99664046,NoArch
52a30bcb1ec150988d0b77136c3eb908de4bdd4d,1,12,7,5,19,0,0,0,21,0,1,1,0,0,6,532,9,397,0,397,9829,0,9829,85,0,85,0,100,NoArch
fe261d81b20f1557b4b515c020948762d49a409c,0,0,0,0,0,0,0,0,0,0,0,0,0,0,0,533,10,0,0,0,0,0,0,0,0,0,0,100,NoArch
6bb6b76edbcfd46d2334a3ec448da3dd170dab35,0,0,0,0,0,0,0,0,0,0,0,0,0,0,0,534,11,0,0,0,0,0,0,0,0,0,0,100,NoArch
16c3c8706077a4cfeea9be62446b1ee18ec77cb3,0,0,0,0,0,0,0,0,0,0,0,0,0,0,0,1375,15,0,0,0,0,0,0,0,0,0,1,100,NoArch
3b96e846ee2c36d310dd8654675caff3737c1d0c,1,3,3,0,6,0,0,0,32,55,1,1,0,0,11,201,2,166,0,166,6053,0,6053,28,0,28,1,100,NoArch
c67cf4f4b9ccc4464193d863c29e2cc165edb2c4,3,133,18,115,151,2,0,2,100,59,2,2,1.449868058,0,6,1376,16,545,0,545,24972,0,24972,349,0,349,1,100,NoArch
75ec62753dc1e7b7c87a828a27ddb1bf8de951e0,2,311,0,311,311,2,0,2,1,0,1,2,0.612649473,0,1,585,27,17,0,17,1615,0,1615,9,0,9,0,99.98320513,NoArch
f528e871e51c5d3b0fbad55ca04892c68e2788c6,508,5789,17540,11751,23329,7,87,94,126,558,7,159,7.925681323,11560,10,609,38,15413,1351,14062,662757,50264,612493,5270,673,4597,0,93.84938199,Arch
04b535bbb4667e43492515718a061553d50644d8,47,49,50,1,99,0,0,0,96,43,2,16,5.530822403,0,2,610,39,1491,0,1491,110750,0,110750,472,0,472,0,100,NoArch
00597a58fbb8af58a2c84d37cb504496a8d0e6c2,509,17398,5912,11486,23310,104,3,107,129,286,7,159,7.927715396,219,11,586,27,16870,20,16850,715015,876,714139,5951,16,5935,0,93.84938199,Arch
2a67573c03226ec40a2820cfb0b012766330b3ae,2,19,10,9,29,0,0,0,27,10,1,2,0.992266639,0,2,1377,17,95,0,95,5355,0,5355,45,0,45,1,100,NoArch
1848efe5e8c6603c17ba1504c34399ff3e042052,1,4,1,3,5,0,0,0,13,1335,1,1,0,0,3,535,11,34,0,34,924,0,924,6,0,6,0,100,NoArch
3783bb2e3ba5ee4d0b79272ea42005704e17bdc4,0,0,0,0,0,0,0,0,0,0,0,0,0,0,0,536,12,0,0,0,0,0,0,0,0,0,0,100,NoArch
720b7dea454c1d250ddd89845a3eda35bc1bd40c,2,8,4,4,12,0,0,0,118,613,2,2,0.650022422,0,12,537,13,283,0,283,7851,0,7851,69,0,69,1,100,NoArch
23d6508a4b8ef3852e6ad81e5a0c7b9cb871ea5b,0,0,0,0,0,0,0,0,0,0,0,0,0,0,0,231,2,0,0,0,0,0,0,0,0,0,1,100,NoArch
ced1a3d386c718fd888742ec43d38ba3cb4e7b0c,5,66,12,54,78,3,0,3,9,590,1,2,2.194544281,0,2,202,3,210,0,210,8521,0,8521,78,0,78,1,100,NoArch
1c5deac261d13e7f2baf5a13fd8379992ed6b48a,6,40,11,29,51,1,0,1,28,940,2,3,1.852496747,0,4,1378,18,153,0,153,8388,0,8388,76,0,76,1,100,NoArch
71a588f7ae031c2740c0770ced059fcbdc07f73d,4,473,0,473,473,4,0,4,1,0,1,2,1.710472173,0,1,587,27,25,0,25,2250,0,2250,13,0,13,0,99.96642718,NoArch
c7a7830c91eb02ac20701d15742172001f1be294,519,5820,17671,11851,23491,7,88,95,126,493,7,163,7.946782451,11615,2,611,38,15954,1351,14603,681392,50264,631128,5437,673,4764,0,93.8534124,Arch
47fff36aeff60d63ff6271317583d334aa1587d9,521,17601,5955,11646,23556,106,3,109,130,292,7,163,7.952619824,219,3,1379,19,17451,20,17431,736153,876,735277,6145,16,6129,1,92.60950031,Arch
5e2a230bdd930839d4b7d7a99f2885632e810284,4,136,2,134,138,2,0,2,69,95,2,4,1.857161673,0,1,588,28,160,0,160,7720,0,7720,46,0,46,1,99.98809382,NoArch
5614dafd4eeabb8e0b730a5194008705a7a57014,520,5832,17744,11912,23576,7,88,95,126,492,7,163,7.950489125,11615,2,612,39,15976,1351,14625,682930,50264,632666,5453,673,4780,1,92.61304053,Arch
855ac7153a35f7a412e001284b2b4458a20fd8a7,521,17607,5959,11648,23566,106,3,109,130,292,7,163,7.95241009,219,3,538,14,17457,20,17437,736327,876,735451,6145,16,6129,0,92.61304053,Arch
3d03077dd0377b735a813b1809f5e8ce3694b3db,1,3,3,0,6,0,0,0,16,483,1,1,0,0,4,539,15,27,0,27,1364,0,1364,6,0,6,0,100,NoArch
f4b1468bb1e516085bc033c9b82d1ba3102f9813,1,9,9,0,18,0,0,0,70,60,1,1,0,0,5,1380,20,377,0,377,11672,0,11672,89,0,89,0,100,NoArch
0e1b77546b7ca67e12ecccffe5b83a1923a61cc3,1,1,1,0,2,0,0,0,71,0,1,1,0,0,5,1381,21,377,0,377,11672,0,11672,89,0,89,0,100,NoArch
be7f70413077f7efba1a296492c8c6d5cf6d0ca3,1,6,2,4,8,0,0,0,7,1,1,1,0,0,2,203,4,36,0,36,832,0,832,8,0,8,0,100,NoArch
33cb37a0e9694734e37198161aad793305793c4c,3,12,3,9,15,1,0,1,28,329,1,3,1.399581231,0,4,1382,22,434,0,434,13448,0,13448,155,0,155,1,100,NoArch
382158bb392e13999776ffac9f3bb20b4ae9b66a,1,38,0,38,38,1,0,1,2,41,1,1,0,0,1,589,29,5,0,5,592,0,592,4,0,4,0,100,NoArch
8d017b5946f841f2aed502c2a7244be25ff34d9d,523,5854,17781,11927,23635,7,88,95,126,492,7,166,7.955465799,11615,2,613,40,16078,1351,14727,686188,50264,635924,5504,673,4831,0,92.61304053,Arch
536e79f2321c0578ae00a394ff1091fc10dad550,1,6,6,0,12,0,0,0,2,2,1,1,0,0,1,614,41,2,0,2,308,0,308,1,0,1,0,100,NoArch
fdacb46ee80133266af3f1142aa275a701833561,527,18031,5983,12048,24014,109,3,112,130,285,7,169,7.959197756,219,3,590,28,17585,20,17565,742089,876,741213,6208,16,6192,0,92.59876029,Arch
d3434fa8d0c6b9ada00f8ad9eb33ed17d173c78b,524,5860,17787,11927,23647,7,88,95,126,491,7,167,7.957714508,11615,2,615,41,16080,1351,14729,686496,50264,636232,5505,673,4832,0,92.6153182,Arch
ec8393ef9cfde228430def55a185914ba07d8024,526,17747,6002,11745,23749,107,3,110,130,285,7,167,7.966209156,219,3,1383,23,17773,20,17753,746706,876,745830,6264,16,6248,1,92.60882989,Arch
007277e5fb2fc49f04d51f958400f85fb41c6495,1,21,3,18,24,0,0,0,11,171,1,1,0,0,2,540,15,102,0,102,3175,0,3175,20,0,20,1,100,NoArch
ca67e9a840565d90ba98e8537b64ea8db7b8633b,0,0,0,0,0,0,0,0,0,0,0,0,0,0,0,541,14,0,0,0,0,0,0,0,0,0,0,100,NoArch
26b684c863bebfa38e6fdd8f462c8d008704c9c6,0,0,0,0,0,0,0,0,0,0,0,0,0,0,0,542,15,0,0,0,0,0,0,0,0,0,0,100,NoArch
ca1e98271fb3456f5debfe5c1ad22a4819f9409f,0,0,0,0,0,0,0,0,0,0,0,0,0,0,0,543,16,0,0,0,0,0,0,0,0,0,0,100,NoArch
8210839483dad6dc7021520baae7f5f3f5c55557,0,0,0,0,0,0,0,0,0,0,0,0,0,0,0,544,17,0,0,0,0,0,0,0,0,0,0,100,NoArch
47604b9ca30989d5a5d3a8d9f9f1bf2764ada455,0,0,0,0,0,0,0,0,0,0,0,0,0,0,0,545,18,0,0,0,0,0,0,0,0,0,0,100,NoArch
2c992cb9aeca97515454e863fff44f88210a079c,4,230,5,225,235,2,0,2,17,1536,2,4,1.445373015,0,6,232,2,154,0,154,4709,0,4709,35,0,35,1,99.99403377,NoArch
27e7ac7cfb52bbab1051d23b002ec7996f1939cc,530,5937,18167,12230,24104,7,88,95,126,491,7,170,7.985759979,11615,2,616,29,16490,1351,15139,699902,50264,649638,5609,673,4936,0,92.60219835,Arch
0c906f3cc98a47d83faf8bd43354baa8aee75380,534,18294,6064,12230,24358,111,3,114,131,289,7,170,7.995671694,219,3,1384,19,18145,20,18125,757778,876,756902,6375,16,6359,1,92.59339302,Arch
159355c0debc032757dbcc926f275d6e9c9c7578,2,46,7,39,53,1,0,1,22,11,1,1,0.698700353,0,1,546,17,400,0,400,9904,0,9904,88,0,88,0,99.99403448,NoArch
4135cd3b59d4a556f20eb3cd0fcfb5f5f172ea25,1,2,1,1,3,0,0,0,2,0,1,1,0,0,1,547,18,3,0,3,102,0,102,3,0,3,0,100,NoArch
8ba62afd77c74af7599b8a16442eaf8d15fc2359,535,5941,18477,12536,24418,7,89,96,126,485,7,171,7.999102559,11784,2,523,0,16563,1381,15182,702003,50928,651075,5629,703,4926,0,92.58767597,Arch
3b8844dc381b7806c5899dc01e6b8220376d1133,3,6,13,7,19,0,0,0,44,38,1,2,1.267443804,0,3,524,1,72,0,72,5502,0,5502,16,0,16,0,100,NoArch
d5e5211301d67aeaf81d078cb2fc9b76478e555f,539,18323,6076,12247,24399,112,3,115,132,283,7,171,8.003685522,219,3,1385,20,18565,20,18545,770569,876,769693,6526,16,6510,0,92.58767597,Arch
92203fbada808fccf32814a3d4cda8293b4e8ba1,538,5957,18492,12535,24449,7,89,96,126,483,7,171,8.002251085,11789,2,617,24,16977,1381,15596,714608,50928,663680,5777,703,5074,0,92.58767597,Arch
1a0d8e4ccd4c6546bc8812fb96ddd93aea6a9a97,540,18324,6093,12231,24417,112,3,115,132,283,7,172,8.003900727,219,3,204,4,18618,20,18598,776003,876,775127,6554,16,6538,0,92.58767597,Arch
7524807b1dc58e4052eac67d623835f9eeb2b458,543,5978,18966,12988,24944,7,90,97,126,478,7,172,8.029146839,11913,2,618,24,17049,1403,15646,720448,51699,668749,5808,708,5100,0,92.57554224,Arch
0e45e5ef79b8f0deb04c35262dc05965fefac73a,543,18807,6167,12640,24974,115,3,118,132,282,7,172,8.02662878,209,3,1386,20,18693,20,18673,778449,876,777573,6579,16,6563,1,92.57554224,Arch
7595de6342798a9770bcaa0f3776e36006ffeb43,4,27,19,8,46,0,0,0,19,518,3,3,1.685679489,0,3,205,5,220,0,220,13777,0,13777,82,0,82,1,100,NoArch
4df60b3f1f7ed60e66db251fb078ba668cb0433d,1,2,0,2,2,1,0,1,14,302,1,1,0,0,4,206,6,35,0,35,3656,0,3656,24,0,24,1,100,NoArch
b612339d586017f0c4e2f0d3d993efe0ebe7932d,1,48,8,40,56,0,0,0,4,462,1,1,0,0,3,548,19,74,0,74,2180,0,2180,21,0,21,0,100,NoArch
bd3430f518704f920d841816d65b2b818f528663,2,1,4,3,5,0,0,0,73,2,2,2,0.970950594,0,6,1387,21,448,0,448,16721,0,16721,149,0,149,1,100,NoArch
de58d7625dbbe04296f8059849854e55a7b7e3c1,15,38,22,16,60,0,0,0,133,295,1,8,3.612647406,0,2,1388,22,1659,0,1659,54080,0,54080,477,0,477,1,100,NoArch
313b2dc34cf9ed5ddba6fef64853f6af143c3009,8,23,14,9,37,0,0,0,134,3,1,5,2.701507757,0,1,1389,23,1438,0,1438,46204,0,46204,445,0,445,1,100,NoArch
29acb6302e688c41517cc8b667de3a0edc7d13da,1,1,4,3,5,0,0,0,15,290,1,1,0,0,3,1390,24,81,0,81,2492,0,2492,37,0,37,1,100,NoArch
0231e162d823ddd7949ed95f221f343cb91bdfa9,2,33,7,26,40,1,0,1,32,157,1,1,0.669015835,0,4,1391,25,87,0,87,3380,0,3380,21,0,21,1,99.99403519,NoArch
8b750c1fffdf66419b6878d4a12853fcad4ff8d9,2,25,1,24,26,1,0,1,33,264,1,2,0.391243564,0,2,1392,26,419,0,419,15752,0,15752,139,0,139,1,100,NoArch
76cb9b05aa799d8ae2a85a21495529149184af1e,3,231,21,210,252,1,0,1,10,190,1,2,1.313237699,0,1,549,20,58,0,58,2098,0,2098,12,0,12,1,99.98509109,NoArch
185dc7344d06d283382066f0fa254fd414355cf4,1,9,11,2,20,0,0,0,5,2,1,1,0,0,3,550,21,73,0,73,2154,0,2154,20,0,20,1,100,NoArch
20ae386cd6579a0c5ada7d3b1e9f1821c2519058,5,54,3,51,57,2,0,2,11,340,1,2,1.477623928,0,2,233,2,44,0,44,4137,0,4137,39,0,39,1,99.99105652,NoArch
07a86f15fda71377d81dc08e08dcbf343e652f80,1,8,4,4,12,0,0,0,6,327,1,1,0,0,4,234,3,27,0,27,969,0,969,5,0,5,1,100,NoArch
8254d79be898f4b1e8bdc24ed3465a0a7a3b9ac2,3,133,0,133,133,3,0,3,1,0,1,3,1.467457965,0,1,235,4,4,0,4,414,0,414,4,0,4,1,99.97913748,NoArch
8b697ed365227feedd97ae394bc3ef3dce57092d,574,7322,19680,12358,27002,12,98,110,126,456,7,183,8.081647371,12497,2,619,10,17878,1451,16427,766085,53947,712138,6174,733,5441,0,92.62228138,Arch
c371427ec99459ef9bafce27531f3715f47a0622,575,19349,7545,11804,26894,120,7,127,134,258,7,184,8.076853002,1420,3,236,5,19554,88,19466,821588,7311,814277,6916,70,6846,1,92.62228138,Arch
b1d7db59317853fd6d44ed9c0cfa5296d50a8b2e,1,32,32,0,64,0,0,0,135,12,1,1,0,0,6,1393,18,334,0,334,11224,0,11224,77,0,77,1,100,NoArch
da8bd6aa43c10fe2848c1c87ad21d35ae98b35a0,0,0,0,0,0,0,0,0,0,0,0,0,0,0,0,551,16,0,0,0,0,0,0,0,0,0,0,100,NoArch
4e1c201280b01ffe70a6d7d0bec1b9f93544f4be,1,5,6,1,11,0,0,0,43,434,1,1,0,0,8,552,17,161,0,161,6681,0,6681,18,0,18,0,100,NoArch
579c7bcd6bf202f2d7f1c3699389266bc47c5be9,4,215,29,186,244,1,0,1,14,263,1,3,1.535398149,0,1,553,18,184,0,184,6750,0,6750,67,0,67,0,95.82212326,Arch
8eaee76e2872077273b629cbdedb88a2deee0d89,2,1,2,1,3,0,0,0,15,0,1,1,0.918295834,0,1,554,19,73,0,73,2904,0,2904,44,0,44,0,100,NoArch
5d9b27b12f26a86f2d3b2af42dd8ad98c3472c82,2,7,0,7,7,2,0,2,2,5434,1,1,0.591672779,0,2,237,6,6,0,6,148,0,148,6,0,6,1,100,NoArch
bdaf80012fbedd397e3cdc555dc180c42938f667,1,3,0,3,3,1,0,1,3,0,1,1,0,0,2,238,7,0,0,0,51,0,51,0,0,0,1,100,NoArch
3b44c545dd1e790dea8ba5650cad5dbc224ea32f,2,19,8,11,27,0,0,0,13,2,1,2,0.950956048,0,1,555,20,113,0,113,3944,0,3944,23,0,23,0,100,NoArch
380d4620d613a30ba436c5131065ec2393f7179e,4,225,47,178,272,1,0,1,136,657,1,3,1.465744277,0,2,1394,16,447,0,447,17453,0,17453,153,0,153,1,100,NoArch
ad8fbe7b9a1d8d8422da7479ee54f648de0bd138,4,172,36,136,208,1,0,1,16,0,1,3,1.298164999,0,1,556,21,214,0,214,7972,0,7972,75,0,75,0,100,NoArch
c3494c750f04cb4d4efc0295047316be5b5aca3b,0,0,0,0,0,0,0,0,0,0,0,0,0,0,0,239,7,0,0,0,0,0,0,0,0,0,1,100,NoArch
f99d692f217f2777b7df7d58762570e65677093c,0,0,0,0,0,0,0,0,0,0,0,0,0,0,0,240,8,0,0,0,0,0,0,0,0,0,1,100,NoArch
a0ae89d855b7c03b0bb2ebff31606fff9b8858aa,585,7930,20349,12419,28279,14,94,108,126,449,7,188,8.102472934,12349,2,620,8,18222,1467,16755,781543,54582,726961,6269,749,5520,0,93.55254472,Arch
bb2757c945ea3bcd93d321782fb4df39aaadd133,6,1046,26,1020,1072,5,0,5,2,0,1,2,2.296085547,0,1,621,9,47,0,47,9921,0,9921,45,0,45,0,96.4254472,Arch
2ba67fa79c9874ffd2b1f407ffb2aec75a89a50e,589,20002,9170,10832,29172,123,11,134,136,267,7,188,8.094715457,2270,3,591,2,19912,131,19781,835710,16993,818717,7045,111,6934,0,94.00998336,Arch
5e1b222710251899d0220451e6fcb536f8168f21,589,8950,20349,11399,29299,18,95,113,126,441,7,188,8.101665525,12484,2,622,9,18252,1467,16785,788197,54582,733615,6297,749,5548,0,94.00998336,Arch
dbc2475e978173a8d024268cd5204817505d8777,592,20311,9226,11085,29537,122,13,135,137,268,7,188,8.085191284,2911,3,1395,13,20099,131,19968,841551,16993,824558,7120,111,7009,1,94.00998336,Arch
9bfb76f38275f50bc4ee02124b40055b54dbe21b,597,9511,20637,11126,30148,23,95,118,126,437,7,191,8.115309306,12484,2,623,8,18424,1467,16957,794815,54582,740233,6362,749,5613,0,93.97234115,Arch
6a705cbb8a516df07c02bef7bb7398186fccbec6,597,20319,9715,10604,30034,121,18,139,138,262,7,190,8.111075472,3404,3,1396,13,20099,152,19947,841512,19114,822398,7120,124,6996,1,93.97234115,Arch
c821f0a3192b8a8041748fb41d8bf85cfbf3afec,5,46,42,4,88,0,0,0,139,4,1,5,2.019646638,0,2,1397,14,729,0,729,39520,0,39520,293,0,293,1,100,NoArch
dba906dad34b6e491284aac3e0e6685c469ca45d,1,5,1,4,6,0,0,0,30,21,1,1,0,0,4,1398,14,361,0,361,11549,0,11549,110,0,110,1,100,NoArch
c31a3ea2afa1cc53ed3bb101223828cfaf1f76d6,1,17,11,6,28,0,0,0,15,8,1,1,0,0,2,557,17,121,0,121,4025,0,4025,26,0,26,0,100,NoArch
c8f00d621bbebb4566bad45aca324676c221102c,597,9595,20693,11098,30288,23,95,118,126,437,7,191,8.116145164,12504,2,624,8,18426,1467,16959,795017,54582,740435,6362,749,5613,0,93.97234115,Arch
da600d1605516c96c1fa52ab69cfa9355f983470,5,159,14,145,173,3,0,3,74,14,1,2,1.938064412,0,3,625,9,202,0,202,17369,0,17369,83,0,83,0,99.98817128,NoArch
c82557043a2a9a1658c3e8ca90e4bec365a6ef43,599,20496,10045,10451,30541,121,15,136,139,251,7,190,8.109592566,2275,3,558,12,20185,157,20028,843960,20545,823415,7154,127,7027,1,93.98392016,Arch
bc155be50a726dd4503dd703d34ec3b22001936f,1,96,1,95,97,0,0,0,24,8,1,1,0,0,3,7,0,80,0,80,5511,0,5511,76,0,76,1,100,NoArch
57ddbcba00b29780db69558fade8d29b32afeb05,2,11,6,5,17,0,0,0,140,6,1,2,0.936667382,0,3,1399,15,436,0,436,17411,0,17411,161,0,161,1,100,NoArch
70cf608bf17c42208bfb066312207a8217ebf0e0,1,36,1,35,37,0,0,0,10,1007,1,1,0,0,5,1400,16,16,0,16,1044,0,1044,16,0,16,1,100,NoArch
8f8c7ef139537afbb6c1b43fa320d743d168c1ed,600,9942,20953,11011,30895,23,95,118,126,432,7,191,8.107194518,12504,2,626,10,18522,1467,17055,799909,54582,745327,6411,749,5662,0,93.98392016,Arch
4c3aeadaab87eb25c651bf7e0d79602173bf1451,600,20715,10136,10579,30851,121,18,139,141,252,7,190,8.098119498,3685,3,1401,17,20246,161,20085,845957,21160,824797,7192,129,7063,1,93.98392016,Arch
4318942cb10e3454de5d084646a9ee199bad54e6,1,1,1,0,2,0,0,0,142,1,1,1,0,0,6,1402,18,379,0,379,12213,0,12213,87,0,87,1,100,NoArch
a49acbdff65435b2addc0e01fd13040c229516ee,1,2,2,0,4,0,0,0,16,139,1,1,0,0,5,207,3,102,0,102,2754,0,2754,35,0,35,1,100,NoArch
40c49c0fbb290f8dc75b9d60ee2555c20c2c8791,1,5,3,2,8,0,0,0,5,1725,1,1,0,0,2,158,0,14,0,14,525,0,525,12,0,12,1,100,NoArch
434132594b23cc18f36cab5c3109a4490b35883c,2,47,3,44,50,0,0,0,15,167,1,2,0.242292189,0,1,1403,18,121,0,121,4716,0,4716,46,0,46,1,100,NoArch
3c466ba1fac07a024cf60864a045615e73d5c88d,2,53,2,51,55,1,0,1,11,89,2,2,0.988283611,0,3,208,4,158,0,158,11914,0,11914,73,0,73,1,95.06304498,Arch
3f0d66dbd032e758ee86c09331001481c5e31cfe,1,1,1,0,2,0,0,0,24,88,1,1,0,0,3,284,0,63,0,63,1965,0,1965,14,0,14,2,100,NoArch
6c3e1dfa06bcb448ef3853fcbc9d41e01c917a63,604,9949,21137,11188,31086,23,95,118,126,431,7,193,8.114719787,12504,2,627,9,18781,1467,17314,808681,54582,754099,6498,749,5749,1,91.24311637,Arch
b52e54d76c669edbc8ba4f9baf389b36fb5dea41,604,20837,10148,10689,30985,121,18,139,142,251,7,192,8.111222571,3685,3,1404,18,20520,161,20359,855553,21160,834393,7284,129,7155,1,91.24311637,Arch
624fde0283cd1574b4010764e13cd8f1fe5fd388,2,17,0,17,17,2,0,2,103,18,1,1,0.997502546,0,6,1405,19,421,0,421,20862,0,20862,329,0,329,1,100,NoArch
05fe97f4a20cd8524eb0869d1c62cb29feda9c04,3,25,7,18,32,0,0,0,11,396,1,3,0.868392729,0,1,1406,19,208,0,208,7154,0,7154,94,0,94,1,100,NoArch
ba741f46f4ea241dcbd4f4e35016d194bd1f5e95,1,210,0,210,210,1,0,1,1,0,1,1,0,0,1,209,4,23,0,23,1678,0,1678,12,0,12,1,99.98162384,NoArch
02f690f7daee782ba51495d66dacfe222b13ac15,610,10245,21409,11164,31654,25,96,121,126,427,7,197,8.134792377,12714,2,628,9,18992,1490,17502,817365,56260,761105,6595,761,5834,0,91.22706767,Arch
69bc8b32faebee6b68c545fd281a460bcedad1b7,612,21225,10461,10764,31686,123,20,143,143,257,7,197,8.135049183,3969,3,1407,20,20794,168,20626,866153,22767,843386,7415,136,7279,1,91.22706767,Arch
bb0f33bf08d59c85940280ce5071a5856686781e,1,13,4,9,17,0,0,0,8,42,1,1,0,0,1,1408,16,195,0,195,6316,0,6316,63,0,63,1,100,NoArch
26c10829e48bb274100d4e160ccafa2a2768af74,3,227,7,220,234,1,0,1,14,83,1,1,0.561709905,0,1,1409,16,294,0,294,9202,0,9202,186,0,186,1,92.59210913,Arch
bc37bdbf19a7950840c746cfddf7bde3ae59967a,2,31,0,31,31,2,0,2,9,104,1,1,0.637387499,0,1,1410,17,200,0,200,6693,0,6693,64,0,64,1,99.98952258,NoArch
341b0f3bb1b7393ec2264fed5aebc10513697182,616,10599,21784,11185,32383,26,97,123,126,425,7,198,8.145939444,12925,2,629,10,19080,1522,17558,822431,57144,765287,6643,793,5850,0,91.24496193,Arch
5e7356aecc3e0d9e3853c3b800b9690e84b34e0a,616,21494,10797,10697,32291,125,21,146,143,253,7,197,8.141401299,4210,3,1411,18,20886,178,20708,869314,24369,844945,7475,141,7334,1,91.24496193,Arch
dc09232e0b47c1d2925fd895e516a72ae088c73e,0,0,0,0,0,0,0,0,0,0,0,0,0,0,0,1412,19,0,0,0,0,0,0,0,0,0,1,100,NoArch
e45e550d1f9deb86e646038449fa8eefce9ae38f,616,10703,22041,11338,32744,26,97,123,126,425,7,198,8.14675344,12925,2,630,11,19029,1522,17507,821926,57144,764782,6640,793,5847,0,91.23065114,Arch
0fab00948955f2fb17f33ca30b12f81140e1afec,616,21727,10900,10827,32627,124,21,145,143,253,7,197,8.14138158,4307,3,1413,20,20886,181,20705,869318,24996,844322,7475,144,7331,1,91.23065114,Arch
9bffdd0707b3c41bd54cbd9422c8619f1bfc07ec,617,10910,22046,11136,32956,27,97,124,126,425,7,198,8.148729077,12925,2,631,12,19047,1522,17525,823070,57144,765926,6645,793,5852,0,91.22964195,Arch
6026796ce0b4085cba182af808a0eb2d79bd61bc,617,21730,11108,10622,32838,124,22,146,144,253,7,197,8.142455365,4512,3,210,3,20886,199,20687,869318,26140,843178,7475,149,7326,1,91.22964195,Arch
3194eb13b90803f262dc53a241abaff6a7f5a6d7,617,10903,22047,11144,32950,27,97,124,126,425,7,198,8.148655189,12925,2,632,12,19051,1522,17529,823676,57144,766532,6647,793,5854,0,91.22964195,Arch
45d4d47b3188ad126894560ea5e17dcb60828baf,4,353,4,349,357,3,0,3,5,9,1,2,1.46772042,0,1,633,13,69,0,69,5115,0,5115,28,0,28,0,99.98819258,NoArch
75e1bf58478e7150e5647718b59757b3496f5456,620,21757,11449,10308,33206,125,22,147,144,251,7,198,8.152875503,4331,3,592,1,20899,256,20643,870347,28637,841710,7482,165,7317,1,91.22728436,Arch
9b874fc8061f253e83e965cdd2db1a5c04357bc6,619,11252,22047,10795,33299,29,97,126,126,424,7,198,8.156085756,12925,2,634,14,19104,1522,17582,825567,57144,768423,6661,793,5868,1,91.22728436,Arch
0da0f84710fdfd660bce4be64d9c59d940f17086,619,21741,11462,10279,33203,124,24,148,144,251,7,197,8.151653712,4853,3,593,2,20885,256,20629,869322,28637,840685,7475,165,7310,1,91.22728436,Arch
af1ed23bbe2a10244dbda950c3936ec59f586c03,619,11252,22047,10795,33299,29,97,126,126,424,7,198,8.156085756,12925,2,635,15,19103,1522,17581,825571,57144,768427,6661,793,5868,1,91.22728436,Arch
ebf6c02cc4988f31f521bc9a27041d396be61534,3,5,5,0,10,0,0,0,6,15,1,1,1.570950594,0,1,636,16,37,0,37,8141,0,8141,33,0,33,0,100,NoArch
95b615699694db9517e03987d6e02062760310c5,3,548,0,548,548,3,0,3,3,1,1,2,0.993651727,0,1,637,17,53,0,53,4069,0,4069,19,0,19,0,94.41302701,Arch
b89704d67dc4a9eb5cd59890956ebdcac0584123,0,0,0,0,0,0,0,0,0,0,0,0,0,0,0,638,17,0,0,0,0,0,0,0,0,0,0,100,NoArch
59742b14708200f687fc784aa3351163864c6676,621,21763,12001,9762,33764,124,22,146,144,248,7,197,8.154783023,4023,3,1414,19,20889,296,20593,869564,31965,837599,7478,180,7298,1,90.54236738,Arch
3cd23910e77dfb21c9622cf96c5118765a79e03c,1,1,1,0,2,0,0,0,145,5,1,1,0,0,7,1415,20,381,0,381,12230,0,12230,87,0,87,1,100,NoArch
8057253dc8240f273afdeb53f8faddfb5d1c8168,621,11804,22080,10276,33884,31,97,128,126,423,7,198,8.160851796,12925,2,639,17,19143,1522,17621,828899,57144,771755,6676,793,5883,0,90.54236738,Arch
fc7e8229088afa5ba7f97e79f0fe62baa52c6053,621,21776,12007,9769,33783,124,26,150,146,248,7,197,8.154663733,5401,3,1416,21,20893,296,20597,869630,31965,837665,7478,180,7298,1,90.54236738,Arch
42ca2f4eb35e6496264a2e1306077495f3e67e3d,2,21,0,21,21,2,0,2,22,74,1,2,0.791858353,0,1,1417,22,107,0,107,4824,0,4824,72,0,72,1,99.98603011,NoArch
007861913735815db8a2a8fa52d4d621cf54fc01,623,12852,22114,9262,34966,33,97,130,126,422,7,198,8.139659405,12925,2,640,17,19289,1522,17767,834909,57144,777765,6719,793,5926,0,90.53436765,Arch
6b62ac91c454f61cad5b5138a9fa8ffd28b5581f,623,21798,13049,8749,34847,124,28,152,146,246,7,197,8.133572474,6443,3,1418,22,20898,442,20456,869775,37975,831800,7481,223,7258,1,90.53436765,Arch
b2fbefa151406f4e1b65ba6bf29392c0a5efbfcc,1,2,2,0,4,0,0,0,23,68,1,1,0,0,6,594,2,397,0,397,9805,0,9805,85,0,85,0,100,NoArch
329571d451eef8eed5c5b88d25998b8d3a73a7b4,1,1,2,1,3,0,0,0,3,1071,1,1,0,0,2,559,2,3,0,3,95,0,95,2,0,2,0,100,NoArch
569847fb98fb4b1ef293327b863571e978ba8175,1,18,13,5,31,0,0,0,6,63,1,1,0,0,3,560,3,74,0,74,2203,0,2203,21,0,21,1,100,NoArch
7f4f3630c35dbe78d9bbff2359a128db52b8cd8c,2,23,13,10,36,0,0,0,71,730,1,2,0.811278124,0,2,1419,20,91,0,91,3306,0,3306,24,0,24,1,100,NoArch
bc3e23bd6dfe14f2d1471a286a6ea3d4e0556ade,6,48,40,8,88,1,0,1,147,61,1,4,1.757735954,0,2,1420,21,755,0,755,27588,0,27588,260,0,260,1,100,NoArch
7bbcaeae79726aff567a14f15e5aed8c0adf9744,4,24,24,0,48,1,0,1,44,303,1,1,1.398090027,0,4,1421,22,240,0,240,15300,0,15300,186,0,186,1,100,NoArch
99c47519ffbf30335559f8c32d222314ff6ea438,628,12923,22210,9287,35133,33,97,130,126,424,7,198,8.15317349,12925,2,641,17,19472,1522,17950,845840,57144,788696,6853,793,6060,0,90.53436765,Arch
2b0565d07974a9880c62900dc41b489bb118defa,635,22123,13156,8967,35279,126,28,154,147,244,7,197,8.166037648,6441,3,1422,23,21163,442,20721,885332,37937,847395,7675,223,7452,1,90.52213394,Arch
93cde374aafa21a984a4d76a192b6068d52fe6d1,2,2,2,0,4,0,0,0,5,159,1,1,1,0,1,1423,24,37,0,37,1119,0,1119,22,0,22,1,100,NoArch
1f49ed484b2697b2d39cf757c6194daefeb5f2f4,0,0,0,0,0,0,0,0,0,0,0,0,0,0,0,561,3,0,0,0,0,0,0,0,0,0,0,100,NoArch
1676bb6092e9ee2bb63bbce1bb62154ee49cb151,3,98,48,50,146,2,0,2,11,569,2,3,0.895748883,0,1,595,3,73,0,73,4297,0,4297,29,0,29,1,100,NoArch
9bce1ec680bad9b757813fdb45f8c1c8233be0e3,636,12960,22441,9481,35401,33,99,132,126,418,7,198,8.172584548,13078,2,642,16,19540,1545,17995,849611,57767,791844,6903,805,6098,1,90.52213394,Arch
baa6132a0cc4e51421536d89b2f2c245abe5272d,639,22443,13445,8998,35888,127,28,155,147,240,7,198,8.150804947,6441,3,1424,25,21302,442,20860,890331,37937,852394,7762,223,7539,1,90.52213394,Arch
3e84ba479b66e5a4d81b9aa61804d2979214a49e,1,1,1,0,2,0,0,0,3,389,1,1,0,0,2,562,3,12,0,12,303,0,303,6,0,6,0,100,NoArch
25fbe3151e350b252260659d84854f6f612a0d11,7,198,8,190,206,3,0,3,6,1031,3,4,2.265780671,0,1,285,1,149,0,149,4988,0,4988,79,0,79,1,99.97556804,NoArch
60eae5b22be2fec2237918b1d2fc4ea77cff0223,2,2,4,2,6,0,0,0,4,1111,1,2,1,0,3,64,0,22,0,22,676,0,676,10,0,10,1,100,NoArch
48144f06a9779320b7d8537899b2f3b9ecacdb43,647,13592,22958,9366,36550,33,101,134,126,405,7,203,8.16719276,13149,2,643,16,19860,1555,18305,860513,58292,802221,7062,812,6250,0,90.5126264,Arch
ebd2889e35dddb29935436e0bc3b8b2560b9e23f,1,1,2,1,3,0,0,0,5,78,1,1,0,0,2,644,17,11,0,11,318,0,318,5,0,5,1,100,NoArch
483c7b0073b992e4cab14aaed187e30f8f2b1719,647,22657,13803,8854,36460,129,28,157,147,246,7,202,8.160026749,6775,3,563,4,21471,497,20974,895730,39912,855818,7849,234,7615,0,90.5126264,Arch
dd694534d5bec3b0f6aeafd4bb26e97e08ab2e12,1,33,0,33,33,1,0,1,5,8,1,1,0,0,1,596,4,21,0,21,2867,0,2867,13,0,13,0,100,NoArch
ed1bf4e6662c3868705a28474162418ba288c43e,647,13590,22996,9406,36586,33,101,134,126,404,7,203,8.166547528,13192,2,645,18,19860,1553,18307,860509,58251,802258,7062,810,6252,0,90.5126264,Arch
77e8fb41593b2291cf1c9a063335967c3939cfeb,648,22666,13803,8863,36469,130,28,158,147,245,7,202,8.161326552,6775,3,564,5,21482,497,20985,896378,39912,856466,7852,234,7618,1,90.5126264,Arch
80ec74a4ff63bb55ff454e9da45343cd5b80b5eb,0,0,0,0,0,0,0,0,0,0,0,0,0,0,0,565,6,0,0,0,0,0,0,0,0,0,1,100,NoArch
3afead5e84ab41a564e4444973ade0cfcaa51c06,2,30,17,13,47,0,0,0,72,1254,2,2,0.25387844,0,2,1425,23,91,0,91,3153,0,3153,19,0,19,1,100,NoArch
4f9e5de1fa2f7788dd13602d131398332fbee70c,2,34,1,33,35,1,0,1,148,20,1,1,0.315997133,0,3,1426,24,540,0,540,17607,0,17607,125,0,125,1,100,NoArch
fb49b7e571e1f3853ced406fd4d0e4974a584abe,4,44,8,36,52,2,0,2,26,441,2,3,1.578398151,0,3,566,7,210,0,210,7373,0,7373,70,0,70,1,100,NoArch
00af0597c650f8b9fccd64e3f362edf9fc9f4b3d,7,65,7,58,72,3,0,3,63,449,2,4,2.621273644,0,2,1427,24,269,0,269,10338,0,10338,113,0,113,1,100,NoArch
0a2e01f228890abba0bde43a545ea046c9c46119,1,1,1,0,2,0,0,0,11,0,1,1,0,0,3,1428,25,21,0,21,1896,0,1896,16,0,16,1,100,NoArch
c16038d475aa69c338171e36629aec5ca757ef53,2,7,14,7,21,0,0,0,3,0,1,1,0.985228136,0,1,1429,26,53,0,53,1380,0,1380,37,0,37,1,100,NoArch
ac24b66124844cb577e18c0659fdb1d69c496654,1,1,1,0,2,0,0,0,4,0,1,1,0,0,1,1430,27,26,0,26,718,0,718,20,0,20,1,100,NoArch
ed0fc365473d395c241232dfa4d10f15d8f90c3c,655,14782,23166,8384,37948,35,101,136,126,405,7,204,8.104838341,13192,2,646,19,20018,1553,18465,875469,58251,817218,7170,810,6360,0,90.5126264,Arch
38d9ace960004de4a38035efd411dac1d84cb85d,2,217,0,217,217,2,0,2,1,0,1,2,0.699248942,0,1,647,20,9,0,9,1130,0,1130,9,0,9,0,99.9889671,NoArch
f0939c91e9adaee10baac0b8960135b96e35843c,659,22996,15245,7751,38241,134,30,164,148,246,7,204,8.116906092,8156,3,1431,27,21666,544,21122,907093,49442,857651,7982,272,7710,1,90.50579871,Arch
a98d18ed2a859822068025662c7bbe5fbb2f8b3d,659,15266,23335,8069,38601,37,101,138,126,405,7,205,8.105896843,13189,2,648,21,20080,1553,18527,881347,58234,823113,7222,810,6412,0,90.50579871,Arch
cbaad9ca95ecda178af0d48463740ad96efa8d0b,4,44,8,36,52,2,0,2,30,94,2,3,1.578398151,0,2,649,20,215,0,215,7765,0,7765,74,0,74,1,100,NoArch
102be3684ea737b1c6d68ba24a7170cb3c799f96,1,9,0,9,9,1,0,1,4,125,1,1,0,0,1,650,21,11,0,11,648,0,648,3,0,3,1,100,NoArch
1c4994aab8ad01f1cdb420b5eb18c9e01a79c7c7,0,0,0,0,0,0,0,0,0,0,0,0,0,0,0,651,22,0,0,0,0,0,0,0,0,0,1,100,NoArch
928dac86f1cbb3141204a3570c584bf9e05704a7,3,357,45,312,402,0,0,0,6,13,1,2,0.586823675,0,1,652,23,82,0,82,6860,0,6860,29,0,29,0,100,NoArch
a2efbd3ffb14ba842d1d41b0d38d661c9d932411,663,23083,15818,7265,38901,134,27,161,148,247,7,205,8.093145056,7911,3,1432,24,21802,572,21230,910513,53119,857394,8054,284,7770,1,90.4979455,Arch
0cffef8fc445a8a367315521b03620a14bb8c60a,5,112,36,76,148,0,0,0,87,78,2,4,1.707689154,0,2,1433,25,544,0,544,17616,0,17616,191,0,191,1,100,NoArch
b244ea59e64cc24fd82c4a76f20fcd2d2126357e,1,7,1,6,8,0,0,0,23,71,1,1,0,0,7,241,0,135,0,135,4727,0,4727,23,0,23,1,100,NoArch
3b49b4264d025e048695e303435b373a98cb4315,664,15633,23532,7899,39165,36,101,137,126,403,7,206,8.102186862,13189,2,653,24,20275,1553,18722,888128,58234,829894,7325,810,6515,0,90.4979455,Arch
003a0d420dca03b94d5ec111dab645669446a942,1,41,0,41,41,1,0,1,1,0,1,1,0,0,1,654,25,1,0,1,106,0,106,1,0,1,0,99.99558752,NoArch
231f70d7777ff2f0e1cd56fd9948994ef611eda6,665,23224,15891,7333,39115,134,31,165,148,245,7,205,8.100762226,8743,3,1434,23,21875,573,21302,912960,53225,859735,8086,285,7801,0,90.49305293,Arch
ce8b13fa4ed9784bb9fff443e182edf166b466d1,10,130,19,111,149,1,0,1,88,400,2,8,2.901948999,0,5,1435,24,605,0,605,32875,0,32875,284,0,284,1,99.98255226,NoArch
a63dfffb980d78956e3cc75929e749dffe1c7138,3,23,15,8,38,0,0,0,149,246,1,3,1.24273038,0,7,1436,25,444,0,444,13947,0,13947,122,0,122,1,99.98952953,NoArch
48f22102e6bc9ee0bbafcffdeee1228b2c536789,2,150,55,95,205,1,0,1,10,313,1,1,0.987450486,0,1,16,0,52,0,52,1765,0,1765,19,0,19,1,99.98603986,NoArch
a7522eafd809e6e8c3c3e73f1c3a7bb0ecbd5acd,0,0,0,0,0,0,0,0,0,0,0,0,0,0,0,17,1,0,0,0,0,0,0,0,0,0,1,100,NoArch
0c2a87c0a733efff02a2d09691a51ecf51829105,2,2,13,11,15,0,0,0,150,3,1,2,0.721928095,0,7,1437,24,406,0,406,13726,0,13726,92,0,92,0,100,NoArch
7b2d389597d6b940820da48ca02143169e01264c,1,8,0,8,8,1,0,1,79,124,1,1,0,0,5,65,1,137,0,137,5571,0,5571,25,0,25,1,100,NoArch
1c47998af22572769364c90e19ec9fc123d2ebde,670,15760,23848,8088,39608,37,102,139,126,400,7,207,8.128676433,13278,2,655,24,20383,1563,18820,891458,58653,832805,7379,813,6566,1,90.46962073,Arch
fef3f12ad0e54f483c5b4c036070f9fed46b37df,2,150,55,95,205,1,0,1,10,314,1,1,0.987450486,0,1,656,25,52,0,52,1765,0,1765,19,0,19,1,99.99116588,NoArch
76bfa9da203b16af0f0348858ce1db6e3bf85084,0,0,0,0,0,0,0,0,0,0,0,0,0,0,0,657,26,0,0,0,0,0,0,0,0,0,1,100,NoArch
9ba6e49cd2f258cfea58b43c53e4f2719e261d9f,669,23399,15920,7479,39319,135,31,166,150,242,7,206,8.114746659,8743,3,1438,24,21984,573,21411,917127,53225,863902,8153,285,7868,1,90.48121399,Arch
9c655bfec4fab7c1148d354066d79a702e2db118,1,1,0,1,1,1,0,1,91,5,1,1,0,0,5,1439,25,300,0,300,8124,0,8124,53,0,53,0,100,NoArch
b256c462ac837e254e826a082a2d71d9f17b18c5,673,16517,23752,7235,40269,41,101,142,126,399,7,208,8.127332954,13189,2,658,26,20452,1553,18899,896408,58234,838174,7411,810,6601,0,90.48455531,Arch
f37eff902170f60b1b670700b9547d9540862a47,673,23413,16730,6683,40143,135,34,169,150,240,7,207,8.12106331,9538,3,567,8,21986,657,21329,917774,57668,860106,8154,312,7842,0,90.48455531,Arch
526498b2bf73e8f0d76bf36bf76353e9ba81c829,2,32,2,30,34,1,0,1,8,373,2,2,0.997502546,0,2,597,5,329,0,329,10624,0,10624,119,0,119,0,100,NoArch
b12b45feed8de22cac47e44ba1e113b56dfbef53,673,16517,23752,7235,40269,41,101,142,126,399,7,208,8.127332954,13189,2,659,27,20455,1553,18902,896452,58234,838218,7413,810,6603,0,90.48455531,Arch
0e33a8091949cdb162075c1eeb0bc82ce447f805,674,23605,16873,6732,40478,134,34,168,151,240,7,207,8.121613475,9538,3,1440,26,22013,657,21356,918972,57668,861304,8169,312,7857,1,90.48455531,Arch
d933d45a5df92fa2736878bdffc8191f042bc4fb,2,346,1,345,347,1,0,1,2,1,1,1,0.701893271,0,1,18,2,67,0,67,2153,0,2153,30,0,30,1,99.98953172,NoArch
d6668a7cce598c3f6aa090c36ffcd83c58f02f7f,1,2,2,0,4,0,0,0,152,5,1,1,0,0,7,1441,27,380,0,380,12196,0,12196,87,0,87,0,100,NoArch
e132290e48667842106f8d4e64397e59e7ea6064,674,16660,23944,7284,40604,41,101,142,126,399,7,208,8.127865955,13189,2,660,25,20474,1553,18921,897245,58234,839011,7423,810,6613,1,90.48558381,Arch
916b902173de7e32e0b9edde8523eb4559415191,1,3,3,0,6,0,0,0,9,8,1,1,0,0,2,661,26,11,0,11,1005,0,1005,6,0,6,0,100,NoArch
03f31aedfaf53d808e88e9262c5ee3232b023a67,675,23626,16891,6735,40517,134,34,168,153,238,7,208,8.122941602,9538,3,1442,28,22026,657,21369,920017,57668,862349,8176,312,7864,1,90.48558381,Arch
be2581714062c8937145df240b9bd2b298819b68,1,5,1,4,6,0,0,0,45,14,1,1,0,0,5,1443,29,56,0,56,1751,0,1751,29,0,29,1,100,NoArch
74a52d0fe68a7a84f44cdc4583ed8b1ef2036b42,0,0,0,0,0,0,0,0,0,0,0,0,0,0,0,568,9,0,0,0,0,0,0,0,0,0,0,100,NoArch
6e022e235449c0167f3700b6579d261586d87055,1,3,0,3,3,1,0,1,24,34,1,1,0,0,6,211,0,398,0,398,9817,0,9817,85,0,85,1,100,NoArch
0feb9222ddcb94464356e12ee9a0da88576514ca,5,33,21,12,54,0,0,0,154,84,2,3,2.052679097,0,1,1444,30,459,0,459,15586,0,15586,128,0,128,1,100,NoArch
5e550253a1132127609e6ee87470fbb12a9454ce,2,77,9,68,86,1,0,1,13,2523,1,2,0.820363643,0,2,1445,31,27,0,27,1356,0,1356,10,0,10,0,99.94754695,NoArch
94802b6733d1dbbda1873ce2b7fa444a4f573947,1,1,1,0,2,0,0,0,16,75,1,1,0,0,3,66,2,121,0,121,4025,0,4025,26,0,26,1,100,NoArch
ae9468de2c91817cdfd0046ea22509dc6e47c8a7,3,64,27,37,91,1,0,1,12,127,2,2,1.189687267,0,5,1446,32,79,0,79,3069,0,3069,73,0,73,1,98.39549463,NoArch
524a7c2488b5833f3b976950632e7a01ab041661,1,78,0,78,78,1,0,1,1,0,1,1,0,0,1,1447,33,8,0,8,296,0,296,7,0,7,0,99.98568105,NoArch
51ed8435f6d373f8cd510aea85e5ff6e13f488a2,1,7,1,6,8,0,0,0,70,125,1,1,0,0,8,598,4,141,0,141,4653,0,4653,31,0,31,0,100,NoArch
a5326e31ab0cbc807a60edfee3353c8bbe6df124,679,16701,24190,7489,40891,42,101,143,126,394,7,211,8.144716261,13058,2,662,21,20524,1561,18963,899746,58527,841219,7462,817,6645,0,90.15445069,Arch
942e3f021dc5b961bf56a76d481dd5b752c0644c,679,23853,16915,6938,40768,137,34,171,154,242,7,210,8.138926977,9538,3,569,10,22087,657,21430,922664,57668,864996,8226,312,7914,0,90.15445069,Arch
7f717e81f99c50175d5fcd5dcef42ac9a4ff4618,679,16708,24192,7484,40900,42,102,144,126,394,7,211,8.144994657,13269,2,663,22,20524,1561,18963,899788,58527,841261,7462,817,6645,0,90.15445069,Arch
3ba70b45de658b98c96485f10c9f688332d7510c,681,24019,16934,7085,40953,138,34,172,154,241,7,210,8.147806547,9544,3,1448,29,22487,657,21830,938554,57710,880844,8449,312,8137,1,90.15445069,Arch
5837ed9d0c1df87603865d90461bbd3060866aaf,1,22,21,1,43,0,0,0,20,135,1,1,0,0,10,570,9,623,0,623,16391,0,16391,139,0,139,0,100,NoArch
b7ffb08d976550ba512dda1aa51205c1f3c4ac00,679,16331,24379,8048,40710,40,102,142,126,394,7,211,8.150512929,13269,2,664,21,20885,1561,19324,912394,58527,853867,7662,817,6845,0,90.16129472,Arch
13b02383a3590149174d0f22bd07853d5cf31a03,4,316,60,256,376,1,0,1,89,11,1,1,1.441684354,0,1,665,22,276,0,276,11675,0,11675,56,0,56,0,99.99558947,NoArch
4720dbf421c6231b790710b379ab57b14415c384,680,24046,16806,7240,40852,138,31,169,154,241,7,210,8.146867436,8738,3,571,9,22490,670,21820,938564,57366,881198,8450,305,8145,0,90.15637366,Arch
a372781bb429b50f5897af37ed72970ac06a0ac8,1,1,1,0,2,0,0,0,71,6,1,1,0,0,8,599,3,142,0,142,4657,0,4657,31,0,31,1,100,NoArch
69a81532a908194e4b27359aa3fbe063515bb70a,680,16593,24385,7792,40978,41,102,143,126,394,7,211,8.153025936,13269,2,666,23,20919,1561,19358,914379,58527,855852,7670,817,6853,1,90.15637366,Arch
606974c0e9f629ea875f395e43275aa747e55b18,680,24062,16806,7256,40868,138,33,171,154,241,7,210,8.148381382,9390,3,600,4,22492,670,21822,938676,57366,881310,8450,305,8145,0,90.15637366,Arch
e3e32663ae329f8e7986b12b1e59aab030b292d8,12,374,64,310,438,3,0,3,40,217,1,2,2.742284761,0,3,1449,24,859,0,859,34720,0,34720,492,0,492,1,100,NoArch
efbfc2fa90b21e7766f85cb36445146e5c516061,8,51,28,23,79,1,0,1,155,76,1,5,2.738517422,0,1,1450,25,644,0,644,21632,0,21632,228,0,228,1,97.43132838,Arch
3a89665775890e7482a99d7c29dff448da224167,1,1,1,0,2,0,0,0,4,1480,1,1,0,0,4,601,4,14,0,14,551,0,551,5,0,5,0,100,NoArch
7099417b5237d98699c8d8b7c894318172f602ee,12,159,105,54,264,0,0,0,156,268,1,8,2.910974939,0,5,1451,26,1066,0,1066,41856,0,41856,413,0,413,2,100,NoArch
a46ce9df2d4caf13ea2ff217c7ed2d787178e795,1,12,0,12,12,1,0,1,105,77,1,1,0,0,6,1452,27,219,0,219,13677,0,13677,187,0,187,1,100,NoArch
aa3726b4330b3eacf4e167d3259f4f2ffc477117,2,90,0,90,90,2,0,2,11,257,1,2,0.721928095,0,1,602,5,62,0,62,2694,0,2694,37,0,37,1,93.85490515,Arch
0ae6e7910f19193866e7224d6caf7700e4e1f53d,2,6,0,6,6,2,0,2,12,182,1,1,1,0,2,1453,22,46,0,46,1709,0,1709,15,0,15,1,100,NoArch
33824b36624a885b616d86e7447535e7c96d5c37,3,28,12,16,40,0,0,0,157,257,1,2,1.16302482,0,7,1454,22,418,0,418,13283,0,13283,115,0,115,1,98.85072449,NoArch
c8847b7463f4f7beec2995458cdb58173c672f57,690,16793,24989,8196,41782,41,100,141,126,393,7,211,8.175830637,12709,2,667,18,21119,1566,19553,923522,58705,864817,7755,822,6933,0,92.63157895,Arch
e91a5c202f37648943947ab3837edf5483d7a099,690,24668,17008,7660,41676,140,33,173,157,245,7,210,8.16892948,9406,3,8,0,22768,671,22097,950338,57470,892868,8583,305,8278,0,92.63157895,Arch
8703ce00bf4987a3b00631e5232e7abbb96d6260,690,16814,25008,8194,41822,41,102,143,126,393,7,211,8.175383224,13311,2,668,16,21122,1566,19556,923620,58705,864915,7755,822,6933,0,92.63157895,Arch
f47125823394579b307d8dbab89fc6cdb38e8c80,1,13,2,11,15,0,0,0,3,2,1,1,0,0,1,669,17,33,0,33,1543,0,1543,6,0,6,0,100,NoArch
c8559620ce947a79f8de2d7f13d34bfa5df68237,806,24670,17380,7290,42050,140,32,172,157,547,7,248,8.224906456,9197,3,572,5,24645,675,23970,1012695,57537,955158,9403,305,9098,0,92.63157895,Arch
96e4336334842ce599ca821319f56813b5036486,0,0,0,0,0,0,0,0,0,0,0,0,0,0,0,573,6,0,0,0,0,0,0,0,0,0,0,100,NoArch
865036b9e1576360b34798c5fc89e81af96fbfe6,11,107,23,84,130,3,0,3,158,25,1,7,3.143322885,0,2,1455,22,1275,0,1275,54357,0,54357,514,0,514,1,94.91829876,Arch
8616653e43046fe7c09c0cf8eb5c169d64e7c59b,4,12,4,8,16,0,0,0,9,607,1,4,2,0,3,242,1,63,0,63,2942,0,2942,10,0,10,1,100,NoArch
6d90bcc2633460b5fce7892365afb0dd23b38e94,3,5,3,2,8,0,0,0,22,2573,1,1,1.561278124,0,2,603,6,58,0,58,2219,0,2219,13,0,13,0,100,NoArch
d26a05cd19d78d96aea4c11fb37b43786be53f09,811,17186,25120,7934,42306,155,102,257,126,442,7,251,8.233513754,13308,2,670,15,23151,1566,21585,991241,58705,932536,8673,822,7851,0,91.38941353,Arch
2e5b5f26312cf3313dd4896394507a14edd4ec0b,2,749,0,749,749,2,0,2,1,0,1,2,0.338267323,0,1,671,16,36,0,36,4422,0,4422,21,0,21,0,99.98415371,NoArch
eac8cf37670d44993dec6691f116ae64855538a7,4,486,0,486,486,4,0,4,11,5,2,3,1.449612028,0,1,672,17,72,0,72,4375,0,4375,27,0,27,0,99.98613724,NoArch
6cac783caab8741da93236de2223ac4dbe51fa8e,833,26037,19057,6980,45094,150,37,187,158,524,7,251,8.284342286,10371,3,19,1,24896,745,24151,1023620,64733,958887,9552,343,9209,1,91.28361533,Arch
fbe4c7ea6f1afff6ddf09c4b402c98b8a6d7debb,5,156,20,136,176,1,0,1,32,574,1,4,2.027886564,0,6,212,1,145,0,145,7165,0,7165,54,0,54,1,100,NoArch
82cde9eefdf806ca1df735f350b4ae452ef84ca0,821,18441,25275,6834,43716,160,102,262,126,424,7,253,8.24312159,13308,2,673,14,23356,1566,21790,1005523,58705,946818,8760,822,7938,1,91.98777169,Arch
8e54dcedbb0f99a11598faa824641ff76f9931a6,7,539,44,495,583,3,0,3,27,44,1,2,1.206547579,0,1,674,14,345,0,345,12649,0,12649,97,0,97,0,100,NoArch
ba9841abf1b6dcfb08c016957261bb7630fdaf7f,822,24947,19154,5793,44101,141,35,176,158,532,7,252,8.235153062,9795,3,604,6,24962,843,24119,1026459,67788,958671,9561,360,9201,1,91.98777169,Arch
76d10e750efeb0f0533f1465b236a6b1900f52bf,822,18940,25282,6342,44222,161,102,263,126,420,7,253,8.240731859,13311,2,675,15,23455,1566,21889,1008662,58713,949949,8777,822,7955,1,91.98777169,Arch
0e5b958dfc41d7debd5ee68b9eb8ba117ea6db75,822,24944,19154,5790,44098,141,39,180,158,532,7,252,8.234829769,11139,3,574,6,24962,843,24119,1026459,67788,958671,9561,360,9201,0,91.98777169,Arch
85c6cb558cabc1248fca9711b66a0dc15e3e6f83,0,0,0,0,0,0,0,0,0,0,0,0,0,0,0,575,7,0,0,0,0,0,0,0,0,0,0,100,NoArch
b91d4c69e23ed7935655a8c78670df407b11bf51,0,0,0,0,0,0,0,0,0,0,0,0,0,0,0,576,8,0,0,0,0,0,0,0,0,0,0,100,NoArch
0c1056239a1fa3649658d5ce2cf0a64df2cb5fa7,0,0,0,0,0,0,0,0,0,0,0,0,0,0,0,577,9,0,0,0,0,0,0,0,0,0,0,100,NoArch
96af328d2c57b0af255457f88b5c3badeeda88b4,2,34,3,31,37,0,0,0,8,2138,2,2,0.98678672,0,2,578,10,12,0,12,846,0,846,9,0,9,1,100,NoArch
6c0b998e888de9a20ae91cf121c44b0916d8babd,7,12,90,78,102,1,1,2,24,746,3,6,2.088754163,23,2,579,11,116,0,116,4327,24,4303,62,0,62,0,99.98754709,NoArch
e07e865dfe69cb31802e349924bbbecca5c35aba,1,245,19,226,264,0,0,0,20,0,1,1,0,0,4,580,12,65,0,65,2106,0,2106,27,0,27,0,100,NoArch
a3f3df042f158b67426700c95a7be09bb764f3a7,14,59,346,287,405,1,0,1,25,637,4,11,1.779568987,-14,2,581,13,331,50,281,22154,1416,20738,207,24,183,0,99.99377219,NoArch
7e204b565715bd02a23263c1689e371bc9090e3a,113,9115,0,9115,9115,113,0,113,2,0,3,36,6.457395933,0,1,68,2,773,0,773,40947,0,40947,426,0,426,1,96.80161038,Arch
13c9797c84f647dbecd1cef854721c7a274603c2,1,1,1,0,2,0,0,0,11,49,1,1,0,0,1,1456,14,200,0,200,6467,0,6467,64,0,64,0,100,NoArch
31b6da012c6afa3a0729a8c00faf69b2c8aca492,1,1,1,0,2,0,0,0,12,0,1,1,0,0,1,1457,15,200,0,200,6465,0,6465,64,0,64,0,100,NoArch
728590b437c9decb1561b60fbe95c712fb3fadf6,1,57,8,49,65,0,0,0,16,20,1,1,0,0,5,1458,16,99,0,99,2698,0,2698,26,0,26,1,100,NoArch
ebc910780b2b9b971a7c1c2e4019bdf9ec35e460,11,157,61,96,218,3,0,3,159,52,1,6,2.967132459,0,2,1459,17,1118,0,1118,48653,0,48653,387,0,387,1,99.99343875,NoArch
7f67c206de4eb9dbf7605fb103733b2b9eea3775,4,270,37,233,307,2,0,2,18,134,2,2,1.142828746,0,1,605,7,212,0,212,6860,0,6860,34,0,34,1,95.99973897,Arch
da63682bc7776b57e79b949abe4ee75af8170017,3,83,24,59,107,1,0,1,106,22,2,2,1.53965638,0,6,1460,18,475,0,475,24272,0,24272,297,0,297,1,100,NoArch
dbe7e5b4d5e32de6ee2aca00fae6f2b14e9832ca,957,19567,35088,15521,54655,165,215,380,126,357,9,300,8.629356135,22423,2,676,14,23960,2340,21620,1036365,99735,936630,9049,1249,7800,1,91.37901425,Arch
070bde423e1b7f0544be1ae1f408cbc0e507825f,958,35145,19563,15582,54708,270,44,314,159,467,9,301,8.632293374,11575,3,1461,17,26313,898,25415,1099560,69415,1030145,10301,386,9915,1,91.37901425,Arch
229bc4ccaed5d4989b3ec363b1964cb2df00cf6e,960,20448,35151,14703,55599,167,231,398,126,352,9,301,8.627490915,23011,2,677,15,24124,2342,21782,1042685,99800,942885,9099,1251,7848,0,91.81752806,Arch
c521fa9250eb9d1561e12bcfdee7eda366cde420,962,35177,20444,14733,55621,271,46,317,159,471,9,301,8.6300001,12454,3,1462,18,26332,1026,25306,1100365,73091,1027274,10316,409,9907,1,91.4554826,Arch
15c560d4dd9d025ee0dd2f43cc1721f590bbc064,4,57,108,51,165,0,2,2,4,3823,1,1,1.933966953,106,3,582,13,0,0,0,270,175,95,0,0,0,0,94.50011585,Arch
2df7c37b7a4578eaa1436056f3179f6e20a8e895,2,9,9,0,18,0,0,0,29,816,1,2,0.503258335,0,3,286,0,99,0,99,4703,0,4703,43,0,43,0,100,NoArch
71f8d3a03aac093d7c7655ce4ceeb855ac3789c3,968,20567,35249,14682,55816,169,231,400,126,352,9,303,8.640876672,23011,2,678,16,24239,2342,21897,1048256,99800,948456,9155,1251,7904,0,92.45525026,Arch
1f16cb0bdf894848f68e2ee38f5253f5e9f87910,969,35352,20561,14791,55913,272,48,320,159,482,9,303,8.644258781,12560,3,12,4,26450,1026,25424,1105705,73266,1032439,10377,409,9968,1,92.44998005,Arch
893263d9f832d052c396d3532784c667c60c5037,0,0,0,0,0,0,0,0,0,0,0,0,0,0,0,13,5,0,0,0,0,0,0,0,0,0,1,100,NoArch
57afcdbeadb65078c5a77b9b272776aa99e75fc6,0,0,0,0,0,0,0,0,0,0,0,0,0,0,0,213,1,0,0,0,0,0,0,0,0,0,0,100,NoArch
fcef06bdf510d58544357bd71ae1e7221caa5b47,20,28,53,25,81,0,0,0,32,1550,3,17,3.986041714,0,3,583,14,677,0,677,34291,0,34291,297,0,297,0,100,NoArch
fce8e753c2be355963a02bd585e4e74e9d8e5ebb,6,102,25,77,127,0,0,0,91,205,2,5,1.72402004,0,3,1463,15,467,0,467,19866,0,19866,241,0,241,0,100,NoArch
a465a179aef282b716693843898b466150b643cb,989,20668,35488,14820,56156,169,232,401,126,357,9,315,8.652436388,23120,2,679,17,24848,2361,22487,1077339,100167,977172,9411,1269,8142,0,92.44363367,Arch
ab1cd2bba38e4209991bd108158a08036f097b5e,2,228,4,224,232,0,0,0,14,84,1,1,0.999517475,0,2,680,18,32,0,32,4782,0,4782,25,0,25,0,100,NoArch
7eedbb7fe0f96daa39589145f0284f9054a1b469,991,35490,20898,14592,56388,272,47,319,159,498,9,316,8.65429222,12371,3,214,2,27143,1016,26127,1138784,73609,1065175,10659,410,10249,1,92.44363367,Arch
a203500961a7487322dedc1f4a2071babfe311d1,0,0,0,0,0,0,0,0,0,0,0,0,0,0,0,584,14,0,0,0,0,0,0,0,0,0,0,100,NoArch
6747de05fe379662c494c5420a5f10b8d9c9a4ac,3,33,8,25,41,1,0,1,80,369,2,3,1.281553108,0,2,606,7,248,0,248,10378,0,10378,43,0,43,1,100,NoArch
925978effd034bbddc7ebe3716c4f6ed916e5b40,991,20901,35494,14593,56395,169,232,401,126,357,9,316,8.654422098,23120,2,681,17,24915,2361,22554,1081954,100167,981787,9431,1269,8162,1,92.44363367,Arch
c5f3efe0ae4f39ac133d3de8c55a5b4670000611,991,35487,20895,14592,56382,272,48,320,159,498,9,316,8.654412236,12692,3,14,6,27147,1016,26131,1138956,73609,1065347,10660,410,10250,1,92.44363367,Arch
c9e1a9c73395f53e53973ed25f32456b78959a50,1,14,3,11,17,0,0,0,10,560,1,1,0,0,5,215,3,205,0,205,6698,0,6698,60,0,60,1,100,NoArch
3b85cfaa3e3ede4c2abf977b4c0bbe4ec289c09a,6,18,24,6,42,0,0,0,17,1029,2,4,2.265190638,0,5,585,15,205,0,205,6519,0,6519,56,0,56,0,100,NoArch
23276318ea9192b3f69aa30ad9a27deb45d00bd5,3,73,13,60,86,2,0,2,19,417,2,2,0.607884723,0,5,1464,16,123,0,123,4414,0,4414,54,0,54,1,100,NoArch
f67163396c93eb267b920464325ce3b792fded59,1,1,1,0,2,0,0,0,17,0,1,1,0,0,3,1465,17,69,0,69,2217,0,2217,23,0,23,1,100,NoArch
1eb690865160a2b4ad50c08a1b59729408d3c419,0,0,0,0,0,0,0,0,0,0,0,0,0,0,0,159,0,0,0,0,0,0,0,0,0,0,1,100,NoArch
eed15b403add8264f8ee8d670dae7f8a07788c83,425,16593,15462,1131,32055,39,88,127,103,566,4,101,7.448453939,11767,2,732,26,8240,1384,6856,435293,50284,385009,2627,674,1953,0,93.63553892,Arch
475500b009afbdb7901f50c18891e14b6a234f42,1,15,8,7,23,0,0,0,6,3,1,1,0,0,1,733,27,73,0,73,3001,0,3001,14,0,14,0,100,NoArch
4843806921c665a3a2fecb5826ae2d20ec563ab2,2,13,66,53,79,0,0,0,9,1292,1,1,0.547990008,0,3,594,15,74,0,74,2123,0,2123,19,0,19,0,100,NoArch
f1d5ca8aee78a87a3cf2382a7498d8acc143bd3e,0,0,0,0,0,0,0,0,0,0,0,0,0,0,0,595,16,0,0,0,0,0,0,0,0,0,0,100,NoArch
92003dbdda20095cab1bf5740a211a6c9b554b50,0,0,0,0,0,0,0,0,0,0,0,0,0,0,0,596,17,0,0,0,0,0,0,0,0,0,0,100,NoArch
f23fe707b64e4ff9c32b37cc77168503ebba86ff,2,4,1,3,5,1,0,1,85,1018,1,2,0.970950594,0,8,734,28,164,0,164,4997,0,4997,38,0,38,1,100,NoArch
c9f5e018a9fa458f9896bebfb16c78bf68a41e34,5,44,18,26,62,0,0,0,39,659,2,4,2.183193267,0,3,597,18,281,0,281,12532,0,12532,96,0,96,0,100,NoArch
c86b32063506fe346c6b9c435647f6ced93bdc67,10,666,182,484,848,2,0,2,104,122,2,6,2.555637233,0,2,735,27,817,0,817,38415,0,38415,191,0,191,0,100,NoArch
3898dbb3e29202c0d2942fb903fa29a7c16418a7,5,28,37,9,65,0,0,0,33,905,1,3,2.268484888,0,6,598,18,192,0,192,7443,0,7443,91,0,91,0,100,NoArch
1632b7eec151d571f75c7f6953fa0ce1994113b2,1,21,1,20,22,0,0,0,14,237,1,1,0,0,4,20,1,74,0,74,2004,0,2004,14,0,14,0,100,NoArch
2fdf13d8ce9ae886a68e4aa35c20af405a232655,2,16,8,8,24,0,0,0,11,63,1,1,0.650022422,0,1,21,2,93,0,93,2783,0,2783,41,0,41,0,100,NoArch
e996789ad3c2094908f787c9d9e5339bd5852026,1,23,2,21,25,0,0,0,3,0,1,1,0,0,1,22,3,55,0,55,1516,0,1516,27,0,27,0,100,NoArch
3410e46e518e92c8ff99ad4179c188cc518b3260,2,2,2,0,4,0,0,0,15,0,1,1,1,0,1,23,4,129,0,129,3518,0,3518,41,0,41,0,100,NoArch
0146d65aa1aa2681d358928f8e4ac918bf2b0305,4,883,11,872,894,2,0,2,29,54,2,3,0.704121606,0,1,736,25,116,0,116,9476,0,9476,53,0,53,0,99.98508843,NoArch
1acfc88090a7fca36194f6f1658375184053bab7,37,5481,0,5481,5481,37,0,37,1,0,1,10,4.578725401,0,1,287,1,624,0,624,24944,0,24944,392,0,392,1,95.53283394,Arch
d8e4ad366ca5fa36a0a89fac417b30a90c0e05ad,0,0,0,0,0,0,0,0,0,0,0,0,0,0,0,288,2,0,0,0,0,0,0,0,0,0,1,100,NoArch
48b36289423a0f99f74a4bc17b335403da1450ae,2,9,0,9,9,2,0,2,5,2641,1,1,0.918295834,0,2,243,1,23,0,23,566,0,566,13,0,13,1,100,NoArch
01f06dc19334b42c83efa839643a99c9502b3e5a,0,0,0,0,0,0,0,0,0,0,0,0,0,0,0,244,2,0,0,0,0,0,0,0,0,0,0,100,NoArch
6edbd5859bf607dcde8f9a31b6a4658df0b91e21,5,876,28,848,904,1,0,1,30,2,2,3,1.512648954,0,3,737,23,291,0,291,16302,0,16302,89,0,89,0,99.9949523,NoArch
48f53080dc94bc4f24a1679b1e3238fcacbe512a,3,104,7,97,111,2,0,2,2,11,1,1,1.543159774,0,1,24,5,59,0,59,3496,0,3496,19,0,19,0,99.98485957,NoArch
b09f960b6e55c51ccc12b4bd2d1910002970fbc5,1,1,0,1,1,1,0,1,5,401,1,1,0,0,4,245,3,56,0,56,2915,0,2915,18,0,18,1,100,NoArch
a371057fdeae99861ff7a7de34f387aa3820a9c7,3,104,6,98,110,0,0,0,12,820,2,2,1.562577815,0,3,78,0,289,0,289,8254,0,8254,53,0,53,1,99.99243055,NoArch
367c959779bf00e04ac7b8929e918e07eeeba37c,1,1,0,1,1,1,0,1,7,0,1,1,0,0,3,79,1,11,0,11,1123,0,1123,9,0,9,1,100,NoArch
f6bab1a9a3e4602e386574c657d8827c9a528429,0,0,0,0,0,0,0,0,0,0,0,0,0,0,0,289,3,0,0,0,0,0,0,0,0,0,1,100,NoArch
32e9e2242f59a143568fd2483cd4aef7ed63e33c,1,2,1,1,3,0,0,0,3,104,1,1,0,0,2,290,4,6,0,6,872,0,872,2,0,2,0,100,NoArch
81d8e24b045d1719c7b1a6918d5b1b43740423e3,0,0,0,0,0,0,0,0,0,0,0,0,0,0,0,291,5,0,0,0,0,0,0,0,0,0,1,100,NoArch
66bd965f3def49204082c34bc2c81f079bafc7c0,0,0,0,0,0,0,0,0,0,0,0,0,0,0,0,292,6,0,0,0,0,0,0,0,0,0,1,100,NoArch
42931a244c5c4d0e0e3ca98a34b0448511703fcb,11,301,340,39,641,0,0,0,31,318,3,8,2.151162803,0,3,738,22,416,0,416,20545,0,20545,118,0,118,0,100,NoArch
313c40705b0bec3e506e8cbb56ebdc371f4a7568,5,27,0,27,27,5,0,5,12,92,1,1,2.272088893,0,1,739,23,120,0,120,24513,0,24513,89,0,89,0,100,NoArch
cf26ae9a13bdec8aa8f49531161e98dc95629231,0,0,0,0,0,0,0,0,0,0,0,0,0,0,0,599,17,0,0,0,0,0,0,0,0,0,0,100,NoArch
5a0d5de27c3d83e82f18ebed908f0624c8b7585a,17,54,27,27,81,10,0,10,3,17,1,5,3.5653529,0,2,600,18,137,0,137,7934,0,7934,56,0,56,0,100,NoArch
7dc270e8415ba6fdf3decb2d3a9f23722711bcae,0,0,0,0,0,0,0,0,0,0,0,0,0,0,0,601,19,0,0,0,0,0,0,0,0,0,0,100,NoArch
3c95b4b01da194ba34a2230dd00a2333d820464a,10,51,55,4,106,0,0,0,4,18,1,7,2.63309291,0,2,602,20,168,0,168,8629,0,8629,88,0,88,0,100,NoArch
7a9039c7a6d001974b70cbd1df064991c8f291a1,1,1,1,0,2,0,0,0,3,0,1,1,0,0,2,603,21,11,0,11,411,0,411,6,0,6,0,100,NoArch
94bd1cce747041cbadc644b8ad5394901f435bd9,1,19,0,19,19,1,0,1,4,0,1,1,0,0,2,604,22,15,0,15,1391,0,1391,14,0,14,0,99.98485728,NoArch
0946fd921cca26b62812a8e91620b1fe1237daf1,1,2,0,2,2,1,0,1,2,4,1,1,0,0,2,605,23,4,0,4,322,0,322,2,0,2,0,100,NoArch
51efdf3df80358fc41ef17ae612ccc83e041b3a8,3,14,2,12,16,2,0,2,2,3,1,1,1.579434003,0,2,606,24,134,0,134,3515,0,3515,103,0,103,0,100,NoArch
6358dc0577bb2ff41f91a6c3ac121a75d3da1a6e,5,104,35,69,139,2,0,2,105,49,2,2,1.917164016,0,3,740,21,677,0,677,29303,0,29303,135,0,135,1,100,NoArch
cfb3f1801d853c631c61a074bc3d8b419de4e942,6,492,25,467,517,3,0,3,16,9,1,4,2.150970688,0,1,25,5,214,0,214,7327,0,7327,80,0,80,1,98.43874381,NoArch
dd31efec968b7e0fc084065c058fdb1f6e66af72,1,15,22,7,37,0,0,0,4,239,1,1,0,0,1,741,20,5,0,5,299,0,299,4,0,4,0,100,NoArch
aa297f8681af755744f22c7c62385686d4abc229,0,0,0,0,0,0,0,0,0,0,0,0,0,0,0,742,21,0,0,0,0,0,0,0,0,0,0,100,NoArch
6fc4cdf9d0a55b0d9ee87f27e20f67333977e828,6,279,34,245,313,1,0,1,32,9,2,3,1.746203518,0,1,743,19,376,0,376,22042,0,22042,108,0,108,0,100,NoArch
1d7365b33c03b44f8fa984fc1f6350469f6bb7f3,1,24,1,23,25,0,0,0,8,573,1,1,0,0,1,744,20,16,0,16,806,0,806,5,0,5,0,100,NoArch
252994f076ae5d27b27f78901f19e7ac670b218b,1,16,6,10,22,0,0,0,40,587,1,1,0,0,8,246,3,199,0,199,6361,0,6361,71,0,71,1,100,NoArch
493e0842b4a5692df158c014587e720a7b2319ce,5,471,0,471,471,5,0,5,1,0,1,2,2.056044761,0,1,26,6,39,0,39,2479,0,2479,25,0,25,1,99.96082016,NoArch
5ff578ad60ef1a447de3659866a1b27788bfc722,2,0,5,5,5,0,0,0,2,0,1,2,0.721928095,0,1,27,7,31,0,31,1949,0,1949,19,0,19,0,100,NoArch
a00f4c5014238482985191c4485985239e53e46d,2,37,3,34,40,0,0,0,8,1622,1,1,0.286396957,0,3,247,4,23,0,23,2181,0,2181,20,0,20,1,100,NoArch
1fb14e95f423756961b1055cb513631de7a4fff9,1,1,6,5,7,0,0,0,9,0,1,1,0,0,3,248,5,18,0,18,1757,0,1757,16,0,16,1,100,NoArch
3c78d3be567447c50d10ed52fcfe231525d2bf9c,3,167,7,160,174,1,0,1,7,435,1,2,1.440329879,0,2,293,6,50,0,50,2013,0,2013,27,0,27,1,97.47155499,Arch
8017011a7b653d41628ad7bc5ff05071e3b6488a,3,93,16,77,109,1,0,1,2,18,1,1,1.41739093,0,1,294,7,95,0,95,3369,0,3369,42,0,42,1,99.98980086,NoArch
c63e862730c4a0c99dcf4ca1b70141309b28d32c,10,11,11,0,22,0,0,0,45,672,4,8,3.277613437,0,3,295,8,472,0,472,16384,0,16384,90,0,90,0,100,NoArch
3fa3231b13f06664b6aaf6b56e3de5738c89a574,1,1,7,6,8,0,0,0,3,0,1,1,0,0,1,296,9,81,0,81,2638,0,2638,30,0,30,1,100,NoArch
4a32e60fe9ebeb752a79b3f5dab89baf152d0243,17,1110,170,940,1280,6,0,6,32,593,1,8,3.240671008,0,4,18,0,678,0,678,30794,0,30794,320,0,320,0,93.20098536,Arch
923ad4a992f9d40285a80d6a8e701b0dda4d52ea,8,23,29,6,52,0,0,0,6,895,1,1,2.73355643,0,4,19,1,247,0,247,19221,0,19221,139,0,139,0,99.97312009,NoArch
4f648cb0e564548abe0ce32283596b6e13ef3c31,1,2,0,2,2,1,0,1,31,161,1,1,0,0,4,1466,3,361,0,361,11567,0,11567,110,0,110,0,100,NoArch
31b6842880028b87b8bd43465fabc33f335ccaa7,1,13,9,4,22,0,0,0,93,59,1,1,0,0,5,1467,4,302,0,302,8179,0,8179,54,0,54,0,100,NoArch
bff9bf284e7a25c5dbcb3da0e0a7ea1d246400d6,1,9,4,5,13,0,0,0,25,242,1,1,0,0,2,1468,5,50,0,50,1985,0,1985,20,0,20,1,100,NoArch
e07188519ce8bbc20db421747559d530f500f50a,13,390,30,360,420,5,0,5,14,378,1,7,3.487890269,0,1,1469,6,215,0,215,7775,0,7775,105,0,105,1,96.38052312,Arch
eeb54d7aed207717fd2243f6975f0dc432c4035d,4,127,32,95,159,3,0,3,3,5,1,1,1.932827005,0,1,28,8,61,0,61,3383,0,3383,20,0,20,0,99.97573405,NoArch
61145ca9fe23be1c9a88570926308e30b276c5c1,1,25,4,21,29,0,0,0,4,3,1,1,0,0,1,297,10,88,0,88,2989,0,2989,30,0,30,1,100,NoArch
51b6917d75fe664c0baf21c641232cfb6e1761de,1,1,1,0,2,0,0,0,3,3,1,1,0,0,1,298,11,5,0,5,387,0,387,3,0,3,1,100,NoArch
8ba668a7d1b94a169a1dd0bea457e08705c64e1b,2,62,16,46,78,0,0,0,11,145,1,2,0.586918583,0,2,1470,6,116,0,116,3785,0,3785,40,0,40,1,100,NoArch
9f49d939d2d87bf1f793aff2e2ed0f76102b1b74,1,6,0,6,6,1,0,1,12,3,1,1,0,0,5,216,1,20,0,20,749,0,749,20,0,20,0,100,NoArch
90c163306e79d9f2d38c094ac6b8996fc7c62bcc,4,667,10,657,677,3,0,3,16,61,2,3,1.447023115,0,1,745,13,73,0,73,3751,0,3751,25,0,25,0,99.97574582,NoArch
bb42285dce2af51edf4f90985a50b6eed5a77015,1,3,2,1,5,0,0,0,33,867,1,1,0,0,9,217,1,156,0,156,4543,0,4543,30,0,30,1,100,NoArch
094d369363e640de47299e93e288bab758562eb3,0,0,0,0,0,0,0,0,0,0,0,0,0,0,0,1471,5,0,0,0,0,0,0,0,0,0,0,100,NoArch
6019486954e7e48efbd393f5fe1e7dcee3a2253c,0,0,0,0,0,0,0,0,0,0,0,0,0,0,0,1472,6,0,0,0,0,0,0,0,0,0,0,100,NoArch
445c6ddae4952653ebad7ea15e23c42f51063b3f,5,230,117,113,347,3,0,3,15,264,1,3,1.746078749,0,1,1473,7,44,0,44,2323,0,2323,13,0,13,1,99.94460601,NoArch
703b93cc965672f920088deeff8bde9c90b05480,1,6,0,6,6,1,0,1,2,314,1,1,0,0,1,1474,8,8,0,8,341,0,341,8,0,8,1,100,NoArch
1223a2c432c7901be7254e358928e6db91db89aa,3,5,1,4,6,2,0,2,2,1875,1,1,1.584962501,0,2,1475,9,18,0,18,1019,0,1019,16,0,16,0,100,NoArch
ea5663f29fb9a64430bea5a58798a0a79373542a,1,5,0,5,5,1,0,1,26,67,1,1,0,0,8,249,6,47,0,47,1796,0,1796,18,0,18,1,100,NoArch
f475c44bd42d2864d03166a79c9aebc7ecc074e6,1,8,2,6,10,0,0,0,27,0,1,1,0,0,8,250,7,49,0,49,1820,0,1820,18,0,18,1,100,NoArch
6241186c4e4ec1c14ff467884f83716fe6e2e2c7,10,228,45,183,273,2,0,2,28,79,2,6,2.837879514,0,1,746,10,548,0,548,20540,0,20540,160,0,160,0,100,NoArch
d9def5efccb06983c719bf56bac9b276440612dc,0,0,0,0,0,0,0,0,0,0,0,0,0,0,0,747,11,0,0,0,0,0,0,0,0,0,0,100,NoArch
1d6438784fc0fee6e00f3492b2920953ed6354fe,171,1458,1557,99,3015,39,5,44,69,862,7,81,4.679848055,427,3,607,9,7159,97,7062,277503,3919,273584,2464,34,2430,0,92.91225716,Arch
373d15b429b3c517fe0e8ee792dc547135f92717,1,10,10,0,20,0,0,0,2,0,1,1,0,0,1,608,10,49,0,49,1820,0,1820,18,0,18,1,100,NoArch
2a057461bc998a3c539434f7fe21adc5880e9d40,0,0,0,0,0,0,0,0,0,0,0,0,0,0,0,609,10,0,0,0,0,0,0,0,0,0,0,100,NoArch
e72cd4a144dd7851b145e2a55d8e6c3759201a3c,1,7,1,6,8,0,0,0,63,630,1,1,0,0,8,610,11,244,0,244,8584,0,8584,54,0,54,1,100,NoArch
7d30aec26dc1a64a05d838d081e1ec09cc5a6ee7,2,24,4,20,28,0,0,0,10,551,1,1,0.985228136,0,2,1476,10,163,0,163,4930,0,4930,50,0,50,0,100,NoArch
0fd41e29ea4a79d7dd44569db6c804c5b257085b,8,152,89,63,241,1,0,1,33,403,1,4,2.052843181,0,2,20,2,336,0,336,15889,0,15889,144,0,144,1,93.97030026,Arch
7e13cf2af586861c937bca78f4e1b9a5357f40d1,3,0,402,402,402,0,3,3,7,1187,1,1,1.375610759,402,3,21,3,0,70,70,0,1918,1918,0,21,21,1,94.88447867,Arch
e8d94a36e0f91ffb18da9a5c3bfb22580ab89afb,6,93,67,26,160,0,0,0,33,71,2,5,2.121862574,0,3,748,11,165,0,165,18786,0,18786,97,0,97,0,100,NoArch
d5f4ca8a34a1f52f89bdc7f2cc886d6ad1ee7819,2,237,0,237,237,2,0,2,1,0,1,2,0.718539698,0,1,749,12,19,0,19,992,0,992,7,0,7,0,99.98369583,NoArch
a93cb919813047ddefa90240d5c3d18d9a97cc78,1,7,4,3,11,0,0,0,3,9,1,1,0,0,1,750,13,11,0,11,1254,0,1254,8,0,8,0,100,NoArch
7534fe96fde42cc35c57924c355c5a91cab7c984,4,53,19,34,72,1,0,1,5,300,1,2,1.598816797,0,1,751,14,50,0,50,2777,0,2777,21,0,21,0,100,NoArch
ad5888fd8dbd9fb18e40a7dec12c3fe2825209e5,1,24,20,4,44,0,0,0,5,0,1,1,0,0,1,752,15,26,0,26,1056,0,1056,11,0,11,0,100,NoArch
48ef6df6050cac1efea7111eb0aa7ef268704ccd,9,56,24,32,80,0,0,0,15,358,1,8,2.662125792,0,1,1477,11,176,0,176,7030,0,7030,72,0,72,0,100,NoArch
0fa7477274ea6c430f764d5c6a013bb09cae9409,2,2,9,7,11,0,0,0,6,2,1,2,0.684038436,0,1,753,16,79,0,79,10462,0,10462,51,0,51,0,100,NoArch
bcd6241254269e25617494beda11fba529f1396a,4,14,8,6,22,1,0,1,48,403,3,4,1.413088436,0,2,1478,12,232,0,232,7804,0,7804,78,0,78,1,100,NoArch
ca2e809293de5775d94fd91344f2f239480a8c0c,3,41,2,39,43,2,0,2,49,123,1,3,1.318300593,0,1,1479,13,246,0,246,8603,0,8603,90,0,90,1,100,NoArch
49c144e2fbf4eb6d720200272f241ee576c30b9d,1,3,3,0,6,0,0,0,3,0,1,1,0,0,1,1480,14,17,0,17,1433,0,1433,17,0,17,1,100,NoArch
1764cb7d4180169f647cb728fd36603d265e5a9c,2,50,1,49,51,1,0,1,50,525,1,2,0.787126586,0,2,1481,15,177,0,177,6808,0,6808,47,0,47,1,100,NoArch
0f65c53f8e82600b64ebd83afaf00637a70fc8eb,7,62,76,14,138,0,0,0,34,11,1,4,2.518921003,0,5,22,4,427,0,427,15597,0,15597,169,0,169,1,100,NoArch
c650d4d328c3780d3d086824885b18bbfd6e3c3a,3,12,2,10,14,1,0,1,86,77,1,2,1.413799565,0,8,754,16,213,0,213,8244,0,8244,45,0,45,0,100,NoArch
008f6e6d4e35d379d1ec26292e64f6fb71f9837a,4,533,14,519,547,2,0,2,7,9,1,2,0.345085815,0,1,755,17,368,0,368,12137,0,12137,58,0,58,0,99.98043882,NoArch
d7f3a21dd059ece008ad43e9b5614cc34c11dc63,1,6,5,1,11,0,0,0,38,212,1,1,0,0,5,1482,16,59,0,59,2014,0,2014,23,0,23,0,100,NoArch
445d38ab1bade4408a3b76e495759d4808fd4c58,1,26,0,26,26,1,0,1,10,3,1,1,0,0,2,1483,17,7,0,7,1214,0,1214,7,0,7,1,100,NoArch
3cbfe03f6e045c870b95b25d7c427c387555b364,1,1,1,0,2,0,0,0,7,1371,1,1,0,0,3,1484,18,25,0,25,517,0,517,10,0,10,1,100,NoArch
b5a5c91b7e662fc6523d4a29766fe32fed225b53,2,2,0,2,2,2,0,2,18,2194,2,2,1,0,6,611,4,92,0,92,3139,0,3139,13,0,13,0,100,NoArch
99f93d13e68e4c5413ee0203bf2680ed26eb8343,1,12,8,4,20,0,0,0,64,14,1,1,0,0,8,612,5,245,0,245,8606,0,8606,55,0,55,1,100,NoArch
02a7a30b31f85d620965b5423cdb410e9839f7fd,2,10,2,8,12,1,0,1,15,544,2,2,0.811278124,0,4,613,6,163,0,163,5929,0,5929,58,0,58,1,100,NoArch
ba9ab3554aec260f698a3b16f6e48b799b002b0e,1,9,0,9,9,1,0,1,16,0,1,1,0,0,3,614,7,141,0,141,4865,0,4865,40,0,40,1,100,NoArch
a1b1e7898cb51e2681203e4ec89767a89f2750cf,1,0,12,12,12,0,0,0,4,9,1,1,0,0,1,756,15,11,0,11,1218,0,1218,8,0,8,0,100,NoArch
722a3bb0eaaed7d90a2749d1efeb531ae1b7e6f2,0,0,0,0,0,0,0,0,0,0,0,0,0,0,0,757,16,0,0,0,0,0,0,0,0,0,0,100,NoArch
a4cfbbb8c8b8c0490e5f1a93c20ca41085926fd2,2,6,5,1,11,1,0,1,48,761,2,2,0.439496987,0,3,1485,19,61,0,61,2040,0,2040,18,0,18,2,100,NoArch
24cbca795a21070f5bf11587277900b3a2cf226b,8,210,82,128,292,2,0,2,87,52,2,3,2.416482832,0,3,758,17,638,0,638,28734,0,28734,171,0,171,0,100,NoArch
03fa30f3b320c3ffd45043f94289f98756d97064,2,5,6,1,11,0,0,0,49,0,2,2,0.439496987,0,3,1486,20,61,0,61,2026,0,2026,18,0,18,0,99.98696007,NoArch
4a59f1cb44eaecd77dd33fbcca981e9df86d6fb3,9,324,54,270,378,6,0,6,51,115,2,4,3.106420088,0,1,615,8,984,0,984,33395,0,33395,252,0,252,1,100,NoArch
d927be58bdba950ff6ad84cb02a76b05cea4993f,1,1,1,0,2,0,0,0,17,3,1,1,0,0,3,616,9,141,0,141,4867,0,4867,40,0,40,1,95.78631816,Arch
353e4ec70b57983fdee090d831c4bae06a9a6784,1,38,13,25,51,0,0,0,18,21,1,1,0,0,1,759,14,23,0,23,2357,0,2357,15,0,15,0,100,NoArch
48751778ed8eee0af48b4100b3e8260587e27754,31,1588,1106,482,2694,10,7,17,3,22,1,17,4.354389868,884,1,15,0,272,90,182,15018,5477,9541,140,38,102,2,100,NoArch
e046c38c9d8569f4a6fa2bc3cfa4bccb38e9f71f,1,58,0,58,58,1,0,1,33,42,1,1,0,0,2,760,15,57,0,57,7244,0,7244,32,0,32,0,99.7039256,NoArch
8cd826e6dcbe68c28d37a7581612239e2728f5fc,1,4,5,1,9,0,0,0,2,81,1,1,0,0,2,617,10,10,0,10,741,0,741,3,0,3,0,100,NoArch
58ced123c8d80d7f31e6d37d1d04927baef8ad0e,3,30,4,26,34,1,0,1,52,30,1,2,1.520568918,0,3,761,16,115,0,115,4474,0,4474,46,0,46,1,100,NoArch
ad9fef8fe55752ca99a5047efb2fdc54e7d19e01,1,5,0,5,5,1,0,1,2,0,1,1,0,0,1,16,1,9,0,9,896,0,896,9,0,9,0,100,NoArch
b8ea49f96a496e958443c15f8a6048573256636f,1,6,2,4,8,0,0,0,11,299,1,1,0,0,2,762,17,196,0,196,3912,0,3912,41,0,41,1,100,NoArch
185f6743a55a4a318542beb86564c6da6d35d523,0,0,0,0,0,0,0,0,0,0,0,0,0,0,0,878,23,0,0,0,0,0,0,0,0,0,0,100,NoArch
b37837f0067dbcb48e8431a8caa2554f32be559c,3,17,1,16,18,2,0,2,27,120,1,2,1.435520504,0,1,1709,40,395,0,395,12065,0,12065,265,0,265,0,100,NoArch
535917e7e2960f5ea8bba6f209eaf53616ec5934,0,0,0,0,0,0,0,0,0,0,0,0,0,0,0,1710,41,0,0,0,0,0,0,0,0,0,0,100,NoArch
935ec1584cfc42ec7400505bad6ad68d81153799,1,8,0,8,8,1,0,1,9,109,1,1,0,0,4,241,4,30,0,30,1071,0,1071,13,0,13,1,100,NoArch
86a69a6dea54550dec43e0f6906a276945c53bb4,0,0,0,0,0,0,0,0,0,0,0,0,0,0,0,242,5,0,0,0,0,0,0,0,0,0,0,100,NoArch
836b08e6ca23b7f627b2a6c8e5b9340a9687bdd7,1,139,0,139,139,1,0,1,9,104,1,1,0,0,1,961,10,29,0,29,2962,0,2962,12,0,12,0,100,NoArch
6351c76dc86a2b2ddb4c6b8916e726ac8e084c6d,1,6,8,2,14,0,0,0,10,0,1,1,0,0,1,962,11,29,0,29,2962,0,2962,12,0,12,0,100,NoArch
2fd68d8b34ed0eb1c0a24cab6055497998ca46d7,2,19,11,8,30,0,0,0,171,20,2,2,0.566509507,0,3,1711,37,415,0,415,13624,0,13624,109,0,109,0,100,NoArch
fce0ce3a7f173dec44473b17199b113a5cb1df12,1,12,4,8,16,0,0,0,9,1394,1,1,0,0,4,28,0,44,0,44,1188,0,1188,7,0,7,1,100,NoArch
3d210220f02839cd8388e36f2ae9e6bf645cbdd7,7,44,1,43,45,6,0,6,74,478,2,6,2.728770953,0,5,879,24,302,0,302,9148,0,9148,127,0,127,1,100,NoArch
cfbe8942a1f2f029faad8c0fce9ff02a3bfb9fdb,1,1,6,5,7,0,0,0,82,42,1,1,0,0,3,1712,38,98,0,98,3117,0,3117,21,0,21,1,100,NoArch
880377a9727528be3aea212a983ac2eced157e8d,1,2,2,0,4,0,0,0,11,777,1,1,0,0,3,1713,39,22,0,22,956,0,956,7,0,7,1,100,NoArch
7521ad685276b02af30a5fa145dbced0b91058fd,6,46,127,81,173,2,0,2,75,214,1,6,1.740821298,0,8,880,25,370,0,370,18645,0,18645,195,0,195,0,96.63716814,Arch
ae039d5762840d76f710393071aad85fb09fd5ea,1,6,2,4,8,0,0,0,7,157,1,1,0,0,3,1714,39,54,0,54,1713,0,1713,25,0,25,1,100,NoArch
8d781313a13fa53742b2f1c84438d3d1abba30d3,1,74,0,74,74,1,0,1,1,0,1,1,0,0,1,243,6,1,0,1,303,0,303,1,0,1,1,99.99560092,NoArch
4a876e047ed085237ac65c47d2a3ef9635e682fd,2,2,3,1,5,0,0,0,4,85,1,2,0.970950594,0,1,963,10,31,0,31,2425,0,2425,13,0,13,0,100,NoArch
c6efa27d4625cf7219a39621ca4c4e3af9ceb81e,32,506,46,460,552,7,0,7,120,296,3,13,3.600970609,0,1,964,11,2551,0,2551,90123,0,90123,433,0,433,0,91.06525376,Arch
5ef45a148c6a7f175e35b40406a60e2efe214d31,0,0,0,0,0,0,0,0,0,0,0,0,0,0,0,1715,37,0,0,0,0,0,0,0,0,0,1,100,NoArch
ecf2fdbe01d938809dcc1f71f3d4cd4de82fa702,1,2,2,0,4,0,0,0,119,54,1,1,0,0,6,1716,38,243,0,243,15515,0,15515,205,0,205,0,100,NoArch
6502de3d212a182cd256aa54787c4a834195ff2d,7,1,23,22,24,0,0,0,11,14,2,4,2.450825795,0,1,965,12,119,0,119,12118,0,12118,59,0,59,0,100,NoArch
e61bfa7953dfe33d244bb5b59435ec93c7506feb,1,2,0,2,2,1,0,1,9,122,1,1,0,0,4,29,1,14,0,14,572,0,572,2,0,2,0,100,NoArch
086b11667b96dec701f592ae2925bfa5de7ad647,2,4,6,2,10,0,0,0,13,321,1,2,1,0,3,966,13,62,0,62,1648,0,1648,25,0,25,1,100,NoArch
af00425e04f2b7944853939e8bee1886148fbfe5,64,217,866,649,1083,6,3,9,170,174,4,37,4.630127453,309,1,877,14,4369,20,4349,169894,1681,168213,1377,5,1372,0,91.36069114,Arch
f73a8780a2856a2df8f0d8499232b59845b8582a,64,870,222,648,1092,17,0,17,171,245,4,37,4.640950709,0,1,967,14,4468,0,4468,173939,0,173939,1392,0,1392,1,91.36069114,Arch
e68bd71f0145ee6719d80328366209a07b984df5,12,64,61,3,125,0,0,0,8,5,3,4,3.444793434,0,1,1717,38,117,0,117,5212,0,5212,79,0,79,1,99.89334958,NoArch
a9f3c9416b33a7688cb0c8922619b713ea6b1c7c,3,34,5,29,39,1,0,1,120,71,2,3,1.485731248,0,6,1718,37,606,0,606,26204,0,26204,414,0,414,1,100,NoArch
c873f990c114ad0256f796226ba14c84c9958ac3,2,4,4,0,8,0,0,0,7,179,1,2,0.811278124,0,1,881,17,479,0,479,12411,0,12411,111,0,111,0,100,NoArch
02df8d6837563f5749b6d983e771b71652425c9c,2,11,2,9,13,0,0,0,18,219,2,2,0.619382195,0,4,882,18,120,0,120,7953,0,7953,36,0,36,0,100,NoArch
5c43ede9914108c7d8b9f1d06d6e4601b8732746,2,20,7,13,27,0,0,0,2,320,1,1,0.99107606,0,1,883,19,19,0,19,944,0,944,8,0,8,0,99.99238153,NoArch
9a2fe574c337173cf02bb87aca33bb232a544f70,0,0,0,0,0,0,0,0,0,0,0,0,0,0,0,884,20,0,0,0,0,0,0,0,0,0,0,100,NoArch
6ffe710140ed4319e0ffb04fedf880b4f890f701,2,37,3,34,40,1,0,1,11,614,2,2,0.881290899,0,5,1719,38,451,0,451,14052,0,14052,113,0,113,0,100,NoArch
cda59ba670339fe9a404b9e9f29ed891529ba187,13,323,1543,1220,1866,1,4,5,15,145,1,7,3.49916597,823,2,968,15,106,83,23,7352,6779,573,53,37,16,0,99.9199329,NoArch
9a20282e40c3d60d03871440d0b14ee02d3f0a32,1,1,2,1,3,0,0,0,11,1,1,1,0,0,5,1720,36,17,0,17,1056,0,1056,17,0,17,0,100,NoArch
9603da46c34c6e9d45172d8c0c5de236178c0a85,9,280,1096,816,1376,1,4,5,16,119,1,5,2.806183328,969,1,969,16,77,34,43,5731,4550,1181,43,31,12,0,91.14941576,Arch
b509ba67ce2ebe6655879e9999821ea8a5b4bd6d,20,1142,5774,4632,6916,1,8,9,42,230,1,11,3.805120238,4003,1,970,16,413,229,184,26167,24196,1971,131,111,20,0,91.18086283,Arch
e64947fd2cc76de4e3aa045f628a5a570862b449,11,32,156,124,188,1,0,1,121,69,3,5,2.369786883,0,1,1721,31,460,0,460,26005,0,26005,305,0,305,1,99.95406523,NoArch
e25741b0ae646a475088dcfb5c17f90356ee2d80,28,1147,4374,3227,5521,0,9,9,52,240,1,8,4.167362488,3162,1,971,16,336,181,155,24423,17017,7406,149,115,34,0,99.81211656,NoArch
c2eff324be4e679755818ac04f6a8dc8ef3fdc66,1,3,1,2,4,0,0,0,53,0,1,1,0,0,3,972,17,99,0,99,7467,0,7467,40,0,40,0,100,NoArch
22ac3203afc7c5017b266e25fdde0df16c294b54,2,1,5,4,6,0,0,0,54,1,1,2,0.650022422,0,3,973,18,164,0,164,10851,0,10851,54,0,54,0,100,NoArch
3207e8844add3d5ed6fb8e16c5e88f90f4ce5832,0,0,0,0,0,0,0,0,0,0,0,0,0,0,0,244,7,0,0,0,0,0,0,0,0,0,0,100,NoArch
3b0aae20f9709c5c72fe231edc3eff4a2675c47f,15,1181,1063,118,2244,3,0,3,16,205,1,12,2.994890714,0,2,974,18,202,0,202,18575,0,18575,111,0,111,0,99.96161376,NoArch
ad82b0bdebba6bafe2711620cef8ce7446c26a1b,2,6,6,0,12,0,0,0,4,812,1,2,1,0,3,975,18,17,0,17,437,0,437,2,0,2,0,100,NoArch
48f200d771704bb86dab8165835aac67b360590f,1,1,1,0,2,0,0,0,30,36,1,1,0,0,3,976,19,86,0,86,1661,0,1661,47,0,47,0,100,NoArch
01ad820abd4d4dd172c1c6b19bf5a93f828decfe,3,121,2,119,123,2,0,2,2,17,1,1,1.572756543,0,1,1722,26,12,0,12,854,0,854,9,0,9,1,99.98465669,NoArch
d0f40121063a8924bc02fd31b84d99fd06513573,4,29,18,11,47,0,0,0,30,237,2,4,1.84848241,0,3,977,20,197,0,197,8329,0,8329,53,0,53,0,100,NoArch
75a584de2b9ec8154222bd48c56568ef7041cd57,5,44,2,42,46,4,0,4,122,112,2,2,2.288434764,0,4,1723,18,772,0,772,39615,0,39615,550,0,550,1,100,NoArch
2246e1393aa56ff8411efabf2d49c3ef75ffdfec,3,83,6,77,89,1,0,1,14,525,1,2,0.925593874,0,1,1724,17,38,0,38,1651,0,1651,16,0,16,1,99.92328347,NoArch
0072de63525d9510df5482fa8d0cf2fe55fdcad2,2,3,2,1,5,0,0,0,15,0,1,2,0.970950594,0,1,1725,18,38,0,38,1616,0,1616,16,0,16,1,100,NoArch
006892d4d0cca3417fdf69d808b95b498373e73d,13,797,14,783,811,8,0,8,26,502,2,8,3.032174112,0,1,978,18,191,0,191,9091,0,9091,73,0,73,0,99.58953506,NoArch
966ca864ae768b2db5c06bbffd311c2234516867,0,0,0,0,0,0,0,0,0,0,0,0,0,0,0,979,19,0,0,0,0,0,0,0,0,0,0,100,NoArch
d89b292f4939f419ceb097de02aa2861476cf2e1,0,0,0,0,0,0,0,0,0,0,0,0,0,0,0,980,20,0,0,0,0,0,0,0,0,0,0,100,NoArch
da8972f3d4e92b18f464009ec27228cef0069da5,7,64,41,23,105,2,0,2,84,45,2,5,2.434836576,0,1,1726,17,321,0,321,12501,0,12501,103,0,103,0,99.58947207,NoArch
f6207d02c31b2351eee0ba206d80b84e8cc6cad7,1,0,1,1,1,0,0,0,71,0,1,1,0,0,3,1727,18,73,0,73,2689,0,2689,18,0,18,0,100,NoArch
e45f3e5b93c1f7b884e4899027c482a91f024db4,0,0,0,0,0,0,0,0,0,0,0,0,0,0,0,981,20,0,0,0,0,0,0,0,0,0,0,100,NoArch
40a2c68f02fc3f33ab3ca897879c91970382048b,5,397,15,382,412,1,0,1,7,659,2,4,1.759928652,0,2,982,21,105,0,105,5438,0,5438,30,0,30,0,99.93857022,NoArch
eff0fa9e3a08baf154a31eb9b05cecedf733c05d,1,0,0,0,0,1,0,1,3,1573,1,1,0,0,1,245,4,6,0,6,638,0,638,6,0,6,0,100,NoArch
a754fecdb8e5aec4b9a6fcfca34000b98bc60b01,2,7,4,3,11,0,0,0,2,26,1,1,0.845350937,0,1,1728,19,10,0,10,388,0,388,9,0,9,1,100,NoArch
cf915317e475c1648e01e8bae05d847503a5bc88,1,0,2,2,2,0,0,0,8,110,1,1,0,0,2,1729,20,12,0,12,262,0,262,7,0,7,0,100,NoArch
3ef21c829aa2c8272f87c2d9564011b95a976587,3,207,1,206,208,2,0,2,13,349,2,2,1.500299156,0,1,1730,21,62,0,62,2145,0,2145,19,0,19,1,99.97695764,NoArch
a8859f4744c980a2456414da10a00199773f6010,1,2,1,1,3,0,0,0,25,252,1,1,0,0,6,246,5,120,0,120,3768,0,3768,51,0,51,1,100,NoArch
1fc25ea2bcefd89cceb70ffe25b2f91b400ea232,12,558,25,533,583,6,0,6,98,493,2,6,3.069403861,0,1,983,22,346,0,346,15546,0,15546,112,0,112,0,99.49376798,NoArch
e6cb482393a5dc4e27d034f414772bbce4dcef57,1,3,4,1,7,0,0,0,3,304,1,1,0,0,2,885,6,66,0,66,2257,0,2257,11,0,11,1,100,NoArch
32fd2f750dfe84ea8ec7f6710e79017033283a97,1,1,1,0,2,0,0,0,14,174,1,1,0,0,3,886,7,39,0,39,1899,0,1899,22,0,22,1,100,NoArch
97afa21c40d0e3997100e107f33b523b297fa949,12,491,25,466,516,6,0,6,58,187,3,4,3.070511498,0,1,95,0,603,0,603,19524,0,19524,145,0,145,1,99.94640123,NoArch
e87f55351ed3520c505f83c41a52ff096933a571,1,22,18,4,40,0,0,0,8,1031,1,1,0,0,1,1731,20,93,0,93,2170,0,2170,71,0,71,0,100,NoArch
f42f6b6ba6037850bd200923b72fd3e716ccbbff,1,15,2,13,17,0,0,0,14,2,1,1,0,0,4,1732,21,57,0,57,1754,0,1754,13,0,13,1,100,NoArch
8bc55793927818a8b0de19f3851742d597214bc5,1,1,1,0,2,0,0,0,2,405,1,1,0,0,2,247,4,15,0,15,425,0,425,3,0,3,1,100,NoArch
536f0c957386061b1abfe0a46d772620f18fbf39,1,81,0,81,81,1,0,1,1,0,1,1,0,0,1,1733,21,8,0,8,398,0,398,4,0,4,1,99.99234772,NoArch
eec9d19c2bd836b28d60ec826f3ed0bd9e67e977,1,1,1,0,2,0,0,0,2,0,1,1,0,0,1,1734,22,8,0,8,398,0,398,4,0,4,1,100,NoArch
a72f421b25cc491be2b586ef41a7d15980407a58,1,22,6,16,28,0,0,0,3,0,1,1,0,0,1,1735,22,13,0,13,473,0,473,7,0,7,1,100,NoArch
1cb3c15b49d53d391e2e6ab403ba7ecea0954d29,18,699,881,182,1580,0,0,0,34,284,1,4,3.744676233,0,1,984,21,1022,0,1022,64040,0,64040,264,0,264,0,100,NoArch
f3497b00bd89e2978d605425c98f93fd310f442e,0,0,0,0,0,0,0,0,0,0,0,0,0,0,0,248,5,0,0,0,0,0,0,0,0,0,0,100,NoArch
8115b318225cb981a5fdc6fed824b15ab4e8c66d,2,4,4,0,8,0,0,0,12,20,1,1,1,0,2,985,22,27,0,27,1776,0,1776,14,0,14,0,100,NoArch
4d392f1bfee96317d42c1c9d82a1f06da5158b54,2,5,3,2,8,1,0,1,2,0,1,1,0.954434003,0,2,887,6,9,0,9,478,0,478,8,0,8,0,99.99617503,NoArch
ee1f819312ab69397fd155ea0e03e495776a73ce,5,70,43,27,113,2,0,2,15,1808,2,4,0.891587479,0,5,888,7,231,0,231,12205,0,12205,61,0,61,1,100,NoArch
818363f4a008615f40837caa78689515215e3a62,3,35,2,33,37,2,0,2,21,908,1,3,1.53630937,0,3,30,1,75,0,75,4176,0,4176,14,0,14,1,100,NoArch
c22742203f1669ed0b3a793f6539c9ffcba83a8b,1,9,0,9,9,1,0,1,2,356,1,1,0,0,2,1736,21,7,0,7,185,0,185,7,0,7,0,100,NoArch
120428ddcb6bf805735c2e192d9e789b92349166,1,37,0,37,37,1,0,1,12,221,1,1,0,0,2,1737,22,137,0,137,11834,0,11834,129,0,129,1,100,NoArch
1474bc3b866a44cdf9355d1753abf1e8705da5fe,2,3,13,10,16,0,0,0,36,147,1,1,0.811278124,0,1,1738,23,85,0,85,5968,0,5968,70,0,70,1,100,NoArch
4c343aa62ea777e6665de45dd950de343a3b5f85,4,28,11,17,39,0,0,0,35,8,2,2,1.731469938,0,2,986,22,266,0,266,8691,0,8691,31,0,31,0,100,NoArch
5db6a0382e3706afd9fa69277efc9f2fabbf1c44,1,4,1,3,5,0,0,0,8,122,1,1,0,0,2,31,2,16,0,16,909,0,909,6,0,6,0,100,NoArch
961e8a7eda058e8a9c082406fbf425f045f5c7fb,1,24,8,16,32,0,0,0,4,9,1,1,0,0,1,1739,24,17,0,17,540,0,540,10,0,10,0,100,NoArch
3b21a29437c3f0a3f7ee05a9fa7a1e79e35393a8,1,3,3,0,6,0,0,0,36,0,1,1,0,0,1,987,23,158,0,158,4260,0,4260,11,0,11,0,100,NoArch
629713a1e4219537286d9b329063bc507b2e5b43,3,40,47,7,87,0,0,0,37,2,1,1,1.20612619,0,1,988,24,424,0,424,12771,0,12771,42,0,42,0,100,NoArch
2b33266fd9dc0e0b323fff13ae7bfe2ef3e74135,2,14,1,13,15,1,0,1,123,39,2,2,0.918295834,0,6,1740,25,461,0,461,22303,0,22303,277,0,277,1,100,NoArch
9e27007895d269fb3e2c47e39f65286d29a7896b,0,0,0,0,0,0,0,0,0,0,0,0,0,0,0,1741,26,0,0,0,0,0,0,0,0,0,0,100,NoArch
10d86cfe1b44ea471a6ddade1ef97b0090b29fa5,3,109,0,109,109,3,0,3,15,144,2,3,1.043721828,0,1,889,8,121,0,121,3965,0,3965,28,0,28,1,99.9923524,NoArch
a5272604a833f7fb53514428ef04a3bc9a550e79,1,1,1,0,2,0,0,0,4,0,1,1,0,0,1,890,9,48,0,48,1014,0,1014,10,0,10,0,100,NoArch
9c7f0eef07382abebde1fd94834c7a51b38446a1,2,48,16,32,64,1,0,1,5,1,1,1,0.982316608,0,1,1742,25,19,0,19,606,0,606,12,0,12,1,99.99235357,NoArch
b5aff34f534d7b3cebb67771ad2a624cdfec617a,1,2,2,0,4,0,0,0,12,24,1,1,0,0,2,989,21,13,0,13,1192,0,1192,8,0,8,0,100,NoArch
cb178eec048c23f17a0f750075057f39b0dac53d,1,1,1,0,2,0,0,0,29,41,1,1,0,0,1,1743,24,247,0,247,7781,0,7781,158,0,158,1,100,NoArch
1d9c6ac9ad9a7f6e9984dc98adb1a3db16fc34ec,1,11,0,11,11,1,0,1,124,5,1,1,0,0,6,1744,25,249,0,249,15883,0,15883,211,0,211,1,100,NoArch
accafceb65e4b327e33f4c3cc87c88b438ac0389,2,158,0,158,158,2,0,2,1,0,1,1,0.990617497,0,1,249,5,8,0,8,671,0,671,6,0,6,1,99.98471065,NoArch
07413be9527ec0fde42a27517ee019b57dce7b82,1,0,2,2,2,0,0,0,2,0,1,1,0,0,1,250,6,3,0,3,394,0,394,3,0,3,1,100,NoArch
47d5bb448fbe8ab329cfd934e83fddff7086130c,4,127,16,111,143,2,0,2,16,335,1,4,1.609062789,0,1,1745,26,230,0,230,9824,0,9824,111,0,111,1,99.9694248,NoArch
ed20495cafc89cb6dd4dd23b4558e1a31777af58,0,0,0,0,0,0,0,0,0,0,0,0,0,0,0,891,6,0,0,0,0,0,0,0,0,0,1,100,NoArch
8507fd5476b758ecd9dc0e1e8971eff317a70a74,1,1,3,2,4,0,0,0,3,129,1,1,0,0,1,892,7,11,0,11,257,0,257,4,0,4,0,100,NoArch
ec9c41e4f2b8392c092a330171c147875a0b6caa,2,43,10,33,53,0,0,0,8,1644,1,1,0.997687576,0,2,893,8,62,0,62,1887,0,1887,12,0,12,1,100,NoArch
ba3ffb12d7c745e757c0c585268c5ae95e91afeb,4,7,7,0,14,0,0,0,45,278,1,2,1.664497779,0,6,894,9,279,0,279,22300,0,22300,142,0,142,1,100,NoArch
88d83b58ae3a3c586739696a96af010c0bdcbabe,1,1,1,0,2,0,0,0,83,101,1,1,0,0,5,1746,25,122,0,122,3894,0,3894,32,0,32,0,100,NoArch
0e7bb9cdbb5f335147e2f2f82881e66f7d2000cd,3,38,2,36,40,1,0,1,11,26,2,3,0.568995594,0,1,990,20,95,0,95,5440,0,5440,29,0,29,0,100,NoArch
e10f669c0085b797d2e8b25514405569f6f48924,3,247,69,178,316,2,0,2,15,6,2,2,1.574524388,0,4,1747,26,74,0,74,2461,0,2461,22,0,22,1,99.33393059,NoArch
820b2468e2b55bbd2ba8366121aa041c4cc6f38e,2,67,0,67,67,2,0,2,9,218,1,1,0.953048347,0,1,991,20,59,0,59,1741,0,1741,11,0,11,0,94.83183857,Arch
60fec6d7fddaa8324fc9652c6b7cbc100fa31822,3,55,10,45,65,0,0,0,12,153,2,2,1.385223472,0,4,1748,27,53,0,53,1932,0,1932,19,0,19,1,99.99647117,NoArch
12eda4f03c46507e78ffc78b0fb1b8f4b5726efa,4,50,8,42,58,1,0,1,38,14,2,2,1.603599604,0,2,992,21,443,0,443,14347,0,14347,50,0,50,0,100,NoArch
80eefb2ea8e8b2f885c78b479f96c451acf0d508,6,101,21,80,122,2,0,2,16,162,3,4,2.383585609,0,1,1749,27,122,0,122,4235,0,4235,44,0,44,1,99.98235585,NoArch
330d7a926a2bf1216429a3ac7b5843e3b65df215,2,10,12,2,22,0,0,0,4,646,1,2,1,0,1,993,19,8,0,8,1603,0,1603,4,0,4,0,100,NoArch
c2d10270fe89946a5da895333649180fa4bc0d71,0,0,0,0,0,0,0,0,0,0,0,0,0,0,0,994,20,0,0,0,0,0,0,0,0,0,0,100,NoArch
276c35ea9bca26339f009cb50b64e54bf563ea4d,3,4,0,4,4,3,0,3,31,376,1,1,1.5,0,2,995,20,81,0,81,4245,0,4245,21,0,21,1,100,NoArch
f9b4939d483b43eb72ad165f995e763ce6bc34d8,2,15,0,15,15,2,0,2,125,133,2,2,0.970950594,0,6,1750,28,411,0,411,21546,0,21546,242,0,242,0,100,NoArch
b4b9a010bb23059251400455afabddee15b46127,2,72,25,47,97,0,0,0,32,144,1,2,0.999309899,0,1,996,19,83,0,83,6130,0,6130,32,0,32,0,100,NoArch
0fdc68f4cd45715a57f0aabd1c8f33da556bf50e,3,62,10,52,72,1,0,1,24,150,1,3,1.111868527,0,2,1751,28,337,0,337,17599,0,17599,201,0,201,1,100,NoArch
a82d9b4fee15bf518c98d60d77b9b745cc5340bc,1,2,0,2,2,1,0,1,5,400,1,1,0,0,3,251,6,15,0,15,384,0,384,4,0,4,1,100,NoArch
c96aec03812bea5eb62fc646a9ec6e45b87e5d84,2,3,1,2,4,1,0,1,6,253,1,2,1,0,1,252,7,16,0,16,485,0,485,5,0,5,1,100,NoArch
14e827def5265daa5530821383c0cef7ab64c700,2,76,21,55,97,0,0,0,25,147,1,2,0.853193525,0,1,1752,29,152,0,152,5466,0,5466,56,0,56,0,100,NoArch
a4a5b4fb19362f33b5b1255aff61d9edf51628a1,1,2,0,2,2,1,0,1,13,641,1,1,0,0,3,997,19,1,0,1,358,0,358,1,0,1,0,100,NoArch
bd16e0eb9e286918e60bc7d92f9af5bd18f150cb,2,80,42,38,122,0,0,0,30,10,1,1,0.762554999,0,1,1753,29,414,0,414,13615,0,13615,188,0,188,1,100,NoArch
236926c28c55bad9b7ff6c596662e98f4ff8a6fc,1,46,7,39,53,0,0,0,7,1867,1,1,0,0,2,29,0,31,0,31,680,0,680,14,0,14,1,100,NoArch
b573206455f597317ff1c3cfefe09b410c92fbe9,2,8,0,8,8,2,0,2,7,2,1,2,0.811278124,0,1,253,8,17,0,17,531,0,531,5,0,5,1,100,NoArch
f560c627dbbc16b0d3a1f908ae2294571df692d6,2,83,77,6,160,0,0,0,3,2053,1,1,0.916198397,0,2,187,0,48,0,48,2108,0,2108,19,0,19,1,100,NoArch
d85ccc54e03f861c4906b71ed51c0d8dc740fc3c,1,1,1,0,2,0,0,0,8,0,1,1,0,0,3,254,9,16,0,16,400,0,400,4,0,4,1,100,NoArch
99a0584b7c483844cab66e231cb8ffa559ea7cf9,2,79,47,32,126,1,0,1,11,243,2,2,0.341153893,0,5,1754,26,128,0,128,3370,0,3370,46,0,46,0,100,NoArch
76e6684cbb46f3709dd4bfa02041267348cda6c8,0,0,0,0,0,0,0,0,0,0,0,0,0,0,0,998,14,0,0,0,0,0,0,0,0,0,0,100,NoArch
c689308e76f2821820566b728298f28bbbb979f9,2,24,135,111,159,0,0,0,2,1906,1,2,0.260452348,0,1,1755,24,21,0,21,876,0,876,16,0,16,1,90.94586736,Arch
18ae0bda4f44425072a634f48985e3bab2f71451,7,222,13,209,235,4,0,4,4,55,2,4,2.640341,0,2,188,1,62,0,62,3352,0,3352,30,0,30,1,99.97833708,NoArch
7b2020d6a9f1de574348ae979a5b8a80f5984a6d,4,73,10,63,83,1,0,1,5,0,2,3,1.626760806,0,1,189,2,51,0,51,2667,0,2667,23,0,23,1,99.98227998,NoArch
0ea2ba994fd1710253823ce84d26400ecca392ec,2,2,2,0,4,0,0,0,3,0,1,2,1,0,1,1756,25,21,0,21,876,0,876,16,0,16,1,100,NoArch
1d0b185a6767dd78f3d3dae6b0829004653016b9,2,25,4,21,29,1,0,1,17,24,1,2,0.999142104,0,1,1757,26,198,0,198,7938,0,7938,83,0,83,1,100,NoArch
a6bb6636d201878e35c49f728af5b67916a0b805,1,4,0,4,4,1,0,1,6,31,1,1,0,0,1,1758,27,20,0,20,1356,0,1356,16,0,16,0,100,NoArch
0ff365aa8bb9b7b2180dbf1afd17b4cc39020f40,2,18,0,18,18,2,0,2,37,15,1,1,1,0,1,1759,28,89,0,89,6077,0,6077,72,0,72,0,100,NoArch
12c910c524c8dd40149b087312763b3d2a4434b0,2,17,2,15,19,1,0,1,38,0,1,1,0.949452015,0,1,1760,25,89,0,89,6112,0,6112,72,0,72,0,100,NoArch
30a6fee4cefe0831c98d569f2eb7e8a3572ff8a8,5,83,31,52,114,2,0,2,121,102,1,2,2.014100217,0,3,999,15,824,0,824,27307,0,27307,123,0,123,0,100,NoArch
f1474c76a33a6d84d588b1138c9816480d3e66de,0,0,0,0,0,0,0,0,0,0,0,0,0,0,0,1000,16,0,0,0,0,0,0,0,0,0,0,100,NoArch
66a2078b2699a91116f84175bb0e9c5daddbbe99,15,52,29,23,81,6,0,6,18,466,1,10,3.308000118,0,1,1761,25,157,0,157,5638,0,5638,102,0,102,0,100,NoArch
14be17bff7941e358189b7058792ada4dbe3c7eb,4,144,17,127,161,3,0,3,11,0,1,1,1.8696298,0,1,1762,26,28,0,28,978,0,978,11,0,11,1,99.97834347,NoArch
d32f56ed2e717b3bd646b0bdf37d92da57fe8a4e,2,0,13,13,13,0,0,0,39,0,1,1,0.391243564,0,1,1763,27,89,0,89,6081,0,6081,72,0,72,0,100,NoArch
fa76f6a041ad486ab8afb21db37cc4a490c532e9,2,8,15,7,23,0,0,0,32,34,2,2,0.886540893,0,1,1764,28,135,0,135,4180,0,4180,65,0,65,0,100,NoArch
292bcb08bcb865a21929af20947beab032ff8889,2,7,0,7,7,2,0,2,11,157,2,2,0.985228136,0,1,1765,29,50,0,50,2124,0,2124,34,0,34,0,100,NoArch
6c6d8d64d1e7fa7cdd287ca68195e344a7641399,1,3,0,3,3,1,0,1,12,0,1,1,0,0,1,1766,30,22,0,22,1439,0,1439,17,0,17,0,100,NoArch
dd7889902be831becf1dc57b3639cc882d953267,1,5,6,1,11,0,0,0,13,23,1,1,0,0,5,32,2,24,0,24,817,0,817,7,0,7,1,99.99803142,NoArch
b2cc4b22eb064e6a0b242646cb50772f8edc55d2,7,217,48,169,265,1,0,1,26,362,2,5,2.47620323,0,2,1767,25,331,0,331,14655,0,14655,106,0,106,1,99.99015574,NoArch
6e351465962e069730f95d60d581181207a16ef3,5,634,33,601,667,4,0,4,12,17,1,3,1.98478555,0,1,1768,18,532,0,532,15795,0,15795,140,0,140,1,99.98031264,NoArch
b54be09de3abb65bb0bf43dbe3ed8aa346a47251,1,24,3,21,27,0,0,0,2,8,1,1,0,0,1,1769,18,69,0,69,1745,0,1745,26,0,26,1,100,NoArch
40ea3f77f1717088e5ba09c8710f69096d8021a0,0,0,0,0,0,0,0,0,0,0,0,0,0,0,0,1770,19,0,0,0,0,0,0,0,0,0,1,100,NoArch
97204118297f76cc48ee2acb154ad2761b725f19,3,20,3,17,23,1,0,1,50,299,2,2,1.509871837,0,5,1771,20,161,0,161,4802,0,4802,87,0,87,1,100,NoArch
5dc29c16f921f7dedf604bc082cf9069c11f120c,13,151,37,114,188,3,0,3,10,357,1,10,2.888809353,0,1,33,1,303,0,303,13159,0,13159,140,0,140,1,100,NoArch
31cf9c76f6d1be4b901bf06514a9717d936da2fb,1,2,0,2,2,1,0,1,4,5,1,1,0,0,2,34,2,6,0,6,859,0,859,6,0,6,0,100,NoArch
910f4e95785ce77628833a296b036b0374570e7f,2,41,16,25,57,0,0,0,3,12,1,2,0.219297308,0,1,1772,16,85,0,85,2317,0,2317,32,0,32,1,100,NoArch
5f321f0a2c77e84381f3489501bf7c0eee91b5a8,4,41,23,18,64,2,0,2,22,178,1,4,1.927164418,0,2,35,3,83,0,83,4415,0,4415,19,0,19,1,100,NoArch
1bf4c0cfb71ac140139e4cb1bf799a024f67e388,1,1,1,0,2,0,0,0,122,41,1,1,0,0,9,1001,0,378,0,378,13065,0,13065,51,0,51,1,100,NoArch
3a962e4c1a0a1ddc28ac4ee4216c10185b95601a,0,0,0,0,0,0,0,0,0,0,0,0,0,0,0,1002,1,0,0,0,0,0,0,0,0,0,0,100,NoArch
11b4bedd47eed11662f3021f6220a6bd4aa01fa8,1,9,2,7,11,0,0,0,2,432,1,1,0,0,1,895,0,12,0,12,335,0,335,11,0,11,0,100,NoArch
461f8d739a22fa5caaac3552244a693f4bde136b,0,0,0,0,0,0,0,0,0,0,0,0,0,0,0,896,1,0,0,0,0,0,0,0,0,0,0,100,NoArch
5753513fa33edafda8730b9e275865d777c2926c,0,0,0,0,0,0,0,0,0,0,0,0,0,0,0,897,2,0,0,0,0,0,0,0,0,0,0,100,NoArch
2e4a6787a49d4d92c929b686e12e264dda216539,1,6,6,0,12,0,0,0,9,83,1,1,0,0,2,36,3,16,0,16,901,0,901,6,0,6,0,100,NoArch
e92859b6279b233c0d4d81ccbc0210b55041eec5,4,131,0,131,131,4,0,4,4,291,1,4,1.275067499,0,1,37,4,52,0,52,3595,0,3595,32,0,32,1,99.99409519,NoArch
669aa67bbeb6a61186bc55a037af4b583af7746c,2,2,4,2,6,0,0,0,2,440,1,2,0.918295834,0,2,1003,2,31,0,31,980,0,980,20,0,20,0,100,NoArch
fb8061c8e24710869b963ab68bcfc55aee9ccc2d,5,18,54,36,72,0,0,0,42,1200,2,2,1.596950694,0,3,898,3,418,0,418,11806,0,11806,165,0,165,0,100,NoArch
0919edd76e4909f06216c546628a6f7d586479b2,3,2,36,34,38,0,1,1,8,1893,1,2,0.953013885,30,2,899,4,23,0,23,889,28,861,8,0,8,0,92.87836719,Arch
90ab5afdd29f5daef5af01453cdaa4f40ef099bf,4,0,302,302,302,0,4,4,3,2116,1,2,1.953369709,302,3,900,5,0,21,21,0,1079,1079,0,17,17,0,99.96804908,NoArch
b34e1daed084078d5cd5964fbf4741a9f9bffb12,1,0,20,20,20,0,0,0,6,440,1,1,0,0,1,901,6,620,0,620,16294,0,16294,138,0,138,0,100,NoArch
68b030840e7cadb726f3be292b8456444e815344,3,1,136,135,137,0,2,2,3,312,1,2,1.270577323,128,1,902,7,5,9,4,560,624,64,5,5,0,0,99.98082025,NoArch
2e0b830589e48bfc65501ad81065911b55186b42,1,0,25,25,25,0,0,0,3,270,1,1,0,0,1,903,8,31,0,31,1021,0,1021,9,0,9,0,99.91364698,NoArch
93ea0622ac97b3f0024b3217a76ba820a62eeb94,1,0,80,80,80,0,0,0,5,2118,1,1,0,79,3,904,9,0,13,13,0,282,282,0,7,7,0,99.99360082,NoArch
8eb0e72d3da0247bcea0a29fcdc29946c2fc4c73,5,2,83,81,85,0,0,0,22,511,2,5,1.972528086,38,4,905,10,175,2,173,5804,96,5708,94,1,93,0,99.9936,NoArch
883739a64f3ea76e146490d4c158314c75603285,1,0,2,2,2,0,0,0,4,0,1,1,0,0,2,906,11,5,0,5,550,0,550,5,0,5,0,100,NoArch
fcc19c3ddd36f3a55ae2675e2ebbf853cbd3d9f7,23,2,1412,1410,1414,0,4,4,99,873,2,8,3.407482097,1094,4,907,12,526,123,403,28884,6664,22220,156,47,109,0,92.44897317,Arch
90b98052841c12eaa4ba0d99013c7844f193fd32,1,1,1,0,2,0,0,0,2,442,1,1,0,0,1,908,13,46,0,46,1283,0,1283,10,0,10,0,100,NoArch
dd61195c15e6810e3edbe6547162e8d19bbf2f72,2,5,6,1,11,0,0,0,1,0,1,2,0.845350937,0,1,190,0,4,0,4,248,0,248,4,0,4,1,99.98145171,NoArch
888bfa0ee1fcb1c649b8af7291bad431bb3f9474,3,88,93,5,181,0,0,0,123,168,1,2,0.512573041,0,3,1004,3,528,0,528,18398,0,18398,80,0,80,0,100,NoArch
724bc946c756d792a210c9aa7c757094b744c57c,1,9,0,9,9,1,0,1,12,296,1,1,0,0,4,276,0,27,0,27,950,0,950,14,0,14,1,100,NoArch
473bbf66e023f79b888c1e61ae5331a70f75611b,0,0,0,0,0,0,0,0,0,0,0,0,0,0,0,334,0,0,0,0,0,0,0,0,0,0,1,100,NoArch
64a23c3044b21ce4acd722ceafae7997d0c3d841,5,6,49,43,55,0,1,1,7,143,1,3,1.168743124,43,2,38,5,128,4,124,4603,80,4523,51,4,47,0,99.94434998,NoArch
1797749c7e90d0b486d41d3ec78bb0540e26741d,14,94,122,28,216,3,0,3,36,338,1,2,2.84535683,0,1,1005,4,597,0,597,23773,0,23773,151,0,151,0,100,NoArch
cc56a00e51c3ab0379825481438d6cbfce326fe7,2,2,2,0,4,0,0,0,5,596,1,2,1,0,2,909,14,20,0,20,1585,0,1585,14,0,14,0,100,NoArch
cae03a033757d9d8c9a04153294702a4c69f6bf9,1,4,2,2,6,0,0,0,2,180,1,1,0,0,1,277,1,26,0,26,801,0,801,21,0,21,1,100,NoArch
8204370f128d8ecd6a647795863ce6bfab34d779,14,493,14,479,507,13,0,13,14,176,2,14,3.557209402,0,1,191,1,114,0,114,4767,0,4767,42,0,42,1,93.64814041,Arch
b7a111f5c5b69d4c5abdf56cf02a4454b54fcd17,0,0,0,0,0,0,0,0,0,0,0,0,0,0,0,1006,5,0,0,0,0,0,0,0,0,0,0,100,NoArch
3fbce4d5c18a1f34fa55d0c67ea730ac865bcd32,1,3,1,2,4,0,0,0,4,929,1,1,0,0,2,1007,6,2,0,2,184,0,184,1,0,1,0,100,NoArch
fa30f5300915756d6b0248e07118686a0fe6862b,3,475,15,460,490,2,0,2,27,17,2,2,1.133122611,0,1,1008,7,125,0,125,4933,0,4933,50,0,50,0,99.96988254,NoArch
01c79cfc4f335477d3460729782cc243d6f55196,2,6,14,8,20,0,0,0,55,119,1,2,1,0,3,1009,8,111,0,111,8463,0,8463,47,0,47,0,100,NoArch
99674f2f92a1fe03a7cf71d14a91b8b5ddf8f1e1,1,4,1,3,5,0,0,0,31,14,1,1,0,0,2,1010,9,69,0,69,2449,0,2449,15,0,15,0,100,NoArch
3120b9373f272d5f962c01c577bf08369c390dac,4,6,10,4,16,0,0,0,4,443,1,3,1.905639062,0,2,1011,10,234,0,234,5124,0,5124,90,0,90,0,100,NoArch
20767c663fc54d3f6d0219a5c347dbaa49939b67,1,6,2,4,8,0,0,0,10,155,1,1,0,0,4,39,6,45,0,45,1206,0,1206,7,0,7,1,100,NoArch
ac2f3f8c4f435ee71f5a7bc27f2d934a24628732,1,9,5,4,14,0,0,0,2,8,1,1,0,0,1,1012,11,76,0,76,2282,0,2282,25,0,25,0,100,NoArch
dda04a0d825d4fff19eda772b0b1d52c6b5978c2,4,71,129,58,200,0,0,0,43,126,1,4,1.669781794,0,2,1013,12,206,0,206,13602,0,13602,59,0,59,0,100,NoArch
e5d5f31bf34ebac25fdb010d45e60c3b2af30af9,1,2,2,0,4,0,0,0,4,33,1,1,0,0,1,1773,1,76,0,76,1907,0,1907,27,0,27,1,100,NoArch
8a1487cac6b6ec2b1bceb38a376f2900bac3a516,1,4,4,0,8,0,0,0,9,938,1,1,0,0,2,1774,2,32,0,32,1320,0,1320,17,0,17,0,100,NoArch
6c3730eccb1ac0b11076daa74ddb66790d7cf518,6,50,82,32,132,0,0,0,56,98,2,5,2.166952915,0,3,1014,13,216,0,216,15489,0,15489,86,0,86,0,100,NoArch
7cbdd5a0e11c285bebe3f42ecc03fb095b6a246f,6,20,20,0,40,1,0,1,39,117,3,6,2.363865122,0,2,1015,14,247,0,247,11794,0,11794,57,0,57,0,100,NoArch
f4f50aa0412bba172fd0f5ebb3e73eb6457c3812,1,51,9,42,60,0,0,0,1,0,1,1,0,0,1,1016,15,14,0,14,860,0,860,5,0,5,0,99.98327088,NoArch
756994d4acce00cac3b2ce64752c0a894eac69ad,1,4,3,1,7,0,0,0,2,0,1,1,0,0,1,1017,16,14,0,14,860,0,860,5,0,5,0,100,NoArch
885d450243af92377f0d83d90c7a9dae124a4d2d,4,26,6,20,32,3,0,3,124,77,2,2,1.260692411,0,1,1018,17,798,0,798,27425,0,27425,98,0,98,0,100,NoArch
b941cb80bc4f75ed3b02afa7c22e6847550cedc6,5,7,4,3,11,1,0,1,7,2741,1,1,2.299896391,0,2,1775,3,17,0,17,1286,0,1286,17,0,17,0,94.98980978,Arch
dae56b90c1de0dce1c00abe12108e364934eccf7,3,184,16,168,200,1,0,1,15,44,1,2,1.040251567,0,6,192,2,57,0,57,3218,0,3218,34,0,34,1,94.97910793,Arch
3c176a2d79def664f5fdc6546d7d313dc29c5fcf,1,2,2,0,4,0,0,0,14,206,1,1,0,0,2,1019,18,326,0,326,9912,0,9912,115,0,115,0,100,NoArch
eb1059d2e38366ca6fc849b0c150c90746675795,0,0,0,0,0,0,0,0,0,0,0,0,0,0,0,193,3,0,0,0,0,0,0,0,0,0,1,100,NoArch
83cfa2f1f181084a6aa3885a7b390cbe78ceeb1f,8,25,250,225,275,0,4,4,10,506,1,5,2.53248596,232,1,1020,19,16,15,1,2958,748,2210,8,10,2,0,99.92627593,NoArch
cbd81c955e5a1f6cef71fe53e088521cdf87c936,6,210,9,201,219,4,0,4,4,140,1,4,1.613215109,0,1,1021,20,24,0,24,3645,0,3645,12,0,12,0,94.98281085,Arch
b92558cba08bb94781174dcd6c9a025bdec519a2,2,28,8,20,36,0,0,0,3,1416,1,2,0.918295834,0,2,1022,21,10,0,10,668,0,668,4,0,4,0,100,NoArch
de4148e857e10ea136b0f1df66a111be949f244c,3,267,1,266,268,2,0,2,9,141,1,2,1.092902451,0,1,1023,22,14,0,14,2151,0,2151,6,0,6,0,99.99309392,NoArch
148b1857070b886e340d8a51044ecfe3492f7ff2,1,4,1,3,5,0,0,0,33,566,1,1,0,0,4,1776,3,362,0,362,11596,0,11596,110,0,110,1,100,NoArch
95fe72099788683e1b079f5827a6c5dc42b3099e,1,0,3,3,3,0,0,0,34,0,1,1,0,0,4,1777,4,361,0,361,11576,0,11576,110,0,110,1,100,NoArch
201d18540308db1fe993f3cbc97aa0edc10df4de,6,191,15,176,206,2,0,2,13,623,2,3,1.547416281,0,1,1024,23,307,0,307,12838,0,12838,91,0,91,0,100,NoArch
b3b3cf8869f39161f8521a33508154799bb54e8e,10,2,715,713,717,0,7,7,10,1234,1,5,2.925214351,598,2,1025,24,8,31,23,1666,3410,1744,4,18,14,0,94.96816805,Arch
4f2b18a5635913cdca3de6dbb247c09231c5c52f,6,44,26,18,70,0,0,0,18,680,1,4,2.171073506,0,1,1778,5,321,0,321,12058,0,12058,162,0,162,0,100,NoArch
60e756d2dc7507716d8b8fa2bfd9b99fc3e2ce73,0,0,0,0,0,0,0,0,0,0,0,0,0,0,0,1026,25,0,0,0,0,0,0,0,0,0,0,100,NoArch
c1d1ee37ab06452b28f972cf0a11f110afb228db,5,334,0,334,334,5,0,5,1,0,1,2,2.283108049,0,1,1027,26,21,0,21,1243,0,1243,11,0,11,0,99.97985901,NoArch
7c1daf4aa92d95e55de49bde07df097ea90ecf11,4,207,118,89,325,3,0,3,6,27,1,1,1.876473107,5,1,1779,6,22,19,3,814,559,255,17,12,5,1,99.96979967,NoArch
0e323f07f45515aa56ad5ca54bcd3db10b964b4e,8,61,14,47,75,1,0,1,100,268,2,7,2.168907435,0,3,1028,27,453,0,453,29754,0,29754,146,0,146,0,100,NoArch
a30397b0c7c4b7fc83e9a4bae71df342c194b60f,3,31,17,14,48,1,0,1,63,0,2,3,1.528368899,0,6,2953,10,155,0,155,8616,0,8616,109,0,109,0,100,NoArch
3f6354a222b4fb9860993b2bc1cbe45bea0fcd5a,0,0,0,0,0,0,0,0,0,0,0,0,0,0,0,1005,15,0,0,0,0,0,0,0,0,0,0,100,NoArch
4350cb303017560396417172cf6974bd0e5c7705,1,4,1,3,5,0,0,0,3,39,1,1,0,0,1,2954,10,16,0,16,739,0,739,7,0,7,1,100,NoArch
945e96af7c8b81c2e90e34858da4ed1680a84b3f,1,1,1,0,2,0,0,0,64,2,1,1,0,0,6,2955,11,109,0,109,7127,0,7127,94,0,94,0,100,NoArch
c340fdc1130871bae879a16e2826df857de44222,3,12,31,19,43,1,0,1,27,2462,1,3,1.231120014,0,2,1006,16,83,0,83,4182,0,4182,22,0,22,1,100,NoArch
14ca8b042f283572967a89c0e69a6430ca115858,0,0,0,0,0,0,0,0,0,0,0,0,0,0,0,1007,17,0,0,0,0,0,0,0,0,0,0,100,NoArch
cb87c3566c17176c0f8a749b7f27bd4c60e15b48,0,0,0,0,0,0,0,0,0,0,0,0,0,0,0,1008,18,0,0,0,0,0,0,0,0,0,0,100,NoArch
4cde671746112fe0710638fe92fdbee84e36ceec,0,0,0,0,0,0,0,0,0,0,0,0,0,0,0,1009,19,0,0,0,0,0,0,0,0,0,0,100,NoArch
6eed66b9d521f08700ae5fe3a8294dfc8f3cc021,2,11,5,6,16,0,0,0,28,2,1,2,0.543564443,0,2,1010,20,62,0,62,2302,0,2302,10,0,10,0,100,NoArch
4f1867eeeb13db3d38ec8e2171e4e9fee1602230,1,63,2,61,65,0,0,0,5,2289,1,1,0,0,2,1011,21,23,0,23,1881,0,1881,6,0,6,0,99.99727134,NoArch
2ab95c71774ccff7576010c1cadca8098858e836,0,0,0,0,0,0,0,0,0,0,0,0,0,0,0,1012,22,0,0,0,0,0,0,0,0,0,0,100,NoArch
dbc4b232b02f013a75ff19ded29de3c815b6e586,1,5,25,20,30,0,0,0,6,0,1,1,0,0,2,1013,23,23,0,23,1671,0,1671,6,0,6,0,99.99727134,NoArch
4eb7580294a726adfa602f51572766e323ad76f0,2,20,4,16,24,0,0,0,3,2954,1,1,0.954434003,0,1,2956,11,13,0,13,467,0,467,9,0,9,1,99.97543467,NoArch
00e228729cc412d1445969bc99041641a686dfc2,0,0,0,0,0,0,0,0,0,0,0,0,0,0,0,1014,24,0,0,0,0,0,0,0,0,0,0,100,NoArch
fb0ae745bc9dd004de375745bbb6ae4ca570cef9,0,0,0,0,0,0,0,0,0,0,0,0,0,0,0,1015,24,0,0,0,0,0,0,0,0,0,0,100,NoArch
6907457ca76fc750ba73226598806b70594dad57,0,0,0,0,0,0,0,0,0,0,0,0,0,0,0,1016,25,0,0,0,0,0,0,0,0,0,0,100,NoArch
74ee669b30b0db8f2139d93b224147c6304c7148,0,0,0,0,0,0,0,0,0,0,0,0,0,0,0,1017,26,0,0,0,0,0,0,0,0,0,0,100,NoArch
0efb6025d1713b8b1693c418921907c0f8906bc0,1,10,9,1,19,0,0,0,71,203,1,1,0,0,5,2957,1,209,0,209,6747,0,6747,49,0,49,1,100,NoArch
2d86f9012e82b844b9f5237ec0693ceead744e94,2,9,0,9,9,2,0,2,163,378,2,2,0.503258335,0,6,2958,2,577,0,577,25791,0,25791,304,0,304,1,100,NoArch
99f7aacbb9c68c33b3e6be7ca7a34c7b1b8feff8,1,13,6,7,19,0,0,0,7,2652,1,1,0,0,4,2959,3,14,0,14,353,0,353,7,0,7,1,100,NoArch
01c0f802bed165359edf68489552061f601ed95e,2,87,0,87,87,2,0,2,2,3538,1,2,0.929363626,0,2,2960,4,60,0,60,1887,0,1887,22,0,22,1,99.97816773,NoArch
35ad8ab2158b7250643506ed0cd58b1de17c094e,1,1,1,0,2,0,0,0,22,180,1,1,0,0,1,2961,4,63,0,63,1630,0,1630,32,0,32,1,100,NoArch
5408578e79a68c199f3430975dbca57fcc0283b6,0,0,0,0,0,0,0,0,0,0,0,0,0,0,0,1018,0,0,0,0,0,0,0,0,0,0,0,100,NoArch
0da72138e1c1f90c25059b70ca13f385ed6e880d,0,0,0,0,0,0,0,0,0,0,0,0,0,0,0,1019,1,0,0,0,0,0,0,0,0,0,0,100,NoArch
e558d0588ee0ef3d23ca71a42d7b6756f0bff3d2,0,0,0,0,0,0,0,0,0,0,0,0,0,0,0,1020,2,0,0,0,0,0,0,0,0,0,0,100,NoArch
f3cba4054a5cc102053af74235d0526e41b75892,1,1,1,0,2,0,0,0,50,96,1,1,0,0,2,2962,5,243,0,243,7235,0,7235,74,0,74,0,100,NoArch
9a0403a56e779dcf55b184397ab3383d34c37193,1,12,7,5,19,0,0,0,43,96,1,1,0,0,3,2963,6,193,0,193,6638,0,6638,36,0,36,0,100,NoArch
894f9382c8506e9d6d6598ec2c1567f9bc13a781,2,15,3,12,18,1,0,1,8,1072,1,2,0.99107606,0,2,2964,6,31,0,31,939,0,939,16,0,16,1,100,NoArch
0da90b1b952ead337619d09d5ebe06a7a67397fb,2,44,7,37,51,0,0,0,9,0,1,2,0.238684511,0,2,2965,7,36,0,36,1125,0,1125,16,0,16,1,100,NoArch
e04b405ebae041b3575abb3c22e4cfd8856e346d,2,166,3,163,169,1,0,1,23,18,1,2,0.248765916,0,1,2966,8,67,0,67,2455,0,2455,36,0,36,1,99.99454476,NoArch
9f5d47d905ff6bca5e60a0fb05e869cb32037dcc,1,21,10,11,31,0,0,0,5,2953,1,1,0,0,3,2967,5,8,0,8,390,0,390,6,0,6,1,100,NoArch
a565df85af30e37e06e076bbfe767cde7df0f24b,0,0,0,0,0,0,0,0,0,0,0,0,0,0,0,1021,3,0,0,0,0,0,0,0,0,0,0,100,NoArch
a4172fa1a7e926cbeb4ba3a21268f48035c0deb4,2,9,9,0,18,0,0,0,85,626,1,1,0.99107606,0,4,1022,4,370,0,370,11411,0,11411,31,0,31,0,100,NoArch
3412672d3a66e83fec5da5307b0e1233c9e4969b,0,0,0,0,0,0,0,0,0,0,0,0,0,0,0,1023,5,0,0,0,0,0,0,0,0,0,0,100,NoArch
8ec192c8a3d235643d9f4f3d83517402a5b80e07,0,0,0,0,0,0,0,0,0,0,0,0,0,0,0,1024,6,0,0,0,0,0,0,0,0,0,0,100,NoArch
569678ec8cfeb6e6fe58f9fb5431272b10fd4ec6,0,0,0,0,0,0,0,0,0,0,0,0,0,0,0,1025,7,0,0,0,0,0,0,0,0,0,0,100,NoArch
9d4fb9a8aefddb7d6ba6c4520e7049c2c13bc6e6,2,42,30,12,72,0,0,0,21,3083,1,2,0.99107606,0,4,14,0,102,0,102,3693,0,3693,37,0,37,0,100,NoArch
44f8f26be904fd9923754496dcc42630b167145b,0,0,0,0,0,0,0,0,0,0,0,0,0,0,0,1026,8,0,0,0,0,0,0,0,0,0,0,100,NoArch
8ae768d769543c82c834ee9f9df883c9b5bbe56b,1,1,0,1,1,1,0,1,7,3047,1,1,0,0,1,2968,6,12,0,12,592,0,592,6,0,6,0,100,NoArch
8f1f537c7d764c5315935ba7ba8b4a6b44ec1b6b,2,33,11,22,44,0,0,0,86,4,1,1,0.359101626,0,4,1027,9,355,0,355,11612,0,11612,28,0,28,1,100,NoArch
24bbc950551976426d5216406f4b2be6d12911eb,0,0,0,0,0,0,0,0,0,0,0,0,0,0,0,1028,10,0,0,0,0,0,0,0,0,0,0,100,NoArch
8e4970d931ae72f92c54d170a844b37137b8fda6,3,47,33,14,80,1,0,1,87,1099,1,3,1.309311544,0,4,2969,7,259,0,259,9282,0,9282,54,0,54,0,99.97000518,NoArch
a6e0532e4112f2b5ffc8c11b97e000ef11da41c7,1,41,0,41,41,1,0,1,1,0,1,1,0,0,1,2970,8,2,0,2,142,0,142,2,0,2,1,99.99454803,NoArch
6499e0d577d734abcc045ca0f80ff983e9d31ab6,1,57,72,15,129,0,0,0,164,62,1,1,0,0,6,2971,9,270,0,270,17769,0,17769,230,0,230,1,100,NoArch
0acf42dd9b4f95cb1289553947b64821c5630d1e,1,1,1,0,2,0,0,0,51,30,1,1,0,0,2,2972,10,243,0,243,7235,0,7235,74,0,74,0,100,NoArch
f2a2e5af8ee713bd8725ce323a2a1e24a494279c,0,0,0,0,0,0,0,0,0,0,0,0,0,0,0,1030,9,0,0,0,0,0,0,0,0,0,0,100,NoArch
33e428428934a25fdad3e8a95eca42e4a96316cc,1,1,1,0,2,0,0,0,165,3,1,1,0,0,6,2973,11,270,0,270,17771,0,17771,230,0,230,0,100,NoArch
062eea9c61f9da913fd628b7ffe0984a435b8005,1,35,0,35,35,1,0,1,52,3,1,1,0,0,2,2974,12,250,0,250,7445,0,7445,77,0,77,1,100,NoArch
53e9b582511bf38cc9c18958636290f7004fd9d9,2,9,0,9,9,2,0,2,3,62,1,2,0.764204507,0,3,0,0,61,0,61,1949,0,1949,23,0,23,1,99.94823876,NoArch
bbe8829c65cbaf1b8f8fe761d4cb2b5c285f6dd1,3,31,12,19,43,0,0,0,166,1,2,2,1.400524001,0,6,2975,13,527,0,527,25477,0,25477,310,0,310,1,100,NoArch
2eff02422ab7d9fd336f44944f624ec35adec18d,1,4,0,4,4,1,0,1,94,919,1,1,0,0,3,2976,14,100,0,100,3170,0,3170,22,0,22,1,100,NoArch
3ac64704755c44d30d76c9244bf3a0fed4191950,1,4,3,1,7,0,0,0,8,5358,1,1,0,0,3,0,0,54,0,54,1569,0,1569,19,0,19,0,100,NoArch
f64b596f272ff28507d58c83a7a545018a73a14c,0,0,0,0,0,0,0,0,0,0,0,0,0,0,0,1031,10,0,0,0,0,0,0,0,0,0,0,100,NoArch
35a5abe046c43c0ba0b09e3a9435ad301dfdcdca,0,0,0,0,0,0,0,0,0,0,0,0,0,0,0,1032,11,0,0,0,0,0,0,0,0,0,0,100,NoArch
f73d3433010059abe144cdb73f9276dc2da14221,1,1,0,1,1,1,0,1,10,819,1,1,0,0,6,1033,12,60,0,60,2458,0,2458,23,0,23,0,100,NoArch
175c8e44b44c16eb6eae7d3b33d9a50aafc25da6,0,0,0,0,0,0,0,0,0,0,0,0,0,0,0,1034,13,0,0,0,0,0,0,0,0,0,0,100,NoArch
29a80a05c55cbb7ac543d3cfaae5357e5ae7e410,0,0,0,0,0,0,0,0,0,0,0,0,0,0,0,1035,14,0,0,0,0,0,0,0,0,0,0,100,NoArch
72a7c9320b3144fdf48a87cfee0ad5eb730acfdf,0,0,0,0,0,0,0,0,0,0,0,0,0,0,0,1036,15,0,0,0,0,0,0,0,0,0,0,100,NoArch
bbc08254a444157746b46100d5bc02fddf2058bd,0,0,0,0,0,0,0,0,0,0,0,0,0,0,0,1037,16,0,0,0,0,0,0,0,0,0,0,100,NoArch
aef4429f41231c9315e7090029385f9b2511067e,2,21,1,20,22,1,0,1,169,203,2,2,0.439496987,0,11,1038,17,889,0,889,26224,0,26224,131,0,131,1,100,NoArch
3f2c0530d9050793c29ae6b40254f582db10dbae,1,1,6,5,7,0,0,0,170,0,1,1,0,0,11,1039,18,414,0,414,13494,0,13494,54,0,54,0,100,NoArch
26816e94aaac6214659e2e7434ce930e16544b93,0,0,0,0,0,0,0,0,0,0,0,0,0,0,0,1040,19,0,0,0,0,0,0,0,0,0,0,100,NoArch
d39f9e091a3015e45838e2a25c6bc584d27099c8,0,0,0,0,0,0,0,0,0,0,0,0,0,0,0,1041,19,0,0,0,0,0,0,0,0,0,0,100,NoArch
79e414cc3c63f217819d99ca9f2174be05d98610,0,0,0,0,0,0,0,0,0,0,0,0,0,0,0,1042,20,0,0,0,0,0,0,0,0,0,0,100,NoArch
9ee64ce808feda92fc907cbed15b9d8807731ed0,0,0,0,0,0,0,0,0,0,0,0,0,0,0,0,1043,16,0,0,0,0,0,0,0,0,0,0,100,NoArch
0015ef059211ec485921ba17745d867791aecf49,0,0,0,0,0,0,0,0,0,0,0,0,0,0,0,1044,17,0,0,0,0,0,0,0,0,0,0,100,NoArch
1f5251c201d83a007917cb38ef14f0056bb02f6c,0,0,0,0,0,0,0,0,0,0,0,0,0,0,0,1045,14,0,0,0,0,0,0,0,0,0,0,100,NoArch
2389837fa4145b3d1b71ebeb5131260829b57609,0,0,0,0,0,0,0,0,0,0,0,0,0,0,0,1046,15,0,0,0,0,0,0,0,0,0,0,100,NoArch
45d41dc1c727de8b637267ca9b1c2a05e4ac2215,3,10,2,8,12,1,0,1,194,489,1,3,1.251629167,0,2,2977,4,750,0,750,22553,0,22553,214,0,214,0,100,NoArch
ff964691b6ef3dacfa437ac4ff5d5224839de2a1,0,0,0,0,0,0,0,0,0,0,0,0,0,0,0,1047,16,0,0,0,0,0,0,0,0,0,0,100,NoArch
cd9cd00370e2c4d74b0241ba427a4d5a35381f1b,0,0,0,0,0,0,0,0,0,0,0,0,0,0,0,1048,17,0,0,0,0,0,0,0,0,0,0,100,NoArch
d6ed764c75bdb76716519f585ecd4c77f38da99b,1,1,0,1,1,1,0,1,15,21,1,1,0,0,6,0,0,513,0,513,12663,0,12663,115,0,115,1,100,NoArch
707f3514eed2bb9263848205fd4032b1377cd1d8,0,0,0,0,0,0,0,0,0,0,0,0,0,0,0,1416,0,0,0,0,0,0,0,0,0,0,0,100,NoArch
e45b682621d18077bc572c4c54017c51eef9cc98,0,0,0,0,0,0,0,0,0,0,0,0,0,0,0,1417,1,0,0,0,0,0,0,0,0,0,0,100,NoArch
495ab0ae875c32c9487c927d1a2935f4b00293d5,1,1,0,1,1,1,0,1,2,2184,1,1,0,0,2,1418,2,12,0,12,505,0,505,10,0,10,0,100,NoArch
c98cb3181ae1153c37240a851aefe8e4f3a40ae9,0,0,0,0,0,0,0,0,0,0,0,0,0,0,0,1419,3,0,0,0,0,0,0,0,0,0,0,100,NoArch
1a1499e912d398dff28775973bc2212228f63a2c,0,0,0,0,0,0,0,0,0,0,0,0,0,0,0,1420,4,0,0,0,0,0,0,0,0,0,0,100,NoArch
8921296ff8e6f3694460e0b3153cf3625e2357a7,2,48,14,34,62,0,0,0,35,178,1,2,0.205592508,0,2,2978,1,138,0,138,4701,0,4701,32,0,32,1,100,NoArch
c309667e62e383d1adbbb3875f19a85e9c504809,0,0,0,0,0,0,0,0,0,0,0,0,0,0,0,1049,13,0,0,0,0,0,0,0,0,0,0,100,NoArch
00e39a59335209de69699865729da2135618384f,0,0,0,0,0,0,0,0,0,0,0,0,0,0,0,1050,14,0,0,0,0,0,0,0,0,0,0,100,NoArch
df83183e5278887b2e74cf243667e357e128e9bd,15,115,35,80,150,1,0,1,9,2350,2,15,3.580214584,0,3,6,0,119,0,119,4520,0,4520,71,0,71,1,99.97822063,NoArch
cd83ad9d117cd981823d6a5ac539e89901fff7a0,3,20,7,13,27,0,0,0,10,542,2,3,1.159511549,0,3,7,1,47,0,47,1472,0,1472,19,0,19,1,100,NoArch
3e7e78b89d78b63fa16033bc0b44111b55f109d4,0,0,0,0,0,0,0,0,0,0,0,0,0,0,0,1051,8,0,0,0,0,0,0,0,0,0,0,100,NoArch
9ef8ec4406629feb0b7c2b61b6ab50a44279068d,0,0,0,0,0,0,0,0,0,0,0,0,0,0,0,1052,9,0,0,0,0,0,0,0,0,0,0,100,NoArch
ef0a8e86d991f758064a3c4a0bcb55c39b18dbf6,1,3,1,2,4,0,0,0,6,3077,1,1,0,0,1,2979,2,28,0,28,759,0,759,21,0,21,0,100,NoArch
317e76ee6d5cfcbcc9479a83d2577f417beac1c6,1,2,1,1,3,0,0,0,34,1424,1,1,0,0,3,2980,3,55,0,55,2116,0,2116,21,0,21,1,100,NoArch
4a89a4870d0b6c28b8d5db1c1b186c8a56779a53,2,3,4,1,7,0,0,0,35,1525,1,2,0.985228136,0,3,2981,4,89,0,89,3195,0,3195,41,0,41,2,100,NoArch
1338469f7d25cfcda75b547c68bed95bd97903ac,3,6,6,0,12,0,0,0,5,1482,1,2,1.584962501,0,2,2982,3,41,0,41,1725,0,1725,25,0,25,0,100,NoArch
a25fda846ac944a14b4f31569bb9158936778643,1,4,2,2,6,0,0,0,55,104,1,1,0,0,3,0,0,254,0,254,7492,0,7492,77,0,77,1,100,NoArch
1b06c1efacf751ed6d4a5214ecc297e3249e72a5,1,6,4,2,10,0,0,0,56,2,1,1,0,0,3,2983,1,255,0,255,7512,0,7512,77,0,77,0,100,NoArch
c936c75c75f068d000a986a6e856e3ecdd3b26ee,0,0,0,0,0,0,0,0,0,0,0,0,0,0,0,1053,0,0,0,0,0,0,0,0,0,0,0,100,NoArch
30fa26453bfac7503049c710bf419e3a1a426a56,0,0,0,0,0,0,0,0,0,0,0,0,0,0,0,1054,1,0,0,0,0,0,0,0,0,0,0,100,NoArch
80d2c4f77dd74bcb51fed52a9457c055ba6289b2,0,0,0,0,0,0,0,0,0,0,0,0,0,0,0,1055,2,0,0,0,0,0,0,0,0,0,0,100,NoArch
ca343e15de6ef5f48059f3db4ac6f22faf7c4648,0,0,0,0,0,0,0,0,0,0,0,0,0,0,0,1056,3,0,0,0,0,0,0,0,0,0,0,100,NoArch
a3811331d5dbd59a936094604ed809192a09e820,1,1,1,0,2,0,0,0,9,2405,1,1,0,0,2,2984,1,210,0,210,6677,0,6677,57,0,57,0,100,NoArch
46b385f984f573d5dabfbe1bd6fa84f8af628484,0,0,0,0,0,0,0,0,0,0,0,0,0,0,0,1057,4,0,0,0,0,0,0,0,0,0,0,100,NoArch
f7147268180de1d6881b154967c2d8fcaf9362c7,1,5,1,4,6,0,0,0,4,3167,1,1,0,0,3,0,0,38,0,38,1123,0,1123,4,0,4,1,100,NoArch
8d8ae785a03dca94ac47fb0cb109c0d8a674f8ed,0,0,0,0,0,0,0,0,0,0,0,0,0,0,0,1058,5,0,0,0,0,0,0,0,0,0,0,100,NoArch
d9a86780898c9d345dc07c614f247313bc1f4380,0,0,0,0,0,0,0,0,0,0,0,0,0,0,0,1059,6,0,0,0,0,0,0,0,0,0,0,100,NoArch
2f89d0013c63de069fa9fffcde959fa8b141d81d,2,79,3,76,82,1,0,1,7,1108,1,1,1,0,3,1060,7,11,0,11,1050,0,1050,9,0,9,0,99.99183407,NoArch
7554fa13a32ab484088ed80bca8ac29610884c59,2,67,14,53,81,1,0,1,49,467,2,2,0.994605981,0,3,1061,8,91,0,91,3911,0,3911,25,0,25,1,99.99183629,NoArch
8a43e828c510e2fbb9b6bf3fabcb8e2f9027beaf,0,0,0,0,0,0,0,0,0,0,0,0,0,0,0,1062,9,0,0,0,0,0,0,0,0,0,0,100,NoArch
293a340d437fb7806f0e2c3392a1df9caaf1eb87,2,2,2,0,4,0,0,0,10,1297,1,1,1,0,3,0,0,108,0,108,3019,0,3019,29,0,29,0,100,NoArch
3ac70240b830176c64ff9d6086eaf62ea3fcb27c,0,0,0,0,0,0,0,0,0,0,0,0,0,0,0,1063,10,0,0,0,0,0,0,0,0,0,0,100,NoArch
f953e3b39c8810dc12c057aa1e818687e8dfb633,1,2,0,2,2,1,0,1,12,3435,1,1,0,0,3,1064,11,23,0,23,2066,0,2066,13,0,13,0,100,NoArch
28c2fafa0f97f5f5593a8743ff8fdeba7e966c69,0,0,0,0,0,0,0,0,0,0,0,0,0,0,0,1065,12,0,0,0,0,0,0,0,0,0,0,100,NoArch
c2f005d11a4b2c0a226e5bf9cf9b2cdce7171aaf,0,0,0,0,0,0,0,0,0,0,0,0,0,0,0,1066,13,0,0,0,0,0,0,0,0,0,0,100,NoArch
fa1d5e7c1aba881900f15829b585c2bfa869b9b5,0,0,0,0,0,0,0,0,0,0,0,0,0,0,0,1067,14,0,0,0,0,0,0,0,0,0,0,100,NoArch
32b2dda26231f3776b1fc87deb1188a324aac50b,0,0,0,0,0,0,0,0,0,0,0,0,0,0,0,1068,15,0,0,0,0,0,0,0,0,0,0,100,NoArch
e0d304a3be2244a57d64e369aa4271124bcb6f97,0,0,0,0,0,0,0,0,0,0,0,0,0,0,0,2985,2,0,0,0,0,0,0,0,0,0,0,100,NoArch
19f69a87bd870c80a86df812180a2d6075881af8,1,5,0,5,5,1,0,1,12,297,1,1,0,0,5,2986,3,39,0,39,1242,0,1242,12,0,12,1,100,NoArch
c793cdfbff7ff1b1c434847c3b12e645bc06864f,0,0,0,0,0,0,0,0,0,0,0,0,0,0,0,1069,16,0,0,0,0,0,0,0,0,0,0,100,NoArch
e2ebb8dc1dcfc50633358dec7dbbe6b5bbb076d4,0,0,0,0,0,0,0,0,0,0,0,0,0,0,0,1070,17,0,0,0,0,0,0,0,0,0,0,100,NoArch
c9e31ce9c4596680d513723643d171f3d081d2d6,2,105,2,103,107,1,0,1,12,601,1,2,0.447907859,0,1,2987,4,97,0,97,2571,0,2571,30,0,30,1,99.98640048,NoArch
322a0b36c26cc6f996f446d4494ebd0674b1fee0,1,2,2,0,4,0,0,0,5,2040,1,1,0,0,2,1071,18,19,0,19,655,0,655,11,0,11,1,100,NoArch
206a1ed36b8d3d1b0b03d93643db4962318ffd5a,2,24,3,21,27,0,0,0,92,2631,1,2,0.99107606,0,4,2988,4,170,0,170,5189,0,5189,62,0,62,1,100,NoArch
cb6447bffd517aeb3ea01de6b5484542ad5adb71,2,23,6,17,29,0,0,0,93,0,1,2,0.999142104,0,4,2989,5,172,0,172,5243,0,5243,62,0,62,1,100,NoArch
b83bad92e6b53c0d081de1ac78e5c393879e3291,0,0,0,0,0,0,0,0,0,0,0,0,0,0,0,1072,19,0,0,0,0,0,0,0,0,0,0,100,NoArch
e97d225d2cf0af31bb06e6af81a5dca6925da003,1,13,13,0,26,0,0,0,3,1266,1,1,0,0,2,2990,6,90,0,90,2116,0,2116,32,0,32,1,100,NoArch
20582279cdbf74fbcb16197052b2cf38f32b469e,3,10,5,5,15,0,0,0,11,206,2,3,1.456564762,0,6,1073,20,95,0,95,4743,0,4743,34,0,34,0,100,NoArch
