NMF,TotalAddLines,TotalDeleteLines,LC,LC_1,FileAdd,FileDelete,NAD,NUC,AGE,NMS,NMD,Entropy ,MLMF,NDVE,EXP,REXP,CommitComplexity,LastCommitComplexity,CFC,CommitTokenCount,LastCommitTokenCount,NCC,CommitMethodNum,LastCommitMethodNum,NFC,NIR,a2a,Tag
0,0,0,0,0,0,0,0,0,0,0,0,0.0,0,0,538,22,0,0,0,0,0,0,0,0,0,1,100.0,NoArch
1,6,1,5,7,0,0,0,4,1995,1,1,0.0,0,3,10,0,18,0,18,752,0,752,10,0,10,1,100.0,NoArch
2,4,2,2,6,0,0,0,9,75,2,2,0.918295834,589,1,325,13,94,93,1,4051,4033,18,20,20,0,0,100.0,NoArch
1,1,2,1,3,0,0,0,11,1,1,1,0.0,0,5,1720,36,17,0,17,1056,0,1056,17,0,17,0,100.0,NoArch
11,301,340,39,641,0,0,0,31,318,3,8,2.151162803,0,3,738,22,416,0,416,20545,0,20545,118,0,118,0,100.0,NoArch
1,17,21,4,38,0,0,0,75,9,1,1,0.0,0,4,541,2,135,0,135,5478,0,5478,24,0,24,0,100.0,NoArch
0,0,0,0,0,0,0,0,0,0,0,0,0.0,0,0,477,14,0,0,0,0,0,0,0,0,0,0,100.0,NoArch
2,0,3,3,3,0,0,0,14,2,1,2,0.918295834,1970,2,312,10,227,227,0,14105,14120,15,80,80,0,0,100.0,NoArch
14,569,178,391,747,5,0,5,11,42,2,5,3.539252206,1995,2,45,11,223,185,38,11227,9885,1342,157,125,32,0,99.92305103,NoArch
1,3,1,2,4,0,0,0,6,480,1,1,0.0,0,2,59,4,311,0,311,9477,0,9477,109,0,109,0,100.0,NoArch
4,172,36,136,208,1,0,1,16,0,1,3,1.298164999,0,1,556,21,214,0,214,7972,0,7972,75,0,75,0,100.0,NoArch
0,0,0,0,0,0,0,0,0,0,0,0,0.0,0,0,591,31,0,0,0,0,0,0,0,0,0,0,100.0,NoArch
2,72,25,47,97,0,0,0,32,144,1,2,0.999309899,0,1,996,19,83,0,83,6130,0,6130,32,0,32,0,100.0,NoArch
4,225,47,178,272,1,0,1,136,657,1,3,1.465744277,0,2,1394,16,447,0,447,17453,0,17453,153,0,153,1,100.0,NoArch
1,3,4,1,7,0,0,0,16,0,1,1,0.0,0,4,680,4,46,0,46,1131,0,1131,17,0,17,0,100.0,NoArch
1,1,0,1,1,1,0,1,5,401,1,1,0.0,0,4,245,3,56,0,56,2915,0,2915,18,0,18,1,100.0,NoArch
2,9,0,9,9,2,0,2,5,2641,1,1,0.918295834,0,2,243,1,23,0,23,566,0,566,13,0,13,1,100.0,NoArch
0,0,0,0,0,0,0,0,0,0,0,0,0.0,0,0,296,7,0,0,0,0,0,0,0,0,0,0,100.0,NoArch
0,0,0,0,0,0,0,0,0,0,0,0,0.0,0,0,654,21,0,0,0,0,0,0,0,0,0,0,100.0,NoArch
1,35,0,35,35,1,0,1,8,30,1,1,0.0,0,5,12,3,30,0,30,3166,0,3166,16,0,16,1,100.0,NoArch
4,200,8,192,208,3,0,3,10,0,2,2,1.786218075,242,1,28,3,55,40,15,1988,1276,712,25,17,8,1,99.96668147,NoArch
9,324,54,270,378,6,0,6,51,115,2,4,3.106420088,0,1,615,8,984,0,984,33395,0,33395,252,0,252,1,100.0,NoArch
3,6,3,3,9,0,0,0,6,265,2,3,1.435520504,391,1,909,39,60,59,1,2047,2011,36,17,17,0,0,100.0,NoArch
9,180,31,149,211,0,0,0,37,41,2,7,2.254787896,4328,2,125,11,511,491,20,27265,26289,976,251,243,8,0,100.0,NoArch
16,612,360,252,972,1,0,1,18,304,3,6,1.972604749,3435,1,462,33,555,502,53,21037,19572,1465,166,161,5,0,99.93544917,NoArch
1,1,1,0,2,0,0,0,4,366,1,1,0.0,191,3,5,0,22,22,0,815,814,1,7,7,0,0,100.0,NoArch
1,1,0,1,1,1,0,1,71,29,1,1,0.0,0,8,639,19,144,0,144,4506,0,4506,53,0,53,0,100.0,NoArch
1,24,13,11,37,0,0,0,3,740,1,1,0.0,235,1,357,13,44,39,5,1564,1479,85,8,7,1,0,100.0,NoArch
1,12,8,4,20,0,0,0,64,14,1,1,0.0,0,8,612,5,245,0,245,8606,0,8606,55,0,55,1,100.0,NoArch
1,1,0,1,1,0,0,0,6,178,1,1,0.0,147,2,141,15,10,10,0,680,674,6,10,10,0,0,100.0,NoArch
3,4,4,0,8,0,0,0,12,60,1,3,1.5,1085,2,65,6,158,158,0,5401,5401,0,67,67,0,0,100.0,NoArch
2,2,2,0,4,0,0,0,15,0,1,1,1.0,0,1,23,4,129,0,129,3518,0,3518,41,0,41,0,100.0,NoArch
0,0,0,0,0,0,0,0,0,0,0,0,0.0,0,0,1065,12,0,0,0,0,0,0,0,0,0,0,100.0,NoArch
2,44,7,37,51,0,0,0,9,0,1,2,0.238684511,0,2,2965,7,36,0,36,1125,0,1125,16,0,16,1,100.0,NoArch
0,0,0,0,0,0,0,0,0,0,0,0,0.0,0,0,101,0,0,0,0,0,0,0,0,0,0,1,100.0,NoArch
1,13,11,2,24,0,0,0,11,8,1,1,0.0,0,4,501,12,66,0,66,2002,0,2002,22,0,22,0,100.0,NoArch
8,159,52,107,211,0,0,0,36,125,2,5,2.539543005,3355,2,122,8,480,463,17,18187,17329,858,247,240,7,0,100.0,NoArch
4,0,302,302,302,0,4,4,3,2116,1,2,1.953369709,302,3,900,5,0,21,21,0,1079,1079,0,17,17,0,99.96804908,NoArch
7,326,103,223,429,1,0,1,11,520,1,4,1.683864888,1322,1,428,33,237,207,30,8600,7288,1312,98,90,8,0,99.63261331,NoArch
10,44,46,2,90,0,0,0,14,45,1,5,2.790348342,0,5,9,3,618,0,618,31183,0,31183,255,0,255,0,100.0,NoArch
2,13,4,9,17,1,0,1,13,650,2,2,0.522559375,0,1,567,12,24,0,24,1534,0,1534,11,0,11,0,100.0,NoArch
3,5,5,0,10,0,0,0,6,15,1,1,1.570950594,0,1,636,16,37,0,37,8141,0,8141,33,0,33,0,100.0,NoArch
0,0,0,0,0,0,0,0,0,0,0,0,0.0,0,0,633,13,0,0,0,0,0,0,0,0,0,0,100.0,NoArch
1,1,0,1,1,0,0,0,7,0,1,1,0.0,190,2,47,3,24,24,0,893,885,8,5,5,0,0,100.0,NoArch
11,26,407,381,433,0,1,1,10,325,3,7,1.977710829,3606,2,122,18,534,593,59,16274,17991,1717,191,217,26,0,99.97241814,NoArch
2,6,8,2,14,0,0,0,4,0,1,2,0.985228136,310,1,323,11,39,38,1,1409,1470,61,9,8,1,0,100.0,NoArch
0,0,0,0,0,0,0,0,0,0,0,0,0.0,0,0,24,9,0,0,0,0,0,0,0,0,0,0,100.0,NoArch
1,2,2,0,4,0,0,0,2,0,1,1,0.0,0,1,577,25,3,0,3,271,0,271,1,0,1,0,100.0,NoArch
3,475,15,460,490,2,0,2,27,17,2,2,1.133122611,0,1,1008,7,125,0,125,4933,0,4933,50,0,50,0,99.96988254,NoArch
39,397,220,177,617,1,0,1,6,82,3,6,4.95346006,7259,1,208,28,813,773,40,30525,29121,1404,451,432,19,0,99.84314181,NoArch
3,32,23,9,55,0,0,0,4,0,1,3,1.112924711,1390,2,74,3,168,166,2,7697,7629,68,48,47,1,0,100.0,NoArch
1,0,2,2,2,0,0,0,4,0,1,1,0.0,0,2,906,11,5,0,5,550,0,550,5,0,5,0,100.0,NoArch
23,389,128,261,517,1,0,1,12,59,2,9,3.809333223,6307,2,48,14,765,730,35,37872,36463,1409,355,334,21,0,99.97116355,NoArch
1,4,3,1,7,0,0,0,2,0,1,1,0.0,0,1,1017,16,14,0,14,860,0,860,5,0,5,0,100.0,NoArch
99,3618,3983,365,7601,0,12,12,48,284,6,57,5.725958339,738,1,45,2,5084,63,5021,189078,2632,186446,1476,35,1441,1,99.84126321,NoArch
0,0,0,0,0,0,0,0,0,0,0,0,0.0,0,0,291,5,0,0,0,0,0,0,0,0,0,1,100.0,NoArch
1,1,1,0,2,0,0,0,15,0,1,1,0.0,0,1,605,39,91,0,91,3527,0,3527,23,0,23,0,100.0,NoArch
1,12,6,6,18,0,0,0,5,500,1,1,0.0,236,1,580,28,46,44,2,902,872,30,6,6,0,0,100.0,NoArch
3,18,13,5,31,0,0,0,95,16,1,3,1.443585942,0,3,603,37,574,0,574,19288,0,19288,109,0,109,0,100.0,NoArch
3,127,21,106,148,2,0,2,2,343,1,2,1.547434654,163,2,163,16,30,23,7,1114,801,313,9,5,4,1,99.97200291,NoArch
0,0,0,0,0,0,0,0,0,0,0,0,0.0,0,0,31,3,0,0,0,0,0,0,0,0,0,0,100.0,NoArch
5,44,2,42,46,4,0,4,122,112,2,2,2.288434764,0,4,1723,18,772,0,772,39615,0,39615,550,0,550,1,100.0,NoArch
3,8,4,4,12,0,0,0,53,0,2,3,1.459147917,0,3,1334,17,139,0,139,4844,0,4844,61,0,61,1,100.0,NoArch
3,61,2,59,63,2,0,2,12,0,1,2,1.492643176,0,1,1309,11,50,0,50,2018,0,2018,18,0,18,0,99.98545878,NoArch
6,36,7,29,43,0,0,0,5,577,1,5,2.375093604,798,2,102,15,94,88,6,3842,3671,171,53,52,1,1,100.0,NoArch
77,3805,3475,330,7280,15,0,15,51,701,5,39,5.548360523,0,2,289,21,4895,0,4895,175822,0,175822,1412,0,1412,0,99.85381949,NoArch
1,1,1,0,2,0,0,0,11,71,1,1,0.0,631,2,304,21,94,94,0,3386,3386,0,37,37,0,1,100.0,NoArch
3,26,51,25,77,0,0,0,3,133,2,3,0.346563258,589,1,226,19,63,67,4,3068,3181,113,24,24,0,0,100.0,NoArch
2,33,1,32,34,1,0,1,97,22,2,2,0.908178347,0,6,1341,8,388,0,388,18377,0,18377,296,0,296,1,100.0,NoArch
0,0,0,0,0,0,0,0,0,0,0,0,0.0,0,0,1042,20,0,0,0,0,0,0,0,0,0,0,100.0,NoArch
3,23,15,8,38,0,0,0,149,246,1,3,1.24273038,0,7,1436,25,444,0,444,13947,0,13947,122,0,122,1,99.98952953,NoArch
1,10,9,1,19,0,0,0,71,203,1,1,0.0,0,5,2957,1,209,0,209,6747,0,6747,49,0,49,1,100.0,NoArch
0,0,0,0,0,0,0,0,0,0,0,0,0.0,0,0,711,8,0,0,0,0,0,0,0,0,0,0,100.0,NoArch
3,176,3,173,179,2,0,2,98,0,2,2,1.505145989,0,6,1344,10,443,0,443,21943,0,21943,337,0,337,1,100.0,NoArch
2,55,7,48,62,0,0,0,4,289,1,2,0.637387499,242,2,16,2,45,45,0,840,840,0,25,25,0,0,100.0,NoArch
1,7,2,5,9,0,0,0,20,35,1,1,0.0,603,2,126,9,92,91,1,3304,3268,36,41,41,0,0,100.0,NoArch
1,1,0,1,1,0,0,0,12,239,1,1,0.0,496,2,368,22,94,94,0,2714,2714,0,7,7,0,1,100.0,NoArch
0,0,0,0,0,0,0,0,0,0,0,0,0.0,0,0,40,0,0,0,0,0,0,0,0,0,0,1,100.0,NoArch
1,2,7,5,9,0,0,0,5,41,1,1,0.0,0,3,487,5,15,0,15,732,0,732,3,0,3,1,100.0,NoArch
0,0,0,0,0,0,0,0,0,0,0,0,0.0,0,0,1044,17,0,0,0,0,0,0,0,0,0,0,100.0,NoArch
1,0,1,1,1,0,0,0,8,0,1,1,0.0,298,2,414,26,26,26,0,978,983,5,10,10,0,0,100.0,NoArch
0,0,0,0,0,0,0,0,0,0,0,0,0.0,0,0,3,3,0,0,0,0,0,0,0,0,0,0,100.0,NoArch
1,0,2,2,2,0,0,0,3,0,1,1,0.0,103,1,95,8,4,4,0,500,516,16,4,4,0,0,100.0,NoArch
18,162,69,93,231,0,0,0,28,84,2,9,3.745545137,7031,1,103,11,844,832,12,41901,41150,751,447,443,4,0,100.0,NoArch
5,80,30,50,110,0,0,0,10,97,2,2,1.723513989,870,1,880,12,121,117,4,4706,4337,369,51,52,1,0,100.0,NoArch
1,1,1,0,2,0,0,0,13,255,1,1,0.0,0,4,674,7,49,0,49,1523,0,1523,9,0,9,1,100.0,NoArch
4,21,5,16,26,0,0,0,4,764,1,1,1.536791896,0,3,190,6,31,0,31,1445,0,1445,23,0,23,0,100.0,NoArch
4,125,94,31,219,0,0,0,7,148,1,3,1.191443958,2999,2,400,22,510,498,12,15721,15579,142,130,130,0,0,100.0,NoArch
1,83,0,83,83,1,0,1,1,0,1,1,0.0,0,1,103,16,3,0,3,411,0,411,3,0,3,0,99.93900072,NoArch
1,12,1,11,13,0,0,0,58,84,1,1,0.0,0,4,98,1,244,0,244,7889,0,7889,81,0,81,1,100.0,NoArch
0,0,0,0,0,0,0,0,0,0,0,0,0.0,0,0,31,3,0,0,0,0,0,0,0,0,0,0,100.0,NoArch
2,1614,1478,136,3092,1,0,1,86,92,1,1,0.999517059,0,6,534,6,345,0,345,10466,0,10466,119,0,119,1,99.99418097,NoArch
1,34,4,30,38,0,0,0,5,352,1,1,0.0,0,4,180,1,46,0,46,3143,0,3143,27,0,27,1,100.0,NoArch
1,1,1,0,2,0,0,0,13,255,1,1,0.0,0,4,674,7,49,0,49,1523,0,1523,9,0,9,1,100.0,NoArch
3,160,3,157,163,2,0,2,12,5,2,3,1.294379383,0,1,564,10,115,0,115,2853,0,2853,19,0,19,1,99.98318367,NoArch
15,141,63,78,204,1,0,1,18,204,2,6,3.132561829,2876,1,60,8,381,375,6,16258,15912,346,124,120,4,0,99.97231297,NoArch
1,4,2,2,6,0,0,0,20,100,1,1,0.0,0,7,71,2,120,0,120,2605,0,2605,10,0,10,1,100.0,NoArch
8,61,14,47,75,1,0,1,100,268,2,7,2.168907435,0,3,1028,27,453,0,453,29754,0,29754,146,0,146,0,100.0,NoArch
0,0,0,0,0,0,0,0,0,0,0,0,0.0,0,0,261,9,0,0,0,0,0,0,0,0,0,0,100.0,NoArch
16,297,138,159,435,1,0,1,15,213,1,7,2.949043171,4092,1,388,32,679,651,28,23671,22419,1252,195,196,1,0,99.77793479,NoArch
2,34,1,33,35,1,0,1,148,20,1,1,0.315997133,0,3,1426,24,540,0,540,17607,0,17607,125,0,125,1,100.0,NoArch
0,0,0,0,0,0,0,0,0,0,0,0,0.0,0,0,356,12,0,0,0,0,0,0,0,0,0,1,100.0,NoArch
2,42,30,12,72,0,0,0,21,3083,1,2,0.99107606,0,4,14,0,102,0,102,3693,0,3693,37,0,37,0,100.0,NoArch
0,0,0,0,0,0,0,0,0,0,0,0,0.0,0,0,3,0,0,0,0,0,0,0,0,0,0,0,100.0,NoArch
0,0,0,0,0,0,0,0,0,0,0,0,0.0,0,0,480,45,0,0,0,0,0,0,0,0,0,0,100.0,NoArch
2,14,1,13,15,1,0,1,123,39,2,2,0.918295834,0,6,1740,25,461,0,461,22303,0,22303,277,0,277,1,100.0,NoArch
0,0,0,0,0,0,0,0,0,0,0,0,0.0,0,0,38,4,0,0,0,0,0,0,0,0,0,0,100.0,NoArch
11,157,61,96,218,3,0,3,159,52,1,6,2.967132459,0,2,1459,17,1118,0,1118,48653,0,48653,387,0,387,1,99.99343875,NoArch
1,6,2,4,8,0,0,0,17,16,1,1,0.0,568,2,413,25,116,115,1,3689,3662,27,38,37,1,0,100.0,NoArch
2,62,23,39,85,0,0,0,15,11,1,2,0.220283267,1291,3,544,25,241,235,6,8973,8708,265,42,42,0,0,100.0,NoArch
1,1,1,0,2,0,0,0,13,192,1,1,0.0,692,3,520,41,104,104,0,3703,3703,0,47,47,0,1,100.0,NoArch
0,0,0,0,0,0,0,0,0,0,0,0,0.0,0,0,742,21,0,0,0,0,0,0,0,0,0,0,100.0,NoArch
98,3931,3626,305,7557,15,0,15,51,879,6,56,5.703749629,0,2,29,3,5191,0,5191,189371,0,189371,1518,0,1518,1,99.85381949,NoArch
0,0,0,0,0,0,0,0,0,0,0,0,0.0,0,0,544,17,0,0,0,0,0,0,0,0,0,0,100.0,NoArch
2,39,8,31,47,0,0,0,12,8,2,2,0.878674493,739,1,559,34,137,135,2,5073,4847,226,28,27,1,1,100.0,NoArch
0,0,0,0,0,0,0,0,0,0,0,0,0.0,0,0,1065,12,0,0,0,0,0,0,0,0,0,0,100.0,NoArch
0,0,0,0,0,0,0,0,0,0,0,0,0.0,0,0,693,14,0,0,0,0,0,0,0,0,0,0,100.0,NoArch
2,2,3,1,5,0,0,0,14,274,2,2,0.970950594,736,1,344,3,132,132,0,3455,3455,0,44,44,0,0,100.0,NoArch
1,1,1,0,2,0,0,0,6,0,1,1,0.0,130,2,98,7,6,6,0,592,592,0,5,5,0,0,100.0,NoArch
5,103,4,99,107,1,0,1,4,236,1,5,1.713048322,1197,2,54,8,109,102,7,7837,7378,459,81,75,6,0,99.98832321,NoArch
0,0,0,0,0,0,0,0,0,0,0,0,0.0,0,0,1026,25,0,0,0,0,0,0,0,0,0,0,100.0,NoArch
0,0,0,0,0,0,0,0,0,0,0,0,0.0,0,0,590,33,0,0,0,0,0,0,0,0,0,1,100.0,NoArch
1,26,0,26,26,1,0,1,10,3,1,1,0.0,0,2,1483,17,7,0,7,1214,0,1214,7,0,7,1,100.0,NoArch
1,4,3,1,7,0,0,0,9,46,1,1,0.0,625,3,498,54,89,89,0,2233,2219,14,39,39,0,0,100.0,NoArch
1,1,1,0,2,0,0,0,14,0,1,1,0.0,192,2,902,32,29,29,0,707,707,0,14,14,0,0,100.0,NoArch
57,2837,3352,515,6189,0,0,0,51,901,5,32,5.126639815,0,2,102,1,4414,0,4414,158906,0,158906,1252,0,1252,0,100.0,NoArch
1,5,1,4,6,0,0,0,6,51,1,1,0.0,351,1,525,9,61,60,1,2450,2429,21,10,10,0,0,100.0,NoArch
13,53,9,44,62,11,0,11,41,793,1,4,2.691851667,0,1,546,6,613,0,613,19881,0,19881,179,0,179,1,100.0,NoArch
0,0,0,0,0,0,0,0,0,0,0,0,0.0,0,0,512,20,0,0,0,0,0,0,0,0,0,0,100.0,NoArch
1,1,1,0,2,0,0,0,2,489,1,1,0.0,52,2,6,0,5,5,0,162,162,0,5,5,0,0,100.0,NoArch
1,7,0,7,7,0,0,0,3,289,1,1,0.0,474,2,84,5,83,82,1,2345,2328,17,41,41,0,0,100.0,NoArch
0,0,0,0,0,0,0,0,0,0,0,0,0.0,0,0,1023,5,0,0,0,0,0,0,0,0,0,0,100.0,NoArch
1,1,1,0,2,0,0,0,5,17,1,1,0.0,134,1,568,29,15,15,0,501,501,0,2,2,0,0,100.0,NoArch
17,54,27,27,81,10,0,10,3,17,1,5,3.5653529,0,2,600,18,137,0,137,7934,0,7934,56,0,56,0,100.0,NoArch
2,5,3,2,8,1,0,1,2,0,1,1,0.954434003,0,2,887,6,9,0,9,478,0,478,8,0,8,0,99.99617503,NoArch
12,64,61,3,125,0,0,0,8,5,3,4,3.444793434,0,1,1717,38,117,0,117,5212,0,5212,79,0,79,1,99.89334958,NoArch
2,3,6,3,9,0,0,0,13,201,1,2,0.99107606,0,1,1353,14,68,0,68,2337,0,2337,39,0,39,1,100.0,NoArch
0,0,0,0,0,0,0,0,0,0,0,0,0.0,0,0,151,9,0,0,0,0,0,0,0,0,0,0,100.0,NoArch
1,31,30,1,61,0,0,0,2,696,1,1,0.0,112,1,331,19,14,13,1,625,617,8,6,6,0,0,100.0,NoArch
1,17,21,4,38,0,0,0,75,9,1,1,0.0,0,4,541,2,135,0,135,5478,0,5478,24,0,24,0,100.0,NoArch
4,71,0,71,71,4,0,4,99,86,1,1,1.192497445,0,6,1361,13,405,0,405,20863,0,20863,320,0,320,1,99.98991529,NoArch
1,10,7,3,17,0,0,0,86,212,1,1,0.0,0,4,1336,15,201,0,201,5328,0,5328,87,0,87,1,100.0,NoArch
0,0,0,0,0,0,0,0,0,0,0,0,0.0,0,0,1009,19,0,0,0,0,0,0,0,0,0,0,100.0,NoArch
2,13,66,53,79,0,0,0,9,1292,1,1,0.547990008,0,3,594,15,74,0,74,2123,0,2123,19,0,19,0,100.0,NoArch
99,3618,3983,365,7601,0,12,12,48,284,6,57,5.725958339,738,1,45,2,5084,63,5021,189078,2632,186446,1476,35,1441,1,99.84126321,NoArch
3,5,90,85,95,0,1,1,15,113,2,3,0.380909126,2371,1,50,4,515,517,2,14171,14557,386,127,129,2,0,99.9883802,NoArch
1,3,2,1,5,0,0,0,33,867,1,1,0.0,0,9,217,1,156,0,156,4543,0,4543,30,0,30,1,100.0,NoArch
0,0,0,0,0,0,0,0,0,0,0,0,0.0,0,0,893,23,0,0,0,0,0,0,0,0,0,0,100.0,NoArch
2,0,13,13,13,0,0,0,39,0,1,1,0.391243564,0,1,1763,27,89,0,89,6081,0,6081,72,0,72,0,100.0,NoArch
3,59,16,43,75,0,0,0,4,166,1,2,1.542833137,445,2,80,1,41,36,5,2353,2158,195,27,24,3,1,100.0,NoArch
0,0,0,0,0,0,0,0,0,0,0,0,0.0,0,0,37,3,0,0,0,0,0,0,0,0,0,0,100.0,NoArch
1,9,0,9,9,0,0,0,8,195,1,1,0.0,658,2,307,24,135,133,2,4090,4029,61,30,30,0,1,100.0,NoArch
8,71,112,41,183,0,0,0,20,276,2,8,2.63326149,4380,3,155,8,639,659,20,27457,27822,365,187,187,0,0,100.0,NoArch
1,3,2,1,5,0,0,0,2,469,1,1,0.0,243,2,11,3,38,38,0,1158,1145,13,21,21,0,1,100.0,NoArch
5,2,83,81,85,0,0,0,22,511,2,5,1.972528086,38,4,905,10,175,2,173,5804,96,5708,94,1,93,0,99.9936,NoArch
4,177,29,148,206,0,0,0,20,580,2,3,1.297816316,0,2,531,8,469,0,469,11853,0,11853,106,0,106,0,99.99664046,NoArch
15,114,141,27,255,0,0,0,7,1645,2,15,3.301110341,0,1,1449,1,80,0,80,7949,0,7949,57,0,57,0,100.0,NoArch
0,0,0,0,0,0,0,0,0,0,0,0,0.0,0,0,101,0,0,0,0,0,0,0,0,0,0,0,100.0,NoArch
5,173,48,125,221,0,0,0,17,13,1,5,1.737039353,2665,3,457,38,493,466,27,15676,14688,988,131,126,5,0,100.0,NoArch
3,95,1,94,96,0,0,0,24,404,2,2,0.768746129,2590,4,494,50,592,588,4,15460,15413,47,175,174,1,1,100.0,NoArch
2,22,3,19,25,0,0,0,13,18,1,2,0.998845536,1666,3,23,4,191,188,3,11094,10990,104,96,95,1,1,100.0,NoArch
49,2530,2951,421,5481,0,0,0,48,1590,4,26,4.916662684,0,3,268,3,3869,0,3869,133635,0,133635,1057,0,1057,0,100.0,NoArch
2,28,1,27,29,1,0,1,7,526,2,2,0.735508582,0,2,221,3,34,0,34,1893,0,1893,22,0,22,1,100.0,NoArch
1,1,1,0,2,0,0,0,142,1,1,1,0.0,0,6,1402,18,379,0,379,12213,0,12213,87,0,87,1,100.0,NoArch
1,1,0,1,1,0,0,0,7,0,1,1,0.0,190,2,47,3,24,24,0,893,885,8,5,5,0,0,100.0,NoArch
3,15,18,3,33,0,0,0,14,36,1,3,0.760732746,3096,2,205,38,658,661,3,19368,19381,13,159,159,0,1,100.0,NoArch
0,0,0,0,0,0,0,0,0,0,0,0,0.0,0,0,1015,24,0,0,0,0,0,0,0,0,0,0,100.0,NoArch
1,3,3,0,6,0,0,0,2,900,1,1,0.0,60,2,12,0,0,0,0,53,53,0,0,0,0,0,100.0,NoArch
2,311,0,311,311,2,0,2,1,0,1,2,0.612649473,0,1,585,27,17,0,17,1615,0,1615,9,0,9,0,99.98320513,NoArch
1,3,0,3,3,1,0,1,23,108,1,1,0.0,0,7,526,9,123,0,123,2649,0,2649,10,0,10,0,100.0,NoArch
38,856,95,761,951,5,0,5,52,158,3,16,4.538227596,10242,2,220,0,1690,1573,117,62962,59010,3952,762,707,55,0,99.28220058,NoArch
7,47,1,46,48,6,0,6,30,11,2,3,1.886824181,0,4,77,4,303,0,303,12419,0,12419,90,0,90,1,99.99470367,NoArch
1,0,122,122,122,0,1,1,2,396,1,1,0.0,122,1,221,20,0,11,11,0,533,533,0,6,6,1,99.98841251,NoArch
8,210,82,128,292,2,0,2,87,52,2,3,2.416482832,0,3,758,17,638,0,638,28734,0,28734,171,0,171,0,100.0,NoArch
0,0,0,0,0,0,0,0,0,0,0,0,0.0,0,0,1031,10,0,0,0,0,0,0,0,0,0,0,100.0,NoArch
1,0,1,1,1,0,0,0,5,0,1,1,0.0,138,2,382,32,21,21,0,889,894,5,13,13,0,0,100.0,NoArch
1,1,0,1,1,0,0,0,7,0,1,1,0.0,190,2,47,3,24,24,0,893,885,8,5,5,0,0,100.0,NoArch
2,63,0,63,63,2,0,2,66,235,1,2,0.841236776,0,2,1349,11,202,0,202,17619,0,17619,170,0,170,0,100.0,NoArch
0,0,0,0,0,0,0,0,0,0,0,0,0.0,0,0,1412,19,0,0,0,0,0,0,0,0,0,1,100.0,NoArch
5,22,1,21,23,0,0,0,11,68,2,2,2.136872696,1416,1,487,48,132,128,4,8305,8175,130,63,61,2,0,100.0,NoArch
10,1347,0,1347,1347,10,0,10,1,0,3,4,2.961386784,0,1,13,4,172,0,172,5091,0,5091,79,0,79,1,99.84398537,NoArch
0,0,0,0,0,0,0,0,0,0,0,0,0.0,0,0,34,6,0,0,0,0,0,0,0,0,0,0,100.0,NoArch
3,26,51,25,77,0,0,0,3,133,2,3,0.346563258,589,1,226,19,63,67,4,3068,3181,113,24,24,0,0,100.0,NoArch
0,0,0,0,0,0,0,0,0,0,0,0,0.0,0,0,928,50,0,0,0,0,0,0,0,0,0,0,100.0,NoArch
0,0,0,0,0,0,0,0,0,0,0,0,0.0,0,0,542,15,0,0,0,0,0,0,0,0,0,0,100.0,NoArch
4,12,4,8,16,0,0,0,9,607,1,4,2.0,0,3,242,1,63,0,63,2942,0,2942,10,0,10,1,100.0,NoArch
7,256,17,239,273,1,0,1,15,377,2,5,1.092780847,1881,1,373,27,377,346,31,10945,10239,706,95,81,14,1,99.99088838,NoArch
5,157,99,58,256,0,0,0,21,133,1,4,2.043467446,3352,3,516,62,642,630,12,21193,20762,431,154,152,2,0,100.0,NoArch
0,0,0,0,0,0,0,0,0,0,0,0,0.0,0,0,2,2,0,0,0,0,0,0,0,0,0,0,100.0,NoArch
6,48,40,8,88,1,0,1,147,61,1,4,1.757735954,0,2,1420,21,755,0,755,27588,0,27588,260,0,260,1,100.0,NoArch
2,23,1,22,24,1,0,1,22,145,1,2,0.41381685,0,3,491,4,133,0,133,4347,0,4347,20,0,20,1,100.0,NoArch
1,36,1,35,37,0,0,0,10,1007,1,1,0.0,0,5,1400,16,16,0,16,1044,0,1044,16,0,16,1,100.0,NoArch
3,4,0,4,4,3,0,3,31,376,1,1,1.5,0,2,995,20,81,0,81,4245,0,4245,21,0,21,1,100.0,NoArch
0,0,0,0,0,0,0,0,0,0,0,0,0.0,0,0,514,68,0,0,0,0,0,0,0,0,0,0,100.0,NoArch
1,2,2,0,4,0,0,0,7,359,1,1,0.0,0,3,181,6,26,0,26,706,0,706,12,0,12,1,100.0,NoArch
0,0,0,0,0,0,0,0,0,0,0,0,0.0,0,0,512,20,0,0,0,0,0,0,0,0,0,0,100.0,NoArch
0,0,0,0,0,0,0,0,0,0,0,0,0.0,0,0,98,11,0,0,0,0,0,0,0,0,0,0,100.0,NoArch
9,100,13,87,113,1,0,1,30,95,2,4,2.785630462,2201,2,107,10,227,219,8,10074,9665,409,177,173,4,1,99.8927566,NoArch
1,38,4,34,42,0,0,0,15,46,1,1,0.0,0,4,679,3,46,0,46,1135,0,1135,17,0,17,1,100.0,NoArch
1,1,1,0,2,0,0,0,18,0,1,1,0.0,747,2,75,7,50,50,0,3214,3216,2,48,48,0,0,100.0,NoArch
0,0,0,0,0,0,0,0,0,0,0,0,0.0,0,0,1,0,0,0,0,0,0,0,0,0,0,0,100.0,NoArch
1,1,1,0,2,0,0,0,5,107,1,1,0.0,141,2,558,33,13,13,0,854,850,4,5,5,0,0,100.0,NoArch
2,8,1,7,9,0,0,0,18,71,2,2,0.764204507,2421,4,15,1,548,546,2,14864,14839,25,136,136,0,0,100.0,NoArch
5,5,5,0,10,0,0,0,3,2042,1,2,2.321928095,0,2,21,0,0,0,0,381,0,381,0,0,0,0,100.0,NoArch
0,0,0,0,0,0,0,0,0,0,0,0,0.0,0,0,590,33,0,0,0,0,0,0,0,0,0,1,100.0,NoArch
3,31,12,19,43,0,0,0,166,1,2,2,1.400524001,0,6,2975,13,527,0,527,25477,0,25477,310,0,310,1,100.0,NoArch
1,4,2,2,6,0,0,0,55,104,1,1,0.0,0,3,0,0,254,0,254,7492,0,7492,77,0,77,1,100.0,NoArch
2,34,0,34,34,2,0,2,74,18,1,1,1.0,0,4,540,3,190,0,190,7613,0,7613,37,0,37,0,99.99497992,NoArch
0,0,0,0,0,0,0,0,0,0,0,0,0.0,0,0,1055,2,0,0,0,0,0,0,0,0,0,0,100.0,NoArch
3,8,9,1,17,0,0,0,14,159,3,3,1.379280487,642,2,581,29,44,44,0,3267,3273,6,39,39,0,0,100.0,NoArch
1,1,1,0,2,0,0,0,11,90,1,1,0.0,201,1,551,32,12,12,0,1237,1237,0,7,7,0,0,100.0,NoArch
1,1,1,0,2,0,0,0,6,0,1,1,0.0,0,2,665,8,12,0,12,1029,0,1029,7,0,7,0,100.0,NoArch
0,0,0,0,0,0,0,0,0,0,0,0,0.0,0,0,891,21,0,0,0,0,0,0,0,0,0,0,100.0,NoArch
0,0,0,0,0,0,0,0,0,0,0,0,0.0,0,0,26,4,0,0,0,0,0,0,0,0,0,0,100.0,NoArch
76,3444,3762,318,7206,0,12,12,48,268,5,38,5.525449415,738,1,1440,24,4817,63,4754,174198,2632,171566,1340,35,1305,1,99.85381949,NoArch
0,0,0,0,0,0,0,0,0,0,0,0,0.0,0,0,1416,0,0,0,0,0,0,0,0,0,0,0,100.0,NoArch
2,87,0,87,87,2,0,2,2,3538,1,2,0.929363626,0,2,2960,4,60,0,60,1887,0,1887,22,0,22,1,99.97816773,NoArch
76,3767,3449,318,7216,15,0,15,51,695,5,38,5.52425678,0,2,1446,18,4844,0,4844,174638,0,174638,1369,0,1369,0,99.85381949,NoArch
1,4,3,1,7,0,0,0,2,0,1,1,0.0,0,1,1017,16,14,0,14,860,0,860,5,0,5,0,100.0,NoArch
0,0,0,0,0,0,0,0,0,0,0,0,0.0,0,0,1040,19,0,0,0,0,0,0,0,0,0,0,100.0,NoArch
10,11,11,0,22,0,0,0,45,672,4,8,3.277613437,0,3,295,8,472,0,472,16384,0,16384,90,0,90,0,100.0,NoArch
4,20,10,10,30,0,0,0,33,695,2,4,1.723231429,0,6,63,2,609,0,609,18757,0,18757,174,0,174,0,100.0,NoArch
4,473,0,473,473,4,0,4,1,0,1,2,1.710472173,0,1,587,27,25,0,25,2250,0,2250,13,0,13,0,99.96642718,NoArch
1,4,1,3,5,0,0,0,13,1335,1,1,0.0,0,3,535,11,34,0,34,924,0,924,6,0,6,0,100.0,NoArch
5,330,35,295,365,3,0,3,30,620,2,5,1.536527624,0,6,73,0,390,0,390,22506,0,22506,143,0,143,1,100.0,NoArch
4,73,10,63,83,1,0,1,5,0,2,3,1.626760806,0,1,189,2,51,0,51,2667,0,2667,23,0,23,1,99.98227998,NoArch
3,181,9,172,190,0,0,0,4,12,1,2,0.615018229,244,1,23,8,48,22,26,1849,1119,730,37,11,26,0,100.0,NoArch
5,116,4,112,120,2,0,2,10,153,1,4,1.688224443,972,1,145,15,108,103,5,5010,4702,308,70,66,4,1,99.98179004,NoArch
1,0,2,2,2,0,0,0,3,0,1,1,0.0,103,1,95,8,4,4,0,500,516,16,4,4,0,0,100.0,NoArch
9,263,139,124,402,0,0,0,9,353,3,8,2.273139553,2659,1,272,15,419,397,22,14872,14165,707,155,142,13,2,100.0,NoArch
0,0,0,0,0,0,0,0,0,0,0,0,0.0,0,0,35,7,0,0,0,0,0,0,0,0,0,0,100.0,NoArch
89,3758,3303,455,7061,0,1,1,48,352,6,55,5.536799352,61,1,387,4,4938,5,4933,184482,123,184359,1474,5,1469,0,98.45503763,NoArch
1,1,0,1,1,0,0,0,5,78,1,1,0.0,181,3,20,0,17,17,0,1086,1075,11,6,6,0,1,100.0,NoArch
2,114,22,92,136,0,0,0,19,0,1,2,0.923119984,0,1,1371,11,102,0,102,4671,0,4671,69,0,69,1,100.0,NoArch
1,2,5,3,7,0,0,0,8,741,1,1,0.0,0,3,550,6,18,0,18,1732,0,1732,10,0,10,0,100.0,NoArch
2,27,21,6,48,0,0,0,11,231,2,2,0.41381685,1546,3,353,11,298,294,4,9303,9280,23,64,64,0,0,100.0,NoArch
0,0,0,0,0,0,0,0,0,0,0,0,0.0,0,0,1018,0,0,0,0,0,0,0,0,0,0,0,100.0,NoArch
1,2,2,0,4,0,0,0,3,44,1,1,0.0,99,1,519,41,19,17,2,505,497,8,5,5,0,1,100.0,NoArch
3,461,36,425,497,1,0,1,81,102,2,3,1.453310877,0,8,375,13,619,0,619,15524,0,15524,184,0,184,0,99.93873592,NoArch
106,777,772,5,1549,0,0,0,24,940,1,37,6.228706212,0,2,560,13,2141,0,2141,145638,0,145638,773,0,773,0,100.0,NoArch
4,9,4,5,13,0,0,0,3,0,1,1,1.987773371,146,2,15,1,0,0,0,288,288,0,0,0,0,0,100.0,NoArch
6,76,34,42,110,0,0,0,13,472,4,6,1.972819315,2268,1,563,38,228,225,3,13247,13033,214,137,136,1,0,100.0,NoArch
6,40,11,29,51,1,0,1,28,940,2,3,1.852496747,0,4,1378,18,153,0,153,8388,0,8388,76,0,76,1,100.0,NoArch
0,0,0,0,0,0,0,0,0,0,0,0,0.0,0,0,1028,10,0,0,0,0,0,0,0,0,0,0,100.0,NoArch
2,1,2,1,3,0,0,0,3,94,2,2,0.918295834,597,1,263,11,83,83,0,3168,3173,5,36,36,0,0,100.0,NoArch
4,319,0,319,319,4,0,4,1,0,1,2,1.557721287,0,1,63,5,11,0,11,1520,0,1520,10,0,10,0,99.94734071,NoArch
9,100,13,87,113,1,0,1,30,95,2,4,2.785630462,2201,2,107,10,227,219,8,10074,9665,409,177,173,4,1,99.8927566,NoArch
0,0,0,0,0,0,0,0,0,0,0,0,0.0,0,0,95,8,0,0,0,0,0,0,0,0,0,0,100.0,NoArch
0,0,0,0,0,0,0,0,0,0,0,0,0.0,0,0,1037,16,0,0,0,0,0,0,0,0,0,0,100.0,NoArch
0,0,0,0,0,0,0,0,0,0,0,0,0.0,0,0,101,14,0,0,0,0,0,0,0,0,0,0,100.0,NoArch
1,4,1,3,5,0,0,0,31,14,1,1,0.0,0,2,1010,9,69,0,69,2449,0,2449,15,0,15,0,100.0,NoArch
8,25,250,225,275,0,4,4,10,506,1,5,2.53248596,232,1,1020,19,16,15,1,2958,748,2210,8,10,2,0,99.92627593,NoArch
2,3,3,0,6,0,0,0,7,2379,2,2,0.918295834,0,2,39,4,15,0,15,916,0,916,12,0,12,0,100.0,NoArch
1,1,1,0,2,0,0,0,2,640,1,1,0.0,0,2,7,2,25,0,25,1107,0,1107,16,0,16,0,100.0,NoArch
0,0,0,0,0,0,0,0,0,0,0,0,0.0,0,0,13,0,0,0,0,0,0,0,0,0,0,1,100.0,NoArch
1,2,2,0,4,0,0,0,152,5,1,1,0.0,0,7,1441,27,380,0,380,12196,0,12196,87,0,87,0,100.0,NoArch
1,7,0,7,7,1,0,1,12,65,1,1,0.0,0,3,179,0,116,0,116,2812,0,2812,18,0,18,1,100.0,NoArch
3,110,3,107,113,2,0,2,8,136,1,2,0.902829063,0,1,187,6,123,0,123,3758,0,3758,51,0,51,1,99.99337924,NoArch
2,6,4,2,10,0,0,0,50,0,2,2,0.881290899,0,2,663,6,78,0,78,3610,0,3610,27,0,27,0,100.0,NoArch
1,1,1,0,2,0,0,0,4,0,1,1,0.0,300,2,317,7,59,59,0,1554,1554,0,18,18,0,0,100.0,NoArch
7,137,1,136,138,1,0,1,8,243,2,6,1.837163234,1248,2,69,6,98,89,9,7919,7154,765,77,69,8,0,99.98925655,NoArch
2,20,0,20,20,0,0,0,2,1022,2,2,1.0,271,1,527,11,38,34,4,1304,1244,60,23,19,4,0,100.0,NoArch
4,112,40,72,152,0,0,0,25,150,1,2,1.226830915,0,1,100,3,146,0,146,4226,0,4226,25,0,25,1,100.0,NoArch
1,21,1,20,22,0,0,0,14,237,1,1,0.0,0,4,20,1,74,0,74,2004,0,2004,14,0,14,0,100.0,NoArch
7,106,7,99,113,2,0,2,3,786,1,5,1.450810452,0,1,1328,19,67,0,67,2266,0,2266,32,0,32,1,99.95286076,NoArch
7,64,67,3,131,0,0,0,18,454,2,7,2.231715355,2693,3,135,9,497,499,2,15305,15425,120,134,135,1,0,99.96895925,NoArch
2,3,2,1,5,0,0,0,13,32,1,2,0.970950594,585,1,445,35,92,92,0,3373,3369,4,14,14,0,0,100.0,NoArch
1,2,4,2,6,0,0,0,13,21,1,1,0.0,220,2,52,8,24,24,0,1425,1425,0,4,4,0,0,100.0,NoArch
0,0,0,0,0,0,0,0,0,0,0,0,0.0,0,0,531,15,0,0,0,0,0,0,0,0,0,0,100.0,NoArch
1,1,1,0,2,0,0,0,11,71,1,1,0.0,720,2,305,22,110,110,0,3626,3627,1,43,43,0,1,100.0,NoArch
4,50,8,42,58,1,0,1,38,14,2,2,1.603599604,0,2,992,21,443,0,443,14347,0,14347,50,0,50,0,100.0,NoArch
0,0,0,0,0,0,0,0,0,0,0,0,0.0,0,0,684,8,0,0,0,0,0,0,0,0,0,0,100.0,NoArch
5,87,26,61,113,0,0,0,12,338,2,4,0.897013834,1959,2,492,50,414,393,21,12310,11913,397,82,81,1,1,100.0,NoArch
2,27,17,10,44,0,0,0,6,22,1,2,0.510787823,1334,2,426,31,112,112,0,7428,7358,70,64,64,0,0,100.0,NoArch
1,0,1,1,1,0,0,0,9,0,1,1,0.0,480,2,383,32,88,88,0,2668,2673,5,36,36,0,0,100.0,NoArch
0,0,0,0,0,0,0,0,0,0,0,0,0.0,0,0,1057,4,0,0,0,0,0,0,0,0,0,0,100.0,NoArch
3,8,4,4,12,1,0,1,10,445,2,2,1.28067213,0,4,57,0,93,0,93,4477,0,4477,22,0,22,1,100.0,NoArch
3,17,5,12,22,0,0,0,5,446,1,2,1.090652803,468,2,115,12,71,70,1,2398,2336,62,34,34,0,1,100.0,NoArch
0,0,0,0,0,0,0,0,0,0,0,0,0.0,0,0,58,3,0,0,0,0,0,0,0,0,0,0,100.0,NoArch
1,1,0,1,1,0,0,0,5,78,1,1,0.0,181,3,20,0,17,17,0,1086,1075,11,6,6,0,1,100.0,NoArch
97,3616,3919,303,7535,0,12,12,48,276,6,55,5.697022115,738,1,20,2,4947,63,4884,183925,2632,181293,1439,35,1404,1,99.85381949,NoArch
0,0,0,0,0,0,0,0,0,0,0,0,0.0,0,0,704,1,0,0,0,0,0,0,0,0,0,1,100.0,NoArch
4,127,32,95,159,3,0,3,3,5,1,1,1.932827005,0,1,28,8,61,0,61,3383,0,3383,20,0,20,0,99.97573405,NoArch
2,15,11,4,26,0,0,0,10,189,1,1,0.619382195,0,5,683,7,87,0,87,2655,0,2655,28,0,28,0,100.0,NoArch
3,11,7,4,18,0,0,0,101,131,2,2,1.351644115,0,2,230,1,301,0,301,9387,0,9387,88,0,88,1,100.0,NoArch
2,34,0,34,34,2,0,2,74,18,1,1,1.0,0,4,540,3,190,0,190,7613,0,7613,37,0,37,0,99.99497992,NoArch
0,0,0,0,0,0,0,0,0,0,0,0,0.0,0,0,17,1,0,0,0,0,0,0,0,0,0,1,100.0,NoArch
2,22,0,22,22,2,0,2,38,0,1,2,0.945660305,0,5,9,2,137,0,137,5357,0,5357,53,0,53,1,100.0,NoArch
9,396,311,85,707,1,1,2,10,207,3,5,2.522367759,4084,1,349,8,598,581,17,20686,20156,530,190,178,12,0,99.96856334,NoArch
4,284,25,259,309,3,0,3,6,0,1,2,1.753464238,94,2,16,7,40,11,29,1365,416,949,29,3,26,0,99.96872068,NoArch
5,109,32,77,141,0,0,0,18,69,1,2,2.013435611,1223,3,21,1,143,133,10,6896,6411,485,55,53,2,1,99.9951105,NoArch
2,10,10,0,20,0,0,0,3,0,1,1,0.970950594,107,2,10,1,0,0,0,95,95,0,0,0,0,0,100.0,NoArch
0,0,0,0,0,0,0,0,0,0,0,0,0.0,0,0,0,0,0,0,0,0,0,0,0,0,0,0,100.0,NoArch
4,92,22,70,114,2,0,2,14,0,1,3,1.449749696,0,2,3,2,94,0,94,3010,0,3010,36,0,36,1,100.0,NoArch
1,0,1,1,1,0,0,0,31,0,1,1,0.0,0,7,692,13,104,0,104,3810,0,3810,24,0,24,1,100.0,NoArch
2,25,1,24,26,0,0,0,3,498,2,2,0.391243564,156,2,154,11,19,17,2,617,434,183,18,17,1,1,99.98328039,NoArch
8,344,116,228,460,1,0,1,10,33,1,5,2.726834217,2741,1,44,10,372,356,16,19366,17817,1549,157,146,11,0,99.99037536,NoArch
3,62,10,52,72,1,0,1,24,150,1,3,1.111868527,0,2,1751,28,337,0,337,17599,0,17599,201,0,201,1,100.0,NoArch
8,192,89,103,281,0,0,0,17,148,4,7,1.474853786,3129,3,578,28,519,507,12,17201,16756,445,189,184,5,3,100.0,NoArch
3,227,0,227,227,3,0,3,3,613,2,2,0.971583155,0,1,46,1,26,0,26,1320,0,1320,14,0,14,1,99.97998799,NoArch
1,1,1,0,2,0,0,0,115,31,1,1,0.0,0,12,225,3,261,0,261,7042,0,7042,67,0,67,1,100.0,NoArch
2,44,3,41,47,0,0,0,10,984,2,2,0.25387844,0,4,361,9,32,0,32,1487,0,1487,11,0,11,0,99.97206801,NoArch
10,44,46,2,90,0,0,0,14,45,1,5,2.790348342,0,5,9,3,618,0,618,31183,0,31183,255,0,255,0,100.0,NoArch
7,44,1,43,45,6,0,6,74,478,2,6,2.728770953,0,5,879,24,302,0,302,9148,0,9148,127,0,127,1,100.0,NoArch
76,3444,3762,318,7206,0,12,12,48,268,5,38,5.525449415,738,1,1442,14,4817,63,4754,174198,2632,171566,1340,35,1305,1,99.85381949,NoArch
3,15,68,53,83,0,0,0,3,328,1,2,0.617723855,793,2,49,3,100,99,1,3287,3229,58,70,69,1,0,100.0,NoArch
1,15,2,13,17,0,0,0,14,2,1,1,0.0,0,4,1732,21,57,0,57,1754,0,1754,13,0,13,1,100.0,NoArch
10,44,46,2,90,0,0,0,14,45,1,5,2.790348342,0,5,9,3,618,0,618,31183,0,31183,255,0,255,0,100.0,NoArch
0,0,0,0,0,0,0,0,0,0,0,0,0.0,0,0,0,0,0,0,0,0,0,0,0,0,0,0,100.0,NoArch
2,5,3,2,8,0,0,0,2,2,2,2,0.811278124,342,2,553,28,48,48,0,1913,1892,21,14,14,0,0,100.0,NoArch
0,0,0,0,0,0,0,0,0,0,0,0,0.0,0,0,356,12,0,0,0,0,0,0,0,0,0,1,100.0,NoArch
3,34,31,3,65,0,0,0,9,174,2,3,1.578410607,1036,2,44,0,184,188,4,5848,5921,73,58,58,0,0,100.0,NoArch
1,18,4,14,22,0,0,0,3,1270,1,1,0.0,0,3,659,2,68,0,68,1763,0,1763,21,0,21,0,99.9774017,NoArch
2,6,6,0,12,0,0,0,4,812,1,2,1.0,0,3,975,18,17,0,17,437,0,437,2,0,2,0,100.0,NoArch
1,2,2,0,4,0,0,0,12,26,1,1,0.0,1442,3,379,30,278,278,0,8825,8827,2,47,47,0,0,100.0,NoArch
2,42,30,12,72,0,0,0,21,3083,1,2,0.99107606,0,4,14,0,102,0,102,3693,0,3693,37,0,37,0,100.0,NoArch
2,79,47,32,126,1,0,1,11,243,2,2,0.341153893,0,5,1754,26,128,0,128,3370,0,3370,46,0,46,0,100.0,NoArch
1,3,0,3,3,1,0,1,6,110,1,1,0.0,0,4,689,10,67,0,67,2330,0,2330,11,0,11,1,100.0,NoArch
0,0,0,0,0,0,0,0,0,0,0,0,0.0,0,0,1047,16,0,0,0,0,0,0,0,0,0,0,100.0,NoArch
2,6,4,2,10,0,0,0,34,217,2,2,0.970950594,0,3,1302,5,76,0,76,2613,0,2613,30,0,30,1,100.0,NoArch
2,6,6,0,12,0,0,0,4,812,1,2,1.0,0,3,975,18,17,0,17,437,0,437,2,0,2,0,100.0,NoArch
1,5,1,4,6,0,0,0,2,42,1,1,0.0,84,1,881,13,7,6,1,404,394,10,3,3,0,0,100.0,NoArch
1,6,2,4,8,0,0,0,13,38,1,1,0.0,0,2,584,29,28,0,28,1301,0,1301,6,0,6,1,100.0,NoArch
4,316,60,256,376,1,0,1,89,11,1,1,1.441684354,0,1,665,22,276,0,276,11675,0,11675,56,0,56,0,99.99558947,NoArch
1,0,2,2,2,0,0,0,6,0,1,1,0.0,370,1,206,39,61,61,0,2616,2630,14,9,9,0,0,100.0,NoArch
4,159,13,146,172,0,0,0,4,297,2,3,1.4970548,1492,3,7,1,139,123,16,9539,8608,931,52,48,4,0,100.0,NoArch
6,538,267,271,805,2,0,2,30,31,1,2,2.366360332,0,1,188,7,312,0,312,8183,0,8183,126,0,126,1,99.97683193,NoArch
1,1,1,0,2,0,0,0,8,0,1,1,0.0,0,3,254,9,16,0,16,400,0,400,4,0,4,1,100.0,NoArch
1,2,7,5,9,0,0,0,5,41,1,1,0.0,0,3,487,5,15,0,15,732,0,732,3,0,3,1,100.0,NoArch
1,108,0,108,108,1,0,1,1,0,1,1,0.0,0,1,74,6,15,0,15,575,0,575,5,0,5,0,99.98427982,NoArch
7,172,6,166,178,2,0,2,25,6,3,4,2.152427241,1568,2,93,6,202,186,16,8555,7860,695,146,136,10,0,99.96518375,NoArch
4,53,12,41,65,1,0,1,114,864,1,4,1.768458491,0,3,483,3,368,0,368,10490,0,10490,88,0,88,1,100.0,NoArch
4,53,19,34,72,1,0,1,5,300,1,2,1.598816797,0,1,751,14,50,0,50,2777,0,2777,21,0,21,0,100.0,NoArch
2,16,1,15,17,0,0,0,3,584,1,2,0.787126586,210,1,367,21,33,29,4,1295,1207,88,10,9,1,1,100.0,NoArch
1,1,0,1,1,1,0,1,51,4663,1,1,0.0,0,5,81,3,77,0,77,6794,0,6794,50,0,50,0,100.0,NoArch
21,348,552,204,900,2,4,6,22,499,3,5,3.66853287,5588,1,467,38,640,647,7,26423,27230,807,217,224,7,0,99.94620185,NoArch
2,28,1,27,29,1,0,1,7,526,2,2,0.735508582,0,2,221,3,34,0,34,1893,0,1893,22,0,22,1,100.0,NoArch
1,83,0,83,83,1,0,1,1,0,1,1,0.0,0,1,103,16,3,0,3,411,0,411,3,0,3,0,99.93900072,NoArch
9,205,29,176,234,2,0,2,32,90,2,5,2.855080808,2549,2,109,10,371,342,29,13751,13064,687,204,188,16,1,99.97342075,NoArch
6,77,47,30,124,0,0,0,42,178,1,3,2.045258137,0,2,619,11,131,0,131,4884,0,4884,54,0,54,1,99.99343207,NoArch
1,4,1,3,5,0,0,0,31,14,1,1,0.0,0,2,1010,9,69,0,69,2449,0,2449,15,0,15,0,100.0,NoArch
1,1,3,2,4,0,0,0,3,129,1,1,0.0,0,1,892,7,11,0,11,257,0,257,4,0,4,0,100.0,NoArch
1,6,0,6,6,1,0,1,2,314,1,1,0.0,0,1,1474,8,8,0,8,341,0,341,8,0,8,1,100.0,NoArch
6,16,12,4,28,0,0,0,2,0,1,5,2.495602924,877,1,502,58,57,57,0,3422,3422,0,19,19,0,0,100.0,NoArch
6,175,77,98,252,1,0,1,6,137,1,2,2.038009911,1766,2,76,5,255,243,12,8749,8212,537,94,88,6,0,99.98533007,NoArch
17,54,27,27,81,10,0,10,3,17,1,5,3.5653529,0,2,600,18,137,0,137,7934,0,7934,56,0,56,0,100.0,NoArch
6,326,35,291,361,1,0,1,8,328,3,6,1.950435328,847,1,324,12,170,137,33,5786,4132,1654,59,47,12,0,99.9776086,NoArch
37,288,496,208,784,0,1,1,7,292,3,23,4.142141717,6094,1,228,21,678,659,19,31543,32355,812,292,309,17,0,94.73189087,Arch
14,1080,1335,255,2415,3,2,5,8,80,1,2,3.155563113,2792,2,7,1,286,315,29,11596,12419,823,124,139,15,1,95.33857251,Arch
18,139,168,29,307,0,0,0,16,265,4,14,3.917013303,6987,2,27,3,1308,1314,6,41161,41665,504,343,343,0,0,96.71343767,Arch
5,108,14,94,122,1,0,1,6,170,1,4,1.969694897,1368,1,62,8,186,179,7,7940,7631,309,63,60,3,1,94.69122427,Arch
2,33,3,30,36,0,0,0,6,112,1,2,0.503258335,304,1,242,23,51,41,10,1732,1581,151,26,24,2,1,92.53663524,Arch
6,65,4,61,69,0,0,0,9,240,2,5,1.786945367,1860,1,243,23,231,219,12,11125,10802,323,84,79,5,1,96.87715991,Arch
38,1740,355,1385,2095,1,0,1,9,91,5,14,3.253866124,8243,2,249,17,1236,970,266,51002,42794,8208,499,448,51,0,94.78129713,Arch
12,620,507,113,1127,2,0,2,9,74,1,3,3.000552079,2385,5,9,1,284,271,13,11952,11273,679,139,121,18,1,93.5795524,Arch
18,603,1136,533,1739,0,3,3,10,90,1,4,3.412288594,2961,2,0,0,259,320,61,11737,13768,2031,146,153,7,1,93.62348178,Arch
4,397,1,396,398,1,0,1,4,328,2,2,1.210988558,679,2,66,3,168,109,59,4649,3043,1606,81,54,27,0,93.69478799,Arch
10,270,200,70,470,1,0,1,12,9,1,2,2.587822402,1873,2,6,6,204,197,7,9831,9699,132,95,94,1,1,97.37972036,Arch
9,426,3,423,429,6,0,6,10,21,2,5,2.510633463,1388,1,36,3,276,248,28,10331,8769,1562,73,57,16,1,97.62762022,Arch
2,56,5,51,61,1,0,1,6,2,1,2,0.643639413,788,2,86,7,199,196,3,4846,4729,117,48,45,3,1,97.34500148,Arch
1,5,2,3,7,0,0,0,2,0,1,1,0.0,22,1,39,3,2,2,0,112,90,22,1,1,0,0,96.23324882,Arch
1,30,2,28,32,0,0,0,3,532,1,1,0.0,111,3,32,6,27,23,4,769,623,146,9,6,3,1,96.21525415,Arch
30,962,890,72,1852,1,0,1,9,482,3,17,3.935130687,8666,2,106,2,1261,1246,15,42632,42587,45,529,521,8,0,95.01735577,Arch
30,892,964,72,1856,0,1,1,10,0,3,17,3.932199116,8738,2,107,3,1246,1261,15,42587,42632,45,521,529,8,0,95.01735577,Arch
39,1097,911,186,2008,1,0,1,11,87,4,25,4.119508832,11203,2,110,6,1581,1548,33,56241,55501,740,660,648,12,0,95.05277045,Arch
1,88,0,88,88,1,0,1,1,0,1,1,0.0,0,1,54,3,7,0,7,403,0,403,4,0,4,1,95.08330121,Arch
19,636,39,597,675,6,0,6,21,137,2,9,3.527604242,3727,1,77,9,616,552,64,22779,19954,2825,267,231,36,0,96.82657511,Arch
21,800,191,609,991,7,0,7,6,20,2,11,3.97468713,1529,1,84,14,266,188,78,10337,7491,2846,143,88,55,0,94.79911264,Arch
6,65,10,55,75,1,0,1,23,9,2,5,1.923049878,1341,2,85,15,134,130,4,6646,6497,149,91,87,4,1,96.89752896,Arch
14,367,25,342,392,1,0,1,10,217,2,9,2.05077561,3081,1,395,28,516,455,61,17532,15282,2250,194,179,15,0,94.79733287,Arch
3,75,6,69,81,1,0,1,19,307,2,3,1.466594698,1433,3,418,26,164,158,6,9025,8726,299,110,108,2,1,97.92002646,Arch
16,941,263,678,1204,4,0,4,27,73,2,6,3.525353939,5958,1,99,7,789,717,72,29364,25813,3551,384,340,44,0,94.97418915,Arch
4,304,92,212,396,0,0,0,12,23,3,4,1.25164874,1739,1,430,33,344,321,23,10821,9248,1573,110,104,6,0,94.64064269,Arch
7,143,82,61,225,0,0,0,15,105,1,4,2.217307235,3924,1,432,34,679,663,16,23044,22771,273,160,157,3,0,92.98725972,Arch
1,23,1,22,24,0,0,0,6,2,1,1,0.0,591,1,435,31,92,89,3,4346,4177,169,19,19,0,0,95.93070105,Arch
5,110,15,95,125,0,0,0,22,44,1,1,1.356297933,1406,3,443,34,230,205,25,7044,6589,455,129,122,7,1,95.21392636,Arch
24,466,75,391,541,3,0,3,34,175,3,12,3.664436855,5541,1,111,12,865,811,54,32976,31021,1955,376,350,26,0,95.50031619,Arch
11,358,228,130,586,1,0,1,9,36,2,4,2.939853928,2691,2,114,12,336,323,13,14373,14064,309,199,181,18,0,95.72761194,Arch
19,961,684,277,1645,2,0,2,19,113,2,9,2.408137921,5208,1,478,46,807,779,28,31520,29701,1819,248,240,8,0,96.53127247,Arch
32,2770,0,2770,2770,32,0,32,1,0,1,10,4.798521647,0,1,501,57,161,0,161,9363,0,9363,89,0,89,0,95.15716649,Arch
12,274,50,224,324,0,0,0,22,644,1,6,2.984782983,1619,1,533,17,250,218,32,10070,8699,1371,104,83,21,2,94.78333799,Arch
40,959,167,792,1126,6,0,6,40,233,2,19,4.378421115,8196,2,132,6,1136,1023,113,50444,46068,4376,568,523,45,0,96.05497728,Arch
13,492,30,462,522,3,0,3,19,226,2,5,2.838283521,2122,1,144,12,298,251,47,12097,9779,2318,176,160,16,1,95.89910326,Arch
2,15,26,11,41,0,0,0,13,56,1,2,0.712064055,411,1,157,12,58,58,0,1744,1844,100,20,20,0,1,95.87164152,Arch
36,2971,0,2971,2971,36,0,36,1,0,1,3,4.305053528,0,1,875,19,229,0,229,12574,0,12574,90,0,90,0,97.69116381,Arch
6,110,11,99,121,1,0,1,8,872,2,5,2.189315013,745,2,883,14,88,74,14,4558,4116,442,36,24,12,1,95.13497352,Arch
9,1251,0,1251,1251,9,0,9,1,0,1,2,2.801054094,0,1,889,19,127,0,127,6355,0,6355,64,0,64,0,95.27127462,Arch
9,76,143,67,219,0,0,0,1,0,1,2,2.151565557,1251,1,890,20,116,127,11,6128,6355,227,62,64,2,0,97.49811178,Arch
30,4,2,2,6,0,0,0,1,0,1,10,0.918295834,2143,1,904,34,125,125,0,8045,8032,13,109,109,0,0,95.05917905,Arch
10,611,447,164,1058,3,0,3,21,58,1,3,2.568251262,1638,2,223,3,225,216,9,9714,8986,728,89,90,1,0,97.08622493,Arch
58,3063,3352,289,6415,1,0,1,51,879,5,33,5.166005492,0,2,50,0,4442,0,4442,160138,0,160138,1264,0,1264,1,95.44083427,Arch
58,3355,3066,289,6421,0,1,1,48,351,5,33,5.171867792,226,1,104,2,4463,28,4435,161803,1232,160571,1260,12,1248,0,95.44083427,Arch
58,3063,3352,289,6415,1,0,1,51,879,5,33,5.166005492,0,2,103,2,4442,0,4442,160138,0,160138,1264,0,1264,0,95.44083427,Arch
61,3355,3292,63,6647,0,2,2,48,352,5,35,5.243199422,288,1,105,3,4472,44,4428,162075,2249,159826,1264,22,1242,0,95.4320403,Arch
64,3388,3363,25,6751,4,0,4,51,835,5,38,5.288710516,0,2,1453,4,4728,0,4728,172263,0,172263,1329,0,1329,2,95.4320403,Arch
62,3367,3165,202,6532,1,1,2,48,342,5,37,5.226401227,226,1,1457,9,4727,28,4699,172776,1232,171544,1315,12,1303,1,95.43889845,Arch
58,3063,3352,289,6415,1,0,1,51,879,5,33,5.166005492,0,2,1454,5,4442,0,4442,160138,0,160138,1264,0,1264,0,95.43889845,Arch
58,3355,3066,289,6421,0,1,1,48,351,5,33,5.171867792,226,1,1460,12,4463,28,4435,161803,1232,160571,1260,12,1248,0,95.43889845,Arch
60,3065,3354,289,6419,1,0,1,51,926,6,35,5.170943565,0,2,23,0,4498,0,4498,161995,0,161995,1273,0,1273,0,95.43889845,Arch
59,3379,3081,298,6460,0,1,1,48,345,5,34,5.193833243,226,1,1461,13,4523,28,4495,163361,1232,162129,1277,12,1265,0,95.43889845,Arch
63,3254,3503,249,6757,3,0,3,62,856,5,34,5.256768421,0,2,51,1,4826,0,4826,171645,0,171645,1369,0,1369,0,95.43068583,Arch
63,3506,3257,249,6763,0,2,2,61,343,5,34,5.262320196,371,1,106,4,4845,42,4803,173194,1691,171503,1362,18,1344,1,95.43068583,Arch
66,3310,3524,214,6834,4,0,4,63,820,5,36,5.288693475,0,2,393,6,5072,0,5072,183393,0,183393,1501,0,1501,1,95.43068583,Arch
63,3506,3257,249,6763,0,2,2,62,344,5,34,5.262320196,371,1,390,6,4846,42,4804,173219,1691,171528,1362,18,1344,1,95.43068583,Arch
64,3270,3511,241,6781,3,0,3,63,849,5,34,5.272078341,0,2,297,6,4903,0,4903,173588,0,173588,1394,0,1394,1,95.43068583,Arch
68,3511,3387,124,6898,1,4,5,62,323,5,38,5.336929742,466,1,1463,15,5065,48,5017,179355,1939,177416,1414,24,1390,1,95.41876371,Arch
67,3295,3522,227,6817,6,0,6,63,809,5,36,5.298706665,0,2,1458,9,4910,0,4910,179086,0,179086,1413,0,1413,1,95.43265095,Arch
67,3527,3298,229,6825,1,2,3,62,357,5,36,5.305095566,371,1,391,6,4931,42,4889,180487,1691,178796,1403,18,1385,0,95.43265095,Arch
68,3297,3529,232,6826,6,0,6,63,788,5,36,5.305846898,0,2,298,6,4985,0,4985,180959,0,180959,1438,0,1438,1,95.43265095,Arch
65,3513,3259,254,6772,1,2,3,62,349,5,35,5.27095746,371,1,1466,18,4942,42,4900,176012,1691,174321,1393,18,1375,1,95.43265095,Arch
68,3344,3510,166,6854,5,0,5,63,792,5,37,5.316068673,0,2,395,7,5329,0,5329,186667,0,186667,1536,0,1536,1,95.42073354,Arch
63,3506,3257,249,6763,0,2,2,62,344,5,34,5.262320196,371,1,392,7,4846,42,4804,173219,1691,171528,1362,18,1344,1,95.43461439,Arch
65,3269,3516,247,6785,2,0,2,63,849,5,35,5.277235839,0,2,396,8,4882,0,4882,173284,0,173284,1384,0,1384,1,95.43461439,Arch
65,3519,3272,247,6791,0,2,2,62,334,5,35,5.282751908,371,1,393,8,4900,42,4858,174841,1691,173150,1377,18,1359,0,95.43461439,Arch
68,3488,3517,29,7005,4,0,4,63,814,5,37,5.354541013,0,2,48,2,5075,0,5075,180507,0,180507,1447,0,1447,1,95.41902799,Arch
65,3519,3272,247,6791,0,2,2,62,334,5,35,5.282751908,371,1,46,0,4900,42,4858,174841,1691,173150,1377,18,1359,1,95.43621858,Arch
69,3304,3522,218,6826,4,0,4,63,810,5,37,5.309302311,0,2,398,10,5372,0,5372,192219,0,192219,1657,0,1657,1,95.43621858,Arch
65,3519,3272,247,6791,0,2,2,62,334,5,35,5.282751908,371,1,394,9,4900,42,4858,174841,1691,173150,1377,18,1359,1,95.43621858,Arch
65,3269,3516,247,6785,2,0,2,63,849,5,35,5.277235839,0,2,1460,11,4882,0,4882,173284,0,173284,1384,0,1384,0,95.43621858,Arch
65,3519,3272,247,6791,0,2,2,62,334,5,35,5.282751908,371,1,1469,21,4900,42,4858,174841,1691,173150,1377,18,1359,0,95.43621858,Arch
66,3270,3517,247,6787,2,0,2,63,845,5,35,5.279561993,0,2,1461,12,4957,0,4957,175175,0,175175,1409,0,1409,0,95.43621858,Arch
65,3519,3272,247,6791,0,2,2,62,334,5,35,5.282751908,371,1,1470,22,4900,42,4858,174841,1691,173150,1377,18,1359,0,95.43621858,Arch
67,3375,3591,216,6966,3,0,3,64,849,5,36,5.314625447,0,2,52,2,4894,0,4894,173890,0,173890,1389,0,1389,0,95.40229885,Arch
67,3594,3378,216,6972,0,3,3,62,322,5,36,5.319998809,432,1,47,1,4914,48,4866,175401,1914,173487,1379,20,1359,1,96.41829229,Arch
69,3388,3591,203,6979,5,0,5,64,855,5,38,5.325754221,0,2,399,11,4960,0,4960,175592,0,175592,1414,0,1414,0,96.41829229,Arch
67,3594,3378,216,6972,0,3,3,62,322,5,36,5.319998809,432,1,395,10,4914,48,4866,175401,1914,173487,1379,20,1359,0,96.41829229,Arch
71,3418,3593,175,7011,6,0,6,64,805,5,38,5.344302466,0,2,400,12,4978,0,4978,176387,0,176387,1430,0,1430,0,96.42253392,Arch
67,3594,3378,216,6972,0,3,3,62,322,5,36,5.319998809,432,1,396,11,4914,48,4866,175401,1914,173487,1379,20,1359,0,96.43607786,Arch
67,3375,3591,216,6966,3,0,3,64,849,5,36,5.314625447,0,2,1462,13,4894,0,4894,173890,0,173890,1389,0,1389,0,96.43607786,Arch
5,228,118,110,346,1,1,2,9,498,1,4,1.365397349,108,1,9,3,76,9,67,3682,477,3205,30,4,26,1,97.67866458,Arch
74,3674,1546,2128,5220,15,0,15,15,967,2,16,4.948043309,0,3,2,0,2050,0,2050,111318,0,111318,1023,0,1023,0,92.04522579,Arch
78,1770,3869,2099,5639,2,5,7,76,570,2,19,5.063213901,1646,2,120,6,2149,227,1922,112207,11380,100827,988,163,825,1,92.00979899,Arch
79,3865,1769,2096,5634,15,1,16,15,720,2,20,5.07444485,108,3,94,9,2213,9,2204,119817,477,119340,1066,4,1062,1,92.00979899,Arch
77,1770,3868,2098,5638,2,8,10,14,580,2,18,5.061645867,2292,2,94,9,1925,227,1698,105589,11380,94209,923,163,760,1,92.00979899,Arch
85,4063,1766,2297,5829,21,1,22,38,729,5,24,5.1918078,108,5,1757,20,2598,9,2589,139586,477,139109,1254,4,1250,3,92.00979899,Arch
77,1770,3868,2098,5638,2,8,10,14,580,2,18,5.061645867,2292,2,1756,19,1925,227,1698,105589,11380,94209,923,163,760,3,92.00979899,Arch
78,3868,1771,2097,5639,15,1,16,15,730,2,19,5.076579706,108,3,95,10,2134,9,2125,116520,477,116043,1059,4,1055,1,92.00979899,Arch
77,1770,3868,2098,5638,2,8,10,14,580,2,18,5.061645867,2292,2,95,10,1925,227,1698,105589,11380,94209,923,163,760,1,92.00979899,Arch
81,3902,1786,2116,5688,15,1,16,40,724,2,21,5.117423911,108,3,621,10,2601,9,2592,134305,477,133828,1194,4,1190,1,92.00671141,Arch
77,1770,3868,2098,5638,2,8,10,14,580,2,18,5.061645867,2292,2,621,10,1925,227,1698,105589,11380,94209,923,163,760,1,92.01033522,Arch
80,3901,1774,2127,5675,16,1,17,15,776,2,21,5.105776342,108,3,622,10,2152,9,2143,118435,477,117958,1075,4,1071,1,92.01033522,Arch
77,1770,3868,2098,5638,2,8,10,14,580,2,18,5.061645867,2292,2,622,10,1925,227,1698,105589,11380,94209,923,163,760,1,92.01033522,Arch
78,3875,1777,2098,5652,15,1,16,15,731,2,19,5.083775618,108,3,96,9,2128,9,2119,116749,477,116272,1052,4,1048,0,92.01033522,Arch
77,1770,3868,2098,5638,2,8,10,14,580,2,18,5.061645867,2292,2,96,9,1925,227,1698,105589,11380,94209,923,163,760,0,92.01033522,Arch
77,3862,1764,2098,5626,15,1,16,15,731,2,18,5.064736824,108,3,1758,16,2105,9,2096,114900,477,114423,1043,4,1039,0,92.01033522,Arch
77,1770,3868,2098,5638,2,8,10,14,580,2,18,5.061645867,2292,2,623,9,1925,227,1698,105589,11380,94209,923,163,760,1,92.01033522,Arch
84,3863,1774,2089,5637,15,1,16,41,742,3,25,5.08042868,108,2,1760,14,2447,9,2438,125867,477,125390,1165,4,1161,0,92.01033522,Arch
84,1780,3869,2089,5649,8,8,16,41,572,3,25,5.077316388,2292,2,11,2,2266,227,2039,116602,11380,105222,1045,163,882,1,92.01033522,Arch
86,3871,1775,2096,5646,16,1,17,42,725,3,27,5.090659937,108,2,186,5,2479,9,2470,126894,477,126417,1176,4,1172,1,92.01033522,Arch
85,1780,3871,2091,5651,8,8,16,41,584,3,26,5.080087371,2292,2,187,6,2339,227,2112,118561,11380,107181,1082,163,919,1,92.01033522,Arch
78,3862,1786,2076,5648,15,1,16,40,731,2,19,5.081794761,108,3,112,3,2179,9,2170,117099,477,116622,1065,4,1061,1,91.98755617,Arch
79,1800,3877,2077,5677,3,8,11,39,573,3,20,5.08949107,2292,2,624,3,2017,227,1790,108466,11380,97086,952,163,789,0,91.98755617,Arch
82,3871,1779,2092,5650,15,1,16,28,736,3,22,5.085361816,108,3,1761,8,2328,9,2319,121060,477,120583,1112,4,1108,0,92.00055312,Arch
78,1778,3877,2099,5655,2,8,10,14,584,3,19,5.072521751,2292,2,1761,9,1938,227,1711,106161,11380,94781,928,163,765,0,92.00055312,Arch
148,3871,8461,4590,12332,15,69,84,15,1690,5,46,6.505828114,6795,2,122,1,2118,649,1469,115465,31087,84378,1048,328,720,1,91.5979862,Arch
148,8468,3878,4590,12346,72,8,80,14,425,5,46,6.504236405,2292,1,12,3,2582,227,2355,137064,11380,125684,1254,163,1091,1,91.5979862,Arch
149,3878,8462,4584,12340,16,71,87,15,1691,5,46,6.508838231,6797,2,123,2,2140,649,1491,116427,31087,85340,1054,328,726,1,91.5979862,Arch
148,8468,3878,4590,12346,72,8,80,14,425,5,46,6.504236405,2292,1,121,1,2582,227,2355,137064,11380,125684,1254,163,1091,1,91.5979862,Arch
148,3872,8462,4590,12334,15,71,86,15,1690,5,46,6.505948853,6797,2,44,0,2122,649,1473,115760,31087,84673,1050,328,722,1,91.5979862,Arch
148,8468,3878,4590,12346,72,8,80,14,425,5,46,6.504236405,2292,1,44,0,2582,227,2355,137064,11380,125684,1254,163,1091,1,91.5979862,Arch
148,3953,8448,4495,12401,15,71,86,15,1682,5,46,6.508388788,6797,2,6,2,2133,649,1484,116390,31087,85303,1055,328,727,0,91.5979862,Arch
146,8395,3941,4454,12336,72,8,80,14,435,5,46,6.489945387,2345,1,45,1,2574,234,2340,136800,11807,124993,1248,166,1082,0,91.5979862,Arch
146,3935,8389,4454,12324,15,71,86,16,1678,5,46,6.491645776,6797,2,46,2,2137,649,1488,117911,31087,86824,1059,328,731,0,91.5979862,Arch
146,8395,3941,4454,12336,72,8,80,14,435,5,46,6.489945387,2345,1,122,2,2574,234,2340,136800,11807,124993,1248,166,1082,1,91.5979862,Arch
147,3971,8389,4418,12360,16,71,87,16,1677,5,47,6.501468336,6797,2,97,0,2159,649,1510,121672,31087,90585,1075,328,747,0,91.5979862,Arch
146,8395,3941,4454,12336,72,8,80,14,435,5,46,6.489945387,2345,1,97,0,2574,234,2340,136800,11807,124993,1248,166,1082,0,91.5979862,Arch
148,3935,8398,4463,12333,15,71,86,27,1676,6,48,6.496288377,6797,2,125,3,2297,649,1648,125278,31087,94191,1089,328,761,1,91.5979862,Arch
148,8404,3941,4463,12345,74,8,82,26,425,6,48,6.494585738,2345,1,98,1,2735,234,2501,144215,11807,132408,1278,166,1112,1,91.5979862,Arch
149,3942,8399,4457,12341,15,71,86,27,1676,7,49,6.499877785,6797,2,37,0,2306,649,1657,125626,31087,94539,1091,328,763,1,91.5979862,Arch
148,8404,3941,4463,12345,74,8,82,26,425,6,48,6.494585738,2345,1,37,0,2735,234,2501,144215,11807,132408,1278,166,1112,1,91.5979862,Arch
149,4067,8517,4450,12584,15,71,86,27,1676,7,49,6.507850682,6797,2,1762,2,2358,649,1709,127455,31087,96368,1095,328,767,0,91.5979862,Arch
149,8523,4073,4450,12596,74,8,82,26,425,7,49,6.506198634,2345,1,1762,5,2793,234,2559,146327,11807,134520,1283,166,1117,1,91.5979862,Arch
150,4080,8518,4438,12598,15,71,86,59,1669,7,50,6.513126624,6797,2,99,2,2605,649,1956,135391,31087,104304,1178,328,850,0,91.5979862,Arch
149,8523,4073,4450,12596,74,8,82,26,425,7,49,6.506198634,2345,1,99,2,2793,234,2559,146327,11807,134520,1283,166,1117,0,91.5979862,Arch
149,4067,8517,4450,12584,15,71,86,27,1676,7,49,6.507850682,6797,2,126,4,2358,649,1709,127455,31087,96368,1095,328,767,1,91.5979862,Arch
149,8523,4073,4450,12596,74,8,82,26,425,7,49,6.506198634,2345,1,123,2,2793,234,2559,146327,11807,134520,1283,166,1117,1,91.5979862,Arch
149,4067,8517,4450,12584,15,71,86,27,1676,7,49,6.507850682,6797,2,127,5,2358,649,1709,127455,31087,96368,1095,328,767,1,91.5979862,Arch
149,8523,4073,4450,12596,74,8,82,26,425,7,49,6.506198634,2345,1,124,3,2793,234,2559,146327,11807,134520,1283,166,1117,1,91.5979862,Arch
149,4067,8517,4450,12584,15,71,86,27,1676,7,49,6.507850682,6797,2,1764,3,2358,649,1709,127455,31087,96368,1095,328,767,1,91.5979862,Arch
149,8523,4073,4450,12596,74,8,82,26,425,7,49,6.506198634,2345,1,1763,3,2793,234,2559,146327,11807,134520,1283,166,1117,1,91.5979862,Arch
149,4067,8517,4450,12584,15,71,86,27,1676,7,49,6.507850682,6797,2,128,6,2358,649,1709,127455,31087,96368,1095,328,767,1,91.5979862,Arch
149,8523,4073,4450,12596,74,8,82,26,425,7,49,6.506198634,2345,1,125,4,2793,234,2559,146327,11807,134520,1283,166,1117,1,91.5979862,Arch
149,4067,8517,4450,12584,15,71,86,27,1676,7,49,6.507850682,6797,2,47,3,2358,649,1709,127455,31087,96368,1095,328,767,0,91.5979862,Arch
149,8523,4073,4450,12596,74,8,82,26,425,7,49,6.506198634,2345,1,46,2,2793,234,2559,146327,11807,134520,1283,166,1117,0,91.5979862,Arch
149,4067,8517,4450,12584,15,71,86,27,1676,7,49,6.507850682,6797,2,48,4,2358,649,1709,127455,31087,96368,1095,328,767,0,91.5979862,Arch
149,8523,4073,4450,12596,74,8,82,26,425,7,49,6.506198634,2345,1,47,3,2793,234,2559,146327,11807,134520,1283,166,1117,0,91.5979862,Arch
149,4087,8517,4430,12604,15,71,86,27,1674,7,49,6.506398834,6797,2,49,5,2358,649,1709,127455,31087,96368,1095,328,767,0,91.5979862,Arch
149,8523,4073,4450,12596,74,8,82,26,427,7,49,6.506198634,2345,1,48,4,2793,234,2559,146327,11807,134520,1283,166,1117,0,91.5979862,Arch
149,4067,8517,4450,12584,15,71,86,27,1674,7,49,6.507850682,6797,2,1765,4,2358,649,1709,127455,31087,96368,1095,328,767,1,91.5979862,Arch
149,8523,4073,4450,12596,74,8,82,26,427,7,49,6.506198634,2345,1,1764,4,2793,234,2559,146327,11807,134520,1283,166,1117,1,91.5979862,Arch
155,4866,8464,3598,13330,21,69,90,27,1561,7,51,6.584669805,6721,2,625,1,2446,646,1800,131614,30959,100655,1124,325,799,1,91.56981076,Arch
160,8369,5121,3248,13490,67,14,81,26,395,7,55,6.6229087,3112,1,100,3,2793,320,2473,146451,15863,130588,1283,193,1090,1,91.56981076,Arch
155,4866,8464,3598,13330,21,64,85,27,1561,7,51,6.584669805,6501,2,627,3,2446,646,1800,131614,30959,100655,1124,325,799,1,91.56981076,Arch
160,8369,5121,3248,13490,67,14,81,26,395,7,55,6.6229087,3112,1,1765,5,2793,320,2473,146451,15863,130588,1283,193,1090,1,91.56981076,Arch
155,4865,8464,3599,13329,21,64,85,27,1561,7,51,6.584720821,6501,2,1767,6,2446,646,1800,131612,30959,100653,1124,325,799,0,91.56981076,Arch
160,8369,5120,3249,13489,67,14,81,26,395,7,55,6.62296067,3111,1,126,5,2793,320,2473,146451,15861,130590,1283,193,1090,1,91.56981076,Arch
155,4865,8464,3599,13329,21,64,85,27,1561,7,51,6.584720821,6501,2,628,4,2446,646,1800,131612,30959,100653,1124,325,799,1,91.56981076,Arch
167,8774,5212,3562,13986,72,13,85,26,381,7,56,6.70960711,2293,1,44,0,2817,242,2575,147895,11242,136653,1302,148,1154,1,91.53230311,Arch
155,4891,8502,3611,13393,21,64,85,27,1557,7,51,6.592853262,6501,2,44,0,2445,646,1799,131366,30959,100407,1123,325,798,1,91.56648926,Arch
160,8407,5190,3217,13597,67,11,78,26,395,7,55,6.629878545,2616,1,625,1,2793,328,2465,146451,16182,130269,1283,194,1089,1,91.56648926,Arch
5,112,4,108,116,4,0,4,82,290,2,3,1.404913477,0,6,1039,2,841,0,841,32621,0,32621,406,0,406,1,96.23811492,Arch
1,27,16,11,43,0,0,0,7,251,1,1,0.0,0,5,682,6,48,0,48,1428,0,1428,19,0,19,2,97.6768501,Arch
3,26,17,9,43,1,0,1,10,890,2,3,1.365201272,0,3,1321,21,153,0,153,4547,0,4547,36,0,36,1,95.65161207,Arch
6,496,94,402,590,5,0,5,73,143,2,3,1.819860782,0,1,539,3,336,0,336,11374,0,11374,54,0,54,1,96.55107896,Arch
34,392,0,392,392,34,0,34,1,0,1,7,2.72319443,0,1,1331,19,899,0,899,32598,0,32598,467,0,467,1,95.1316645,Arch
5,31,6,25,37,3,0,3,18,780,2,4,2.039801005,0,3,356,0,93,0,93,5477,0,5477,47,0,47,1,95.47997439,Arch
7,404,246,158,650,0,0,0,124,529,1,7,1.945498492,0,2,1335,17,642,0,642,36296,0,36296,222,0,222,1,94.71890003,Arch
4,181,4,177,185,2,0,2,11,456,3,4,0.866084366,0,1,499,10,112,0,112,4067,0,4067,24,0,24,1,94.26880719,Arch
23,1969,58,1911,2027,17,0,17,28,209,2,10,3.967662873,0,1,1339,7,432,0,432,18206,0,18206,171,0,171,1,97.24396362,Arch
31,655,640,15,1295,0,0,0,87,64,1,4,4.147865312,0,1,564,17,1808,0,1808,54131,0,54131,272,0,272,0,94.67818171,Arch
280,2639,2611,28,5250,0,0,0,86,207,4,90,7.104122895,0,1,557,10,7009,0,7009,343596,0,343596,2141,0,2141,1,94.62381258,Arch
38,466,576,110,1042,0,2,2,127,824,2,23,4.661556328,74,2,1352,13,1816,0,1816,85778,125,85653,692,0,692,1,95.16091821,Arch
334,3523,3562,39,7085,2,3,5,126,592,5,116,7.425498966,132,10,565,18,9346,4,9342,453923,232,453691,3018,4,3014,0,93.00339758,Arch
349,3622,3735,113,7357,3,2,5,127,242,5,123,7.495769679,132,10,1354,13,10044,14,10030,487454,497,486957,3423,13,3410,1,92.98857486,Arch
353,3727,3708,19,7435,3,1,4,126,584,5,127,7.513754842,56,10,517,4,10248,4,10244,494530,232,494298,3501,4,3497,0,92.98857486,Arch
357,3720,3886,166,7606,6,2,8,127,253,5,129,7.533500492,132,10,76,3,10291,14,10277,497160,497,496663,3524,13,3511,1,92.97502029,Arch
365,3913,3872,41,7785,4,2,6,126,534,5,132,7.554992897,91,10,566,19,10625,8,10617,506636,501,506135,3635,8,3627,0,92.969431,Arch
41,794,162,632,956,17,0,17,89,0,1,5,4.86977578,0,1,569,22,2133,0,2133,73277,0,73277,331,0,331,0,96.91716136,Arch
122,645,11949,11304,12594,1,63,64,90,977,1,7,6.443133141,7694,1,570,22,2006,1308,698,72364,47632,24732,352,641,289,0,95.32107749,Arch
453,15453,5008,10445,20461,93,3,96,127,290,5,135,7.729049839,209,10,558,10,11905,20,11885,554613,874,553739,4271,16,4255,0,93.52771181,Arch
452,4920,15589,10669,20509,5,84,89,126,643,5,135,7.727163063,11357,10,571,23,10611,1336,9275,509534,49121,460413,3653,660,2993,0,93.59469275,Arch
454,15455,5050,10405,20505,93,3,96,127,288,5,136,7.730321291,219,10,523,10,12132,20,12112,560063,876,559187,4320,16,4304,1,93.59469275,Arch
453,5079,15621,10542,20700,5,84,89,126,640,5,136,7.725814236,11357,10,572,22,10870,1336,9534,515768,49121,466647,3707,660,3047,0,93.59469275,Arch
457,15611,5217,10394,20828,93,3,96,127,293,5,137,7.742573251,219,10,229,0,12262,20,12242,564783,876,563907,4355,16,4339,1,93.57745673,Arch
459,5173,15930,10757,21103,5,87,92,126,628,5,139,7.759813655,11535,10,573,21,10983,1344,9639,520235,49866,470369,3735,666,3069,0,93.5587209,Arch
462,15820,5320,10500,21140,97,3,100,127,291,6,141,7.768104004,219,10,524,7,12341,20,12321,567692,876,566816,4383,16,4367,1,93.5587209,Arch
458,5194,15782,10588,20976,5,84,89,126,634,6,139,7.748468876,11357,10,574,22,11052,1336,9716,522327,49111,473216,3757,660,3097,0,93.26970497,Arch
462,15674,5341,10333,21015,94,3,97,127,291,6,142,7.757868363,219,10,61,0,12985,20,12965,584477,876,583601,4528,16,4512,1,93.26970497,Arch
461,5215,15814,10599,21029,5,84,89,126,629,6,142,7.755957459,11357,10,578,26,11704,1336,10368,540001,49111,490890,3908,660,3248,0,93.26970497,Arch
466,15700,5368,10332,21068,94,3,97,127,287,6,145,7.765165762,219,10,62,1,13126,20,13106,588691,876,587815,4582,16,4566,0,93.26970497,Arch
16,288,240,48,528,4,0,4,128,484,2,9,2.619859052,0,6,1360,12,1438,0,1438,64704,0,64704,573,0,573,1,93.86001304,Arch
481,5506,16258,10752,21764,5,85,90,126,606,6,147,7.810608139,11408,10,579,27,13185,1339,11846,594035,49338,544697,4621,663,3958,0,94.03714886,Arch
483,16146,5641,10505,21787,102,3,105,128,287,6,148,7.818324898,219,10,281,0,14539,20,14519,641809,876,640933,5261,16,5245,1,94.03714886,Arch
492,5563,16619,11056,22182,7,87,94,126,599,7,155,7.851114832,11554,10,581,26,14032,1346,12686,621014,49925,571089,4854,668,4186,0,94.00663012,Arch
492,16295,5700,10595,21995,102,3,105,128,287,7,153,7.843487649,219,10,566,11,15392,20,15372,668103,876,667227,5492,16,5476,0,94.02402205,Arch
491,5577,16438,10861,22015,7,85,92,126,595,7,153,7.841224566,11408,10,587,32,14066,1339,12727,621548,49338,572210,4860,663,4197,0,94.02402205,Arch
493,16515,5702,10813,22217,103,3,106,128,289,7,154,7.84600204,219,10,569,13,15412,20,15392,669949,876,669073,5501,16,5485,1,94.02402205,Arch
492,5579,16441,10862,22020,7,84,91,126,595,7,153,7.842314682,10916,10,589,32,14157,1339,12818,623944,47622,576322,4882,663,4219,1,94.02402205,Arch
493,16298,5702,10596,22000,101,3,104,128,287,7,153,7.844577944,219,10,283,2,15487,20,15467,670531,876,669655,5514,16,5498,1,94.02402205,Arch
493,5588,16457,10869,22045,7,85,92,126,592,7,153,7.844148512,11408,10,591,34,14188,1339,12849,625049,49338,575711,4888,663,4225,0,94.02402205,Arch
493,16425,5737,10688,22162,100,3,103,129,287,7,153,7.854098117,219,10,1365,13,15527,20,15507,671829,876,670953,5520,16,5504,0,94.02402205,Arch
492,5614,16568,10954,22182,7,82,89,126,592,7,153,7.851852339,11154,10,593,28,14181,1305,12876,624515,48146,576369,4884,654,4230,0,94.02402205,Arch
494,16465,5738,10727,22203,101,3,104,129,292,7,154,7.85893682,219,10,574,16,15549,20,15529,674164,876,673288,5531,16,5515,0,94.02402205,Arch
492,5614,16568,10954,22182,7,85,92,126,592,7,153,7.851852339,11408,10,594,29,14183,1339,12844,624541,49350,575191,4884,663,4221,0,94.02402205,Arch
493,16430,5751,10679,22181,100,3,103,129,292,7,153,7.856034142,219,10,575,17,15529,20,15509,671897,876,671021,5520,16,5504,0,94.02402205,Arch
492,5628,16573,10945,22201,7,85,92,126,592,7,153,7.853788595,11408,10,599,33,14183,1339,12844,624597,49350,575247,4884,663,4221,0,94.02402205,Arch
495,16498,5752,10746,22250,101,3,104,129,291,7,155,7.864478191,219,10,1366,9,15890,20,15870,683573,876,682697,5632,16,5616,1,93.89455727,Arch
494,5629,16641,11012,22270,7,86,93,126,586,7,155,7.86223604,11460,10,600,34,14538,1342,13196,635994,49549,586445,4993,665,4328,0,93.89455727,Arch
496,16501,5755,10746,22256,101,3,104,129,291,7,156,7.865943404,219,10,577,19,15922,20,15902,688204,876,687328,5659,16,5643,0,93.89455727,Arch
494,5629,16641,11012,22270,7,86,93,126,586,7,155,7.86223604,11460,10,601,35,14538,1342,13196,635994,49549,586445,4993,665,4328,0,93.89455727,Arch
495,16588,5787,10801,22375,101,3,104,129,289,7,155,7.868645093,219,10,578,20,15897,20,15877,683718,876,682842,5634,16,5618,0,93.87058669,Arch
497,5689,16760,11071,22449,7,86,93,126,583,7,155,7.876588965,11460,10,602,36,14687,1342,13345,642308,49549,592759,5069,665,4404,0,93.87058669,Arch
498,16603,5797,10806,22400,102,3,105,129,288,7,155,7.878318602,219,10,144,0,16050,20,16030,690164,876,689288,5711,16,5695,0,93.87058669,Arch
499,5678,16783,11105,22461,7,86,93,126,580,7,156,7.880934331,11460,10,606,39,14770,1342,13428,644288,49549,594739,5087,665,4422,0,93.87058669,Arch
500,16674,5801,10873,22475,102,3,105,129,286,7,156,7.88650567,219,10,582,24,16140,20,16120,692571,876,691695,5731,16,5715,0,93.87058669,Arch
499,5678,16783,11105,22461,7,86,93,126,580,7,156,7.880934331,11460,10,607,39,14772,1342,13430,644489,49549,594940,5087,665,4422,0,93.87058669,Arch
502,16817,5801,11016,22618,104,3,107,129,285,7,158,7.894012817,219,10,583,25,16149,20,16129,693363,876,692487,5737,16,5721,0,93.85518848,Arch
499,5678,16783,11105,22461,7,86,93,126,580,7,156,7.880934331,11460,10,608,39,14772,1342,13430,644489,49549,594940,5087,665,4422,0,93.87259726,Arch
501,16719,5802,10917,22521,103,3,106,129,286,7,157,7.889294636,219,10,200,1,16145,20,16125,692901,876,692025,5734,16,5718,1,93.86336056,Arch
508,5789,17540,11751,23329,7,87,94,126,558,7,159,7.925681323,11560,10,609,38,15413,1351,14062,662757,50264,612493,5270,673,4597,0,93.84938199,Arch
509,17398,5912,11486,23310,104,3,107,129,286,7,159,7.927715396,219,11,586,27,16870,20,16850,715015,876,714139,5951,16,5935,0,93.84938199,Arch
519,5820,17671,11851,23491,7,88,95,126,493,7,163,7.946782451,11615,2,611,38,15954,1351,14603,681392,50264,631128,5437,673,4764,0,93.8534124,Arch
521,17601,5955,11646,23556,106,3,109,130,292,7,163,7.952619824,219,3,1379,19,17451,20,17431,736153,876,735277,6145,16,6129,1,92.60950031,Arch
520,5832,17744,11912,23576,7,88,95,126,492,7,163,7.950489125,11615,2,612,39,15976,1351,14625,682930,50264,632666,5453,673,4780,1,92.61304053,Arch
521,17607,5959,11648,23566,106,3,109,130,292,7,163,7.95241009,219,3,538,14,17457,20,17437,736327,876,735451,6145,16,6129,0,92.61304053,Arch
523,5854,17781,11927,23635,7,88,95,126,492,7,166,7.955465799,11615,2,613,40,16078,1351,14727,686188,50264,635924,5504,673,4831,0,92.61304053,Arch
527,18031,5983,12048,24014,109,3,112,130,285,7,169,7.959197756,219,3,590,28,17585,20,17565,742089,876,741213,6208,16,6192,0,92.59876029,Arch
524,5860,17787,11927,23647,7,88,95,126,491,7,167,7.957714508,11615,2,615,41,16080,1351,14729,686496,50264,636232,5505,673,4832,0,92.6153182,Arch
526,17747,6002,11745,23749,107,3,110,130,285,7,167,7.966209156,219,3,1383,23,17773,20,17753,746706,876,745830,6264,16,6248,1,92.60882989,Arch
530,5937,18167,12230,24104,7,88,95,126,491,7,170,7.985759979,11615,2,616,29,16490,1351,15139,699902,50264,649638,5609,673,4936,0,92.60219835,Arch
534,18294,6064,12230,24358,111,3,114,131,289,7,170,7.995671694,219,3,1384,19,18145,20,18125,757778,876,756902,6375,16,6359,1,92.59339302,Arch
535,5941,18477,12536,24418,7,89,96,126,485,7,171,7.999102559,11784,2,523,0,16563,1381,15182,702003,50928,651075,5629,703,4926,0,92.58767597,Arch
539,18323,6076,12247,24399,112,3,115,132,283,7,171,8.003685522,219,3,1385,20,18565,20,18545,770569,876,769693,6526,16,6510,0,92.58767597,Arch
538,5957,18492,12535,24449,7,89,96,126,483,7,171,8.002251085,11789,2,617,24,16977,1381,15596,714608,50928,663680,5777,703,5074,0,92.58767597,Arch
540,18324,6093,12231,24417,112,3,115,132,283,7,172,8.003900727,219,3,204,4,18618,20,18598,776003,876,775127,6554,16,6538,0,92.58767597,Arch
543,5978,18966,12988,24944,7,90,97,126,478,7,172,8.029146839,11913,2,618,24,17049,1403,15646,720448,51699,668749,5808,708,5100,0,92.57554224,Arch
543,18807,6167,12640,24974,115,3,118,132,282,7,172,8.02662878,209,3,1386,20,18693,20,18673,778449,876,777573,6579,16,6563,1,92.57554224,Arch
574,7322,19680,12358,27002,12,98,110,126,456,7,183,8.081647371,12497,2,619,10,17878,1451,16427,766085,53947,712138,6174,733,5441,0,92.62228138,Arch
575,19349,7545,11804,26894,120,7,127,134,258,7,184,8.076853002,1420,3,236,5,19554,88,19466,821588,7311,814277,6916,70,6846,1,92.62228138,Arch
4,215,29,186,244,1,0,1,14,263,1,3,1.535398149,0,1,553,18,184,0,184,6750,0,6750,67,0,67,0,95.82212326,Arch
585,7930,20349,12419,28279,14,94,108,126,449,7,188,8.102472934,12349,2,620,8,18222,1467,16755,781543,54582,726961,6269,749,5520,0,93.55254472,Arch
6,1046,26,1020,1072,5,0,5,2,0,1,2,2.296085547,0,1,621,9,47,0,47,9921,0,9921,45,0,45,0,96.4254472,Arch
589,20002,9170,10832,29172,123,11,134,136,267,7,188,8.094715457,2270,3,591,2,19912,131,19781,835710,16993,818717,7045,111,6934,0,94.00998336,Arch
589,8950,20349,11399,29299,18,95,113,126,441,7,188,8.101665525,12484,2,622,9,18252,1467,16785,788197,54582,733615,6297,749,5548,0,94.00998336,Arch
592,20311,9226,11085,29537,122,13,135,137,268,7,188,8.085191284,2911,3,1395,13,20099,131,19968,841551,16993,824558,7120,111,7009,1,94.00998336,Arch
597,9511,20637,11126,30148,23,95,118,126,437,7,191,8.115309306,12484,2,623,8,18424,1467,16957,794815,54582,740233,6362,749,5613,0,93.97234115,Arch
597,20319,9715,10604,30034,121,18,139,138,262,7,190,8.111075472,3404,3,1396,13,20099,152,19947,841512,19114,822398,7120,124,6996,1,93.97234115,Arch
597,9595,20693,11098,30288,23,95,118,126,437,7,191,8.116145164,12504,2,624,8,18426,1467,16959,795017,54582,740435,6362,749,5613,0,93.97234115,Arch
599,20496,10045,10451,30541,121,15,136,139,251,7,190,8.109592566,2275,3,558,12,20185,157,20028,843960,20545,823415,7154,127,7027,1,93.98392016,Arch
600,9942,20953,11011,30895,23,95,118,126,432,7,191,8.107194518,12504,2,626,10,18522,1467,17055,799909,54582,745327,6411,749,5662,0,93.98392016,Arch
600,20715,10136,10579,30851,121,18,139,141,252,7,190,8.098119498,3685,3,1401,17,20246,161,20085,845957,21160,824797,7192,129,7063,1,93.98392016,Arch
2,53,2,51,55,1,0,1,11,89,2,2,0.988283611,0,3,208,4,158,0,158,11914,0,11914,73,0,73,1,95.06304498,Arch
604,9949,21137,11188,31086,23,95,118,126,431,7,193,8.114719787,12504,2,627,9,18781,1467,17314,808681,54582,754099,6498,749,5749,1,91.24311637,Arch
604,20837,10148,10689,30985,121,18,139,142,251,7,192,8.111222571,3685,3,1404,18,20520,161,20359,855553,21160,834393,7284,129,7155,1,91.24311637,Arch
610,10245,21409,11164,31654,25,96,121,126,427,7,197,8.134792377,12714,2,628,9,18992,1490,17502,817365,56260,761105,6595,761,5834,0,91.22706767,Arch
612,21225,10461,10764,31686,123,20,143,143,257,7,197,8.135049183,3969,3,1407,20,20794,168,20626,866153,22767,843386,7415,136,7279,1,91.22706767,Arch
3,227,7,220,234,1,0,1,14,83,1,1,0.561709905,0,1,1409,16,294,0,294,9202,0,9202,186,0,186,1,92.59210913,Arch
616,10599,21784,11185,32383,26,97,123,126,425,7,198,8.145939444,12925,2,629,10,19080,1522,17558,822431,57144,765287,6643,793,5850,0,91.24496193,Arch
616,21494,10797,10697,32291,125,21,146,143,253,7,197,8.141401299,4210,3,1411,18,20886,178,20708,869314,24369,844945,7475,141,7334,1,91.24496193,Arch
616,10703,22041,11338,32744,26,97,123,126,425,7,198,8.14675344,12925,2,630,11,19029,1522,17507,821926,57144,764782,6640,793,5847,0,91.23065114,Arch
616,21727,10900,10827,32627,124,21,145,143,253,7,197,8.14138158,4307,3,1413,20,20886,181,20705,869318,24996,844322,7475,144,7331,1,91.23065114,Arch
617,10910,22046,11136,32956,27,97,124,126,425,7,198,8.148729077,12925,2,631,12,19047,1522,17525,823070,57144,765926,6645,793,5852,0,91.22964195,Arch
617,21730,11108,10622,32838,124,22,146,144,253,7,197,8.142455365,4512,3,210,3,20886,199,20687,869318,26140,843178,7475,149,7326,1,91.22964195,Arch
617,10903,22047,11144,32950,27,97,124,126,425,7,198,8.148655189,12925,2,632,12,19051,1522,17529,823676,57144,766532,6647,793,5854,0,91.22964195,Arch
620,21757,11449,10308,33206,125,22,147,144,251,7,198,8.152875503,4331,3,592,1,20899,256,20643,870347,28637,841710,7482,165,7317,1,91.22728436,Arch
619,11252,22047,10795,33299,29,97,126,126,424,7,198,8.156085756,12925,2,634,14,19104,1522,17582,825567,57144,768423,6661,793,5868,1,91.22728436,Arch
619,21741,11462,10279,33203,124,24,148,144,251,7,197,8.151653712,4853,3,593,2,20885,256,20629,869322,28637,840685,7475,165,7310,1,91.22728436,Arch
619,11252,22047,10795,33299,29,97,126,126,424,7,198,8.156085756,12925,2,635,15,19103,1522,17581,825571,57144,768427,6661,793,5868,1,91.22728436,Arch
3,548,0,548,548,3,0,3,3,1,1,2,0.993651727,0,1,637,17,53,0,53,4069,0,4069,19,0,19,0,94.41302701,Arch
621,21763,12001,9762,33764,124,22,146,144,248,7,197,8.154783023,4023,3,1414,19,20889,296,20593,869564,31965,837599,7478,180,7298,1,90.54236738,Arch
621,11804,22080,10276,33884,31,97,128,126,423,7,198,8.160851796,12925,2,639,17,19143,1522,17621,828899,57144,771755,6676,793,5883,0,90.54236738,Arch
621,21776,12007,9769,33783,124,26,150,146,248,7,197,8.154663733,5401,3,1416,21,20893,296,20597,869630,31965,837665,7478,180,7298,1,90.54236738,Arch
623,12852,22114,9262,34966,33,97,130,126,422,7,198,8.139659405,12925,2,640,17,19289,1522,17767,834909,57144,777765,6719,793,5926,0,90.53436765,Arch
623,21798,13049,8749,34847,124,28,152,146,246,7,197,8.133572474,6443,3,1418,22,20898,442,20456,869775,37975,831800,7481,223,7258,1,90.53436765,Arch
628,12923,22210,9287,35133,33,97,130,126,424,7,198,8.15317349,12925,2,641,17,19472,1522,17950,845840,57144,788696,6853,793,6060,0,90.53436765,Arch
635,22123,13156,8967,35279,126,28,154,147,244,7,197,8.166037648,6441,3,1422,23,21163,442,20721,885332,37937,847395,7675,223,7452,1,90.52213394,Arch
636,12960,22441,9481,35401,33,99,132,126,418,7,198,8.172584548,13078,2,642,16,19540,1545,17995,849611,57767,791844,6903,805,6098,1,90.52213394,Arch
639,22443,13445,8998,35888,127,28,155,147,240,7,198,8.150804947,6441,3,1424,25,21302,442,20860,890331,37937,852394,7762,223,7539,1,90.52213394,Arch
647,13592,22958,9366,36550,33,101,134,126,405,7,203,8.16719276,13149,2,643,16,19860,1555,18305,860513,58292,802221,7062,812,6250,0,90.5126264,Arch
647,22657,13803,8854,36460,129,28,157,147,246,7,202,8.160026749,6775,3,563,4,21471,497,20974,895730,39912,855818,7849,234,7615,0,90.5126264,Arch
647,13590,22996,9406,36586,33,101,134,126,404,7,203,8.166547528,13192,2,645,18,19860,1553,18307,860509,58251,802258,7062,810,6252,0,90.5126264,Arch
648,22666,13803,8863,36469,130,28,158,147,245,7,202,8.161326552,6775,3,564,5,21482,497,20985,896378,39912,856466,7852,234,7618,1,90.5126264,Arch
655,14782,23166,8384,37948,35,101,136,126,405,7,204,8.104838341,13192,2,646,19,20018,1553,18465,875469,58251,817218,7170,810,6360,0,90.5126264,Arch
659,22996,15245,7751,38241,134,30,164,148,246,7,204,8.116906092,8156,3,1431,27,21666,544,21122,907093,49442,857651,7982,272,7710,1,90.50579871,Arch
659,15266,23335,8069,38601,37,101,138,126,405,7,205,8.105896843,13189,2,648,21,20080,1553,18527,881347,58234,823113,7222,810,6412,0,90.50579871,Arch
663,23083,15818,7265,38901,134,27,161,148,247,7,205,8.093145056,7911,3,1432,24,21802,572,21230,910513,53119,857394,8054,284,7770,1,90.4979455,Arch
664,15633,23532,7899,39165,36,101,137,126,403,7,206,8.102186862,13189,2,653,24,20275,1553,18722,888128,58234,829894,7325,810,6515,0,90.4979455,Arch
665,23224,15891,7333,39115,134,31,165,148,245,7,205,8.100762226,8743,3,1434,23,21875,573,21302,912960,53225,859735,8086,285,7801,0,90.49305293,Arch
670,15760,23848,8088,39608,37,102,139,126,400,7,207,8.128676433,13278,2,655,24,20383,1563,18820,891458,58653,832805,7379,813,6566,1,90.46962073,Arch
669,23399,15920,7479,39319,135,31,166,150,242,7,206,8.114746659,8743,3,1438,24,21984,573,21411,917127,53225,863902,8153,285,7868,1,90.48121399,Arch
673,16517,23752,7235,40269,41,101,142,126,399,7,208,8.127332954,13189,2,658,26,20452,1553,18899,896408,58234,838174,7411,810,6601,0,90.48455531,Arch
673,23413,16730,6683,40143,135,34,169,150,240,7,207,8.12106331,9538,3,567,8,21986,657,21329,917774,57668,860106,8154,312,7842,0,90.48455531,Arch
673,16517,23752,7235,40269,41,101,142,126,399,7,208,8.127332954,13189,2,659,27,20455,1553,18902,896452,58234,838218,7413,810,6603,0,90.48455531,Arch
674,23605,16873,6732,40478,134,34,168,151,240,7,207,8.121613475,9538,3,1440,26,22013,657,21356,918972,57668,861304,8169,312,7857,1,90.48455531,Arch
674,16660,23944,7284,40604,41,101,142,126,399,7,208,8.127865955,13189,2,660,25,20474,1553,18921,897245,58234,839011,7423,810,6613,1,90.48558381,Arch
675,23626,16891,6735,40517,134,34,168,153,238,7,208,8.122941602,9538,3,1442,28,22026,657,21369,920017,57668,862349,8176,312,7864,1,90.48558381,Arch
679,16701,24190,7489,40891,42,101,143,126,394,7,211,8.144716261,13058,2,662,21,20524,1561,18963,899746,58527,841219,7462,817,6645,0,90.15445069,Arch
679,23853,16915,6938,40768,137,34,171,154,242,7,210,8.138926977,9538,3,569,10,22087,657,21430,922664,57668,864996,8226,312,7914,0,90.15445069,Arch
679,16708,24192,7484,40900,42,102,144,126,394,7,211,8.144994657,13269,2,663,22,20524,1561,18963,899788,58527,841261,7462,817,6645,0,90.15445069,Arch
681,24019,16934,7085,40953,138,34,172,154,241,7,210,8.147806547,9544,3,1448,29,22487,657,21830,938554,57710,880844,8449,312,8137,1,90.15445069,Arch
679,16331,24379,8048,40710,40,102,142,126,394,7,211,8.150512929,13269,2,664,21,20885,1561,19324,912394,58527,853867,7662,817,6845,0,90.16129472,Arch
680,24046,16806,7240,40852,138,31,169,154,241,7,210,8.146867436,8738,3,571,9,22490,670,21820,938564,57366,881198,8450,305,8145,0,90.15637366,Arch
680,16593,24385,7792,40978,41,102,143,126,394,7,211,8.153025936,13269,2,666,23,20919,1561,19358,914379,58527,855852,7670,817,6853,1,90.15637366,Arch
680,24062,16806,7256,40868,138,33,171,154,241,7,210,8.148381382,9390,3,600,4,22492,670,21822,938676,57366,881310,8450,305,8145,0,90.15637366,Arch
8,51,28,23,79,1,0,1,155,76,1,5,2.738517422,0,1,1450,25,644,0,644,21632,0,21632,228,0,228,1,97.43132838,Arch
2,90,0,90,90,2,0,2,11,257,1,2,0.721928095,0,1,602,5,62,0,62,2694,0,2694,37,0,37,1,93.85490515,Arch
690,16793,24989,8196,41782,41,100,141,126,393,7,211,8.175830637,12709,2,667,18,21119,1566,19553,923522,58705,864817,7755,822,6933,0,92.63157895,Arch
690,24668,17008,7660,41676,140,33,173,157,245,7,210,8.16892948,9406,3,8,0,22768,671,22097,950338,57470,892868,8583,305,8278,0,92.63157895,Arch
690,16814,25008,8194,41822,41,102,143,126,393,7,211,8.175383224,13311,2,668,16,21122,1566,19556,923620,58705,864915,7755,822,6933,0,92.63157895,Arch
806,24670,17380,7290,42050,140,32,172,157,547,7,248,8.224906456,9197,3,572,5,24645,675,23970,1012695,57537,955158,9403,305,9098,0,92.63157895,Arch
11,107,23,84,130,3,0,3,158,25,1,7,3.143322885,0,2,1455,22,1275,0,1275,54357,0,54357,514,0,514,1,94.91829876,Arch
811,17186,25120,7934,42306,155,102,257,126,442,7,251,8.233513754,13308,2,670,15,23151,1566,21585,991241,58705,932536,8673,822,7851,0,91.38941353,Arch
833,26037,19057,6980,45094,150,37,187,158,524,7,251,8.284342286,10371,3,19,1,24896,745,24151,1023620,64733,958887,9552,343,9209,1,91.28361533,Arch
821,18441,25275,6834,43716,160,102,262,126,424,7,253,8.24312159,13308,2,673,14,23356,1566,21790,1005523,58705,946818,8760,822,7938,1,91.98777169,Arch
822,24947,19154,5793,44101,141,35,176,158,532,7,252,8.235153062,9795,3,604,6,24962,843,24119,1026459,67788,958671,9561,360,9201,1,91.98777169,Arch
822,18940,25282,6342,44222,161,102,263,126,420,7,253,8.240731859,13311,2,675,15,23455,1566,21889,1008662,58713,949949,8777,822,7955,1,91.98777169,Arch
822,24944,19154,5790,44098,141,39,180,158,532,7,252,8.234829769,11139,3,574,6,24962,843,24119,1026459,67788,958671,9561,360,9201,0,91.98777169,Arch
113,9115,0,9115,9115,113,0,113,2,0,3,36,6.457395933,0,1,68,2,773,0,773,40947,0,40947,426,0,426,1,96.80161038,Arch
4,270,37,233,307,2,0,2,18,134,2,2,1.142828746,0,1,605,7,212,0,212,6860,0,6860,34,0,34,1,95.99973897,Arch
957,19567,35088,15521,54655,165,215,380,126,357,9,300,8.629356135,22423,2,676,14,23960,2340,21620,1036365,99735,936630,9049,1249,7800,1,91.37901425,Arch
958,35145,19563,15582,54708,270,44,314,159,467,9,301,8.632293374,11575,3,1461,17,26313,898,25415,1099560,69415,1030145,10301,386,9915,1,91.37901425,Arch
960,20448,35151,14703,55599,167,231,398,126,352,9,301,8.627490915,23011,2,677,15,24124,2342,21782,1042685,99800,942885,9099,1251,7848,0,91.81752806,Arch
962,35177,20444,14733,55621,271,46,317,159,471,9,301,8.6300001,12454,3,1462,18,26332,1026,25306,1100365,73091,1027274,10316,409,9907,1,91.4554826,Arch
4,57,108,51,165,0,2,2,4,3823,1,1,1.933966953,106,3,582,13,0,0,0,270,175,95,0,0,0,0,94.50011585,Arch
968,20567,35249,14682,55816,169,231,400,126,352,9,303,8.640876672,23011,2,678,16,24239,2342,21897,1048256,99800,948456,9155,1251,7904,0,92.45525026,Arch
969,35352,20561,14791,55913,272,48,320,159,482,9,303,8.644258781,12560,3,12,4,26450,1026,25424,1105705,73266,1032439,10377,409,9968,1,92.44998005,Arch
989,20668,35488,14820,56156,169,232,401,126,357,9,315,8.652436388,23120,2,679,17,24848,2361,22487,1077339,100167,977172,9411,1269,8142,0,92.44363367,Arch
991,35490,20898,14592,56388,272,47,319,159,498,9,316,8.65429222,12371,3,214,2,27143,1016,26127,1138784,73609,1065175,10659,410,10249,1,92.44363367,Arch
991,20901,35494,14593,56395,169,232,401,126,357,9,316,8.654422098,23120,2,681,17,24915,2361,22554,1081954,100167,981787,9431,1269,8162,1,92.44363367,Arch
991,35487,20895,14592,56382,272,48,320,159,498,9,316,8.654412236,12692,3,14,6,27147,1016,26131,1138956,73609,1065347,10660,410,10250,1,92.44363367,Arch
425,16593,15462,1131,32055,39,88,127,103,566,4,101,7.448453939,11767,2,732,26,8240,1384,6856,435293,50284,385009,2627,674,1953,0,93.63553892,Arch
37,5481,0,5481,5481,37,0,37,1,0,1,10,4.578725401,0,1,287,1,624,0,624,24944,0,24944,392,0,392,1,95.53283394,Arch
3,167,7,160,174,1,0,1,7,435,1,2,1.440329879,0,2,293,6,50,0,50,2013,0,2013,27,0,27,1,97.47155499,Arch
17,1110,170,940,1280,6,0,6,32,593,1,8,3.240671008,0,4,18,0,678,0,678,30794,0,30794,320,0,320,0,93.20098536,Arch
13,390,30,360,420,5,0,5,14,378,1,7,3.487890269,0,1,1469,6,215,0,215,7775,0,7775,105,0,105,1,96.38052312,Arch
171,1458,1557,99,3015,39,5,44,69,862,7,81,4.679848055,427,3,607,9,7159,97,7062,277503,3919,273584,2464,34,2430,0,92.91225716,Arch
8,152,89,63,241,1,0,1,33,403,1,4,2.052843181,0,2,20,2,336,0,336,15889,0,15889,144,0,144,1,93.97030026,Arch
3,0,402,402,402,0,3,3,7,1187,1,1,1.375610759,402,3,21,3,0,70,70,0,1918,1918,0,21,21,1,94.88447867,Arch
1,1,1,0,2,0,0,0,17,3,1,1,0.0,0,3,616,9,141,0,141,4867,0,4867,40,0,40,1,95.78631816,Arch
6,46,127,81,173,2,0,2,75,214,1,6,1.740821298,0,8,880,25,370,0,370,18645,0,18645,195,0,195,0,96.63716814,Arch
32,506,46,460,552,7,0,7,120,296,3,13,3.600970609,0,1,964,11,2551,0,2551,90123,0,90123,433,0,433,0,91.06525376,Arch
64,217,866,649,1083,6,3,9,170,174,4,37,4.630127453,309,1,877,14,4369,20,4349,169894,1681,168213,1377,5,1372,0,91.36069114,Arch
64,870,222,648,1092,17,0,17,171,245,4,37,4.640950709,0,1,967,14,4468,0,4468,173939,0,173939,1392,0,1392,1,91.36069114,Arch
9,280,1096,816,1376,1,4,5,16,119,1,5,2.806183328,969,1,969,16,77,34,43,5731,4550,1181,43,31,12,0,91.14941576,Arch
20,1142,5774,4632,6916,1,8,9,42,230,1,11,3.805120238,4003,1,970,16,413,229,184,26167,24196,1971,131,111,20,0,91.18086283,Arch
2,67,0,67,67,2,0,2,9,218,1,1,0.953048347,0,1,991,20,59,0,59,1741,0,1741,11,0,11,0,94.83183857,Arch
2,24,135,111,159,0,0,0,2,1906,1,2,0.260452348,0,1,1755,24,21,0,21,876,0,876,16,0,16,1,90.94586736,Arch
3,2,36,34,38,0,1,1,8,1893,1,2,0.953013885,30,2,899,4,23,0,23,889,28,861,8,0,8,0,92.87836719,Arch
23,2,1412,1410,1414,0,4,4,99,873,2,8,3.407482097,1094,4,907,12,526,123,403,28884,6664,22220,156,47,109,0,92.44897317,Arch
14,493,14,479,507,13,0,13,14,176,2,14,3.557209402,0,1,191,1,114,0,114,4767,0,4767,42,0,42,1,93.64814041,Arch
5,7,4,3,11,1,0,1,7,2741,1,1,2.299896391,0,2,1775,3,17,0,17,1286,0,1286,17,0,17,0,94.98980978,Arch
3,184,16,168,200,1,0,1,15,44,1,2,1.040251567,0,6,192,2,57,0,57,3218,0,3218,34,0,34,1,94.97910793,Arch
6,210,9,201,219,4,0,4,4,140,1,4,1.613215109,0,1,1021,20,24,0,24,3645,0,3645,12,0,12,0,94.98281085,Arch
10,2,715,713,717,0,7,7,10,1234,1,5,2.925214351,598,2,1025,24,8,31,23,1666,3410,1744,4,18,14,0,94.96816805,Arch
