CommitID,NMF,TotalAddLines,TotalDeleteLines,LC,FileAdd,FileDelete,NAD,NDVE,NUC,AGE,NMS,NMD,Entropy ,MLMF,EXP,REXP,CommitComplexity,LastCommitComplexity,CFC,CommitTokenCount,LastCommitTokenCount,NCC,CommitMethodNum,LastCommitMethodNum,NMC,NIR,a2a,Tag
0a3e8490b64ad8466989726ac6215b357fed3152,1,2,3,1,0,0,0,1,7,0,1,1,0.0,427,539,0,53,53,0,1790,1786,4,20,20,0,0,100.0,NoArch
36ddd58a31045addfd9d984353956f7a99c09221,13,49,742,693,0,11,11,3,10,681,2,3,2.623494003,1315,591,7,51,71,20,3727,6804,3077,29,41,12,0,98.69992973,NoArch
83054b95dbcf4b28c54b728994f39c38815fb8de,0,0,0,0,0,0,0,0,0,0,0,0,0.0,0,128,4,0,0,0,0,0,0,0,0,0,0,100.0,NoArch
e657cf66bc54dec762f0355a56cf3b3504a960d9,1,1,1,0,0,0,0,1,2,0,1,1,0.0,382,494,1,46,46,0,1595,1595,0,18,18,0,0,100.0,NoArch
9450cfde68a2e166ef10a33ac5cc5cde4a855040,3,110,89,21,1,1,2,1,7,194,1,2,1.113690277,352,252,31,33,44,11,1190,1197,7,28,39,11,0,99.62686567,NoArch
3573df1ed5fe2d376e134b02fb188ee6f68a63c3,0,0,0,0,0,0,0,0,0,0,0,0,0.0,0,919,7,0,0,0,0,0,0,0,0,0,0,100.0,NoArch
e657cf66bc54dec762f0355a56cf3b3504a960d9,1,1,1,0,0,0,0,1,2,0,1,1,0.0,382,494,1,46,46,0,1595,1595,0,18,18,0,0,100.0,NoArch
b9ef74c8234e9a5d33b18f0c2b540a0a3a43e983,0,0,0,0,0,0,0,0,0,0,0,0,0.0,0,154,11,0,0,0,0,0,0,0,0,0,0,100.0,NoArch
4194c07aa72c2c05f1c11cabc1af25e0c5c3fedd,0,0,0,0,0,0,0,0,0,0,0,0,0.0,0,997,89,0,0,0,0,0,0,0,0,0,1,100.0,NoArch
6341a64a4bdf5d5577a36153f32a8bb60d059a84,0,0,0,0,0,0,0,0,0,0,0,0,0.0,0,317,61,0,0,0,0,0,0,0,0,0,0,100.0,NoArch
6e9fa2a4bac892c42ed85d1af658c5aff41ffbed,11,677,290,387,2,0,2,1,23,0,1,3,2.492213615,19823,272,53,3990,3921,69,118599,116574,2025,1935,1896,39,0,99.38016529,NoArch
e0d52ed35a6016ef317185a72d29310d1fad690e,0,0,0,0,0,0,0,0,0,0,0,0,0.0,0,964,38,0,0,0,0,0,0,0,0,0,0,100.0,NoArch
22b585b07679929aaf5249cd6e0d17ddce7f1b42,0,0,0,0,0,0,0,0,0,0,0,0,0.0,0,203,54,0,0,0,0,0,0,0,0,0,0,100.0,NoArch
5d569518ea617f30296fd3ca983034940a26529d,1,2,1,1,0,0,0,16,104,1,1,1,0.0,1063,1156,0,156,155,1,4538,4514,24,76,76,0,1,100.0,NoArch
59b78a98b328cc8bb229a9643efadfc07c2beff2,0,0,0,0,0,0,0,0,0,0,0,0,0.0,0,254,42,0,0,0,0,0,0,0,0,0,0,100.0,NoArch
6c109484293deb3ad375aed475e84176c46e0e13,3,87,23,64,1,0,1,1,13,139,1,1,1.007027071,346,621,18,40,36,4,1048,912,136,25,22,3,0,98.95931883,NoArch
fd058f91d9cad98ee4d744d46486fe43f7fe6418,1,0,40,40,0,0,0,1,25,7,1,1,0.0,732,894,16,34,38,4,4017,4222,205,13,14,1,0,100.0,NoArch
e8138ed9768e99e98e308845626e36aa55afadb0,5,81,52,29,1,0,1,4,24,85,2,5,1.927152838,2058,4,3,208,207,1,7168,7067,101,91,91,0,1,98.89638259,NoArch
1f995d968b006381272f51f90b73b19e17f7daed,0,0,0,0,0,0,0,0,0,0,0,0,0.0,0,35,12,0,0,0,0,0,0,0,0,0,0,100.0,NoArch
f4a5fdc35a28897c477f027537cdbf0dc3c95c16,1,23,23,0,0,0,0,1,14,26,1,1,0.0,545,335,4,58,58,0,2090,2104,14,19,19,0,0,100.0,NoArch
807c4eae68c10f806383dece81bd4598cbdb2600,3,129,49,80,0,0,0,1,23,95,1,3,1.358449643,1245,436,32,121,111,10,5726,5335,391,47,43,4,0,99.83766234,NoArch
a49b90c770717ab4c5c701678c21e033f8f73018,19,465,47,418,5,0,5,1,18,20,4,8,2.971728585,3152,230,21,208,183,25,17608,16166,1442,93,79,14,0,99.03474903,NoArch
b4da5f5ca279905097b1fe7d5eb9710c6dc8bdd2,2,20,4,16,0,0,0,2,27,18,1,2,0.650022422,1032,42,1,131,130,1,4500,4437,63,42,42,0,0,100.0,NoArch
dd59770046b8b27786b49e75994a07b8498f5549,0,0,0,0,0,0,0,0,0,0,0,0,0.0,0,647,21,0,0,0,0,0,0,0,0,0,0,100.0,NoArch
a274ce492edb3a74e7ae8774da5e64b4f0e53d2d,0,0,0,0,0,0,0,0,0,0,0,0,0.0,0,460,23,0,0,0,0,0,0,0,0,0,0,100.0,NoArch
3c000d45dd7c3d0fa411041d67510f768226ae76,1,49,0,49,1,0,1,1,1,0,1,1,0.0,0,4,0,3,0,3,89,0,89,3,0,3,0,99.4140625,NoArch
38b4e421baea5d8c0fb213dd15bd36bc8d82263c,1,2,2,0,0,0,0,1,13,20,1,1,0.0,326,166,22,37,37,0,1358,1358,0,13,13,0,0,100.0,NoArch
09c99c46a1fa5fc3982cf12c3fb8b3245555099d,1,1,1,0,0,0,0,1,9,25,1,1,0.0,311,502,16,22,21,1,1507,1501,6,15,15,0,0,100.0,NoArch
dc3028e0c6dd56b0ab1f13c0a8ed30f223ed4e8c,0,0,0,0,0,0,0,0,0,0,0,0,0.0,0,753,20,0,0,0,0,0,0,0,0,0,0,100.0,NoArch
ed796e2e6a777df0a44e7a3c3e2dd34867dd1952,0,0,0,0,0,0,0,0,0,0,0,0,0.0,0,590,46,0,0,0,0,0,0,0,0,0,0,100.0,NoArch
6bcd3e51cb67f11a38ff3e3a184838eb7da69137,0,0,0,0,0,0,0,0,0,0,0,0,0.0,0,208,51,0,0,0,0,0,0,0,0,0,0,100.0,NoArch
9654778a6a5c329d1f36ebdea32d68290850f96d,2,36,0,36,0,0,0,1,5,2,1,2,1.0,325,780,6,22,22,0,1538,1538,0,12,12,0,0,100.0,NoArch
ccd934ccae2e22bddbd49d5a49eb5adba477a5b0,0,0,0,0,0,0,0,0,0,0,0,0,0.0,0,520,33,0,0,0,0,0,0,0,0,0,0,100.0,NoArch
47e7d223139391465bea592375031c2315afc99f,1,0,1,1,0,0,0,1,22,0,1,1,0.0,640,402,17,82,82,0,2781,2787,6,38,38,0,0,100.0,NoArch
2fc9e37f63ef80cbd113474a977002843418ce8a,3,19,3,16,0,0,0,2,14,508,1,2,1.288649765,1831,507,20,151,149,2,8262,8188,74,58,56,2,1,100.0,NoArch
c4b4de2ceed58e6897f42488a13aa34666ab8ba5,0,0,0,0,0,0,0,0,0,0,0,0,0.0,0,306,50,0,0,0,0,0,0,0,0,0,0,100.0,NoArch
7d089ef5649e0d1052a188e3aaeb883c0a9a1cc1,3,65,2,63,0,0,0,2,35,2577,2,3,0.573207456,976,3,1,97,96,1,4304,3776,528,44,43,1,0,100.0,NoArch
f700f95e27e29a8b3e1b861536354b33097754a2,3,113,28,85,0,0,0,1,15,96,1,2,1.324360059,769,791,16,62,55,7,4832,4238,594,31,27,4,0,100.0,NoArch
33e6a64dcd8027c5f63234c9300260ba8baf91b3,0,0,0,0,0,0,0,0,0,0,0,0,0.0,0,118,31,0,0,0,0,0,0,0,0,0,0,100.0,NoArch
d3b02c4914be1e6c4e8decbbb0e3e730b6059751,0,0,0,0,0,0,0,0,0,0,0,0,0.0,0,130,6,0,0,0,0,0,0,0,0,0,0,100.0,NoArch
097083c4a2cd2e252c6f3b57e3e837e4a9ecabc9,1,1,2,1,0,0,0,4,32,1,1,1,0.0,614,957,50,25,25,0,4646,4655,9,24,24,0,0,100.0,NoArch
10f054961b37ed17cf1ee679a5b988a302c7c1f4,1,10,0,10,1,0,1,1,1,0,1,1,0.0,0,389,14,1,0,1,28,0,28,1,0,1,0,98.48363927,NoArch
69b824e5c034fa5da20b579eb9db2bb386a521df,1,18,0,18,0,0,0,1,2,0,1,1,0.0,99,108,6,9,9,0,508,508,0,4,4,0,0,100.0,NoArch
756898082b80c2525d3b0b5520544d730c7d8dfe,1,6,4,2,0,0,0,1,19,300,1,1,0.0,728,875,17,35,35,0,3941,3914,27,11,11,0,0,99.94692144,NoArch
e94ea6c6fd196f100259ed4403e00d632f31b2d9,3,31,8,23,0,0,0,1,4,36,1,2,1.334679141,393,251,30,57,54,3,1739,1635,104,26,24,2,0,100.0,NoArch
624ac9c6bf368559e7b4ba389c5d2bfa95fcd617,0,0,0,0,0,0,0,0,0,0,0,0,0.0,0,332,9,0,0,0,0,0,0,0,0,0,0,100.0,NoArch
30bd7b655d201762d8ff74062964621879ac7134,5,112,50,62,3,0,3,3,59,0,1,2,1.913370532,1283,518,31,185,179,6,5633,5401,232,87,80,7,0,99.62762356,NoArch
ba85368e9aa461320071fb872f02b5c3b6619c14,1,8,24,16,0,0,0,4,29,142,1,1,0.0,869,43,0,116,118,2,3504,3568,64,38,39,1,0,100.0,NoArch
330eb3a3d0eaec7b0f77a2783b01cdf3c7745f9d,1,1,1,0,0,0,0,1,5,4,1,1,0.0,88,853,17,7,7,0,279,277,2,5,5,0,0,100.0,NoArch
2f37abce3278c343cbfb1f66079ba259dfc73064,0,0,0,0,0,0,0,0,0,0,0,0,0.0,0,7,2,0,0,0,0,0,0,0,0,0,1,100.0,NoArch
bbd20a15bb466f9c492a87c0180a746dee7ebdc0,0,0,0,0,0,0,0,0,0,0,0,0,0.0,0,216,24,0,0,0,0,0,0,0,0,0,0,100.0,NoArch
6d392ecb929b292ea9438b0e177c4bbab2c3953b,3,19,0,19,0,0,0,3,16,1961,1,1,1.557431962,800,1,0,65,65,0,2559,2508,51,26,26,0,1,100.0,NoArch
8c1b4be57ffaf58ce8708e0e9d3611e4e5955f2e,1,17,9,8,0,0,0,3,4,3867,1,1,0.0,56,0,0,4,4,0,252,228,24,2,2,0,1,100.0,NoArch
05d241da642c6ba0d16b3ce97557128fad4dfe41,3,22,1,21,0,0,0,1,10,0,1,2,1.422475118,366,520,33,34,32,2,1010,909,101,12,12,0,0,100.0,NoArch
9e81c21502b1a29478703cc2743b8333b53843c5,2,5,5,0,0,0,0,1,18,8,1,2,0.721928095,664,478,17,56,55,1,2029,2033,4,28,28,0,0,100.0,NoArch
95893ad37da229d91973bd428ebf19f17cb8a9d8,6,25,53,28,0,0,0,3,10,0,3,3,1.703263419,2023,324,16,128,128,0,10490,10636,146,55,55,0,0,100.0,NoArch
145da217ff35df0178823da784f4dd1618851c5e,2,25,8,17,0,0,0,4,23,32,1,2,0.999337504,1101,509,6,91,90,1,5519,5412,107,50,51,1,0,100.0,NoArch
330eb3a3d0eaec7b0f77a2783b01cdf3c7745f9d,1,1,1,0,0,0,0,1,5,4,1,1,0.0,88,853,17,7,7,0,279,277,2,5,5,0,0,100.0,NoArch
bf1ec60b0e54ce6f6701942f92d39fb84f919276,0,0,0,0,0,0,0,0,0,0,0,0,0.0,0,26,3,0,0,0,0,0,0,0,0,0,0,100.0,NoArch
44b45084315794545d5911194c930ac6593bf8ce,1,6,3,3,0,0,0,1,12,243,1,1,0.0,225,542,19,27,26,1,682,674,8,13,13,0,0,100.0,NoArch
26d0cccf33565c8f0c8bc7e36a73b0d677b5169f,1,1,0,1,0,0,0,1,33,0,1,1,0.0,736,882,11,73,73,0,2873,2868,5,34,34,0,0,100.0,NoArch
5e3520131d5e39d17e299347fcc0cb8d096f99c6,0,0,0,0,0,0,0,0,0,0,0,0,0.0,0,948,34,0,0,0,0,0,0,0,0,0,0,100.0,NoArch
8499680187d1f1061ca8597886e9f869bf637321,17,525,317,208,2,0,2,3,23,1081,2,5,3.656787153,3594,522,0,315,290,25,16777,16199,578,194,182,12,0,99.85825656,NoArch
acb0058db29643ca0ad4f875fec8c9d25419c181,0,0,0,0,0,0,0,0,0,0,0,0,0.0,0,33,10,0,0,0,0,0,0,0,0,0,0,100.0,NoArch
fe34ac579c89407d4c8cd0dabebeaae4f00e3b73,0,0,0,0,0,0,0,0,0,0,0,0,0.0,0,5,5,0,0,0,0,0,0,0,0,0,0,100.0,NoArch
65a71c6ea44deecebdd68412d22f3077d1b507ef,0,0,0,0,0,0,0,0,0,0,0,0,0.0,0,866,10,0,0,0,0,0,0,0,0,0,0,100.0,NoArch
bc926afa3333669d3c5d3a6c82dc724e940b1d1b,2,4,3,1,0,0,0,1,8,0,1,2,0.985228136,741,802,10,71,70,1,3601,3584,17,41,41,0,0,100.0,NoArch
fffdad87792c855bde25db7b8263655ea8b1bf22,2,674,0,674,2,0,2,1,2,0,1,2,0.999942835,0,796,21,63,0,63,3230,0,3230,39,0,39,0,99.78021978,NoArch
e4b8982d8bc6d7701d33d9de166aaa9b0c910615,0,0,0,0,0,0,0,0,0,0,0,0,0.0,0,29,4,0,0,0,0,0,0,0,0,0,0,100.0,NoArch
48d3e31e1355ff193eecff713c2e2b3278882800,0,0,0,0,0,0,0,0,0,0,0,0,0.0,0,275,56,0,0,0,0,0,0,0,0,0,0,100.0,NoArch
acb0058db29643ca0ad4f875fec8c9d25419c181,0,0,0,0,0,0,0,0,0,0,0,0,0.0,0,33,10,0,0,0,0,0,0,0,0,0,0,100.0,NoArch
53dca8a78a385bab757c06c668ac56230d6a7cf9,0,0,0,0,0,0,0,0,0,0,0,0,0.0,0,39,7,0,0,0,0,0,0,0,0,0,0,100.0,NoArch
56d9ba665ef69944ef0ab9c65aa014b921fd39f9,0,0,0,0,0,0,0,0,0,0,0,0,0.0,0,598,14,0,0,0,0,0,0,0,0,0,0,100.0,NoArch
07688bc94bbe507f2fd009b3df1aae21f08f69d0,2,19,1,18,0,0,0,1,3,0,1,1,0.468995594,434,213,21,43,41,2,1710,1583,127,26,25,1,0,100.0,NoArch
0f493b9757a11a197a55deb97cb4c2dd5fd4e429,0,0,0,0,0,0,0,0,0,0,0,0,0.0,0,985,78,0,0,0,0,0,0,0,0,0,0,100.0,NoArch
bf1ec60b0e54ce6f6701942f92d39fb84f919276,0,0,0,0,0,0,0,0,0,0,0,0,0.0,0,26,3,0,0,0,0,0,0,0,0,0,0,100.0,NoArch
a47ab1e1d685fd1792ffd8d4e01412c91bb3dbe2,0,0,0,0,0,0,0,0,0,0,0,0,0.0,0,556,15,0,0,0,0,0,0,0,0,0,1,100.0,NoArch
6612c91e7f6aa50ce961e0bfcc9fb4c3134e0a39,1,3,0,3,0,0,0,1,2,21,1,1,0.0,65,31,9,5,5,0,190,177,13,2,2,0,1,100.0,NoArch
b997bbe1b5672991ab9b67fa31c611c11ccb11d9,0,0,0,0,0,0,0,0,0,0,0,0,0.0,0,754,21,0,0,0,0,0,0,0,0,0,0,100.0,NoArch
1c92f49016e829702b7bffc45a4cca58a2dc54a1,1,1,1,0,0,0,0,3,8,0,1,1,0.0,130,594,50,18,18,0,582,582,0,6,6,0,0,100.0,NoArch
22c24e7eb344378e2a34765858119319c520e66e,1,1,1,0,0,0,0,1,5,352,1,1,0.0,149,405,20,14,14,0,367,367,0,7,7,0,0,100.0,NoArch
f84b6487dc282c104b5a882efb72e3b66934457a,0,0,0,0,0,0,0,0,0,0,0,0,0.0,0,382,24,0,0,0,0,0,0,0,0,0,0,100.0,NoArch
55a6d929030b005c35d31b937de92f4edebdf7e8,0,0,0,0,0,0,0,0,0,0,0,0,0.0,0,1139,0,0,0,0,0,0,0,0,0,0,0,100.0,NoArch
399b42b5bcaea331497b0c3b014899eeaa5fa1eb,0,0,0,0,0,0,0,0,0,0,0,0,0.0,0,52,28,0,0,0,0,0,0,0,0,0,0,100.0,NoArch
cc49ae91f298243f80689a7f879bd9529133755e,1,23,5,18,0,0,0,1,3,1418,1,1,0.0,86,550,9,1,1,0,572,452,120,1,1,0,0,100.0,NoArch
b8d4c3d77de029917820634fa4ed21be19bbcf2c,1,2,0,2,0,0,0,3,5,1176,1,1,0.0,130,513,26,3,3,0,803,775,28,2,2,0,0,100.0,NoArch
dcf828002eef7cd8a092fb963d972f7cfc4e77ff,12,412,809,397,5,2,7,2,2,406,2,6,2.607653167,1504,1,1,65,113,48,6485,8196,1711,40,67,27,0,98.21627648,NoArch
b1ffac9145750e03c01c4ce6823f4a8536054a1e,1,4,1,3,0,0,0,4,6,3015,1,1,0.0,176,0,0,14,13,1,620,598,22,13,13,0,0,100.0,NoArch
b5fd8405ef7ffeed258e4e12597ebc7ce1a6f99e,1,0,5,5,0,0,0,1,2,2,1,1,0.0,54,2,2,4,5,1,94,122,28,4,5,1,0,100.0,NoArch
b79909a4cb17ac5fe20f12fcd5b8e0761492d1b4,5,3715,29,3686,0,0,0,1,4,0,1,3,0.247627389,4407,280,61,1605,805,800,47810,25770,22040,675,351,324,0,98.33178869,NoArch
3863a712d2c614a34de34fcca49caee64a74fb18,1,17,69,52,0,0,0,3,5,0,1,1,0.0,136,515,23,8,18,10,414,613,199,4,6,2,0,100.0,NoArch
132e048a1ac2b02fd39d5c8856a75fcf0b4b6745,1,2,1,1,0,0,0,1,2,0,1,1,0.0,207,373,22,21,21,0,782,770,12,14,14,0,0,100.0,NoArch
5ff3f3c5c774d16f056849209008a800263aac92,1,0,3,3,0,0,0,1,2,0,1,1,0.0,39,195,47,1,1,0,61,90,29,1,1,0,0,100.0,NoArch
43afca7b902bf3d52c33c23924be4ca37c4df23f,1,6,0,6,0,0,0,1,3,24,1,1,0.0,24,375,6,0,0,0,21,21,0,0,0,0,0,100.0,NoArch
2f6e2177e98d0f418b47a664a48c87abf5a72595,20,388,89,299,3,0,3,3,47,886,2,3,3.45210253,4754,0,0,492,452,40,21607,20226,1381,291,261,30,1,99.71401335,NoArch
f268d9acdfd02ec6de36b01d7601d24fe2fa5c6f,0,0,0,0,0,0,0,0,0,0,0,0,0.0,0,501,15,0,0,0,0,0,0,0,0,0,0,100.0,NoArch
ccd934ccae2e22bddbd49d5a49eb5adba477a5b0,0,0,0,0,0,0,0,0,0,0,0,0,0.0,0,520,33,0,0,0,0,0,0,0,0,0,0,100.0,NoArch
099df94a1453db319b2a5fe4eaa7ff4a5dadf518,9,201,347,146,1,0,1,1,7,0,1,5,2.426469222,3309,240,30,629,666,37,17886,18938,1052,226,231,5,0,99.88081049,NoArch
03c555823a18143ba13c4f0cb91468235ec73406,0,0,0,0,0,0,0,0,0,0,0,0,0.0,0,933,19,0,0,0,0,0,0,0,0,0,0,100.0,NoArch
8e83cf71d2288f98f941d14c1a549182918bcfbc,0,0,0,0,0,0,0,0,0,0,0,0,0.0,0,392,16,0,0,0,0,0,0,0,0,0,0,100.0,NoArch
37f577a8de7a831d5168dafcc245f5d4bbddb5da,1,1,1,0,0,0,0,1,11,63,1,1,0.0,305,283,27,18,18,0,1451,1451,0,8,8,0,0,100.0,NoArch
3ba4daef852936aa86cf6e66b830ff8b0cc5a4d4,2,39,18,21,0,0,0,1,28,2,2,2,0.934849024,773,844,15,79,74,5,3307,3210,97,41,40,1,0,100.0,NoArch
ffc5ddc3235d42cad64a75a091b42228519d29ba,0,0,0,0,0,0,0,0,0,0,0,0,0.0,0,132,8,0,0,0,0,0,0,0,0,0,0,100.0,NoArch
1c92f49016e829702b7bffc45a4cca58a2dc54a1,1,1,1,0,0,0,0,3,8,0,1,1,0.0,130,594,50,18,18,0,582,582,0,6,6,0,0,100.0,NoArch
f84b6487dc282c104b5a882efb72e3b66934457a,0,0,0,0,0,0,0,0,0,0,0,0,0.0,0,382,24,0,0,0,0,0,0,0,0,0,0,100.0,NoArch
cd79c076b662401103abb7153ece3d53ff3cdb76,7,347,117,230,1,0,1,1,26,60,1,2,1.866625955,2289,539,16,187,171,16,11745,10617,1128,78,66,12,0,99.73873285,NoArch
e0388f0d54825730717259329382cd86ab69cfbe,0,0,0,0,0,0,0,0,0,0,0,0,0.0,0,0,0,0,0,0,0,0,0,0,0,0,0,100.0,NoArch
32ffdf3a8171cf53de3026487fa2d6ce0d6301cf,0,0,0,0,0,0,0,0,0,0,0,0,0.0,0,827,6,0,0,0,0,0,0,0,0,0,0,100.0,NoArch
07aa0a8f5c2855cbb8837100407c8f5c9e707dfc,0,0,0,0,0,0,0,0,0,0,0,0,0.0,0,445,39,0,0,0,0,0,0,0,0,0,0,100.0,NoArch
269c9988377805b27db0c8d67218b330de367967,0,0,0,0,0,0,0,0,0,0,0,0,0.0,0,54,10,0,0,0,0,0,0,0,0,0,0,100.0,NoArch
93ccd17e7e2de46768fa1aa206fdd5ee0d5ead68,1,0,38,38,0,0,0,1,10,0,1,1,0.0,169,688,5,8,9,1,679,894,215,2,3,1,0,100.0,NoArch
3424fc1e9ce42142e289f18e542b5424ab7adebb,5,90,0,90,0,0,0,1,3,88,2,2,2.321928095,264,528,2,22,22,0,1454,1454,0,7,7,0,0,100.0,NoArch
1fd5a5e76ad203b4b084bbc8b6af33c77f1d345f,0,0,0,0,0,0,0,0,0,0,0,0,0.0,0,326,7,0,0,0,0,0,0,0,0,0,0,100.0,NoArch
bac23d3af7abf4bf25d5acfca7c5f2cb53b739d0,2,62,5,57,0,0,0,4,20,0,1,2,0.839530498,1346,240,6,113,110,3,5701,5469,232,42,40,2,0,100.0,NoArch
15048996e07109c1830815b2d280248dfcf62c5a,0,0,0,0,0,0,0,0,0,0,0,0,0.0,0,620,41,0,0,0,0,0,0,0,0,0,0,100.0,NoArch
aa9913d493d69f2da0ebe15b42a1b8da25e607a3,0,0,0,0,0,0,0,0,0,0,0,0,0.0,0,722,34,0,0,0,0,0,0,0,0,0,0,100.0,NoArch
1f995d968b006381272f51f90b73b19e17f7daed,0,0,0,0,0,0,0,0,0,0,0,0,0.0,0,35,12,0,0,0,0,0,0,0,0,0,0,100.0,NoArch
d4c3b39df687af753b6b9eb909776e01f1d89dd8,0,0,0,0,0,0,0,0,0,0,0,0,0.0,0,738,40,0,0,0,0,0,0,0,0,0,0,100.0,NoArch
cbb0a6338ab846ac2f6bd2ea15e35c5291b58feb,0,0,0,0,0,0,0,0,0,0,0,0,0.0,0,677,34,0,0,0,0,0,0,0,0,0,0,100.0,NoArch
0c521834019b1073badb21bba0395afe0b043dfe,1,1,1,0,0,0,0,1,5,2,1,1,0.0,209,264,8,20,20,0,1036,1036,0,7,7,0,0,100.0,NoArch
56378380f4831e958cd2bc275ab56e07d0446409,0,0,0,0,0,0,0,0,0,0,0,0,0.0,0,362,11,0,0,0,0,0,0,0,0,0,0,100.0,NoArch
3f767a76999f5a4724898351cd498e287fcba1a2,0,0,0,0,0,0,0,0,0,0,0,0,0.0,0,174,26,0,0,0,0,0,0,0,0,0,0,100.0,NoArch
caf6406e94e2c398a6c1f69a1fe7b360bc14b172,0,0,0,0,0,0,0,0,0,0,0,0,0.0,0,63,1,0,0,0,0,0,0,0,0,0,0,100.0,NoArch
4b7b7b67f4ca941bca0f3c4346b86f768f04d867,0,0,0,0,0,0,0,0,0,0,0,0,0.0,0,53,29,0,0,0,0,0,0,0,0,0,0,100.0,NoArch
03566977828a2b181c4d9fbcc87c40ac187f3ba4,18,36,65,29,0,0,0,1,46,264,5,11,3.43568132,4678,0,0,407,411,4,19241,19245,4,202,204,2,0,100.0,NoArch
8c8d7ec2ba24cf192db7cd0a738924a2ec538e09,0,0,0,0,0,0,0,0,0,0,0,0,0.0,0,35,1,0,0,0,0,0,0,0,0,0,2,100.0,NoArch
081bfdbe14121db21b5f873519dac7bdf98ee577,0,0,0,0,0,0,0,0,0,0,0,0,0.0,0,294,75,0,0,0,0,0,0,0,0,0,0,100.0,NoArch
a6b191e38b958d1ec74a116c37d23cadea8716f7,0,0,0,0,0,0,0,0,0,0,0,0,0.0,0,676,33,0,0,0,0,0,0,0,0,0,0,100.0,NoArch
b8a9dfaf83af3d2560934cb13aa52cab138ba809,1,27,31,4,0,0,0,1,34,5,1,1,0.0,651,602,23,82,82,0,2800,2821,21,41,41,0,0,100.0,NoArch
1ee16734beff6e42ef2999dc0c3118857499bd05,0,0,0,0,0,0,0,0,0,0,0,0,0.0,0,494,12,0,0,0,0,0,0,0,0,0,0,100.0,NoArch
ec260486017f245a6a007b9f2887919045cdd3ac,1,3,0,3,0,0,0,2,4,106,1,1,0.0,214,324,5,15,15,0,894,888,6,10,10,0,0,100.0,NoArch
46d112f8fa7c39d8107220e5d74f17c92411ee0b,7,89,34,55,1,0,1,1,8,38,1,3,2.235908089,461,92,13,28,23,5,1861,1717,144,24,19,5,0,99.88290398,NoArch
75bbf18e56b13b977665e5c15dc392601443928e,1,4,10,6,0,0,0,2,5,0,1,1,0.0,117,1,1,5,5,0,709,716,7,5,5,0,0,100.0,NoArch
514ccf8bb45003e4fdef8d92f33c73702bd5c07e,0,0,0,0,0,0,0,0,0,0,0,0,0.0,0,761,63,0,0,0,0,0,0,0,0,0,0,100.0,NoArch
e94ea6c6fd196f100259ed4403e00d632f31b2d9,3,31,8,23,0,0,0,1,4,36,1,2,1.334679141,393,251,30,57,54,3,1739,1635,104,26,24,2,0,100.0,NoArch
208317ab0110663745a5e8e76fd9a8bca634082e,4,67,67,0,0,0,0,2,29,63,2,3,0.451666235,1656,613,12,141,142,1,7817,7810,7,71,71,0,0,100.0,NoArch
804f7e64e865242101e6010fcd1b8247bedaf6c9,2,666,0,666,2,0,2,1,1,0,1,2,0.999993495,0,795,20,60,0,60,3170,0,3170,38,0,38,0,99.78021978,NoArch
82304ea4fcf965b2493ddf94d8ab30ef74af9068,1,8,1,7,0,0,0,8,35,161,1,1,0.0,1140,1158,2,52,51,1,6940,6891,49,21,21,0,0,100.0,NoArch
8285e35d44f108e1fb4ee1ddb80e258525bd2f9a,0,0,0,0,0,0,0,0,0,0,0,0,0.0,0,800,11,0,0,0,0,0,0,0,0,0,0,100.0,NoArch
f89c1ea5336bbde932638a2a28d678b231a2e49b,1,1,1,0,0,0,0,9,48,0,1,1,0.0,1172,887,2,78,78,0,5494,5502,8,38,38,0,0,100.0,NoArch
a49b90c770717ab4c5c701678c21e033f8f73018,19,465,47,418,5,0,5,1,18,20,4,8,2.971728585,3152,230,21,208,183,25,17608,16166,1442,93,79,14,0,99.03474903,NoArch
600a2f94bd968ae8e94f237be8a0962f7af3d538,0,0,0,0,0,0,0,0,0,0,0,0,0.0,0,825,4,0,0,0,0,0,0,0,0,0,0,100.0,NoArch
b6e076cf232672358336a88ccda18e278c7bef4b,2,10,4,6,0,0,0,1,9,0,1,2,0.863120569,282,254,28,20,20,0,891,830,61,15,15,0,0,99.38650307,NoArch
f8814f619fe120b6ca254e0ac2a374de9165ab7c,5,46,84,38,0,0,0,2,23,846,3,5,1.464273371,2032,547,17,128,132,4,10954,11113,159,79,79,0,2,99.96671105,NoArch
bd79f9f68050bd24e6dd370fdda971754887867d,0,0,0,0,0,0,0,0,0,0,0,0,0.0,0,30,7,0,0,0,0,0,0,0,0,0,0,100.0,NoArch
2601866c5e0bd247bd8a12c0da4405838465a63d,0,0,0,0,0,0,0,0,0,0,0,0,0.0,0,130,34,0,0,0,0,0,0,0,0,0,0,100.0,NoArch
37304a496c1b14532f5843700db01dce3d4ec6e6,0,0,0,0,0,0,0,0,0,0,0,0,0.0,0,427,31,0,0,0,0,0,0,0,0,0,0,100.0,NoArch
ead40fb713a933c702ed55c142eef1212e3773e2,2,53,9,44,0,0,0,1,12,93,1,2,0.637387499,374,334,3,31,27,4,1756,1527,229,14,14,0,0,100.0,NoArch
52bd53f5ea5eec84818d65b40e81d0a82ada6ba8,3,49,4,45,0,0,0,1,2,45,1,2,1.578384036,65,1,0,8,8,0,371,360,11,8,8,0,0,100.0,NoArch
57055374f79274f72809fa45539dbfa5d9f3a838,0,0,0,0,0,0,0,0,0,0,0,0,0.0,0,662,19,0,0,0,0,0,0,0,0,0,0,100.0,NoArch
5ff48fcaa39b43b4a3ef1ba194ac54fa300a5339,4,35,23,12,0,0,0,2,4,260,1,2,1.80339253,612,86,16,16,16,0,4388,4268,120,15,15,0,0,99.45684973,NoArch
64ffd374bed766fa4849d61ec404a8eacf3aafbb,1,242,0,242,1,0,1,1,1,0,1,1,0.0,0,742,44,28,0,28,1173,0,1173,7,0,7,0,99.82227488,NoArch
009097800f86708c2cb6d04a1001e1bf06aa7eb0,0,0,0,0,0,0,0,0,0,0,0,0,0.0,0,19,19,0,0,0,0,0,0,0,0,0,0,100.0,NoArch
65a71c6ea44deecebdd68412d22f3077d1b507ef,0,0,0,0,0,0,0,0,0,0,0,0,0.0,0,866,10,0,0,0,0,0,0,0,0,0,0,100.0,NoArch
d71f49bf56ef0e158cf180c7366fbee3ffe3dfb9,6,70,16,54,0,0,0,2,26,637,2,3,2.087959065,2278,574,36,153,146,7,11520,11327,193,80,79,1,1,100.0,NoArch
269c9988377805b27db0c8d67218b330de367967,0,0,0,0,0,0,0,0,0,0,0,0,0.0,0,54,10,0,0,0,0,0,0,0,0,0,0,100.0,NoArch
7a60af0dddbf1e547ddb7448ce99e14341413ef0,5,78,103,25,0,0,0,1,20,531,3,5,1.241776972,1568,952,45,115,120,5,9914,10062,148,82,81,1,1,100.0,NoArch
c97ef5d56f4c79bb87c33706239252c3acdcdb4c,2,119,11,108,0,0,0,1,30,104,1,2,0.792472498,1202,878,19,96,92,4,6261,5730,531,44,42,2,0,100.0,NoArch
2ff89856d6ee2d373cf91bc1a3bd388890604373,0,0,0,0,0,0,0,0,0,0,0,0,0.0,0,594,10,0,0,0,0,0,0,0,0,0,0,100.0,NoArch
e2ef65596baffabba6b882cdf20e3d926dd3c93c,11,64,20,44,1,0,1,2,33,51,5,10,2.602756674,3340,594,15,340,337,3,13000,12968,32,165,162,3,0,99.71590909,NoArch
31c04658c85a687f66db6327c9e8aca250062627,0,0,0,0,0,0,0,0,0,0,0,0,0.0,0,30,5,0,0,0,0,0,0,0,0,0,0,100.0,NoArch
d63e06e84190cde818f56a791b4738b2199d2db8,2,44,1,43,0,0,0,4,16,329,1,2,0.566509507,794,531,4,60,57,3,4264,4085,179,32,31,1,1,99.89633725,NoArch
5ff48fcaa39b43b4a3ef1ba194ac54fa300a5339,4,35,23,12,0,0,0,2,4,260,1,2,1.80339253,612,86,16,16,16,0,4388,4268,120,15,15,0,0,99.45684973,NoArch
fbaf7b875f4362c9df3bdade582a8b956e455629,0,0,0,0,0,0,0,0,0,0,0,0,0.0,0,961,47,0,0,0,0,0,0,0,0,0,0,100.0,NoArch
4956fd9604d3188d58552001f1e8fea587bad810,0,0,0,0,0,0,0,0,0,0,0,0,0.0,0,517,4,0,0,0,0,0,0,0,0,0,0,100.0,NoArch
73cdf1608460c8187928febcd3829ad4ebec8951,1,5,0,5,0,0,0,2,6,1663,1,1,0.0,111,989,81,2,1,1,740,681,59,1,1,0,0,100.0,NoArch
a77796259eb502482cacaceba939bd834b4f177e,1,29,0,29,0,0,0,1,18,5,1,1,0.0,662,902,11,34,33,1,4188,4022,166,18,17,1,0,100.0,NoArch
e955ad6c900f12925c4a5f0fb289c554a27e9c1d,1,56,0,56,0,0,0,1,2,0,1,1,0.0,54,425,29,3,2,1,707,345,362,3,2,1,0,100.0,NoArch
5ce934022e3f923aeee599cb560bb162c0333793,0,0,0,0,0,0,0,0,0,0,0,0,0.0,0,738,49,0,0,0,0,0,0,0,0,0,0,100.0,NoArch
39844c90949d0f3adb65569e6e83c1dd174911c4,0,0,0,0,0,0,0,0,0,0,0,0,0.0,0,261,8,0,0,0,0,0,0,0,0,0,0,100.0,NoArch
ee7e1ea37bbb4bb0014b45bbb59ee6224f6645d7,0,0,0,0,0,0,0,0,0,0,0,0,0.0,0,546,23,0,0,0,0,0,0,0,0,0,0,100.0,NoArch
8b9f7d5ce0369976f766745069be62e2b126ef22,0,0,0,0,0,0,0,0,0,0,0,0,0.0,0,104,0,0,0,0,0,0,0,0,0,0,0,100.0,NoArch
a46c72629074237df9e4c00623fe818e76b2cbef,1,1,1,0,0,0,0,2,8,330,1,1,0.0,339,0,0,37,37,0,1457,1457,0,19,19,0,0,100.0,NoArch
993afbbe29d9b734f9f4ce4b57d0f21b11696599,0,0,0,0,0,0,0,0,0,0,0,0,0.0,0,796,18,0,0,0,0,0,0,0,0,0,0,100.0,NoArch
42275e438ea0c01f7965f7d5e98a39f4420b4914,0,0,0,0,0,0,0,0,0,0,0,0,0.0,0,303,1,0,0,0,0,0,0,0,0,0,0,100.0,NoArch
fdc5600953c29e0cdcfe16396b27d1b447e13380,1,1,1,0,0,0,0,3,6,2,1,1,0.0,259,1,1,19,19,0,804,804,0,13,13,0,1,100.0,NoArch
fad270861feb4dbda36fdea76b4db9ec29e92001,2,28,10,18,0,0,0,2,10,0,2,2,0.297472249,379,578,40,43,40,3,1609,1552,57,15,14,1,0,100.0,NoArch
c311805805a7e6fc3939be69d7d0bd2b31f0ca6e,0,0,0,0,0,0,0,0,0,0,0,0,0.0,0,953,39,0,0,0,0,0,0,0,0,0,0,100.0,NoArch
1a2a94b625e7e1b5e535414e397e9b3a4173ca1b,1,1,1,0,0,0,0,1,4,1,1,1,0.0,255,524,37,13,13,0,1176,1176,0,7,7,0,0,100.0,NoArch
69ec4d7e6cbe30452fc096f1d5fb706ba118413c,0,0,0,0,0,0,0,0,0,0,0,0,0.0,0,946,39,0,0,0,0,0,0,0,0,0,0,100.0,NoArch
a9cdc1463a380854ef8276f9208aeda67b8e0b13,1,1,1,0,0,0,0,1,4,11,1,1,0.0,154,516,30,8,8,0,903,898,5,2,2,0,0,100.0,NoArch
6cebfc13ccdcd9cb2a5b576fa369b957e651752a,1,12,9,3,0,0,0,8,18,588,1,1,0.0,550,0,0,48,47,1,1803,1797,6,26,26,0,1,100.0,NoArch
2a6e3d47378a9a77da34d2ef41e9ced86f7c236f,1,8,0,8,0,0,0,1,17,45,1,1,0.0,269,488,9,22,21,1,800,745,55,10,10,0,0,100.0,NoArch
9d41ecf9f7e6fe6d33114615499b0c97c1217660,2,120,54,66,0,0,0,1,13,97,1,2,0.996566371,553,353,7,44,41,3,2667,2242,425,22,20,2,0,100.0,NoArch
abe2babd8300380299b6afb83986ed3741f1aa46,0,0,0,0,0,0,0,0,0,0,0,0,0.0,0,998,90,0,0,0,0,0,0,0,0,0,0,100.0,NoArch
66c81e05c78519b3f82f59bcae05345e5e24c189,0,0,0,0,0,0,0,0,0,0,0,0,0.0,0,1160,4,0,0,0,0,0,0,0,0,0,1,100.0,NoArch
0f493b9757a11a197a55deb97cb4c2dd5fd4e429,0,0,0,0,0,0,0,0,0,0,0,0,0.0,0,985,78,0,0,0,0,0,0,0,0,0,0,100.0,NoArch
ba4da2c3c7048ea249f18e7b4c815db76f0b1ad0,4,58,55,3,0,0,0,1,35,457,1,2,1.369164021,1909,28,6,211,209,2,8767,8767,0,109,106,3,1,100.0,NoArch
734913cd5a258c7a9bbfdeab7ece9adfa975e96c,0,0,0,0,0,0,0,0,0,0,0,0,0.0,0,44,20,0,0,0,0,0,0,0,0,0,0,100.0,NoArch
d412f2320d571d23c8960214482e84a7911bec16,1,0,1,1,0,0,0,5,21,0,1,1,0.0,912,512,25,62,62,0,4947,4956,9,19,19,0,0,100.0,NoArch
b4bc222ac1b6a3950a76b4a54b0a0b6dafc409ec,0,0,0,0,0,0,0,0,0,0,0,0,0.0,0,119,32,0,0,0,0,0,0,0,0,0,0,100.0,NoArch
ddaff1af9540f42503e3847784e824dd7d23e10e,0,0,0,0,0,0,0,0,0,0,0,0,0.0,0,125,2,0,0,0,0,0,0,0,0,0,0,100.0,NoArch
34e7565d4436bcae4aa680ec61d2257bb4d165aa,0,0,0,0,0,0,0,0,0,0,0,0,0.0,0,5,1,0,0,0,0,0,0,0,0,0,0,100.0,NoArch
350f71990e52aa362de9aa85d331dd8388b35636,0,0,0,0,0,0,0,0,0,0,0,0,0.0,0,368,17,0,0,0,0,0,0,0,0,0,0,100.0,NoArch
1fc29c21b9bfa443df1fb00dc42e07f92d033cea,2,29,32,3,0,0,0,1,11,0,1,2,0.715322053,8493,263,49,1668,1667,1,49856,49906,50,855,855,0,0,100.0,NoArch
763aa39a1467a6963447f7a6b0ab5ff956b1d703,1,1,1,0,0,0,0,5,17,0,1,1,0.0,568,582,44,34,34,0,2737,2733,4,12,12,0,0,100.0,NoArch
9d6586f33145ad1ff91a1a8846a851d492f6abc5,0,0,0,0,0,0,0,0,0,0,0,0,0.0,0,36,13,0,0,0,0,0,0,0,0,0,0,100.0,NoArch
2c0c523223e562b7c31485cabfc3f327793ebdd4,0,0,0,0,0,0,0,0,0,0,0,0,0.0,0,330,1,0,0,0,0,0,0,0,0,0,0,100.0,NoArch
bf4df373e88c8f37cf1b1376241e979916ffadf6,7,279,62,217,0,0,0,1,25,0,1,2,1.838708109,2383,519,32,198,181,17,10495,9545,950,94,89,5,0,100.0,NoArch
c53b936ec060a27ba596c7b4ea993502deb987ea,0,0,0,0,0,0,0,0,0,0,0,0,0.0,0,755,57,0,0,0,0,0,0,0,0,0,0,100.0,NoArch
ca8f2792aa23dec5e35f31c8dcc40ae572f40ef2,0,0,0,0,0,0,0,0,0,0,0,0,0.0,0,522,35,0,0,0,0,0,0,0,0,0,0,100.0,NoArch
9077ad001b32868ac9abcf172438dff9ff82e52f,0,0,0,0,0,0,0,0,0,0,0,0,0.0,0,300,81,0,0,0,0,0,0,0,0,0,0,100.0,NoArch
d3aaddefceaf659cb32d865ead1cd3e294f2fddb,1,1,0,1,0,0,0,1,3,21,1,1,0.0,172,960,53,11,11,0,491,480,11,11,11,0,1,100.0,NoArch
d110cbb60ce96d4030e0e6da5accd64baef62eca,1,2,4,2,0,0,0,2,8,0,1,1,0.0,217,575,37,26,26,0,804,827,23,7,7,0,0,100.0,NoArch
a6b191e38b958d1ec74a116c37d23cadea8716f7,0,0,0,0,0,0,0,0,0,0,0,0,0.0,0,676,33,0,0,0,0,0,0,0,0,0,0,100.0,NoArch
b409936b886b2d785b05e8b9ac5f4a19609e2b29,0,0,0,0,0,0,0,0,0,0,0,0,0.0,0,338,7,0,0,0,0,0,0,0,0,0,0,100.0,NoArch
753142a7652401510096b35c516077b9b8fe38e5,1,0,45,45,0,1,1,2,3,64,1,1,0.0,45,866,5,0,3,3,0,138,138,0,2,2,0,99.94419643,NoArch
4228fe52fa7cdbed5263815e83a1beeecc39c095,0,0,0,0,0,0,0,0,0,0,0,0,0.0,0,683,40,0,0,0,0,0,0,0,0,0,0,100.0,NoArch
9ed75cc27ba2c1938d117ce476f68757d5e68824,0,0,0,0,0,0,0,0,0,0,0,0,0.0,0,725,37,0,0,0,0,0,0,0,0,0,0,100.0,NoArch
e2d49f7266a2532dab086fa24af7ae0a27f227a4,12,739,26,713,7,0,7,1,20,100,2,7,3.060566366,1415,374,19,201,155,46,7808,5170,2638,115,89,26,0,98.54576561,NoArch
6ee94e1eede4ae97223b70d4a22f37be50f14533,0,0,0,0,0,0,0,0,0,0,0,0,0.0,0,1,0,0,0,0,0,0,0,0,0,0,1,100.0,NoArch
52234662fa10c26453c337d0503a5f40ed74ba2e,1,18,0,18,0,0,0,1,2,11,1,1,0.0,36,4,2,4,4,0,106,106,0,3,3,0,0,100.0,NoArch
93fe02a6297cb278f4e4a9db574c6ff2a87340c0,1,1,1,0,0,0,0,1,3,0,1,1,0.0,145,232,23,10,10,0,382,382,0,5,5,0,0,100.0,NoArch
327df3f3b297d632ef66c842728b88eb6d0c1734,0,0,0,0,0,0,0,0,0,0,0,0,0.0,0,34,11,0,0,0,0,0,0,0,0,0,0,100.0,NoArch
4c2ba3744d90f2af12d815e8aa0747fd0d1a1c67,5,107,10,97,2,0,2,1,4,3,1,3,1.583692403,543,23,1,53,48,5,3092,2718,374,26,23,3,1,99.82680984,NoArch
01e9cb0a80924efbf8febdf8fff2ae52fcc02d5c,5,2430,0,2430,3,0,3,1,6,0,1,4,0.74170493,2743,245,35,991,511,480,30225,16090,14135,518,284,234,0,99.34834123,NoArch
55d19fa04b97a6a46581f0077c7fc65d51dd644f,1,1,1,0,0,0,0,5,19,33,1,1,0.0,300,0,0,31,31,0,1187,1187,0,12,12,0,1,100.0,NoArch
85d43f764b3dc1a06f7806be61df182c735ab088,0,0,0,0,0,0,0,0,0,0,0,0,0.0,0,266,10,0,0,0,0,0,0,0,0,0,0,100.0,NoArch
53b931afea58759577bbf5da30dd89c48182b76b,0,0,0,0,0,0,0,0,0,0,0,0,0.0,0,544,3,0,0,0,0,0,0,0,0,0,0,100.0,NoArch
2343daf29388566b0efa0b0a2ad21574fb534a27,5,113,30,83,0,0,0,3,55,1052,1,4,1.784932798,1827,509,22,232,221,11,6806,6532,274,127,123,4,2,100.0,NoArch
acc1a8b1bee1be619c8b08d72df37ca9be129978,1,24,12,12,0,0,0,1,10,0,1,1,0.0,272,172,25,23,23,0,785,800,15,12,12,0,0,100.0,NoArch
f1b94a6a77b3ed1117bd3cbfbec90090b49bf4eb,0,0,0,0,0,0,0,0,0,0,0,0,0.0,0,659,16,0,0,0,0,0,0,0,0,0,0,100.0,NoArch
bd20ecd52d0622a27276c093309ed65eeca77b59,2,22,28,6,0,0,0,1,16,3,1,1,0.680077046,535,464,17,39,39,0,1516,1589,73,26,24,2,0,100.0,NoArch
3355e3b25b8bcb7bc286c785372dcce59103277f,0,0,0,0,0,0,0,0,0,0,0,0,0.0,0,41,17,0,0,0,0,0,0,0,0,0,0,100.0,NoArch
520634faa5b2d18e178ab9f933665a0373a9d3b7,0,0,0,0,0,0,0,0,0,0,0,0,0.0,0,1,1,0,0,0,0,0,0,0,0,0,0,100.0,NoArch
015fc47405d2f89cae1f3367ba1a061376e4d148,2,68,6,62,0,0,0,1,5,0,1,2,0.800392208,446,222,22,39,35,4,2647,2219,428,19,18,1,0,99.38398357,NoArch
d845e81702c17052b2760fd61cdf9b5ac8483c7d,0,0,0,0,0,0,0,0,0,0,0,0,0.0,0,320,46,0,0,0,0,0,0,0,0,0,0,100.0,NoArch
ffc0ef53648d0358a390aa28ae7038bb7c3e5d0d,0,0,0,0,0,0,0,0,0,0,0,0,0.0,0,711,23,0,0,0,0,0,0,0,0,0,0,100.0,NoArch
ee7e1ea37bbb4bb0014b45bbb59ee6224f6645d7,0,0,0,0,0,0,0,0,0,0,0,0,0.0,0,546,23,0,0,0,0,0,0,0,0,0,0,100.0,NoArch
6d5da6edf8ca45517dd635d435ec90e612a1de71,1,0,1,1,0,0,0,1,4,141,1,1,0.0,162,293,37,9,9,0,842,849,7,2,2,0,0,100.0,NoArch
ba2a4738c81122a2f5ae06526d3beeee93a8af89,5,23,43,20,0,0,0,1,51,230,2,4,1.529870257,2531,908,0,245,249,4,11397,11491,94,118,119,1,0,100.0,NoArch
3c000d45dd7c3d0fa411041d67510f768226ae76,1,49,0,49,1,0,1,1,1,0,1,1,0.0,0,4,0,3,0,3,89,0,89,3,0,3,0,99.4140625,NoArch
a8dcc6fd81d946495162694ae43a85a271022ad3,0,0,0,0,0,0,0,0,0,0,0,0,0.0,0,152,13,0,0,0,0,0,0,0,0,0,0,100.0,NoArch
82ba63f1781f218ee8a599ffccd57c1958c4a351,1,5,3,2,0,0,0,1,4,63,1,1,0.0,80,291,35,5,5,0,368,347,21,1,1,0,0,100.0,NoArch
cb34e6f6a41b08c9d4e6179d9f893b0e48e7860c,9,99,43,56,0,0,0,5,65,55,3,6,2.810150342,3411,601,17,312,305,7,17587,17340,247,158,156,2,0,100.0,NoArch
df949e7a27e370d0e7f8013a7c7b0469382d1a2f,2,42,6,36,0,0,0,6,31,1,1,2,0.543564443,1293,591,6,80,79,1,7755,7504,251,56,55,1,1,100.0,NoArch
78460f9041ceb10d641a059773c6b68cab611144,3,0,284,284,0,3,3,1,23,3,1,2,1.33573083,284,291,72,0,11,11,0,1767,1767,0,6,6,0,99.12603496,NoArch
cb0f1ae0e0020f92183025cd04cbf0e4c2b316d5,3,102,34,68,0,0,0,1,27,65,2,3,1.324016331,956,831,10,83,80,3,4857,4410,447,44,43,1,0,100.0,NoArch
321d3a4a11d19f10c067ce2c12f18c0cc56e5cf8,1,30,1,29,0,0,0,1,21,105,1,1,0.0,685,821,3,47,42,5,3163,3039,124,25,25,0,0,100.0,NoArch
a65234ddbdfe1b36db040e1d255a998f77d4f6cb,11,139,21,118,0,0,0,1,44,350,2,7,2.566827029,2732,760,9,251,244,7,12192,11687,505,142,139,3,0,100.0,NoArch
857b40389c6aaf4beb7b510ec05a7bf83fdaa64a,0,0,0,0,0,0,0,0,0,0,0,0,0.0,0,646,20,0,0,0,0,0,0,0,0,0,0,100.0,NoArch
779ff5ea459ce8d60c92db1c3fde2966d1cc3e3a,21,427,339,88,1,3,4,5,66,56,3,13,3.436804802,5124,608,21,456,468,12,23036,23309,273,232,240,8,2,99.41972921,NoArch
1d8553d04c1c69198c4c1cb1fc836407ea6cd9a1,0,0,0,0,0,0,0,0,0,0,0,0,0.0,0,40,16,0,0,0,0,0,0,0,0,0,0,100.0,NoArch
75aa991e366cebdb6873509c7ced252731a2187c,0,0,0,0,0,0,0,0,0,0,0,0,0.0,0,571,33,0,0,0,0,0,0,0,0,0,0,100.0,NoArch
9e2eaf31df76e343e7e48de00497c92d7a812503,0,0,0,0,0,0,0,0,0,0,0,0,0.0,0,136,11,0,0,0,0,0,0,0,0,0,0,100.0,NoArch
1d3bed5ab0db77c0dbeb679d8b8f06cd21348085,1,1,1,0,0,0,0,5,12,384,1,1,0.0,111,0,0,13,13,0,459,451,8,5,5,0,0,100.0,NoArch
64ffd374bed766fa4849d61ec404a8eacf3aafbb,1,242,0,242,1,0,1,1,1,0,1,1,0.0,0,742,44,28,0,28,1173,0,1173,7,0,7,0,99.82227488,NoArch
b25a8a35856abf9710d42fae0a7324fbe66c362d,3,224,243,19,0,0,0,7,32,159,1,2,0.362896053,2606,611,12,241,239,2,12193,12424,231,94,94,0,0,100.0,NoArch
95f5515cfac88b275a2dae5798089498e0374716,0,0,0,0,0,0,0,0,0,0,0,0,0.0,0,28,3,0,0,0,0,0,0,0,0,0,0,100.0,NoArch
ed796e2e6a777df0a44e7a3c3e2dd34867dd1952,0,0,0,0,0,0,0,0,0,0,0,0,0.0,0,590,46,0,0,0,0,0,0,0,0,0,0,100.0,NoArch
73e910a7d906c7bd36ea24205617a89c77561ef7,0,0,0,0,0,0,0,0,0,0,0,0,0.0,0,373,22,0,0,0,0,0,0,0,0,0,0,100.0,NoArch
6f9a9ab4ff218fb4aa8e961239bee45fe647f416,5,2126,13,2113,0,0,0,1,21,0,1,4,0.245967827,14379,270,51,3267,2833,434,97365,84888,12477,1583,1382,201,0,99.94807892,NoArch
136190f691e9acc78c372aa0b790316b88c993af,3,137,9,128,0,0,0,1,8,0,1,1,0.674903692,479,168,22,49,49,0,1720,1704,16,24,24,0,0,100.0,NoArch
f07755171e7f65cfdb286c8be825fbf6be589f2f,0,0,0,0,0,0,0,0,0,0,0,0,0.0,0,850,21,0,0,0,0,0,0,0,0,0,0,100.0,NoArch
c9cb199b07b2047487802d6d5eb90a9e96104008,5,84,46,38,0,0,0,2,22,72,3,5,1.464273371,1994,508,5,132,128,4,11113,10954,159,79,79,0,0,99.96582365,NoArch
579fca53a3eacb21e7ba229acadf26fdfbeb45a9,0,0,0,0,0,0,0,0,0,0,0,0,0.0,0,174,26,0,0,0,0,0,0,0,0,0,0,100.0,NoArch
4ce1f9d018227a03523e0e973cb1571a17a5ee5d,1,8,2,6,0,0,0,2,17,43,1,1,0.0,262,988,80,35,34,1,1077,1057,20,14,14,0,0,100.0,NoArch
1ee16734beff6e42ef2999dc0c3118857499bd05,0,0,0,0,0,0,0,0,0,0,0,0,0.0,0,494,12,0,0,0,0,0,0,0,0,0,0,100.0,NoArch
d4c0be0f2e4f2890c6cc9de5d475b8ae3a6da845,1,9,4,5,0,0,0,4,49,59,1,1,0.0,679,824,4,89,88,1,2892,2873,19,45,44,1,0,100.0,NoArch
7ae8c2da7eb401e376030643770d408fdeaa8239,4,66,177,111,0,0,0,4,28,478,1,4,1.228061366,2674,0,0,217,231,14,13294,13737,443,90,90,0,1,100.0,NoArch
05be2863b502e17d36285af97f3d3834043af025,0,0,0,0,0,0,0,0,0,0,0,0,0.0,0,38,14,0,0,0,0,0,0,0,0,0,0,100.0,NoArch
607d51e8c5b8a6d041e03dae1f417a7729c14654,2,14,39,25,0,1,1,1,3,2,1,2,0.859531691,147,789,3,12,15,3,769,849,80,6,9,3,0,99.84834698,NoArch
36bff3aeb42b5e7e6ef1598714b5fc6fbd046748,0,0,0,0,0,0,0,0,0,0,0,0,0.0,0,218,26,0,0,0,0,0,0,0,0,0,0,100.0,NoArch
2a036c22c6772ea21ec9a4b4bb90319c12cf0bb1,0,0,0,0,0,0,0,0,0,0,0,0,0.0,0,873,17,0,0,0,0,0,0,0,0,0,0,100.0,NoArch
23a948cccfb6bed0fe65cf3511702dc022b8a78e,7,133,20,113,0,0,0,1,15,45,2,4,2.270364167,1409,386,12,118,109,9,5931,5456,475,56,53,3,0,100.0,NoArch
8f3c771e68e487d8ec9ecd297a2e34df561fb193,1,1,1,0,0,0,0,1,21,0,1,1,0.0,629,482,15,70,70,0,2376,2376,0,24,24,0,0,100.0,NoArch
437f7dd98e50977e96b8441d8cd11b24a1cb0941,0,0,0,0,0,0,0,0,0,0,0,0,0.0,0,2,2,0,0,0,0,0,0,0,0,0,0,100.0,NoArch
1ec76e52b0fe3b58ca7279ed6719ba4012febc33,1,1,1,0,0,0,0,3,43,76,1,1,0.0,672,759,8,86,86,0,2887,2889,2,43,43,0,0,100.0,NoArch
1ebe821793d14be9e618b67d2f512efce18bf402,1,18,0,18,0,0,0,1,3,0,1,1,0.0,17,807,21,0,0,0,19,19,0,0,0,0,0,100.0,NoArch
e1c3b39d1a811bc1a129c8dc8205d48d1b8f8a9c,2,1,35,34,0,0,0,1,24,4,1,2,0.811278124,780,847,18,46,46,0,3218,3298,80,26,26,0,0,100.0,NoArch
afa8f7a45b1cc154317ac757d20340ce26b9cdab,30,655,1043,388,0,4,4,3,27,100,3,6,3.014330662,5787,587,3,371,392,21,25487,27938,2451,179,197,18,2,98.07228916,NoArch
a6b191e38b958d1ec74a116c37d23cadea8716f7,0,0,0,0,0,0,0,0,0,0,0,0,0.0,0,676,33,0,0,0,0,0,0,0,0,0,0,100.0,NoArch
1b23f2628952b4b831c0aefddbf9bccc21ab6af4,2,6,8,2,0,0,0,3,3,0,1,2,1.0,474,1161,5,30,30,0,2498,2498,0,19,19,0,1,100.0,NoArch
cb0f1ae0e0020f92183025cd04cbf0e4c2b316d5,3,102,34,68,0,0,0,1,27,65,2,3,1.324016331,956,831,10,83,80,3,4857,4410,447,44,43,1,0,100.0,NoArch
649e490de01a5f440e00b22a69604df49e424242,0,0,0,0,0,0,0,0,0,0,0,0,0.0,0,572,1,0,0,0,0,0,0,0,0,0,0,100.0,NoArch
7f27225b3144a4d5b43ee50b4fd93f20d413a8a0,0,0,0,0,0,0,0,0,0,0,0,0,0.0,0,457,11,0,0,0,0,0,0,0,0,0,0,100.0,NoArch
faf4e376b5eaec83b4613086a392a8ec764802ec,0,0,0,0,0,0,0,0,0,0,0,0,0.0,0,51,27,0,0,0,0,0,0,0,0,0,0,100.0,NoArch
e40bda2e986345aa9025f13eedbeaebaec5d2125,0,0,0,0,0,0,0,0,0,0,0,0,0.0,0,1003,82,0,0,0,0,0,0,0,0,0,0,100.0,NoArch
f98f3e9692422c5372bc2d0dd756df89bd5bfa12,0,0,0,0,0,0,0,0,0,0,0,0,0.0,0,299,43,0,0,0,0,0,0,0,0,0,0,100.0,NoArch
bd20ecd52d0622a27276c093309ed65eeca77b59,2,22,28,6,0,0,0,1,16,3,1,1,0.680077046,535,464,17,39,39,0,1516,1589,73,26,24,2,0,100.0,NoArch
a718c3ad28a6c9575acc81809d99dbccb5a938f3,0,0,0,0,0,0,0,0,0,0,0,0,0.0,0,656,13,0,0,0,0,0,0,0,0,0,0,100.0,NoArch
e8b66887fd632225d80e3e02699e5f26b77ee04f,0,0,0,0,0,0,0,0,0,0,0,0,0.0,0,963,37,0,0,0,0,0,0,0,0,0,0,100.0,NoArch
9588eb9f2ed5068b2634a8b449dd873343d226f0,4,83,2,81,0,0,0,1,9,297,1,2,1.910342461,1015,757,6,101,90,11,4546,4195,351,54,52,2,0,100.0,NoArch
c026df787ab6a547d1eeeafd5785e2859d3e7963,0,0,0,0,0,0,0,0,0,0,0,0,0.0,0,12,1,0,0,0,0,0,0,0,0,0,0,100.0,NoArch
e2551307c2396763244b02bf2ec32f7c7ac79efa,0,0,0,0,0,0,0,0,0,0,0,0,0.0,0,607,28,0,0,0,0,0,0,0,0,0,0,100.0,NoArch
c8995237157a94cc95ae32726765d744109d21b1,1,0,3,3,0,0,0,1,3,41,1,1,0.0,217,323,4,15,15,0,888,894,6,10,10,0,0,100.0,NoArch
32ffdf3a8171cf53de3026487fa2d6ce0d6301cf,0,0,0,0,0,0,0,0,0,0,0,0,0.0,0,827,6,0,0,0,0,0,0,0,0,0,0,100.0,NoArch
48824ebe0df4f384fdb1542d0d9768798c33c058,1,3,3,0,0,0,0,4,20,32,1,1,0.0,687,565,27,43,43,0,3883,3883,0,30,30,0,0,100.0,NoArch
8375120b6edfb8a2f1610c3853dfe0a71acb5b5a,0,0,0,0,0,0,0,0,0,0,0,0,0.0,0,1,1,0,0,0,0,0,0,0,0,0,0,100.0,NoArch
097083c4a2cd2e252c6f3b57e3e837e4a9ecabc9,1,1,2,1,0,0,0,4,32,1,1,1,0.0,614,957,50,25,25,0,4646,4655,9,24,24,0,0,100.0,NoArch
c4f3a505b70f02bf209613307b3bdefaff7bf4fe,1,1,2,1,0,0,0,2,6,1428,1,1,0.0,188,560,22,22,22,0,732,732,0,7,7,0,0,100.0,NoArch
0149fee9a29cd960a073a9435fb5c9d631bfd68d,0,0,0,0,0,0,0,0,0,0,0,0,0.0,0,926,12,0,0,0,0,0,0,0,0,0,0,100.0,NoArch
1d674cb56b01fead1bf9bd10631c05fcfa35fcba,1,45,42,3,0,0,0,2,6,2,1,1,0.0,324,583,40,43,43,0,1366,1366,0,15,15,0,0,100.0,NoArch
2998114ba1674746777f82554cd031131e4c721c,4,12,8,4,0,0,0,1,4,321,2,2,1.712887622,659,281,62,83,82,1,3429,3361,68,34,33,1,0,99.58866545,NoArch
3e7746ae975aa9c737ba92a7f870fa267e6e6d8b,0,0,0,0,0,0,0,0,0,0,0,0,0.0,0,340,9,0,0,0,0,0,0,0,0,0,0,100.0,NoArch
59beafac5efa6e1aee23bdd14b4d88fb8cc15116,0,0,0,0,0,0,0,0,0,0,0,0,0.0,0,719,31,0,0,0,0,0,0,0,0,0,0,100.0,NoArch
44461b749ffcb09dc1b10a8f997a70fe08decf17,0,0,0,0,0,0,0,0,0,0,0,0,0.0,0,658,15,0,0,0,0,0,0,0,0,0,0,100.0,NoArch
a8a5d46cca4a6257d7f8edce9f3d21af3526847b,2,30,6,24,0,0,0,4,6,100,1,1,0.309543429,365,0,0,56,52,4,1523,1402,121,30,28,2,0,100.0,NoArch
9a3eceac2aea9c8b73a36af4f5aa72a62ea41d22,0,0,0,0,0,0,0,0,0,0,0,0,0.0,0,127,37,0,0,0,0,0,0,0,0,0,0,100.0,NoArch
3c3f6acfbc22c7fa2d42dc92001e88a9c2d37b0a,0,0,0,0,0,0,0,0,0,0,0,0,0.0,0,714,26,0,0,0,0,0,0,0,0,0,0,100.0,NoArch
7197401624a22069921c820543cbd7179407ae63,1,11,0,11,0,0,0,1,2,0,1,1,0.0,8,477,21,0,0,0,44,35,9,0,0,0,0,100.0,NoArch
351f01272ef83617976616e0b08019a4bc7f68db,1,5,5,0,0,0,0,1,2,0,1,1,0.0,81,622,19,8,8,0,208,227,19,5,5,0,0,100.0,NoArch
1df5fd0ce5553270b3dcb42b5d2026eaadfffa5d,0,0,0,0,0,0,0,0,0,0,0,0,0.0,0,28,5,0,0,0,0,0,0,0,0,0,0,100.0,NoArch
c1084663aa8991a06cc7390180d07cbaf6c330e1,2,36,0,36,0,0,0,1,2,0,1,1,1.0,14,595,11,0,0,0,64,64,0,0,0,0,0,100.0,NoArch
a47c03671452a20e70deb2b8668d70bd92d78ce7,1,46,9,37,0,0,0,1,10,0,1,1,0.0,600,29,7,38,35,3,3268,3094,174,20,19,1,1,100.0,NoArch
ed93e801eb12102612f310d1ab2339a6f7265ea9,0,0,0,0,0,0,0,0,0,0,0,0,0.0,0,316,8,0,0,0,0,0,0,0,0,0,0,100.0,NoArch
bd8fb6609601f399e7d3ffa0a6b60c658686a4d7,2,44,7,37,0,0,0,3,20,188,1,2,0.462749059,679,2,1,54,49,5,4721,4539,182,33,28,5,0,100.0,NoArch
ca8f2792aa23dec5e35f31c8dcc40ae572f40ef2,0,0,0,0,0,0,0,0,0,0,0,0,0.0,0,522,35,0,0,0,0,0,0,0,0,0,0,100.0,NoArch
4228fe52fa7cdbed5263815e83a1beeecc39c095,0,0,0,0,0,0,0,0,0,0,0,0,0.0,0,683,40,0,0,0,0,0,0,0,0,0,0,100.0,NoArch
dc987ef0ee396efd7eb0caa77bf4993e63929e5c,0,0,0,0,0,0,0,0,0,0,0,0,0.0,0,274,18,0,0,0,0,0,0,0,0,0,0,100.0,NoArch
69c9d8baeb06718c2d887127f0fed6354ebc99c2,0,0,0,0,0,0,0,0,0,0,0,0,0.0,0,947,33,0,0,0,0,0,0,0,0,0,0,100.0,NoArch
37b6dbe64b98ced161dd33b1e7d15e5ade35abc6,2,70,0,70,0,0,0,1,4,299,1,2,0.468995594,418,750,52,48,42,6,2087,1736,351,32,30,2,0,100.0,NoArch
93fe02a6297cb278f4e4a9db574c6ff2a87340c0,1,1,1,0,0,0,0,1,3,0,1,1,0.0,145,232,23,10,10,0,382,382,0,5,5,0,0,100.0,NoArch
659bde34339be61d8314433ae8269c71ec21f534,0,0,0,0,0,0,0,0,0,0,0,0,0.0,0,317,9,0,0,0,0,0,0,0,0,0,0,100.0,NoArch
7aa5617e299a6259de3360bef307a231b426bcfb,1,55,0,55,0,0,0,1,2,0,1,1,0.0,58,777,3,7,4,3,701,328,373,4,3,1,0,99.84862246,NoArch
04cefb47f18c9d4bd3a0eb897563dd5abb7c89c8,6,334,374,40,0,0,0,4,26,2,2,6,1.797351517,2791,236,2,271,271,0,11051,11063,12,113,111,2,0,100.0,NoArch
b75f92bf2dbacd755c770373195a8444338041c8,18,321,528,207,0,2,2,4,25,820,3,6,3.674002595,4046,1,0,313,337,24,17425,17991,566,191,203,12,0,99.85825656,NoArch
64e5cfec37e1a20d4ea925fbb401774fa370995c,0,0,0,0,0,0,0,0,0,0,0,0,0.0,0,306,86,0,0,0,0,0,0,0,0,0,0,100.0,NoArch
a3ca8b5d159262fcd3c2fc7cdfc5c26c6c5473cd,3,81,0,81,0,0,0,7,100,67,1,3,1.530493057,2234,1143,3,265,257,8,10733,10318,415,114,113,1,1,100.0,NoArch
53eceda35aab64e4c703b1dbf630de21bccc4533,0,0,0,0,0,0,0,0,0,0,0,0,0.0,0,365,14,0,0,0,0,0,0,0,0,0,0,100.0,NoArch
6cebfc13ccdcd9cb2a5b576fa369b957e651752a,1,12,9,3,0,0,0,8,18,588,1,1,0.0,550,0,0,48,47,1,1803,1797,6,26,26,0,1,100.0,NoArch
4ad1fb8e5867648e311200edbba773b203c546ad,8,21,254,233,0,0,0,2,16,261,3,7,2.241852626,1957,910,3,117,135,18,8496,10055,1559,89,96,7,0,99.77137631,NoArch
ede665bc855ec1be1f5ed6d285f26c5da65007e7,1,4,3,1,0,0,0,1,4,0,1,1,0.0,77,311,55,5,5,0,170,170,0,2,2,0,0,100.0,NoArch
96340af1d1525b2c5bf50adccc499c6917ff7563,1,5,1,4,0,0,0,7,18,30,1,1,0.0,545,959,52,21,21,0,3208,3177,31,9,9,0,0,100.0,NoArch
9fa9ec0acce8afc01da943b1922a731059cb4cd2,0,0,0,0,0,0,0,0,0,0,0,0,0.0,0,3,2,0,0,0,0,0,0,0,0,0,0,100.0,NoArch
fd3728d56366bcc9c4b3444182a8b6e7a38633a6,1,9,0,9,0,0,0,2,2,148,1,1,0.0,118,1142,2,10,9,1,636,559,77,7,7,0,1,100.0,NoArch
5cdfb5bcdb352e352c45d5cccda7c74aecfb0bd7,1,39,28,11,0,0,0,5,30,500,1,1,0.0,853,542,1,116,116,0,3516,3504,12,38,38,0,0,100.0,NoArch
6e3cbff1cc2e5f4e80f52908c2ad91af64ac0e99,1,11,0,11,0,0,0,1,3,186,1,1,0.0,169,114,27,14,13,1,446,395,51,9,9,0,0,100.0,NoArch
c3adc95315413ee5c0be861b528e80a380444e5b,2,12,15,3,0,0,0,1,3,0,1,2,0.950956048,299,926,19,18,19,1,2229,2189,40,11,11,0,0,99.75240715,NoArch
e4f9bf96ca7eebaee82425ecf65cd6b1e5098a14,2,34,23,11,0,0,0,2,3,8,1,1,0.774631987,128,813,15,10,9,1,576,537,39,9,8,1,0,100.0,NoArch
896c7c1b3a7671c67dbcbca76976e91103b55289,0,0,0,0,0,0,0,0,0,0,0,0,0.0,0,126,2,0,0,0,0,0,0,0,0,0,0,100.0,NoArch
e11db6dfcfd719e0912fbe1c2ab211ceffcb23c4,1,11,0,11,0,0,0,1,12,0,1,1,0.0,165,250,40,16,16,0,1141,1075,66,6,6,0,0,100.0,NoArch
722d0cee3c0ad1ef65f25a80f5363bfcfd9e3792,4,264,14,250,2,0,2,1,26,101,2,3,1.482338676,905,484,3,113,98,15,3947,2965,982,72,62,10,1,99.78457561,NoArch
7483ae82c89a54233df24caa35ef04d3f681f94e,1,1,4,3,0,0,0,1,2,302,1,1,0.0,54,390,15,6,7,1,155,177,22,2,2,0,0,100.0,NoArch
44c99f8860027b8b0015f8cb3d9a6f7522b2a170,0,0,0,0,0,0,0,0,0,0,0,0,0.0,0,952,38,0,0,0,0,0,0,0,0,0,0,100.0,NoArch
171118a943a9c5ae2f82ad48925ee1ddd8db9527,0,0,0,0,0,0,0,0,0,0,0,0,0.0,0,816,18,0,0,0,0,0,0,0,0,0,0,100.0,NoArch
1ca0a4239163e4de730a75fa58cc817b5b54a87c,0,0,0,0,0,0,0,0,0,0,0,0,0.0,0,117,30,0,0,0,0,0,0,0,0,0,0,100.0,NoArch
6464bb4d4d07aeb12409893cbc1026ed1cd79223,0,0,0,0,0,0,0,0,0,0,0,0,0.0,0,541,0,0,0,0,0,0,0,0,0,0,1,100.0,NoArch
3a0a00abe03e7fd8ec26ee3f160ef56961bc7550,1,3,0,3,0,0,0,1,4,141,1,1,0.0,187,287,31,22,22,0,505,505,0,7,7,0,0,100.0,NoArch
a27e00e06cc8496eaa638453b4a46372899fb8a6,1,2,0,2,0,0,0,2,4,585,1,1,0.0,189,123,9,16,16,0,947,929,18,10,10,0,0,100.0,NoArch
2724443527db10aab3e505ce3643a0da67a1a7f2,0,0,0,0,0,0,0,0,0,0,0,0,0.0,0,551,10,0,0,0,0,0,0,0,0,0,0,100.0,NoArch
956176629f5cc9d7c53b52068e4ebdcbdfb86e68,4,12,16,4,0,0,0,3,18,2324,1,1,1.672904265,599,1,0,63,62,1,2183,2211,28,27,27,0,1,100.0,NoArch
9f480b924b6159b5e17c6251df1c704e4d26381e,0,0,0,0,0,0,0,0,0,0,0,0,0.0,0,177,29,0,0,0,0,0,0,0,0,0,0,100.0,NoArch
ec82566202c1e5e879ba31c9da4392f005f922d3,0,0,0,0,0,0,0,0,0,0,0,0,0.0,0,608,29,0,0,0,0,0,0,0,0,0,0,100.0,NoArch
a04b4d562870ea993852ed821bfedc54649cdc21,0,0,0,0,0,0,0,0,0,0,0,0,0.0,0,271,15,0,0,0,0,0,0,0,0,0,0,100.0,NoArch
0f0723bb8502c1529b17d640de7244f488ca128a,0,0,0,0,0,0,0,0,0,0,0,0,0.0,0,330,11,0,0,0,0,0,0,0,0,0,0,100.0,NoArch
b02459f48fa5e1e7d1acacb41a30232c78ef83eb,1,9,0,9,0,0,0,1,2,2,1,1,0.0,275,820,20,29,29,0,1094,1094,0,14,14,0,0,100.0,NoArch
38b4e421baea5d8c0fb213dd15bd36bc8d82263c,1,2,2,0,0,0,0,1,13,20,1,1,0.0,326,166,22,37,37,0,1358,1358,0,13,13,0,0,100.0,NoArch
fe34ac579c89407d4c8cd0dabebeaae4f00e3b73,0,0,0,0,0,0,0,0,0,0,0,0,0.0,0,5,5,0,0,0,0,0,0,0,0,0,0,100.0,NoArch
8cae5ef9fbf170a07909d56c9aa08d24338e565a,2,418,0,418,2,0,2,1,1,0,1,2,0.996281156,0,526,5,38,0,38,2015,0,2015,17,0,17,0,99.67083608,NoArch
67ba6dbeb92040450410c22ea7f4388450832aec,1,3,1,2,0,0,0,1,10,17,1,1,0.0,592,417,32,29,29,0,3654,3636,18,17,17,0,0,100.0,NoArch
21f3ac252fbd31cdf0e0c2069013d6ab7923eec5,1,1,0,1,0,0,0,1,10,0,1,1,0.0,87,817,31,1,1,0,166,166,0,1,1,0,0,100.0,NoArch
abf5fddae35e62b93256c2e473df8b79b3b76969,3,50,23,27,0,0,0,1,8,0,1,1,0.911258331,140,241,31,17,15,2,849,680,169,11,11,0,0,100.0,NoArch
b97439027610df35950a452c23148a15e02023ef,0,0,0,0,0,0,0,0,0,0,0,0,0.0,0,420,35,0,0,0,0,0,0,0,0,0,0,100.0,NoArch
543860f4811fa5327cabe524dad786363eb3f504,7,189,46,143,1,0,1,2,22,56,3,7,2.132738028,2540,543,16,174,161,13,14089,13560,529,97,90,7,0,99.90006662,NoArch
351f01272ef83617976616e0b08019a4bc7f68db,1,5,5,0,0,0,0,1,2,0,1,1,0.0,81,622,19,8,8,0,208,227,19,5,5,0,0,100.0,NoArch
29fb6de7c8b9d34fa5cb8d78a0e3111c53263a12,0,0,0,0,0,0,0,0,0,0,0,0,0.0,0,567,1,0,0,0,0,0,0,0,0,0,0,100.0,NoArch
1eb8aa8490fe4a007173e4dd70a78425cd74e02a,0,0,0,0,0,0,0,0,0,0,0,0,0.0,0,965,58,0,0,0,0,0,0,0,0,0,0,100.0,NoArch
5030c198456150a82bf2a2a2e5aea75b65b2efc8,5,17,12,5,0,0,0,2,14,618,2,3,2.240277443,1701,373,4,180,180,0,7317,7253,64,76,76,0,0,100.0,NoArch
fecb6db8b5d63474cf24e081ba086065c2d8502a,1,388,0,388,1,0,1,1,1,0,1,1,0.0,0,264,50,71,0,71,2131,0,2131,37,0,37,0,99.89059081,NoArch
a21c31c59c5209bda75ad853bcf657c85753e99d,0,0,0,0,0,0,0,0,0,0,0,0,0.0,0,963,56,0,0,0,0,0,0,0,0,0,0,100.0,NoArch
94dff8a5a2ec336a23c05ebe5cdf7e4b117d3925,2,3,0,3,0,0,0,1,15,0,1,2,0.918295834,522,510,23,53,53,0,1395,1395,0,43,43,0,0,100.0,NoArch
b7cfbb64a10526a612f87a00f62e32d08b5da411,1,4,1,3,0,0,0,5,29,2,1,1,0.0,735,616,15,44,44,0,4205,4176,29,31,31,0,0,100.0,NoArch
3d3336a09ccbc380b68b03d2d4057c6c5b17615c,2,415,1,414,1,0,1,1,5,46,1,1,0.043940679,181,181,33,50,14,36,1844,446,1398,29,9,20,0,99.21752739,NoArch
e9cf5ad6db7ef14d511cedeaccf35ec7d9b22e9d,40,834,743,91,6,2,8,1,17,26,2,15,4.617590111,7169,194,46,544,529,15,28445,28066,379,274,269,5,0,88.61154446,Arch
10fe2fd4ab5b582dc2931d91db36e84874ebb539,10,112,17,95,0,0,0,1,13,57,1,5,2.863705852,1758,200,52,111,108,3,7617,7097,520,61,58,3,0,91.18046133,Arch
8e847c76edab42f5c847d4b50dcca34ea8b8c78b,1,39,1,38,0,0,0,1,2,129,1,1,0.0,51,202,53,2,1,1,328,164,164,2,1,1,0,92.06762029,Arch
3e78e6b58406ccdab762c0f8fd84447b8d10785b,3,112,22,90,0,0,0,1,9,13,1,2,1.445097459,639,120,33,61,52,9,3106,2670,436,27,21,6,0,95.6780924,Arch
04532e686b5d2e6dd1b996d8c17aee3a845a68dc,8,703,226,477,4,1,5,1,10,0,1,2,2.309436569,872,128,32,99,74,25,5077,3436,1641,44,37,7,0,94.0915805,Arch
f338e2335d5bac887565ed5fb94dba5a27d9ef02,3,127,6,121,1,0,1,1,8,0,1,2,1.562279307,947,140,36,82,76,6,4777,4333,444,26,24,2,0,96.74902471,Arch
31cffd77b4a0ff39be39a49e967629d4a9e8fdff,11,275,34,241,0,0,0,1,11,86,3,6,2.423064256,2532,143,28,215,193,22,12859,11872,987,102,92,10,0,94.05255878,Arch
6fd1fcf932e674dc6e9d6de0d4691e2d229a43d4,18,149,157,8,1,0,1,1,12,78,2,10,3.479143453,4497,147,8,356,358,2,19572,19598,26,166,167,1,0,97.5,Arch
6477ee4bc53b9ff55e0a41b67679871da7918a9b,8,658,964,306,2,2,4,1,14,59,1,2,2.570759878,1490,167,21,97,120,23,4810,5579,769,41,54,13,0,97.47235387,Arch
7439e966018aedc9930e0586bfae2cc62c899366,4,450,3,447,3,0,3,1,1,0,1,2,1.474968359,24,169,22,27,0,27,1771,25,1746,16,0,16,0,97.03125,Arch
b34a9621f36eb74e94db3ea34d5d80c15ed3c7e9,8,410,377,33,1,1,2,1,5,140,1,2,1.820416581,1036,178,30,79,69,10,4546,4234,312,38,33,5,0,94.18070444,Arch
18f25f679cb0ad0d98adbc88f06fdb8ffcceff97,1,0,38,38,0,0,0,1,3,0,1,1,0.0,89,205,56,1,2,1,165,328,163,1,2,1,0,92.06762029,Arch
be193437e46149bbe1bc9ba99acb2b3fd32d215d,9,1058,0,1058,9,0,9,1,1,0,1,2,2.911504392,0,211,20,85,0,85,3965,0,3965,54,0,54,0,89.42436412,Arch
03f72ec5d4901dd075e2509eba7983495da1bce3,9,479,114,365,4,0,4,1,4,0,1,2,2.878503568,800,214,22,99,68,31,4844,3134,1710,53,43,10,0,90.21879022,Arch
d03c40dff7d277325998d482a1d50ece5af946bf,20,971,247,724,10,0,10,1,5,0,1,4,3.356117489,1082,221,29,109,68,41,7080,4548,2532,72,43,29,0,94.9044586,Arch
1b644817e443ca7ff86dd9877b703e8c69aefd89,1,44,0,44,0,0,0,1,3,2,1,1,0.0,176,236,25,7,5,2,1006,767,239,4,3,1,0,95.58974359,Arch
1c95337b20d664936f9464a5d833969bf421dd02,3,29,7,22,0,0,0,1,9,40,2,2,1.430498019,548,238,27,28,26,2,2500,2525,25,14,14,0,0,95.58974359,Arch
5b7758f13fe33c2c8a03669de0a002c8192946c5,20,87,173,86,1,3,4,1,10,82,5,8,3.075212068,2873,249,35,177,173,4,12348,12659,311,78,79,1,0,96.26168224,Arch
56eb5d83a84143a25eedd4f6f465d843d9fd5fbc,16,85,291,206,0,2,2,1,20,77,4,11,2.985866514,4186,253,27,387,402,15,15049,15520,471,187,202,15,0,83.41067285,Arch
80d515277197e2e3c56c26e429a3db80258c5390,22,1541,0,1541,22,0,22,1,1,0,1,9,4.251685904,0,256,7,113,0,113,7754,0,7754,71,0,71,0,93.15263909,Arch
612c7e4b5f37ca2678e5ef52c1c03d771ae21123,18,440,524,84,2,8,10,1,6,0,2,9,3.766245065,1295,258,7,113,114,1,6746,6685,61,58,60,2,0,95.08196721,Arch
78192933024528d664e25618eeae6742ede51dfe,19,313,99,214,4,1,5,1,3,0,1,7,3.277833597,1368,259,6,112,102,10,8624,7392,1232,70,61,9,0,94.01709402,Arch
7288effdbc724cae1679fb3b9e01922808c9c4df,15,133,35,98,0,0,0,1,4,0,1,5,3.318011028,1388,260,7,109,101,8,7413,7218,195,66,60,6,0,77.57660167,Arch
d355ba93f98f400f9b839f4fb984d207a819e50d,4,7,0,7,0,0,0,1,2,0,1,2,1.950212065,289,267,11,27,27,0,1159,1105,54,20,20,0,0,80.82010582,Arch
cf09a02e2cbf3ff197f057d5be0e6f9bd62391ca,20,114,67,47,0,0,0,1,1,0,1,6,3.898868138,1868,273,17,133,131,2,9685,9332,353,88,85,3,0,73.9869281,Arch
0865db60e3e57f923e036699a2c9393b712f5c92,1,18,1,17,0,0,0,1,9,63,1,1,0.0,158,292,36,6,6,0,1180,1074,106,3,3,0,0,86.43457383,Arch
d6b16a76f54dc9a5b3b4da4c820f637e2d34dcdc,8,111,11,100,2,0,2,1,12,24,4,7,2.114006788,1438,295,39,95,92,3,6822,6455,367,37,35,2,0,97.49182116,Arch
140aaffce1c958c8fcb443d4afc6a8c9da731c8e,3,178,12,166,1,0,1,1,3,0,1,1,0.728295414,659,296,40,71,54,17,2827,2290,537,40,30,10,0,93.26818675,Arch
512e3f2de763cd1876bd354c5e37d010cb37025e,20,610,33,577,5,0,5,1,21,196,2,7,3.175085876,3483,309,1,297,271,26,17665,15300,2365,155,144,11,0,88.80829016,Arch
8d2c1cde32f5470106c4381426cd7a09261a1c97,16,302,75,227,4,0,4,1,17,0,1,4,3.105976071,1997,303,47,161,153,8,9088,7953,1135,99,94,5,0,87.27477477,Arch
8b71679a5756417e94cda51c93d580d4dbb8740a,7,74,28,46,1,0,1,1,11,9,4,6,2.297769845,1211,309,53,66,64,2,6360,6133,227,25,24,1,0,90.6002265,Arch
64a657533da270700c7fed933df302b0fa4ff059,10,43,176,133,0,3,3,1,13,0,5,8,2.514884417,1660,310,54,87,87,0,7546,8235,689,33,35,2,0,93.72427984,Arch
5ddc45d445b676d907ece19d352ab3e158e3d428,33,174,1081,907,2,12,14,1,15,33,5,14,4.393965366,5606,302,0,336,383,47,19814,22925,3111,179,209,30,0,92.29166667,Arch
363372be55e99260ebec902e7a03b8b2c5b0d9d8,13,108,160,52,0,2,2,1,13,46,5,9,3.224271575,2630,304,2,165,160,5,11646,11940,294,69,69,0,0,94.22657952,Arch
270b70c4626d4a50927393e184085b125ae7f9e0,18,948,5,943,12,0,12,1,18,3,2,5,3.64361801,1649,325,6,176,137,39,10291,6946,3345,104,75,29,0,95.33195021,Arch
e6aa29f66a5bf4a9d6e0e1fdd68e4035cb5f4ce7,18,5,948,943,0,12,12,1,16,43,2,5,3.64361801,2592,306,4,137,176,39,6946,10291,3345,75,104,29,0,95.33195021,Arch
ec78c8c04d74be389cf856ce24143495c17713eb,18,948,5,943,12,0,12,1,18,3,2,5,3.64361801,1649,329,10,176,137,39,10291,6946,3345,104,75,29,0,95.33195021,Arch
8670ecd41d785234e8d1f90e50265e9ad7281aab,4,192,16,176,1,0,1,1,13,183,1,2,1.851142807,1176,331,8,98,90,8,5783,5157,626,38,33,5,0,87.20173536,Arch
23ad7255d9733e647d8303c5d84aa56cb2a9a235,2,146,1,145,1,0,1,1,13,48,1,1,0.14372617,307,333,2,22,18,4,2289,1505,784,6,4,2,0,85.85858586,Arch
66f0876bd294e51987ed0d7082e45a26a66a66a3,36,66,1634,1568,0,17,17,1,20,37,2,10,4.442691749,6170,308,0,373,445,72,19888,25790,5902,194,235,41,0,86.91489362,Arch
a8a543b99c35bb4c2a5370abb87ba6de47523163,19,1067,129,938,12,0,12,1,19,21,2,6,3.793887923,2255,339,8,242,204,38,12619,9294,3325,125,97,28,0,95.11698881,Arch
01884d69d74d5c49e0748a6196e8226c0fe50241,19,129,1067,938,0,12,12,1,18,56,2,6,3.793887923,3193,311,3,204,242,38,9294,12619,3325,97,125,28,0,95.11698881,Arch
81e8bd4dc2fb1eb771e7deda646e8d210400e796,19,1067,129,938,12,0,12,1,19,21,2,6,3.793887923,2255,342,11,242,204,38,12619,9294,3325,125,97,28,0,95.11698881,Arch
066fbb591969d7ecc90107e39288674e83818ac4,1,18,6,12,0,0,0,1,4,540,1,1,0.0,108,355,4,5,5,0,278,233,45,4,4,0,0,92.68510259,Arch
eb4d2aaf7702e7e5ffbf1c1dd8544e88b1171045,10,364,101,263,1,0,1,1,22,124,3,7,2.532853498,2111,356,5,157,134,23,10745,10102,643,66,52,14,0,95.57877814,Arch
511af91ab42c638f45f6328588b66b76dd692901,13,108,420,312,0,1,1,0,21,81,3,10,2.916813375,3502,2,2,207,232,25,14850,15720,870,86,101,15,0,91.42857143,Arch
bfe3b8db844415ad538d1c9bde8295a81474d25c,13,419,107,312,1,0,1,1,22,145,3,10,2.918147436,3190,360,9,232,207,25,15720,14850,870,101,86,15,0,91.42857143,Arch
53c9cda3e31cd6111f67da77fda56bdfa0c22a3a,1,7,3,4,0,0,0,1,12,110,1,1,0.0,613,370,19,30,30,0,3288,3244,44,10,10,0,0,92.56698358,Arch
9b9cac92d153f85fae05d1f1e9af19c960b051b7,8,0,517,517,0,3,3,1,20,132,1,3,2.319349863,2035,372,21,134,164,30,6218,8832,2614,75,96,21,0,96.13356766,Arch
072a88a8f45fee8e1b0e921123dbb94831e7d060,8,517,0,517,3,0,3,1,19,48,1,3,2.319349863,1518,370,19,164,134,30,8832,6218,2614,96,75,21,0,96.13356766,Arch
1c10d4fd75f72dd5ca2e1de987c1d45dc3594e4f,16,481,20,461,8,0,8,1,23,165,1,4,3.419819284,1814,424,28,179,162,17,9046,7342,1704,112,102,10,0,94.41157133,Arch
1cf2724fa50fe75b993be41d278f1bcaeb1c6c0f,8,89,7,82,2,0,2,1,24,16,2,5,2.735735867,1703,428,32,183,178,5,6920,6480,440,106,101,5,0,93.43707713,Arch
76d23af185b4a5818f740d8fbbc431bbd25970d3,1,53,11,42,0,0,0,1,12,13,1,1,0.0,218,443,37,32,25,7,1052,973,79,12,11,1,0,93.55670103,Arch
537bba739fbd4b0c8b8b658d5a0b655a50c1601c,20,11,944,933,0,12,12,1,26,207,3,6,3.731459846,2966,447,41,183,222,39,8305,11546,3241,98,125,27,0,89.41368078,Arch
469da5e561baac8f10d6dadefebabcdf2e8eb44e,24,1484,12,1472,14,0,14,1,25,29,3,7,3.790047455,2490,447,23,295,219,76,14926,9680,5246,159,120,39,0,89.05109489,Arch
340f000604a1b156b9a109241b4ba0de526abd20,4,26,31,5,0,0,0,1,14,8,1,2,1.186588971,962,450,26,79,83,4,3491,3489,2,30,29,1,0,91.98341396,Arch
8df4988ee5127dc89047384ab8ea1ee09ae44031,5,16,537,521,0,2,2,0,16,21,1,2,1.410645928,1256,448,24,63,94,31,2952,4904,1952,32,45,13,0,91.74757282,Arch
a02082ea2b482970e160b159c6c1b51f3e360777,4,534,0,534,2,0,2,1,16,12,1,2,1.237362215,537,456,20,85,52,33,3966,1959,2007,40,27,13,0,91.74757282,Arch
11032b3a496d44738f0ca440e2d83a46b195ad52,4,26,559,533,0,2,2,0,14,21,1,2,1.531665146,1072,453,6,53,85,32,1921,3967,2046,28,40,12,0,91.74757282,Arch
9306d93a0013df64c06e4cd003eb311cf50f7ce0,4,535,0,535,2,0,2,1,18,3,1,2,1.237136497,539,463,16,86,53,33,3929,1921,2008,41,28,13,0,91.74757282,Arch
f0c4b674e48b1599fba0139872bb3c6c7ba2ba65,5,26,530,504,0,2,2,2,14,37,2,3,1.485369406,1129,1,0,61,91,30,2350,4152,1802,32,47,15,0,91.74757282,Arch
7c1aa60572d9c5c7a41945ac8812463e51edcbbd,9,753,71,682,3,0,3,1,24,116,2,4,2.078132847,1127,454,1,170,105,65,6828,4123,2705,79,47,32,0,88.98450947,Arch
b05e761e28ce1e581ed91d891cb61adcd3760493,20,11,944,933,0,12,12,2,26,207,3,6,3.731459846,3005,475,17,189,228,39,8467,11708,3241,99,126,27,0,97.60132341,Arch
16b22bc4db9b4f682dcbb979813ff94423f34d85,21,14,959,945,0,12,12,3,33,21,3,6,3.779206109,3324,593,49,216,255,39,9561,12887,3326,113,140,27,0,93.28775637,Arch
9b846c783959b4e7d5817f18ca5c52808a02225a,21,959,14,945,12,0,12,3,32,127,3,6,3.779206109,2379,591,47,255,216,39,12887,9561,3326,140,113,27,0,93.28775637,Arch
38fd751bee7bd8b0b7860e47928dc1cc3f042eb1,21,14,959,945,0,12,12,3,31,173,3,6,3.779206109,3324,595,51,216,255,39,9561,12887,3326,113,140,27,0,93.28775637,Arch
d35cf1662b1cef6359fa2d687eebda78c3af0da9,118,2025,1284,741,12,0,12,3,32,315,4,21,6.620275653,18913,592,48,1460,1421,39,79379,76053,3326,721,694,27,0,93.28775637,Arch
d9f6e18d0be85b6f8790093d99784bac4a487c38,3,295,19,276,2,0,2,1,9,2,1,2,1.412013169,350,593,14,63,43,20,2572,1366,1206,25,15,10,0,94.69240048,Arch
7a81d0619e35986585fdf5241ec6cd4148b93fa9,3,77,42,35,0,0,0,1,28,18,1,2,1.048002454,1138,603,24,121,121,0,5035,4878,157,45,47,2,0,97.01986755,Arch
3401bc54d13353be4654acc2f15b6a357cae7eb2,15,328,107,221,2,0,2,1,35,202,3,8,2.964897964,3819,605,26,388,372,16,17710,16575,1135,174,164,10,0,88.85850991,Arch
8c736c79d3e8d9c4b050917013f0435e579f3772,21,14,959,945,0,12,12,3,35,19,3,6,3.779206109,3324,599,20,216,255,39,9552,12878,3326,113,140,27,0,96.06413994,Arch
33221e335e72a3a578e167ea60922b0b70c8b4ea,22,966,30,936,12,0,12,3,33,132,3,6,3.850403153,2441,595,16,266,229,37,13128,9827,3301,144,118,26,0,96.06413994,Arch
210d18ccf32e9cfcc8bc0e1d261e75696d7ce089,21,14,959,945,0,12,12,3,35,19,3,6,3.779206109,3324,606,27,216,255,39,9552,12878,3326,113,140,27,0,95.46452085,Arch
f0ff775d32048d1697b7591923d4bd2bcf25a63c,23,969,175,794,12,1,13,3,33,115,4,8,3.895398042,2986,601,22,284,255,29,15097,12233,2864,161,140,21,0,95.44452608,Arch
86f41a4c25d957c3b71f00db14cf3b33a583a92a,21,14,959,945,0,12,12,3,35,19,3,6,3.779206109,3324,608,29,216,255,39,9552,12878,3326,113,140,27,0,96.06413994,Arch
b8a9dfaf83af3d2560934cb13aa52cab138ba809,21,986,45,941,12,0,12,3,34,127,3,6,3.842013768,2379,602,23,255,216,39,12857,9552,3305,140,113,27,0,96.06413994,Arch
83552f9e8955f3467728b0c09b5b2e248bc98b21,21,14,959,945,0,12,12,3,37,19,3,6,3.779206109,3320,610,31,216,255,39,9531,12857,3326,113,140,27,0,96.06413994,Arch
7a81d0619e35986585fdf5241ec6cd4148b93fa9,24,1036,56,980,12,0,12,3,34,112,4,8,3.978389485,3513,603,24,376,337,39,17892,14409,3483,185,160,25,0,95.3125,Arch
17a26bc9c44fc5c38bc338fd8643a0e0e526d608,21,14,959,945,0,12,12,3,37,19,3,6,3.779206109,3320,613,34,216,255,39,9531,12857,3326,113,140,27,0,97.33939001,Arch
3401bc54d13353be4654acc2f15b6a357cae7eb2,35,1287,121,1166,14,0,14,3,35,154,4,11,4.401973541,5547,605,26,561,506,55,27767,23306,4461,273,236,37,0,86.08321377,Arch
b597446f7c20f5155d45049c2494fa07d2b26466,21,14,959,945,0,12,12,3,39,19,3,6,3.779206109,3330,616,37,217,256,39,9568,12894,3326,113,140,27,0,97.38924051,Arch
8a83ec318757b4f1ba1d44009d9ee9eb6ae2ac69,2,21,14,7,0,0,0,1,12,68,1,2,0.863120569,1123,369,18,77,76,1,5245,5170,75,32,32,0,0,92.56698358,Arch
14a130973dbfdd21a57cb93b51eb420ab96f458d,40,1011,76,935,12,0,12,2,26,141,6,19,4.280458183,7301,473,17,729,690,39,30477,27081,3396,393,366,27,0,97.60132341,Arch
068e89b5169f87924c0804096a9c65fd0197a0d2,20,14,949,935,0,12,12,2,28,207,3,6,3.753197068,3022,490,21,192,231,39,8515,11787,3272,102,129,27,0,97.62100082,Arch
e378578c3d713d35928826f3ce95ae1a71665681,28,1141,15,1126,12,0,12,2,26,107,3,7,4.175059453,3787,486,18,358,301,57,21216,17048,4168,228,183,45,0,97.62100082,Arch
872aa2c7121f2b1a1d610d11b91c94103ff43683,1,0,21,21,0,0,0,1,26,53,1,1,0.0,357,489,10,41,43,2,1460,1591,131,17,17,0,0,88.10006761,Arch
03cb5b3fa5a2b1d9f1dad7caac045bc44e135418,5,360,2,358,3,0,3,1,9,14,1,2,1.141001477,373,490,11,44,20,24,2718,932,1786,30,19,11,0,87.84040532,Arch
27e80f9641d4b2bbd63eb9f0c41d985da6b70388,2,56,15,41,0,0,0,1,5,225,2,2,0.106792032,225,505,19,13,12,1,1200,1040,160,4,4,0,0,90.56463596,Arch
f78e49828e1ed7ac593448a2db995d79e1d126a6,3,13,4,9,0,0,0,1,6,1,2,3,0.834347023,487,507,21,25,24,1,2787,2728,59,9,9,0,0,97.88172992,Arch
7941e0403f34c6e15f66061d0bbc192f591b7a45,20,8,941,933,0,12,12,1,28,200,3,6,3.70655331,3607,514,22,219,258,39,12136,15398,3262,121,148,27,0,86.04651163,Arch
0e61aa27027512ff44d35885c3de925519ccd46e,22,1018,29,989,12,0,12,3,26,45,4,7,3.858196609,3020,508,22,304,254,50,17242,13769,3473,163,134,29,0,86.04651163,Arch
48b15e6032489e63358101f4c09884506a4b66c7,8,54,88,34,0,0,0,3,27,35,3,6,2.144414634,1682,1,1,153,156,3,7868,8058,190,70,69,1,0,88.46453624,Arch
aaddc1d36b06f63d350d724de7e1d490ad2025bf,7,87,31,56,0,0,0,3,28,3,3,6,1.791811584,1481,510,24,132,128,4,7565,7317,248,56,56,0,0,88.46453624,Arch
f2e9a51bf509729ccae3e9641d52845004f9afe3,3,132,58,74,0,1,1,1,8,82,2,3,1.112717685,367,512,26,34,26,8,2092,1691,401,17,16,1,0,91.93415638,Arch
5bd3f7bc6e9b36b00043613d507ac9d507e96a1f,21,25,1010,985,0,12,12,3,28,186,3,6,3.811549857,3744,526,34,227,276,49,12557,16018,3461,125,154,29,0,93.18028359,Arch
b7259addc2d63b7647625a415624914c67c6fb48,22,1011,26,985,12,0,12,3,26,32,3,6,3.824371368,2881,517,31,284,235,49,16380,12923,3457,156,127,29,0,93.18028359,Arch
83ce25c12f5f829f7d74d7141a09e9e9dd85cc84,6,218,43,175,3,0,3,1,27,90,1,3,2.360590015,1002,521,34,123,109,14,4511,3629,882,78,65,13,0,89.22829582,Arch
ab6318dae1314e9fd42ba309b61af7b2cc8833eb,5,81,20,61,1,0,1,1,30,63,2,4,1.485183196,1090,523,2,80,79,1,4924,4745,179,41,41,0,0,87.39559605,Arch
d98d9e51b3c5181d635449f46a151330039968ce,3,7,1,6,0,0,0,1,19,223,1,3,1.298794941,322,530,7,39,38,1,1233,1189,44,16,16,0,0,96.87721789,Arch
aef6de3c27f84cbed28def48da2074d66188d07e,3,33,7,26,0,0,0,1,28,157,2,3,1.219240705,864,531,8,104,96,8,3471,3322,149,50,50,0,0,94.37037037,Arch
05d43e75e410f938b45fc008f03a7a362dbe91ad,1,2,0,2,0,0,0,1,5,243,1,1,0.0,40,532,9,2,2,0,106,84,22,2,2,0,0,93.59673025,Arch
92b3662674c1cd1a5b15e13ccad3031569465323,22,26,1011,985,0,12,12,3,31,172,3,6,3.824371368,3917,559,24,235,284,49,13080,16537,3457,128,157,29,0,90.74949359,Arch
3e15a946f6e7f3de925d1a7552970fe8369e8d28,22,1011,26,985,12,0,12,3,32,132,3,6,3.824371368,2932,566,31,284,235,49,16537,13080,3457,157,128,29,0,90.74949359,Arch
b9accf4e25c788113466386e964a9e23c76f4e16,22,26,1011,985,0,12,12,3,31,172,3,6,3.824371368,3917,560,25,235,284,49,13080,16537,3457,128,157,29,0,90.74949359,Arch
ac1562dfd9e50e10df08d753184742d53aec2442,23,1023,28,995,12,0,12,3,28,55,4,7,3.875507519,3233,547,24,324,273,51,17843,14311,3532,172,143,29,0,90.74949359,Arch
db6483cd95cbdb6f5ae948f5d5149443ecd8ce29,22,26,1011,985,0,12,12,3,31,172,3,6,3.824371368,3917,561,26,235,284,49,13080,16537,3457,128,157,29,0,90.74949359,Arch
9b721be45329dc13f79599f2d44504010c12a047,22,1011,26,985,12,0,12,3,32,132,3,6,3.824371368,2932,568,33,284,235,49,16537,13080,3457,157,128,29,0,90.74949359,Arch
8eeae1248202487e2d22644516e410ef875bb5f9,22,26,1011,985,0,12,12,3,31,172,3,6,3.824371368,3917,563,28,235,284,49,13080,16537,3457,128,157,29,0,90.74949359,Arch
293bd81694e4578bc652e4464e96639b482bac9c,23,1019,28,991,12,0,12,3,28,55,4,7,3.865646722,3268,548,25,309,258,51,18279,14781,3498,174,145,29,0,90.74949359,Arch
a39eafb69004ad2af3aff4960c9bf275fe83b89d,22,26,1011,985,0,12,12,3,31,172,3,6,3.824371368,3917,563,28,235,284,49,13080,16537,3457,128,157,29,0,90.74949359,Arch
d92a4c09cf31374d8443783894c85dbfe093198b,22,1011,26,985,12,0,12,3,32,132,3,6,3.824371368,2932,570,35,284,235,49,16537,13080,3457,157,128,29,0,90.74949359,Arch
2596c92d04eb2981dd04361d9513ba4a5b0ce75a,22,26,1011,985,0,12,12,3,31,172,3,6,3.824371368,3917,566,31,235,284,49,13080,16537,3457,128,157,29,0,90.74949359,Arch
1974281588159f5a1310a5f41224c770bfbb3a0e,22,1011,26,985,12,0,12,3,32,132,3,6,3.824371368,2932,2,0,284,235,49,16537,13080,3457,157,128,29,0,90.74949359,Arch
130bfcec35521f6eb0a12552b50c4c2d2cd78869,52,214,2929,2715,0,20,20,1,29,105,5,15,4.721329211,10391,529,0,611,808,197,33719,45132,11413,312,414,102,0,89.84025559,Arch
83f2baa5d30ec3741debbccda4564cae7f7b2b04,34,1918,188,1730,8,0,8,1,31,93,5,14,3.878966853,6386,568,33,672,524,148,35105,27149,7956,332,259,73,0,93.59313078,Arch
46a4c24b669c761c0fbb6de577f24b1f8c3b8091,22,1011,26,985,12,0,12,3,32,132,3,6,3.824371368,2932,578,43,284,235,49,16537,13080,3457,157,128,29,0,90.74949359,Arch
567ac981f63b461628e01057303bffccefabb878,2,76,16,60,0,0,0,1,8,220,1,2,0.958348517,513,585,42,52,48,4,2658,2330,328,15,13,2,0,94.72463768,Arch
e2551307c2396763244b02bf2ec32f7c7ac79efa,21,959,14,945,12,0,12,3,35,127,3,6,3.779206109,2385,607,28,256,217,39,12894,9568,3326,140,113,27,0,97.38924051,Arch
5996ffd7ffc6713fc1f62d4eff5c97143c07ddae,21,14,959,945,0,12,12,3,39,173,3,6,3.779206109,3330,618,39,217,256,39,9568,12894,3326,113,140,27,0,97.38924051,Arch
ec82566202c1e5e879ba31c9da4392f005f922d3,21,959,14,945,12,0,12,3,35,127,3,6,3.779206109,2385,608,29,256,217,39,12894,9568,3326,140,113,27,0,97.38924051,Arch
44a15bf9365fe9a1273092bc39f50c643149628c,21,14,959,945,0,12,12,3,39,19,3,6,3.779206109,3330,617,38,217,256,39,9568,12894,3326,113,140,27,0,97.38924051,Arch
86a5fa6afe43976fc8f098e1d2cde11aac6bc24e,21,959,14,945,12,0,12,3,35,127,3,6,3.779206109,2385,611,32,256,217,39,12894,9568,3326,140,113,27,0,97.38924051,Arch
1ba887d62f47e18edd3dc118e3cefed8618b3478,21,14,959,945,0,12,12,3,39,173,3,6,3.779206109,3330,621,42,217,256,39,9568,12894,3326,113,140,27,0,97.38924051,Arch
f74f680cade374d290acf65cb452a1d7ee8b7286,22,999,14,985,12,0,12,3,35,128,4,7,3.869911467,2484,612,16,263,222,41,13665,10098,3567,143,115,28,0,97.38924051,Arch
a9c2e294c6806ebd63c3ad328870be05cc28d1c9,2,121,0,121,2,0,2,1,1,0,1,2,0.931458189,0,614,18,9,0,9,309,0,309,8,0,8,0,97.65940274,Arch
cb657706839551c5682e7ae9fb3ed42e83fb5697,15,95,0,95,0,0,0,1,30,42,1,1,3.601439831,2725,619,23,232,232,0,8776,8761,15,126,126,0,0,96.4801444,Arch
867b2eb0bd1bc8f9425b7eb567bba435142fa07c,21,14,959,945,0,12,12,3,39,19,3,6,3.779206109,3330,637,26,217,256,39,9568,12894,3326,113,140,27,0,96.47058824,Arch
51515e2f4d7e114af6104d1ea2f64cbf2c0748aa,27,1084,205,879,12,0,12,1,35,105,5,11,4.207878559,3872,623,20,374,351,23,18877,15888,2989,202,177,25,0,96.47058824,Arch
ed6f52fe9e36426bf26bdb5274ac410642b2b825,21,14,959,945,0,12,12,3,39,19,3,6,3.779206109,3330,639,28,217,256,39,9568,12894,3326,113,140,27,0,96.47058824,Arch
5206e80a2b1ddca7b17f1ffe2e3b15878fcf7d98,21,959,14,945,12,0,12,3,35,127,3,6,3.779206109,2385,624,12,256,217,39,12894,9568,3326,140,113,27,0,96.47058824,Arch
35869a79b1a64dd3e53828b1934cfdcb9ff1a315,21,14,959,945,0,12,12,3,41,18,3,6,3.779206109,3342,643,17,218,257,39,9586,12912,3326,114,141,27,0,96.47058824,Arch
d0d03373282632ccd9e9d18249dc32ba901050df,23,972,20,952,12,0,12,3,36,126,4,7,3.860714506,2690,627,15,280,240,40,14249,10893,3356,149,122,27,0,96.47058824,Arch
5685b1c6d1913e887fab3ecb960fa266d2de61d1,21,14,959,945,0,12,12,3,41,18,3,6,3.779206109,3342,645,19,218,257,39,9586,12912,3326,114,141,27,0,96.47058824,Arch
b05e761e28ce1e581ed91d891cb61adcd3760493,22,1878,104,1774,7,0,7,1,24,104,4,10,3.449817156,3835,475,17,501,339,162,23190,16031,7159,221,144,77,0,91.97482297,Arch
7941e0403f34c6e15f66061d0bbc192f591b7a45,25,1454,76,1378,8,0,8,3,28,82,3,7,3.839142606,3774,514,22,419,309,110,21723,14886,6837,240,183,57,0,93.90243902,Arch
6b9d6e12375708ee731196ddeb94635d71372fd5,29,1365,54,1311,13,0,13,3,26,33,4,8,4.285891668,4938,518,31,465,395,70,25925,21133,4792,245,205,40,0,93.05461902,Arch
a769286ea72f885c1c1a5c5de355b731a3971b15,310,38163,138,38025,306,1,307,0,41,82,9,49,7.692705124,135,654,11,2725,10,2715,150275,507,149768,1501,10,1491,0,5.944055944,Arch
672cf5c417b78266d1ec89f9ea9145923aa849dd,9,390,20,370,1,0,1,1,20,198,2,3,1.028539591,1748,687,4,164,129,35,8588,7393,1195,66,51,15,0,96.52836579,Arch
26521296455232eb206fdcd39911d4665a3ac0ce,3,36,20,16,0,0,0,1,32,71,1,2,1.374797629,1232,730,41,118,115,3,5059,4979,80,48,46,2,0,89.04203997,Arch
21a8f701ebcfad333da59622d2a7b38fb532eae1,10,158,55,103,1,0,1,1,13,470,2,4,2.093109904,1307,736,38,108,101,7,6037,5579,458,58,56,2,0,97.78575703,Arch
85f8045fe91fe0c76b337127a45345b09f2037f5,3,87,7,80,0,0,0,1,2,0,1,1,1.29120781,152,746,48,14,13,1,764,646,118,13,13,0,0,93.48441926,Arch
882bc94618f3e8077079f080fd8eb8283c6447df,7,359,200,159,5,1,6,1,22,93,2,2,2.481580727,642,753,18,81,62,19,2751,2429,322,45,32,13,0,97.54901961,Arch
8cd8347c8fb4406e7eb41dafe20abcdd52d8818d,1,103,0,103,1,0,1,1,4,0,1,1,0.0,0,754,19,8,0,8,313,0,313,6,0,6,0,84.82088646,Arch
972684dd056ed2fde7e5cab55dee724969c707ce,6,107,359,252,0,5,5,0,21,8,1,1,2.19791489,801,755,20,54,81,27,2140,2751,611,26,45,19,0,84.89993936,Arch
95c2d1c053135736c7e930ac5bbe5d6137230ecd,6,350,98,252,5,0,5,1,24,2,1,1,2.240021997,546,789,14,81,54,27,2731,2120,611,45,26,19,0,84.70238095,Arch
8c9e3f0e3a1c62a580f50c514e55d34dc0f71038,4,141,26,115,0,0,0,1,20,328,1,3,1.017763866,1027,794,19,62,53,9,4864,4258,606,34,31,3,0,90.47907823,Arch
365875755c4015504d7ed7fed0f3a1e78e593ac4,23,215,438,223,1,5,6,1,48,161,5,12,3.529696378,4806,809,12,412,428,16,17110,18524,1414,202,212,10,0,96.31284916,Arch
2cb2cdfc99ebed79860704d4250803cb01246a4d,11,133,136,3,0,0,0,1,25,375,3,5,2.268757705,1990,810,12,172,168,4,7863,7755,108,98,94,4,0,94.02390438,Arch
6b200d5607a4d341b097e18345666da1a47d45b4,33,576,350,226,5,1,6,1,46,154,5,16,3.997553417,6371,798,1,581,569,12,25387,24081,1306,296,290,6,0,90.46793761,Arch
e8a5f9ce0c52108785530fec3bf88b7e7cbb9f5a,27,282,180,102,1,0,1,1,48,285,5,14,3.59014968,6169,812,14,559,548,11,23584,23182,402,283,275,8,0,91.05691057,Arch
ff4ec29f5958cc9162f0302c02f4ec50c0e796cd,6,259,78,181,1,0,1,1,49,166,2,4,2.096978778,2439,823,3,250,240,10,11205,10309,896,120,112,8,0,88.28654405,Arch
57cdbcd38a8d94f717bcdd07d00959f2152e46d3,5,54,234,180,0,1,1,0,48,84,2,4,1.772387522,1905,823,3,193,204,11,7146,8021,875,87,94,7,0,88.28654405,Arch
112b5d9238c0642da31c6fcf6ba1a6602cbc6bd8,4,276,64,212,1,0,1,1,34,219,1,3,1.499566119,1046,826,5,119,105,14,5175,4273,902,49,43,6,0,88.28654405,Arch
46493f9fcc88a8feff24617325d96c816694fb48,2,742,0,742,2,0,2,1,8,0,1,2,0.999868976,0,841,12,71,0,71,3601,0,3601,41,0,41,0,96.14849188,Arch
296437ee0e2526a0beca5b776ec019416c7fe4cf,2,0,756,756,0,2,2,1,10,42,1,2,0.999979806,756,843,14,0,74,74,0,3685,3685,0,42,42,0,96.14849188,Arch
3c1b1b4dbf256e318b803e7bbcc2a3dcd2b88619,2,57,2,55,0,0,0,1,6,801,1,2,0.923842228,181,852,18,20,14,6,856,589,267,8,5,3,0,95.00706547,Arch
ab43c0e903a9aec26a344aac86d4ef83b7d9a5e8,1,33,1,32,0,0,0,1,3,110,1,1,0.0,284,864,8,35,29,6,1264,1094,170,15,14,1,0,80.81659106,Arch
bacec7716fddeb39a415bce5c65bf0a28ecf9b39,3,28,12,16,0,0,0,1,8,335,2,3,0.759840305,772,865,9,80,77,3,2942,2899,43,33,31,2,0,80.81659106,Arch
27550024ad3dcda7c2494f633d0b60cdc2f43ad2,4,243,2,241,2,0,2,1,50,231,1,2,1.157283714,745,897,18,114,95,19,4374,3045,1329,66,51,15,0,96.87971817,Arch
0482093d86ca0ca7a83ec5df9c31a0553f35f132,2,128,44,84,0,0,0,1,51,160,1,2,0.837769869,1285,899,14,124,119,5,7023,6573,450,65,63,2,0,95.16785351,Arch
8d32c4738afe4fb6fa5e6fd843b05821ddc2ce88,658,40722,42576,1854,317,331,648,1,53,244,8,93,8.746137256,43700,921,7,2977,6002,3025,164549,332199,167650,1617,3272,1655,0,27.93778802,Arch
86857cb5aa5511240544f49848054cb6a6453ed4,7,80,27,53,0,0,0,1,9,7,1,3,2.335148858,443,93,14,24,23,1,1676,1507,169,18,19,1,0,89.34010152,Arch
86e442a1d9a0907c12f21787ba26bc6be9b80e7b,3,297,249,48,0,0,0,2,4,486,1,2,1.055156218,933,104,2,75,69,6,3896,3695,201,31,30,1,0,88.49614396,Arch
6d7f726bea4919562cf521d48a105f4ffc23c30b,8,534,777,243,0,1,1,1,6,89,2,7,2.684533987,2840,0,0,204,224,20,10980,12004,1024,100,107,7,0,88.38254172,Arch
37cf6524cbe5315bbaf3e5d94c637529fe1f4c6e,24,1105,686,419,2,1,3,1,9,152,4,10,3.378943386,6601,0,0,592,560,32,30636,28941,1695,332,316,16,0,87.8516624,Arch
64a21a79c5c8bbb9f5b36dfdfd7adbec72795af3,26,697,1182,485,1,3,4,1,7,226,4,11,3.494112178,7225,104,0,567,601,34,29290,31179,1889,322,339,17,0,87.98722045,Arch
38a29687f140bf5c8ff27d6d2ff591bdcc172cba,28,1244,697,547,3,1,4,2,9,155,4,13,3.595326938,8257,109,0,723,687,36,38419,36203,2216,379,361,18,0,87.98722045,Arch
3eb4d69c9cbf5fe5108a49cdaceff58b9659e056,15,508,1115,607,0,3,3,2,6,28,3,11,3.188056337,4912,105,1,335,376,41,18229,20846,2617,143,164,21,0,88.20905035,Arch
f424f856643e8b59c611137238a617ef8cce7256,14,1114,489,625,3,0,3,2,9,249,3,10,3.135595406,4276,113,4,376,335,41,20821,18204,2617,164,143,21,1,88.20905035,Arch
b949f57b49600f53aa63d1f9fdad8a71e7d7a4df,4,87,0,87,4,0,4,1,1,0,1,2,1.838371232,0,232,22,6,0,6,505,0,505,5,0,5,0,96.28554846,Arch
10e52ad0051f839e0349d728b22254a42e91924e,3,232,0,232,2,0,2,1,2,0,1,1,1.195580201,36,233,23,33,3,30,982,220,762,22,2,20,0,96.72036824,Arch
f103e02dcc906f9d0387a1e720fa20f8aa479904,15,677,44,633,9,0,9,1,2,0,1,3,2.7416338,319,234,24,125,36,89,3687,1267,2420,87,25,62,0,97.02531646,Arch
49d0294657d242f366db4a0e0654f429100c4b85,12,263,195,68,4,2,6,1,17,0,1,3,3.323099612,514,256,44,63,52,11,2954,2818,136,56,40,16,0,90.94669118,Arch
e5ecbcd96fd84611a11a34074d63ae05a77df0d9,10,173,96,77,2,2,4,1,19,0,1,5,2.403077865,739,258,46,103,93,10,4218,3676,542,60,57,3,0,97.46732026,Arch
530010d902cb8a2ff09ffe66048e9f11a0650cb1,8,115,405,290,1,2,3,1,20,2,1,5,1.83119163,5536,259,47,967,1009,42,30658,32092,1434,503,532,29,0,95.14604811,Arch
4465fe0f5ac3b7f7c2287980bc114ece9d635f16,13,4243,102,4141,8,0,8,1,13,0,1,5,2.189647941,6738,260,48,2188,1348,840,62889,38937,23952,947,589,358,0,91.91000479,Arch
41ac42bb67cd9e3196ec2f0873a4efe595c6ed41,18,4792,56,4736,8,0,8,1,18,0,1,3,1.786106051,12513,267,48,3386,2461,925,100302,72973,27329,1638,1206,432,0,97.92883696,Arch
8bfaffd24177bba0431fc765f4b1d560aa58bf71,43,53,739,686,0,2,2,1,21,0,1,7,2.170357601,23580,277,58,4393,4510,117,132069,135780,3711,2110,2181,71,0,92.4412666,Arch
87582a9b2f5640fedaa6122a8c7c7d4eafb96e19,19,12071,24,12047,14,0,14,1,22,0,1,6,2.085603367,23704,279,60,7447,4928,2519,211563,140415,71148,3168,2131,1037,0,96.36627907,Arch
bef0b8b7683b65cbeb8bd6dfaf5b54858936180b,112,2,62352,62350,0,111,111,0,3,0,2,12,4.124380978,62593,232,13,46,12649,12603,1052,357598,356546,17,5235,5218,0,82.15633423,Arch
cb9d8dd96e4c625f154f6f15d39801701c2cdab1,112,62352,2,62350,111,0,111,1,23,0,2,12,4.124380978,243,287,68,12649,46,12603,357598,1052,356546,5235,17,5218,0,82.15633423,Arch
bfc388ce020afa62a6f5e1d6bd3c6cdd9a82e8a3,1,15,0,15,0,0,0,1,6,4,1,1,0.0,712,293,74,80,78,2,3777,3696,81,25,24,1,0,97.05494505,Arch
bee07a525682436ce33e7110b8f6688ec1df285f,2,217,4,213,1,0,1,1,24,1,1,2,0.340595912,146,298,79,25,11,14,2139,886,1253,11,5,6,0,97.78242678,Arch
1a63a102ebbaaead265babd71a3d52928f848bd0,117,604,64588,63984,0,113,113,0,12,11,4,14,4.201420074,65543,0,0,152,13063,12911,6299,371849,365550,56,5414,5358,1,80.82400814,Arch
30019cda31afee4150bd014d849e5e7677d02909,117,64586,603,63983,113,0,113,1,25,1,4,14,4.201263603,1559,299,80,13064,152,12912,371846,6299,365547,5414,56,5358,0,80.82400814,Arch
0b7ae7e3672a9c817fe31144cd6b18d9a357f124,117,89,64033,63944,0,113,113,0,13,0,4,14,4.137354587,65561,1,1,152,13066,12914,6299,371959,365660,56,5415,5359,1,80.88235294,Arch
3a0f6472ec059f4e44b9e79a329326a2cf57fbad,117,64262,89,64173,113,0,113,1,26,1,4,14,4.124963192,1617,303,84,13088,152,12936,373129,6299,366830,5443,56,5387,0,80.87044534,Arch
2c376b9f51d6eab4340651abce3284f358bedbc7,119,119,64714,64595,0,115,115,0,13,0,4,14,4.162694041,66239,2,2,154,13162,13008,6346,375379,369033,60,5482,5422,1,80.66465257,Arch
d3ce45c637caf1cef7263489eef5889a684cbca7,120,64748,144,64604,115,0,115,1,27,1,4,15,4.169406191,2086,308,76,13188,180,13008,377736,8611,369125,5494,72,5422,0,80.66465257,Arch
63d0401c05f6cc122468f55c79c9e1bd4ddb3eb5,123,484,64750,64266,1,115,116,0,23,0,4,17,4.201871723,67775,3,3,322,13307,12985,13874,381664,367790,135,5548,5413,1,81.87163155,Arch
27c70aab9a3d86ba9a8a20e3ae28ef5bed147300,134,65017,711,64306,115,2,117,1,27,9,6,23,4.248180575,6732,0,0,13507,522,12985,397802,30220,367582,5634,220,5414,1,81.88976378,Arch
5954e66fa3108c39b3f2915583def5e51915846f,134,741,65019,64278,2,115,117,0,26,35,6,23,4.250530931,71038,238,4,525,13507,12982,30344,397802,367458,221,5634,5413,0,81.88976378,Arch
61eb3886e371f7285b8a0572a6b1c896c64b8065,135,65080,835,64245,115,2,117,1,27,0,6,23,4.26466602,6962,1,1,13526,546,12980,398382,31133,367249,5644,233,5411,1,81.88976378,Arch
5d7d0c7f1430dde06cef8800bca3f035dd707c0d,19,810,354,456,2,0,2,2,26,327,5,12,3.229857299,6272,322,14,500,466,34,30173,27994,2179,216,199,17,1,97.36191261,Arch
30e66cfa3e8e7d09f553adbaa699edbd05993a4e,12,262,741,479,1,2,3,3,22,216,3,9,2.97508576,4100,0,0,313,352,39,14067,15812,1745,137,158,21,1,96.39794168,Arch
2337b64fc5a1cfbbcbe462560cb0a8d2fef22c0a,22,913,335,578,2,1,3,3,26,93,5,13,3.439180848,7115,323,15,568,522,46,33893,32169,1724,252,226,26,1,96.39794168,Arch
67dbfadcefa31e7e73873f85f20c3205218e4d68,16,236,763,527,0,2,2,3,22,54,4,10,3.030438215,5432,2,2,393,434,41,20874,22884,2010,174,196,22,1,97.36191261,Arch
c885c8fac3ef1c6450dedd173dd1ef6baae826bb,15,763,236,527,2,0,2,3,26,89,4,10,3.015003838,4702,325,17,419,378,41,22549,20537,2012,182,160,22,1,97.36191261,Arch
7d192424d06a04f27c4efc8cac27762ad841b532,3,80,4,76,1,0,1,1,7,668,1,3,1.053707088,866,327,19,63,61,2,4154,3741,413,32,31,1,1,97.14407502,Arch
2df9b97dfdd8f322efcb5facf0ba933c2125e4ef,24,369,875,506,0,2,2,2,22,320,5,13,3.531414067,8027,1,1,543,587,44,34130,35467,1337,244,268,24,1,95.44392523,Arch
1103f476d84a53784377a96f8661bd9219e7412d,26,333,1064,731,0,3,3,2,22,251,5,15,3.721905065,8535,0,0,567,617,50,35104,37792,2688,259,289,30,1,93.66602687,Arch
5deb7ed38d5754d936dafc422246d8634abecc57,26,1065,334,731,3,0,3,3,26,200,5,15,3.721133752,7804,0,0,617,567,50,37792,35104,2688,289,259,30,0,93.66602687,Arch
58fcc548f87e3c787f82d48931e2e9992f6c3366,16,504,158,346,5,0,5,1,34,536,2,5,2.717556769,2756,369,0,303,259,44,13017,11736,1281,189,156,33,0,95.41719343,Arch
d3672a5acbd2bdf0f8caa9b7c8ea07e9d4e4dd2a,16,388,62,326,1,0,1,1,23,120,3,7,3.448826421,3190,370,1,274,263,11,15634,15171,463,161,156,5,0,94.87723553,Arch
04caf36cd4ee76b358c7866da18c858b5608ebca,22,267,891,624,0,6,6,0,33,191,3,7,3.513435829,5434,26,4,412,464,52,22026,23528,1502,231,268,37,1,97.42319128,Arch
49b2fd3a8313cd05292e2ca8edb4b14b08f0de55,22,1022,266,756,6,0,6,1,34,333,3,7,3.481658667,4810,371,2,479,412,67,24127,22026,2101,275,231,44,0,97.42319128,Arch
22d034af90987940420649c5f320e8dc09910c8a,35,649,1151,502,3,6,9,0,34,335,3,7,3.908702433,8035,27,5,661,712,51,33367,34743,1376,341,376,35,1,95.96860507,Arch
79d152ca42b0a34826369c5620ce7807c668ad63,36,1161,692,469,6,3,9,1,34,380,3,7,3.947026984,7703,374,5,729,683,46,35256,34053,1203,388,357,31,0,95.96860507,Arch
fb274b1c8d56eeae97c50966ba69e6b98fd71274,16,640,181,459,3,0,3,2,37,556,1,4,2.492712973,2849,376,7,289,261,28,13215,11331,1884,152,131,21,2,96.49184975,Arch
227aaf3f56dd2e587977f97d10b9b8b20525830a,82,2805,3515,710,2,17,19,1,39,192,5,23,5.189557428,21978,11,0,1656,1691,35,98460,99719,1259,823,873,50,0,95.28130672,Arch
2bd53fc28fbaa70ed380af0579853db83b63a663,15,914,0,914,13,0,13,1,40,104,1,4,3.166011536,1101,13,2,170,122,48,8154,4145,4009,93,56,37,1,94.55501314,Arch
4ec5ffe3a9d1c14a0a5acbe1ebb5552a284a8908,4,526,191,335,3,0,3,1,3,0,2,4,1.361285228,305,17,6,46,12,34,3925,2422,1503,28,9,19,1,97.5130365,Arch
d86f51f8c2c473715cddfcd32f087e2510332b4f,2,20,24,4,0,0,0,2,6,0,1,2,0.156491063,612,449,3,41,41,0,3739,3746,7,23,23,0,0,95.31690141,Arch
7df5ab38d6055bfe6439e7337816ea00768a5401,36,706,193,513,6,0,6,1,42,1121,1,5,3.969828689,5699,455,9,463,437,26,26024,23179,2845,296,274,22,0,94.30716297,Arch
4275b3c60c9350a2c0cd3d7297643db03ba3304d,3,14,49,35,0,0,0,1,7,868,2,2,0.932796591,202,459,13,11,16,5,681,753,72,10,15,5,0,97.13322091,Arch
8389371b3bd635d39aecc8e63020ef95896fbc21,2,6,3,3,0,0,0,1,15,0,1,2,0.99107606,308,461,15,0,0,0,446,431,15,0,0,0,0,97.68378651,Arch
d5d12c88b075fd1fc51a29412b3c08918cceb983,57,2492,296,2196,17,0,17,1,54,280,4,17,4.29063284,13018,39,3,1207,1049,158,66860,58026,8834,598,498,100,2,96.78312003,Arch
af369dec7a3ba20c60c68b502198bd851e34906f,27,756,587,169,4,1,5,2,54,317,4,12,3.789418226,7503,22,1,627,657,30,30881,30604,277,317,330,13,1,91.66979362,Arch
e239137019608f02cabb23c27ab13adcef88c027,26,796,778,18,4,4,8,2,58,186,4,11,4.002026288,5682,517,30,511,475,36,22041,21883,158,274,259,15,0,91.46706587,Arch
6c5a154c8cb33bc0fa62f5ad9daac8d45db50262,31,840,915,75,5,7,12,2,54,210,4,12,4.242670135,6037,24,3,488,533,45,23091,23562,471,266,288,22,1,92.78242678,Arch
5f094f8bb6dca3c056051cb8800b418839cca0e1,32,898,865,33,7,5,12,2,59,173,4,13,4.276728335,6515,522,35,562,522,40,26160,25695,465,300,277,23,0,92.78242678,Arch
667c97e7f3e2966153fb5c105020deaac7d0f510,8,683,20,663,5,0,5,5,19,67,1,3,2.17335336,1476,25,4,114,98,16,9179,6737,2442,58,47,11,2,93.34500876,Arch
72f722372aedc221f6dd633113b5f9c30e8bd8e2,33,962,868,94,7,5,12,1,59,144,5,14,4.270104166,7073,538,35,606,557,49,29705,28873,832,320,294,26,2,92.79247911,Arch
d57aaeb77b40fd6a4f5aa52e3d4e44dbe02c1700,8,683,20,663,5,0,5,5,19,27,1,3,2.17335336,1474,541,38,114,98,16,9168,6726,2442,58,47,11,2,94.10187668,Arch
4c3c8377935f8ae2c0f24c4a1010cf4bdef4e297,19,775,506,269,3,3,6,1,9,86,1,3,2.384069891,1506,589,5,87,72,15,8972,6388,2584,60,45,15,2,97.42233972,Arch
d42ef172e57af17ed42d7c2c4e2d9a7a0c520f3c,9,353,406,53,2,0,2,3,9,19,2,4,1.925308022,1510,590,6,97,93,4,7830,8157,327,57,54,3,0,97.75947282,Arch
3029856c894a72ed2c5762e0c6acd2c0a8cd3937,165,1308,8119,6811,3,62,65,2,43,186,7,30,6.337837149,33145,478,1,1949,2353,404,116888,145991,29103,997,1252,255,0,89.60280374,Arch
b89091e9363e760aa34028bcfb57baf6ca921957,164,7462,1519,5943,32,3,35,2,66,371,7,30,6.204259042,27356,602,17,2379,1972,407,146661,117511,29150,1277,1019,258,0,89.60280374,Arch
add56dc92e4564ce5d146a8f3c0a8ae51c6dc46f,55,1332,1171,161,3,4,7,3,63,93,4,15,4.132162084,9530,588,3,725,736,11,41549,41342,207,387,400,13,0,96.32757988,Arch
0fe4d969f86836ecfcf27ab1164c422e771d1495,26,558,999,441,1,10,11,3,12,371,2,4,2.998456494,2246,601,14,113,114,1,8220,9003,783,71,65,6,2,97.74119449,Arch
a14b277b97a8e94cdd8820c2b0da50430bb1b5d1,165,1566,8714,7148,1,64,65,2,43,196,7,30,6.317132032,33375,0,0,1942,2374,432,116768,147139,30371,993,1262,269,0,89.66925276,Arch
c1e2a308d891cba4251adcb18a91d074077979b9,11,78,184,106,0,1,1,0,18,640,2,8,2.613628228,2249,0,0,175,184,9,10226,10676,450,98,103,5,1,91.85888738,Arch
9b68e19a278e025fa5884445a2b2519463b57445,9,130,151,21,1,1,2,5,18,386,2,5,2.253676317,2783,490,0,211,213,2,12585,12807,222,95,96,1,0,91.94205523,Arch
fefbba1cc3bd5641983657440b40e25425165a6a,7,465,348,117,2,0,2,1,27,261,2,4,1.658453321,1914,493,0,165,162,3,9242,8908,334,86,86,0,0,96.89078896,Arch
a01f2a00dcbf608f5e297683e51a5244ffd679bf,9,480,464,16,2,2,4,0,26,228,1,4,2.206155432,2821,493,0,240,240,0,14623,14675,52,121,120,1,0,96.70287044,Arch
003acc6027aa63e59b5de3b0d1da7e33c2b9f9cc,45,170,183,13,0,2,2,1,45,1022,7,19,4.310746737,14605,493,0,1443,1448,5,60847,60159,688,659,662,3,0,96.6017564,Arch
6b8113b65dce1958a405186ff8ee3c9b4f14f362,49,255,307,52,2,0,2,1,44,397,8,22,4.584458922,15349,494,1,1520,1516,4,62911,63900,989,694,692,2,0,96.6017564,Arch
bef5bb9bd2ff5ba7862d89120b5d3443587bd39a,53,379,254,125,0,1,1,1,46,1039,8,25,4.733081672,15778,31,0,1539,1542,3,66764,65251,1513,711,712,1,1,92.248394,Arch
c1ea06b1bb5ada979b17e3d1e1f6a65897d1927e,9,175,81,94,1,0,1,2,22,285,2,5,2.695400037,2737,505,12,221,215,6,13952,13989,37,112,109,3,1,93.06779012,Arch
5d485b07218a72a7b01fe5cfd69b1b7c7b9910a8,6,86,14,72,1,0,1,4,21,971,1,4,2.075761738,1308,506,13,83,82,1,6509,5966,543,49,48,1,0,93.27217125,Arch
55ca08cb1aef3deada6ae6bb128c6fb2f0608777,60,572,912,340,2,3,5,1,44,381,8,27,4.049710582,17557,495,2,1653,1661,8,72331,74522,2191,773,780,7,0,91.86770428,Arch
649e0ba24b4123829e1267c755318a288f6f9e0c,56,609,118,491,3,0,3,1,46,1009,8,26,4.827274033,16128,512,19,1606,1591,15,69396,66682,2714,741,731,10,1,93.27641409,Arch
022de3921a120c6f86cc6e21442327cc04b66cd2,2,127,3,124,0,0,0,5,10,292,1,2,0.690070365,577,0,0,44,35,9,3642,2905,737,24,20,4,1,94.54184585,Arch
dd20f1dbed3879372483d7e8f7eb05d920707168,3,82,2,80,1,0,1,1,5,2296,1,2,1.28067213,334,0,0,53,47,6,1594,1202,392,29,26,3,1,97.3987585,Arch
8fe1e2699feea9efea0029af5f6961b2b67318a3,6,191,13,178,2,0,2,1,8,1356,1,4,1.879591047,708,558,5,93,83,10,4493,3500,993,52,46,6,1,97.65258216,Arch
27d3b109723e999d463d2a29a3df79b04a53a4db,2,18,34,16,0,1,1,2,9,1344,1,2,0.947062243,289,559,6,50,50,0,1165,1183,18,19,19,0,0,97.71260997,Arch
10e2d9db821ed03903f00ce4f23e431168fce910,101,3238,1206,2032,11,1,12,1,47,988,8,34,5.516924175,22960,534,0,2225,2062,163,109270,99465,9805,1082,1009,73,0,91.77576368,Arch
2fccfc190d7a36c4d8a20ed18907bbd97c9b97ad,183,10659,2005,8654,40,2,42,2,78,290,7,31,6.425302832,29575,776,3,2795,2152,643,169746,128310,41436,1457,1087,370,0,87.46721073,Arch
3478aca7ed6852484b5574a6082f4bb75c04a1e0,186,1852,11503,9651,2,76,78,2,47,327,7,31,6.564306355,38828,60,0,2204,2843,639,130178,171606,41428,1113,1483,370,1,87.46721073,Arch
60d24c2c982ef185ac10d08d01a7eca8f6d57e61,183,10659,2005,8654,40,2,42,2,78,290,7,31,6.425302832,29575,101,2,2795,2152,643,169746,128310,41436,1457,1087,370,1,87.46721073,Arch
a8a5d46cca4a6257d7f8edce9f3d21af3526847b,185,1848,11506,9658,2,76,78,2,47,291,7,31,6.56277275,38275,0,0,2156,2795,639,128431,169803,41372,1089,1457,368,0,87.46721073,Arch
e6ed99965b6df91607b2505a3784780e51fa8c53,183,10659,2005,8654,40,2,42,2,78,290,7,31,6.425302832,29599,102,2,2799,2156,643,169873,128431,41442,1459,1089,370,1,87.46721073,Arch
82a8906ddb185e4d405056aeed8abc807f440440,187,1830,11502,9672,2,76,78,2,47,305,7,31,6.560324518,38642,0,0,2183,2824,641,130269,171690,41421,1103,1472,369,1,87.46721073,Arch
adcaf340f32755f063d50eef6baf7b0740eb7e40,183,10659,2005,8654,40,2,42,2,78,290,7,31,6.425302832,29599,103,1,2799,2156,643,169873,128431,41442,1459,1089,370,1,87.46721073,Arch
140342045e15876e610d5adee5eda5723d00f09d,185,1819,11501,9682,2,76,78,2,47,291,7,31,6.555234981,38299,2,2,2156,2799,643,128431,169930,41499,1089,1459,370,0,87.46721073,Arch
67cebe5c243b7e87a0cb475c909d907435f5d427,183,10659,2005,8654,40,2,42,2,78,290,7,31,6.425302832,29603,785,3,2800,2157,643,169888,128446,41442,1459,1089,370,1,87.35465116,Arch
2ae72d67a499c92a6ca0bea795d28b13b54d8b0c,194,1858,11938,10080,2,85,87,2,47,281,8,33,6.64503407,38712,0,0,2157,2843,686,128458,172571,44113,1089,1494,405,1,86.83602771,Arch
c53f59dcc048006bce0a5df3c0718ccdbb39774f,192,11085,2044,9041,49,2,51,2,78,273,8,33,6.51903613,29614,788,2,2843,2157,686,172387,128458,43929,1492,1089,403,0,86.83602771,Arch
ea6261e52e00d724cd41248a99787e6e5ad465bf,6,38,57,19,1,1,2,1,4,0,1,1,2.269462814,229,790,4,24,28,4,1339,1515,176,21,24,3,0,96.02290805,Arch
71283320eba76ef6fe02af84ac31bd27a4ef3916,11,141,206,65,3,5,8,1,5,0,1,3,2.555281944,354,791,5,29,36,7,1910,2248,338,20,27,7,0,95.47193878,Arch
7689f33eab9e75fc5f443043bb7dd3675c1530dc,3,97,19,78,1,0,1,1,5,0,1,2,1.529915965,385,795,9,45,42,3,2593,2114,479,27,25,2,0,92.07831325,Arch
74f14106bf389b8cdf92f2838a41372fabdbfa18,5,189,43,146,1,1,2,1,6,0,1,2,2.031090876,477,796,10,60,45,15,3488,2602,886,36,27,9,0,97.82214156,Arch
52c9c7d6fecb8df5eb93f0f5a28a2cf3f6268091,202,1861,12707,10846,2,93,95,2,47,283,8,34,6.725778873,39472,0,0,2157,2891,734,128461,175000,46539,1089,1517,428,1,86.07411697,Arch
9b84ba3988ce533ec549980dcab77c8e35230cef,240,13445,2134,11311,77,2,79,2,78,222,9,38,6.905348629,30119,799,13,3011,2157,854,182748,128493,54255,1617,1089,528,0,85.33184607,Arch
10170c2691687cc9f266b6b19ab57b75b088233c,27,1032,50,982,18,0,18,1,43,85,2,3,3.906033581,2519,800,14,256,198,58,16235,11027,5208,173,124,49,0,94.31702345,Arch
394eb9008f226433d983b3ffde31abd6a49f4571,67,714,1980,1266,1,30,31,1,34,17,3,9,5.461207432,4247,801,15,143,273,130,11288,18714,7426,125,215,90,0,94.76190476,Arch
476d55fe210621d3647355a08c0fb7a926d88a21,42,89,67,22,0,0,0,1,5,0,1,4,5.211286973,3065,808,22,112,112,0,10110,9716,394,98,98,0,0,96.13028953,Arch
2fa1a69afd9b1b9d4be6c756b643ca4d4ce1f810,18,238,57,181,2,0,2,1,7,0,1,3,3.370980015,1477,810,24,120,111,9,7838,7286,552,103,98,5,0,95.20851819,Arch
e8d1352253ba0df915bb478e3bc40c2156477494,4,892,2,890,2,0,2,1,7,0,1,2,0.970054961,210,811,25,64,16,48,7016,1199,5817,38,15,23,0,87.58641419,Arch
3876d3eebe50aaadef71e5d32f425fad622513a0,2,24,23,1,0,0,0,1,8,2,1,2,0.999673426,184,815,29,1,1,0,225,212,13,1,1,0,0,92.24806202,Arch
ee4031de78ab06494013e47911896e4e689ba131,17,189,99,90,1,0,1,1,9,0,1,3,3.650167563,1678,816,30,132,124,8,8449,8120,329,107,101,6,0,93.07105109,Arch
fb277f9601411427dee7d26dd2be76941d38c0c3,238,1832,16209,14377,2,128,130,2,47,226,8,35,7.043786022,43034,541,0,2157,3013,856,128478,188620,60142,1089,1616,527,0,84.50860633,Arch
da48ef388f6153e66d251121854bb0faae77a3ec,183,10660,2005,8655,40,2,42,2,78,278,7,31,6.425658472,29608,789,3,2800,2157,643,169898,128461,41437,1459,1089,370,1,87.35465116,Arch
6d392ecb929b292ea9438b0e177c4bbab2c3953b,187,1838,11502,9664,2,76,78,2,47,335,7,31,6.561864194,38647,1,0,2179,2822,643,129429,170872,41443,1099,1469,370,1,87.35465116,Arch
8f592095d295a7dffe44fb6b0432d703bd4cf5b4,238,15152,2127,13025,80,2,82,2,78,230,8,35,6.93361364,30301,818,32,3035,2179,856,189480,129461,60019,1626,1099,527,0,84.50860633,Arch
b58cfd068dbe4771f83365124693049b6051f63e,73,76,4751,4675,0,52,52,0,46,136,3,10,5.44519185,11173,790,4,566,779,213,27263,45894,18631,306,463,157,1,89.88269795,Arch
b4cbe4ba1a2e844405dd30b5505fa24dab63db70,185,1819,11502,9683,2,76,78,2,47,310,7,31,6.555568823,38314,544,3,2157,2800,643,128478,169972,41494,1089,1459,370,0,87.35465116,Arch
dca47a880f6c68b134cc49c5cfa775ffd3323c0e,238,15185,2127,13058,80,2,82,2,78,230,8,35,6.933860673,30301,820,34,3038,2179,859,189661,129461,60200,1628,1099,529,0,84.44444444,Arch
144977f8bc94115fac53163f81310aff0d50c78d,240,1896,16281,14385,2,128,130,2,47,265,8,35,7.055584829,43405,545,4,2179,3038,859,129457,189718,60261,1099,1628,529,1,84.44444444,Arch
770aa411d00f97ce6040f2b4182d6f0fe744262d,183,10660,2005,8655,40,2,42,2,78,278,7,31,6.425658472,29614,793,7,2800,2157,643,169911,128474,41437,1459,1089,370,1,87.35465116,Arch
bc8e981662cfc996a6e20507e49be80de2aca759,185,1819,11502,9683,2,76,78,2,47,314,7,31,6.555568823,38315,546,5,2157,2800,643,128474,169968,41494,1089,1459,370,0,87.35465116,Arch
e45466acd8fcdcfd9066d5be04e4a176e8e67b89,236,15148,2066,13082,80,2,82,2,78,238,8,35,6.921489721,29939,821,35,3016,2157,859,188744,128478,60266,1618,1089,529,0,84.44444444,Arch
0b699a368bbb5f3c72ab609fa590bf225c2a2d7a,240,1905,16282,14377,2,128,130,2,47,262,8,35,7.055817298,43405,546,5,2181,3038,857,129526,189718,60192,1099,1628,529,0,84.44444444,Arch
90b39dd87ce8e96dc4d25633960ec7583d33b3d6,183,10660,2005,8655,40,2,42,2,78,278,7,31,6.425658472,29622,797,11,2802,2159,643,169980,128543,41437,1459,1089,370,1,87.35465116,Arch
2ef420cab3bc2951559304786b9789763b796292,74,4782,88,4694,52,0,52,1,44,130,3,11,5.456813697,6979,822,36,842,628,214,47972,29274,18698,485,326,159,0,89.84741784,Arch
acd90971dafd9c3b4373f45734dd9f8f88a165ce,75,213,4809,4596,0,52,52,0,46,148,4,12,5.487381483,11837,798,12,662,857,195,30322,48584,18262,340,492,152,0,89.84741784,Arch
2342578f424230ee9dd0abfd47f0042f9c422343,185,1797,11587,9790,2,76,78,2,47,322,7,31,6.555954992,38417,549,8,2159,2820,661,128422,170462,42040,1089,1466,377,0,87.35465116,Arch
540cd28a33bccc6423765851631a02dcd974b89f,183,10746,1983,8763,40,2,42,2,78,284,7,31,6.426659094,29609,801,15,2820,2159,661,170405,128422,41983,1466,1089,377,1,87.35465116,Arch
cc49ae91f298243f80689a7f879bd9529133755e,186,1820,11593,9773,2,76,78,2,47,328,7,31,6.564156237,38504,550,9,2160,2821,661,128994,170914,41920,1090,1467,377,0,87.35465116,Arch
5cf7d050fa9905332e358cfaeb93d2e739d158a0,183,10746,1983,8763,40,2,42,2,78,284,7,31,6.426659094,29609,803,17,2820,2159,661,170405,128422,41983,1466,1089,377,1,87.35465116,Arch
2724443527db10aab3e505ce3643a0da67a1a7f2,185,1799,11597,9798,2,76,78,2,47,322,7,31,6.557863032,38425,551,10,2159,2821,662,128422,170474,42052,1089,1466,377,0,87.35465116,Arch
8e7fbac86dfe14f18a540a6a10c75f5bfe74120a,183,10755,1985,8770,40,2,42,2,78,287,7,31,6.428407928,29609,811,25,2821,2159,662,170417,128422,41995,1466,1089,377,1,87.35465116,Arch
386cadefb6b40d949d6646f2ee237b413dac2733,185,1799,11597,9798,2,76,78,2,47,322,7,31,6.557863032,38425,557,16,2159,2821,662,128422,170474,42052,1089,1466,377,1,87.35465116,Arch
649c441529040401e2f414fbaffd8c6122263e70,242,15493,2151,13342,82,2,84,2,78,227,8,35,6.962796107,30574,823,8,3078,2191,887,192083,130874,61209,1648,1102,546,0,84.32732316,Arch
8fe1e2699feea9efea0029af5f6961b2b67318a3,249,2084,16576,14492,3,129,132,2,47,308,8,38,7.103896693,44670,558,5,2284,3161,877,135367,195640,60273,1154,1694,540,1,83.34812186,Arch
8363692841ea46caebd25f7fe8e61b5bc8295bab,183,10755,1985,8770,40,2,42,2,78,287,7,31,6.428407928,29609,816,14,2821,2159,662,170417,128422,41995,1466,1089,377,1,87.36933798,Arch
6d8c0be868341a0885023976dbd1c9f04395d818,185,1799,11597,9798,2,76,78,2,47,322,7,31,6.557863032,38425,561,8,2159,2821,662,128422,170474,42052,1089,1466,377,1,87.36933798,Arch
3a966eae1eedfad1324ce689c9f168c48ad27bd1,247,15505,2332,13173,82,3,85,2,78,225,8,38,6.992452512,31451,826,3,3161,2284,877,195583,135372,60211,1694,1154,540,0,84.28056557,Arch
651ac591725567bf85ec830a45b9b062d5dd7474,240,1921,16650,14729,2,130,132,2,47,253,8,35,7.074574417,43488,0,0,2169,3067,898,128924,190408,61484,1092,1642,550,0,84.32567156,Arch
d7a65ad5e90c26cb487fe864146b01277dd8cc1a,238,15556,2164,13392,82,2,84,2,78,227,8,35,6.955325291,30050,865,4,3067,2170,897,190351,128984,61367,1642,1092,550,1,84.34301521,Arch
8c1c5ffa287d22eaea18bf6f89a4a8bf6d9b871c,205,2581,12116,9535,5,77,82,2,47,401,7,35,6.724213188,41188,2,0,2400,3030,630,141662,181906,40244,1221,1592,371,1,86.9740634,Arch
87a145ca3346cd1bab8a4fbdc3b1d3d9fe237dc7,239,15556,2209,13347,82,3,85,2,78,225,8,35,6.963204251,30095,105,1,3067,2176,891,190351,129260,61091,1642,1096,546,0,84.27899253,Arch
08102b0f09f1b1ac79699d121bca8076853f4e44,241,2029,16651,14622,3,130,133,2,47,247,8,35,7.079414537,43488,0,0,2175,3067,892,129484,190469,60985,1095,1642,547,0,84.27899253,Arch
7d44baee3d87890b67fc4900f204bb5111368079,239,15556,2209,13347,82,3,85,2,78,225,8,35,6.963204251,30150,868,6,3069,2178,891,190713,129622,61091,1643,1097,546,1,84.27899253,Arch
337b9d929c6e027719044559de65468c044c4251,241,1978,16650,14672,3,130,133,2,47,264,8,35,7.082471188,43543,1,0,2175,3069,894,129503,190831,61328,1095,1643,548,0,84.27899253,Arch
0e23fbac1be51df269f1b396af03980f8a614cab,239,15557,2211,13346,82,3,85,2,78,225,8,35,6.963549635,30153,869,7,3069,2178,891,190732,129641,61091,1643,1097,546,1,84.27899253,Arch
0fc0cbec1ad65d108e2c239f7a6ddfb93f3ed2b0,242,2039,16711,14672,3,130,133,2,47,256,8,35,7.08817783,43646,567,4,2178,3073,895,130163,191382,61219,1096,1644,548,0,84.27899253,Arch
9b73d11bc03c6e37567e237e96c36cdf93e4ff66,240,15609,2270,13339,82,3,85,2,78,233,8,35,6.969168518,30256,0,0,3078,2181,897,191117,130301,60816,1647,1098,549,0,84.27899253,Arch
a0c72bd4ee1255b1ac8bf6c24358dc5f6fcc7f57,241,2034,16703,14669,3,130,133,2,47,264,8,35,7.076426399,43540,2,0,2175,3074,899,129503,190706,61203,1095,1646,551,1,84.27899253,Arch
850b6e4e427028aa6366cd51d524570a10343a97,239,15557,2211,13346,82,3,85,2,78,225,8,35,6.963549635,30153,871,4,3069,2178,891,190732,129641,61091,1643,1097,546,1,84.27899253,Arch
2672049482abea4fba1354e7e583e197cdc5c61e,242,2038,16652,14614,3,130,133,2,47,277,8,35,7.091239604,43646,570,4,2180,3073,893,130544,191382,60838,1097,1644,547,1,84.27899253,Arch
6d41d4a8025a8c982fc8fbd1c92b5cd9a3e3dacc,239,15557,2211,13346,82,3,85,2,78,225,8,35,6.963549635,30153,875,8,3069,2178,891,190732,129641,61091,1643,1097,546,1,84.27899253,Arch
bec1443c9cb04f512df8145fbbaaca7c1c6511b4,241,2025,16628,14603,3,129,132,2,47,263,8,35,7.081241008,43545,0,0,2178,3069,891,129666,190857,61191,1097,1643,546,1,83.58208955,Arch
d1a08ae3c92249f0365fd2c918f48f06e7589f3d,5,4,138,134,0,1,1,2,33,265,2,4,1.790835754,1550,1,0,152,156,4,5673,6364,691,63,66,3,0,96.74109837,Arch
b3939acd47b6198930812236678ceae6f6f6a7af,239,15557,2211,13346,82,3,85,2,78,225,8,35,6.963549635,30153,4,2,3069,2178,891,190732,129641,61091,1643,1097,546,1,84.27899253,Arch
e7d57eccfc756efb2cac83edf25da9d57f740553,105,686,5949,5263,3,56,59,0,44,141,6,25,5.933197675,19190,781,0,1205,1477,272,61767,83538,21771,606,786,180,0,88.93406913,Arch
1826b66d72f6e543a57aaf5f3acc3cd9ca6e965d,102,5951,141,5810,57,0,57,1,47,331,6,25,5.864750026,13383,886,1,1471,1169,302,83369,59410,23959,782,582,200,2,89.66684019,Arch
4bc2ac329517df67fd6cb410fd24ede9f12335d9,246,2010,17231,15221,3,134,137,2,47,257,8,35,7.118618616,44185,571,0,2185,3109,924,129867,193394,63527,1103,1671,568,0,85.01994018,Arch
191aca247dc17d7657a3aaf2c678d29036e992cb,239,15557,2211,13346,82,3,85,2,78,225,8,35,6.963549635,30153,878,2,3069,2178,891,190732,129641,61091,1643,1097,546,1,84.27899253,Arch
9febe31899126ca615117a49fa4c4385bf6498a8,241,1977,16651,14674,3,130,133,2,47,263,8,35,7.082471188,43545,573,2,2175,3069,894,129503,190850,61347,1095,1643,548,0,84.27899253,Arch
fcec4b650d186932d3e7164f09c15b4a6e1e06a4,239,15557,2211,13346,82,3,85,2,78,225,8,35,6.963549635,30153,5,3,3069,2178,891,190732,129641,61091,1643,1097,546,1,84.27899253,Arch
e3fec5bc7fcd1091c3f07317039d1d5ed20f2d66,10,643,96,547,4,0,4,1,48,224,4,8,2.764883742,2055,891,0,196,166,30,11269,9089,2180,97,77,20,2,95.98090932,Arch
302661a7af89d4101a9751acfa4897c45fcc44d9,246,2012,17235,15223,3,134,137,2,47,257,8,35,7.118597947,44185,574,1,2184,3109,925,129867,193394,63527,1103,1671,568,0,85.01994018,Arch
00ffe77951a88ea12c60a506a9beff1ae78de300,239,15557,2211,13346,82,3,85,2,78,225,8,35,6.963549635,30151,881,2,3068,2177,891,190732,129641,61091,1643,1097,546,1,84.27899253,Arch
da7f18c618eb51e6aaaff7b10f79240cefaf0183,10,643,96,547,4,0,4,1,48,217,4,8,2.764883742,2053,895,4,195,165,30,11269,9089,2180,97,77,20,2,95.98090932,Arch
96cb3374f1170afd1b3a5f7ac0fe82d79636a093,247,2016,17232,15216,3,134,137,2,47,268,8,35,7.120709335,44425,0,0,2207,3131,924,130652,194193,63541,1118,1686,568,1,85.01994018,Arch
abaabb5f65c2161f77527165a15d2420f6c88219,2,73,2,71,1,0,1,1,14,11,1,1,0.989587521,438,5,1,58,55,3,2060,1897,163,22,20,2,1,96.74109837,Arch
086c5b4152cdb045e7bb4818d9cef925e88ed313,245,16087,2340,13747,86,3,89,2,78,228,8,35,7.004068991,30633,897,5,3131,2213,918,194075,130953,63122,1686,1122,564,0,84.0032591,Arch
527768de890e163770aa4e2de084c7cb20bab82a,7,523,11,512,3,0,3,1,18,819,2,5,2.163523538,816,902,0,164,98,66,6846,4187,2659,82,44,38,3,93.21620303,Arch
0f5d10da38626494ae4d0e3339a2a35f270b0edd,96,8618,49,8569,84,0,84,1,50,55,5,22,6.12838243,3831,907,0,932,329,603,49812,15865,33947,615,167,448,7,93.98443029,Arch
e158bbc75affef29828b98373e864b2c460c1f4d,2,64,8,56,1,0,1,4,27,714,2,2,0.870864469,528,917,10,71,64,7,2446,2317,129,31,29,2,0,91.23235613,Arch
4cd731c92d34a075d9d5a9610ec2610d69aa7792,18,934,35,899,13,0,13,1,2,5,1,7,3.818819126,1009,921,14,152,96,56,7890,3960,3930,106,64,42,1,88.10665069,Arch
4a0e022ce361e21b9f1751434166c5a90c4a8845,19,52,935,883,0,13,13,0,9,11,1,8,3.873457765,2268,921,14,113,167,54,6289,10071,3782,75,116,41,0,90.92687699,Arch
1784a7c68982bae8bed471d92464168f87b0fceb,17,927,34,893,13,0,13,1,2,4,1,6,3.781039672,944,923,16,145,90,55,7587,3683,3904,104,62,42,2,90.92465753,Arch
11be719b32bcf8879c44a0c2005ba5a2107986cb,11,0,800,800,0,11,11,0,0,0,1,3,3.248757007,800,922,15,0,54,54,0,3601,3601,0,41,41,1,93.51750547,Arch
1a15582b59ccfaf80b1547fd57bcb7dfe894b1c8,9,677,0,677,9,0,9,1,2,0,1,3,2.968985219,0,925,18,46,0,46,3094,0,3094,34,0,34,0,93.61993428,Arch
1b6216e97be2771e927b7302160957834039579c,13,6,725,719,0,9,9,0,10,200,2,6,2.950587106,1303,923,16,38,78,40,2558,5912,3354,28,57,29,0,93.4264585,Arch
2ab172a45722efb08e85b6b4d230d9d04b4ce15b,11,721,1,720,9,0,9,1,6,382,2,4,2.878969936,107,933,26,48,8,40,3694,346,3348,37,8,29,1,93.4264585,Arch
123f2ece539f924705945f462030ec2b9692aebd,10,1,845,844,0,8,8,0,4,260,2,4,2.517407225,951,924,17,8,60,52,346,4968,4622,8,43,35,0,93.47766511,Arch
84191f3d46d015cb49ebebb42fddc1019b3db6c3,10,845,1,844,8,0,8,1,6,210,2,4,2.517407225,107,943,36,60,8,52,4968,346,4622,43,8,35,1,93.47766511,Arch
74013456da1260f9155a72fa651d5d6fa449d984,12,15,849,834,0,8,8,1,11,219,2,6,2.631702909,1321,925,18,27,78,51,3525,8076,4551,25,59,34,0,93.47766511,Arch
33e4138840904635a1793084051fd50b643794f1,17,958,179,779,8,0,8,1,19,263,3,9,3.22827047,2366,945,38,222,177,45,19266,14981,4285,148,123,25,0,93.47766511,Arch
7e611bd1c7bbdea3f220af0a17d12bdf1b49b8c0,12,556,39,517,4,0,4,1,51,1718,1,3,2.479077369,1846,1,0,154,135,19,10834,8168,2666,92,75,17,1,96.32116004,Arch
0641243f75d25a92a9ceb811e8e2611a1e95869e,12,306,52,254,4,0,4,1,79,457,4,5,2.800258959,4601,954,47,430,410,20,19590,18797,793,224,212,12,0,92.8,Arch
58bc969fecc01a1947dd272300d4fb305d221ea2,40,789,384,405,8,3,11,1,53,802,7,15,4.074611072,13610,955,48,844,821,23,73243,72185,1058,459,443,16,0,90.49373618,Arch
42ee566f4f93cf074b93eb08266634d2e993bf4c,49,393,1170,777,2,12,14,1,78,279,7,18,4.499812144,17063,954,47,1069,1123,54,83676,86270,2594,552,589,37,0,92.51194902,Arch
aa976bbe83a8961b33f76aa5b0a7302a3b5f8f39,49,1171,393,778,12,2,14,1,80,168,7,18,4.501550622,16286,964,57,1122,1072,50,86224,83762,2462,588,555,33,0,92.51194902,Arch
8a9f7a8a705a7b19fb7226a5aeb971f9ff931cce,49,393,1171,778,2,12,14,1,78,279,7,18,4.501550622,17064,957,50,1069,1123,54,83676,86277,2601,552,589,37,0,92.51194902,Arch
95b70d2b4b04ca86194cbf54e9b5dc1869b36b3b,116,0,64747,64747,0,115,115,1,28,3260,2,11,4.14890736,64919,954,47,11,13026,13015,480,370163,369683,11,5439,5428,0,86.02725087,Arch
334950f6188fe646a4588fd5aafd46e1525686d2,52,1174,404,770,12,2,14,1,80,158,7,21,4.546044195,17020,967,60,1167,1118,49,90647,88273,2374,617,584,33,1,90.88195387,Arch
9454f1ca46bcbd52ba3d7767f2e76a05ffdf56f6,50,396,1174,778,2,12,14,1,78,347,8,19,4.520544139,17213,9,0,1075,1129,54,84698,87301,2603,557,594,37,0,90.88195387,Arch
63f83104d8b7fc086ad92ba166ce58e1897646be,49,1171,393,778,12,2,14,1,80,168,7,18,4.501550622,16286,968,61,1122,1072,50,86224,83762,2462,588,555,33,1,90.88195387,Arch
b57f9ef65c1c0fcf948da3f9d66e31c74d5e3db9,52,404,1174,770,2,12,14,1,78,263,7,21,4.546044195,17790,965,58,1115,1168,53,88187,90700,2513,581,618,37,1,90.88195387,Arch
afc206c7efad8bf3e596b2e9a523cce3b355f035,52,1174,404,770,12,2,14,1,80,158,7,21,4.546044195,17020,969,62,1167,1118,49,90647,88273,2374,617,584,33,0,90.88195387,Arch
2204c15508f7b5757dfcbba8234ca57de8b0884d,52,404,1174,770,2,12,14,1,78,263,7,21,4.546044195,17790,966,59,1115,1168,53,88187,90700,2513,581,618,37,0,90.88195387,Arch
31d7f9a2040975dee08cb685d61cceb7015f9e32,49,1171,393,778,12,2,14,1,80,168,7,18,4.501550622,16286,984,77,1122,1072,50,86224,83762,2462,588,555,33,1,90.88195387,Arch
9745ec4ac2a8585b859350a9e15e06d59dca19fc,11,83,373,290,0,2,2,4,97,1160,2,7,2.748493503,3400,0,0,329,344,15,10674,11505,831,195,202,7,1,93.22563835,Arch
d1a9234ecae47e3704037c839e6041931c24d1f4,64,233,3595,3362,0,19,19,2,98,2546,7,25,4.526090867,23898,976,0,1577,1816,239,99713,113930,14217,768,885,117,1,88.39590444,Arch
7bbb7196173b88baac0e102bdff265dc7f2ee77e,36,511,61,450,6,0,6,2,41,1737,6,14,4.033856223,10256,977,1,686,653,33,55557,54070,1487,352,331,21,1,92.82038716,Arch
d65669b64f003326c98843b32b997e3ffab1e442,23,838,24,814,11,0,11,1,99,677,5,11,3.675792015,3529,978,2,322,283,39,19286,15586,3700,199,164,35,1,96.43218623,Arch
7f9e9cc48e04e4f6cdbea47b98ba2c602059d973,26,2894,1,2893,23,0,23,1,60,3,2,5,4.305955327,2059,980,2,448,255,193,21524,8101,13423,202,97,105,1,93.54626996,Arch
844c0ad36340b695b2784489c078cfd78522143c,6,393,8,385,2,0,2,2,61,1778,1,2,1.859236475,1449,1140,0,204,171,33,7314,5582,1732,77,63,14,1,93.84996192,Arch
b29bb010ada7f17626438b828de1f9e122e5d7bf,27,593,196,397,5,0,5,2,28,1604,3,10,3.892819222,3628,1141,1,279,250,29,19037,17586,1451,153,138,15,1,90.86104382,Arch
04affff861f142881ebb60fce5d8d89568385ab5,9,122,44,78,1,0,1,5,101,1929,2,3,2.504421691,3455,2,0,356,347,9,14989,14607,382,174,171,3,1,95.5231931,Arch
