CommitID,NMF,TotalAddLines,TotalDeleteLines,LC,FileAdd,FileDelete,NAD,NDVE,NUC,AGE,NMS,NMD,Entropy ,MLMF,EXP,REXP,CommitComplexity,LastCommitComplexity,CFC,CommitTokenCount,LastCommitTokenCount,NCC,CommitMethodNum,LastCommitMethodNum,NMC,NIR,a2a,Tag
8ee777a9bbe2b995f3f1984c83db1de46e27c104,69,3365,1892,1473,17,5,22,2,7,88,5,30,5.135222748,9493,42,14,954,878,76,64923,57637,7286,460,386,74,0,91.77545692,Arch
ccd8cb240726deda35fabd2860edcbf4adeb1013,45,1254,1171,83,4,5,9,2,8,0,5,23,4.673832341,8345,43,15,739,746,7,51644,50613,1031,346,363,17,0,93.7357631,Arch
48fbb0f4258499366477b00e164bccbfacccd792,15,1496,23,1473,11,0,11,1,4,12,2,8,3.425484789,728,44,16,222,81,141,10897,3555,7342,127,39,88,0,96.41350211,Arch
11d2fd34281aa8a7365c46f033a65eab29898042,30,1074,95,979,10,0,10,2,9,18,2,15,4.11089273,3871,10,0,457,393,64,25334,19877,5457,272,228,44,0,91.79600887,Arch
eb46e7c72bbbe3149ebf66a6d90167966ba65938,46,1110,418,692,6,2,8,3,10,6,4,26,4.732054237,8674,11,1,762,700,62,57435,53557,3878,374,338,36,0,93.98843931,Arch
1132f3533d0bf76c323a1728ef35301e3b55e38e,9,221,125,96,0,0,0,2,11,8,2,8,1.838661002,2911,45,17,256,246,10,18530,17939,591,98,92,6,0,99.66555184,NoArch
fe5c5e80214493f39390e16f33366d12e895f63a,2,12,8,4,0,0,0,2,3,0,2,2,0.881290899,131,46,18,11,10,1,703,685,18,5,5,0,0,100,NoArch
c4fa585b27cb4e20de44879053ab46aa8e1ad040,1,6,2,4,0,0,0,4,7,6,1,1,0,264,0,0,31,29,2,1708,1688,20,10,10,0,0,100,NoArch
116a78094fd53fc13d3b613f422a9fb220b95f1f,3,151,318,167,0,0,0,4,12,15,1,2,1.403358887,1373,23,2,103,103,0,6997,8257,1260,48,48,0,0,99.55406912,NoArch
8a2a9ae764b38369d252c57eaaa77b0dcf0061c3,0,0,0,0,0,0,0,0,0,0,0,0,0,0,12,2,0,0,0,0,0,0,0,0,0,0,100,NoArch
d84aea35121ea59d48de75cebe8d03fbd82a50de,0,0,0,0,0,0,0,0,0,0,0,0,0,0,47,19,0,0,0,0,0,0,0,0,0,0,100,NoArch
41e08018fc0bd8ceb740602a31781872338c9cc5,0,0,0,0,0,0,0,0,0,0,0,0,0,0,48,20,0,0,0,0,0,0,0,0,0,0,100,NoArch
348a48aa8047b29d05dd0e08287a225ede008dae,16,241,68,173,0,0,0,4,8,79,2,9,3.467758933,3164,0,0,307,291,16,21309,20171,1138,152,145,7,0,100,NoArch
404726031d37211f149c241c731ecf9b5f528bbd,0,0,0,0,0,0,0,0,0,0,0,0,0,0,13,3,0,0,0,0,0,0,0,0,0,0,100,NoArch
b252633fab182ba248aa5ccbb9aea2e661c26b81,0,0,0,0,0,0,0,0,0,0,0,0,0,0,11,0,0,0,0,0,0,0,0,0,0,0,100,NoArch
c3257b96806608a2f082313c743c90cfa4718e44,0,0,0,0,0,0,0,0,0,0,0,0,0,0,12,1,0,0,0,0,0,0,0,0,0,0,100,NoArch
69d3950a325a9b3cb22b6948abba1b22145783cf,26,1739,261,1478,16,1,17,1,13,38,3,10,3.971180778,2123,24,1,374,269,105,19236,12209,7027,183,129,54,0,93.04152637,Arch
6f36e1eaaf6d4a83de3f41e61e650c16db5b4120,22,1344,130,1214,6,0,6,2,14,53,3,15,3.555962385,4070,14,2,514,417,97,30863,23069,7794,285,221,64,0,93.89312977,Arch
d83b671ada9981780257b10acabfce7b4e5a8403,6,122,27,95,0,0,0,3,15,0,3,6,2.19691779,2718,49,2,235,229,6,18188,17493,695,90,87,3,0,100,NoArch
d835710c5196ae5a5272a513acb78913ef946b19,4,27,14,13,0,0,0,2,16,38,2,4,1.385098338,1661,15,2,128,128,0,10998,10912,86,62,62,0,0,100,NoArch
431a9adc5600387d8960b599a6b046bd4fe25fb3,137,2638,10209,7571,6,63,69,1,7,6,6,46,6.301135464,19909,41,0,1198,1779,581,70710,112132,41422,586,952,366,0,76.96969697,Arch
21898907c1d1dd1dd962b441db29c6663756cdb8,141,10983,2672,8311,66,6,72,2,17,31,6,46,6.348365142,12413,0,0,1840,1201,639,117261,71082,46179,978,588,390,0,76.32211538,Arch
f1b7afad2143cba6a87e03207e0e45c7cfc8ef10,5,51,3,48,0,0,0,4,18,78,1,3,2.156982535,1787,16,2,175,169,6,10186,9948,238,118,113,5,0,100,NoArch
b02910c588bc41d9235ff53ef766250b98673956,0,0,0,0,0,0,0,0,0,0,0,0,0,0,1,1,0,0,0,0,0,0,0,0,0,0,100,NoArch
b7047ab4fbe5274d9cb01d5eee85edf8735051c1,1,2,2,0,0,0,0,4,7,4,1,1,0,342,0,0,51,51,0,1627,1631,4,51,51,0,0,100,NoArch
a94f3a638e82193e0243d8227b998046255efbb3,1,3,2,1,0,0,0,3,3,88,1,1,0,89,1,0,2,1,1,467,451,16,1,1,0,0,100,NoArch
f3c851d75487790ab9f4d95817abef2ad2d8ca80,141,2645,11005,8360,6,66,72,1,7,4,6,46,6.342974219,20773,10,0,1201,1847,646,71080,117511,46431,588,983,395,0,76.32211538,Arch
0e3f635adbc231ad513948c39e8b2d93573a035b,141,11005,2645,8360,66,6,72,2,18,31,6,46,6.342747085,12413,17,3,1847,1201,646,117509,71080,46429,983,588,395,0,76.32211538,Arch
a7cd021f266cdaa053fef4304f0794f539333170,0,0,0,0,0,0,0,0,0,0,0,0,0,0,18,4,0,0,0,0,0,0,0,0,0,0,100,NoArch
4c3b367efb369f6bede4bf0169e682adf1123cc1,141,2644,11004,8360,6,66,72,1,7,4,6,46,6.342463124,20773,42,1,1201,1847,646,71080,117509,46429,588,983,395,0,76.32211538,Arch
d6f94b998dc3b98308b86c4a6cd11e2a250a8913,142,11041,2649,8392,66,6,72,2,18,33,6,46,6.351422584,13090,0,0,1977,1331,646,121858,75185,46673,1108,713,395,0,76.32211538,Arch
bca7e7dae40570982155d05467e99446f8e80c44,2,13,33,20,0,0,0,4,8,9,2,2,0.151096971,474,1,1,48,48,0,2332,2508,176,32,31,1,0,100,NoArch
e3b273e9fd33665e46a6fbccfbcf4504399f6f1a,0,0,0,0,0,0,0,0,0,0,0,0,0,0,2,2,0,0,0,0,0,0,0,0,0,0,100,NoArch
77e54e78f8cf4f615f1b899703c85b00a8f8aad1,2,8,0,8,0,0,0,4,9,51,1,2,0.811278124,607,50,0,82,80,2,3436,3393,43,45,44,1,0,100,NoArch
f4bb44c1b1ea3d2645fe209c30e20289a3b30d2c,0,0,0,0,0,0,0,0,0,0,0,0,0,0,51,1,0,0,0,0,0,0,0,0,0,0,100,NoArch
803c635098bbcb4a761eec5cd73ae81965c2f1b4,0,0,0,0,0,0,0,0,0,0,0,0,0,0,52,2,0,0,0,0,0,0,0,0,0,0,100,NoArch
db7311f85e2298d297202c5a8f4f6fc4e5e8ea28,12,92,34,58,0,0,0,2,14,138,3,9,2.916087857,4119,0,0,378,394,16,28213,27632,581,169,174,5,0,100,NoArch
52c507f83ed90ea37b1e64c82fca10b2909f2503,4,9,9,0,0,0,0,3,15,0,2,3,1.925126559,1911,1,1,170,148,22,14372,14366,6,58,50,8,0,100,NoArch
7ef76a4de0c1000abe81513472712cf5602ef97c,0,0,0,0,0,0,0,0,0,0,0,0,0,0,21,0,0,0,0,0,0,0,0,0,0,0,100,NoArch
3aa80839132fa0fafefef66c242bdd426df92653,2,24,4,20,0,0,0,7,16,13,1,2,0.749595257,2001,1,1,163,162,1,14889,14775,114,60,59,1,0,100,NoArch
649475c5cbad78130ac5a4973d0872082b21ecdf,0,0,0,0,0,0,0,0,0,0,0,0,0,0,22,1,0,0,0,0,0,0,0,0,0,0,100,NoArch
b0a2a23372212f865fa559da1b128e4a2279784f,0,0,0,0,0,0,0,0,0,0,0,0,0,0,23,2,0,0,0,0,0,0,0,0,0,0,100,NoArch
23e7badd8ad31113ce8983c8666ff5509f9a847a,15,182,54,128,1,0,1,3,26,168,1,7,3.142812023,3979,27,0,385,376,9,23872,23392,480,208,200,8,0,98.56184084,NoArch
c00f1a9ed972dac9a8c4c238c762cb390b62f54c,41,805,404,401,2,0,2,2,27,72,5,24,3.427788953,10600,28,1,919,900,19,67319,66198,1121,456,428,28,0,95.37572254,Arch
754ab88a2d1e9fe5266d61472d96e34a70e7e888,16,264,166,98,0,0,0,4,28,22,4,13,2.427490203,5922,29,2,463,453,10,38920,37660,1260,203,202,1,0,98.02259887,NoArch
29b906b76329b85d2765c95be76afea8720e2022,1,1,1,0,0,0,0,2,2,318,1,1,0,105,0,0,9,9,0,520,518,2,2,2,0,0,100,NoArch
5cc071f74e518b5b37ce953434d6445c2a97024b,4,64,8,56,0,0,0,6,11,133,2,4,1.589271184,781,73,5,78,75,3,5696,5252,444,49,47,2,0,100,NoArch
e5d9b818bce3fcd9714a5973c68745cce0845fcc,3,96,25,71,0,0,0,4,4,43,1,2,1.100889814,839,2,0,58,55,3,6127,5622,505,32,30,2,0,100,NoArch
348250d9607c5441b13860f178308a3159b15e6b,1,4,4,0,0,0,0,3,5,324,1,1,0,133,3,1,29,29,0,589,578,11,9,9,0,0,100,NoArch
06d44daea321b47476361d1a94f216288b083c6f,0,0,0,0,0,0,0,0,0,0,0,0,0,0,4,2,0,0,0,0,0,0,0,0,0,0,100,NoArch
3eba812a1b53eba9df96fc164c6482bd08cf14ec,0,0,0,0,0,0,0,0,0,0,0,0,0,0,5,3,0,0,0,0,0,0,0,0,0,0,100,NoArch
7d3963b4abfa150a7175d284e3ac38085ccbc233,0,0,0,0,0,0,0,0,0,0,0,0,0,0,74,1,0,0,0,0,0,0,0,0,0,0,100,NoArch
48eedf39f2ed86eab6cc2a13cae5fe6625919a1f,61,611,1442,831,0,3,3,2,25,47,5,30,4.391719546,14870,2,0,1256,1307,51,85574,90080,4506,633,678,45,0,95.50140581,Arch
57693659340cd7e5480ab1058dfd80c8bacad71a,0,0,0,0,0,0,0,0,0,0,0,0,0,0,3,1,0,0,0,0,0,0,0,0,0,0,100,NoArch
e8b3ddd7cbf4232d3e02fa9bcb71c100a5aea26f,61,1433,602,831,3,0,3,2,28,95,5,30,4.413241675,14039,30,0,1307,1256,51,90080,85574,4506,678,633,45,0,95.50140581,Arch
cf1dde03231b54cacecf53e0f9b8320eba4a7590,0,0,0,0,0,0,0,0,0,0,0,0,0,0,31,1,0,0,0,0,0,0,0,0,0,0,100,NoArch
616c9a68c3168d927f08117014949df2f1a859ec,5,264,13,251,1,0,1,7,12,108,2,5,1.543002928,781,6,0,84,71,13,6883,4983,1900,45,38,7,0,98.9021043,NoArch
19c22b231ed69197fb8c932dab464d3f93ecc9ad,13,378,3854,3476,2,1,3,4,29,119,3,9,0.861629519,6463,7,1,313,802,489,18332,32846,14514,167,374,207,0,99.17958067,NoArch
0b26b60a5c253717d890d658a6e6a55caa310518,4,103,40,63,0,0,0,7,19,95,2,4,1.782209115,2260,8,2,216,207,9,17137,16402,735,96,91,5,0,94.15262636,Arch
86209640f76d64767a24c344ec0e2b22c2a381e6,24,776,471,305,3,1,4,1,20,130,2,16,2.922513688,5255,32,0,477,435,42,36054,34540,1514,256,237,19,0,90.54470709,Arch
45dd8980c34b009c6609c0ebfb903b55cbecc2de,1,4,3,1,0,0,0,4,10,0,1,1,0,325,33,1,16,16,0,2241,2253,12,9,9,0,0,100,NoArch
5ee4ac40ae479fc5558863ed425d8e26157f9b34,2,4,4,0,0,0,0,6,13,75,1,2,0.811278124,582,9,3,60,60,0,2418,2418,0,27,27,0,0,100,NoArch
6a3c94aaa30cb00675ff416d0d33ba3a1e868ccc,0,0,0,0,0,0,0,0,0,0,0,0,0,0,10,2,0,0,0,0,0,0,0,0,0,0,100,NoArch
a2e0f523a03ddbb6586210bb6726c4c162225ab0,78,4955,2874,2081,2,9,11,2,25,56,5,36,3.631874677,17194,72,0,1905,1528,377,110578,104263,6315,922,789,133,0,90.9178744,Arch
90b0e5ea49cbd1b7ab98f4d54c12f3249e11fb54,0,0,0,0,0,0,0,0,0,0,0,0,0,0,0,0,0,0,0,0,0,0,0,0,0,0,100,NoArch
1b19658a7d1c7f2a1940e942c90a9d1f00243dbc,0,0,0,0,0,0,0,0,0,0,0,0,0,0,27,0,0,0,0,0,0,0,0,0,0,0,100,NoArch
b1cf097b0cb685ebfb0e507ac8ad777de6baa8ac,82,3116,4953,1837,10,2,12,2,29,105,5,40,3.770442776,19891,1,0,1613,1979,366,110074,114468,4394,825,951,126,0,90.55876686,Arch
e484e91807caeda5afd905b649c97902ec0cdde5,2,13,2,11,0,0,0,6,30,55,1,2,0.566509507,1220,11,2,137,135,2,6859,6788,71,90,88,2,0,100,NoArch
63f1b123554c9c350958beebb539a538bcd52cd2,1,123,0,123,1,0,1,1,1,0,1,1,0,0,12,2,12,0,12,978,0,978,3,0,3,0,99.80732177,NoArch
e2d13c63052a90ac109e26cad05b04c3678aa953,3,6,6,0,0,0,0,2,11,235,2,3,1.251629167,710,13,1,47,47,0,4579,4567,12,26,26,0,0,100,NoArch
ec40d04d514aff1c33eda768651d7e007d629460,2,33,51,18,0,0,0,9,21,166,1,2,0.958711883,2061,0,0,163,163,0,15175,15240,65,61,61,0,0,100,NoArch
5c639c0b05ecb6ae6fcffd6724d15a6c7329b37b,2,64,3,61,1,0,1,1,31,31,1,2,0.998553286,832,1,1,77,75,2,5059,4891,168,29,28,1,0,99.80806142,NoArch
7e9a4a89dd65d7b3791b56284120f98833a31139,1,1,1,0,0,0,0,7,19,119,1,1,0,361,2,0,55,55,0,2108,2111,3,35,35,0,0,100,NoArch
6230e151916ce2f0f76a43c792528d7cabfabc57,1,1,1,0,0,0,0,7,17,33,1,1,0,617,0,0,68,68,0,3620,3620,0,32,32,0,0,100,NoArch
9f98ae643b20203e8fbb9bf65248f9392e54bd3e,6,154,1,153,0,0,0,1,7,298,1,5,2.390060043,1069,34,0,114,101,13,5976,5801,175,67,54,13,0,100,NoArch
f2980052cd2a1eba3ebd62a2683a417ff9484258,1,3,2,1,0,0,0,7,18,29,1,1,0,617,35,1,68,68,0,3639,3620,19,32,32,0,0,100,NoArch
c98ee057fcd9d2566e5cefcf15bd5d2e5ec9283e,9,192,23,169,0,0,0,3,16,270,2,7,2.772661015,2048,2,0,205,188,17,13443,12338,1105,143,131,12,0,99.90421456,NoArch
64e0573aca01dfd07b23ec41e20acb307829733e,28,693,329,364,5,2,7,1,32,230,6,14,3.81887031,5647,36,2,484,466,18,37167,35245,1922,244,235,9,0,92.4783028,Arch
274aaf49fedc9afd97092e169b970d600eeda7b1,7,22,35,13,0,0,0,1,7,60,4,6,2.385129824,1128,37,3,83,84,1,7332,7403,71,46,47,1,0,99.90291262,NoArch
3768ad45fb7b59451cb2e8a2616deec1870b5b52,0,0,0,0,0,0,0,0,0,0,0,0,0,0,38,4,0,0,0,0,0,0,0,0,0,0,100,NoArch
50139fe9040fd4ad500f3faa1dafabe8e017ef9d,0,0,0,0,0,0,0,0,0,0,0,0,0,0,39,5,0,0,0,0,0,0,0,0,0,0,100,NoArch
7f079632a6420f118aca3d7befe2c1593d0640aa,19,55,49,6,0,0,0,4,23,83,5,16,3.968274177,8258,13,2,474,474,0,60134,60101,33,237,237,0,0,100,NoArch
ba7c258c618d9f08750609cc10e80f72550ad563,5,20,7,13,0,0,0,2,28,140,1,3,2.086772687,1268,14,3,152,150,2,6420,6344,76,131,129,2,0,100,NoArch
9dff8c2326bee74f2653b9bdc3fd917918b6b9d2,4,270,25,245,1,0,1,3,10,104,3,4,1.2061207,1338,30,2,203,180,23,9548,7620,1928,61,57,4,0,99.14089347,NoArch
c5b4cb1b75e75b3ae9328dcf1b8fadaa0374abc1,8,529,28,501,2,0,2,1,29,60,1,4,1.914922653,1376,2,0,207,156,51,10464,7694,2770,132,111,21,0,99.57374254,NoArch
d3df32fa03e3b83a914ef9df9d56046dacb681bc,1,7,3,4,0,0,0,5,11,0,1,1,0,269,15,3,26,25,1,1628,1565,63,10,10,0,0,100,NoArch
123da020e209b1537a7b247a9991082071a862c2,4,27,41,14,0,0,0,5,14,24,1,2,1.433384433,2230,31,3,133,135,2,15498,15568,70,64,65,1,0,100,NoArch
291a88ba941a6ededdbf6d06c5684ea38f90502a,2,50,4,46,0,0,0,5,47,35,1,2,0.935711051,2701,3,0,205,201,4,18424,18107,317,81,78,3,0,100,NoArch
48643795b809ba748d4439ec602f38d6e77675c5,1,6,1,5,0,0,0,10,48,1,1,1,0,1104,16,3,103,102,1,5945,5913,32,45,45,0,0,100,NoArch
1b756db2219352b695b9da28f00f2449d2b1c4f5,6,27,6,21,0,0,0,4,30,87,1,3,2.439116288,1413,32,2,146,143,3,8809,8677,132,122,119,3,0,91.48753224,Arch
fa787ab5ab422689ddef4956417b77863a26b2e6,4,21,19,2,0,0,0,3,10,308,1,4,1.533206219,616,0,0,109,108,1,3302,3312,10,48,47,1,0,100,NoArch
987f5d6b965b49e0ba86e5d06ef5e685fb465f2e,22,971,278,693,6,0,6,2,31,58,4,13,3.894154591,3374,33,3,388,341,47,22370,18601,3769,261,227,34,0,94.90333919,Arch
788e4f2d2eeeeee685b9f5d2e09b56be230e34d4,193,4972,5966,994,4,0,4,5,49,171,7,63,6.370780482,36965,0,0,3316,3316,0,213811,213792,19,1795,1795,0,0,90.67357513,Arch
a4049329a5170aea4d7c73f6e6890ee05d16448e,0,0,0,0,0,0,0,0,0,0,0,0,0,0,48,0,0,0,0,0,0,0,0,0,0,0,100,NoArch
6c226ca21a84b18bde0ff3a3c569f3e6957a480f,8,1972,1164,808,4,0,4,10,25,12,2,3,2.15075704,2197,1,1,227,184,43,19621,17521,2100,127,89,38,0,97.91666667,Arch
720e42f52a0e3a5e50e63ec39c46b758a7454b01,13,553,126,427,7,0,7,2,35,18,2,6,3.462291119,1990,34,0,241,211,30,12962,11253,1709,120,100,20,0,98.53300733,NoArch
c3c205fc02155d398e52d4395527c03c710c2bdb,15,221,116,105,0,0,0,5,33,41,4,10,2.861937046,5102,35,1,436,424,12,35264,34448,816,265,256,9,0,99.75825947,NoArch
fa73a911cc3628e375816155c6951c5398b46d30,0,0,0,0,0,0,0,0,0,0,0,0,0,0,27,0,0,0,0,0,0,0,0,0,0,0,100,NoArch
4d1fba24c958c17652b693d22af378e6c2ceb749,3,294,3,291,1,0,1,1,15,39,1,3,0.433486786,683,0,0,80,63,17,5939,4126,1813,32,26,6,0,99.59774739,NoArch
b9b9b24993993051ba9378f4e8ed1b103d811795,1,27,28,1,0,0,0,1,2,0,1,1,0,276,1,1,15,15,0,1753,1730,23,6,6,0,0,100,NoArch
c66004d79a2b1d30584df5e99e782d399d0b8ce7,8,556,101,455,2,0,2,3,10,104,1,2,2.820786968,862,2,0,108,81,27,9154,6806,2348,50,30,20,0,97.04918033,Arch
04655e9e85e8e4aacc8c66209ccd0f4fb0b28671,17,614,119,495,2,0,2,1,50,72,2,10,3.542457983,4194,36,1,485,421,64,27683,25106,2577,242,204,38,0,96.52945924,Arch
75df72f575d67042dcbbfd2123fc304992048ae4,3,161,10,151,1,0,1,2,7,78,1,3,0.80750076,531,37,1,41,34,7,4259,3316,943,21,18,3,0,92.4351585,Arch
93f345a032629367dc2e63b7b61712d6e201c5be,13,117,78,39,0,0,0,5,34,48,4,9,3.005482809,4757,38,2,408,403,5,31974,31765,209,246,243,3,0,100,NoArch
dfc0c61eb7d8ef6e66e96252f0fc89c260786704,46,2617,1251,1366,20,7,27,5,36,21,4,19,4.828453297,6280,3,0,572,484,88,46919,41505,5414,295,231,64,0,95.17833554,Arch
23d53763c4db744fe936e2e609fe6abaf7bd9a82,1,13,6,7,0,0,0,6,18,140,1,1,0,323,39,2,30,28,2,2305,2211,94,9,9,0,0,100,NoArch
a97814462d1b7b2b7a1a880df1e30bc5a8c3544b,3,93,27,66,0,0,0,4,9,144,2,3,1.37538809,486,2,0,63,54,9,2977,2626,351,23,18,5,0,100,NoArch
85dd265b7bb87fb19a9c8317fff97f24000367ee,3,16,7,9,0,0,0,4,35,176,3,3,1.337778097,922,49,0,134,128,6,4889,4839,50,104,103,1,0,100,NoArch
8f1d362015aeff281c7327d657b0dd7d89ff3083,1,8,8,0,0,0,0,3,4,629,1,1,0,100,2,0,11,11,0,428,414,14,9,9,0,0,100,NoArch
8ad8030f2a0b9da3cd3cdecc21992803ce8a37fc,5,36,22,14,0,0,0,5,28,199,2,5,2.233868539,1151,1,0,85,85,0,9842,9776,66,51,51,0,0,100,NoArch
4f76f2899e08935e89b6060a14cfbb8af0e83981,0,0,0,0,0,0,0,0,0,0,0,0,0,0,28,0,0,0,0,0,0,0,0,0,0,0,100,NoArch
43ef3857305dc4ebf56e8c574198f81ebd7844db,0,0,0,0,0,0,0,0,0,0,0,0,0,0,50,1,0,0,0,0,0,0,0,0,0,0,100,NoArch
98fd97b65fdf136212fd16366c7ae2af48c86bd6,8,531,81,450,2,0,2,12,44,139,2,6,1.961076006,2494,0,0,268,244,24,19661,16749,2912,134,123,11,0,98.84526559,NoArch
b5a75fdd910e907f308c5a404a722baf98db825d,0,0,0,0,0,0,0,0,0,0,0,0,0,0,7,4,0,0,0,0,0,0,0,0,0,0,100,NoArch
06bdba3cef187d4b7ca906dc7012b880bbc7fe93,0,0,0,0,0,0,0,0,0,0,0,0,0,0,30,0,0,0,0,0,0,0,0,0,0,0,100,NoArch
9710b5a3a63633a3487431219b6af16b8753598f,3,35,0,35,0,0,0,5,32,133,2,3,1.556656707,646,24,4,80,75,5,4762,4444,318,42,40,2,0,100,NoArch
f3418e47181edfcbd2db778ad4c7af7312ec9c65,5,330,5,325,2,0,2,2,6,19,3,4,1.288700222,620,25,4,36,16,20,5849,3942,1907,25,13,12,0,99.1954023,NoArch
0a200c32e5043eca194c0dc287ba7114067c1851,0,0,0,0,0,0,0,0,0,0,0,0,0,0,31,1,0,0,0,0,0,0,0,0,0,0,100,NoArch
1fca9b21cc020294dd65bcec542969b6145b3048,3,65,1,64,0,0,0,2,13,35,2,3,1.513202452,614,63,0,50,43,7,4167,3709,458,25,22,3,0,100,NoArch
8485b9e2630a0619ad59ffb29739477b46d6a527,2,32,1,31,0,0,0,1,19,74,2,2,0.439496987,358,26,0,32,32,0,2348,2087,261,11,11,0,0,99.48246118,NoArch
1628d044ac5b2197fd8a565961f68b3aa7936f67,2,21,0,21,0,0,0,4,22,76,2,2,0.998363673,457,1,0,50,47,3,2959,2810,149,31,29,2,0,100,NoArch
48aa026dc4887eaf78eacb8ceb428f8534c6d03b,0,0,0,0,0,0,0,0,0,0,0,0,0,0,50,0,0,0,0,0,0,0,0,0,0,0,100,NoArch
d904fe69ca003260f871ea4e099b1bd564951a70,2,64,1,63,1,0,1,1,8,65,1,2,0.538141185,214,0,0,29,24,5,1653,1349,304,13,12,1,0,99.88465975,NoArch
07324e7a20fb40ed8179c47a1dc213e56d51c229,9,1754,153,1601,5,0,5,1,9,63,4,7,2.791482211,894,27,1,224,77,147,18774,6623,12151,97,39,58,0,98.48058526,NoArch
25cd05b24e2f324b66873d812ecbc8fbd966ac6b,4,432,9,423,2,0,2,5,18,71,2,2,1.294375771,575,28,1,91,56,35,7069,3575,3494,36,29,7,0,99.61559583,NoArch
1362942aa3dc69c7daecdd3f270d423f53890c6c,1,1,1,0,0,0,0,5,20,173,1,1,0,292,64,0,24,24,0,1508,1508,0,24,24,0,0,100,NoArch
d0fde474589aaf17bb840dbf86e2809eddc60e1d,2,42,26,16,0,0,0,8,45,305,1,2,0.191433255,1339,51,0,127,127,0,9054,8910,144,61,61,0,0,100,NoArch
fa65db9c4cd8ce1c71d46789c9bb8e0fb03de98a,4,130,31,99,2,0,2,1,10,254,2,4,1.872375435,1043,65,0,167,156,11,5809,5458,351,143,137,6,0,99.72662657,NoArch
f999e4960c9c5e901c3e44ebf716e3eaaa173522,8,29,22,7,0,0,0,9,58,223,1,4,2.270235251,3947,29,0,421,421,0,23833,23794,39,178,178,0,0,100,NoArch
0015c9b00e46bde88089680e790a7fb3ad12e5ef,0,0,0,0,0,0,0,0,0,0,0,0,0,0,66,1,0,0,0,0,0,0,0,0,0,0,100,NoArch
e83dde3b9591d0ff52c453331e80a5d6ae91bb11,1,10,0,10,0,0,0,12,47,18,1,1,0,861,52,0,96,94,2,5279,5201,78,47,47,0,0,100,NoArch
7243ce40c93f60e8d3e47c2405dc92b4e38e1b10,13,51,456,405,0,4,4,3,23,559,3,7,2.678557847,2016,53,1,158,178,20,8619,11179,2560,93,103,10,0,96.01873536,Arch
bf65219b730d99f98f78fa7cb3f016249a57fe49,1,279,0,279,1,0,1,1,1,0,1,1,0,0,2,0,9,0,9,1556,0,1556,5,0,5,0,99.68414403,NoArch
466ff73ffbbfcffd5b22763245098951575788e5,4,15,15,0,0,0,0,5,10,460,3,4,1.425605199,901,0,0,123,123,0,5726,5726,0,37,37,0,0,100,NoArch
30c5f8b7bd051271de7f9012221c2a47d9f92ea9,12,156,24,132,2,0,2,2,28,168,5,8,2.884790401,3053,30,0,362,346,16,18399,17887,512,157,152,5,0,95.22673031,Arch
6946dd75576cecceffdeb0bf06299f483ddeb444,39,253,332,79,0,0,0,2,59,264,5,22,3.781126339,10021,0,0,1037,1052,15,58148,58761,613,516,516,0,0,100,NoArch
345aaa31aaefa3abd7bcd7ea038821da298ac6b4,0,0,0,0,0,0,0,0,0,0,0,0,0,0,0,0,0,0,0,0,0,0,0,0,0,0,100,NoArch
110df7190b9c414d25ab7f7012bcbb524db8b0b4,10,103,39,64,0,0,0,3,28,320,3,8,2.832988145,3718,54,0,216,209,7,28214,27616,598,111,110,1,0,99.60451977,NoArch
d1bb804577168107f347b10913538e13b180d004,1,10,1,9,0,0,0,9,29,90,1,1,0,407,55,1,66,65,1,2445,2386,59,39,39,0,0,100,NoArch
169e3f66bbdc2a8c4163e8966461b1d891e0ca11,3,22,1,21,0,0,0,2,39,245,1,2,1.402934238,411,56,1,19,17,2,2773,2645,128,11,9,2,0,100,NoArch
68723764ed276556b8bf1a1c3f2ea3d695586544,1,12,0,12,0,0,0,8,17,912,1,1,0,114,57,1,5,4,1,817,733,84,2,2,0,0,100,NoArch
994d42d3079b347946c3888fa9962274b89888f1,9,31,24,7,0,0,0,5,60,179,1,5,2.675272945,6002,58,2,496,495,1,40331,40313,18,216,215,1,0,100,NoArch
7985eb72b5e5a71372196f2510db68982c6761aa,8,86,73,13,0,0,0,2,29,386,1,3,2.577644064,1581,59,3,146,142,4,9760,9768,8,63,61,2,0,99.94356659,NoArch
2b55f0751fea7a10ac0d3520f8fba30e463981e6,0,0,0,0,0,0,0,0,0,0,0,0,0,0,0,0,0,0,0,0,0,0,0,0,0,0,100,NoArch
c70dbc13e94c8917967924bf7a8b950a085ad160,0,0,0,0,0,0,0,0,0,0,0,0,0,0,67,0,0,0,0,0,0,0,0,0,0,0,100,NoArch
3a0044216cb2f707639d48e2869f4ee6f25cfc19,47,2141,249,1892,14,0,14,2,24,257,6,19,4.895804592,5789,31,0,640,500,140,47261,35827,11434,336,253,83,0,92.25473322,Arch
defcf6a0b9d8894aa9efd1c9515c1d1d11512e60,3,36,8,28,0,0,0,5,17,526,1,3,1.472596227,915,32,1,82,75,7,6723,6535,188,30,26,4,0,100,NoArch
8adaca34548ffdb89615dfbb4a2d44d8f71bff55,6,97,18,79,0,0,0,3,61,42,1,3,1.927408992,4417,33,2,401,397,4,28684,28155,529,179,176,3,0,100,NoArch
09f203d324d75aea1166b344ef9b5054fdb78380,0,0,0,0,0,0,0,0,0,0,0,0,0,0,1,1,0,0,0,0,0,0,0,0,0,0,100,NoArch
ef0d6f2218cd8604507e53e36b390e8f71ef698e,0,0,0,0,0,0,0,0,0,0,0,0,0,0,32,0,0,0,0,0,0,0,0,0,0,0,100,NoArch
a16aa2a78fbe6c7d4ab784ea7d5431d2d73d8a86,0,0,0,0,0,0,0,0,0,0,0,0,0,0,33,1,0,0,0,0,0,0,0,0,0,0,100,NoArch
8dddecf00f377f1e72a0e0119af97972bfd6059f,0,0,0,0,0,0,0,0,0,0,0,0,0,0,1,0,0,0,0,0,0,0,0,0,0,0,100,NoArch
639c287cab4876f3b5951e5bcd7d4e940f16223f,2,9,3,6,0,0,0,7,20,666,2,2,0.811278124,363,0,0,42,41,1,1985,1960,25,13,13,0,0,100,NoArch
94eb6fd91948f92bc32d50e9011f10acc7744b4e,0,0,0,0,0,0,0,0,0,0,0,0,0,0,1,0,0,0,0,0,0,0,0,0,0,0,100,NoArch
75c7a2622bb65e09a9dac15ba4ed02f91c8dbb75,1,36,0,36,1,0,1,1,1,0,1,1,0,0,1,1,1,0,1,59,0,59,1,0,1,0,99.88344988,NoArch
080b7d4d9b12baa93744744ec82facced847622a,0,0,0,0,0,0,0,0,0,0,0,0,0,0,8,0,0,0,0,0,0,0,0,0,0,0,100,NoArch
bbf40ef9878af05fc2f92d2382a582f52fc4f209,0,0,0,0,0,0,0,0,0,0,0,0,0,0,9,1,0,0,0,0,0,0,0,0,0,0,100,NoArch
363df2c12e520c5e1a5afc14391154707650524b,0,0,0,0,0,0,0,0,0,0,0,0,0,0,68,0,0,0,0,0,0,0,0,0,0,0,100,NoArch
3ae6cb4ed5820d6407663ffa74c6d201feaa8b45,20,388,120,268,1,0,1,1,40,284,4,12,3.375901224,6530,34,0,535,517,18,49138,46846,2292,246,233,13,0,99.53623188,NoArch
b514e1ab18415e3d369e3b836c14c7b1a9498cea,0,0,0,0,0,0,0,0,0,0,0,0,0,0,0,0,0,0,0,0,0,0,0,0,0,0,100,NoArch
4a8bec7ea58950c7450f5edec93e9dd00cef2972,3,15,8,7,0,0,0,6,27,150,2,3,1.409844941,875,4,0,88,88,0,4934,4909,25,43,42,1,0,100,NoArch
3c647a99cf50a8148aeabc950d7d33dbc080e226,0,0,0,0,0,0,0,0,0,0,0,0,0,0,2,0,0,0,0,0,0,0,0,0,0,0,100,NoArch
adc8cac74378c16f2508adbf16a6a51d241a3e35,0,0,0,0,0,0,0,0,0,0,0,0,0,0,35,1,0,0,0,0,0,0,0,0,0,0,100,NoArch
57bbed21de888b4b58f20fe753630c231547a40d,0,0,0,0,0,0,0,0,0,0,0,0,0,0,69,1,0,0,0,0,0,0,0,0,0,0,100,NoArch
621f2b878d1bcd259d5c1361ef0ad686b5e5b5af,0,0,0,0,0,0,0,0,0,0,0,0,0,0,0,0,0,0,0,0,0,0,0,0,0,1,100,NoArch
48797b1ae1bf3ad08908d43e3fdc5824e3d79eee,3,16,2,14,0,0,0,6,40,729,1,2,1.41526895,802,1,1,114,112,2,4027,3949,78,113,111,2,0,100,NoArch
a6c45feb2c6d81c4cba5c0e345aca3d1e517c9d6,5,125,122,3,1,0,1,1,9,286,1,4,1.167330805,700,5,1,78,79,1,3150,2929,221,51,46,5,0,99.88465975,NoArch
0dd4a90b0334d819fa8e080c5fae9ad21947156d,6,341,74,267,0,0,0,8,62,253,2,5,1.88237998,4493,60,0,417,402,15,30384,28587,1797,192,190,2,0,100,NoArch
9e59da7fd96d8af0587efa2f34c89f56320d4c91,12,268,173,95,0,0,0,9,63,144,2,7,2.088052354,7345,61,1,678,659,19,48113,47491,622,334,323,11,0,100,NoArch
a2a052abd9b8955817eb4438db68998ab83d81c1,0,0,0,0,0,0,0,0,0,0,0,0,0,0,0,0,0,0,0,0,0,0,0,0,0,0,100,NoArch
194d904c99ebd013af55eac7509e3e79193dce77,0,0,0,0,0,0,0,0,0,0,0,0,0,0,36,1,0,0,0,0,0,0,0,0,0,0,100,NoArch
395806fc684d8f6c3fa1b6b0f29e601cb6f4bbd0,2,1,119,118,0,1,1,4,12,698,1,2,0.249882293,239,0,0,6,16,10,444,944,500,2,11,9,1,99.65337955,NoArch
3d9041e2165bb0de0aaf71ad04cee16daa7d74b4,10,114,30,84,0,0,0,3,53,173,3,7,2.83675035,2933,62,2,297,287,10,19034,18421,613,149,144,5,0,99.82608696,NoArch
372fbc4733824d6f61db7f4b7d5e289dc902e634,4,31,21,10,0,0,0,6,41,522,1,3,1.483248807,1423,70,1,141,141,0,8860,8773,87,135,135,0,1,100,NoArch
e56c1612e46ba831f45c1ce8ee9fc2694933e2d5,3,7,8,1,0,0,0,3,29,115,2,2,1.5058231,551,71,2,54,54,0,3257,3274,17,20,20,0,1,100,NoArch
f1410bfdcde0745625d46b9f3f5e996eb368663f,9,112,23,89,1,0,1,8,42,357,1,7,2.477964632,2672,72,3,272,262,10,15766,15258,508,210,204,6,1,95.35374868,Arch
5847f0c934a8ce2ead96c8adc8c0259dda6b1283,2,12,6,6,0,0,0,5,15,420,1,2,0.852405179,1014,73,3,158,158,0,6045,6004,41,139,139,0,1,100,NoArch
51f490898913db5964c208c57ab14794b42fa44d,1,3,2,1,0,0,0,6,11,15,1,1,0,776,74,4,132,132,0,4264,4256,8,125,125,0,1,100,NoArch
b34a204a527a156406908686e54484a0c3d8a3d7,4,20,9,11,0,0,0,6,64,90,3,3,1.931402878,2402,75,5,232,231,1,14053,13983,70,109,109,0,0,100,NoArch
d1d33f725ecbef51cec05be805094b6bb1733c3e,2,38,1,37,0,0,0,5,31,575,1,2,0.821280942,525,1,0,79,74,5,3343,3126,217,50,46,4,1,100,NoArch
2577014617220abe3def503e931f811d238c1a10,7,246,7,239,2,0,2,7,41,274,2,5,2.018954044,1000,63,1,127,119,8,8127,6427,1700,68,61,7,0,99.71000483,NoArch
b07110b9fdb7d25c0cb737bef6fe0628fdfb147d,0,0,0,0,0,0,0,0,0,0,0,0,0,0,37,0,0,0,0,0,0,0,0,0,0,0,100,NoArch
a8feee929394194922405bd12b330e40e9b710fe,3,28,4,24,0,0,0,8,43,92,1,2,1.400074515,1236,64,1,164,159,5,6888,6735,153,137,134,3,0,100,NoArch
83b6aa5e9163d9e5bc79ef45a950faed202a4ba6,0,0,0,0,0,0,0,0,0,0,0,0,0,0,3,0,0,0,0,0,0,0,0,0,0,1,100,NoArch
9e7ce19b06c5b6235857e22dc039bb726b61f8ca,2,52,2,50,0,0,0,6,21,472,1,2,0.650022422,1753,65,2,92,89,3,14483,13986,497,50,49,1,0,100,NoArch
e35d24f31dc7a8d60bc63efc5ee5020880119dea,5,122,125,3,0,1,1,1,10,85,1,4,1.167330805,703,6,0,79,78,1,2929,3150,221,46,51,5,0,99.9034749,NoArch
36ef94004ec8443d980342e3b69ca729d105af4d,0,0,0,0,0,0,0,0,0,0,0,0,0,0,38,1,0,0,0,0,0,0,0,0,0,0,100,NoArch
243c58f77cfc875159a0ac568efb0e3dfff199a6,0,0,0,0,0,0,0,0,0,0,0,0,0,0,39,2,0,0,0,0,0,0,0,0,0,0,100,NoArch
9ef51deb841765e85a1d1c8ab337677a687dfb66,1,48,0,48,1,0,1,1,1,0,1,1,0,0,0,0,4,0,4,138,0,138,4,0,4,0,93.24988824,Arch
2f1e3e15fb5844edf406b03085309d2135f47177,2,2,52,50,0,0,0,6,22,4,1,2,0.650022422,1803,40,3,89,92,3,13986,14483,497,49,50,1,0,100,NoArch
26f24b6728343b2788125edf8de94a4800fd8c0e,3,10,125,115,0,0,0,6,23,386,1,2,1.346324975,2001,66,1,107,112,5,14041,14822,781,61,63,2,0,100,NoArch
461ce18bd1177a54ca737acab879361f680960d8,0,0,0,0,0,0,0,0,0,0,0,0,0,0,0,0,0,0,0,0,0,0,0,0,0,0,100,NoArch
7129dc5bb7dded620141c868cefd64ab18bac139,14,953,187,766,8,0,8,1,13,157,1,2,3.439878515,1585,0,0,188,114,74,13766,10384,3382,87,48,39,0,99.04919388,NoArch
ea20d4724813990c87159be0dd10b40f6ac71542,9,74,82,8,0,0,0,1,44,89,1,2,2.322105163,1737,76,0,195,196,1,8667,8603,64,151,149,2,0,99.5075913,NoArch
57a8b9cc8c6a1526bd9e2174321a5b675d716943,2,10,6,4,0,0,0,6,16,84,2,2,0.811278124,709,11,0,63,64,1,4173,4163,10,30,30,0,0,100,NoArch
978470af336c1efd04864c2f0c1eb6a963233f39,1,1,1,0,0,0,0,5,13,2,1,1,0,223,41,0,22,22,0,1357,1355,2,11,11,0,0,100,NoArch
f47f0eb6cba5ae861a8c9e8eb06b6acdb68d159f,0,0,0,0,0,0,0,0,0,0,0,0,0,0,0,0,0,0,0,0,0,0,0,0,0,1,100,NoArch
ee1feb7c75fda1e3d28cb8635694ad69d849fa74,0,0,0,0,0,0,0,0,0,0,0,0,0,0,42,1,0,0,0,0,0,0,0,0,0,1,100,NoArch
a33a55fcb59c9de341bc3169defda94df2910e65,1,9,3,6,0,0,0,4,9,1206,1,1,0,311,67,1,30,30,0,1748,1676,72,12,12,0,0,100,NoArch
738635306bef3d5e7c9395d71409bc4dc8feb2cc,5,194,122,72,1,0,1,1,11,55,1,4,1.066537821,700,7,0,85,79,6,3471,2929,542,55,46,9,0,99.91809992,NoArch
e2dcef860672c140e4b66091292ff3bee3d20110,0,0,0,0,0,0,0,0,0,0,0,0,0,0,1,1,0,0,0,0,0,0,0,0,0,1,100,NoArch
4b27cc72bbb87b74c47950a2bd24ef94cfecac8d,1,9,2,7,0,0,0,5,7,717,1,1,0,72,0,0,6,5,1,456,432,24,2,2,0,0,100,NoArch
a0e62b79192874808193247053b502746a8bef1d,6,459,159,300,2,0,2,7,45,24,1,3,2.08040247,1669,77,1,199,178,21,12101,10329,1772,154,140,14,0,99.79583503,NoArch
9cce9abf4de340c095760431301d369e364c5b34,8,48,22,26,0,0,0,6,65,316,3,4,1.474362351,3310,43,2,334,329,5,18950,18729,221,150,150,0,0,100,NoArch
af46078a828abb45e9e90915fd7e5f6f2a83d1ee,1,2,1,1,0,0,0,4,7,273,1,1,0,368,68,1,47,47,0,2386,2382,4,12,12,0,0,100,NoArch
6e1e62635731d73ccc424df88d9c7c9a2e57ec8d,1,1,1,0,0,0,0,6,18,2,1,1,0,511,44,3,45,45,0,3041,3037,4,19,19,0,0,100,NoArch
7002ca6775b66521bbd926e3aab4f6c2f3c537e0,0,0,0,0,0,0,0,0,0,0,0,0,0,0,78,1,0,0,0,0,0,0,0,0,0,0,100,NoArch
cc38abecc8944135bb7b9475ff36890aa0a96680,0,0,0,0,0,0,0,0,0,0,0,0,0,0,12,1,0,0,0,0,0,0,0,0,0,0,100,NoArch
64fec640975b42b0645c75416eb8bbf0b8092c66,105,8538,864,7674,50,0,50,1,66,228,5,29,5.557498163,18632,45,3,2425,1721,704,160122,117817,42305,1377,936,441,0,93.15512353,Arch
e43efa042fe04f1bbb29a9794cddbd47eff62248,0,0,0,0,0,0,0,0,0,0,0,0,0,0,79,2,0,0,0,0,0,0,0,0,0,0,100,NoArch
a7e6cf51974f96c6b4bc945db25658cbb4bc48c7,3,12,4,8,0,0,0,5,19,169,2,3,1.298794941,846,46,4,78,76,2,4973,4937,36,33,32,1,0,100,NoArch
3fd2fd6e9dbf8c03bcc742b883fa2a0598ad99be,6,74,71,3,0,0,0,3,17,43,1,2,2.172545182,1703,1,1,120,121,1,11475,11555,80,53,53,0,0,100,NoArch
145034c5faebefe51b6f1557f156bc19c787d671,52,1663,966,697,4,2,6,5,67,230,5,27,4.919918466,17891,47,4,1692,1622,70,122445,118634,3811,1007,966,41,0,95.13274336,Arch
2fe526d5485963493e44d9c6cb2a80cb84244c1f,4,53,11,42,0,0,0,4,9,536,1,1,1.978247161,694,48,5,66,62,4,4740,4367,373,28,27,1,0,100,NoArch
f120427607986de82f99f2ba9a2eb0ff136c2bae,1,22,1,21,0,0,0,2,2,303,1,1,0,245,0,0,25,23,2,1636,1495,141,12,11,1,1,100,NoArch
4074c5eb234f643ed0d79efff090138b50ad99ea,5,82,90,8,0,0,0,8,18,19,1,2,1.774461794,1285,80,3,100,97,3,8266,8433,167,48,45,3,1,100,NoArch
99b0c72aa6e02a86517bc674bdd6b18f7842c7d8,2,7,3,4,0,0,0,1,44,16,2,2,1,398,49,6,35,34,1,2732,2733,1,19,18,1,1,100,NoArch
f2d91a455ec17e66ad319f47a2d5ad45d62c9ca3,7,461,30,431,3,0,3,7,48,164,1,3,2.552052231,1738,0,0,240,202,38,11761,9420,2341,195,162,33,0,93.22033898,Arch
d0d2fa03379525e8156d5dc0adae9eb852603899,8,25,16,9,0,0,0,1,19,42,2,7,2.637020301,3784,50,7,265,265,0,30132,30050,82,117,117,0,0,100,NoArch
9c8f8212ef0979add9f5fba7d5c7c6be58869aab,0,0,0,0,0,0,0,0,0,0,0,0,0,0,51,6,0,0,0,0,0,0,0,0,0,1,100,NoArch
33f5208c1e95067606cd24ea90c05cd33626a243,1,3,2,1,0,0,0,12,68,21,1,1,0,1414,52,7,145,145,0,8413,8409,4,56,56,0,0,100,NoArch
93f8f12a30a05cd8c6862d0f895e4bd9a9b3336a,3,126,21,105,0,0,0,5,33,438,2,3,1.090204366,782,53,8,113,103,10,5478,4866,612,64,61,3,1,99.90426041,NoArch
a1f287d359f9c5e55b6d3d19871feca5cf3d250c,0,0,0,0,0,0,0,0,0,0,0,0,0,0,81,2,0,0,0,0,0,0,0,0,0,0,100,NoArch
227785c022939cd2ba153c2a4f7791ab3394c6c7,0,0,0,0,0,0,0,0,0,0,0,0,0,0,14,0,0,0,0,0,0,0,0,0,0,0,100,NoArch
d860fb18b6248abfa911e6188d1105f2afc4e582,1,2,5,3,0,0,0,12,69,2,1,1,0,1415,54,9,145,145,0,8389,8413,24,56,56,0,1,100,NoArch
6b5abb5d92043b5360d4059280a1f39e35974eae,0,0,0,0,0,0,0,0,0,0,0,0,0,0,0,0,0,0,0,0,0,0,0,0,0,0,100,NoArch
3b916ec1af070f00f43ceb4d3b41c8209739bb42,0,0,0,0,0,0,0,0,0,0,0,0,0,0,82,2,0,0,0,0,0,0,0,0,0,0,100,NoArch
a5e24395149fcabca5e93d15654b036f8e91020a,0,0,0,0,0,0,0,0,0,0,0,0,0,0,83,3,0,0,0,0,0,0,0,0,0,0,100,NoArch
acd74129cd97f24c0dde9bf032a4048f2ce27b5f,1,36,0,36,1,0,1,1,1,0,1,1,0,0,84,4,1,0,1,59,0,59,1,0,1,0,99.90412272,NoArch
7b4a28ecf8d6a51c30c989df6e3cad64c58bf985,0,0,0,0,0,0,0,0,0,0,0,0,0,0,85,5,0,0,0,0,0,0,0,0,0,0,100,NoArch
66893bfef21ef4644536688595f685f4e1a95051,0,0,0,0,0,0,0,0,0,0,0,0,0,0,0,0,0,0,0,0,0,0,0,0,0,1,100,NoArch
a0391b7c0183316d35862ae73ca8e1c8c4931fef,2,46,4,42,0,0,0,5,12,36,1,2,0.634309555,416,55,7,45,43,2,2743,2294,449,37,35,2,0,100,NoArch
5ae34db76481d19932e0e250b1601f1a041ce709,1,14,18,4,0,0,0,3,4,1219,1,1,0,111,56,7,8,8,0,380,457,77,5,5,0,0,100,NoArch
45e65cc2f7f2bdebbd51222854033719deba9288,0,0,0,0,0,0,0,0,0,0,0,0,0,0,57,8,0,0,0,0,0,0,0,0,0,0,100,NoArch
b325cbff1018cd25534fc4564593fbb3c5bf53cd,0,0,0,0,0,0,0,0,0,0,0,0,0,0,1,1,0,0,0,0,0,0,0,0,0,0,100,NoArch
173e0b6be4f835c6f0f3b8354d6d402f20dd4903,0,0,0,0,0,0,0,0,0,0,0,0,0,0,2,2,0,0,0,0,0,0,0,0,0,0,100,NoArch
30b0f2636fa8a24232096b9e6efcb895850d7ba5,0,0,0,0,0,0,0,0,0,0,0,0,0,0,58,8,0,0,0,0,0,0,0,0,0,0,100,NoArch
479908fd20a97c5f7007f06ba7ee3904967e1050,417,3877,3188,689,0,0,0,2,70,418,10,80,8.665860115,67884,59,8,6006,6006,0,390370,390370,0,3408,3408,0,1,100,NoArch
065173211e2d884e22d48173f75763c8f6b6c7e3,2,24,18,6,0,0,0,9,57,0,1,1,0.985228136,1228,60,9,130,130,0,6984,6991,7,71,70,1,1,100,NoArch
51d122b5c39525720ce946755f57326ce24f6e38,2,52,42,10,0,0,0,1,16,6,2,2,0.382380675,402,61,7,45,44,1,2496,2462,34,17,17,0,0,92.66963843,Arch
b791473a6d663cd4ac2ce535aaa62bcd89fea3af,30,697,406,291,4,0,4,3,58,0,2,13,3.703972649,6630,86,4,611,587,24,41181,39853,1328,332,310,22,0,99.44077275,NoArch
1c943ab2305a06467cb039b534ee0915e4ef7453,3,111,49,62,0,0,0,5,20,9,2,3,0.23096453,768,62,7,47,42,5,5853,5271,582,22,21,1,0,100,NoArch
04fc86b43d0afc39b76a7d85e82e8b94dee42923,9,21,257,236,0,5,5,1,24,8,1,1,2.771473732,2231,63,8,126,142,16,12679,13516,837,73,85,12,0,91.61793372,Arch
136f8478a3d8deb1e2c00ee2bf45dd5f25fcb87f,2,2,56,54,0,0,0,1,29,8,1,1,0.216396932,1378,64,9,55,57,2,10596,10912,316,23,25,2,0,99.81105338,NoArch
cd7623e2160abd43ea44f48a9640ea8fa0bb6db3,10,146,54,92,0,0,0,5,30,4,1,4,3.009221244,4806,65,10,288,268,20,33755,33478,277,150,141,9,0,100,NoArch
129e4336413fd2290e137804cf16c515c502c2f7,18,465,172,293,1,0,1,4,22,0,3,8,3.199453558,4584,69,0,488,465,23,27777,25735,2042,212,200,12,0,99.62157048,NoArch
8e08d498c9c822e5d23ef2392863a97ce6fc1a96,1,6,9,3,0,0,0,8,38,24,1,1,0,543,70,1,58,60,2,3420,3446,26,17,17,0,0,100,NoArch
8c9980f4f5aab1f7d576567595d4cc0e4745308a,0,0,0,0,0,0,0,0,0,0,0,0,0,0,34,0,0,0,0,0,0,0,0,0,0,0,100,NoArch
a1483f2c5f3b921d1117d31f75453e45e5717259,11,48,27,21,0,0,0,1,39,20,3,8,3.236265308,5709,66,11,454,453,1,39840,39686,154,223,223,0,1,100,NoArch
3a210ef08e178d4cb41f7d7a0ab774a04d0e8eab,0,0,0,0,0,0,0,0,0,0,0,0,0,0,67,12,0,0,0,0,0,0,0,0,0,0,100,NoArch
a0d7ab238473f22347e140b0e1e273ab80583eb7,27,1955,423,1532,9,0,9,1,71,14,4,15,3.482781545,7440,68,13,811,664,147,54592,46928,7664,417,340,77,1,91.03182257,Arch
2c40e8419e209767653e2741e653a71bb429d31d,5,16,7,9,0,0,0,1,21,20,3,5,1.978808695,995,69,13,110,108,2,4444,4387,57,67,65,2,0,100,NoArch
822312761113baea86145279a156c9c63d1a331d,1,2,0,2,0,0,0,3,4,34,1,1,0,67,70,13,7,7,0,226,219,7,5,5,0,0,100,NoArch
66c7fa2322d0dce8ebb29f9b15a711f5f7b72884,1,4,1,3,0,0,0,9,39,34,1,1,0,428,71,14,42,41,1,2126,2115,11,25,25,0,0,100,NoArch
1b61eb45e0643a76cfc949e61d2ddd51f7d7183e,2,18,4,14,0,0,0,9,50,34,1,2,0.976020648,1051,0,0,159,156,3,5879,5786,93,131,130,1,0,100,NoArch
17e878f721c110f274251d2ba6c7c50fcd58cb8f,1,81,0,81,1,0,1,1,1,0,1,1,0,0,0,0,9,0,9,364,0,364,4,0,4,0,97.28971963,Arch
e48e35385a91cf6d03a0a91d71aabfe78fe82928,3,68,25,43,1,0,1,1,22,12,1,2,1.564735091,661,0,0,55,55,0,3608,3298,310,29,28,1,0,99.82214317,NoArch
9f18a1ca80ec1d08253688d9b4d4538a86068559,3,29,7,22,0,0,0,7,23,23,2,2,1.052940761,1871,72,6,165,162,3,9446,9354,92,84,82,2,0,100,NoArch
62ecb2da62117e65117f7f6070469ac27a3ea5dd,1,5,0,5,0,0,0,6,20,75,1,1,0,675,0,0,87,86,1,3907,3863,44,35,35,0,0,100,NoArch
11c4121f739d1d00a4ec66b4e243e47602d6ffb4,0,0,0,0,0,0,0,0,0,0,0,0,0,0,1,0,0,0,0,0,0,0,0,0,0,0,100,NoArch
621c246fa9ea607a3cd8f33fdc3d8b528315e327,4,61,18,43,0,0,0,4,24,54,2,3,1.172408735,1829,0,0,158,155,3,11113,10875,238,79,77,2,1,100,NoArch
5823c1ebd7e12a48805eed05532edfd25b69c6fe,21,482,167,315,2,0,2,1,72,69,3,11,3.586019811,8042,73,0,880,839,41,48931,47612,1319,558,534,24,1,99.50980392,NoArch
ae3c02fb3fff47da8f20c4f9c8012a257a3df792,12,91,27,64,0,0,0,5,59,83,3,8,2.732762473,5521,74,1,562,556,6,35983,35648,335,295,289,6,1,99.86577181,NoArch
c0593e7a13b6c0bdb35c944e3ed67a79f3ce9b9b,1,11,3,8,0,0,0,3,11,96,1,1,0,404,0,0,49,48,1,1840,1814,26,19,19,0,0,100,NoArch
3d408ee96b7cc8eb15756276dbab031eb549e6e2,1,9,4,5,0,0,0,8,41,8,1,1,0,541,75,2,59,58,1,3432,3425,7,17,17,0,1,100,NoArch
6efa16317c0f0f13798d739d9615dda24bf91bcf,1,7,7,0,0,0,0,7,12,100,1,1,0,242,2,0,27,27,0,1563,1535,28,14,14,0,0,100,NoArch
9857c4b21ccb77a97817e1e448c4c54bdd409562,2,14,4,10,0,0,0,9,25,68,1,2,0.918295834,832,1,1,75,75,0,4612,4583,29,34,34,0,0,100,NoArch
0b451b3a58cabe25c0cecd3fd8847a8597e2313a,3,39,4,35,0,0,0,10,35,83,1,3,1.409749999,1238,76,3,170,164,6,6322,6157,165,87,85,2,1,100,NoArch
83dab21ae13137270df79c1b731b131ed3a24aa1,1,5,3,2,0,0,0,1,4,32,1,1,0,907,77,4,159,159,0,5115,5106,9,130,130,0,0,100,NoArch
9265c7cc36381591d92fca60517d1c64f7481709,0,0,0,0,0,0,0,0,0,0,0,0,0,0,78,3,0,0,0,0,0,0,0,0,0,0,100,NoArch
e0648de2ef89ec55481a185a520a79b325236e28,2,18,1,17,0,0,0,9,26,40,1,1,0.949452015,1060,2,2,103,98,5,5583,5471,112,38,38,0,1,100,NoArch
68464c7d027462eb481b3edffc980c4d0a0bd643,0,0,0,0,0,0,0,0,0,0,0,0,0,0,0,0,0,0,0,0,0,0,0,0,0,1,100,NoArch
e20b77be3b1e14039d659cd56bec163708e1b24d,6,62,45,17,0,0,0,3,38,116,2,2,2.273190802,1096,87,0,101,103,2,6804,6703,101,47,47,0,1,100,NoArch
6e0ff3a235602c6181e90ffe77de76a36fd21af4,0,0,0,0,0,0,0,0,0,0,0,0,0,0,79,3,0,0,0,0,0,0,0,0,0,0,100,NoArch
171901a9d0bfe6d405a10e8774d74b88a87edf0b,0,0,0,0,0,0,0,0,0,0,0,0,0,0,0,0,0,0,0,0,0,0,0,0,0,0,100,NoArch
69d2afd0a9d5fc59091429770da48869d146b05b,0,0,0,0,0,0,0,0,0,0,0,0,0,0,0,0,0,0,0,0,0,0,0,0,0,0,100,NoArch
8ddfa2ecda33830d30bf53bdf6a926a2a88855c9,0,0,0,0,0,0,0,0,0,0,0,0,0,0,16,0,0,0,0,0,0,0,0,0,0,1,100,NoArch
8139ffd94cae2b924477d3bd4fd4781929662b04,0,0,0,0,0,0,0,0,0,0,0,0,0,0,80,4,0,0,0,0,0,0,0,0,0,1,100,NoArch
86b5fcdd332f8d7f1c079dbc54756173ca4b7c94,7,113,14,99,0,0,0,8,73,103,1,6,2.111466487,3740,0,0,419,409,10,21746,21064,682,259,250,9,0,100,NoArch
1a29d46a5707d58a33f170ce6877ebbe814715e2,1,1,15,14,0,0,0,5,14,150,1,1,0,255,3,0,16,17,1,1502,1574,72,6,6,0,0,100,NoArch
a066865bd6e1bbdae145324d70fbfb8b5b69b2ab,1,933,0,933,1,0,1,1,1,0,1,1,0,0,4,1,128,0,128,5090,0,5090,47,0,47,0,99.91055456,NoArch
ec965892b042b123e985db5676fdf599d934404c,0,0,0,0,0,0,0,0,0,0,0,0,0,0,81,4,0,0,0,0,0,0,0,0,0,1,100,NoArch
d288e328339f29b8d5acffea416c9bd1281e6010,1,17,13,4,0,0,0,4,13,143,1,1,0,359,0,0,50,50,0,1678,1661,17,34,34,0,1,100,NoArch
722b6be04a0083f96438fe026cafd4cec5ef6093,125,754,758,4,0,0,0,3,74,93,7,43,6.464148964,34174,0,0,2916,2915,1,214293,213666,627,1518,1518,0,1,97.72329247,Arch
a4f9d7575f39bb79089714049ffea12ba5f25ec8,863,72616,72326,290,433,405,838,1,75,0,19,166,9.110925089,72301,82,4,6437,12849,6412,412280,821635,409355,3619,7231,3612,1,21.68674699,Arch
8d37fbf0db8aa1a65225aba95d2f6b485e869567,0,0,0,0,0,0,0,0,0,0,0,0,0,0,71,0,0,0,0,0,0,0,0,0,0,0,100,NoArch
4787076c6d87488c0087ac0cfb7fa86596b1357a,2,52,65,13,0,0,0,1,2,4,1,2,0.748449295,1888,83,3,111,117,6,13998,14081,83,40,41,1,1,100,NoArch
8f5e7ad5d96302905c09cfae9d28bfe684782fc7,0,0,0,0,0,0,0,0,0,0,0,0,0,0,1,0,0,0,0,0,0,0,0,0,0,1,100,NoArch
1b79ef7672031301b6269e3a7b3587ddb7c793d9,2,4,4,0,0,0,0,2,2,12,2,2,0.811278124,1107,0,0,87,87,0,7181,7173,8,42,42,0,1,100,NoArch
92eed6aca81d69c7fb91107b19366d03f7f4a944,0,0,0,0,0,0,0,0,0,0,0,0,0,0,4,0,0,0,0,0,0,0,0,0,0,1,100,NoArch
6edf0b9defe8c82b0ef0076a6300c00c1641a6e6,5,440,130,310,1,0,1,2,2,24,3,3,1.67373174,1461,35,0,151,122,29,10583,9337,1246,75,52,23,3,95.61808118,Arch
cd090871a18210ac311c02009b27bd7cfcf2bb44,15,529,52,477,1,0,1,2,2,28,5,10,1.209039004,3921,36,1,480,428,52,26135,24475,1660,185,169,16,1,99.74500637,NoArch
c265b4948fd78b2d9050b67d18c20b4caa8aceab,0,0,0,0,0,0,0,0,0,0,0,0,0,0,84,1,0,0,0,0,0,0,0,0,0,1,100,NoArch
78e07215070106176902b57108a5689dce3cf606,0,0,0,0,0,0,0,0,0,0,0,0,0,0,88,0,0,0,0,0,0,0,0,0,0,1,100,NoArch
e0ab89b3ac22207ff45cf3cae782d64b8be01bf1,4,194,5,189,3,0,3,1,2,12,1,4,1.839359122,505,0,0,63,51,12,3615,2816,799,16,11,5,1,98.45758355,NoArch
baea4f3b82661747f574eda24cfb7dac89ddd72b,1,11,4,7,0,0,0,2,2,49,1,1,0,184,0,0,16,15,1,1158,1115,43,9,9,0,0,100,NoArch
b5d4da79586192f17c0db458c1d4fcdbb334c3e2,1,3,2,1,0,0,0,2,3,0,1,1,0,191,1,1,16,16,0,1158,1158,0,9,9,0,0,100,NoArch
41dbac69037ddd770a94cf41f39beff92aec9568,1,16,1,15,0,0,0,2,2,49,1,1,0,225,2,2,13,12,1,1939,1813,126,12,11,1,0,100,NoArch
b44f8521f2b25928bccce9a6ba5c89fb76e5330e,0,0,0,0,0,0,0,0,0,0,0,0,0,0,1,1,0,0,0,0,0,0,0,0,0,1,100,NoArch
00cfe72c5d56dbaa2e170a087cf04b1e56a87bc3,0,0,0,0,0,0,0,0,0,0,0,0,0,0,2,2,0,0,0,0,0,0,0,0,0,0,100,NoArch
5f9fa82f47e1cc14a22b869250fe23c8f9c033cd,0,0,0,0,0,0,0,0,0,0,0,0,0,0,85,1,0,0,0,0,0,0,0,0,0,1,100,NoArch
5c2da6051effb38795011fc1d296ef9bd38f1208,1,36,0,36,1,0,1,1,1,0,1,1,0,0,3,3,1,0,1,61,0,61,1,0,1,1,99.91356958,NoArch
40dd4dd637a44f532af9143bf588dc36a3ced729,0,0,0,0,0,0,0,0,0,0,0,0,0,0,4,4,0,0,0,0,0,0,0,0,0,1,100,NoArch
a6908ef44dc21898ed53785fe0bd5f1e373ae779,2,22,3,19,0,0,0,1,2,54,1,2,0.529360865,732,86,2,59,58,1,4836,4764,72,26,25,1,1,100,NoArch
376b59ae5ff46a77941c6e6608a82b8ceb6523ef,4,77,20,57,0,0,0,1,3,40,1,4,1.328978128,1191,87,3,95,92,3,7931,7490,441,44,42,2,1,100,NoArch
8b150a3c6bf76e8029fda82a8a4e181b7a026980,0,0,0,0,0,0,0,0,0,0,0,0,0,0,5,4,0,0,0,0,0,0,0,0,0,1,100,NoArch
555dd55c16b2df504214f2bdfe84a6b106f61904,1,1,1,0,0,0,0,3,4,0,1,1,0,531,3,3,55,55,0,2986,2984,2,11,11,0,0,100,NoArch
821e0dcffcd7d0ca5b0140ebe585639fc0c32e22,2,19,18,1,0,0,0,2,2,68,1,2,0.800392208,243,6,5,21,19,2,1531,1526,5,8,8,0,1,100,NoArch
07a0ea87ab8239889149e462864acee66fa9547d,1,1,1,0,0,0,0,2,2,76,1,1,0,849,7,6,69,69,0,4005,4005,0,48,48,0,0,100,NoArch
0e6f078ec4648fc0abc7f0453b2ba1837480cfb9,0,0,0,0,0,0,0,0,0,0,0,0,0,0,0,0,0,0,0,0,0,0,0,0,0,0,100,NoArch
7a973a694488930627028b3175a731a23e3d3f32,45,388,290,98,2,0,2,2,3,77,7,28,4.617932871,11283,37,0,1153,1132,21,68141,67994,147,519,509,10,1,98.52813853,NoArch
d0b9b56b7de3a70cc24475fd552ebe00ad07ab39,4,4,8,4,0,0,0,3,4,0,3,3,1.887918503,887,89,0,106,106,0,4981,4997,16,45,45,0,1,100,NoArch
93bc5e2153c90e44d35dafc468466196306f4227,10,31,27,4,0,0,0,2,3,50,3,8,3.119830238,2186,88,2,226,226,0,12119,12113,6,87,87,0,1,99.65277778,NoArch
64df98fc4a15d5b80dfbb2843e919effa99c4ec2,4,165,25,140,1,0,1,3,3,46,2,4,1.30809619,1322,5,0,156,146,10,8121,7144,977,100,93,7,1,99.91326973,NoArch
6f2b166005043b85056e23c420195a9e569e443b,24,2227,2333,106,1,0,1,2,4,49,1,7,3.29973938,9240,1,0,533,544,11,64323,65730,1407,288,274,14,1,97.68518519,Arch
90bfb900aa47d4e77873fafe89e4d8bdd0ec4d96,1,0,4,4,0,0,0,2,3,0,1,1,0,137,2,1,6,6,0,871,919,48,5,5,0,0,100,NoArch
80c27f23510e9c4232ee87e06475d8af4823bb38,7,7,62,55,0,0,0,2,4,0,1,4,2.508250201,3274,3,2,146,156,10,23853,24055,202,91,93,2,0,100,NoArch
5f04241fce99f47abfb7ef9f03292472b3ee23fb,7,132,118,14,0,0,0,2,5,0,1,1,2.118056005,3618,4,3,233,239,6,22792,23064,272,122,127,5,0,99.70384995,NoArch
895d732a1423f3a113d9630aa3c56e4b0837effd,2,4,4,0,0,0,0,2,5,0,1,1,1,755,5,4,64,64,0,3158,3158,0,41,41,0,0,100,NoArch
58623631d4cbe016e0a3142ca931f412a181d8b2,4,42,23,19,0,0,0,1,3,73,1,3,1.996798444,332,89,1,24,24,0,1863,1863,0,11,11,0,1,100,NoArch
117a68d5038960fa0cb14e00c0e27b9a772e1bf2,0,0,0,0,0,0,0,0,0,0,0,0,0,0,90,2,0,0,0,0,0,0,0,0,0,0,100,NoArch
36c74c8a160660f8f3790dbb5da7e30dd7c4b32a,0,0,0,0,0,0,0,0,0,0,0,0,0,0,91,3,0,0,0,0,0,0,0,0,0,1,100,NoArch
d2525c31b7dad7bae2d4899d8df2a353ca39af50,0,0,0,0,0,0,0,0,0,0,0,0,0,0,92,4,0,0,0,0,0,0,0,0,0,0,100,NoArch
0b032b2761fcc23a3bcedaf654431635ec7e7f03,2,12,11,1,0,0,0,3,5,50,1,2,0.886540893,2679,72,0,194,195,1,18290,18262,28,78,78,0,0,100,NoArch
3ee16b5439837f6bb03052a7d57edd8bc67db7d7,0,0,0,0,0,0,0,0,0,0,0,0,0,0,93,5,0,0,0,0,0,0,0,0,0,1,100,NoArch
b1446be2b4d50e60b54146c66a6e6412d41b3a17,1,1,1,0,0,0,0,3,4,6,1,1,0,461,90,1,83,83,0,2795,2795,0,17,17,0,1,100,NoArch
1a61d6bc4df2d0c45515c41210b1e48e4d2c1d1b,0,0,0,0,0,0,0,0,0,0,0,0,0,0,94,6,0,0,0,0,0,0,0,0,0,1,100,NoArch
7190c022bb741fe78418b13efb6fe13fcbd128b0,0,0,0,0,0,0,0,0,0,0,0,0,0,0,95,7,0,0,0,0,0,0,0,0,0,1,100,NoArch
63cc455d9c273af0dda8a07f2293d350da36c851,0,0,0,0,0,0,0,0,0,0,0,0,0,0,96,8,0,0,0,0,0,0,0,0,0,1,100,NoArch
c0f42afa35768cf191dcc061feac2e7396457058,2,34,3,31,0,0,0,2,3,57,1,2,0.98678672,1599,0,0,193,184,9,9556,9312,244,73,71,2,1,100,NoArch
629698d54fbc17c32fd321913e9441fb0487a991,0,0,0,0,0,0,0,0,0,0,0,0,0,0,97,9,0,0,0,0,0,0,0,0,0,1,100,NoArch
96a46d870122914dd7cc1f9f20a5489b8fe03187,0,0,0,0,0,0,0,0,0,0,0,0,0,0,98,10,0,0,0,0,0,0,0,0,0,1,100,NoArch
2c6da09d9d17f33ebc025c9ec9fa949605288bb7,2,4,0,4,0,0,0,3,4,14,1,2,1,999,99,11,65,65,0,8045,8029,16,27,27,0,1,100,NoArch
c1e7d0e5a6ebc6fa416fc463ea6526f64a39afc5,0,0,0,0,0,0,0,0,0,0,0,0,0,0,100,12,0,0,0,0,0,0,0,0,0,1,100,NoArch
e217db56ab30ec9630411aefc16516747b3112e0,0,0,0,0,0,0,0,0,0,0,0,0,0,0,91,2,0,0,0,0,0,0,0,0,0,1,100,NoArch
4bda742a938a344fb667d5d86ef1007de5c29365,0,0,0,0,0,0,0,0,0,0,0,0,0,0,101,13,0,0,0,0,0,0,0,0,0,0,100,NoArch
2e75a6973df26625ef0b5b44ad1cbbc7989bbea0,0,0,0,0,0,0,0,0,0,0,0,0,0,0,102,14,0,0,0,0,0,0,0,0,0,0,100,NoArch
69ca45b2da0f1791d4d8f049726a31ba3d90dcd7,0,0,0,0,0,0,0,0,0,0,0,0,0,0,103,15,0,0,0,0,0,0,0,0,0,0,100,NoArch
1104f9526fcd05270ed5cd084228f023f1a01c46,3,177,55,122,0,0,0,3,5,75,1,2,1.118334988,1113,73,1,108,92,16,7586,6758,828,49,44,5,1,100,NoArch
f020d029c406008b7342f1117b95b68b4a90d401,11,24,24,0,0,0,0,2,6,71,4,9,3.204986856,6461,2,0,388,388,0,47695,47695,0,220,220,0,1,100,NoArch
635154c43930ddf57c31446897b41df3178f9f6a,1,1,1,0,0,0,0,2,2,124,1,1,0,227,0,0,25,25,0,1497,1488,9,14,14,0,0,100,NoArch
1e6dd1ca1de576bc090c67ba0abdf466ada5cb3e,0,0,0,0,0,0,0,0,0,0,0,0,0,0,38,1,0,0,0,0,0,0,0,0,0,0,100,NoArch
bf05f954133da5b760a66906557df0305dbd0eaf,1,11,0,11,0,0,0,3,3,97,1,1,0,572,0,0,53,52,1,2861,2780,81,27,27,0,1,100,NoArch
2ea8b0c3f1eeb19f4dc1e9946331c8fd93e6daab,6,19,14,5,0,0,0,1,4,96,3,6,2.351340622,1200,104,15,117,116,1,6016,5983,33,66,65,1,1,100,NoArch
01e803b00e5acf9bb1dbe38340e38e8feb8d037d,14,142,141,1,0,0,0,2,7,29,2,6,3.365265694,6302,3,1,379,378,1,44508,44988,480,196,195,1,1,100,NoArch
50a073ff57c20eef2a80a44532ed5536c6435ac6,1,206,0,206,1,0,1,1,1,0,1,1,0,0,6,0,18,0,18,1160,0,1160,14,0,14,1,99.90205681,NoArch
6e8a28bcaee173f703132f52f525d1568596ac3d,1,1,1,0,0,0,0,1,2,149,1,1,0,168,105,7,15,16,1,911,917,6,11,11,0,1,100,NoArch
1d2e3dcc65187d1bf90cc9c05d85ba4d27124270,0,0,0,0,0,0,0,0,0,0,0,0,0,0,106,8,0,0,0,0,0,0,0,0,0,1,100,NoArch
e41835fd912d35c52bf339fcef626ca7df06da62,0,0,0,0,0,0,0,0,0,0,0,0,0,0,107,5,0,0,0,0,0,0,0,0,0,1,100,NoArch
6da2f9ac7c51117c9cd76e82ce01d4c0a0c69477,0,0,0,0,0,0,0,0,0,0,0,0,0,0,108,4,0,0,0,0,0,0,0,0,0,1,100,NoArch
e78ba598c549d51a3e7ce4231acebe46f9828001,0,0,0,0,0,0,0,0,0,0,0,0,0,0,109,5,0,0,0,0,0,0,0,0,0,0,100,NoArch
e75fa070f85ed1e0f72f9718a715a08a76679140,0,0,0,0,0,0,0,0,0,0,0,0,0,0,110,6,0,0,0,0,0,0,0,0,0,1,100,NoArch
cef06c1e4849ea93644c17af89b56b3f17d322fc,0,0,0,0,0,0,0,0,0,0,0,0,0,0,111,7,0,0,0,0,0,0,0,0,0,1,100,NoArch
3dedc7e5fdd5f885915e81e47e110b845a905dbf,33,249,273,24,1,0,1,2,8,65,4,15,4.240095457,10488,8,0,545,541,4,80362,80769,407,318,311,7,1,98.68868383,NoArch
7dd9c74b1bb28c3a934e46d560abbb4c5b6d4586,2,72,3,69,1,0,1,1,2,80,1,2,0.665273523,58,9,1,6,2,4,685,311,374,3,2,1,1,99.85583854,NoArch
9b66ea41fd4e4e08eeb426bc1b698766284e71e4,0,0,0,0,0,0,0,0,0,0,0,0,0,0,112,8,0,0,0,0,0,0,0,0,0,1,100,NoArch
eb4cc05c1beb48da99c21ce10140d70b9fbb5454,0,0,0,0,0,0,0,0,0,0,0,0,0,0,113,9,0,0,0,0,0,0,0,0,0,1,100,NoArch
8a55938ca18b24b9f6bbfa16a8ef55077663844d,0,0,0,0,0,0,0,0,0,0,0,0,0,0,114,10,0,0,0,0,0,0,0,0,0,1,100,NoArch
d050d980715c0d8649531a3ed5ca7a7472b29760,11,117,0,117,1,0,1,2,7,113,2,9,1.848642719,2830,10,2,260,252,8,18022,17494,528,130,124,6,1,99.85645933,NoArch
e655cfba3018359457d2f3911ec5f7e78a5f2a56,0,0,0,0,0,0,0,0,0,0,0,0,0,0,39,0,0,0,0,0,0,0,0,0,0,0,100,NoArch
834c591955cfa8a9c5f286967d693932564b6764,0,0,0,0,0,0,0,0,0,0,0,0,0,0,115,10,0,0,0,0,0,0,0,0,0,0,100,NoArch
b19bed442d84c1cb1e48d184c9554920735bcb6c,351,6929,8726,1797,0,0,0,1,9,0,10,74,7.405470213,68971,11,3,6164,6164,0,399036,399036,0,3433,3433,0,1,100,NoArch
e10e06918e4758917513c55f9bc02c35dad99128,2,15,0,15,0,0,0,2,3,2,1,2,0.918295834,443,12,4,34,33,1,3431,3233,198,19,19,0,1,100,NoArch
c052167c064b453ba5761f1137dc68104414121a,0,0,0,0,0,0,0,0,0,0,0,0,0,0,0,0,0,0,0,0,0,0,0,0,0,0,100,NoArch
12523c379fe9d0bcf298fba80d9c2ca08e1a0d56,6,88,38,50,0,0,0,4,5,27,3,4,1.740989498,1751,0,0,168,161,7,12616,12461,155,82,77,5,1,100,NoArch
1c09f5b055cc78fabb4881cac75f43734f3dcf61,1,2,1,1,0,0,0,4,5,17,1,1,0,316,0,0,29,28,1,2093,2071,22,13,13,0,1,100,NoArch
8c133400627db55570183c9d478098f339fd4977,0,0,0,0,0,0,0,0,0,0,0,0,0,0,1,0,0,0,0,0,0,0,0,0,0,0,100,NoArch
77f4e73615d0949eec70187e397ef17f62e908a0,10,368,393,25,0,0,0,2,4,19,3,7,1.726155637,2377,116,8,270,260,10,13528,12577,951,152,139,13,1,99.95219885,NoArch
603df66938ebf1a72ceab5a055d911e0caa438f5,0,0,0,0,0,0,0,0,0,0,0,0,0,0,117,9,0,0,0,0,0,0,0,0,0,0,100,NoArch
0b0018a789ba69c6377bd0c32cfc37dc52b2d398,0,0,0,0,0,0,0,0,0,0,0,0,0,0,118,10,0,0,0,0,0,0,0,0,0,1,100,NoArch
b7c827d06d8021d42985fbaf42736461d7b3d196,0,0,0,0,0,0,0,0,0,0,0,0,0,0,119,11,0,0,0,0,0,0,0,0,0,1,100,NoArch
0cbcf67e3722f62994bc475e72974dd68fbed220,0,0,0,0,0,0,0,0,0,0,0,0,0,0,120,12,0,0,0,0,0,0,0,0,0,1,100,NoArch
90571b755659fb581c4eb3f1a3b3e207f490f832,0,0,0,0,0,0,0,0,0,0,0,0,0,0,121,13,0,0,0,0,0,0,0,0,0,1,100,NoArch
83e411e21bc51d081955a0716157e5e2e6593926,0,0,0,0,0,0,0,0,0,0,0,0,0,0,122,14,0,0,0,0,0,0,0,0,0,1,100,NoArch
a133c6781db5c2cf96234abaa6af73e7b85e0fb8,0,0,0,0,0,0,0,0,0,0,0,0,0,0,123,15,0,0,0,0,0,0,0,0,0,1,100,NoArch
1cfd311b40d814b87ede942f770324abdd1affea,0,0,0,0,0,0,0,0,0,0,0,0,0,0,124,8,0,0,0,0,0,0,0,0,0,0,100,NoArch
7381b661942dad9c650e43179a478a57b530a606,0,0,0,0,0,0,0,0,0,0,0,0,0,0,118,10,0,0,0,0,0,0,0,0,0,1,100,NoArch
ed745dfdbf254bfc2ec6d9c7baed8ccbf571abab,6,224,5,219,2,0,2,3,3,12,1,4,2.177004183,516,0,0,53,40,13,4802,3117,1685,34,26,8,1,98.06877061,NoArch
dfdc0e40e1f85c49e580b31204621758e3d76ac5,2,16,6,10,0,0,0,3,5,30,1,2,0.945660305,519,40,1,51,50,1,2941,2878,63,28,27,1,1,100,NoArch
14dd649d06009e99f0d687edd0763c27e3df0389,0,0,0,0,0,0,0,0,0,0,0,0,0,0,119,4,0,0,0,0,0,0,0,0,0,0,100,NoArch
4529f535b26496ec838bd6cd6673a53f42b766e2,1,1,1,0,0,0,0,6,7,37,1,1,0,685,0,0,95,95,0,4344,4342,2,36,36,0,0,100,NoArch
031b067a3ab77afb55f8f48b06eead27f551e12e,0,0,0,0,0,0,0,0,0,0,0,0,0,0,0,0,0,0,0,0,0,0,0,0,0,0,100,NoArch
e4c91ed13f16e1d0d55d9d690395bb62ab2b4fa0,18,25,25,0,0,0,0,1,4,2,6,10,4.00385619,5426,41,1,276,276,0,43926,43926,0,147,147,0,1,94.36677632,Arch
d8be818ac9b7b7674918e59eac270e067a2c52a2,17,562,103,459,6,0,6,4,6,22,3,10,3.614378037,3735,120,5,399,368,31,28379,26167,2212,180,163,17,1,99.44933921,NoArch
1cfd311b40d814b87ede942f770324abdd1affea,44,140,828,688,0,8,8,2,6,73,7,26,4.453749305,11569,124,8,829,874,45,80430,84392,3962,399,425,26,0,92.42236025,Arch
c23da694ccbbf1f0ebcc5ed770dd56c74c1e06d7,49,1287,404,883,8,0,8,3,7,0,7,27,4.275580434,12938,121,5,1159,1091,68,97334,92183,5151,621,579,42,1,92.18362283,Arch
ef5001e432c12a2812d5a2e48621e9845666c3d1,0,0,0,0,0,0,0,0,0,0,0,0,0,0,13,0,0,0,0,0,0,0,0,0,0,0,100,NoArch
b0838d25f7280784e8707a3528c8b8f3c0defb04,0,0,0,0,0,0,0,0,0,0,0,0,0,0,14,1,0,0,0,0,0,0,0,0,0,0,100,NoArch
7c7403a59dedc012fe2945e230a50f90139fce4b,1,2,1,1,0,0,0,2,2,25,1,1,0,363,15,2,11,11,0,2756,2749,7,11,11,0,0,100,NoArch
eda472adb09ce82063f58200eafcb7be361b4cb8,0,0,0,0,0,0,0,0,0,0,0,0,0,0,0,0,0,0,0,0,0,0,0,0,0,0,100,NoArch
3251d62bd3c740b25139029a1913d1cf5a57173f,1,17,0,17,0,0,0,3,3,65,1,1,0,229,1,0,20,16,4,1602,1510,92,7,6,1,1,100,NoArch
ee0fd06de73e0191365549fa7c4f6c71c1bbc08d,1,10,7,3,0,0,0,3,4,0,1,1,0,246,2,1,20,20,0,1607,1602,5,7,7,0,0,100,NoArch
74d8e625c51e0f469bf0e387d30c950a8d135276,0,0,0,0,0,0,0,0,0,0,0,0,0,0,0,0,0,0,0,0,0,0,0,0,0,0,100,NoArch
144ea4eedf74e2204c2482afb1baf725363a8a67,0,0,0,0,0,0,0,0,0,0,0,0,0,0,1,1,0,0,0,0,0,0,0,0,0,0,100,NoArch
a6390aefc41482ba224a4524fe216c277e4f5e79,3,15,6,9,0,0,0,4,6,66,2,2,1.409975019,1345,122,3,122,121,1,7062,6997,65,51,51,0,1,100,NoArch
b6057c5e0e60945e7731367381d190dad47f710d,1,1,1,0,0,0,0,5,6,53,1,1,0,390,3,2,51,51,0,2592,2592,0,15,15,0,1,100,NoArch
bd77dc792c723eed9958596be36c86c6d00e4065,1,65,14,51,0,0,0,4,4,70,1,1,0,129,4,3,13,7,6,748,444,304,8,4,4,0,100,NoArch
91740635b2cf02ef9e34a603dea31bd246f5b436,2,47,25,22,0,0,0,4,4,70,1,1,0.309543429,479,0,0,52,48,4,3473,3359,114,22,21,1,1,100,NoArch
04834817c89ef22cc71362702b675548e637b603,0,0,0,0,0,0,0,0,0,0,0,0,0,0,7,0,0,0,0,0,0,0,0,0,0,0,100,NoArch
71ac2c0d5e8bffdbb11f7789a7805575736049c1,1,3,2,1,0,0,0,3,3,78,1,1,0,107,1,1,10,9,1,560,539,21,2,2,0,1,100,NoArch
20871a17b2ec2b0998b80d941bac51434b0854d5,1,1,1,0,0,0,0,5,5,82,1,1,0,217,0,0,36,36,0,1248,1260,12,26,26,0,1,100,NoArch
0863b1cfd947402c66221afa8d1f18fd2bd8273b,5,8,18,10,0,0,0,5,6,66,2,2,2.192005835,2397,1,1,250,250,0,17033,17110,77,97,97,0,1,100,NoArch
1ce3d891cea49990922b8e17080aa496ec22d4f1,0,0,0,0,0,0,0,0,0,0,0,0,0,0,0,0,0,0,0,0,0,0,0,0,0,0,100,NoArch
1483b97018646f1cc8d6bbed357d7115c9079ea2,0,0,0,0,0,0,0,0,0,0,0,0,0,0,42,0,0,0,0,0,0,0,0,0,0,0,100,NoArch
5f1309407aba9c7df3a53ce5b30168cce2f20fcc,2,55,6,49,0,0,0,3,5,87,1,2,0.349184374,633,0,0,50,42,8,4836,4527,309,40,36,4,1,100,NoArch
23b303e4b17c5f7b603900ee5b0d2e6718118014,2,81,2,79,0,0,0,4,5,62,1,1,0.867629312,527,1,0,50,44,6,3532,3019,513,39,33,6,1,100,NoArch
1032fc3e549aa70a8817fd4782e971de976b682a,33,787,491,296,1,0,1,2,8,44,5,18,3.870952891,10042,123,1,1044,1012,32,63303,61498,1805,524,500,24,1,99.9272198,NoArch
0bb5999f7950d010649e082f6f056f44d92c91f9,1,7,5,2,0,0,0,7,8,59,1,1,0,685,1,0,95,95,0,4381,4344,37,36,36,0,1,100,NoArch
8ff06ddb0fdc8325382dbca4bd9dd4884b4e1110,9,167,24,143,0,0,0,3,8,28,2,7,1.977573386,4219,124,2,460,445,15,26062,24908,1154,314,308,6,1,100,NoArch
045fa87a3db5d9954d1ca88c8a2ef28c11214330,1,3,3,0,0,0,0,5,9,3,1,1,0,1070,0,0,60,60,0,7584,7587,3,30,30,0,1,100,NoArch
92c69f57038d055e680f75627426e97679196ce0,0,0,0,0,0,0,0,0,0,0,0,0,0,0,2,0,0,0,0,0,0,0,0,0,0,0,100,NoArch
f7c2f8cedc999ddfbd3e29718442a507cf526cf0,0,0,0,0,0,0,0,0,0,0,0,0,0,0,125,3,0,0,0,0,0,0,0,0,0,1,100,NoArch
22315a887f5bf277007bdfcec24bc014982a6d4b,0,0,0,0,0,0,0,0,0,0,0,0,0,0,0,0,0,0,0,0,0,0,0,0,0,0,100,NoArch
3a05edab01f72a0e7e9efb890691d938bca4d795,3,66,35,31,0,0,0,5,7,59,1,1,1.349099497,788,74,0,91,87,4,5165,4987,178,30,30,0,0,100,NoArch
f82e58994e046d92916d45f7ec921e2fb6ba26ef,2,36,15,21,0,0,0,4,8,16,2,2,0.986367607,1764,75,1,200,197,3,10529,10426,103,98,97,1,0,100,NoArch
e806eb797f4839017dfa87d2cc31a0b01570b061,2,9,0,9,0,0,0,2,3,203,1,2,0.918295834,111,0,0,9,9,0,425,360,65,6,6,0,1,100,NoArch
66492498f702e9224da838d1869e9376111939ce,0,0,0,0,0,0,0,0,0,0,0,0,0,0,1,1,0,0,0,0,0,0,0,0,0,1,100,NoArch
804e348d0e8176ceced046fa9e87963907aecc38,80,1,107,106,0,0,0,3,9,74,7,48,6.18290197,20110,2,2,1930,1930,0,122301,122301,0,1045,1045,0,1,100,NoArch
d9fbe33339cce5e5577eff5257bd9b683daed194,0,0,0,0,0,0,0,0,0,0,0,0,0,0,1,1,0,0,0,0,0,0,0,0,0,0,100,NoArch
1e14390719cc9e79cc67272a50e7e0bf95b38d87,1,4,3,1,0,0,0,4,6,3,1,1,0,312,1,1,44,44,0,1867,1867,0,9,9,0,1,100,NoArch
17eaf41c54411344916fdf4ace80163438e9bee2,0,0,0,0,0,0,0,0,0,0,0,0,0,0,2,0,0,0,0,0,0,0,0,0,0,1,100,NoArch
7bc08cbfdce337ad980bb544ec9fc3dbdf9cffff,5,7,6,1,0,0,0,3,8,122,2,5,2.257756064,721,0,0,56,56,0,4450,4423,27,26,26,0,1,100,NoArch
c3355109b1fa8f3055a2ba57d6e2b49679581db5,14,605,51,554,0,0,0,3,9,51,4,8,2.844486079,5121,2,1,614,565,49,33975,30287,3688,360,337,23,1,99.78205594,NoArch
845a0509b327c3187c036d2b9668048a25ccf423,1,11,16,5,0,0,0,3,3,137,1,1,0,266,0,0,9,9,0,1554,1589,35,5,5,0,0,100,NoArch
44823041a37601fed8163502272a8fcb7a5be45d,2,8,0,8,0,0,0,2,3,227,1,1,1,176,1,1,16,13,3,561,509,52,11,10,1,1,100,NoArch
212282c8aaf623f451e3f72674ed4d3ed550602d,0,0,0,0,0,0,0,0,0,0,0,0,0,0,3,3,0,0,0,0,0,0,0,0,0,1,100,NoArch
a7e07cd910425b5cfe9886677e780bfb2ae96c52,0,0,0,0,0,0,0,0,0,0,0,0,0,0,2,2,0,0,0,0,0,0,0,0,0,1,100,NoArch
2a4cfb47c76a0c8800d4998453ec356711807c83,2,96,10,86,0,0,0,4,5,20,1,2,0.536906438,454,2,1,41,34,7,4160,3431,729,22,19,3,1,100,NoArch
60fed21dc7e4cb66b154ae9be77dfada0f3071a5,6,96,24,72,1,0,1,5,5,103,3,3,2.241018253,526,0,0,67,52,15,3069,2759,310,26,23,3,1,99.74536195,NoArch
d6e83e8f49828940159cd34711cc88ee7b42dc1c,2,13,2,11,0,0,0,9,10,22,2,2,0.996791632,1228,0,0,189,187,2,7823,7731,92,85,84,1,1,100,NoArch
b77fad39b53049279bba1ba367f43cce73f48bfa,13,83,70,13,0,0,0,3,11,89,3,6,2.818389895,3193,4,4,371,371,0,19633,19643,10,163,163,0,1,100,NoArch
f9139c0f616775f4b3d0df95772f2621f0e7c9f1,94,779,612,167,0,0,0,4,8,69,5,23,6.043531952,14733,5,5,1269,1269,0,88092,88092,0,626,626,0,1,100,NoArch
da8d1334eecd65f2896613b1143d6ba31bae03b7,102,889,691,198,0,0,0,6,10,91,1,26,6.270131564,23646,2,1,1957,1957,0,148921,148921,0,1127,1127,0,1,100,NoArch
0b52ae3ac2685c5afa7821d663854b526b5a1cff,7,158,4,154,2,0,2,4,8,20,1,3,1.759751346,977,0,0,152,139,13,5380,4706,674,145,137,8,1,99.70866715,NoArch
024230fbd23173db38e2c0f66808606481223003,0,0,0,0,0,0,0,0,0,0,0,0,0,0,3,2,0,0,0,0,0,0,0,0,0,1,100,NoArch
b65a897856259e7872e39a9e3e68661926592d7b,1,1,1,0,0,0,0,4,4,9,1,1,0,200,3,3,18,18,0,1158,1160,2,14,14,0,1,100,NoArch
75132c139f0faf9ef68bb461b3a551238a377455,27,98,26,72,0,0,0,5,7,142,1,3,4.557413529,3675,3,1,328,328,0,26330,26330,0,129,129,0,1,100,NoArch
784e3ad0b65ce8f7e0de2e2935032fb2573d5a26,134,1023,801,222,0,0,0,3,8,96,1,26,6.553225913,25205,4,3,2589,2589,0,141638,141638,0,1589,1589,0,1,100,NoArch
ff688107fa99742cccaa0a80075f58efb017ebab,0,0,0,0,0,0,0,0,0,0,0,0,0,0,5,4,0,0,0,0,0,0,0,0,0,0,100,NoArch
89f09680976de6d677cc9739160a206ca9ae9ff3,0,0,0,0,0,0,0,0,0,0,0,0,0,0,6,5,0,0,0,0,0,0,0,0,0,0,100,NoArch
845e26165848c97798ba5dd8fc534fdfa9552552,0,0,0,0,0,0,0,0,0,0,0,0,0,0,16,0,0,0,0,0,0,0,0,0,0,0,100,NoArch
98ab33bb6e1637d18c8fab7a9ddd50daeaf56962,11,425,35,390,4,0,4,4,11,3,2,8,2.825731208,3349,17,1,254,237,17,28126,25594,2532,146,132,14,1,99.45848375,NoArch
84602c888298e70ea5e64029c14e862172d32f99,149,637,380,257,0,0,0,4,9,47,1,28,6.478295197,23720,4,0,2251,2251,0,127544,127544,0,1374,1374,0,1,100,NoArch
b2d9638bea43f6b0a9c3412362dc4cb08e214957,21,149,109,40,0,0,0,5,8,0,1,3,3.953299133,3408,4,2,304,304,0,25374,25374,0,111,111,0,1,100,NoArch
b3e0ebbc4ae61b7e21d63f5e6548b86547f6bf06,36,168,168,0,0,0,0,5,10,0,6,19,4.827392903,11625,7,5,1034,1034,0,74035,74033,2,559,559,0,0,100,NoArch
c06d89b648bbdaaad9c68fb9d3c6d53b4d68541c,9,59,48,11,0,0,0,10,12,24,3,7,2.094544634,2437,8,6,199,199,0,15867,15867,0,100,100,0,1,100,NoArch
2745b7552f2f2ee7a61d3ea49139ef2af3ffe13f,136,432,430,2,0,0,0,3,13,22,7,47,6.21087658,31207,9,7,2693,2693,0,189917,189917,0,1391,1391,0,1,100,NoArch
63e330b17cdd4ce367484120d6ec82262fe540d0,0,0,0,0,0,0,0,0,0,0,0,0,0,0,10,8,0,0,0,0,0,0,0,0,0,0,100,NoArch
e555aa516de867a4faf0322e79defa1f52d887ef,5,33,6,27,0,0,0,7,8,30,4,4,2.251561835,416,5,0,51,42,9,2234,2000,234,16,15,1,1,100,NoArch
70a1040998deb4585f6622e23f887dba21556cbd,1,15,11,4,0,0,0,3,3,27,1,1,0,65,11,9,4,4,0,223,199,24,4,4,0,0,100,NoArch
d447e2d7518fc6ee87f1620542e45f1454a5ba0f,100,514,493,21,0,0,0,4,14,0,8,36,5.990927393,28856,12,10,2737,2737,0,180897,180688,209,1287,1287,0,0,100,NoArch
8df4b83017f74173b8289ab50b0f723a38e8eebe,2,14,7,7,0,0,0,7,15,6,1,2,0.702466551,1138,0,0,179,179,0,7315,7239,76,53,53,0,1,100,NoArch
24a09c775f6d4b855e2096001f5e034da80158a8,2,15,6,9,0,0,0,6,8,9,1,2,0.863120569,231,13,11,21,21,0,1509,1464,45,11,11,0,1,100,NoArch
3790b75e059a06e6f5467c8b8d549ef38cd6b98a,1,34,55,21,0,0,0,5,7,14,1,1,0,572,3,0,34,35,1,3962,4208,246,20,21,1,1,100,NoArch
ba514cfea0fbb3a71a93fc7b5d5fe06dc1fdfffd,46,106,107,1,0,0,0,4,16,0,8,23,4.941003726,13790,14,12,1504,1504,0,81383,81631,248,815,815,0,0,100,NoArch
a405d3873b176a410abc5ef5239066f94214454c,0,0,0,0,0,0,0,0,0,0,0,0,0,0,15,12,0,0,0,0,0,0,0,0,0,0,100,NoArch
f324057b6e27075833673b09b5c92d9c53ed2b58,1,3,2,1,0,0,0,5,5,10,1,1,0,63,16,13,8,8,0,297,301,4,3,3,0,0,100,NoArch
8963a68e6a3f4875de6787dfc206543e9ca824d9,2,72,2,70,1,0,1,7,9,5,1,2,0.405977038,89,4,1,13,6,7,894,470,424,5,2,3,1,99.92841804,NoArch
9a1f698eef1044443adadbf7a1bf7b5eb94fb84e,45,1098,403,695,3,0,3,3,15,4,4,25,4.680637258,17957,126,0,1624,1556,68,127795,123263,4532,871,844,27,1,99.35622318,NoArch
7498ca71cb8cfc95c2bd987030f23b75be23b84d,0,0,0,0,0,0,0,0,0,0,0,0,0,0,17,10,0,0,0,0,0,0,0,0,0,0,100,NoArch
14881e99e0aff5ffd72ed26d2beddef23d7a77c7,22,1062,102,960,9,1,10,5,12,11,3,12,3.721632362,3338,3,0,469,362,107,25722,21885,3837,289,248,41,1,98.65343728,NoArch
36b3b6f5dd913d3f1c9aa116aff8daf6540fed65,0,0,0,0,0,0,0,0,0,0,0,0,0,0,1,0,0,0,0,0,0,0,0,0,0,1,100,NoArch
b284091783af44341f20af11825ea9b6e3ba23da,0,0,0,0,0,0,0,0,0,0,0,0,0,0,18,7,0,0,0,0,0,0,0,0,0,1,100,NoArch
313fab5fd1ef715f98a123d0e09f6010daacab68,0,0,0,0,0,0,0,0,0,0,0,0,0,0,19,7,0,0,0,0,0,0,0,0,0,1,100,NoArch
350b0ecb4d137411c6231a1568add585c6d7b7d5,12,266,74,192,3,1,4,6,8,37,3,9,2.81434169,1128,43,0,108,95,13,7858,7052,806,66,57,9,1,99.68443198,NoArch
8172197c353ff6cda491120c41b2d14b412ad709,1,1,1,0,0,0,0,6,13,24,1,1,0,781,1,0,91,91,0,4943,4941,2,44,44,0,0,100,NoArch
4b1b3fc28cc68c61e2042029a80211dcbe0fcfb4,0,0,0,0,0,0,0,0,0,0,0,0,0,0,20,7,0,0,0,0,0,0,0,0,0,0,100,NoArch
41f36770e09b41aee8f5c8789f2b5f8bf151fb3c,1,1,1,0,0,0,0,5,8,39,1,1,0,305,0,0,26,26,0,1666,1666,0,26,26,0,0,100,NoArch
dd06660183d49211408fa2851c06f1a4d8946749,1,1,1,0,0,0,0,6,8,44,1,1,0,471,0,0,50,50,0,2359,2359,0,22,22,0,0,100,NoArch
94aec965f533fdf724ca433233e67ce2374e26df,2,2,2,0,0,0,0,2,15,23,2,2,1,1543,0,0,172,172,0,9311,9311,0,65,65,0,0,100,NoArch
9c4217a3e1b9b728690282c914db2067117f4cfb,14,278,150,128,0,0,0,8,13,71,1,5,2.798765222,3390,4,1,259,251,8,21044,19986,1058,158,153,5,1,100,NoArch
8affdf8bcbb4c7b236283e97c3afad186d5b6a3e,14,224,317,93,0,0,0,8,13,41,2,3,2.402016697,3104,5,1,270,294,24,22938,23429,491,100,119,19,1,100,NoArch
3c811ec29be12b3084c0ff4b77774d9ea527bcea,2,2,2,0,0,0,0,9,16,31,2,2,1,1612,1,1,176,176,0,9570,9570,0,71,71,0,0,100,NoArch
def18a5086cac23266dec4e285cc7850ef8ac011,5,8,10,2,0,0,0,5,8,53,1,2,1.879964949,759,0,0,59,60,1,4729,4759,30,44,44,0,0,100,NoArch
842eabb27fc7b4295a6ad8a44fb21ba0394c7aa8,2,2,2,0,0,0,0,6,8,2,1,1,1,342,21,5,27,27,0,2574,2578,4,4,4,0,1,100,NoArch
f20a130e3ac3cf5434bf58cc6b0b64cd4d9a6931,1,1,1,0,0,0,0,7,11,44,1,1,0,588,0,0,54,54,0,2878,2878,0,27,27,0,0,100,NoArch
bb90dedfc84dc3a1aa7c3eb2e64320346f5e192c,2,6,4,2,0,0,0,6,10,2,2,2,0.721928095,828,22,6,76,75,1,4843,4834,9,29,29,0,0,100,NoArch
36c0e6bae142d18dd0c4ede9c04dc20005380562,1,1,1,0,0,0,0,6,9,0,1,1,0,242,23,7,22,22,0,1965,1965,0,2,2,0,0,100,NoArch
74b00d1f954b5146611f26e55c567861898b084f,0,0,0,0,0,0,0,0,0,0,0,0,0,0,24,8,0,0,0,0,0,0,0,0,0,0,100,NoArch
01c25d6afff703156c31c4f4c12138113dca494a,3,7,9,2,0,0,0,7,11,93,3,3,1.405639062,866,2,2,75,76,1,4853,4862,9,29,29,0,0,100,NoArch
58c5bed40a76189a28dd72bbd67fcefaac587184,1,7,0,7,0,0,0,3,7,41,1,1,0,349,22,5,44,42,2,2517,2485,32,12,12,0,1,100,NoArch
179837e8ef1d624c8805c4af8896589193481ad0,1,1,1,0,0,0,0,3,8,0,1,1,0,356,23,6,44,44,0,2517,2517,0,12,12,0,0,100,NoArch
2f254163d49a89c4a2d89ad1aac8f2217d159edf,1,6,10,4,0,0,0,3,9,0,1,1,0,356,24,7,44,44,0,2515,2517,2,12,12,0,0,100,NoArch
84404829777dafb68b8b9903015016a1549d54a4,2,6,9,3,0,0,0,8,14,6,2,2,0.836640742,898,25,8,113,115,2,5601,5635,34,56,56,0,0,100,NoArch
e4ea7a2971ce20d89a46556e19f2ad22014d9123,1,1,1,0,0,0,0,8,15,0,1,1,0,546,26,9,71,71,0,3116,3116,0,44,44,0,0,100,NoArch
2a823f32ee161d3e366979f2060cb93536e8059d,1,1,1,0,0,0,0,6,7,61,1,1,0,144,1,1,5,5,0,954,954,0,2,2,0,0,100,NoArch
ab6ae5cebb43ffffa9ea47feeda36e955bc6b470,23,42,0,42,0,0,0,7,17,51,5,16,4.189238256,8778,27,10,981,981,0,47416,47332,84,478,478,0,1,100,NoArch
e637d9ed26fea1a336f2fd6139cde0dd192c429d,25,237,245,8,0,0,0,4,18,32,1,7,4.314388959,7761,0,0,832,832,0,46493,46720,227,352,352,0,1,100,NoArch
619f5010549220c98cb6849ebcfb3592a811c679,45,258,292,34,0,0,0,6,16,19,5,22,4.73008015,13568,25,7,1462,1461,1,76413,76261,152,673,673,0,0,100,NoArch
add4b1e3296262801255a1098eeaeaefe200cfeb,44,286,252,34,0,0,0,7,18,41,5,21,4.680673028,13294,0,0,1440,1440,0,74305,74452,147,671,671,0,0,100,NoArch
47c1f746e2ddd061064af6026de9125c65bf114a,0,0,0,0,0,0,0,0,0,0,0,0,0,0,1,1,0,0,0,0,0,0,0,0,0,1,100,NoArch
98c0d8cf6069bdda32cc1ef7d33541206e3ef8e9,0,0,0,0,0,0,0,0,0,0,0,0,0,0,2,2,0,0,0,0,0,0,0,0,0,1,100,NoArch
dde21e7315739c108567307813f4b816dd9f1920,62,320,619,299,0,0,0,5,16,30,7,27,4.930227055,19803,4,0,1237,1270,33,143143,145739,2596,700,712,12,1,99.82499125,NoArch
e1e5fe33249bf511486073dd9cf48e5b7ea14816,1,1,1,0,0,0,0,4,6,67,1,1,0,184,32,14,12,12,0,1297,1297,0,2,2,0,0,100,NoArch
ff1113f3b730a68dd0a1a7bd219ad20e5166f8ca,1,1,1,0,0,0,0,2,2,62,1,1,0,68,0,0,7,7,0,391,391,0,3,3,0,1,100,NoArch
290278fc6cd90c6dad09618275d2016c295c0b0d,6,138,25,113,0,0,0,8,13,49,2,2,1.951117297,1311,5,1,141,125,16,11377,10337,1040,49,46,3,1,95.81190301,Arch
a733f4ef723865738d8541282c0c7234d64668db,17,142,176,34,0,0,0,8,14,18,1,3,3.621991288,3188,1,1,267,268,1,24411,24774,363,80,79,1,0,100,NoArch
726ae47ce250309710f88e17d1ee89d6fff9b386,28,152,199,47,0,0,0,4,19,30,1,10,4.29511265,9864,2,2,1006,1005,1,59651,59936,285,550,549,1,0,100,NoArch
7031445eb3cae5a4557786c7eb080944320609aa,8,133,66,67,0,0,0,5,12,49,3,5,2.526913493,2205,5,1,217,205,12,14422,13886,536,108,105,3,1,100,NoArch
28ccf8c5216eaedf16b16b0220f03311fcba6787,2,28,1,27,1,0,1,1,8,36,1,2,0.362051252,347,33,14,46,43,3,2309,2212,97,18,16,2,1,99.84550019,NoArch
b9fab0b933315d88e059a07a0dcf2397d5b69d14,25,245,237,8,0,0,0,5,20,0,1,7,4.314388959,7727,1,1,832,832,0,46539,46312,227,352,352,0,1,100,NoArch
2d5b79d96fa23571da5003fd4460d2d6d3998275,0,0,0,0,0,0,0,0,0,0,0,0,0,0,6,1,0,0,0,0,0,0,0,0,0,1,100,NoArch
8f935e779a7d9dd082d305b2c21fdf273c2ba338,6,23,26,3,0,0,0,8,13,53,2,3,1.877255501,1094,6,2,122,121,1,6099,6077,22,33,34,1,1,100,NoArch
c78092d2d3660aadb270fc514a46f831e47c1340,0,0,0,0,0,0,0,0,0,0,0,0,0,0,0,0,0,0,0,0,0,0,0,0,0,1,100,NoArch
75c3f630d4dadda24a95f5d65031e462561d47f1,2,0,4,4,0,0,0,6,12,3,2,2,0.811278124,860,34,14,69,69,0,6126,6165,39,47,47,0,1,100,NoArch
b5df6723a21e39fd7676921edb758afc7200c0c7,0,0,0,0,0,0,0,0,0,0,0,0,0,0,0,0,0,0,0,0,0,0,0,0,0,1,100,NoArch
8306f749a2bd3e8f2fff5034cdb6fd3773a881f8,2,451,336,115,1,0,1,11,21,0,1,1,0.996474063,1431,127,0,164,158,6,9224,8637,587,66,60,6,1,99.9229584,NoArch
9706f659dba8f2abd501464a96254c052d100c72,69,287,287,0,0,0,0,7,22,28,8,33,4.709697943,19629,44,0,1746,1746,0,126102,126102,0,860,860,0,1,99.53846154,NoArch
9884972a3a1d1158b657e2f012a886b319f99002,0,0,0,0,0,0,0,0,0,0,0,0,0,0,35,14,0,0,0,0,0,0,0,0,0,0,100,NoArch
aba83876e7c20e8c2402c74c2465ef3ebc93ef85,1,16,28,12,0,0,0,6,11,6,1,1,0,529,6,0,58,61,3,3080,3141,61,25,25,0,0,100,NoArch
480fc7869d4d69e1219bf278fd9a37f27ac260f6,0,0,0,0,0,0,0,0,0,0,0,0,0,0,0,0,0,0,0,0,0,0,0,0,0,1,100,NoArch
d09eacdc13b9f19f69a317c8d08bda69a43678bc,5,590,111,479,2,0,2,1,7,89,1,2,1.992518575,516,8,0,90,46,44,5879,3086,2793,38,19,19,1,95.11363636,Arch
5af3dc6aedcfc8d7d4cd5da21300d9cfb92c16ba,1,63,17,46,0,0,0,13,23,4,1,1,0,1125,7,1,115,115,0,6550,6561,11,49,49,0,1,100,NoArch
3c90d252cc464fbd4ec3554fc930e41a0fcaa29f,10,125,36,89,0,0,0,8,15,12,4,7,2.253182116,3158,2,0,321,307,14,18025,17223,802,180,175,5,1,99.62783774,NoArch
04afac977d4bd615c217349083b5f86cfa8060c4,1,4,5,1,0,0,0,7,9,9,1,1,0,245,18,0,21,21,0,2209,2205,4,7,7,0,1,100,NoArch
b95367d82a4e0c31a526cf8b292388355847e274,1,2,1,1,0,0,0,5,7,90,1,1,0,347,1,0,86,87,1,1861,1872,11,35,35,0,1,100,NoArch
e1031650833e3d359e00473884ceac272eac3afa,2,5,4,1,0,0,0,6,8,56,1,2,0.99107606,590,36,11,114,114,0,3449,3439,10,50,50,0,0,100,NoArch
017ee8e66193fd7056c08ec1f36a1d9d6ee58969,4,4,4,0,0,0,0,11,18,19,3,4,2,3108,37,12,233,233,0,22997,22997,0,104,104,0,0,100,NoArch
d9675c4ec0be3f342c30e17a4779c8319b207681,15,15,15,0,0,0,0,4,15,20,5,7,3.906890596,3423,38,13,284,284,0,21089,21059,30,117,117,0,1,100,NoArch
ad50008a5946f15ee4ba4dd69ac514f11fed2034,3,4,1,3,0,0,0,8,11,17,3,3,1.521928095,1016,2,0,131,130,1,6599,6565,34,43,43,0,2,100,NoArch
971c7d41bd912b0e00ae8606adbe36548e2c49b3,1,11,2,9,0,0,0,11,16,8,1,1,0,521,0,0,57,55,2,3095,3038,57,11,11,0,1,100,NoArch
a44c61b81356e93340710ccc0022e576b7b6e077,3,96,2,94,1,0,1,1,11,18,2,3,0.745505552,297,0,0,37,33,4,2520,2026,494,20,16,4,1,99.74054855,NoArch
c1f8acab344fa632f1cce6268d2fc765c45e8b22,1,5,0,5,0,0,0,8,12,21,1,1,0,319,0,0,29,29,0,2152,2094,58,13,13,0,1,100,NoArch
fd8f1c70c07dec3e6670d460fcd887f9d5842b6d,2,4,2,2,0,0,0,8,14,24,2,2,1,944,39,8,57,57,0,7841,7825,16,46,46,0,0,100,NoArch
2bb0c21a3dd29687e49d362ed34f050380ff47ae,4,17,8,9,0,0,0,7,11,19,2,2,1.759627536,1077,3,0,85,85,0,6674,6620,54,45,45,0,0,100,NoArch
9b2944a9a261eb41bd841f080b5d9aeeec18589c,1,8,8,0,0,0,0,3,3,125,1,1,0,97,40,8,21,21,0,442,442,0,14,14,0,0,100,NoArch
87fdb769f0020414f500805838fbe5cb99159515,1,16,0,16,0,0,0,7,7,16,1,1,0,201,6,1,20,18,2,1227,1159,68,15,14,1,0,100,NoArch
2b2f23aa60bde21ab6ef2404ece1cbfa6ab1324c,1,18,11,7,0,0,0,7,8,0,1,1,0,217,7,2,20,20,0,1324,1227,97,16,15,1,0,100,NoArch
2248fd9aea4d28f9c264d4bd6a4ead63c706b9b7,1,1,1,0,0,0,0,7,9,0,1,1,0,224,8,3,20,20,0,1324,1324,0,16,16,0,0,100,NoArch
7aa3ce31e6a662af2da4584b881043061a216d2e,1,4,1,3,0,0,0,8,13,6,1,1,0,324,41,8,29,29,0,2157,2152,5,13,13,0,0,100,NoArch
dd09abb56d9e4074f5c2558fcfd001a33570e98c,6,454,22,432,1,0,1,3,14,56,2,4,0.808268313,1058,0,0,170,121,49,6746,5314,1432,103,76,27,1,99.85212569,NoArch
1daba24065959dcab3606836bd1d789b3d74cc15,10,92,11,81,1,0,1,9,17,2,2,6,1.669182454,2103,0,0,194,187,7,13585,13167,418,77,75,2,0,99.33579336,NoArch
b39458b008250f1a5bfe4316ce96fc3ec3cc7cfa,9,38,37,1,0,0,0,6,15,48,2,7,2.13296087,3082,1,1,210,210,0,21264,21258,6,106,106,0,0,100,NoArch
8a3a50309b425d70df1b5753e06aa2b9ac2a004a,1,10,0,10,0,0,0,2,2,2,1,1,0,411,42,9,44,44,0,1293,1273,20,25,25,0,0,100,NoArch
c2c0f6b13d5b72b3098ed1b343b0a89679f854b3,77,855,822,33,1,1,2,2,24,23,9,32,5.347266381,26005,45,1,2207,2208,1,169348,169380,32,1082,1091,9,1,97.35595896,Arch
baa6b5e8899eb976b8b8cce92b1ba2cefaee8501,1,38,0,38,0,0,0,8,11,28,1,1,0,102,46,2,8,6,2,958,618,340,3,2,1,1,100,NoArch
0a07752dc03c51e16d7bb4239523b0181d819708,0,0,0,0,0,0,0,0,0,0,0,0,0,0,0,0,0,0,0,0,0,0,0,0,0,1,100,NoArch
923e2b4a1ef0645596eabcd41832cdf8acba4b9a,7,58,28,30,0,0,0,5,25,28,3,5,1.896106421,3183,128,1,314,313,1,21213,20939,274,144,143,1,1,100,NoArch
292c1e2ff436a711cbbb53ad9b1f6232121d53ec,4,71,101,30,0,0,0,6,10,116,1,3,1.35343364,684,1,0,47,51,4,4760,5033,273,25,28,3,1,99.61636829,NoArch
5471d8f0c2ed43435622069bee8b68a8ba5141f4,1,5,0,5,0,0,0,2,2,98,1,1,0,79,19,1,10,9,1,267,250,17,7,6,1,0,100,NoArch
3f4966ddeaef02ee95a5e873387dad0c81c14fb6,0,0,0,0,0,0,0,0,0,0,0,0,0,0,3,0,0,0,0,0,0,0,0,0,0,0,100,NoArch
d0ee95ed16de6c3568f575169cb993b9c10ced3d,3,99,5,94,0,0,0,10,19,16,1,2,1.108597735,1332,2,2,128,115,13,9670,9093,577,60,52,8,1,100,NoArch
9489d0fb844208443a18964be878102e9560bd0d,4,286,194,92,3,1,4,1,7,19,1,1,1.768102657,194,3,3,12,6,6,1396,1608,212,12,6,6,1,99.27412468,NoArch
7087e7d7668e39e5c0ce98c965750d228481748f,0,0,0,0,0,0,0,0,0,0,0,0,0,0,20,2,0,0,0,0,0,0,0,0,0,1,100,NoArch
ba54a7e9731a8371a8a85e04570d2c951a74ce53,7,28,8,20,0,0,0,5,16,26,2,5,2.53567257,3256,129,2,335,332,3,19244,18990,254,248,248,0,1,100,NoArch
94ed9b9122b664d16b633cc36bfd161fa0d117c5,0,0,0,0,0,0,0,0,0,0,0,0,0,0,21,3,0,0,0,0,0,0,0,0,0,0,100,NoArch
bb58be1c56c6a98ae443557251fa0d023553f6d3,0,0,0,0,0,0,0,0,0,0,0,0,0,0,130,3,0,0,0,0,0,0,0,0,0,0,100,NoArch
76d956165d299b4d107f028d5686a6d49fb7db7a,0,0,0,0,0,0,0,0,0,0,0,0,0,0,131,3,0,0,0,0,0,0,0,0,0,0,100,NoArch
9129edb595b2bf7879903680609797ffde5d6cd9,0,0,0,0,0,0,0,0,0,0,0,0,0,0,132,4,0,0,0,0,0,0,0,0,0,0,100,NoArch
78eb53df30f09ca25664d71a13f776211b05a17b,1,18,0,18,0,0,0,2,2,51,1,1,0,27,22,4,3,3,0,97,97,0,2,2,0,0,100,NoArch
7ba012981ed95cceec25d3cd2a15e4f6d3283196,0,0,0,0,0,0,0,0,0,0,0,0,0,0,23,5,0,0,0,0,0,0,0,0,0,0,100,NoArch
78ca2fd62f0afd5e2ccce853df98d28eb6396ea5,0,0,0,0,0,0,0,0,0,0,0,0,0,0,24,5,0,0,0,0,0,0,0,0,0,0,100,NoArch
6e59c1c77798e53f74f581856a3609239f50a877,0,0,0,0,0,0,0,0,0,0,0,0,0,0,21,3,0,0,0,0,0,0,0,0,0,0,100,NoArch
924bf514e27f126c5fa9a8beca5f3011f4d646ac,0,0,0,0,0,0,0,0,0,0,0,0,0,0,130,3,0,0,0,0,0,0,0,0,0,0,100,NoArch
b6e2993ceb03d7bf17a08ef3c6698df5b21954a7,1,9,1,8,0,0,0,8,16,2,1,1,0,533,3,0,74,74,0,2459,2459,0,43,43,0,0,100,NoArch
a54535ed5a0247854660ace3a022db4891c6966d,0,0,0,0,0,0,0,0,0,0,0,0,0,0,43,8,0,0,0,0,0,0,0,0,0,0,100,NoArch
76d956165d299b4d107f028d5686a6d49fb7db7a,1,1,9,8,0,0,0,7,15,9,1,1,0,541,131,3,74,74,0,2459,2459,0,43,43,0,0,100,NoArch
a46fea9ff46342f6bba7c1c26e8c2354b1307a1f,1,9,1,8,0,0,0,8,16,2,1,1,0,533,131,3,74,74,0,2459,2459,0,43,43,0,0,100,NoArch
8e3d81cff118f81a29e286053ba48a1a33eb658c,0,0,0,0,0,0,0,0,0,0,0,0,0,0,132,4,0,0,0,0,0,0,0,0,0,0,100,NoArch
78eb53df30f09ca25664d71a13f776211b05a17b,2,19,9,10,0,0,0,2,15,29,2,2,0.940285959,568,22,4,77,77,0,2556,2556,0,45,45,0,0,100,NoArch
ed54eb20a5c9c82c348bc39387ef73f835ad6821,1,9,1,8,0,0,0,8,16,2,1,1,0,533,22,4,74,74,0,2459,2459,0,43,43,0,0,100,NoArch
7ba012981ed95cceec25d3cd2a15e4f6d3283196,1,1,9,8,0,0,0,7,15,9,1,1,0,541,23,5,74,74,0,2459,2459,0,43,43,0,0,100,NoArch
fc8d4a71add3b27e7b3b07a1c513bdc223c640a0,1,9,1,8,0,0,0,8,16,2,1,1,0,533,23,5,74,74,0,2459,2459,0,43,43,0,0,100,NoArch
1e79cbc259b92f75e5fd387c0271b163532aebb9,0,0,0,0,0,0,0,0,0,0,0,0,0,0,9,0,0,0,0,0,0,0,0,0,0,1,100,NoArch
cdb028f1f3493123310acd6fce59fd251a4fddd9,0,0,0,0,0,0,0,0,0,0,0,0,0,0,44,7,0,0,0,0,0,0,0,0,0,0,100,NoArch
56a4e0d56c226781d3dd1beb42af1efa77199ccd,0,0,0,0,0,0,0,0,0,0,0,0,0,0,45,6,0,0,0,0,0,0,0,0,0,0,100,NoArch
362a9b9aab9a3f8bed0ac3a8c9e0ac5c2f487f32,0,0,0,0,0,0,0,0,0,0,0,0,0,0,0,0,0,0,0,0,0,0,0,0,0,0,100,NoArch
c06ec8bfc78fa9fed966c3d5bbb0ebc65e8771de,3,21,24,3,0,0,0,7,11,113,2,2,0.521639048,813,46,4,56,56,0,5530,5544,14,34,34,0,0,100,NoArch
6f34be1b8dd55304317c40565dad23c09ddda5bf,2,134,1,133,0,0,0,6,8,87,1,2,0.894451885,1562,1,0,77,68,9,13200,12586,614,48,43,5,1,100,NoArch
652224edc882c083ac46cff095324975e2457004,1,5,2,3,0,0,0,2,2,41,1,1,0,106,24,5,15,15,0,597,548,49,4,4,0,1,100,NoArch
78ca2fd62f0afd5e2ccce853df98d28eb6396ea5,7,28,169,141,0,0,0,1,15,60,4,6,1.981699034,3155,24,5,213,222,9,21137,21786,649,124,129,5,0,100,NoArch
f27c7a16c6d437efaa83e50a7117b83e5201ac49,8,286,28,258,1,0,1,2,16,57,4,6,2.182838382,3014,1,1,232,213,19,22391,21137,1254,137,124,13,1,99.87234043,NoArch
5b7bb142dc6712c41fd8ada208ab3186369431f9,65,423,550,127,0,0,0,2,26,54,8,28,4.829938738,20907,4,0,2128,2149,21,129770,130697,927,1087,1088,1,1,99.31972789,NoArch
00262340115986676fef8bbda0b8f08000c06442,0,0,0,0,0,0,0,0,0,0,0,0,0,0,5,1,0,0,0,0,0,0,0,0,0,0,100,NoArch
fcf9e4aded13a1a6306d6cbbc26d7f71ecbf08a9,0,0,0,0,0,0,0,0,0,0,0,0,0,0,6,2,0,0,0,0,0,0,0,0,0,0,100,NoArch
d07ac588ac30e80f59522d51e939cc125edcff52,3,68,22,46,0,0,0,6,17,65,1,1,1.166331814,1299,0,0,86,84,2,8302,7864,438,59,58,1,0,100,NoArch
347e297ac19ed55172e84e13075e19ce060954c6,1,27,25,2,0,0,0,7,11,52,1,1,0,233,2,0,25,25,0,1403,1397,6,9,9,0,1,100,NoArch
594da28fbf64fb20432e718a409577fd10516c4a,24,169,221,52,0,0,0,8,20,56,6,23,4.065439713,10824,7,3,920,925,5,74811,75177,366,424,424,0,1,100,NoArch
4de0fcfcb54ac76ed3b6852917588c32fec9bea8,2,279,1,278,0,0,0,6,9,65,1,2,0.108023195,517,2,1,57,34,23,5191,2812,2379,38,32,6,1,100,NoArch
425e3e6c78b9be00fc3fecfc335c94e05a1c70e5,0,0,0,0,0,0,0,0,0,0,0,0,0,0,47,3,0,0,0,0,0,0,0,0,0,1,100,NoArch
46842f4e92202bca9a3a4f972f481c93ccc29a3c,8,23,39,16,0,0,0,5,21,31,4,7,1.966291439,2558,48,4,320,320,0,14678,14724,46,143,143,0,0,100,NoArch
c1516df8ac55757ebd07d8aa459a0ceedeccab7b,4,131,3,128,0,0,0,11,15,56,1,3,1.368769412,1417,1,0,180,172,8,8900,8153,747,165,162,3,1,99.31536157,NoArch
462fd025563b0ae8a4d4f28d366a9bbfca070d3f,8,385,201,184,0,0,0,8,20,52,3,6,2.520160112,2426,1,1,267,239,28,15101,14241,860,192,178,14,1,99.95693368,NoArch
1fb0b001a38ddc940995e45f5cd53701d0110c3b,2,100,7,93,0,0,0,7,9,7,1,2,0.383464132,803,2,1,113,108,5,6006,5169,837,67,64,3,1,100,NoArch
d26dc0b229043afa5aefca239e72f40d80446917,0,0,0,0,0,0,0,0,0,0,0,0,0,0,3,2,0,0,0,0,0,0,0,0,0,1,100,NoArch
5fdf5a192706d8c8a0432297cca1e6e097de0e58,1,0,38,38,0,1,1,5,5,197,1,1,0,38,4,0,0,1,1,0,106,106,0,1,1,1,99.9137931,NoArch
578efa2a0778f1d747c24e7ee3ca321acaab8024,0,0,0,0,0,0,0,0,0,0,0,0,0,0,0,0,0,0,0,0,0,0,0,0,0,1,100,NoArch
e5a69ed6af18a3af131323b2297aae6c052ebc72,0,0,0,0,0,0,0,0,0,0,0,0,0,0,49,3,0,0,0,0,0,0,0,0,0,1,100,NoArch
d2c872ede47bf532193b208a8924932c7e1f7741,1,5,5,0,0,0,0,5,7,192,1,1,0,56,50,4,3,2,1,184,181,3,2,2,0,1,100,NoArch
63b42166b1af49671110283a3982de990abcf687,1,63,3,60,0,0,0,8,11,21,1,1,0,311,2,2,32,26,6,3186,2638,548,11,10,1,0,100,NoArch
01c868ab86e33161b03d422c03af41f01947ea06,1,1,1,0,0,0,0,9,12,2,1,1,0,371,51,4,32,32,0,3186,3186,0,11,11,0,1,100,NoArch
175de0db7b5687e5f8602ccaf97dadd7758287e0,1,1,1,0,0,0,0,5,7,191,1,1,0,152,5,1,15,15,0,480,480,0,7,7,0,0,100,NoArch
dfbee673ef63c7305e131d5dfa17b304b128917f,5,283,4,279,2,0,2,9,18,39,1,3,1.831998556,1240,1,0,135,113,22,10315,8732,1583,87,77,10,1,99.78476108,NoArch
20ed2516d38b9ce4b3e185bd89b62264b8bd3f25,3,216,67,149,0,0,0,3,17,101,1,2,0.669766555,911,3,3,91,79,12,8766,7762,1004,32,24,8,1,94.80349345,Arch
aaa6cf9a989e88d3273cc0a9fffc1eaa8a6e6b92,2,5,5,0,0,0,0,10,27,36,2,2,0.721928095,1752,0,0,169,169,0,9396,9396,0,76,76,0,0,100,NoArch
24e73816b2b50af518576907379bf9202d6b8dd2,18,148,170,22,0,0,0,4,22,74,4,15,3.507310071,8635,8,4,685,686,1,65174,65257,83,354,354,0,0,100,NoArch
b8f9d0ec4548a2487914c4cc982fc5e1f4e0c88c,2,91,0,91,1,0,1,1,6,112,1,2,0.877223623,70,9,2,19,8,11,535,189,346,13,5,8,1,99.82261641,NoArch
00493235f5f2b14709199dd6ef02bad9c0d3bab9,1,13,59,46,0,0,0,7,13,97,1,1,0,398,9,0,28,30,2,2139,2350,211,15,17,2,1,100,NoArch
8c6138cb01997e0ef35c396b2048cf956b53d28f,1,28,8,20,0,0,0,7,12,49,1,1,0,94,6,2,8,8,0,511,502,9,3,3,0,0,100,NoArch
c2b08cdfc9b762801a63fee988f1c24cc17df4ce,1,1,1,0,0,0,0,11,13,101,1,1,0,126,0,0,14,14,0,654,654,0,2,2,0,1,100,NoArch
f9d2f66dc16540e3e5c1cb1f7f23b4fca7c656c3,17,3,46,43,0,0,0,8,28,76,3,10,4.020037079,5949,10,2,645,645,0,31278,31507,229,284,284,0,1,100,NoArch
185ff646ad6979722a3f1c4b34d87c7f98bd87e4,1,6,6,0,0,0,0,6,9,122,1,1,0,348,76,0,86,86,0,1858,1858,0,35,35,0,0,100,NoArch
078d4825d909b2c469398f31c97d2290687321a8,31,130,141,11,0,0,0,10,16,88,5,22,4.497298215,9467,11,3,957,956,1,63178,63310,132,488,487,1,2,100,NoArch
4e7fcde4a6c69a070987fb97d978564f105ce547,0,0,0,0,0,0,0,0,0,0,0,0,0,0,2,0,0,0,0,0,0,0,0,0,0,1,100,NoArch
83c8ad5a38e1b561d501d0dcbcbd39fb02638054,1,3,42,39,0,0,0,5,7,68,1,1,0,170,52,3,7,12,5,384,590,206,6,8,2,1,100,NoArch
11fb2c26145f672d36a3491366c05caf3a23fde8,0,0,0,0,0,0,0,0,0,0,0,0,0,0,53,4,0,0,0,0,0,0,0,0,0,1,100,NoArch
323fffad0dccf0ca5cb4e533e7fbcd2a2bcfaf3b,0,0,0,0,0,0,0,0,0,0,0,0,0,0,54,3,0,0,0,0,0,0,0,0,0,1,100,NoArch
b7f35be452078f2941fb98a310b385c3afd971fc,2,635,29,606,1,0,1,1,8,60,1,2,0.316345088,452,0,0,73,51,22,7393,3367,4026,55,29,26,1,99.91150442,NoArch
cacd9a33222d28c905891362312545230b6d30b9,0,0,0,0,0,0,0,0,0,0,0,0,0,0,55,4,0,0,0,0,0,0,0,0,0,1,100,NoArch
71170fafe77e11ea1a458a38e3395a471d94a047,88,288,300,12,0,2,2,5,21,27,5,32,5.501260829,24975,47,0,2079,2075,4,160533,160145,388,1088,1085,3,1,87.29478944,Arch
acf359c834bc1d9b9c4ea64d362ea20c7410c70a,0,0,0,0,0,0,0,0,0,0,0,0,0,0,1,1,0,0,0,0,0,0,0,0,0,1,100,NoArch
0cde27e63c2cf9b70f24f0ae6b63fad9259b28d3,0,0,0,0,0,0,0,0,0,0,0,0,0,0,25,0,0,0,0,0,0,0,0,0,0,1,100,NoArch
9160084bb147552d670235d27ecb198239ee32e5,0,0,0,0,0,0,0,0,0,0,0,0,0,0,5,0,0,0,0,0,0,0,0,0,0,0,100,NoArch
afaf4bac31dd2081d1080fd3d969d1fadc800da7,0,0,0,0,0,0,0,0,0,0,0,0,0,0,6,0,0,0,0,0,0,0,0,0,0,0,100,NoArch
e9f114f3dd8673b8b66b024e62cc1e3e808e7ea9,0,0,0,0,0,0,0,0,0,0,0,0,0,0,12,0,0,0,0,0,0,0,0,0,0,1,100,NoArch
3639241d24178292223996fd591a7d0c6e27a528,0,0,0,0,0,0,0,0,0,0,0,0,0,0,6,1,0,0,0,0,0,0,0,0,0,1,100,NoArch
a355c7611c55151e6cfd5942c9eb067b622ae57b,0,0,0,0,0,0,0,0,0,0,0,0,0,0,48,1,0,0,0,0,0,0,0,0,0,1,100,NoArch
71b5d92a15844ef1847721f2fac21b8a2956a8b7,0,0,0,0,0,0,0,0,0,0,0,0,0,0,7,1,0,0,0,0,0,0,0,0,0,1,100,NoArch
5029888db024898e928bf301da2a78a7432ba198,0,0,0,0,0,0,0,0,0,0,0,0,0,0,7,0,0,0,0,0,0,0,0,0,0,0,100,NoArch
41202da7788193da77f1ae4b784127bb93eaae2c,0,0,0,0,0,0,0,0,0,0,0,0,0,0,8,1,0,0,0,0,0,0,0,0,0,0,100,NoArch
2d040145810b8b14c59c5882f9115698351039d1,2,100,1,99,1,0,1,1,18,4,1,2,0.968586717,229,3,0,30,24,6,1927,1482,445,15,12,3,1,99.67183771,NoArch
8306205d7abb0acbb73a1d178e3eb90f2bc29a5e,7,153,12,141,1,0,1,6,16,39,2,5,2.315202103,2746,8,0,318,303,15,18198,17565,633,132,124,8,1,96.82034976,Arch
9d46ce380a3929605b3838238e8aa07a9918ab7a,3,36,4,32,0,0,0,9,13,78,1,2,1.29708926,2114,2,2,130,129,1,15507,15297,210,68,68,0,0,100,NoArch
5f85c267040fd51c186794fdae900162ab176b14,0,0,0,0,0,0,0,0,0,0,0,0,0,0,10,0,0,0,0,0,0,0,0,0,0,1,100,NoArch
ccbf543607db2c3479094a3216f733f6844b6f06,14,0,0,0,0,0,0,1,1,0,1,4,0,2825,56,4,316,316,0,17613,17613,0,130,130,0,1,97.81942078,Arch
3d3781810c2fd28c85407b04aad08fc2a85174dc,6,288,13,275,3,0,3,1,14,69,1,3,2.195579869,584,4,0,79,56,23,5332,3984,1348,33,24,9,0,99.627245,NoArch
ee5b32f5d4aa26e7fc58ccdae46935f063460920,5,81,87,6,0,0,0,12,19,18,2,5,1.783996634,2520,6,1,135,135,0,18019,18052,33,79,79,0,1,100,NoArch
170ee884578a85db53b87cee87f5208083f142aa,4,99,8,91,2,0,2,1,3,85,1,3,1.559667968,247,57,5,26,22,4,1210,972,238,19,16,3,1,99.83136594,NoArch
90227eeda757516abdd06b436ae08a4adacc28e1,3,3,3,0,0,0,0,1,10,34,3,3,0.918295834,551,58,6,57,57,0,3377,3377,0,31,31,0,1,99.86531987,NoArch
fdcd3b18b63d54e4b468a62d92c27497398d67ac,0,0,0,0,0,0,0,0,0,0,0,0,0,0,0,0,0,0,0,0,0,0,0,0,0,1,100,NoArch
5f8bf970058d5915af1910dbf917a33356d06af2,1,129,4,125,0,0,0,8,12,28,1,1,0,426,4,0,32,24,8,4207,3076,1131,23,19,4,1,100,NoArch
415882f9023795994e9cc8a8294909bbec7ab191,0,0,0,0,0,0,0,0,0,0,0,0,0,0,12,0,0,0,0,0,0,0,0,0,0,1,100,NoArch
e9f114f3dd8673b8b66b024e62cc1e3e808e7ea9,43,132,889,757,0,7,7,1,22,40,7,25,4.268802626,12523,12,0,1015,1072,57,78504,82476,3972,482,509,27,1,94.64512041,Arch
2137ecfa2296b1b2d281fcd2d2a35a9282d2b477,43,889,132,757,7,0,7,1,19,26,7,25,4.268802626,11766,7,2,1072,1015,57,82476,78504,3972,509,482,27,1,94.64512041,Arch
f93e64fee413ed1b774156e688794ee7937cc01a,3,7,26,19,0,0,0,15,22,14,3,3,1.182032094,1028,9,1,101,103,2,5917,6040,123,36,38,2,1,100,NoArch
3639241d24178292223996fd591a7d0c6e27a528,44,158,896,738,0,7,7,1,22,40,8,26,4.31427228,13045,6,1,1074,1129,55,81638,85487,3849,493,518,25,1,94.64512041,Arch
44700d531a74f24762903df2729577a0d96e4ec0,47,1392,158,1234,10,0,10,1,22,24,8,28,4.276719341,12307,2,0,1155,1074,81,89047,81638,7409,529,493,36,1,94.60297767,Arch
77d5b92d88d6583bdfc09e4c10ecfe7ddbb04806,2,119,3,116,0,0,0,6,6,208,1,1,0.246783955,98,5,1,8,4,4,1978,414,1564,5,4,1,1,100,NoArch
cf0a4c19bc4ed850172e6ac938f57a0bf7e96353,1,25,0,25,0,0,0,7,9,107,1,1,0,204,6,2,12,10,2,1614,1384,230,7,6,1,1,100,NoArch
dd7cf38a137ed43b8f00aa14c985bf8b106e256f,0,0,0,0,0,0,0,0,0,0,0,0,0,0,48,1,0,0,0,0,0,0,0,0,0,1,100,NoArch
1ca912af0904283a270a822d5876babca5c89739,2,23,23,0,0,0,0,11,19,94,2,2,0.426228657,1269,10,0,118,118,0,8868,8832,36,80,80,0,1,100,NoArch
7194514aff33815a2f4d6d1847f00b94d1a1a36b,2,4,4,0,0,0,0,11,19,26,1,1,0.811278124,1008,0,0,87,87,0,8545,8545,0,29,29,0,1,100,NoArch
7d668314447650243ec5c872229efdd02fb0212c,1,0,54,54,0,0,0,8,17,39,1,1,0,365,7,3,32,40,8,1972,2195,223,12,17,5,0,100,NoArch
0f892ef62c76436b17030e6edb4642f476d7de1e,1,30,9,21,0,0,0,9,11,39,1,1,0,136,10,2,14,11,3,1147,988,159,6,5,1,1,100,NoArch
c40a0d4e91896dece51969f5308016ecb3aa635c,0,0,0,0,0,0,0,0,0,0,0,0,0,0,4,1,0,0,0,0,0,0,0,0,0,1,100,NoArch
a355c7611c55151e6cfd5942c9eb067b622ae57b,55,251,1593,1342,0,10,10,1,22,37,8,32,4.606635689,16349,48,1,1313,1395,82,100725,109900,9175,624,658,34,1,94.60297767,Arch
fb7fba365f89afaf97cc969ecc09f3bbfc4a5dbd,56,1596,252,1344,10,0,10,1,22,26,8,32,4.61894358,15147,49,1,1401,1319,82,110855,101667,9188,662,628,34,1,94.60297767,Arch
99b7e9eb9ef8827c1e06b7e8621b6be6403b061e,48,308,211,97,1,0,1,5,23,83,6,28,4.984503241,16563,13,1,1671,1655,16,100683,100248,435,920,910,10,1,96.09209331,Arch
14323cb10012bdbf80cbb838928af9301cb42ba0,3,141,216,75,0,1,1,2,2,15,1,2,0.748591598,496,2,0,26,26,0,3072,3560,488,11,11,0,1,99.88555079,NoArch
23afe7a4872fca66d9aeb36d209c6538a17d81f1,0,0,0,0,0,0,0,0,0,0,0,0,0,0,133,0,0,0,0,0,0,0,0,0,0,1,100,NoArch
cf765df6062f896ad6bf0a8ddf711aad19dbf59b,7,475,33,442,2,0,2,1,20,64,2,4,2.2782776,1828,4,0,203,165,38,14391,12319,2072,130,109,21,1,92.86921257,Arch
55e6d348155f63eb128cd208687d02206bad66a5,9,132,475,343,2,2,4,0,19,32,3,6,2.710873243,2270,11,3,169,203,34,12649,14518,1869,113,130,17,1,92.78002699,Arch
3ef9e885cacc064fc316c61c7c826f3a1cb96da0,1,1,1,0,0,0,0,2,2,205,1,1,0,134,12,4,5,5,0,850,850,0,3,3,0,1,100,NoArch
418f9bb2e91ed6c02077d36e49a47f0c8d08303a,1,12,3,9,0,0,0,6,10,178,1,1,0,181,1,0,25,24,1,1007,980,27,4,3,1,0,100,NoArch
f1d7bb381d4a370beeedb45132b24c2cac00aabf,2,156,1,155,1,0,1,1,2,1,1,2,0.454700686,46,13,5,11,3,8,814,107,707,11,3,8,1,99.94295493,NoArch
e3019031d8fff60df4fec82eac3fd5c044011635,1,4,3,1,0,0,0,6,11,2,1,1,0,190,50,2,25,25,0,1026,1007,19,4,4,0,1,100,NoArch
0a4902eccece1df959946fcb7379a94fc5fe0784,4,107,0,107,0,0,0,8,19,62,1,3,1.071342973,1193,26,0,177,162,15,6749,6035,714,169,158,11,1,99.09935266,NoArch
779edc068865898049569da0fe750574f93a0dca,2,178,58,120,0,0,0,2,3,8,1,2,0.996681868,421,3,1,39,26,13,3755,3072,683,20,11,9,1,98.77910278,NoArch
1e321c2fc0f9fedcbb8a0339c90a28a9be5afd64,10,286,45,241,1,0,1,4,20,166,1,3,2.065610219,1354,1,0,212,179,33,7237,6178,1059,183,163,20,1,94.38459027,Arch
a752b7b18c5c74c0c9115168188fa4a15a670225,7,475,33,442,2,0,2,1,20,64,2,4,2.2782776,1828,11,1,203,165,38,14391,12319,2072,130,109,21,1,93.0479183,Arch
14e0c95206f6d7c1806555490bcbce8785ffea5a,2,3,1,2,0,0,0,8,13,51,1,2,1,331,0,0,23,22,1,2632,2589,43,18,18,0,1,100,NoArch
21c45e1051b593f0e1023a84cb96658320046dae,1,0,4,4,0,0,0,11,21,19,1,1,0,583,7,0,53,54,1,2843,2853,10,26,27,1,1,100,NoArch
eeab532d794426115f839e6ee11a9fc1314698fe,1,0,1,1,0,0,0,16,24,19,1,1,0,541,8,1,59,59,0,3117,3130,13,11,11,0,1,100,NoArch
83fb9651f368351446bb6ef0c9ebde34cf61b809,12,170,61,109,0,0,0,10,21,60,1,6,2.718532353,4523,1,1,345,340,5,32079,31172,907,158,156,2,1,100,NoArch
c5030f77a0e63f609ed2c674bea00201b97d8bb6,0,0,0,0,0,0,0,0,0,0,0,0,0,0,8,1,0,0,0,0,0,0,0,0,0,1,100,NoArch
71b5d92a15844ef1847721f2fac21b8a2956a8b7,123,608,3254,2646,0,16,16,1,22,29,10,57,5.758990858,33121,7,1,2834,3049,215,191761,207434,15673,1521,1640,119,1,89.15537018,Arch
8b00791ef47f708f54ffbfb5789ed65f958740b3,124,3257,615,2642,16,0,16,1,25,38,10,57,5.766961496,30561,1,1,3055,2840,215,207740,192100,15640,1645,1526,119,0,89.15537018,Arch
06652aa93515fa8178e7fea2279f40123a69978c,2,4,16,12,0,0,0,17,26,28,2,2,0.934068055,972,2,2,110,110,0,5815,5834,19,30,30,0,0,100,NoArch
1e1d9e1d345a104d6f873403ef2826778ac114d3,1,2,1,1,0,0,0,11,21,19,1,1,0,913,7,0,80,80,0,6405,6404,1,57,57,0,1,100,NoArch
38c3ccc51a069dbccab718423055c0a708b44d63,1,1,1,0,0,0,0,8,13,141,1,1,0,232,59,0,26,25,1,1398,1387,11,9,9,0,1,100,NoArch
0241b21f771fd1b7438a103a7b49f913632d4b97,65,657,657,0,0,0,0,5,27,83,7,33,5.125081609,21401,3,3,1848,1848,0,140152,140152,0,930,930,0,1,100,NoArch
cafc87041baf4055c39244e7cde0187437bb03d4,5,377,5,372,3,0,3,10,17,22,2,4,1.58534209,779,14,5,70,53,17,8655,6485,2170,32,23,9,1,99.71062422,NoArch
41202da7788193da77f1ae4b784127bb93eaae2c,168,1242,4245,3003,0,19,19,1,22,16,10,65,6.222605537,45149,8,1,3826,4059,233,266649,284452,17803,2064,2192,128,0,88.93897365,Arch
bc82e2be6cf080ab99092758368e91f509a2004c,169,4313,1244,3069,20,0,20,1,27,38,10,66,6.211450863,42146,4,2,4067,3826,241,284832,266649,18183,2200,2064,136,1,91.72259508,Arch
5eed6c98a8880dc3b4e64ec9ff9dae4859e89b4c,1,1,1,0,0,0,0,13,23,7,1,1,0,789,9,2,92,92,0,5014,5014,0,44,44,0,0,100,NoArch
e101ea9bd4405a461bc78aad1af64499f797daed,0,0,0,0,0,0,0,0,0,0,0,0,0,0,14,1,0,0,0,0,0,0,0,0,0,0,100,NoArch
8b0a4009a9c662f45a0b7bbbb6f01c2b07c36809,9,110,81,29,1,0,1,5,21,35,1,7,2.071052094,3930,27,1,435,437,2,23293,23162,131,264,266,2,1,94.30865922,Arch
1713f686f86e8c2f0a908c313cca9b595c6aed33,1,5,1,4,0,0,0,9,12,39,1,1,0,301,5,3,26,26,0,1679,1660,19,26,26,0,0,100,NoArch
8c3001363d80b29733470221c192a72f541381c5,44,427,208,219,1,0,1,10,22,56,8,29,4.574029071,13349,15,1,1256,1226,30,86554,85810,744,686,671,15,1,99.78670459,NoArch
04449f33feb300b99750c52ec37f2561aa644456,2,1,27,26,0,0,0,4,10,0,2,2,0.491237342,218,16,2,24,28,4,834,919,85,14,15,1,1,100,NoArch
ac73bdcdc39e100d4082cf54359690490e5774f7,9,1444,0,1444,9,0,9,1,1,0,2,3,3.001890646,0,12,1,143,0,143,7692,0,7692,101,0,101,1,98.86965736,NoArch
07c3c5d797f612f9b73b2805b65275c2029c2442,18,134,57,77,1,0,1,11,24,18,1,9,3.716316821,4420,28,2,420,413,7,27374,26972,402,214,207,7,1,94.22084623,Arch
e057c27603301d8b49e9b50b78a3ffce247b1059,263,532,531,1,0,0,0,2,28,34,8,78,7.626172658,59964,51,1,5438,5438,0,372343,372023,320,2977,2977,0,1,87.54940711,Arch
fad4bd377bb14a9ff6e684a526d0eaa65458d91d,0,0,0,0,0,0,0,0,0,0,0,0,0,0,52,2,0,0,0,0,0,0,0,0,0,1,100,NoArch
fa36082554373dd4dce3e3d3159ab87300a4601d,188,448,420,28,0,0,0,3,29,2,8,71,6.981854726,50595,17,3,4287,4287,0,334228,334227,1,2175,2175,0,1,100,NoArch
1f5b0c77d6c87a936f2d34287ec6a1df1cb18b33,6,37,24,13,0,0,0,13,27,0,1,3,1.737797591,4702,0,0,381,378,3,31290,31100,190,174,173,1,1,100,NoArch
9f51b99174da2ce72adc632b9ef84cfd3760c153,1,10,4,6,0,0,0,8,10,1,1,1,0,114,8,0,6,5,1,910,838,72,4,3,1,0,100,NoArch
dbc9acd23a4eb208c7cd458bb3adaf54731d4145,5,78,1,77,0,0,0,8,15,0,3,5,2.164192284,2447,60,1,243,233,10,17473,16968,505,128,124,4,1,100,NoArch
ce0a4c64d07d6eea926d1bfb92b69ae387b88f50,1,17,2,15,0,0,0,12,19,2,1,1,0,556,2,0,63,63,0,3510,3344,166,36,36,0,1,100,NoArch
9ecf0ccfb263cee8190afeb965ba350525860d6e,2,18,1,17,0,0,0,5,7,154,1,2,0.485460761,238,0,0,16,14,2,1519,1388,131,8,7,1,1,100,NoArch
78b3194e8241c519a85310997f31b2b55df487e1,31,57,41,16,0,0,0,7,30,56,6,18,4.351805575,7102,0,0,751,753,2,38120,37932,188,411,411,0,1,100,NoArch
c146ca90fdd102f2bda90a2b15f6aef56414f9f4,0,0,0,0,0,0,0,0,0,0,0,0,0,0,9,1,0,0,0,0,0,0,0,0,0,1,100,NoArch
2a611f4ad3816b67b54e0fcd1ef588668fba0732,0,0,0,0,0,0,0,0,0,0,0,0,0,0,0,0,0,0,0,0,0,0,0,0,0,1,100,NoArch
5b53b0d85e0d60a37c37941b5a653b0718534e7b,8,314,46,268,3,0,3,1,31,0,1,5,2.485788255,2430,6,2,249,232,17,16732,14980,1752,127,113,14,1,99.64664311,NoArch
194e20e66189e9e7ef313804532386339aeb6212,0,0,0,0,0,0,0,0,0,0,0,0,0,0,10,2,0,0,0,0,0,0,0,0,0,0,100,NoArch
bd716ece1826fcc44092bd0add6cbbc097eeaec2,0,0,0,0,0,0,0,0,0,0,0,0,0,0,7,0,0,0,0,0,0,0,0,0,0,0,100,NoArch
639ec20412f73d221c24737e35667b37b35cc583,0,0,0,0,0,0,0,0,0,0,0,0,0,0,0,0,0,0,0,0,0,0,0,0,0,1,100,NoArch
6808559b018366b4bc6d47b40dbbe362f48f65d7,3,101,10,91,0,0,0,5,5,19,1,2,0.810548188,1400,9,1,144,142,2,10781,10038,743,66,65,1,1,100,NoArch
deb95ad9962bd40dc3edcc66281e8d333f32bab3,0,0,0,0,0,0,0,0,0,0,0,0,0,0,10,2,0,0,0,0,0,0,0,0,0,1,100,NoArch
575d87cf7d6f0f743cb7cec6520d80e6fcc3e20a,3,277,0,277,3,0,3,1,1,0,1,2,1.357798413,0,3,0,19,0,19,1292,0,1292,9,0,9,1,96.75845242,Arch
eaf6cc2d90bf27c0d9414a4ea18dbd1b61f58e50,30,584,554,30,3,1,4,8,28,0,2,14,3.556325283,13285,53,2,1001,998,3,91720,91627,93,476,474,2,1,99.3902439,NoArch
b5d093a21bbb19f164fbc549277188f2151232a8,1,1,2,1,0,0,0,6,6,135,1,1,0,76,4,0,10,10,0,235,235,0,6,6,0,0,100,NoArch
d610252d6b54dcbb1897bb8881d59c3838a46c18,18,935,78,857,3,0,3,4,32,13,4,9,2.836428257,5437,8,0,556,465,91,40936,35246,5690,302,252,50,1,99.58254269,NoArch
4e5c8671ef3213ffa5c40f09aae27aacfa20f907,5,103,59,44,1,0,1,9,22,20,1,3,1.936385057,1182,15,0,108,114,6,9536,9529,7,39,37,2,1,93.13116551,Arch
f7b55afb74545aefd440cc83f3d0552e333048e3,1,1,1,0,0,0,0,8,12,29,1,1,0,171,0,0,15,15,0,929,929,0,11,11,0,0,100,NoArch
1f6be820f327503b460f9e8c372c07d6b0918fca,1,31,14,17,0,0,0,9,12,3,1,1,0,304,5,0,17,16,1,1491,1409,82,17,16,1,1,100,NoArch
3c803421e0e138c223c9bec90f9b7c8a6751317d,1,4,4,0,0,0,0,9,13,0,1,1,0,321,6,1,17,17,0,1491,1491,0,17,17,0,0,100,NoArch
996f7612323729d3ab4bedc1b0c7754aded2dc00,3,78,3,75,1,0,1,7,12,20,2,3,0.701486195,679,1,0,42,39,3,5675,5202,473,19,18,1,0,99.92947814,NoArch
f5f34bb1c16e6d070668486eba2a29f554c0bbc7,4,329,23,306,1,0,1,1,10,24,2,4,1.310481227,751,1,1,90,74,16,6508,4049,2459,47,36,11,1,99.92957746,NoArch
8c7cef3e50471d3645b207d97d515107764688c9,4,18,12,6,0,0,0,14,33,8,1,2,1.784640699,2517,11,0,233,235,2,15804,15775,29,115,115,0,0,100,NoArch
c0f96e072650d39433929c6efe3bc0b2cd882a39,11,540,125,415,0,0,0,4,25,28,3,7,2.518103447,4164,2,0,314,297,17,32099,29544,2555,180,160,20,1,99.85930355,NoArch
a464a2972e83e648585277ebe567703c8285cf1e,3,351,19,332,2,0,2,1,10,11,1,3,1.130075067,265,16,1,35,23,12,4592,2225,2367,7,3,4,1,99.78939979,NoArch
5d717a28f45137bea71dffa31b0ae7ccbf1bda00,2,3,0,3,0,0,0,7,7,39,1,2,0.918295834,125,0,0,9,9,0,455,438,17,6,6,0,1,100,NoArch
6d7ca2cf7e441ad19d32d7a25739e454f39ed253,3,84,17,67,0,0,0,10,15,41,2,3,1.191941091,705,9,1,91,83,8,4975,4471,504,35,31,4,1,100,NoArch
447ba3bae6dbaec7b6cfa0950cd24f5c4fcf5025,1,2,1,1,0,0,0,2,2,43,1,1,0,356,13,0,32,32,0,2181,2183,2,16,16,0,0,100,NoArch
17bf9303423821483f17785f8536b7bfed45e42e,39,2703,859,1844,28,0,28,2,29,3,2,9,4.728831123,6858,134,0,637,530,107,54229,44639,9590,346,260,86,1,92.32821881,Arch
661b0b3bab85c8fd958a9e256dab99790ea92713,20,907,520,387,7,0,7,2,30,5,3,11,3.539774238,5577,54,1,513,493,20,36977,35323,1654,250,235,15,1,95.05962521,Arch
644c1cc8bd1965271c4433edccb17aa8fda5f403,5,304,6,298,2,0,2,1,15,4,1,4,1.382624037,508,17,2,53,44,9,5626,3735,1891,23,17,6,1,92.26150767,Arch
14d4fea8339913c0df8ea829036a45a187c55208,7,147,64,83,0,0,0,2,34,20,1,5,2.64364274,2750,0,0,264,256,8,17419,16945,474,131,127,4,1,99.87763842,NoArch
d65efe659d36dfb80be16a6389c5aba2f8701c39,14,255,248,7,0,0,0,1,14,99,7,7,2.368873124,2504,7,0,165,166,1,16747,16517,230,109,110,1,1,100,NoArch
9ca710cb02d34ab26fbf59b2d9152f2df86875f3,2,2,2,0,0,0,0,3,30,8,1,1,1,1018,0,0,96,96,0,5693,5693,0,45,45,0,1,100,NoArch
19d29ac7d0ac451324d25bfe85b51b1eca10bc67,15,1004,180,824,2,0,2,5,24,18,4,11,2.369738319,6753,11,2,764,704,60,47292,42697,4595,415,389,26,1,97.63677566,Arch
acdc4a8d004394590f9e5ffcc703ea23624e66d9,6,124,124,0,0,0,0,2,15,73,3,6,2.019300253,1574,8,1,74,76,2,11067,10994,73,61,62,1,1,100,NoArch
acb1ada2f756b49d9f9a0aa152f99fcc9e86dde7,1,3,1,2,0,0,0,19,31,2,1,1,0,622,1,0,60,60,0,3153,3140,13,30,30,0,1,100,NoArch
75523657a4b5c67209e48c1c989a4dd017b4fdd1,3,9,21,12,0,0,0,3,3,15,2,3,0.566509507,635,0,0,50,56,6,3035,3052,17,36,36,0,0,100,NoArch
09fd6f64c527e6a822c4e17dc4e61b8fdee28189,1,4,2,2,0,0,0,7,11,66,1,1,0,98,0,0,12,11,1,377,364,13,6,6,0,1,100,NoArch
ddd105bb3119174b613c6917ee25795f2939f430,4,134,2,132,0,0,0,4,25,94,2,3,1.481832483,1145,0,0,173,162,11,7065,6174,891,155,146,9,1,99.93122421,NoArch
2a2f31d919dbabde76284f3b7fdae1e45dc9ceb1,1,1,5,4,0,0,0,13,20,30,1,1,0,307,10,0,48,48,0,1645,1678,33,38,38,0,0,100,NoArch
332072bc6d5fd04e9325d21e55dfac66bc8f848a,14,1041,368,673,5,0,5,8,18,45,3,6,2.670816279,3060,5,0,355,293,62,23942,19870,4072,164,131,33,1,99.07912688,NoArch
84dd9047d3902650d7ff5bc95b9789d6880ca8e2,2,217,60,157,0,0,0,7,18,64,1,2,0.400140643,557,18,3,75,48,27,5124,3730,1394,27,17,10,1,100,NoArch
62bd3e7ded0b9f02742ece746fd7179ba20b5c92,3,264,0,264,1,0,1,3,4,13,2,3,0.610168826,414,12,1,85,52,33,4546,2812,1734,40,33,7,1,99.89858012,NoArch
2a56f82908a8b8f788a7547d3c707c144696c1df,2,2,17,15,0,0,0,4,32,16,1,1,0.629249224,1020,2,1,94,96,2,5599,5706,107,44,45,1,1,100,NoArch
6e15eebd81da41b1076179a8ddcedcf07d1c9043,13,459,423,36,1,0,1,3,15,88,3,8,2.967518536,3156,9,2,181,179,2,25179,24878,301,94,92,2,1,99.62837838,NoArch
26684f5984baafdfcbef3718fa5abcbd0983a6a4,2,74,1,73,1,0,1,1,2,40,1,2,0.566509507,94,29,0,10,6,4,862,419,443,7,5,2,2,99.89871708,NoArch
aea7c1657ee41ac740b4974f4239c90960553f64,1,21,3,18,0,0,0,5,8,44,1,1,0,339,3,2,43,42,1,2438,2401,37,12,12,0,1,100,NoArch
19cc15c0987043175685aaeb45facb15af23e34f,2,2,2,0,0,0,0,5,33,0,1,1,1,1005,3,0,94,94,0,5599,5599,0,44,44,0,0,100,NoArch
19ca0b56296bf89c611406bb86c3626f87d562ee,58,789,601,188,5,0,5,8,31,10,3,20,3.705225361,11147,55,1,977,969,8,72794,71523,1271,585,575,10,1,96.97275479,Arch
6de9f5d9e5cb1f82d7c32d04b114e7d4a181619b,10,138,99,39,3,1,4,3,5,44,1,5,2.671716056,1008,3,0,83,85,2,5992,5896,96,43,43,0,1,99.00332226,NoArch
06dae30297ea02ab122c9029a54f7927e8212039,36,1232,1243,11,0,0,0,2,27,44,4,16,4.627820072,13264,10,3,719,741,22,96545,95766,779,417,417,0,1,98.9200135,NoArch
69b16309c8c46f831c8b9be42de8b2e29c74f03e,4,44,46,2,0,0,0,2,6,134,1,3,1.460708373,667,11,4,38,38,0,4988,4957,31,31,31,0,1,100,NoArch
9059bce977cee98e2d65769622c46a1941c563dd,3,246,7,239,1,0,1,1,15,28,1,3,0.654572645,302,19,1,30,22,8,3890,2182,1708,6,2,4,1,99.93079585,NoArch
c4b71622b90fc66f20f361d4c083b0a396572b75,26,64,62,2,0,0,0,15,28,45,4,18,4.413322384,11201,56,1,918,918,0,73194,73194,0,485,485,0,0,100,NoArch
506447fd4fde4cd922f7aa8f4e17a7f06666dc97,3,85,48,37,0,0,0,3,11,5,2,3,1.050618104,1826,135,0,136,131,5,12418,12400,18,64,61,3,1,100,NoArch
096f7f55b2553265c0b72f42a1eb7f291e5626ad,17,192,214,22,0,0,0,1,29,122,1,4,3.491388112,3210,12,3,228,237,9,21566,21309,257,159,159,0,1,100,NoArch
5e0f5e5521c52a08c284a92a3a6a00e34805cce5,0,0,0,0,0,0,0,0,0,0,0,0,0,0,0,0,0,0,0,0,0,0,0,0,0,1,100,NoArch
e21441ad8317f302fed947c414e059a332e4d1ef,3,61,2,59,1,0,1,4,19,31,1,3,1.12865817,306,2,0,30,26,4,2027,1789,238,10,9,1,0,99.79274611,NoArch
366bb10d8c4fe98424f09a6cf6f4aee7716451a4,40,709,805,96,0,1,1,3,20,100,5,18,4.191261609,9451,13,3,598,628,30,69210,68789,421,357,363,6,1,98.55218855,NoArch
f921469afcd03baaf2a4f3266c8ba97e516d6935,5,432,12,420,2,0,2,1,17,32,1,4,1.591354734,537,20,1,57,46,11,6656,3725,2931,25,17,8,1,90.78508639,Arch
f6c87b56c1f79697428eafde8d167dbcfe93b282,534,19929,33328,13399,81,183,264,1,22,0,11,123,8.075533922,84044,10,0,6357,8580,2223,429023,583500,154477,3481,4811,1330,0,77.123804,Arch
e783ab174946a0b767396239c0132c31c8d26458,534,33320,19921,13399,186,81,267,1,34,0,11,123,8.075980613,70648,4,0,7274,7672,398,510740,502284,8456,4080,4205,125,1,77.123804,Arch
d54b4b8a525868ea6d15e2e2cc6ffccc62d5c43c,6,199,57,142,0,0,0,8,22,43,3,5,1.90082434,2606,5,0,278,259,19,17200,16327,873,134,125,9,1,100,NoArch
dd7952ec9de7f9858ded98b49923e8978fd1df78,534,19867,33414,13547,81,186,267,1,22,0,11,123,8.073102195,84189,8,0,6357,8604,2247,428990,584631,155641,3481,4824,1343,1,77.123804,Arch
1d16b151b9079c4ad9bfb08bfa6114c3ad585e0f,3,7,26,19,0,0,0,15,22,70,3,3,1.182032094,990,8,0,96,98,2,5749,5872,123,34,36,2,1,100,NoArch
cebce61a3496f8788f5b96d6aedce0a8394fc325,48,308,211,97,1,0,1,5,23,259,6,28,4.984503241,16527,13,0,1670,1654,16,100402,99967,435,920,910,10,1,95.00674764,Arch
2112d0ada59cb12b3be6eb7d407ba48b494c505f,3,16,12,4,0,0,0,12,24,84,1,2,1.470142979,1891,11,1,169,172,3,11682,11688,6,84,84,0,0,100,NoArch
e3f7659b3470a16f2d46ab75df576a7f00b432cd,1,3,1,2,0,0,0,12,22,0,1,1,0,582,1,0,53,53,0,2858,2845,13,27,27,0,1,100,NoArch
18453a456db0f5be0b935e5a04d8c0cdb3958936,1,26,6,20,0,0,0,10,14,282,1,1,0,502,2,0,59,59,0,3317,3127,190,34,34,0,1,100,NoArch
9a2b3e3c93f670c79adb3d5cba69cdd3f551005a,0,0,0,0,0,0,0,0,0,0,0,0,0,0,3,0,0,0,0,0,0,0,0,0,0,1,100,NoArch
ea48ca9b62a2f216460a0795ef9d519481510cd7,2,85,42,43,0,0,0,2,2,212,1,2,0.915648771,1480,133,0,113,108,5,10356,10278,78,45,42,3,1,100,NoArch
96b2359fda4d5b55e51e8f347228fe2f7cf6b24f,5,36,23,13,0,0,0,10,21,84,1,3,1.581468057,3359,0,0,333,330,3,20612,20424,188,151,150,1,1,100,NoArch
0050e00afdc728793f9928cbb594e657c7219c41,2,100,1,99,1,0,1,1,20,0,1,2,0.968586717,228,4,1,30,24,6,1884,1439,445,15,12,3,1,87.90573588,Arch
d535381e3f98008cd00161304b7a4e59644f5da0,1,12,3,9,0,0,0,6,10,337,1,1,0,181,1,0,25,24,1,1007,980,27,4,3,1,0,100,NoArch
bd7060186f7165f01aa8508c3fd8c3c81b012a2f,1,4,3,1,0,0,0,6,11,0,1,1,0,190,49,0,25,25,0,1026,1007,19,4,4,0,1,100,NoArch
d476ac541b00b6a00dd690c4a7bfa3fc6037e7ab,3,61,2,59,1,0,1,3,14,163,1,3,1.12865817,299,2,1,29,25,4,1986,1748,238,9,8,1,0,99.68701095,NoArch
cc4aa45ae28bbd4135d1c65f38a2dcd5de749418,2,3,0,3,0,0,0,5,5,493,1,2,0.918295834,123,0,0,9,9,0,442,425,17,6,6,0,1,100,NoArch
86698b516001fc30427f3f15a56ec5289d17a9c1,5,78,1,77,0,0,0,7,13,116,3,5,2.164192284,2450,56,0,244,234,10,17524,17019,505,128,124,4,1,100,NoArch
fa6aba751d8de16d9d109a8cfc21150b17b59cff,528,32722,19583,13139,181,79,260,1,34,0,11,122,8.025296913,70607,0,0,7250,7659,409,510064,502167,7897,4068,4196,128,0,68.60167945,Arch
2e5f6011575cc9fb6adbae822718ea08ac00c4be,528,19596,32733,13137,79,181,260,1,24,0,11,122,8.025138687,83746,0,0,6355,8545,2190,429510,582384,152874,3481,4790,1309,1,68.60167945,Arch
45efa695c15f64294e84506a8e8cb19aba1af7df,0,0,0,0,0,0,0,0,0,0,0,0,0,0,14,1,0,0,0,0,0,0,0,0,0,0,100,NoArch
2f4ee0a4af3c088f825decd77c5429c822b50ad6,2,18,1,17,0,0,0,5,7,193,1,2,0.485460761,238,0,0,16,14,2,1519,1388,131,8,7,1,1,100,NoArch
e80dd0414b1842fd1128fb7d6262b43f8426e048,3,99,8,91,0,0,0,8,24,160,1,2,0.729982292,1401,4,0,144,142,2,10783,10040,743,66,65,1,1,100,NoArch
f9c3b078966fad1843554853b6179c04cae1d7f8,3,84,17,67,0,0,0,10,13,326,2,3,1.191941091,705,7,0,91,83,8,4979,4475,504,35,31,4,1,100,NoArch
500b3907a5057b3945115132beb97ef6cae37687,1,21,3,18,0,0,0,2,2,219,1,1,0,345,2,1,43,42,1,2483,2446,37,12,12,0,1,100,NoArch
0dcc20458d36fdb6d052a62ca52a77fa0c31745f,1,1,1,0,0,0,0,13,23,6,1,1,0,584,3,0,53,53,0,2858,2858,0,27,27,0,0,100,NoArch
288bc4dd809521af896d0538ec2ae87bc034df7b,0,0,0,0,0,0,0,0,0,0,0,0,0,0,0,0,0,0,0,0,0,0,0,0,0,1,100,NoArch
be205eda53ab3210aea455a377aaf7610b8e35e1,1,1,1,0,0,0,0,8,9,241,1,1,0,147,0,0,10,10,0,858,858,0,5,5,0,0,100,NoArch
f92b9fdcc4d7c0dff9953e42205fca22472525c9,528,32739,19768,12971,182,79,261,1,34,0,11,122,8.02636946,70646,57,1,7239,7677,438,509344,503628,5716,4064,4203,139,0,68.5516235,Arch
8d0e23173b3f21d7cdb24942913eb1132a111a32,3,29,9,20,0,0,0,13,22,30,2,3,1.344127981,1091,136,1,103,99,4,7405,7230,175,58,56,2,1,92.93163384,Arch
6dac10115c155b619734938caac447c8b04d4c8e,9,21,22,1,0,0,0,7,23,69,1,7,2.743891059,3680,1,0,269,269,0,20943,20976,33,166,166,0,1,100,NoArch
5d37e66b7ee99a4a496261d98e33e3244b9b9a2a,1,1,1,0,0,0,0,10,16,127,1,1,0,232,0,0,26,26,0,1398,1398,0,9,9,0,0,100,NoArch
77d7500d3bbcedda81fa182908984e658d6689e5,528,19807,32796,12989,79,182,261,1,24,0,11,122,8.028709571,83636,8,1,6357,8545,2188,430131,582446,152315,3483,4792,1309,1,70.14812002,Arch
295d00beea1c84f83d707f7c6e70292787f1e3e0,528,32802,19803,12999,182,79,261,1,34,0,11,122,8.029366568,70647,2,1,7243,7677,434,509571,503629,5942,4066,4203,137,1,70.14812002,Arch
b54517aad07750071c9df164d9e573ed3335652d,12,78,78,0,0,0,0,3,30,6,1,8,2.702243131,7473,3,2,394,394,0,54501,54813,312,236,236,0,1,100,NoArch
e8ffc6f0aa91e2ba2f4affe09d4cb29bd12d41e4,4,11,7,4,0,0,0,3,8,22,1,3,1.836591668,666,4,3,54,54,0,3797,3794,3,33,33,0,1,100,NoArch
404c7e82d9b538c356f93ffbbcb2c20d23310fd0,1,9,2,7,0,0,0,11,15,80,1,1,0,321,6,1,17,17,0,1506,1495,11,17,17,0,1,100,NoArch
32ea4c70ff259798dee571670dbcc501cc477cb0,2,4,1,3,0,0,0,9,9,57,1,2,0.721928095,125,1,1,8,8,0,488,471,17,6,6,0,1,100,NoArch
32bada29dc95f1d5910713ae6b4f4a4ef39677c9,1,2,0,2,0,0,0,16,25,69,1,1,0,289,0,0,32,32,0,1763,1737,26,15,15,0,1,100,NoArch
0d4848b68b625a17d05b38864a84a6cc71189bfa,33,99,78,21,0,0,0,1,15,21,5,18,4.36430565,7418,14,2,497,497,0,51789,51466,323,304,304,0,1,92.6889715,Arch
83796b3189570182c68a9c41e57b356124c301ca,2,15,9,6,0,0,0,4,6,51,1,2,0.870864469,421,5,1,46,45,1,2724,2678,46,25,25,0,1,100,NoArch
3a2fe13fcb7c168f8ff023e3bdb6ae482b400316,4,202,19,183,1,0,1,2,18,100,2,3,0.860327167,823,21,1,88,83,5,7429,6124,1305,36,32,4,1,99.93581515,NoArch
f094f4285782e1253b52fef788fa7461c67d95a7,2,60,13,47,0,0,0,2,16,69,1,2,0.939453207,208,6,2,23,17,6,1324,1093,231,7,5,2,1,100,NoArch
a64afdfd17ac974e451bceb877f3d40a9c775253,0,0,0,0,0,0,0,0,0,0,0,0,0,0,1,0,0,0,0,0,0,0,0,0,0,1,100,NoArch
25e0b75b3d03b6d460dc18d1a5fce7b881b0e019,2,73,17,56,1,0,1,1,35,46,1,2,0.987137774,528,7,3,57,56,1,3221,3071,150,14,11,3,1,99.77578475,NoArch
2ada2ef50fc373ed3083d0e7a96e5e644be52bfb,2,59,2,57,1,0,1,1,4,279,1,2,0.966985296,57,15,3,13,6,7,597,189,408,11,5,6,1,99.90403071,NoArch
148b2458f678025698a802cc9f72ee11dc829a1a,0,0,0,0,0,0,0,0,0,0,0,0,0,0,16,4,0,0,0,0,0,0,0,0,0,0,100,NoArch
25a0080b2f6ddce0e528b2a72aea33a565f0e565,9,64,26,38,0,0,0,6,36,62,5,7,2.609125971,3165,11,0,320,320,0,16807,16838,31,157,157,0,1,100,NoArch
3c9da2e5f038ea90a823334a7b07bb4d13f90996,3,40,31,9,0,0,0,7,25,59,2,3,0.824458529,1463,137,1,131,130,1,6784,6837,53,77,76,1,1,100,NoArch
29edf4b3b8ade64ec7822d6b7b2a125d5ca781c4,16,1381,65,1316,5,0,5,9,27,41,2,12,2.982676131,3060,14,0,438,330,108,27907,18576,9331,301,241,60,1,94.29991231,Arch
5fbb5a76f9ded25e9b6bd15e2db40e1a7c7a0f4d,557,22480,37168,14688,96,206,302,1,24,1,11,136,8.15310234,85850,2,0,6382,8873,2491,432972,613446,180474,3500,5003,1503,1,67.18694573,Arch
8324f6ecb030227beca87d92031cefb08c21ae6e,2,217,60,157,0,0,0,6,15,240,1,2,0.400140643,556,9,1,75,48,27,5114,3720,1394,27,17,10,1,99.73944763,NoArch
da043af11e731b3e53d998c3db3a66f13fd59026,1,2,0,2,0,0,0,14,21,28,1,1,0,266,0,0,29,29,0,1633,1607,26,14,14,0,1,100,NoArch
57132f79bb2dad6cfb215480b435a778714a442d,558,37350,22624,14726,207,96,303,1,36,1,11,136,8.155959632,71321,22,2,7395,7925,530,524817,525544,727,4156,4353,197,1,63.81498158,Arch
459356e292ea869ffe5f39235646dc474da76ea5,0,0,0,0,0,0,0,0,0,0,0,0,0,0,0,0,0,0,0,0,0,0,0,0,0,1,100,NoArch
2600d2de8d9d963db920ff486032482a946fe3d6,3,53,15,38,0,0,0,2,9,143,2,3,1.526914311,481,0,0,57,57,0,1950,1950,0,21,21,0,0,100,NoArch
e6f3bf10cf2c62a1008b82765abdcd33cfd64c67,5,84,6,78,0,0,0,10,28,30,2,4,1.85206404,2631,138,2,289,282,7,17002,16450,552,218,213,5,1,100,NoArch
161a7983375b0787398a1219a80531019810e692,5,361,35,326,2,0,2,1,19,16,1,4,1.948206727,554,23,3,69,50,19,5823,3867,1956,28,19,9,1,99.69768223,NoArch
0dc2fa6172cd62a6ea3b117735132ff9a80211a2,1,1,1,0,0,0,0,8,13,153,1,1,0,134,3,0,13,13,0,948,948,0,5,5,0,0,100,NoArch
244d47494e2d4d5b3ca60e460e1feb9351fb8e69,2,19,8,11,0,0,0,9,20,1,2,2,0.380946586,471,1,1,56,55,1,3595,3539,56,21,20,1,1,100,NoArch
f802d4400b14a4b11be6f6a1b758e1bb6fbb62a3,1,3,3,0,0,0,0,2,3,65,1,1,0,488,17,3,26,26,0,3187,3185,2,12,12,0,0,100,NoArch
74ecc27e920c70fa4598d8e5a696954203a5b127,4,11,3,8,0,0,0,2,29,29,2,3,1.483831707,1621,139,3,212,212,0,9122,9012,110,187,187,0,2,100,NoArch
6a0aa9a645d11ed7b50e18aa0563dafcd9d145f7,2,97,13,84,0,0,0,4,8,12,1,2,0.62109937,445,10,0,50,47,3,3574,2837,737,29,26,3,1,99.96646546,NoArch
802d16c8c9793156ef7fef0c59088040800fe025,7,260,19,241,1,0,1,10,19,56,2,5,1.749301306,1234,24,4,98,88,10,10428,8572,1856,58,50,8,1,99.9330656,NoArch
f34de3fb2738c8c36c937eba8df2a6848fafa886,12,905,2,903,7,0,7,1,30,81,1,4,2.99153684,1128,18,4,231,164,67,10123,5392,4731,213,155,58,1,99.40199336,NoArch
45acccdb8a1aadc8aa499f0eb564f98247880357,0,0,0,0,0,0,0,0,0,0,0,0,0,0,58,1,0,0,0,0,0,0,0,0,0,0,100,NoArch
d3edac4612bde2fa9deca9536801dbc48961fb95,1,0,5,5,0,0,0,10,16,11,1,1,0,306,0,0,25,26,1,1670,1696,26,25,26,1,1,100,NoArch
f22c3e933e828d1342bed67874b9ab3fee0ad099,0,0,0,0,0,0,0,0,0,0,0,0,0,0,30,0,0,0,0,0,0,0,0,0,0,1,100,NoArch
492f324bc79febd8299fbb837b67c900ace18ac2,1,1,1,0,0,0,0,12,17,23,1,1,0,328,31,1,17,17,0,1506,1506,0,17,17,0,1,100,NoArch
4095de4d45f174b45dd1310a6a99c4fecfb2466a,572,22903,38742,15839,98,214,312,1,24,0,11,138,8.213384521,88191,134,0,6502,9087,2585,439223,630044,190821,3556,5130,1574,1,68.08349146,Arch
7c766c33ddc5171743181767d1c6ce8d237ab5db,2,426,0,426,1,0,1,9,10,21,1,2,0.208556601,260,0,0,81,33,48,3903,1716,2187,34,16,18,1,99.9109528,NoArch
0fb02e7ad1111f1b84d48c8983e9a4cd7eb8b91e,3,40,31,9,0,0,0,7,14,144,2,3,0.824458529,1837,135,1,177,176,1,9584,9637,53,85,84,1,1,100,NoArch
555ff1aea4d7cc5947e890866b2a384b5409fb3a,3,77,5,72,0,0,0,10,22,119,2,3,1.543316704,2234,136,2,256,249,7,14435,13895,540,200,195,5,1,100,NoArch
4192cc65d02640f53db78922a1783103e7a46cfb,0,0,0,0,0,0,0,0,0,0,0,0,0,0,0,0,0,0,0,0,0,0,0,0,0,1,100,NoArch
b69bb18fdd3d5ab825d1f59024b10204890968ff,4,12,3,9,0,0,0,7,20,89,2,3,1.425605199,1573,137,3,203,203,0,8765,8644,121,182,182,0,2,100,NoArch
07345bacb0b494158760fa9f4aa92a4980f1f085,1,52,52,0,0,0,0,5,5,1,1,1,0,1164,10,0,115,115,0,6522,6510,12,49,49,0,0,100,NoArch
46572d04c4fed19941cb136882d4895d36b5c2fb,572,38285,22962,15323,213,98,311,1,36,0,11,138,8.208448675,72868,59,1,7554,8082,528,536424,533820,2604,4256,4431,175,0,68.14562002,Arch
0a77a3bbaba64d9b5930429d465b5f4071d494f8,572,22964,38287,15323,98,213,311,1,24,0,11,138,8.207212991,88191,11,1,6558,9087,2529,442037,630044,188007,3580,5130,1550,0,68.14562002,Arch
498c86b2b8cdd640e9bf00e4a224f7c17ebef618,0,0,0,0,0,0,0,0,0,0,0,0,0,0,50,0,0,0,0,0,0,0,0,0,0,0,100,NoArch
3a776f6eb2793b31ca4a76fbbe59e205b83ab75b,0,0,0,0,0,0,0,0,0,0,0,0,0,0,26,0,0,0,0,0,0,0,0,0,0,1,100,NoArch
54bbe32d741733e405b241fd95d1dc2dfefea144,1,1,1,0,0,0,0,7,10,335,1,1,0,306,27,1,16,16,0,1458,1458,0,16,16,0,1,100,NoArch
6c450957ced051de6231ad047bce22752210b786,572,38290,22966,15324,213,98,311,1,36,0,11,138,8.208889576,72868,19,5,7554,8082,528,536424,533827,2597,4256,4431,175,1,68.14562002,Arch
9697fbf71ead328cae6d56e9f99872e871342887,0,0,0,0,0,0,0,0,0,0,0,0,0,0,12,0,0,0,0,0,0,0,0,0,0,1,100,NoArch
03f136361a5fed594855992ab10bee8bb5060c5b,72,286,260,26,0,0,0,1,31,12,6,32,4.35778426,20086,20,6,1235,1235,0,144497,144166,331,732,732,0,1,95.21817095,Arch
bde7a7043e100242fec8fc0111e489a269a1d997,8,510,144,366,6,1,7,1,13,43,3,4,2.595493999,214,4,0,37,12,25,2951,1216,1735,29,6,23,1,95.86082783,Arch
3574a89232ad8573d1f76b27f127cc2ab9195e38,1,12,12,0,0,0,0,8,13,178,1,1,0,361,1,0,22,22,0,2505,2529,24,11,11,0,1,100,NoArch
5a0d3f1cf963e0061364d915ac86a465dd079bac,2,48,28,20,0,0,0,3,6,92,1,2,0.926819064,441,15,1,42,34,8,2910,2683,227,30,30,0,1,100,NoArch
7b1a049be9fa3f59da7d881e0fb3ec507f519012,593,26020,41756,15736,112,232,344,1,24,0,12,142,8.249460351,88721,1,1,6565,9333,2768,442520,656919,214399,3583,5283,1700,1,66.17142857,Arch
7fb1251c6ed769ea6877126957a03c5f95d42d8f,593,41756,26019,15737,232,112,344,1,36,0,12,142,8.250625074,72985,16,2,7594,8298,704,539211,557458,18247,4282,4561,279,1,66.17142857,Arch
b43a63ec9ff83f92884b5b5c27d7accbbf3afe47,593,26021,41757,15736,112,232,344,1,24,0,12,142,8.249447496,88722,12,2,6565,9333,2768,442531,656941,214410,3583,5283,1700,1,66.17142857,Arch
1a9fef48e767c2bb56b9fba5cac48540c5d6c6c1,593,41756,26020,15736,232,112,344,1,36,0,12,142,8.250619547,72986,17,3,7594,8298,704,539211,557480,18269,4282,4561,279,0,66.17142857,Arch
5a04fc7dc84cf0cc4e4c66703a96de36cfc546ff,592,26006,41722,15716,112,232,344,1,24,0,12,142,8.246641816,88286,0,0,6512,9280,2768,440917,655327,214410,3566,5266,1700,0,66.17142857,Arch
ef109c219544c0e8e6f1f91ff5ebced45b4f3392,0,0,0,0,0,0,0,0,0,0,0,0,0,0,13,3,0,0,0,0,0,0,0,0,0,0,100,NoArch
949941197df728d8bf811acd2a813332d2719e4b,0,0,0,0,0,0,0,0,0,0,0,0,0,0,51,1,0,0,0,0,0,0,0,0,0,0,100,NoArch
8cb86b4d36de2ee7f8360b715f9f85c635c71a90,592,41721,26005,15716,232,112,344,1,36,0,12,142,8.247814681,72570,0,0,7541,8245,704,537597,555866,18269,4265,4544,279,0,66.17142857,Arch
7c59095314f5525590eea308084079a31bde3e17,1,13,7,6,0,0,0,8,18,78,1,1,0,1164,2,1,80,79,1,10722,10688,34,28,27,1,1,100,NoArch
742c2040995167871db976fc0eb280347401ffc4,63,240,247,7,0,0,0,1,25,11,4,22,4.95132721,19721,21,4,1198,1198,0,138031,138044,13,721,721,0,1,93.78176383,Arch
a9a97d6af47841caaa745497ec425267db0873c8,1,10,0,10,0,0,0,12,17,127,1,1,0,405,0,0,53,51,2,2798,2686,112,15,15,0,1,100,NoArch
a68180b179ae57f16ff0a8d74b72b43b501d36c6,25,159,120,39,0,0,0,2,24,0,2,11,4.161370238,7801,140,0,410,413,3,56501,56158,343,242,247,5,1,100,NoArch
fb283934a33a0bc7b11f80e4149f7922fa4f0af5,8,36,4,32,0,0,0,5,23,86,2,7,2.228217073,3456,141,1,229,226,3,23448,23288,160,145,143,2,1,100,NoArch
6dcd0a3524fe7be0bbbd3e673ed7e1d4b035e0cb,601,29282,45284,16002,121,242,363,1,24,0,12,141,8.242249814,88366,138,4,6503,9527,3024,439717,681377,241660,3556,5414,1858,1,68.00404585,Arch
ae48ecbe232eb55267d1a138baeec13baa1fb249,6,32,2,30,0,0,0,5,22,177,2,5,1.822946565,3089,139,5,270,267,3,20701,20562,139,150,148,2,1,99.86625056,NoArch
e9cab67b8095b30205af27498dc0b279d188a454,601,45230,29313,15917,242,121,363,1,36,0,12,141,8.243115369,72394,1,0,7543,8440,897,537990,575996,38006,4258,4656,398,1,68.02698145,Arch
e0a5e0d3435acc5f01812aa46d96cc7d5eb65860,1,1,1,0,0,0,0,9,13,175,1,1,0,356,0,0,39,38,1,2061,2048,13,10,10,0,1,100,NoArch
2901f5423a08c8f0c5fe60c8a3f23acbd36c0aed,2,4,2,2,0,0,0,7,10,106,1,2,0.918295834,500,5,0,29,29,0,3203,3168,35,18,18,0,1,100,NoArch
97ab97b72635164db5ac2a4f93e72e224603ffe0,1,6,0,6,0,0,0,10,17,83,1,1,0,232,2,0,27,26,1,1428,1398,30,9,9,0,1,100,NoArch
84ca5b0cae72d9b33271045efee93a4cf1a0cff5,601,29323,45300,15977,121,243,364,1,24,0,12,141,8.243428483,88319,14,3,6506,9603,3097,439682,685390,245708,3558,5456,1898,0,67.97165035,Arch
7d40f19f395460bc78a12ac452831a9f0393ab49,601,45325,29317,16008,243,121,364,1,36,0,12,141,8.24403179,72342,7,0,7548,8512,964,538234,579891,41657,4259,4704,445,1,67.97165035,Arch
9e07cebece3b4c8b964ddca2f40053734a392ce2,1,1,1,0,0,0,0,8,11,146,1,1,0,140,1,0,9,9,0,741,741,0,8,8,0,1,100,NoArch
937566ee15c6a873258cb22f0cf78623f3c169fc,601,29320,45312,15992,121,243,364,1,24,0,12,141,8.241877602,88350,1,0,6513,9606,3093,439802,685583,245781,3560,5457,1897,1,67.97165035,Arch
22cd824d993bf43d88121ea89bad3a1f23a28518,601,45421,29459,15962,243,122,365,1,36,0,12,141,8.2465982,72358,2,1,7545,8526,981,538191,580182,41991,4261,4708,447,1,67.99594458,Arch
6318e943d168b961e4def3f37de47faf9ae44136,1,3,4,1,0,0,0,3,5,15,1,1,0,243,6,1,18,18,0,1196,1196,0,5,5,0,1,100,NoArch
3387b3841f784fef2bb8548375b8c2078bc03506,1,1,1,0,0,0,0,12,21,22,1,1,0,678,0,0,62,61,1,3394,3390,4,37,37,0,1,100,NoArch
37838cea6094ddc66191df42e8b2c84f132d1623,18,919,624,295,4,0,4,2,20,51,2,9,3.036372933,4960,2,0,359,347,12,36249,34799,1450,162,154,8,1,96.1058264,Arch
ce0c840ec1425536d7db33c2140497c48a164fdb,606,30077,46333,16256,123,248,371,1,24,0,12,143,8.276421452,88614,15,3,6513,9627,3114,439802,687624,247822,3560,5473,1913,0,64.85054862,Arch
df2e0c760e7df0bd1b200867b3f0d2ca3a3f1fce,606,46335,30074,16261,248,123,371,1,36,0,12,143,8.277710113,72358,1,0,7558,8535,977,539703,580710,41007,4269,4712,443,1,64.85054862,Arch
a7fd33162447b4c2816d1910bb166721cff1ed31,2,73,13,60,0,0,0,9,12,12,2,2,0.960627661,1885,7,0,75,73,2,14429,14098,331,45,43,2,0,100,NoArch
fcabc8fbca1670c9d50105495278ff147ccbdd4a,5,66,22,44,0,0,0,4,20,129,1,2,1.775664899,992,25,0,67,65,2,7701,7441,260,29,29,0,1,100,NoArch
31ef4acc59e82c55862e9170e7511a0a06024748,0,0,0,0,0,0,0,0,0,0,0,0,0,0,11,0,0,0,0,0,0,0,0,0,0,0,100,NoArch
ede6c9bda4dba8a9981252bd05f0725ff1024b95,5,47,15,32,0,0,0,10,37,117,1,4,1.489465215,1209,0,0,102,103,1,8110,7861,249,37,36,1,1,100,NoArch
043eb564c2c7e4578237b5d0f2bbad8276db51f4,2,35,0,35,0,0,0,7,10,118,1,2,0.660962335,718,1,1,41,39,2,5559,5273,286,21,20,1,1,100,NoArch
2a04647f5e7b33e7a4d658b1258d21cc947b6f94,0,0,0,0,0,0,0,0,0,0,0,0,0,0,18,0,0,0,0,0,0,0,0,0,0,0,100,NoArch
5099a91edd3aaba114a86251336ae98374722270,2,88,4,84,1,0,1,1,3,301,1,2,0.641541059,38,26,1,6,1,5,564,131,433,4,1,3,1,99.90183246,NoArch
f3a701757b9fb838acc4fb2975f378009d71f104,9,513,43,470,2,0,2,2,21,52,2,5,1.823141902,1851,27,2,171,157,14,17204,14045,3159,85,73,12,1,93.06989089,Arch
ab724af5c4e5b267919ee2a07ef41169f24924cd,4,15,15,0,0,0,0,1,3,53,1,3,1.825605199,1268,22,0,98,98,0,8869,8869,0,68,68,0,0,99.89241528,NoArch
8a9fdd603e3e532ea5252b98205acfb8aa648795,2,58,51,7,0,0,0,22,38,23,2,2,0.776890121,1414,23,1,201,201,0,7649,7575,74,156,156,0,1,100,NoArch
68a656b01650cfcd8c099dd04cea59fb083dca69,2,2,68,66,0,0,0,12,34,78,1,1,0.371232327,450,1,0,39,42,3,2650,2949,299,35,38,3,1,100,NoArch
89e37d5273ea1c6bf2fe3a8f7053e7a3cc44011d,4,52,12,40,0,0,0,2,10,91,3,4,1.638479541,1793,7,1,195,194,1,12090,11728,362,90,90,0,1,100,NoArch
5e476733417c3f92ea97d3e5f9a5c8bc48246e99,1,0,49,49,0,1,1,3,3,602,1,1,0,49,2,1,0,4,4,0,109,109,0,4,4,1,99.94617869,NoArch
2603cfb33e272632d7f36a53e1b13fe86dbb8627,53,1034,490,544,4,0,4,21,39,99,8,30,4.67675707,16139,13,0,1487,1431,56,104331,101309,3022,743,702,41,1,93.2347925,Arch
31247e9b3417871d90454c1c62f8d3bdcbd7ffa9,1,48,0,48,1,0,1,1,1,0,1,1,0,0,24,2,1,0,1,161,0,161,1,0,1,1,99.78947368,NoArch
8919be6a5d8038db7265bfd7459d72fbd545f133,11,208,179,29,1,1,2,21,36,58,3,9,2.859331798,4523,142,0,437,422,15,26570,26358,212,306,298,8,1,99.15840096,NoArch
2be924fd3a04e2106f1ad3f9ce91890ea58c8a88,4,57,154,97,0,0,0,7,15,85,1,4,1.629151319,3200,1,0,168,175,7,22190,22956,766,91,93,2,1,99.75932611,NoArch
37ea79566de190605d0a941d6b65e2f46196de88,1,12,1,11,0,0,0,10,16,72,1,1,0,193,0,0,27,25,2,1099,1049,50,6,4,2,1,100,NoArch
574dcf920c4677513f6fdc8d441bb42827afa5a2,0,0,0,0,0,0,0,0,0,0,0,0,0,0,0,0,0,0,0,0,0,0,0,0,0,0,100,NoArch
3b9a30528bd6a6369181702303f3384162b04a7f,14,579,396,183,6,0,6,1,8,87,3,6,3.231904088,1421,25,1,93,95,2,9868,9357,511,61,61,0,1,99.519952,NoArch
be85a6c32bd9ef1931f2af7d268a7e0cb8631002,2,54,2,52,1,0,1,9,13,67,1,1,0.371232327,100,8,0,15,12,3,458,377,81,9,6,3,1,99.88045427,NoArch
8c4ff185f1752b5041c4e66ac595bd90c2693137,0,0,0,0,0,0,0,0,0,0,0,0,0,0,0,0,0,0,0,0,0,0,0,0,0,1,100,NoArch
7b2a947aed5649f8cbbade748e464e1228da6e5d,11,53,49,4,1,0,1,2,19,64,1,7,2.587943063,6922,26,2,371,380,9,49906,49869,37,210,214,4,1,99.85079081,NoArch
086853c004c6581e08744c5900210b6aaffd90e4,2,90,14,76,1,0,1,10,14,18,1,2,0.98285869,1009,8,0,151,142,9,6234,5990,244,58,48,10,1,99.00990099,NoArch
d58644b6573152ac191a1119c395d71cdc7c9c7d,2,42,5,37,0,0,0,11,19,74,1,2,0.784992089,545,1,0,38,39,1,4318,4115,203,21,20,1,1,100,NoArch
c7f1a781ab4ff3784d53a102364fd85e379811d1,14,667,67,600,6,0,6,23,40,86,2,4,3.143256006,1151,11,0,178,115,63,8855,5945,2910,84,30,54,1,99.19210054,NoArch
9627a385febbc8769021e7d0a805756b74c2a82a,7,404,51,353,2,0,2,11,28,43,2,5,2.189446223,1036,12,1,146,110,36,7728,6090,1638,63,46,17,1,99.88151659,NoArch
abfebd30f30d7a5975e3ecea403fec13d5d27cd5,2,2,2,0,0,0,0,7,37,103,1,1,1,1022,0,0,96,96,0,5722,5722,0,44,44,0,0,100,NoArch
20ac7c3337a14dd777f6ebe21b13dab2786f2479,1,6,36,30,0,0,0,2,3,111,1,1,0,125,27,3,7,10,3,617,812,195,6,8,2,1,100,NoArch
10e457278bee529d14e445012fa61e875e3f77cd,1,1,1,0,0,0,0,10,12,316,1,1,0,224,0,0,20,20,0,1322,1322,0,16,16,0,1,100,NoArch
21bb1b505a0a433bdbe367f7f252afdddafafc96,4,202,48,154,0,0,0,3,17,101,1,4,0.814857025,1630,19,0,132,113,19,12594,11510,1084,68,60,8,1,100,NoArch
f5dc8ca733014d15a6d7966a5b6ae4308868adfa,4,177,129,48,2,0,2,1,20,59,1,2,1.455647107,1038,28,3,82,84,2,7293,7172,121,44,46,2,1,99.88179669,NoArch
b399b4ad43b8caa69f129e756e51ad4bc8c81de2,7,138,72,66,1,0,1,1,5,3,1,4,2.212994362,753,29,4,41,37,4,5342,4638,704,31,27,4,1,93.78898129,Arch
bf1d36fa639cae558aa388d8d547e58ad2e67aba,1,4,3,1,0,0,0,4,4,57,1,1,0,271,4,0,39,39,0,1909,1875,34,7,7,0,1,100,NoArch
1aae437257cfd94fd277cf667257f6abffcc0c21,4,260,0,260,2,0,2,18,29,23,2,4,1.371872567,881,7,0,140,111,29,6058,4481,1577,75,61,14,1,99.88407141,NoArch
b71f25f210c4004a2dcc97a9967399e74f870fc7,24,67,10,57,0,0,0,9,27,156,2,16,3.46346269,6787,14,0,537,534,3,47252,46754,498,240,239,1,1,100,NoArch
1ec89e9a94161aa5d48b8f170bf67633b389d997,44,2021,586,1435,11,1,12,2,34,71,4,17,4.766209811,12986,2,0,1251,1138,113,93673,84492,9181,766,698,68,1,94.01686874,Arch
5e7ab11e2ead23428ed5089421f2abd6433fe8e5,2,187,149,38,1,0,1,1,20,20,1,1,0.995676386,600,30,4,45,47,2,5186,5002,184,23,24,1,1,98.66548043,NoArch
743ef322b88d90be9775b889f6381925cdda5f35,2,4,1,3,0,0,0,2,4,188,1,2,0.721928095,126,0,0,8,8,0,492,475,17,6,6,0,1,100,NoArch
12ef8c9249249a3c02e6bd8f0392614f8e195982,7,227,49,178,2,0,2,3,11,236,1,5,2.441056773,407,28,0,62,42,20,2491,1701,790,35,23,12,1,99.74137931,NoArch
5b6026ba436f7bde0e810983b6934d07dbe46e8d,6,166,25,141,1,0,1,2,19,98,3,5,1.85022312,2367,20,1,222,217,5,16674,15836,838,128,122,6,1,99.88535397,NoArch
9bd37ef2912eefc7bbc34382525032570d6f9c60,1,11,7,4,0,0,0,11,20,0,1,1,0,1216,60,0,79,78,1,8648,8611,37,42,41,1,0,100,NoArch
a8bd76c299b13af93c9eed92309ecb3a86a6734c,5,372,211,161,2,0,2,1,24,59,1,3,1.641421185,1364,61,1,108,103,5,9488,8404,1084,66,61,5,1,99.88558352,NoArch
3dd189ec7d748eecb3750521870130fb81f17842,1,1,1,0,0,0,0,11,21,0,1,1,0,1220,62,2,79,79,0,8648,8648,0,42,42,0,0,100,NoArch
c39778c150ad2d5f38af4628fea21de4c191d3ca,5,134,0,134,1,0,1,2,35,87,1,4,1.905603617,1122,0,0,182,167,15,6251,5617,634,175,162,13,1,99.85722444,NoArch
f61cd1086ae8014b2e1da129dccfe47b64116369,0,0,0,0,0,0,0,0,0,0,0,0,0,0,61,0,0,0,0,0,0,0,0,0,0,1,100,NoArch
da106803b6d0bdbb37f22b9bd73b9b3a77f77063,10,616,0,616,8,0,8,1,36,0,1,9,3.053556476,1120,12,0,220,174,46,8449,5941,2508,200,162,38,1,99.40357853,NoArch
c3279cd5989805946267b046007ea23ba4b615c2,2,63,5,58,0,0,0,5,9,8,1,2,0.638514626,542,9,0,51,48,3,4469,3953,516,22,21,1,1,100,NoArch
467d097dae5d38bfba8e1249ab52fe0f294e6172,2,4,1,3,0,0,0,3,5,8,1,2,0.721928095,129,3,0,8,8,0,509,492,17,6,6,0,0,100,NoArch
0cb24e4a2defd8e639437b6cd145a26f038ef1af,3,16,17,1,0,0,0,4,8,140,1,3,1.349548553,936,31,4,92,92,0,7070,7078,8,62,62,0,0,100,NoArch
ca36c44cb3a081ce68282742f177f471fb7ed8c3,57,455,421,34,2,1,3,1,28,51,5,22,4.146839851,17836,32,4,1072,1099,27,128128,129051,923,625,645,20,1,99.4635799,NoArch
fa419213f62d2006aeea228180302024977feb16,6,393,7,386,3,0,3,1,12,146,3,4,1.708540705,606,29,1,86,60,26,5855,3752,2103,45,33,12,1,99.63390594,NoArch
5e7931b1f9d586a44bcfa13e21917b24d4f78596,1,1,1,0,0,0,0,2,2,0,1,1,0,190,8,1,11,11,0,1198,1196,2,5,5,0,0,99.80320495,NoArch
b2763f433b3efb92fdcc0e760a88a43eaa2e5be3,1,2,2,0,0,0,0,7,12,214,1,1,0,282,21,1,27,27,0,1464,1464,0,27,27,0,0,100,NoArch
d5b593b7d952a39679cade2b18aadbdfb2dc3eed,1,1,1,0,0,0,0,15,20,97,1,1,0,158,13,0,14,14,0,971,971,0,8,8,0,0,100,NoArch
2fc2b01d8647aafe2862db14fc169aa40d4ae3d5,84,6105,56,6049,65,0,65,1,41,27,6,31,5.882469828,4815,77,0,1092,532,560,61608,28306,33302,570,234,336,1,95.50236718,Arch
ccd70a7e486850ca6ce4d7fcc806e396ff0b6aa0,23,626,136,490,6,0,6,2,37,86,2,11,3.834263733,4091,5,0,455,423,32,25347,23075,2272,341,318,23,1,94.04151404,Arch
727f1df62c343ca3649678f6e28ec7914ea7d247,2,18,4,14,0,0,0,3,19,54,2,2,0.845350937,663,6,0,52,52,0,3717,3651,66,39,39,0,0,100,NoArch
e79fbc07fe803bc51cdf4f11948b133bbaa70595,10,130,53,77,0,0,0,2,38,17,2,7,2.262219571,4055,9,2,417,408,9,24925,24228,697,298,295,3,1,99.9275887,NoArch
10e426879237b636f8b5913ac931dd7f8af8b817,22,292,265,27,2,1,3,2,29,36,4,12,4.066680745,8351,33,3,543,539,4,63151,63163,12,307,306,1,1,99.68469561,NoArch
30dcd5cf06c3f48bbdde1e18403ff7d0556ca511,12,2,35,33,0,0,0,2,2,1,1,9,3.388262069,1414,13,1,129,129,0,8522,8977,455,61,61,0,0,99.90246281,NoArch
4ebd2db05b9c272ab8676e82a4113f46701c2aef,1,1,1,0,0,0,0,12,13,18,1,1,0,306,14,1,34,34,0,2075,2075,0,23,23,0,0,100,NoArch
8aa9142de85e7a87f42ee43659024cb10c7b43a7,0,0,0,0,0,0,0,0,0,0,0,0,0,0,34,4,0,0,0,0,0,0,0,0,0,0,100,NoArch
433d7d2c9886fed161557efe88b62ebdce0fe5df,7,198,40,158,1,0,1,1,42,12,4,7,2.212457867,2818,10,1,368,360,8,17305,16307,998,259,252,7,1,99.95121951,NoArch
266bce12b32ae5dc35e04d1c25530df9257d5dc9,1,1,1,0,0,0,0,4,5,9,1,1,0,80,22,2,3,3,0,524,524,0,1,1,0,0,100,NoArch
539621bd33893d99a07b8f739a1e965ca72acdc9,136,6839,777,6062,44,0,44,2,43,84,7,47,6.140715711,23786,63,3,2898,2344,554,179347,144054,35293,1703,1372,331,12,91.41401892,Arch
ab11ba43e1a5496cf85a7a772929bb90fcbf07d3,8,41,200,159,0,1,1,2,44,0,4,8,2.276782324,3120,23,3,377,385,8,17243,18254,1011,267,274,7,1,99.95171415,NoArch
d3711a26415703c3db412ad3102856ce15459cde,1,6,0,6,0,0,0,5,8,2,1,1,0,282,1,0,26,26,0,1915,1867,48,14,14,0,1,100,NoArch
217a84192c594929963856d2224b9282a71c4048,7,248,9,239,1,0,1,3,40,103,1,3,1.753047247,2637,0,0,272,234,38,18695,17301,1394,132,124,8,1,99.90345161,NoArch
61e027fadda4cefc56a18bc284267d34b336f6cc,1,17,2,15,0,0,0,12,15,4,1,1,0,311,143,0,36,35,1,2208,2096,112,23,23,0,0,100,NoArch
7a2429f5ba45e3c3c6f4e167fdc5b79be716febb,13,457,171,286,2,0,2,7,41,47,5,7,2.615755586,3364,144,1,359,340,19,21225,19515,1710,168,159,9,1,99.75932611,NoArch
9bcd3221fd440081dbae70e89d08539c3b484862,2,22,8,14,0,0,0,4,17,154,1,2,0.948078244,306,145,2,31,30,1,1933,1837,96,9,9,0,1,100,NoArch
c21209cb58a5cff3267aca9f17fe7d2c4edd3190,4,122,1,121,2,0,2,1,10,66,1,2,1.210210948,101,15,0,17,7,10,797,349,448,8,1,7,1,99.83205374,NoArch
51ea27d665d8053895dd047ca85e3338b357a81d,25,1209,133,1076,8,0,8,5,45,0,2,9,3.103545903,4296,3,0,599,493,106,32357,25897,6460,235,188,47,1,98.18659031,NoArch
b51646dcc76acc68e97dd6a67cc7557e362b590d,1,1,1,0,0,0,0,25,43,1,1,1,0,677,14,1,90,89,1,3726,3722,4,29,29,0,1,100,NoArch
ab453f26235c67fa3536b494c6c9f9c31e265ef8,4,95,52,43,0,0,0,2,2,8,2,3,1.258715753,1107,10,2,87,80,7,9271,8828,443,40,38,2,1,100,NoArch
4f74a84607d46249e9bb6e1397246f8dc076b390,9,51,37,14,0,0,0,3,22,28,4,6,2.941589811,2930,4,1,271,269,2,19818,19770,48,137,135,2,1,99.59475566,NoArch
8b66524090a5f21a11c2546580c952aa917bd0ad,3,0,6,6,0,0,0,13,17,10,1,3,1.459147917,637,0,0,69,69,0,4118,4184,66,38,38,0,0,99.88041138,NoArch
1072f2748a3e6802b0c1c9492edf7573779645ac,1,3,3,0,0,0,0,6,7,35,1,1,0,352,0,0,43,43,0,1406,1402,4,25,25,0,1,100,NoArch
5ee676e34fa2429d02ecd1a3cf7f586518ed2081,2,13,16,3,0,0,0,1,7,27,2,2,0.79732651,283,35,3,28,30,2,1959,1986,27,15,15,0,0,100,NoArch
9fe2d2b14a2a0f465d75e39fdfdcc4d5e0101ee7,10,441,28,413,2,0,2,13,22,22,5,8,2.323077205,4120,5,0,342,312,30,32858,29643,3215,173,160,13,2,99.88055423,NoArch
3c949d2ff5527a698d703f64923095dd931d3b66,0,0,0,0,0,0,0,0,0,0,0,0,0,0,15,2,0,0,0,0,0,0,0,0,0,0,100,NoArch
6b349b771198d463b0ffd5f45e22846db95c2238,10,493,2,491,6,0,6,1,42,8,1,4,2.857479509,1254,3,0,229,192,37,8484,6323,2161,213,184,29,1,99.57183635,NoArch
c24c528fb7275a3ee1db4774f321dfc075b4f8a8,0,0,0,0,0,0,0,0,0,0,0,0,0,0,0,0,0,0,0,0,0,0,0,0,0,1,100,NoArch
e4a2d98f79f920ea60346fb78ef4b5af1f874afd,7,86,19,67,0,0,0,4,12,67,4,7,2.24477764,2586,11,3,283,276,7,17994,17514,480,164,161,3,1,99.83400522,NoArch
ff53e8f0b62448815a487285ce0cc337398272f2,22,1521,264,1257,10,0,10,1,28,8,3,8,3.802075038,3626,24,3,485,380,105,28820,21357,7463,232,187,45,1,99.24314096,NoArch
858eda85d7a5e4ee3be9aa28e7e7311bc8fb8983,6,349,100,249,1,0,1,1,32,167,2,4,2.372396726,2257,25,4,208,178,30,14699,13382,1317,124,108,16,1,99.22161172,NoArch
934f00b68976b68b9393406d83b9953811de90b4,0,0,0,0,0,0,0,0,0,0,0,0,0,0,4,1,0,0,0,0,0,0,0,0,0,1,100,NoArch
b2e703d4427abca02b053fa4444cd5058aa256ef,20,666,491,175,3,1,4,5,27,21,2,12,2.968730667,5817,36,3,484,467,17,41611,40619,992,279,264,15,1,99.82222222,NoArch
9c24151929659f80f88607f068662fdc5855fc91,2,7,7,0,0,0,0,14,21,14,1,1,0.591672779,738,26,5,53,53,0,4111,4108,3,40,40,0,1,100,NoArch
626f78f6f639cae2d3d57d29e7ef0642cb0be7ee,20,491,666,175,1,3,4,6,28,0,2,12,2.968730667,5992,146,3,467,484,17,40600,41632,1032,264,279,15,1,99.82222222,NoArch
8b928e9bca5ecac8f956b17e5d18f2deaf526253,19,703,161,542,4,0,4,4,43,125,3,11,3.091833414,5368,6,1,607,549,58,39027,35220,3807,412,381,31,1,99.55614736,NoArch
8d0426826472f5b861b6bd7c43d8935917431467,3,19,10,9,0,0,0,5,17,172,1,3,1.334599426,441,12,3,46,45,1,2808,2702,106,17,17,0,1,100,NoArch
379cf0786fe9fea94ec8c0da7d467ae2fb30dd0b,54,4178,467,3711,29,3,32,1,35,17,3,18,5.183131611,3931,27,5,702,366,336,44956,22693,22263,379,214,165,1,96.03208105,Arch
9bde6d616c5ee2ef131037af5b5527a0717cc527,11,171,0,171,3,0,3,5,12,233,4,8,2.911708825,617,64,1,34,34,0,2754,2080,674,21,21,0,1,99.45498587,NoArch
b8f4a30efd8bb6257c926a4b79a092cb96b8aff8,4,35,19,16,0,0,0,9,22,6,2,3,0.973128405,954,147,4,54,53,1,5879,5762,117,22,22,0,0,99.93935719,NoArch
efb3025003cd2c1c22e64ec7580450b14f96a190,0,0,0,0,0,0,0,0,0,0,0,0,0,0,16,2,0,0,0,0,0,0,0,0,0,0,100,NoArch
85a17b2c48c9ac05d84321a261f9f07f245df31c,0,0,0,0,0,0,0,0,0,0,0,0,0,0,17,2,0,0,0,0,0,0,0,0,0,1,100,NoArch
62c297e2ffa891bd19c1ea402293abcfd0074c59,3,41,28,13,0,0,0,1,6,86,1,2,1.316696865,393,13,0,47,45,2,2061,1967,94,16,15,1,1,100,NoArch
b6d363c0d4a6906ef1c9ea54c0263c6b5915e0b6,0,0,0,0,0,0,0,0,0,0,0,0,0,0,18,2,0,0,0,0,0,0,0,0,0,0,100,NoArch
bedbb825e06d479f90bb09d09be4ade37fdaa8b3,6,292,0,292,4,0,4,1,14,91,2,4,2.295188423,985,2,0,194,171,23,6888,5440,1448,154,136,18,1,99.77804681,NoArch
824f23bcb8b017aca44a6fbd8af41f4170e1eee0,0,0,0,0,0,0,0,0,0,0,0,0,0,0,17,2,0,0,0,0,0,0,0,0,0,1,100,NoArch
85a17b2c48c9ac05d84321a261f9f07f245df31c,6,0,292,292,0,4,4,0,13,22,2,4,2.295188423,1277,17,2,171,194,23,5440,6888,1448,136,154,18,1,99.77804681,NoArch
6fa371a79c27aa532700b5f1eecf5933fc618693,6,292,0,292,4,0,4,1,14,91,2,4,2.295188423,985,18,3,194,171,23,6888,5440,1448,154,136,18,0,99.77804681,NoArch
1137b0b3434a788fa42a17e5755af8ffb0d3f473,2,16,8,8,0,0,0,3,21,90,1,2,0.870864469,969,0,0,80,79,1,6959,6935,24,43,41,2,0,100,NoArch
a2312fa1b79609e35a9c7f775eb1d76cd0c0754a,3,41,28,13,0,0,0,1,6,86,1,2,1.316696865,393,13,0,47,45,2,2061,1967,94,16,15,1,1,100,NoArch
62c297e2ffa891bd19c1ea402293abcfd0074c59,8,8,308,300,0,4,4,0,20,47,2,6,2.574755102,2254,13,0,250,274,24,12375,13847,1472,177,197,20,1,99.77804681,NoArch
bd7814dadf9f6f5faa5b9ab61ff5f6bbfe5da5e2,10,310,13,297,4,0,4,1,21,80,2,8,2.688388049,2177,15,1,291,267,24,14820,13377,1443,206,186,20,1,99.77804681,NoArch
b883b6d2682a3043eaf263c86182b19922660fd9,6,250,17,233,3,0,3,26,46,35,2,5,1.936421158,790,16,1,91,79,12,5441,4379,1062,38,30,8,1,99.75864843,NoArch
34c8c9e3ea068f969b4ffa263071b79bf1d11bd5,2,2,3,1,0,0,0,2,2,16,1,2,0.721928095,185,17,2,17,17,0,774,776,2,8,8,0,0,99.91964644,NoArch
3a2ae16961131ed22e3b09877ff00cc42d47aa7d,22,686,545,141,3,1,4,7,29,22,3,13,3.079255343,6326,37,2,520,508,12,45387,44440,947,291,281,10,1,99.83948636,NoArch
bfdce7b082256f3f6c51321e102284191e847145,0,0,0,0,0,0,0,0,0,0,0,0,0,0,5,2,0,0,0,0,0,0,0,0,0,1,100,NoArch
1d09c02f1cb9a3929995fb6df1bb7d58cdcb3eb3,3,124,33,91,1,0,1,5,15,30,1,2,1.544686632,601,11,0,58,51,7,4874,4485,389,28,22,6,1,99.93990385,NoArch
7291607ae31dc9fc887b6af79e8275f42da6b50a,1,0,3,3,0,0,0,6,9,305,1,1,0,206,2,0,13,13,0,1174,1207,33,11,11,0,0,100,NoArch
b6d363c0d4a6906ef1c9ea54c0263c6b5915e0b6,42,593,1351,758,0,10,10,26,45,8,4,27,4.216673318,10761,18,2,920,975,55,66204,70029,3825,527,571,44,0,99.23541247,NoArch
35b21855da209c812e006c1afff3d940d5ac2a18,49,1481,675,806,10,1,11,26,46,22,5,32,4.49627778,11299,18,3,1126,1061,65,77512,73308,4204,627,579,48,1,99.15492958,NoArch
f8dcd5334effb0157cfa764c4f6a08976eb346e1,4,19,34,15,0,0,0,2,11,252,1,3,1.945517902,671,19,4,77,79,2,3631,3714,83,40,40,0,1,100,NoArch
111a9753a0dc8a8634a5aaf549ceff5cbd89bcb8,0,0,0,0,0,0,0,0,0,0,0,0,0,0,38,2,0,0,0,0,0,0,0,0,0,0,100,NoArch
ea983ff912dab8604eec3085bc1c041cb6e60bc8,4,21,6,15,0,0,0,9,23,66,2,4,1.547954857,646,9,0,68,68,0,4410,4292,118,26,26,0,1,100,NoArch
f7e02aa8a309bfaa3e5c9c2f2523c82715628df3,0,0,0,0,0,0,0,0,0,0,0,0,0,0,19,3,0,0,0,0,0,0,0,0,0,0,100,NoArch
9b1f16b604143f5a6926db57173f9eeee21fbb6c,2,12,0,12,0,0,0,4,24,153,1,1,0.979868757,676,16,0,81,80,1,3066,3004,62,68,67,1,1,100,NoArch
218d4a6836ce86216d289fa5fbb389871ad7ba0f,3,24,4,20,0,0,0,8,13,265,1,1,1.442604943,897,17,1,97,94,3,5329,5190,139,70,67,3,1,100,NoArch
6a4dc7384c8f7efbbce729b8e57b3eaaf5cab104,4,34,12,22,1,0,1,2,44,46,1,3,1.510389395,1199,3,1,193,193,0,6287,6286,1,186,186,0,1,99.93995196,NoArch
492ddcbb06e107618ae71fa369ba07af47a036fb,3,319,21,298,2,0,2,2,2,19,2,3,1.22649699,189,10,1,46,21,25,3116,968,2148,21,12,9,1,99.90037856,NoArch
cc555ba1882ba12724a34953db042f719519534a,2,3,3,0,0,0,0,9,12,500,1,2,0.918295834,805,3,0,97,97,0,3045,3043,2,61,61,0,1,100,NoArch
7e68c42eb19bfe955217f0e8e25acbeb4a6974b5,1,0,27,27,0,0,0,19,38,65,1,1,0,231,20,5,22,26,4,1520,1617,97,20,24,4,1,100,NoArch
df8f099c999379038bf189491ff71dfb958806dd,15,67,0,67,0,0,0,2,19,63,1,9,3.672328555,1718,21,6,100,100,0,11313,11313,0,80,80,0,1,100,NoArch
f468c20c6cb237c1d190989045f397758db8d685,3,25,2,23,0,0,0,2,9,49,1,2,1.173012585,241,11,2,31,29,2,1613,1395,218,12,11,1,1,100,NoArch
dedc4517dd7014af697169130f5a72c1e90469b7,0,0,0,0,0,0,0,0,0,0,0,0,0,0,30,0,0,0,0,0,0,0,0,0,0,1,100,NoArch
3a578d740234db9c44e6b9f8d27d21713eb5f386,0,0,0,0,0,0,0,0,0,0,0,0,0,0,28,1,0,0,0,0,0,0,0,0,0,1,100,NoArch
fa812482473f0cc8c2f34e2db07366cc3e5f7066,20,171,3,168,0,0,0,2,29,75,2,6,3.515488067,2308,22,7,269,269,0,12062,12062,0,118,118,0,1,100,NoArch
4dbeabffa3b2b9f30c48f2deae3ea4f91570afdd,2,73,3,70,0,0,0,1,2,8,1,2,0.967788463,314,12,3,33,27,6,2911,2280,631,14,10,4,1,100,NoArch
0360bef2173e95462975eb967424ec9f68b74123,1,19,32,13,0,0,0,9,25,24,1,1,0,1227,39,2,75,77,2,9705,9724,19,30,32,2,0,100,NoArch
6b417d1a867c51dad174fce7c68dd7a3146931b5,0,0,0,0,0,0,0,0,0,0,0,0,0,0,2,0,0,0,0,0,0,0,0,0,0,1,100,NoArch
6df8f88d86a20bbabeb0acc1103376ac6f461df6,1,0,45,45,0,0,0,4,7,54,1,1,0,106,23,8,3,9,6,335,697,362,2,7,5,1,99.96031746,NoArch
6461927eac3f8a225b17af5ecb6ace8c9cf1757b,51,2184,294,1890,9,1,10,14,45,64,4,24,4.277682464,15364,18,2,1368,1181,187,115202,103178,12024,826,732,94,1,98.69827084,NoArch
48a58c98a11ec9d5d3f40c07f23e64a1d5ccd6e6,2,18,5,13,0,0,0,2,5,38,2,2,0.558629373,660,5,0,79,75,4,3806,3760,46,23,23,0,0,100,NoArch
8d19ebfd0f1edc412332045ca6ba10f50af01d9f,17,230,15,215,1,0,1,3,46,53,5,13,1.519903648,7739,1,0,584,568,16,56077,54576,1501,395,383,12,1,99.96193376,NoArch
6537af26761ca785aaf4f8e9158909205875c1bf,3,25,13,12,0,0,0,3,37,74,2,3,1.361258844,570,1,0,61,59,2,3249,3223,26,29,28,1,1,100,NoArch
83e39e2b179fb1db13f1c4865a1849855fc32b65,13,426,467,41,1,0,1,2,30,42,3,9,3.41010644,4141,40,2,295,281,14,32153,32676,523,162,148,14,1,99.96199164,NoArch
fe7c9e71eb0aa365306c2d91da82234a96a5c1c6,1,26,13,13,0,0,0,2,3,192,1,1,0,137,19,1,10,7,3,635,586,49,6,6,0,0,100,NoArch
51b16bd36fd7b49f453bfbfcfb1e344ca14ca11a,0,0,0,0,0,0,0,0,0,0,0,0,0,0,0,0,0,0,0,0,0,0,0,0,0,0,100,NoArch
e3cf34dff924fe6d93ad5e7c603d3095a8714e38,0,0,0,0,0,0,0,0,0,0,0,0,0,0,6,1,0,0,0,0,0,0,0,0,0,0,100,NoArch
2fee087f0f167370570a88b6d9d28ddbe8402a3e,4,64,93,29,0,0,0,27,47,26,3,4,1.579781294,1613,7,0,174,180,6,9966,9944,22,72,75,3,1,100,NoArch
53d1e551108c6fcde3b39f0080b64996892256de,14,99,38,61,0,0,0,4,39,88,5,11,2.815974301,2933,3,0,347,338,9,17653,17383,270,163,157,6,0,99.98102467,NoArch
fec7cd3c9704ce366d1d92fd4d9941a7edbe8198,6,133,26,107,1,0,1,4,4,46,1,5,1.716792304,691,4,0,85,72,13,4172,3587,585,64,55,9,1,99.45252029,NoArch
063a98fc2b76beac28a4797884973abd2911c887,2,100,7,93,1,0,1,1,2,245,1,2,0.750844664,97,1,0,28,21,7,933,442,491,20,14,6,1,99.83108108,NoArch
a1cff8abae9d9dab87d439c90451da73cc71eebf,3,201,1,200,2,0,2,1,6,36,1,2,1.173328429,86,0,0,22,11,11,1451,303,1148,13,6,7,1,99.90631441,NoArch
5e61454a6c343225e6ca90c4be79e0c2937a748a,2,151,4,147,1,0,1,1,4,368,1,2,0.605789252,68,148,0,16,6,10,1035,227,808,9,3,6,1,99.9251637,NoArch
6c84ef20ac737087ed76c12b2f3e40d9c3aa4b30,1,13,0,13,0,0,0,12,20,206,1,1,0,240,6,0,26,24,2,1466,1411,55,10,9,1,1,100,NoArch
581d54097c89e5f9c04d8f606c9081dc17138bd5,8,39,38,1,0,0,0,3,14,142,6,7,2.437969174,2930,0,0,249,249,0,21337,21347,10,141,141,0,1,100,NoArch
3201665295122a892c8ade92aca5f72426a403fd,9,204,171,33,0,0,0,4,28,65,4,7,2.623018833,3401,41,1,296,286,10,25119,25012,107,180,169,11,1,100,NoArch
bf65269f66075069b421dfa25f90b105bc4ec662,0,0,0,0,0,0,0,0,0,0,0,0,0,0,13,0,0,0,0,0,0,0,0,0,0,1,100,NoArch
73e5b4c7bbd1306a6a2686f6e8d85a2c871ac7ff,3,79,8,71,0,0,0,3,24,141,1,2,1.038310845,774,14,0,72,69,3,6612,5889,723,27,25,2,1,100,NoArch
7c45894f432387463b05c096bfe15d196e596ef5,7,241,233,8,0,0,0,9,19,145,2,4,2.201329219,2572,42,2,249,266,17,18338,18741,403,163,162,1,1,100,NoArch
c8e19e2def0c33415bc3945ffb81f524c484c924,11,286,32,254,4,0,4,5,48,123,1,6,2.956177695,3037,8,0,318,299,19,20712,19700,1012,151,137,14,1,98.50905218,NoArch
80870165044ed675d2c40d05eb04740bc6b9216a,1,3,0,3,0,0,0,3,3,130,1,1,0,141,0,0,13,13,0,686,661,25,13,13,0,1,100,NoArch
fcc497eff11f128b2c1feaa5ced6c340b6b41849,3,39,3,36,0,0,0,6,9,81,1,3,1.503889287,908,4,0,100,95,5,5338,5202,136,45,43,2,1,100,NoArch
d37977b310713f59ddbecb3c6127d9e86414a8b0,1,0,2,2,0,0,0,15,23,66,1,1,0,445,8,1,18,18,0,1969,1973,4,18,18,0,0,100,NoArch
83d2e03cf7f51059c292c2acf1d124fe69259d65,0,0,0,0,0,0,0,0,0,0,0,0,0,0,65,0,0,0,0,0,0,0,0,0,0,0,100,NoArch
6837118c21d2575cfba0486b0a7344f55d41675f,3,6,5,1,0,0,0,3,15,180,2,3,1.435371391,287,0,0,21,21,0,1487,1497,10,11,11,0,0,100,NoArch
2eaba0962a67d72000a3b1033f5f3d5bde5f4d7f,2,13,3,10,0,0,0,8,12,332,2,2,0.988699408,434,31,0,40,39,1,3015,2959,56,12,12,0,1,100,NoArch
1dd6635fbbe0e8bb9e2844d1b78c916e8ddaf7c1,1,1,1,0,0,0,0,13,15,28,1,1,0,223,24,0,20,20,0,1320,1320,0,16,16,0,0,100,NoArch
ae68b2b355a9dd23ff9fd1dd3f5637039b02c14a,9,66,46,20,0,0,0,6,29,250,4,8,2.145035982,4121,1,1,344,344,0,27374,27374,0,178,178,0,0,100,NoArch
1be0b06ef8839c46318cfa900f18ac6e237d928b,10,206,242,36,0,0,0,7,30,125,3,5,2.858443772,3126,43,2,178,182,4,22047,22037,10,100,102,2,1,100,NoArch
b0f1b736f8f16253cf7522589a343ef384d7d407,1,1,1,0,0,0,0,6,10,0,1,1,0,291,32,0,28,28,0,1031,1031,0,13,13,0,0,100,NoArch
a86f5574ed68333f03165ae560a4d88812ba7478,4,37,9,28,0,0,0,2,40,110,2,2,1.461577342,1072,7,1,129,123,6,6793,6632,161,48,47,1,1,100,NoArch
c0c0095fa96636d620c5ff428610d75aee902d74,0,0,0,0,0,0,0,0,0,0,0,0,0,0,12,0,0,0,0,0,0,0,0,0,0,0,100,NoArch
20b9b399c980270afdd60cc5fbce783c700a8376,7,59,15,44,0,0,0,12,49,153,1,5,2.720009443,1878,8,2,198,191,7,12824,12406,418,80,78,2,1,98.60226469,NoArch
32c9cad52c7eef1067f12867afc405a1624cef14,3,83,53,30,0,0,0,2,11,336,1,2,0.607892608,1908,32,1,90,86,4,15014,14890,124,53,52,1,1,100,NoArch
a99e93bed542c8ae30a641d1df616cc2cd5798e1,52,1967,347,1620,7,0,7,7,41,160,4,22,4.887126963,16236,4,0,1768,1610,158,116804,105038,11766,1079,967,112,1,99.00432087,NoArch
5aaaf8bff17fcff595aa3927b45f4928e0d400e8,1,2,2,0,0,0,0,5,5,63,1,1,0,121,13,1,11,11,0,584,584,0,4,4,0,0,100,NoArch
1f7add92916c37b05be270d9c75a9042134ec506,366,6106,4909,1197,37,20,57,5,50,9,6,119,6.988191966,50456,25,1,4043,4099,56,314786,313226,1560,2371,2384,13,1,72.83480353,Arch
6c610b91efad789db7d5b7d8dbe7503f63427de9,3,30,9,21,0,0,0,2,2,6,1,2,0.991264261,230,20,0,29,24,5,1015,936,79,18,15,3,1,100,NoArch
080ba3ed54fc12942d7ce8326435d80a46fb48bf,0,0,0,0,0,0,0,0,0,0,0,0,0,0,15,0,0,0,0,0,0,0,0,0,0,1,100,NoArch
b335459c805748815ccc858ff1a9ef4cd830da8c,4,25,4,21,0,0,0,28,51,39,3,4,1.40210521,1087,12,0,126,121,5,6412,6281,131,47,45,2,1,100,NoArch
fdae388626b8d97acc01191aa0e7075c36a41132,4,48,8,40,0,0,0,9,13,140,2,4,1.373188898,1468,5,1,237,225,12,7935,7636,299,212,209,3,1,100,NoArch
fed01cd3c94bb340976fc214fb199b0c891365fe,1,1,1,0,0,0,0,11,17,12,1,1,0,100,0,0,8,8,0,605,605,0,3,3,0,0,100,NoArch
524193eb4bd45eb21a64c68e927600a52b9ade1d,9,252,57,195,2,0,2,1,52,67,2,6,2.601304744,1800,16,1,217,198,19,10525,9800,725,79,69,10,1,99.63929557,NoArch
788d236c443eb4ced819f9305ed8e0460b5984b7,11,132,122,10,0,0,0,10,53,120,2,8,1.755307303,2615,21,1,333,329,4,15617,15492,125,146,145,1,1,99.97876858,NoArch
1d1d91d444b6af2b24b17d94068512a930877a98,15,256,254,2,0,0,0,8,16,27,2,8,3.038345476,6523,44,1,450,449,1,51169,51275,106,276,267,9,1,99.31747673,NoArch
00271af64e8a913f69a093935fc4e412a48f16ae,3,15,15,0,0,0,0,6,8,300,1,1,1.569974075,198,2,1,19,19,0,631,631,0,10,10,0,0,100,NoArch
eafd7bf289f901edfedc350beec30fa3cc09bb85,6,17,17,0,0,0,0,2,2,24,1,5,1.853688226,1191,14,2,84,84,0,5117,5117,0,48,48,0,0,100,NoArch
585ce0094d6527bab988f7657b4e84d12274ee28,1,27,2,25,0,0,0,3,4,318,1,1,0,397,6,1,46,43,3,2115,2002,113,18,16,2,1,100,NoArch
86db4da33cca40858529abd998bbe81b19f25c69,0,0,0,0,0,0,0,0,0,0,0,0,0,0,7,2,0,0,0,0,0,0,0,0,0,1,100,NoArch
d4d4c8c8994d4da988005b7930b797213aed4303,6,9,20,11,0,0,0,5,17,405,1,5,2.418157288,1349,3,1,144,146,2,7214,7306,92,71,72,1,0,99.87908102,NoArch
032bc3b08fe61ff23c8a1002d78a8197893d4f89,1,6,1,5,0,0,0,5,6,915,1,1,0,145,4,2,30,28,2,591,570,21,17,17,0,0,100,NoArch
2126f13e130ea0394bb395aa38bc6df4052576e6,3,28,34,6,0,0,0,6,47,93,1,2,0.482750854,2208,8,3,206,208,2,14725,14614,111,103,105,2,1,100,NoArch
b58daf29ba7f0100d16deb793757d93d073c9a03,3,5,9,4,0,0,0,2,3,61,2,3,1.148834854,302,5,3,23,23,0,1803,1834,31,11,11,0,0,97.92499524,Arch
c0472d3317e9bfe0b39ee2212e760e96b5a67ee9,4,133,32,101,0,0,0,2,3,25,1,3,1.521903324,2311,1,0,299,290,9,14617,13798,819,256,252,4,1,100,NoArch
c5e10d668f9366f29bdf7721f7efe4140782527b,6,112,156,44,0,0,0,4,17,27,4,5,1.599431388,2315,45,1,165,177,12,17230,17583,353,115,117,2,1,94.13654618,Arch
0d407342efb8e7c29012a42b989585f239594359,2,78,0,78,0,0,0,2,3,21,1,1,0.918295834,580,5,1,33,29,4,4901,4230,671,23,20,3,1,100,NoArch
b66c3ef23a021114c3c05ccf4d724b4a16926c53,2,6,2,4,0,0,0,4,11,534,1,1,0.811278124,489,9,4,52,51,1,2397,2357,40,19,19,0,1,98.55578849,NoArch
c7d962efffa9440746d54dd2bcba73a9df8b354a,3,277,0,277,3,0,3,1,1,0,1,3,1.559847495,0,3,0,26,0,26,1462,0,1462,22,0,22,1,98.54809437,NoArch
7fa641ea9ad2318b185f8492964b30ebc90759b0,9,83,24,59,0,0,0,2,44,133,2,6,1.954504321,2451,6,1,261,255,6,16412,15875,537,95,91,4,1,99.97847611,NoArch
a44f66869f1b938e83857ceaed9291eca9194f45,0,0,0,0,0,0,0,0,0,0,0,0,0,0,1,1,0,0,0,0,0,0,0,0,0,1,100,NoArch
ec6267c30328521621e6e803dfd6aaa65ae489f7,0,0,0,0,0,0,0,0,0,0,0,0,0,0,10,5,0,0,0,0,0,0,0,0,0,1,100,NoArch
35d406de4025ccd6c117e241c2174dbfc63e2e88,2,4,1,3,0,0,0,4,6,254,1,2,0.721928095,132,0,0,8,8,0,526,509,17,6,6,0,1,100,NoArch
4d80e1e221b0ddfd542baeee9b6cbb3b28a88e68,7,146,65,81,0,0,0,2,3,40,1,5,0.676898651,2467,11,6,168,157,11,20543,20015,528,80,71,9,1,100,NoArch
6490b029dd05e5a3d704ebd5b314899a53dd76fb,0,0,0,0,0,0,0,0,0,0,0,0,0,0,20,0,0,0,0,0,0,0,0,0,0,1,100,NoArch
fd269ddeb07fad015f71fc2c7daa53ace0e0e2da,6,33,23,10,0,0,0,11,28,348,1,3,1.759230165,857,2,0,82,82,0,5359,5371,12,37,37,0,0,98.62614488,NoArch
af5ef4d49d9c7eb610c446d8058216f39bb2fcfa,2,40,22,18,0,0,0,2,12,129,1,2,0.740865686,330,3,1,20,20,0,2101,1972,129,10,9,1,1,100,NoArch
e4931744ebcb6380ec967636213c406fd80a735f,2,1,2,1,0,0,0,7,9,132,1,1,0.918295834,241,17,0,27,27,0,1101,1102,1,11,11,0,1,100,NoArch
49407169ac1711c0babb77fb3014473c0b236edd,2,26,5,21,0,0,0,26,48,16,1,2,0.99323382,1086,13,0,145,141,4,6876,6741,135,50,49,1,1,100,NoArch
14c4611857ea796b8d3aef96f867db9cd0ae31f7,1,1,1,0,0,0,0,2,2,60,1,1,0,404,46,2,28,28,0,3408,3402,6,16,16,0,0,100,NoArch
49e855c3488ebe53af3a72fc3b5a22ba47a45e01,2,30,6,24,0,0,0,6,6,66,2,2,0.503258335,245,22,0,33,29,4,1247,1126,121,16,14,2,1,100,NoArch
8545ea3856134d9252339614390672b1872ec75c,1,2,3,1,0,0,0,2,2,72,1,1,0,410,12,3,53,53,0,2903,2893,10,16,16,0,1,100,NoArch
e206ddd431131da26cf1bb00f70fe64ad0450059,3,6,13,7,0,0,0,3,3,62,1,1,1.461838199,532,4,1,54,54,0,3682,3755,73,29,29,0,0,100,NoArch
e109a61803326ac81edc60ae3a889d8d6c75e902,7,90,27,63,0,0,0,4,7,128,1,6,2.607096853,913,7,0,90,84,6,6238,5654,584,49,46,3,0,99.93952832,NoArch
736a9408549f66014bfdfdc72832be11aa9fd39b,2,105,0,105,2,0,2,1,1,0,1,2,0.944252934,0,9,0,10,0,10,486,0,486,4,0,4,1,99.71717172,NoArch
6310a2307abba94c7ff8a770f45462deae2c312e,11,187,46,141,0,0,0,3,7,118,1,7,2.8916846,1967,23,1,245,225,20,12211,11344,867,133,127,6,1,100,NoArch
a205dd10faba0a83dcb39a12abb6f744b5224992,11,385,73,312,4,0,4,1,8,25,1,7,3.057363186,1264,29,0,205,180,25,8109,6511,1598,103,86,17,1,99.81810833,NoArch
59f995a3f5476e8171f24a32250da85e13d28daf,5,398,84,314,2,0,2,1,3,43,2,4,2.055107632,1119,0,0,113,87,26,9793,7965,1828,61,45,16,0,99.89921387,NoArch
d160abb43740e0bcdf40458c345ecd2d74e6698c,31,943,600,343,10,2,12,3,10,21,2,11,4.565070166,2697,5,1,307,268,39,15426,14105,1321,168,140,28,1,98.03607214,NoArch
5f5c15b0d9f807dc7f9112a5220c3daeb01f0cb8,3,21,14,7,0,0,0,5,23,237,1,2,1.263481591,577,13,1,68,63,5,3563,3457,106,22,21,1,1,100,NoArch
33ec88fc3840c47a54b5862e4d276889c4121231,20,725,14,711,3,0,3,7,27,85,2,9,3.447083676,6592,7,0,691,633,58,47655,42768,4887,479,434,45,1,96.65441176,Arch
0364498ae3be553f7c9fab78469283a6958da2ff,2,11,0,11,0,0,0,6,15,74,1,2,0.439496987,705,9,0,80,79,1,4809,4690,119,40,39,1,1,100,NoArch
42b6aeca28664767add190374b13f57c99e17286,3,30,11,19,0,0,0,9,18,77,2,2,1.530943616,1345,149,0,154,150,4,7182,7091,91,63,62,1,1,100,NoArch
430d4b428e7c5b325c7414a187f9cda158c2758a,0,0,0,0,0,0,0,0,0,0,0,0,0,0,0,0,0,0,0,0,0,0,0,0,0,1,100,NoArch
4d05680038752077ceaebef261b66a5afc761e10,44,4100,37,4063,38,0,38,1,2,15,3,23,5.000188698,1020,6,0,438,88,350,29189,4790,24399,245,62,183,1,93.04647785,Arch
a23230c8c2be5e0d6e9d8cbf936892402b7d741f,6,50,50,0,0,0,0,7,54,104,2,3,1.74203813,3223,7,1,326,326,0,20869,20839,30,149,149,0,1,100,NoArch
d7af8caa45095acac7fe62d215c22c5989b81b09,1,1,12,11,0,0,0,4,4,107,1,1,0,498,0,0,71,72,1,3110,3173,63,24,25,1,1,100,NoArch
c8d5ea2752f8289b9dec37a149e82c030f657924,21,102,71,31,0,0,0,2,3,5,2,13,3.898319034,3028,7,0,279,278,1,18899,18873,26,152,151,1,0,99.51352403,NoArch
537502a8efd92ebed43ab245b0802f3b9d251cc2,0,0,0,0,0,0,0,0,0,0,0,0,0,0,8,2,0,0,0,0,0,0,0,0,0,0,100,NoArch
971f028aaf3e90ddee571e9862509d34a637782d,1,25,35,10,0,0,0,7,10,176,1,1,0,220,33,0,20,21,1,1851,1923,72,4,3,1,1,99.94148625,NoArch
d9411c38dbe6684ed2b0b59b27fbb1a46ac16c34,4,219,0,219,3,0,3,1,1,0,1,4,1.539466518,74,14,0,24,8,16,1480,301,1179,20,4,16,1,98.34127741,NoArch
751e4ee88219c9d7d212cd2abcfe57ec59bb322e,0,0,0,0,0,0,0,0,0,0,0,0,0,0,10,0,0,0,0,0,0,0,0,0,0,1,100,NoArch
0ebef1c0a0e4b96616ee7e4372d3b9f0eb83a919,4,52,34,18,0,0,0,4,13,593,2,2,1.131401424,1124,150,1,154,149,5,5784,5697,87,86,82,4,1,100,NoArch
56866a11fe8b7a0ef8340f221da30c83c72b85da,0,0,0,0,0,0,0,0,0,0,0,0,0,0,0,0,0,0,0,0,0,0,0,0,0,1,100,NoArch
3d5e9fee7f42d45f737e170a1937bdf676df9c60,1,2,5,3,0,0,0,4,4,14,1,1,0,324,33,0,34,35,1,2017,2043,26,14,14,0,0,100,NoArch
36ce5bcd92fa6cb2fb88677eae1a7a846f606e3f,0,0,0,0,0,0,0,0,0,0,0,0,0,0,1,1,0,0,0,0,0,0,0,0,0,1,100,NoArch
b826c53e331fa5a80b7f9505dcdee0cbf16740e2,8,390,138,252,7,0,7,1,10,73,1,2,2.727671893,436,1,0,89,53,36,2158,1614,544,47,17,30,1,99.53375606,NoArch
ac23d2587f58d2199535dea779925cec02304b2d,6,122,2,120,0,0,0,10,13,288,2,6,2.24086102,3275,24,0,388,376,12,21330,20349,981,281,276,5,1,99.94401941,NoArch
78fd12259404cad8117862fdf0b948cbe115e453,2,4,4,0,0,0,0,3,3,91,1,2,0.543564443,1469,2,0,100,99,1,10488,10446,42,50,50,0,1,100,NoArch
1f0d5c077ea34ea91c6577cf2391291d06917378,11,137,6,131,1,0,1,7,45,143,4,9,2.47844621,2871,14,0,323,309,14,19079,18225,854,198,190,8,1,99.92538705,NoArch
62b392b49c13455199e0372204dedf8a371b452c,5,133,5,128,2,0,2,2,50,78,1,4,1.983831844,1171,10,0,158,148,10,7779,7217,562,59,53,6,1,98.8745076,NoArch
319b7a58e4773ca51c4ef9b82faf55d03d208e46,0,0,0,0,0,0,0,0,0,0,0,0,0,0,2,1,0,0,0,0,0,0,0,0,0,1,100,NoArch
de2fbeac334e65abee38f5f5867805ad07b8dcd2,5,105,11,94,1,0,1,2,5,91,2,4,2.138060561,1584,9,0,243,233,10,8762,8404,358,234,226,8,1,99.79237448,NoArch
3a91d26d625415b7ccd74f9f32418f8a84aa3e3c,0,0,0,0,0,0,0,0,0,0,0,0,0,0,0,0,0,0,0,0,0,0,0,0,0,0,100,NoArch
fce1453fa608fcff5df4d5aca8c88107d4151b09,34,111,70,41,1,0,1,11,55,54,5,22,3.199908395,6709,11,0,558,557,1,44533,44325,208,273,273,0,1,96.0882462,Arch
007014c1ef11083f4adad908ce390ec976fcdc33,1,5,8,3,0,0,0,2,3,62,1,1,0,74,10,1,4,4,0,364,355,9,3,3,0,0,100,NoArch
bd9cceccb582ede88b989824241498e8c32d4f13,2,4,4,0,0,0,0,7,16,206,1,1,1,472,47,0,37,37,0,3522,3518,4,12,12,0,1,100,NoArch
4bc45a391afc14738a42fc731fe958b2af5e3ee8,10,412,68,344,0,0,0,3,18,340,5,7,2.799811773,3384,0,0,230,207,23,26401,25119,1282,126,103,23,1,100,NoArch
6cf25d5c8a4c0ee7e8cd09a7a2884806b0fee1b7,0,0,0,0,0,0,0,0,0,0,0,0,0,0,11,2,0,0,0,0,0,0,0,0,0,0,100,NoArch
236d1b0dec409efb9c7a9febd260b1060da6a9c1,13,39,34,5,0,0,0,3,4,126,1,12,3.554866136,1625,15,0,140,140,0,10488,10252,236,81,81,0,1,96.94052939,Arch
11bc1fe6f498850d2c496151741813001d3850a3,2,45,1,44,0,0,0,3,4,202,1,2,0.258018669,1639,1,0,126,125,1,12563,12257,306,46,45,1,1,100,NoArch
facde4c16f9a61e1c62ed268c869493696aa6a06,3,9,1,8,0,0,0,1,3,252,1,2,1.521928095,387,15,1,26,25,1,2332,2271,61,11,11,0,1,100,NoArch
069a1dcf24e076388bf0579275155f42bfe09075,1,1,1,0,0,0,0,4,4,34,1,1,0,611,151,0,53,53,0,2584,2582,2,33,33,0,1,100,NoArch
93d9c25aee37d36c03e4c0edfc18db7da819ce2d,1,9,10,1,0,0,0,2,2,223,1,1,0,298,1,1,23,23,0,1808,1820,12,13,13,0,0,100,NoArch
26cdc457f6b2491caf28dcb7e33f03e7a2dac6fa,0,0,0,0,0,0,0,0,0,0,0,0,0,0,12,1,0,0,0,0,0,0,0,0,0,1,100,NoArch
6a6b772c4980106efe71e3799da9e6a00746dd4e,1,1,1,0,0,0,0,3,3,81,1,1,0,225,0,0,20,20,0,1283,1274,9,9,9,0,0,100,NoArch
4ddfc61d70e39bc09dd1aa020bde26284ed35d39,1,12,1,11,0,0,0,2,2,22,1,1,0,227,12,3,22,21,1,1388,1342,46,18,17,1,0,100,NoArch
14d5d1100c69839d2bcfea26af0efdcd2057650d,7,444,8,436,2,0,2,1,13,120,1,3,1.383897724,464,21,0,64,30,34,5099,2519,2580,31,16,15,1,97.50631313,Arch
8b5d6f94304229e9ec61d44aeda3b514dd67f2a6,14,23,9,14,0,0,0,2,5,154,2,10,3.440120407,3294,16,1,298,298,0,18565,18341,224,171,171,0,1,100,NoArch
5388c7f7a3efb84516af71a2533e8953113b30da,1,4,0,4,0,0,0,4,5,23,1,1,0,355,5,0,36,36,0,2599,2555,44,20,20,0,1,100,NoArch
33d338f3923862fdff24443a02d8a33a56d92e63,12,386,25,361,4,0,4,29,56,63,6,9,2.691087124,3430,30,0,486,464,22,21859,20201,1658,321,304,17,1,99.84697781,NoArch
e4e2fbc3bb2c4796c6813114dd1c37ffa5a1e03a,21,2105,1,2104,18,0,18,1,3,14,2,10,3.832975705,299,16,1,215,23,192,15073,1649,13424,131,21,110,1,91.47920927,Arch
0c821fecc2140683de24d9b350c8142b4b8b8c47,2,2,2,0,0,0,0,2,2,146,1,2,1,259,1,1,37,37,0,1266,1262,4,13,13,0,0,100,NoArch
6dc03b65bfd98d0a1fde2d48ebb31f36b1186cf9,48,2380,130,2250,18,0,18,1,28,79,2,36,4.969499114,9973,13,0,1146,944,202,75684,62645,13039,802,654,148,1,99.14302038,NoArch
959afb8ba4cadf0fe09ddd6d67f9bf38bea13050,2,2,2,0,0,0,0,2,2,146,1,2,1,259,8,0,37,37,0,1266,1262,4,13,13,0,1,100,NoArch
f8ccb2872dc9ba10853650fac2baed1406f3b731,1,8,4,4,0,0,0,2,3,15,1,1,0,238,13,3,24,22,2,1437,1388,49,18,18,0,1,100,NoArch
01ad449ad68d9c77ee1493fcdf833df53df6106a,1,2,1,1,0,0,0,5,5,1,1,1,0,878,14,4,78,77,1,4194,4181,13,44,44,0,1,100,NoArch
38b9264dd041db955ffa4c0f10273e1b5fa21cfb,1,3,0,3,0,0,0,4,4,152,1,1,0,629,3,0,36,36,0,5290,5267,23,23,23,0,1,100,NoArch
89f482eaf249bf89b7182c4ca97ffda0929b4b7e,0,0,0,0,0,0,0,0,0,0,0,0,0,0,13,2,0,0,0,0,0,0,0,0,0,1,100,NoArch
286055ce34bdbbac68c995a2710fc7be07734b12,21,1322,317,1005,14,0,14,1,8,12,2,7,4.081134069,2096,14,2,341,277,64,16760,12112,4648,283,243,40,1,94.02258905,Arch
e807bb895e5a31a40f51b2c2bd9b732d26bebd46,0,0,0,0,0,0,0,0,0,0,0,0,0,0,17,2,0,0,0,0,0,0,0,0,0,1,100,NoArch
3ec9270e8e0be4c94106bdb09543971296ebe2d2,2,29,3,26,0,0,0,11,15,395,1,2,0.337290067,875,152,1,77,75,2,5522,5360,162,31,30,1,1,100,NoArch
8cf6a7223f5fa6c2014a7351198ac6d1ebd26621,25,566,149,417,4,0,4,8,9,196,2,14,3.988683264,3044,31,1,379,346,33,19970,17409,2561,191,177,14,2,99.6625964,NoArch
9e6889a8ce522ec455a11d6f6cf4949255c91a0f,1,40,11,29,0,0,0,7,11,116,1,1,0,1125,18,3,83,81,2,8543,8274,269,63,61,2,1,100,NoArch
6cdf59d92b1c260abae82bba7d30d8ac280bddbf,8,339,6,333,3,0,3,5,9,39,1,6,2.750209643,3502,19,4,421,398,23,24467,22384,2083,325,306,19,1,91.18753358,Arch
e177466fd266ebf3a8d371ce1bf2ecf3bdfe90ed,11,228,16,212,1,0,1,7,9,42,2,9,2.35801252,3653,20,4,339,325,14,25918,24570,1348,216,204,12,1,99.91871571,NoArch
76faf59652468e9d6b8507216e52f282c585841d,0,0,0,0,0,0,0,0,0,0,0,0,0,0,2,1,0,0,0,0,0,0,0,0,0,1,100,NoArch
0ecdec348efdc0d34401bae5d75435d4821f72b5,1,0,5,5,0,0,0,6,6,19,1,1,0,879,3,2,77,78,1,4184,4194,10,44,44,0,0,100,NoArch
4c17528de021054699c60e292874cdfdbcf592af,2,22,3,19,0,0,0,3,3,106,1,2,0.795040279,659,2,0,58,56,2,5157,4972,185,26,25,1,1,100,NoArch
b83d1d3e61d51a7b098789532e31531d94330cb0,2,37,6,31,0,0,0,4,5,172,1,1,0.933025295,598,4,1,75,73,2,3804,3687,117,26,26,0,1,100,NoArch
da51aa64fcaf8cd3099ef9c085c207283999306f,1,120,0,120,0,0,0,5,5,17,1,1,0,632,6,1,42,36,6,6082,5290,792,28,23,5,1,100,NoArch
e33a8f733c4a9a94479c166ad13ae9d53142cd3f,4,83,22,61,0,0,0,4,10,51,1,2,1.715233946,936,7,2,137,127,10,5957,5458,499,44,40,4,1,100,NoArch
c6bf95233240d75160670ee96c356946c44c6169,2,32,6,26,0,0,0,3,5,253,2,2,0.74248757,902,25,0,73,70,3,5538,5324,214,28,28,0,1,100,NoArch
ef28763f083375c4fe8c1f94acdf785d9bc7f9bf,0,0,0,0,0,0,0,0,0,0,0,0,0,0,15,3,0,0,0,0,0,0,0,0,0,0,100,NoArch
605b617cfa9a25bff48e618beccfaa7b4eaeee56,29,591,298,293,2,0,2,3,13,262,4,20,3.520188396,9623,8,0,817,760,57,67582,66081,1501,467,442,25,1,95.93768487,Arch
c5e8a024f6a2169f8d6256039de00a44fdb2f5a0,18,458,122,336,3,0,3,1,10,103,4,16,3.328359917,7542,9,1,644,615,29,54433,52667,1766,457,435,22,1,99.75157653,NoArch
a23aa41a1a3082eda080ec1cf3ad99e5ec37a9a0,2,10,2,8,0,0,0,2,4,45,1,2,1,640,3,1,74,72,2,4153,4101,52,22,22,0,1,100,NoArch
ff8313caf1dfe0b13fa9f160489a74600b0e8756,5,188,2,186,2,0,2,1,4,18,2,4,1.368324929,543,17,0,65,53,12,4904,3666,1238,49,43,6,1,90.1086335,Arch
c3e9243ea1066adb2f12cf5b9cee82445d61a840,0,0,0,0,0,0,0,0,0,0,0,0,0,0,2,1,0,0,0,0,0,0,0,0,0,0,100,NoArch
298808baaf771a3707cf55db8d89ed4421e1f8c3,42,3994,241,3753,17,0,17,1,29,111,3,20,4.141255194,10142,26,1,1559,1252,307,79756,57930,21826,977,817,160,4,99.28071172,NoArch
4e642268442782cdd7ad753981dd2571388cd189,35,284,98,186,1,0,1,2,18,135,8,30,4.352729947,10332,14,0,1019,1010,9,65527,64357,1170,587,580,7,2,99.7370892,NoArch
2bd4a68731826698d120765c534cabe6c3069a95,2,68,33,35,0,0,0,2,13,0,1,2,0.525935984,1926,27,2,285,283,2,10949,10716,233,242,239,3,1,100,NoArch
4b94529aafd45b608c6d1ab13376216144b934f6,10,906,467,439,3,0,3,1,10,57,2,7,2.612683822,3746,1,0,326,294,32,25580,23177,2403,153,134,19,1,99.8687664,NoArch
1a0579ca7df8d3ab83775d356f34f5b432b05176,4,68,30,38,0,0,0,5,18,231,1,2,1.705081147,1098,3,0,126,122,4,7404,7113,291,39,38,1,1,100,NoArch
31e674eb57c7e01af783dccb01828a0b6eb2a632,10,53,68,15,0,0,0,2,9,0,3,8,1.952555863,4163,92,0,419,418,1,28241,28199,42,187,188,1,2,99.92506557,NoArch
698694a1571cdcc9848fc79aa34c8cbbf9662bc4,3,44,7,37,0,0,0,1,22,169,1,3,1.573564149,1199,9,1,81,79,2,9916,9636,280,49,48,1,1,100,NoArch
47c5e518a756df815287502a50da9d73d28fc662,2,33,1,32,0,0,0,7,17,118,1,2,0.522559375,716,16,1,84,80,4,5005,4809,196,41,40,1,1,100,NoArch
da2919a75f564be6c3d731a2c503959e416ebe71,3,75,13,62,0,0,0,2,7,238,1,3,0.921152371,1457,32,1,136,134,2,11252,10715,537,63,61,2,1,100,NoArch
2c4868e7707bcdb2b2e1f1530c7b2b4d81584a1f,2,78,0,78,0,0,0,2,4,343,1,2,0.6789539,382,10,1,41,33,8,3646,2926,720,16,14,2,1,99.90589121,NoArch
b593f1062931a4d017ae8bd7dd42e47a8873a39f,2,0,0,0,0,0,0,1,1,0,1,1,0,415,17,2,29,29,0,2823,2823,0,8,8,0,0,99.84871407,NoArch
5ff8e88d58c2a6efa1046716e11dca0d61cdf872,8,54,57,3,0,0,0,3,8,39,1,7,2.537351652,3597,66,0,279,278,1,23476,23582,106,168,167,1,1,99.96217852,NoArch
17df517b812c9a37dd64014f0d5c35a3cfac0c4e,154,190,180,10,0,0,0,10,22,47,5,70,7.053074064,23554,15,1,2184,2184,0,143356,143274,82,1261,1261,0,1,89.56441149,Arch
c151147819abb6b4c418138d9b401f374fc021a0,1,2,4,2,0,0,0,2,2,154,1,1,0,68,4,0,5,4,1,454,432,22,3,3,0,1,100,NoArch
1a836f9a84f0191fe4e40017308af95d872767db,1,1,1,0,0,0,0,6,8,444,1,1,0,48,0,0,0,0,0,142,139,3,0,0,0,1,100,NoArch
79ec7b4894b997183a6e10fdc19d34f5ab4ea437,1,41,0,41,0,0,0,5,8,15,1,1,0,473,10,2,66,59,7,3009,2733,276,18,17,1,1,100,NoArch
65866c45ec04820b01ab701e7de5cf6a406d2a8e,17,301,33,268,0,0,0,7,22,79,3,13,3.074450079,8557,67,1,730,706,24,63514,61292,2222,385,370,15,4,98.12947002,NoArch
368c1a8f5c36d06ed49706b4afde4a83073a9011,8,306,25,281,1,0,1,7,57,70,3,6,2.036037369,4181,21,3,425,398,27,26780,24695,2085,225,211,14,5,99.88903274,NoArch
23e93d05c02775b0c518a2da160810b23bb4bca4,0,0,0,0,0,0,0,0,0,0,0,0,0,0,11,3,0,0,0,0,0,0,0,0,0,0,100,NoArch
7ce3ac778eb475bf23ffa31243dc0843ec7d089a,37,509,97,412,3,0,3,10,19,0,8,30,3.864618158,8933,16,2,786,753,33,58747,56090,2657,371,348,23,1,95.18026565,Arch
de42adc2302528541145a714078cc6d10cbb8d9a,0,0,0,0,0,0,0,0,0,0,0,0,0,0,22,2,0,0,0,0,0,0,0,0,0,1,100,NoArch
e3d3677b7e7899705b624925666317f0c074f7c7,14,259,113,146,0,0,0,11,23,58,2,11,3.05338198,4713,33,1,402,382,20,34314,33157,1157,209,202,7,1,99.98050682,NoArch
e926c1a45ca95fa1911f6f88a0577554f2797760,1,1,1,0,0,0,0,6,6,45,1,1,0,752,8,0,42,42,0,6084,6082,2,28,28,0,1,100,NoArch
749f6578561cbf065c7f74ab51b1c01881a1bd97,4,36,36,0,0,0,0,7,18,45,4,4,0.545897059,1546,9,1,148,151,3,10326,10409,83,68,70,2,1,100,NoArch
a43e191d6cd91f8fb787fc1fc99ec12218195313,0,0,0,0,0,0,0,0,0,0,0,0,0,0,34,2,0,0,0,0,0,0,0,0,0,0,100,NoArch
3d1d5d00b00987e0c04e4ff4692fc50d1be85922,3,40,9,31,0,0,0,2,2,78,2,3,1.502901402,222,11,2,23,18,5,1110,930,180,18,16,2,1,100,NoArch
684e12e9fcfa45c6ac922a84fb3116ac8142bc18,3,16,4,12,0,0,0,3,7,26,2,2,1.360964047,1462,17,2,92,92,0,9816,9661,155,44,44,0,1,100,NoArch
a38612b10f6ae04644519270f9b5eb631a77c148,2,31,21,10,0,0,0,13,20,32,1,2,0.98285869,1029,0,0,154,152,2,5893,5747,146,71,71,0,1,100,NoArch
b9c2856d164c58075a2a0f88ed07fb00d24f65e5,0,0,0,0,0,0,0,0,0,0,0,0,0,0,35,3,0,0,0,0,0,0,0,0,0,1,100,NoArch
91b9cb53d35e315668f4f82029a34f2b69d01d73,1,2,2,0,0,0,0,4,4,36,1,1,0,314,36,4,33,33,0,1597,1597,0,31,31,0,0,100,NoArch
e23967b9e9fcc95dbe71369098c8d12cba90eb95,0,0,0,0,0,0,0,0,0,0,0,0,0,0,37,5,0,0,0,0,0,0,0,0,0,1,100,NoArch
5ca0625b277efa3a73d2ae0fbdfa4c6163f312d2,55,767,570,197,1,0,1,10,20,40,9,39,4.857406777,17012,68,2,1573,1540,33,111970,110907,1063,864,846,18,0,95.45619117,Arch
c931dc5406a808f7afc25a62d22a2ccd545eb066,3,3,3,0,0,0,0,5,6,36,1,3,1.584962501,1013,0,0,111,114,3,6520,6532,12,35,35,0,0,100,NoArch
244f6def9c905382739e76cb8ad0feaa6801a311,0,0,0,0,0,0,0,0,0,0,0,0,0,0,11,0,0,0,0,0,0,0,0,0,0,0,100,NoArch
2c69f69cfce944f7ff3061000145ce805211854d,0,0,0,0,0,0,0,0,0,0,0,0,0,0,93,0,0,0,0,0,0,0,0,0,0,0,100,NoArch
bead4331ba17c67b31425722f9bc22d3c303979d,2,7,1,6,0,0,0,2,9,32,2,2,0.811278124,1038,94,1,43,43,0,7265,7259,6,23,23,0,0,100,NoArch
ab4319ddbc07dacf6f3e34c4e08d1156391ae63a,0,0,0,0,0,0,0,0,0,0,0,0,0,0,95,2,0,0,0,0,0,0,0,0,0,0,100,NoArch
6d58ace7b06b2d12fffab31676810c538bde212b,0,0,0,0,0,0,0,0,0,0,0,0,0,0,96,3,0,0,0,0,0,0,0,0,0,0,100,NoArch
7aeb3ccff33c740c07456d7c9ec22e9d574e6650,0,0,0,0,0,0,0,0,0,0,0,0,0,0,18,0,0,0,0,0,0,0,0,0,0,0,100,NoArch
04731916a5dd782c1f1f248f85085245a4c7ee7d,0,0,0,0,0,0,0,0,0,0,0,0,0,0,97,4,0,0,0,0,0,0,0,0,0,0,100,NoArch
162dc18fc6a1e1d0db420a4735bc8c5a0ba7cf12,0,0,0,0,0,0,0,0,0,0,0,0,0,0,98,5,0,0,0,0,0,0,0,0,0,0,100,NoArch
5e30fc1b2b3c3a2c0b08640ff800ba4f801c0623,2,4,0,4,0,0,0,2,9,32,2,2,1,1037,69,3,43,43,0,7285,7259,26,23,23,0,0,100,NoArch
bead4331ba17c67b31425722f9bc22d3c303979d,1,5,3,2,0,0,0,5,9,2,1,1,0,950,94,1,40,40,0,6709,6729,20,20,20,0,0,100,NoArch
81ccb0c71ad2c17c5613698d4fb50f3b49b21fb4,1,3,5,2,0,0,0,5,9,2,1,1,0,952,70,3,40,40,0,6729,6709,20,20,20,0,0,100,NoArch
6d58ace7b06b2d12fffab31676810c538bde212b,1,5,3,2,0,0,0,5,9,2,1,1,0,950,96,3,40,40,0,6709,6729,20,20,20,0,0,100,NoArch
976420c49a3fe764f7cecd30b6cdb32861be5537,1,3,5,2,0,0,0,5,9,2,1,1,0,952,15,0,40,40,0,6729,6709,20,20,20,0,1,100,NoArch
b64d22e0478b967c83be22509beaaf8c5f114e19,1,121,45,76,0,0,0,5,5,42,1,1,0,225,0,0,34,20,14,1694,1283,411,12,9,3,1,100,NoArch
641abe8ab7c1c4d9915c6582389476fa5f7ae067,6,1096,0,1096,4,0,4,1,4,18,1,4,2.081430583,213,0,0,117,20,97,8902,1060,7842,62,11,51,1,97.08772557,Arch
748dcc9aae88d8d8b7d4fb70341c78d02b9ab5fb,2,7,9,2,0,0,0,5,6,33,1,2,0.69621226,500,18,0,39,39,0,2870,2875,5,14,14,0,0,100,NoArch
048633da1a913a05252b1b5dea0b3d40d75c81b4,1,0,1,1,0,0,0,2,2,525,1,1,0,98,0,0,9,9,0,501,503,2,3,3,0,0,100,NoArch
d3ea0f957e231029c5c21ac479039159aa499cb4,0,0,0,0,0,0,0,0,0,0,0,0,0,0,19,1,0,0,0,0,0,0,0,0,0,0,100,NoArch
7aeb3ccff33c740c07456d7c9ec22e9d574e6650,10,57,1224,1167,0,4,4,1,9,32,3,8,2.437698933,2854,18,0,94,205,111,10736,19002,8266,45,99,54,0,97.08772557,Arch
e302c6bc12c7eb764781898fdee8ee302ef4ec10,10,1224,57,1167,4,0,4,2,9,68,3,8,2.437698933,1687,20,2,205,94,111,19002,10736,8266,99,45,54,1,97.08772557,Arch
84df26323d2bb2ad36beb6228f70a60e21e7a57f,0,0,0,0,0,0,0,0,0,0,0,0,0,0,48,0,0,0,0,0,0,0,0,0,0,0,100,NoArch
81836f0309b293892a3013017dbd90c93dbf3df9,0,0,0,0,0,0,0,0,0,0,0,0,0,0,71,3,0,0,0,0,0,0,0,0,0,0,100,NoArch
c4afd179c1983a382b8a5197d800b0f5dba254de,4,290,0,290,2,0,2,1,1,0,1,2,0.647346664,126,18,0,43,13,30,1610,538,1072,27,8,19,1,99.69714178,NoArch
162dc18fc6a1e1d0db420a4735bc8c5a0ba7cf12,14,57,1514,1457,0,6,6,1,9,22,3,10,2.797235818,3270,98,5,107,248,141,11274,20612,9338,53,126,73,0,96.84154176,Arch
c8ee40f8ae34607072a27d4e7ccb21fc4df13ca1,14,1514,57,1457,6,0,6,2,9,48,3,10,2.797235818,1813,72,4,248,107,141,20612,11274,9338,126,53,73,0,96.84154176,Arch
a54550d94f2973f5e6c73ce4c3bb9eaba8aff711,1,1,1,0,0,0,0,5,8,13,1,1,0,300,1,1,34,34,0,1693,1694,1,12,12,0,0,100,NoArch
2ee1c3fb0cb9740dc6d924f5e6e638aec19ed9b3,7,266,26,240,1,0,1,7,16,83,1,6,2.02990305,4109,3,0,482,463,19,27749,26615,1134,360,345,15,1,90.43592634,Arch
7b2e658ac00410b2a20dd456e431394a75dcb0d3,0,0,0,0,0,0,0,0,0,0,0,0,0,0,21,3,0,0,0,0,0,0,0,0,0,0,100,NoArch
bc0325f6ea0a734f106f21a2fcd4ead413a6cf7b,36,3489,266,3223,22,1,23,3,19,39,3,16,4.474198452,3040,4,0,589,321,268,35493,18630,16863,315,172,143,1,88.37130802,Arch
23f2ef3efbea5e9a686bac195cdf97605f20d91d,1,0,118,118,0,1,1,7,12,914,1,1,0,118,22,4,0,11,11,0,681,681,0,3,3,1,99.96920234,NoArch
2d2d5c83b1ca33ad413746987c4aa816dd43520d,4,39,10,29,0,0,0,7,8,75,1,4,1.618630568,805,12,1,78,76,2,6306,6100,206,44,42,2,1,99.95378216,NoArch
9cb6cb818968d3ef10b3264714e30b8df957ec9d,2,81,3,78,0,0,0,2,2,358,1,1,0.829607103,299,13,2,22,18,4,3055,2276,779,8,5,3,1,99.95376791,NoArch
5d053b495b8cb44cce88a67e82cbdfdc3d8b3180,2,57,9,48,1,0,1,1,4,57,1,2,0.902393283,242,0,0,26,24,2,1638,1437,201,19,18,1,0,99.93837621,NoArch
f159c0c49a7bad564f1fb6ba2758e4b89db4704a,1,2,9,7,0,0,0,3,3,74,1,1,0,166,4,0,10,13,3,1004,1048,44,5,5,0,1,100,NoArch
0d8a4d0a56dcb35e499216c7bfab17a05716bc44,2,47,5,42,0,0,0,15,29,449,1,1,0.51594693,868,5,0,126,120,6,4465,4185,280,70,65,5,1,100,NoArch
ec950b4cfe0e86d4e06b7b80d595510540768fdb,1,1,1,0,0,0,0,4,5,70,1,1,0,192,0,0,17,17,0,1452,1452,0,10,10,0,0,100,NoArch
50ff9ab2d2d4fe217fb1ac540d96bddd07c2f6f8,2,6,6,0,0,0,0,10,15,20,1,1,0.918295834,595,15,0,47,47,0,3984,3984,0,23,23,0,0,99.78451593,NoArch
d74d8e208439df8cb2eb6c24019be55c002d00a5,2,145,0,145,1,0,1,1,5,17,1,2,0.145295445,80,23,5,19,6,13,1457,482,975,12,2,10,1,99.96924023,NoArch
eb91e5ba7006ec9297fbc17658ee951afeb903f1,3,9,3,6,0,0,0,2,4,176,1,3,1.584962501,616,38,0,62,59,3,3719,3683,36,38,38,0,1,100,NoArch
17802569fd64d865317353b3d855a68a6b3874bd,1,12,12,0,0,0,0,22,33,74,1,1,0,449,1,0,62,63,1,3074,3120,46,24,24,0,1,99.62761831,NoArch
647e9faf255b9ae5796f513d13c769a8c87788d4,1,1,3,2,0,0,0,4,4,21,1,1,0,91,24,6,3,3,0,543,556,13,3,3,0,1,100,NoArch
4a5683d54a3910e1c860f26b291e1e99931b5949,1,1,1,0,0,0,0,1,2,139,1,1,0,74,39,1,6,6,0,273,273,0,6,6,0,0,100,NoArch
b51b3a39a81848e6fcb5bf7a2480769a012a4339,1,12,13,1,0,0,0,16,30,11,1,1,0,649,0,0,87,87,0,3140,3145,5,52,52,0,1,100,NoArch
b5d4a046bb4d4addc9675a802d5e9c2ecf42445a,2,42,0,42,0,0,0,13,22,694,1,2,0.371232327,538,40,2,32,30,2,4435,4010,425,10,9,1,1,100,NoArch
b2c47a24be53016d1c9220cb98d9fb7cd587e748,0,0,0,0,0,0,0,0,0,0,0,0,0,0,10,0,0,0,0,0,0,0,0,0,0,1,100,NoArch
291f92069eee7bbff5e192d7ea6576a25a8c400c,1,1,1,0,0,0,0,6,8,27,1,1,0,253,0,0,31,31,0,1447,1448,1,14,14,0,0,100,NoArch
4c5b6923ccfaaa6616a934a3f690b1a795a42d41,30,1435,393,1042,5,0,5,1,30,33,3,17,4.064485216,5133,5,1,554,484,70,35740,30549,5191,291,247,44,1,96.62387066,Arch
c30481f4b0d7552a5ac73bb9955f6326f90ba329,0,0,0,0,0,0,0,0,0,0,0,0,0,0,0,0,0,0,0,0,0,0,0,0,0,1,100,NoArch
7a98b1c878e330e53e53ddd1b9161c8669806efa,1,1,1,0,0,0,0,2,2,154,1,1,0,82,12,0,8,8,0,302,306,4,3,3,0,1,100,NoArch
a2f85d90de73a58e924b4de757d09d6133b046a4,1,3,3,0,0,0,0,2,3,111,1,1,0,119,16,1,3,3,0,782,782,0,1,1,0,0,100,NoArch
26da4f546275e8ab6496537743efe73510cb723d,0,0,0,0,0,0,0,0,0,0,0,0,0,0,1,0,0,0,0,0,0,0,0,0,0,1,100,NoArch
ff0e3f5669f1a70cbe9d302e8b1e6a5dbc801b25,2,63,9,54,0,0,0,2,3,14,1,2,0.764204507,408,62,0,18,14,4,3399,3009,390,7,6,1,1,99.93582545,NoArch
d5f202821b11659693a2e934d4b8f4c99f19755e,23,270,43,227,2,0,2,29,58,253,3,8,3.021218621,3987,41,3,482,446,36,22549,21188,1361,227,217,10,0,99.93587688,NoArch
527175ab0be59d15f035a09a0466bfeca9abfb23,2,40,1,39,1,0,1,1,17,24,1,2,0.281193796,1296,49,0,230,229,1,6886,6759,127,228,227,1,0,99.93594876,NoArch
302bd29dab2866e07eb71823e4142f2da9addbb4,0,0,0,0,0,0,0,0,0,0,0,0,0,0,17,2,0,0,0,0,0,0,0,0,0,0,100,NoArch
5d2491d10c70e4e5fc9b7aeb62cc64bcaaf6043f,27,1105,111,994,4,0,4,1,10,59,2,11,3.864336331,3952,6,1,412,342,70,26760,22397,4363,251,209,42,1,98.83630721,NoArch
37972071ff4d1912ea58834061abf95fc499739d,1,3,1,2,0,0,0,1,1,0,1,1,0,28,6,0,0,0,0,63,56,7,0,0,0,1,99.93977718,NoArch
c4bbcb7f0e83732b63ed7bb81c20470ae8d9a0dc,4,8,11,3,0,0,0,2,4,20,1,3,1.739954647,822,63,1,62,62,0,4540,4570,30,33,33,0,1,100,NoArch
9431aabfab47a3b679bd6ccfa8b5fa584260fc9e,7,354,46,308,2,0,2,1,31,140,2,6,2.063567444,2382,1,0,362,336,26,15437,13274,2163,317,302,15,1,99.87957248,NoArch
b0010bf3b449a9d2e01955b0746b795e22e577db,2,3,2,1,0,0,0,5,5,288,1,2,0.970950594,447,8,0,47,47,0,2659,2640,19,14,14,0,1,100,NoArch
0d91c451b0e823162c261ec09fed9b5f4748d9e6,1,1,1,0,0,0,0,3,3,766,1,1,0,104,14,0,11,11,0,514,518,4,7,7,0,1,100,NoArch
c9fcf964b2bae56a54cb72951c8d8999eb323ed6,57,216,186,30,0,0,0,8,59,219,8,36,4.866115861,18837,42,1,1602,1598,4,129161,127291,1870,784,780,4,1,100,NoArch
ffcfb58bacab377bc72d20041baa54a3fd8fc812,61,1517,306,1211,5,0,5,30,60,118,8,43,4.510494186,25341,11,0,2298,2180,118,180279,172612,7667,1340,1269,71,1,96.41501476,Arch
43a0776c7c88a5f7beac6c8853db7e341810635a,1,2,5,3,0,0,0,10,14,95,1,1,0,619,1,0,102,102,0,3750,3796,46,53,53,0,1,100,NoArch
3ceb1b4c83d4e004c9b397bd05600c2aaf86196d,7,261,23,238,0,0,0,1,20,54,3,5,1.80896487,1708,7,1,183,155,28,10660,9456,1204,92,80,12,1,100,NoArch
2efd0760acb5de06adc0f0a4a045df792ff3b6ab,17,1503,10,1493,13,0,13,2,6,30,2,8,3.328744245,863,19,0,191,94,97,15087,5264,9823,127,73,54,1,89.24343798,Arch
d2f360f5dd80ff7f85a18225d68d684f071cc734,2,7,4,3,0,0,0,2,5,247,1,2,0.439496987,371,28,0,38,37,1,2336,2315,21,21,21,0,0,100,NoArch
3b8d0f3b1f368af8d3a38027d2ac82662ff9779f,1,3,2,1,0,0,0,6,6,17,1,1,0,234,0,0,26,26,0,1381,1381,0,7,7,0,0,100,NoArch
ab9933f20606d0b35d32ae1e971d5fa370012647,0,0,0,0,0,0,0,0,0,0,0,0,0,0,50,1,0,0,0,0,0,0,0,0,0,1,100,NoArch
77ba561a6bacbf9e7dc9c1582eb068f7ad800cd9,4,163,11,152,0,0,0,6,20,140,1,3,1.454482456,2983,2,0,390,370,20,19520,18062,1458,320,316,4,1,100,NoArch
97864a48c1979ca2b3f0579cf26bba81fba7e46c,1,8,1,7,0,0,0,1,2,23,1,1,0,202,8,2,18,16,2,1010,984,26,8,8,0,1,100,NoArch
06dc7c7fd8a867a1e1da90f7dc19b0cc2da69bba,1,25,14,11,0,0,0,1,4,6,1,1,0,284,9,3,29,28,1,1479,1456,23,12,11,1,1,100,NoArch
617cc24ad1a28196b872df5663e9e0f48cd7f0fa,5,213,30,183,0,0,0,6,22,395,1,4,1.533258943,2331,12,0,196,174,22,18589,17412,1177,129,118,11,1,97.56808106,Arch
8c2197ae5e9c139e488a33f5a507b79bfa2f6f27,4,75,31,44,0,0,0,4,7,80,2,3,1.082931127,1294,13,1,91,85,6,9326,9038,288,43,42,1,1,100,NoArch
9f5e8cc7c3789fd3658f52f960fb5cbc8e4efce9,0,0,0,0,0,0,0,0,0,0,0,0,0,0,43,2,0,0,0,0,0,0,0,0,0,0,100,NoArch
022df0d1b134422f7b6f305cd7ec04b25caa23f0,3,38,2,36,0,0,0,3,12,46,2,3,1.451334178,1640,29,1,111,107,4,10966,10715,251,61,59,2,1,100,NoArch
be257b58c689510a21529019a766b7a2bfc7ebe6,1,1,1,0,0,0,0,5,6,1351,1,1,0,135,0,0,16,16,0,566,570,4,8,8,0,0,100,NoArch
7a11de12764d8f68f296c6e68a22822318bfbefa,38,2296,152,2144,16,0,16,2,11,9,2,15,4.744907999,5503,10,4,672,484,188,43659,31561,12098,364,274,90,1,93.70056889,Arch
657e73f9b157a1ed4d6e6e515ae8f63156061b88,0,0,0,0,0,0,0,0,0,0,0,0,0,0,44,2,0,0,0,0,0,0,0,0,0,1,100,NoArch
7a6b071647fae632af2126b517ac869e81f539cb,4,2,96,94,0,0,0,4,15,184,2,4,1.636928465,1334,15,1,153,163,10,7899,8644,745,81,85,4,1,100,NoArch
73fa308ff0c2e3bd0a1e53052187eabe9889d596,2,55,4,51,0,0,0,7,13,12,1,2,0.964690083,1433,30,2,90,85,5,10163,9719,444,35,35,0,1,100,NoArch
0dde7f9185a350599adaab5af5738b73a15243d7,1,11,2,9,0,0,0,8,12,30,1,1,0,286,2,1,34,32,2,1645,1611,34,13,11,2,1,100,NoArch
4fa43359cb1f95a0f663bb32b6f479fd85bdb255,1,1,1,0,0,0,0,13,23,16,1,1,0,305,0,0,36,36,0,1808,1804,4,12,12,0,0,100,NoArch
f11a6c7b2d4ef045419a4522e8e203f51292b816,5,147,15,132,0,0,0,11,21,88,2,3,1.77295743,2129,31,3,314,300,14,12891,11891,1000,273,267,6,1,99.93932959,NoArch
899ae70fdb70c1511c099a64230fd91b2fe8d4ee,12,272,8,264,2,0,2,1,14,232,2,9,3.274850949,1682,51,1,277,247,30,10107,8549,1558,159,145,14,1,95.37659487,Arch
89003bc7801b035b5be31c76bfbf691bfcf9081a,34,4874,78,4796,21,0,21,1,12,9,1,15,4.456026508,3009,11,4,818,249,569,42342,16867,25475,328,127,201,1,99.31455633,NoArch
7cc75e0be25b7c3345efd890b1a353d49db5bace,7,109,6,103,0,0,0,5,28,141,2,5,2.413241612,2429,16,2,257,246,11,15031,14345,686,156,149,7,1,100,NoArch
f53bca404f1482e0e99ad683dd29bfaff8bfb8ab,2,41,27,14,0,0,0,2,2,232,1,2,0.989992792,421,52,2,33,33,0,2703,2514,189,14,14,0,1,100,NoArch
bc883db5de5832fa429bbb04a35d3606fdacdb2a,19,313,185,128,0,0,0,7,61,112,8,16,2.799648558,7726,7,0,665,648,17,51926,51868,58,335,327,8,1,99.95045212,NoArch
f2159c4573810f922fadff640a953175a852dc43,1,13,14,1,0,0,0,11,13,40,1,1,0,935,12,1,85,85,0,4659,4689,30,47,47,0,1,100,NoArch
11ad4ed26b6046201945f0e14449e1cbc5b6f1f2,2,75,9,66,0,0,0,3,6,99,1,2,0.99631652,460,17,2,47,41,6,4105,3650,455,19,16,3,1,93.17048853,Arch
9437e0ddef9821f728a4edf24ab90506532b6d0d,1,1,0,1,0,0,0,8,14,7,1,1,0,337,53,3,43,43,0,2010,1997,13,20,20,0,0,100,NoArch
5cf2f2618b6a59a831543b588fb3bb85bdf5f1e8,3,127,19,108,0,0,0,3,15,128,1,2,1.135011145,1915,45,2,158,144,14,14903,14159,744,106,96,10,1,100,NoArch
02073235c3bbe72db32ed282b3e318e7daa0800a,1,4,0,4,0,0,0,6,7,375,1,1,0,288,0,0,44,42,2,2090,2038,52,8,8,0,1,100,NoArch
8b9dea4ad9012d84203a888b601cca03bf857aeb,3,46,52,6,0,0,0,2,2,135,1,2,1.542241278,863,20,1,68,68,0,6394,6397,3,31,31,0,1,100,NoArch
d3a451611cc01a65cc0f305c72c04d64af0e7d38,1,6,1,5,0,0,0,6,6,48,1,1,0,392,54,4,47,46,1,1805,1782,23,24,23,1,0,100,NoArch
d8af24d8a2fdbead4592a36df1bd9dda333f1513,12,343,37,306,1,0,1,4,11,147,1,8,2.74755331,2167,9,0,302,267,35,15183,12994,2189,143,127,16,1,99.92474602,NoArch
c4a66324cdd3e289e0bf18bdd150b95ee6e4c66c,5,54,14,40,0,0,0,4,11,75,2,4,1.880629793,3255,18,3,275,273,2,26123,25658,465,165,165,0,1,100,NoArch
2fdae6835ce3fcad3111205d2373a69b34788483,22,1964,128,1836,7,0,7,1,15,6,2,13,3.593050982,3720,12,4,504,366,138,32063,21611,10452,264,175,89,1,99.67316153,NoArch
12ff562d2bd77b6dc8676eac79cbd631185dac3c,8,169,83,86,0,0,0,1,7,15,1,5,2.110115219,2172,13,3,122,116,6,13997,13403,594,75,73,2,1,96.4490995,Arch
e8e6708aea1ace4aecaba594d7fd84a0b5cac635,9,241,25,216,1,0,1,1,16,16,1,9,1.760260367,1776,14,4,150,129,21,11846,10833,1013,93,76,17,1,99.28214331,NoArch
20786ab8a2a1e7735ab846e92802fb9f4449adc9,17,437,164,273,1,0,1,1,17,60,2,13,2.512908207,3696,15,5,377,342,35,22975,21622,1353,187,177,10,1,87.08549042,Arch
f5e31be0866848940510b91dd4e9cdc7500a9086,2,7,8,1,0,0,0,3,3,22,1,2,0.566509507,435,1,0,33,33,0,2707,2703,4,14,14,0,1,100,NoArch
e93c6a569310ce55c5a0fc0655328e7fd32a9da2,4,112,48,64,1,0,1,8,21,195,1,3,1.738677524,1299,46,2,182,178,4,7003,6868,135,92,89,3,1,99.92206983,NoArch
fc6c5f4285098d18cd7f6e81785f59e68a3b6862,69,195,198,3,0,0,0,1,18,4,1,25,5.665575449,13657,16,5,1205,1205,0,72879,72904,25,604,604,0,1,93.85645654,Arch
76bf2cc790edc0be10dfa2454c42687c38e7e5fc,9,135,62,73,0,0,0,1,2,0,1,6,2.53408412,1767,17,6,154,146,8,9280,9015,265,108,102,6,1,100,NoArch
3b36cb805d066a3112e3a355ef502dbe4b2c1824,8,126,87,39,0,0,0,3,18,156,3,7,1.572673885,3072,32,2,264,256,8,18109,18001,108,142,141,1,1,100,NoArch
16864aee14d465a098ca58599bce6c08eadd1b0b,1,1,1,0,0,0,0,8,12,72,1,1,0,99,1,0,4,4,0,488,488,0,3,3,0,1,100,NoArch
b038623ed3318404f9bc4707f005a9fc458c0adf,4,7,4,3,0,0,0,2,4,263,2,4,1.980825936,324,47,2,24,23,1,1722,1685,37,17,17,0,1,100,NoArch
74241947c123c860a1b0344f25cef316440a70d6,77,4523,377,4146,29,0,29,3,62,70,6,55,5.320703045,21065,13,1,2382,1997,385,167583,141726,25857,1491,1258,233,1,86.61123367,Arch
968488fa3a3c67962ed5b60e00836e71c730a9a5,2,22,2,20,0,0,0,1,3,6,1,2,0.994984828,625,18,7,57,52,5,4466,4299,167,30,29,1,1,100,NoArch
f1e0018f12b66770ba3785be7aa8f5f6a80bab6f,4,168,20,148,0,0,0,1,3,8,1,4,1.285724484,807,19,8,53,38,15,5390,4198,1192,42,33,9,1,91.6832868,Arch
d429169ff7ef66dfcd6825b74fcbceddb46369a5,0,0,0,0,0,0,0,0,0,0,0,0,0,0,1,1,0,0,0,0,0,0,0,0,0,1,100,NoArch
e602e5dfb9f3db6ee31267f305f4449dc4b32b40,1,0,1,1,0,0,0,11,15,5,1,1,0,1055,25,0,107,107,0,5500,5509,9,57,57,0,0,100,NoArch
1277c62398c58690cd5a6aa78048335d5313ca05,3,170,5,165,1,0,1,1,2,272,1,3,0.988101791,106,0,0,23,8,15,1363,270,1093,21,8,13,1,91.67332268,Arch
f74828fca10ca5539c1aaad2c5e99bb1ddb373c5,4,88,47,41,0,0,0,1,3,10,1,4,0.82320605,1317,20,8,110,106,4,6980,6715,265,68,65,3,1,100,NoArch
55a489c769c7681d2732aa99f963d02d26ed991b,0,0,0,0,0,0,0,0,0,0,0,0,0,0,48,3,0,0,0,0,0,0,0,0,0,0,100,NoArch
161d530f932f4f1bc676e3c1b784858b18e4939f,3,20,25,5,0,0,0,13,24,40,1,3,0.757833408,2304,49,4,174,176,2,17476,17489,13,112,112,0,0,100,NoArch
900de34e45b4c1d19c01ea84adc38413f2bd52ff,5,307,4,303,3,0,3,1,11,233,1,5,1.845959966,130,2,0,29,6,23,2176,666,1510,20,5,15,1,99.52914798,NoArch
ce3e8ec87083ef4cd4f33de39b6697f66ff3f277,0,0,0,0,0,0,0,0,0,0,0,0,0,0,1,0,0,0,0,0,0,0,0,0,0,1,100,NoArch
d7b18783bdd6edd6355ee68714982401d3321f86,7,42,17,25,0,0,0,10,18,9,5,7,2.448214656,2759,14,1,226,223,3,20556,20309,247,157,155,2,1,99.82086879,NoArch
0e6909d3e241c794ed1b9318fcb9142a36cb0133,0,0,0,0,0,0,0,0,0,0,0,0,0,0,0,0,0,0,0,0,0,0,0,0,0,0,100,NoArch
03668dbaf1a60428d7e0d68c6622605e0809150a,3,86,49,37,0,0,0,1,4,16,1,3,0.782214179,812,21,9,77,74,3,5550,5293,257,40,39,1,1,100,NoArch
01a1d7997bc8f3f82452ebf8e2e655143d00926c,3,27,27,0,0,0,0,10,19,6,3,3,1.12465812,2019,15,2,142,142,0,15272,15272,0,103,103,0,1,100,NoArch
29b79c99b02d66ef9b087b56223e74c0d1f99e94,1,19,8,11,0,0,0,1,4,17,1,1,0,156,22,10,15,14,1,953,916,37,7,7,0,0,100,NoArch
9bfd810e745202bd27980fa696d61b47922f46a9,0,0,0,0,0,0,0,0,0,0,0,0,0,0,3,0,0,0,0,0,0,0,0,0,0,0,100,NoArch
399604412b9a5f59ae88a0dac98d94e61638a43a,2,25,0,25,0,0,0,8,12,47,2,2,0.942683189,529,13,0,59,55,4,3339,3229,110,37,37,0,0,100,NoArch
b7c47b195861c90269f10932dd2838e2f53bf326,6,20,14,6,0,0,0,10,23,22,3,5,1.731360029,4879,16,3,570,567,3,30388,30384,4,450,450,0,1,100,NoArch
8cc8c0b743840e1b365e8625202fed0a53f66621,0,0,0,0,0,0,0,0,0,0,0,0,0,0,14,1,0,0,0,0,0,0,0,0,0,0,100,NoArch
0921272442b424000f39fea73c5abc30037d67f1,0,0,0,0,0,0,0,0,0,0,0,0,0,0,4,1,0,0,0,0,0,0,0,0,0,0,100,NoArch
a90125a324921cac7e62306ec925246a4c9e8a4b,0,0,0,0,0,0,0,0,0,0,0,0,0,0,15,2,0,0,0,0,0,0,0,0,0,0,100,NoArch
da65d3cae99e8fee0ede9b5ed8630a3716d284c8,0,0,0,0,0,0,0,0,0,0,0,0,0,0,5,2,0,0,0,0,0,0,0,0,0,0,100,NoArch
8b774fe3313757a8b94ca408079327c62b4a664c,20,331,321,10,0,0,0,1,19,16,1,12,3.19605161,4611,23,7,333,336,3,27644,27787,143,212,214,2,1,100,NoArch
399604412b9a5f59ae88a0dac98d94e61638a43a,22,348,333,15,0,0,0,8,18,4,3,14,3.338365394,5150,13,0,395,388,7,31126,30873,253,251,249,2,0,100,NoArch
bec70413c0943f38ee5cdf62fa3a79af44d8cded,28,351,360,9,0,0,0,7,23,17,4,19,3.540960422,10044,16,3,958,962,4,61261,61510,249,699,701,2,1,100,NoArch
b7c47b195861c90269f10932dd2838e2f53bf326,22,348,333,15,0,0,0,8,18,4,3,14,3.338365394,5150,16,3,395,388,7,31126,30873,253,251,249,2,1,100,NoArch
ecbd389a3f9215e219cb19b8641f2faea4fa3ad7,28,631,584,47,2,0,2,7,19,29,3,18,3.474444813,5709,21,0,437,441,4,34342,34425,83,275,275,0,1,99.84350548,NoArch
0921272442b424000f39fea73c5abc30037d67f1,28,586,633,47,0,2,2,8,18,15,3,18,3.475373225,5756,4,1,441,437,4,34425,34342,83,275,275,0,0,99.84350548,NoArch
d415d45416707ca4d5b1dbad65dc80e6fccfa378,35,1277,619,658,5,0,5,7,20,16,3,22,4.258870187,7115,24,8,615,575,40,46015,43176,2839,368,344,24,1,99.64269763,NoArch
452f5e2d661ee667cdd1348c0f580fcc650318b7,2,25,0,25,0,0,0,8,12,54,2,2,0.942683189,529,13,0,59,55,4,3339,3229,110,37,37,0,0,100,NoArch
4db970dc8afd79964bbfa85097954750cb4f1ab2,0,0,0,0,0,0,0,0,0,0,0,0,0,0,14,1,0,0,0,0,0,0,0,0,0,0,100,NoArch
e069b64e10124de76e0d54d0f24d4ec95890e82d,0,0,0,0,0,0,0,0,0,0,0,0,0,0,4,1,0,0,0,0,0,0,0,0,0,0,100,NoArch
050626ad6cb8bbd06d138456ccc00dddcff2a860,0,0,0,0,0,0,0,0,0,0,0,0,0,0,15,2,0,0,0,0,0,0,0,0,0,0,100,NoArch
a90125a324921cac7e62306ec925246a4c9e8a4b,33,596,1279,683,0,5,5,1,18,11,2,20,4.20096943,7244,15,2,516,560,44,39837,42786,2949,307,331,24,0,99.64269763,NoArch
3cab928b508be6729c9c8abe30b4beb5ddd12b04,33,1277,594,683,5,0,5,1,20,15,2,20,4.200587964,6561,18,0,560,516,44,42786,39837,2949,331,307,24,1,99.64269763,NoArch
8bc65b93189e249be43fe6cba2387ca83babc2c8,2,7,7,0,0,0,0,1,6,21,1,1,0.985228136,653,0,0,77,77,0,4638,4638,0,33,33,0,1,94.76577963,Arch
aa0da72c59cb3764205f90b025b24d1640727795,4,6,9,3,0,0,0,8,9,190,2,4,1.889246429,1632,0,0,120,120,0,11499,11547,48,67,67,0,0,100,NoArch
fe16d0de7c76105775c887b700751241bc82624c,1,0,319,319,0,1,1,8,8,158,1,1,0,319,19,1,0,36,36,0,2049,2049,0,11,11,0,94.80519481,Arch
9804662bc8e17d6936c20326f17ec7c0360dcaf6,20,557,158,399,2,0,2,1,33,41,3,15,3.723504722,5264,25,6,543,502,41,32673,30341,2332,301,285,16,1,98.31597607,NoArch
684622c7c9fa6df9eb177b51cb1e7bd6dd16f78d,6,41,6,35,0,0,0,31,63,158,3,5,2.414932932,2590,8,0,368,362,6,14134,13872,262,170,168,2,1,100,NoArch
94a5e72f16620da86bd2ca7ef27bb9abc266cc47,2,47,43,4,0,0,0,2,5,96,1,2,0.970950594,354,0,0,30,26,4,1984,2065,81,19,15,4,1,99.95600528,NoArch
e970e1f48302aec3af7eeca009a2c793757cd501,0,0,0,0,0,0,0,0,0,0,0,0,0,0,0,0,0,0,0,0,0,0,0,0,0,1,100,NoArch
da65d3cae99e8fee0ede9b5ed8630a3716d284c8,59,826,1942,1116,0,7,7,31,62,22,4,36,5.011623601,15634,5,2,1386,1445,59,86270,89635,3365,743,778,35,0,97.84779232,Arch
920537cac83d59ac05676fb952d5479c41adf757,62,2067,1249,818,7,1,8,31,63,47,5,38,4.991628277,15202,0,0,1518,1456,62,94786,91324,3462,806,771,35,1,97.84779232,Arch
9c369c607df2816ea2cd1221fb6d879e3fb8f74c,25,638,400,238,2,0,2,1,21,70,3,15,3.820701534,5493,26,5,436,442,6,30906,29576,1330,256,247,9,1,98.86487666,NoArch
e692c704da732c0f2a4d2892729687766a462e53,0,0,0,0,0,0,0,0,0,0,0,0,0,0,1,1,0,0,0,0,0,0,0,0,0,0,100,NoArch
8527590772d05b58dcf7db460f743c6a43b78c1b,1,2,1,1,0,0,0,7,7,1,1,1,0,156,1,1,20,20,0,858,846,12,7,7,0,1,100,NoArch
d035fcbb3cf7aa33bafdd902a5e6a76f549e7ee1,2,25,4,21,0,0,0,5,8,1104,1,1,0.999142104,144,1,0,26,20,6,543,475,68,18,12,6,1,100,NoArch
dadd081d454a25cb57668ca89a8338a9cb9493ad,1,6,2,4,0,0,0,15,25,55,1,1,0,299,2,2,33,34,1,1798,1772,26,12,12,0,1,100,NoArch
f4f9dd9d83a6a852c0e733802c6c49747cde5531,1,1,1,0,0,0,0,6,6,738,1,1,0,76,2,1,12,12,0,252,250,2,7,7,0,1,100,NoArch
3a926aacf6552fc06005db4a7880a233db904330,1,3,4,1,0,0,0,8,11,738,1,1,0,226,3,2,28,28,0,1036,1061,25,23,23,0,1,100,NoArch
18459d4045ec4a85081c227893b226a4d759f84b,2,10,8,2,0,0,0,3,4,497,2,2,1,165,0,0,11,11,0,904,899,5,6,6,0,0,100,NoArch
ecdbd2517fd8157d9e96f3d9abf195a589e191ae,11,725,84,641,2,0,2,6,28,304,3,8,2.283748939,3084,34,0,284,251,33,27795,23576,4219,149,120,29,1,99.42035208,NoArch
5b3608f14951e3aaf4ef7b5238bf32f524c24bb0,2,31,5,26,0,0,0,2,2,72,1,1,0.979868757,109,4,3,14,7,7,321,236,85,14,7,7,1,100,NoArch
cf3d2e21ebf66f3709b3fbb036d0e30526e6f938,0,0,0,0,0,0,0,0,0,0,0,0,0,0,16,3,0,0,0,0,0,0,0,0,0,0,100,NoArch
08e82c469c456fbafc66c8e232dcd070f05fadee,2,54,1,53,1,0,1,2,2,243,1,2,0.788940657,37,2,0,4,1,3,307,145,162,3,1,2,1,99.95748299,NoArch
6786581c4842e47e1a8a8e942f54003dc151c7c6,6,58,11,47,0,0,0,1,22,8,1,6,1.806331816,2109,27,3,134,131,3,12150,11911,239,74,74,0,1,99.95753715,NoArch
8d4a7fe33e041719e2509f1f8ad3667e2ae7bbb4,1,3,1,2,0,0,0,7,7,521,1,1,0,84,2,0,7,7,0,303,296,7,5,5,0,1,100,NoArch
b554835053b0b2653ac34a8fdb923fd197ede724,1,1,1,0,0,0,0,8,8,11,1,1,0,157,1,1,20,20,0,858,858,0,7,7,0,0,100,NoArch
f3777f44fe3229e9582a03d5734a4580eaa8503a,15,6,40,34,0,0,0,2,22,236,2,9,3.108884766,2578,26,0,321,321,0,15011,15326,315,138,138,0,0,100,NoArch
1da16dfd2e4c0277ecfab8a5f0928757c3005bb1,2,3,3,0,0,0,0,5,7,358,1,2,0.918295834,714,3,0,82,82,0,4414,4407,7,32,32,0,1,100,NoArch
040756d8c0db4633ac3cccaa11e4172e8e077e1e,4,5,12,7,0,0,0,11,52,112,3,3,1.451660764,1240,27,1,126,127,1,7206,7217,11,42,43,1,1,99.78795589,NoArch
1ff99ca7d7bbdcb24ebae96c434a35000eded1fc,2,7,1,6,0,0,0,8,23,8,1,2,0.811278124,881,28,3,53,53,0,4749,4719,30,29,29,0,1,100,NoArch
e16d31dce2386868634963ec7cf79c5dfae03cc7,0,0,0,0,0,0,0,0,0,0,0,0,0,0,5,4,0,0,0,0,0,0,0,0,0,1,100,NoArch
65844a8d29b715227f3b2ecdf9b102a08950ee67,1,24,7,17,0,0,0,12,18,265,1,1,0,167,3,1,21,17,4,1024,938,86,9,8,1,1,100,NoArch
ab4a7b0b4afc66d2123c7f63fdab77b925a8a7f1,22,519,88,431,3,0,3,4,16,43,4,13,3.843419837,4857,29,4,464,426,38,30262,27848,2414,260,242,18,1,99.49206349,NoArch
8d29863c86aed57dc8f1a0a450bce3b256de2960,1,6,0,6,0,0,0,2,3,767,1,1,0,161,50,0,19,18,1,992,924,68,16,15,1,1,100,NoArch
62bb9e10d9d2f2a9807ee46b0ed094ef2fcc89e5,2,5,5,0,0,0,0,3,24,141,1,2,0.721928095,354,2,2,35,35,0,2309,2313,4,12,12,0,0,100,NoArch
6d1aec604fd854dc0fb27a4c6aa6113ae771c7e1,1,1,1,0,0,0,0,2,2,92,1,1,0,373,6,5,35,35,0,2117,2113,4,13,13,0,1,100,NoArch
191470d1fc9b3596eb4da2413e8bef286ccc7135,0,0,0,0,0,0,0,0,0,0,0,0,0,0,0,0,0,0,0,0,0,0,0,0,0,1,100,NoArch
b6d949b48a649acac27d5d9b91677bf2e25e9342,4,49,30,19,0,0,0,1,10,91,2,3,1.49029252,927,30,4,71,71,0,5705,5625,80,37,37,0,1,100,NoArch
62b8a341ddae0ab80195c41c7a44b84c1fe23d31,1,8,1,7,0,0,0,2,2,95,1,1,0,385,4,1,51,49,2,2198,2134,64,13,13,0,1,100,NoArch
1d53d6e6c2d3ff967d333d87b308406c8cd6917a,2,3,0,3,0,0,0,5,8,278,1,2,0.918295834,137,0,0,8,8,0,550,533,17,6,6,0,1,100,NoArch
4e050cc2ba2620d83687be5e5d69dcd747e9f72c,0,0,0,0,0,0,0,0,0,0,0,0,0,0,19,0,0,0,0,0,0,0,0,0,0,0,100,NoArch
f7b6b680632115da7eb63eceadf95bd99f02d355,1,20,20,0,0,0,0,5,5,158,1,1,0,638,3,2,21,21,0,5098,5098,0,17,17,0,0,100,NoArch
dab5114f168112f6e195af8257c01a7c7c8ee082,3,97,25,72,0,0,0,1,6,74,1,2,1.556500578,524,31,5,63,52,11,3005,2738,267,30,26,4,1,99.91539763,NoArch
ec2334ceac28463d7586d79f6078c69fb3eb4877,3,35,4,31,0,0,0,3,3,367,3,3,0.937194895,232,0,0,16,11,5,1682,1371,311,12,9,3,1,100,NoArch
d21753d903a78f2f728c9e77b5fed2e3a06f6c1c,0,0,0,0,0,0,0,0,0,0,0,0,0,0,3,0,0,0,0,0,0,0,0,0,0,1,100,NoArch
6b4b878d089c5a0ba88e94b0ec747d648c6a6084,2,19,0,19,0,0,0,2,8,434,1,2,0.629249224,396,3,3,28,26,2,2676,2579,97,11,10,1,1,100,NoArch
9a288ccbebf1aee3164e7bc472a3e795bb83652b,1,2,2,0,0,0,0,8,15,101,1,1,0,506,1,0,51,49,2,3046,3042,4,15,15,0,0,100,NoArch
d6d52c60636ae6a0c16469fa6761d0080fddf72f,3,88,12,76,1,0,1,1,4,38,1,3,1.031893959,849,32,5,90,83,7,4663,4281,382,49,46,3,1,99.95768091,NoArch
3253079507d74f6d52e78ad7f88b297daf969455,3,153,2,151,1,0,1,3,29,71,2,2,1.042085744,595,1,0,81,69,12,5775,4619,1156,28,25,3,1,100,NoArch
aacb8be5213a64a3cc9ddd791e2321526517d044,10,250,33,217,1,0,1,11,21,192,2,6,2.856430291,4415,9,0,464,435,29,32177,30851,1326,205,198,7,1,99.85216473,NoArch
ac3589f00659985c39ef29e5edd089279f6c2f70,4,68,6,62,0,0,0,1,11,48,1,3,1.708223141,1333,33,6,66,62,4,8134,7662,472,45,44,1,1,99.45182374,NoArch
cc81ddde01d6c743708e68c7fb6394facca1e672,2,12,1,11,0,0,0,2,9,11,1,2,0.995727452,829,7,3,44,43,1,4270,4178,92,19,19,0,1,100,NoArch
c24d90d25a049dc6a9e3213f2b6906c2374c0e28,1,5,1,4,0,0,0,4,4,320,1,1,0,58,20,0,7,6,1,208,185,23,4,3,1,0,100,NoArch
b31c520c66a65723580807b8eb6a2639c96328a8,6,235,7,228,0,0,0,6,13,115,2,4,0.787153776,2615,0,0,318,300,18,21428,19535,1893,204,193,11,1,100,NoArch
4a3431866d995fd877a067967457591a0bc8847d,4,282,30,252,1,0,1,1,24,210,1,3,1.813505051,900,1,1,70,54,16,9151,7175,1976,36,26,10,1,99.5995785,NoArch
a1e636dc6b4cd39606f7e47cbb1363f4fa9b79e4,2,20,0,20,0,0,0,2,2,512,1,2,0.811278124,595,0,0,55,53,2,3445,3273,172,23,23,0,1,100,NoArch
a5789c40673b36d40adab696706acc1446a286f8,1,9,10,1,0,0,0,1,4,7,1,1,0,645,34,7,73,73,0,3239,3253,14,40,40,0,1,100,NoArch
1b27259b530225e3c76fda684f888cad78045d3c,4,147,17,130,0,0,0,1,12,22,1,4,1.371708597,1950,35,7,121,109,12,11114,10390,724,71,65,6,1,100,NoArch
3e4fa170cfd2c198599c3bed3982f2f643c7fbe8,3,8,8,0,0,0,0,13,26,58,1,3,1.298794941,2310,51,1,175,175,0,17526,17526,0,113,113,0,1,100,NoArch
d047e91d86d6905c0f66dbdb24f2e9ecd3684430,13,159,54,105,0,0,0,8,24,144,3,8,2.690033856,3613,36,7,352,338,14,19479,19039,440,198,183,15,1,99.59583067,NoArch
f4e3b949714aceaf8823fd1659e44d3b7e98089a,3,28,1,27,0,0,0,4,23,63,1,2,1.31625222,2314,0,0,184,180,4,17537,17350,187,119,117,2,1,100,NoArch
9bbb458e888273af95b04f72cc5b428524b41487,1,1,1,0,0,0,0,4,4,123,1,1,0,184,4,2,13,13,0,1230,1234,4,9,9,0,0,100,NoArch
5be3997f70415e1752a0b5214f9398880fc8fd1f,5,112,11,101,0,0,0,1,25,6,1,5,1.825381369,1777,37,8,134,129,5,10390,9667,723,82,79,3,1,100,NoArch
63fa2b618626b2b8e9530ec105e0d4995eebb643,2,18,0,18,0,0,0,2,3,65,1,2,0.650022422,333,8,2,32,31,1,1554,1493,61,24,23,1,1,100,NoArch
299958650916eecc243f20bf9362ed70073d30db,1,19,3,16,0,0,0,4,5,2,1,1,0,252,20,1,18,16,2,2134,2032,102,12,11,1,1,100,NoArch
e4fd195d9fd0cc1128b8c6797d88e56402b166bd,4,82,16,66,0,0,0,7,9,20,1,4,1.687679551,1812,5,3,188,179,9,12947,12535,412,87,79,8,0,99.91423671,NoArch
386767693d46e7419c4fb0fa292ccb7ab7f7098d,2,45,6,39,0,0,0,11,13,147,1,2,0.522559375,2210,21,2,168,163,5,16514,16190,324,90,88,2,1,99.04801325,NoArch
3ca90302562580a7c5c69fd3f11ab376cfac1f0b,0,0,0,0,0,0,0,0,0,0,0,0,0,0,0,0,0,0,0,0,0,0,0,0,0,1,100,NoArch
c9bcb5e33f7f9f97af0e8429a88d95f58ee48f13,2,47,0,47,1,0,1,1,2,398,1,2,0.550984443,44,10,1,4,2,2,314,152,162,2,1,1,1,99.31918302,NoArch
6e9c5dd76548911abd346fad61a0dd6d3c623af9,7,177,167,10,1,0,1,1,13,13,1,7,2.309718329,2520,38,8,159,155,4,13187,13241,54,93,92,1,1,99.95998399,NoArch
6848a683bd89a6f5f30559f7daff918a498f0808,4,112,17,95,0,0,0,1,14,25,1,4,1.564093172,1875,39,9,180,168,12,11677,11131,546,93,88,5,1,99.2921746,NoArch
929eca43fe8fb9cac6eedd50656a6616616d0b11,3,45,1,44,0,0,0,6,17,168,1,3,1.034023831,1362,4,0,128,126,2,9793,9515,278,61,59,2,1,100,NoArch
faf3785a2de24415ab8cb7c8072cc738f8282db9,1,29,35,6,0,0,0,10,19,208,1,1,0,493,55,0,21,23,2,3791,3765,26,7,9,2,1,100,NoArch
46de9e0f3fd0ff5e33c8e37c6bb9dc5d6ae6d214,0,0,0,0,0,0,0,0,0,0,0,0,0,0,56,1,0,0,0,0,0,0,0,0,0,1,100,NoArch
3418a92de8a45986e55a29a9498791222f6a6fa6,6,80,14,66,0,0,0,2,3,552,1,3,2.439663952,442,57,2,21,16,5,3609,3232,377,18,13,5,1,100,NoArch
ea14d687da0e20a4673efa1326e5332978305269,1,14,3,11,0,0,0,12,14,13,1,1,0,404,1,1,38,37,1,2688,2620,68,15,15,0,1,100,NoArch
c5220b96e94d13530f14cd4ea9ba04cd1e559474,2,28,1,27,0,0,0,2,15,4,1,2,0.735508582,885,1,1,65,62,3,6143,5934,209,36,35,1,1,100,NoArch
1db904a12ed295e08ded14bb5677dc02d76887a2,2,73,1,72,0,0,0,2,15,964,1,2,0.179256067,1181,5,1,153,151,2,7632,7081,551,58,57,1,1,100,NoArch
0284cdecce3136c28cd8599f77f9a0b174145265,1,1,1,0,0,0,0,3,3,355,1,1,0,85,52,1,6,6,0,607,602,5,4,4,0,1,100,NoArch
0a5863939b8da149f6dab3ec0fdb86d77baa9739,10,36,1146,1110,0,7,7,2,8,166,1,6,3.071270476,1439,9,1,8,95,87,2199,8490,6291,3,42,39,1,87.60480026,Arch
528f4ca988209cbc9e519bd42b87b896aea992b6,5,36,32,4,0,0,0,1,10,40,2,5,1.876418023,1889,40,5,193,194,1,9466,9540,74,105,106,1,1,100,NoArch
2c5a661a64d7d6ae117013f6df9b24ecb63108fe,2,36,28,8,0,0,0,7,10,30,1,2,0.448864489,1245,4,0,102,102,0,9146,9067,79,44,44,0,1,100,NoArch
bfbf993cbe3f1e3fab93095f4342ed17423efab5,11,298,224,74,0,1,1,1,14,62,2,9,2.96597972,3385,41,6,273,270,3,17952,17498,454,169,166,3,1,99.97139588,NoArch
c1b331bcffaffde7661b75a9b846b117e9df63dc,4,49,8,41,0,0,0,1,26,12,2,4,1.323911525,1170,42,6,121,115,6,6133,6013,120,74,72,2,1,100,NoArch
511ac4881d6bf3385fd98946594aae16088047f1,1,3,18,15,0,0,0,2,2,168,1,1,0,406,10,2,52,53,1,2009,2051,42,18,19,1,0,100,NoArch
8a48d16e41b544787459454ef4b81e6852cd500b,9,44,13,31,0,0,0,5,64,288,4,7,2.701115916,4715,3,0,533,525,8,28271,28065,206,246,245,1,1,100,NoArch
aa398f77f13dbf98731b33d027f7f942aef62ffe,3,115,14,101,0,0,0,7,18,86,1,3,1.430524778,1017,2,0,81,74,7,7889,7408,481,53,48,5,1,100,NoArch
42ec7e30d74104a15ff76cb004fe7a0c2649abe6,2,11,0,11,0,0,0,2,8,90,1,1,0.994030211,305,43,5,29,27,2,1282,1241,41,19,17,2,1,100,NoArch
7a5af806cfe54474014db5c70641c0c6269fff03,2,77,0,77,0,0,0,2,8,42,1,2,0.972449715,488,11,3,39,35,4,3994,3355,639,27,25,2,1,100,NoArch
ac72470e10f8e7bd437c9e232e58d749750ed483,0,0,0,0,0,0,0,0,0,0,0,0,0,0,53,1,0,0,0,0,0,0,0,0,0,1,100,NoArch
be9db2c4f5a570fcaa555618b34ad11109ed6b00,41,355,215,140,1,0,1,4,23,343,6,29,4.559701599,15951,0,0,1123,1117,6,121284,120111,1173,671,667,4,1,99.49465781,NoArch
5a8b2a4f8675e26d40df9c05ce4c7db3eaff8d8c,1,14,0,14,0,0,0,5,6,202,1,1,0,507,23,0,27,27,0,3460,3392,68,10,10,0,1,100,NoArch
b98c9ab4392727b6b9731aea88deaa5337a91dcf,10,103,34,69,0,0,0,2,17,66,2,6,2.819443722,2758,44,6,273,263,10,14933,14739,194,153,148,5,1,93.85365854,Arch
6f7ff7e8ca3a83d858561dd08f8f093787caa9b2,4,110,2,108,0,0,0,8,24,231,1,4,1.48491825,954,6,2,85,76,9,8246,7294,952,47,43,4,1,99.98951782,NoArch
ad77cf42ba7d8eab086be1f6d91f465bf29164ed,13,340,276,64,1,0,1,1,18,14,2,8,2.961391075,3323,45,5,346,325,21,18617,18269,348,179,173,6,1,97.02993182,Arch
12443e41873269a2c0ba12447f73c8a88fa7138f,5,92,7,85,1,0,1,5,18,327,2,4,1.874506732,766,0,0,81,72,9,4448,4047,401,52,45,7,1,98.46657929,NoArch
8869b3b4184bbec4502e2e3f6fde0ea9260cf0b0,5,32,8,24,0,0,0,1,16,96,2,5,2.033778887,1680,46,6,168,164,4,8079,7939,140,99,97,2,1,100,NoArch
fcedbfcb58109f6af0b0a1e69915b40a0fcd5ccb,1,0,1,1,0,0,0,2,2,337,1,1,0,242,6,0,28,28,0,966,971,5,17,17,0,0,100,NoArch
46a2399a45803e1b0d863eec47168a09c37ab920,9,337,89,248,2,0,2,1,17,121,2,7,2.572873618,2128,47,7,142,118,24,13566,12450,1116,81,65,16,1,98.44077568,NoArch
7d2971d4e23b1f2724e9c0ea3f233fa8105f8c1f,5,89,24,65,0,0,0,2,18,4,1,5,0.970171015,2498,48,8,157,153,4,13821,13457,364,88,84,4,1,100,NoArch
5d1f592395fe23459091ac2c7a5d539cdd9be819,0,0,0,0,0,0,0,0,0,0,0,0,0,0,54,2,0,0,0,0,0,0,0,0,0,1,100,NoArch
fe3f5c2d560d9f27984b97c9840b7572337bd420,4,12,25,13,0,0,0,9,13,840,3,4,1.921649569,682,0,0,65,70,5,3957,4007,50,39,39,0,1,100,NoArch
ced068e1ee79147dfe959676c953441bf6da5e87,1,0,8,8,0,0,0,8,10,192,1,1,0,380,28,0,44,45,1,2769,2831,62,22,23,1,0,100,NoArch
9b01d2f864e5cc4a559cfd4199136bca0979b095,6,171,11,160,1,0,1,1,17,39,2,6,1.891128991,2370,49,9,166,155,11,14569,13553,1016,89,82,7,1,98.65820932,NoArch
928b09ea0b2d97bc5055170c8c87fa0103615b4c,2,11,2,9,0,0,0,2,18,78,1,2,0.995727452,689,0,0,22,21,1,3583,3525,58,14,14,0,1,100,NoArch
081061e14bd54be4ee8f4eef6253d5ec9d395ee7,5,116,0,116,0,0,0,8,24,287,1,3,1.24203675,1042,7,1,92,83,9,8514,7545,969,62,57,5,1,96.58369317,Arch
7c213f9f260fa911db3fbdbc74cb4f723edf3dbc,1,3,10,7,0,0,0,8,19,21,1,1,0,529,50,10,81,82,1,3781,3880,99,39,39,0,1,100,NoArch
a96034d38d378e4c53b72d50e7b7bcd91da9552d,3,79,11,68,0,0,0,2,2,597,1,3,1.565817877,392,6,0,57,50,7,2547,2185,362,25,20,5,1,100,NoArch
99b14a78e38b081efbdda59243626c244335ea7c,1,2,2,0,0,0,0,3,6,43,1,1,0,110,1,1,4,4,0,639,639,0,1,1,0,1,100,NoArch
685f77b5dda92bb4ecd3a5480a1a5ed2eaee5fef,11,161,107,54,0,0,0,8,15,108,3,10,2.823666874,4880,0,0,371,364,7,38489,38074,415,228,232,4,1,99.94382022,NoArch
653981373339b8ce74b1227278d435f5c34d2deb,1,3,1,2,0,0,0,3,3,263,1,1,0,26,29,1,0,0,0,21,21,0,0,0,0,0,100,NoArch
369a8493378f069d5471098d75a251fa67d99737,0,0,0,0,0,0,0,0,0,0,0,0,0,0,0,0,0,0,0,0,0,0,0,0,0,1,100,NoArch
aba1eadbfc015095f31271b2648faa7023126b99,3,108,9,99,0,0,0,2,19,133,1,3,1.11723731,1046,0,0,123,115,8,7099,6529,570,33,29,4,1,100,NoArch
e7020748b500e38838a8d84df64267a07b529aa7,8,22,11,11,0,0,0,32,65,211,6,6,2.911650471,3328,30,2,366,366,0,18896,18778,118,161,161,0,1,100,NoArch
afa6bc0b100450b5d80a27bf5b87cbd4a0fbb3a5,4,184,10,174,1,0,1,1,15,176,2,3,0.92257839,682,58,0,91,81,10,6252,4737,1515,54,46,8,1,97.26556695,Arch
112732db815660dfdf4b62aa443127d7884b6e63,1,3,3,0,0,0,0,5,6,124,1,1,0,108,34,0,9,9,0,638,644,6,8,8,0,1,100,NoArch
4eb6ef8144861599f858b4119a3574e37dfbea58,1,1,1,0,0,0,0,6,7,1267,1,1,0,83,0,0,6,6,0,413,413,0,2,2,0,1,100,NoArch
7fed7352bd506e20e5316bb0b3ed9e5c1e9c76df,4,48,13,35,0,0,0,8,28,172,2,3,1.286882853,1983,51,6,319,310,9,10822,10624,198,283,279,4,1,100,NoArch
bc18c39835d6775b063ae072aea4ba43177d66b1,7,133,11,122,0,0,0,2,29,37,1,7,2.037316042,2841,0,0,220,210,10,15852,15301,551,121,119,2,0,100,NoArch
974b476180e61fac58cd87e78699428d4108a482,1,94,0,94,1,0,1,1,1,0,1,1,0,0,31,3,1,0,1,374,0,374,1,0,1,1,99.93691847,NoArch
0709c62a6b48483a619ed99afc7dbfb493819236,3,95,5,90,0,0,0,9,16,393,2,3,0.787018995,756,4,0,91,88,3,6911,6174,737,61,58,3,1,99.98423707,NoArch
dcd7c331dc72df9ab10e4867a3592faf89f1480b,0,0,0,0,0,0,0,0,0,0,0,0,0,0,11,0,0,0,0,0,0,0,0,0,0,1,100,NoArch
d965b0550fe194f0082f5450ba5be4e07ef7aabf,1,0,1,1,0,0,0,2,2,299,1,1,0,289,0,0,41,41,0,1393,1395,2,27,27,0,0,100,NoArch
7a63175a7073d886110c1993eec872ded713e356,1,1,1,0,0,0,0,19,36,17,1,1,0,771,0,0,112,112,0,3529,3529,0,66,66,0,0,100,NoArch
34ab756a40b8ff25984a809803bffbe97c00a4ab,0,0,0,0,0,0,0,0,0,0,0,0,0,0,52,5,0,0,0,0,0,0,0,0,0,1,100,NoArch
219b92c8ae6343cc534b7e418d4e712c7f9f7fc1,1,1,1,0,0,0,0,2,3,0,1,1,0,288,1,1,41,41,0,1389,1393,4,27,27,0,0,100,NoArch
e6a71ea544f3dd1ab5227b4c89a1540df5f7891a,1,1,1,0,0,0,0,2,2,300,1,1,0,102,2,2,9,9,0,470,470,0,3,3,0,0,100,NoArch
83b0301c1aff51a59b88e8edf7e9cd047023086a,1,7,5,2,0,0,0,3,3,794,1,1,0,106,0,0,24,23,1,516,487,29,15,15,0,1,100,NoArch
83c31e356fa21b6312be10d5ccd4e21be8db7310,1,27,6,21,0,0,0,4,7,32,1,1,0,110,0,0,5,4,1,845,639,206,1,1,0,1,100,NoArch
bf1cfb563512116c0d414309ffe797719011ea5e,10,410,192,218,2,0,2,1,11,56,1,5,2.32734675,1598,53,4,149,128,21,9114,8376,738,89,72,17,1,99.79521109,NoArch
7fa2f8ea827257e0320f670e5f22a114a52933cf,2,7,0,7,0,0,0,9,30,14,1,2,0.591672779,959,54,5,54,54,0,5157,5115,42,30,30,0,1,100,NoArch
05a9830e861f21f74d0674edbed10f8fff853c08,0,0,0,0,0,0,0,0,0,0,0,0,0,0,1,1,0,0,0,0,0,0,0,0,0,1,100,NoArch
86007e9a13341e1181f940c5f6e5f6dba8eed755,2,2,2,0,0,0,0,3,8,42,1,2,1,351,1,1,9,9,0,2419,2405,14,3,3,0,1,100,NoArch
ad72691d24443bab1b3828bf435b3f8404ea9dab,0,0,0,0,0,0,0,0,0,0,0,0,0,0,2,1,0,0,0,0,0,0,0,0,0,1,100,NoArch
f6eee77636223077cfd2ce516f1b8805dfa6e35e,1,1,2,1,0,0,0,4,4,703,1,1,0,50,3,3,4,4,0,70,79,9,4,4,0,0,100,NoArch
870e97b5f82f7657ac1547c5ab38c0797aea5c27,1,0,12,12,0,0,0,6,6,151,1,1,0,293,32,3,32,34,2,1911,1973,62,15,16,1,0,100,NoArch
a658328001218273c3c9153b485340ac0e91db93,3,80,14,66,0,0,0,3,20,61,1,3,0.654551863,1680,55,4,167,162,5,9457,9194,263,84,82,2,1,100,NoArch
d02c0e5387481a4ac4bdc60163001b2a365150d9,0,0,0,0,0,0,0,0,0,0,0,0,0,0,73,0,0,0,0,0,0,0,0,0,0,0,100,NoArch
c4a2ad2702c28fc03392a917a878570af40062db,1,15,11,4,0,0,0,2,18,23,1,1,0,582,1,1,56,54,2,2653,2627,26,33,33,0,1,100,NoArch
cf90f17732e313cf71248a8baaf10307463d9b6e,3,28,5,23,0,0,0,4,4,276,2,3,1.274311382,439,1,1,40,38,2,3311,3124,187,21,19,2,1,100,NoArch
c2383ee9040001cfc1a9e8f6add65d24ad991969,2,9,16,7,0,0,0,8,15,89,1,1,0.634309555,779,56,5,95,96,1,5133,5200,67,26,26,0,1,100,NoArch
dab13f7473cfe4fad42189056e4c931ee2e2a297,1,1,6,5,0,0,0,2,3,209,1,1,0,238,4,4,31,32,1,1721,1740,19,15,15,0,1,100,NoArch
2a7e1e091e69c53acc0a19e3d792ca15a3d7db62,0,0,0,0,0,0,0,0,0,0,0,0,0,0,2,2,0,0,0,0,0,0,0,0,0,1,100,NoArch
08464a6a5b11ad2afa98eed7bc4e7777c4121b6b,8,177,38,139,2,0,2,2,12,56,1,4,2.462711056,1183,57,6,96,88,8,7447,6981,466,66,57,9,1,99.81129108,NoArch
0d0dc6fb07e0c5496224c75052ab4f43d57b40f6,1,2,1,1,0,0,0,3,6,93,1,1,0,384,3,3,36,36,0,2150,2148,2,13,13,0,1,100,NoArch
f3d7b49bfea0630dcf488c087755485d8d088270,1,0,2,2,0,0,0,14,19,81,1,1,0,601,4,4,99,99,0,3617,3648,31,52,52,0,1,100,NoArch
441076b2ccf66949310030fc6680bb68c259d8da,6,230,83,147,2,0,2,5,9,97,1,3,1.971324609,1657,59,1,136,125,11,12707,12028,679,78,69,9,1,90.68718905,Arch
919590988a4db1b73a67188d8b1b0d971f8b766d,3,158,4,154,0,0,0,4,9,456,1,3,1.469241895,481,55,0,39,25,14,4133,2892,1241,29,20,9,1,100,NoArch
57611d10b5ae5cb3580dcbd4abb4cdc131cbd575,2,284,0,284,2,0,2,1,1,0,1,2,0.953126983,0,3,0,16,0,16,1436,0,1436,12,0,12,1,90.75590551,Arch
cf83f10f5b369e1f16e63b4b68750d3ad2dc0240,11,507,113,394,4,0,4,2,21,4,1,8,2.846852771,2439,2,2,172,141,31,15790,13807,1983,96,75,21,0,99.83899533,NoArch
f760ec543ec9ea23b7d4c9f61c76a283bd737f27,31,475,124,351,3,0,3,12,37,265,5,22,4.041251197,10092,12,1,1204,1159,45,61632,60555,1077,734,715,19,1,99.87152722,NoArch
7261f0850727aea611cd34e1bb07d684b44534f6,18,814,102,712,7,0,7,32,66,83,5,16,3.458041202,4457,33,2,571,510,61,28444,24915,3529,387,357,30,1,97.18598857,Arch
75d663f65d1963fccf65149f052b8506c17898a1,1,1,3,2,0,0,0,9,12,0,1,1,0,510,5,5,76,76,0,3220,3254,34,25,25,0,1,100,NoArch
11360f707e969747e1a30791acb23857cc376589,1,1,1,0,0,0,0,8,10,395,1,1,0,99,5,5,14,14,0,362,361,1,7,7,0,1,100,NoArch
a6f5fc5967c1bcd509166686ab8a2dcc2c5dbd59,1,22,0,22,0,0,0,1,10,78,1,1,0,207,58,7,25,22,3,947,883,64,10,9,1,1,100,NoArch
e8fcf04b5709d795a1de086824b6eff462c8c835,3,17,12,5,0,0,0,1,9,27,1,3,1.537755967,1208,59,8,144,144,0,6254,6253,1,68,68,0,1,99.87868985,NoArch
728089a88827c3f4e9813f2d2e4d3d4a4a872605,7,53,62,9,0,0,0,2,14,0,1,5,1.631189503,1067,3,3,93,93,0,5620,5694,74,61,61,0,0,99.89229941,NoArch
afbafe70469c40ae6c23eec59848ca92b2f07fc7,1,1,0,1,0,0,0,11,15,3,1,1,0,413,60,9,46,46,0,2389,2383,6,19,19,0,1,100,NoArch
a8b10e9067301c1e264e975be9bd8f147be7880e,1,1,1,0,0,0,0,23,34,379,1,1,0,449,6,6,62,62,0,3074,3074,0,24,24,0,0,100,NoArch
e0108e972efcc22a06c487d14b0a8a59aef0f9f7,2,4,1,3,0,0,0,6,9,164,1,2,0.721928095,140,0,0,8,8,0,567,550,17,6,6,0,0,100,NoArch
125415a8b89bb9190d83b3ad74e68f1d86a05118,2,3,0,3,0,0,0,2,19,10,2,2,0.918295834,1062,61,9,107,107,0,5853,5837,16,59,59,0,1,100,NoArch
9e4114dd46cda4db23a24889cd267998734202da,2,284,0,284,2,0,2,1,1,0,1,2,0.915930508,0,4,1,13,0,13,1377,0,1377,12,0,12,1,99.9327505,NoArch
673d62f3c3ab07abb3fcd319607e657339bc0682,2,3,0,3,0,0,0,7,10,2,1,2,0.918295834,143,0,0,8,8,0,584,567,17,6,6,0,0,100,NoArch
ba728d822f733cf1978b95c6b6af793fdf041088,1,2,2,0,0,0,0,8,13,337,1,1,0,346,7,7,43,43,0,2225,2225,0,16,16,0,1,100,NoArch
0c4f2fdc15982870b59d3458303973af95984266,14,772,63,709,5,0,5,5,32,69,2,7,3.344168456,1934,3,2,144,103,41,14599,10870,3729,70,50,20,1,95.11815113,Arch
6e78682ceaa77eead10429a57c6f1d56a15fcedd,1,1,0,1,0,0,0,12,16,11,1,1,0,414,4,3,46,46,0,2393,2389,4,19,19,0,1,100,NoArch
7d9f9d7d8241bfb70d50c557b0194cc8a87b6ee7,0,0,0,0,0,0,0,0,0,0,0,0,0,0,56,1,0,0,0,0,0,0,0,0,0,1,100,NoArch
769dd2d7c98558146eb4accb75b6d8e339ae6e0f,3,128,68,60,1,0,1,1,27,98,1,3,1.053142078,648,6,5,49,47,2,5096,4755,341,26,24,2,1,99.94978659,NoArch
515ce8eb3642491c41e26139a57b74e3d9b43226,1,3,3,0,0,0,0,6,9,149,1,1,0,321,33,0,41,41,0,1890,1885,5,15,15,0,0,100,NoArch
f92283706408e25c48ed63abcbc9d07dc855106d,1,6,5,1,0,0,0,11,15,104,1,1,0,188,60,1,18,18,0,1312,1276,36,8,8,0,1,100,NoArch
cb642ceb75ef903a77593af943c6ba19053257ee,7,197,61,136,0,0,0,1,9,50,2,5,2.277307043,1769,62,9,163,158,5,9826,8983,843,86,83,3,1,99.92467043,NoArch
b8fe5b91d599418cd908d833fd63edc7f362c548,23,2158,87,2071,9,0,9,12,27,239,3,11,3.25740897,3839,2,0,767,473,294,32831,20046,12785,423,362,61,2,98.80683245,NoArch
910fe4842c2fefd57b45de1e0ac6b1998010dd73,0,0,0,0,0,0,0,0,0,0,0,0,0,0,74,1,0,0,0,0,0,0,0,0,0,0,100,NoArch
61efc6af79c389ef0a77cda75e4f562ed59ef86b,1,1,0,1,0,0,0,7,9,16,1,1,0,477,5,4,51,51,0,3192,3188,4,26,26,0,1,100,NoArch
8b0a502c4fd5352863009030a32e219bbf822a6c,1,3,0,3,0,0,0,2,10,1,1,1,0,446,4,2,47,47,0,1996,1992,4,27,27,0,1,100,NoArch
d519c746264c7210a604c8fb43efd084ae69ae41,4,13,10,3,0,0,0,23,35,145,1,1,1.962144157,1059,8,5,124,124,0,7453,7406,47,47,47,0,1,100,NoArch
5ce64a81bdfaa94aefacf7b365e6fb044763827c,2,25,1,24,0,0,0,4,5,388,1,2,0.391243564,288,5,3,20,19,1,2230,2085,145,11,10,1,0,100,NoArch
0b57483a8e41742689a1362aa94aabb94a1361b3,2,6,10,4,0,0,0,2,12,80,1,1,1,635,63,8,58,58,0,4357,4368,11,30,30,0,1,100,NoArch
6763b45dd4be89a62f57623f60798d1f751abca4,3,106,22,84,0,0,0,1,5,3,1,2,1.380305794,801,64,9,58,52,6,4906,4459,447,37,33,4,1,100,NoArch
ad53cf450ef01806ff8b2cfe8ff76fa350a7b4c5,4,107,9,98,0,0,0,5,10,100,1,4,1.27672182,1478,13,1,115,108,7,11518,10861,657,52,51,1,1,100,NoArch
f97dd25d41816f51f4c233d69456dd9892b201b5,2,20,0,20,0,0,0,2,15,44,2,2,0.468995594,840,6,5,59,58,1,4880,4695,185,26,25,1,1,100,NoArch
67c31243522268002c8b1bf5285dfe3c07cf5783,1,6,0,6,0,0,0,4,6,12,1,1,0,162,21,0,2,1,1,998,942,56,1,1,0,1,100,NoArch
b9e28e5292d9b2a4b665c26eeba660437a6a0a45,0,0,0,0,0,0,0,0,0,0,0,0,0,0,14,2,0,0,0,0,0,0,0,0,0,1,100,NoArch
aa6342c3c9af53e7064546becf987e26534d0764,16,156,291,135,0,1,1,2,33,27,2,8,3.331105652,2931,65,10,216,227,11,15397,16370,973,117,122,5,2,95.29164607,Arch
cdb9b48170ef98634babd8954392efb1c1b90fcf,6,23,60,37,0,0,0,2,24,5,1,5,2.237693221,2851,66,10,210,214,4,14163,14330,167,118,119,1,1,100,NoArch
53396061cc169efc99849406561ec5ec7cf437ad,2,1,3,2,0,0,0,2,2,12,2,2,0,224,9,5,12,12,0,974,1002,28,12,12,0,0,99.95135004,NoArch
7865da1e154b5dd9d3063511179993e20adf0579,3,4,5,1,0,0,0,11,16,256,2,3,1.530493057,607,10,6,59,59,0,3372,3383,11,17,17,0,0,100,NoArch
1cbdb49816ac779f803d0b7397f911a2f81ecca5,6,1235,0,1235,5,0,5,1,25,5,1,6,2.221216652,1672,0,0,235,130,105,19908,12806,7102,135,90,45,1,99.85426281,NoArch
c08fbb4268ee4b227452fd27d5e6ba322eeef00e,0,0,0,0,0,0,0,0,0,0,0,0,0,0,11,6,0,0,0,0,0,0,0,0,0,0,100,NoArch
e41f13fe7bf19302def4eb5607e95c9d7395266c,0,0,0,0,0,0,0,0,0,0,0,0,0,0,61,2,0,0,0,0,0,0,0,0,0,0,100,NoArch
429e9fb5fe78e96e565dd6b2ea0f1f9e56a43c6c,1,1,1,0,0,0,0,13,26,4,1,1,0,1716,1,1,133,133,0,13173,13173,0,91,91,0,1,100,NoArch
adf167991a762266afb75b4c0dcc583ae2d5858e,1,1,2,1,0,0,0,2,21,9,1,1,0,577,67,9,55,54,1,2613,2618,5,32,32,0,1,100,NoArch
f8d9242372e9c682ea2573dde8b308d5895357f9,2,26,2,24,0,0,0,10,34,10,1,2,0.811278124,437,6,3,44,42,2,2763,2616,147,21,20,1,1,100,NoArch
4fd8a88b7ef4666f0be90eed864fe3cf1ef896ee,0,0,0,0,0,0,0,0,0,0,0,0,0,0,15,3,0,0,0,0,0,0,0,0,0,1,100,NoArch
cb5cd35991afa2ed5b14ad92f2b98ae341fee9c4,1,1,1,0,0,0,0,17,30,291,1,1,0,339,7,4,56,55,1,1922,1915,7,44,44,0,1,100,NoArch
7bd517a82f9da3a6b42f6786da1d8a23151bdd94,2,54,0,54,0,0,0,6,7,1233,2,2,0.380946586,258,0,0,22,17,5,1547,1221,326,13,12,1,1,100,NoArch
5db37c255ba921b082f3f1952aa9182589f0a7a3,1,6,0,6,0,0,0,2,4,14,1,1,0,182,7,4,15,14,1,833,793,40,8,8,0,1,100,NoArch
69c0d9e2d000061cd5a22bf4abcd800574c4554d,0,0,0,0,0,0,0,0,0,0,0,0,0,0,16,3,0,0,0,0,0,0,0,0,0,1,100,NoArch
062d5baf842c22a6cf3b981ad605cafb6be3f130,3,4,27,23,0,0,0,6,16,317,2,3,1.358584608,1518,34,1,95,99,4,10073,10205,132,52,54,2,1,100,NoArch
11e64b2db0ddf8f816561f8442b373de15a26d71,6,114,22,92,0,0,0,6,17,169,2,4,2.262901919,2334,35,2,189,183,6,15649,15242,407,69,66,3,1,100,NoArch
3fb59dda839b82b6a3bf7538b7604bafb5561a58,1,0,2,2,0,0,0,13,18,44,1,1,0,1055,8,5,107,107,0,5495,5504,9,57,57,0,1,100,NoArch
2687eab8f0b49f410c49fac7771a8409722574cf,1,0,2,2,0,0,0,2,14,15,1,1,0,166,68,8,12,12,0,1009,1019,10,8,8,0,1,100,NoArch
43b9c1fa1caf97f6fb2baf68e350615541ea0a0c,3,4,4,0,0,0,0,6,21,585,1,3,1.5,615,0,0,44,44,0,4311,4305,6,27,27,0,1,100,NoArch
380518e232b883bb12579b3e98283659b464285a,3,26,18,8,0,0,0,3,5,12,1,2,1.560781253,379,8,4,33,32,1,2028,1945,83,12,11,1,1,100,NoArch
e039e0ff6d04b9b0684dbf29452af8a8dae94b09,1,8,1,7,0,0,0,8,18,3,1,1,0,1019,35,0,42,41,1,7438,7382,56,21,20,1,1,100,NoArch
7e50f9a5a6be8d68b13a587a07a9af81819540ca,0,0,0,0,0,0,0,0,0,0,0,0,0,0,17,4,0,0,0,0,0,0,0,0,0,1,100,NoArch
84dd3ca18b62921a60c3970a0f26614d8bafc89d,0,0,0,0,0,0,0,0,0,0,0,0,0,0,18,5,0,0,0,0,0,0,0,0,0,1,100,NoArch
b32855545bb9dbc6f49c18d1586585a39abe5004,4,18,22,4,0,0,0,2,28,223,1,4,1.528230865,633,2,0,58,57,1,3619,3668,49,27,27,0,1,99.95152103,NoArch
218f2a6df8a41279d904a76b594d22f4d66d17c2,1,6,3,3,0,0,0,2,5,8,1,1,0,188,9,5,16,15,1,860,833,27,8,8,0,1,100,NoArch
e64fe5505487f3ee591b2b5d044c2c57989f8991,1,1,2,1,0,0,0,1,5,68,1,1,0,309,69,7,32,32,0,1256,1263,7,18,18,0,1,100,NoArch
0fb8556b0d9274aef650a46bb82a8cf495d4450b,24,1625,71,1554,10,0,10,1,38,125,3,10,3.755760773,5237,0,0,642,512,130,40451,31838,8613,312,235,77,0,99.61333978,NoArch
23dbc09a0d5d677ed3728dbd5357320590ca2833,1,0,133,133,0,0,0,10,12,0,1,1,0,1079,17,0,34,34,0,7445,7445,0,24,24,0,0,100,NoArch
ed1a5daa9a15e9123aa7fdba5ce8262d1cae0704,1,147,0,147,1,0,1,1,1,0,1,1,0,0,7,1,9,0,9,1081,0,1081,9,0,9,1,99.96384671,NoArch
f73bedd374952580c4d6bc9b2e30607c4efdd538,1,0,54,54,0,0,0,10,35,14,1,1,0,322,34,0,26,35,9,1655,1997,342,15,20,5,0,100,NoArch
e99a6b031bf4f2e3037d4cb5307d443cda2d2002,1,11,11,0,0,0,0,5,5,31,1,1,0,174,0,0,19,19,0,1289,1281,8,8,8,0,1,100,NoArch
d24341d10ca49ed52fc0c1c86a164fbfb57327d4,1,21,21,0,0,0,0,1,10,57,1,1,0,715,70,8,84,84,0,3594,3603,9,45,45,0,1,100,NoArch
9e61dad59764abb5acb35adb3399439000b8c774,1,0,1,1,0,0,0,4,7,32,1,1,0,168,35,1,2,2,0,985,998,13,1,1,0,0,100,NoArch
34fc8a8880b0da5adb82b6eb7678f141af54ca18,1,186,1,185,0,0,0,5,8,0,1,1,0,167,8,1,2,2,0,2338,985,1353,1,1,0,1,100,NoArch
039aeb6dcee0a8eb4372c079ec07b8fc2582e41f,8,170,16,154,1,0,1,14,67,310,1,5,2.222979561,1701,9,2,162,153,9,11684,10635,1049,64,57,7,1,99.9397808,NoArch
37b7c65d8a3ede00ae16909a06e31c24f179998c,13,387,166,221,0,0,0,2,36,70,2,8,2.754119778,3970,10,5,377,354,23,23224,22300,924,210,197,13,1,99.915754,NoArch
0749cc826a9ef6b04e2063074b7abac0e69414a0,2,148,117,31,1,0,1,1,13,5,1,2,0.99010602,946,62,2,34,34,0,7505,7445,60,24,24,0,1,99.95189417,NoArch
b8a8f572d6a760c744b0a5228f2512d3d113d390,8,47,20,27,0,0,0,3,25,31,1,8,2.467573145,3923,71,9,304,302,2,21750,21574,176,158,157,1,1,100,NoArch
5a7d1b3d6cb42b1763654e307625e2ae7b799adc,1,2,2,0,0,0,0,3,6,13,1,1,0,191,9,5,16,16,0,860,860,0,8,8,0,1,100,NoArch
f665db071fac50ab1e74ed17bdda2eea9ed0ebb2,2,12,1,11,0,0,0,3,6,17,1,1,0.961236605,238,10,6,9,9,0,1239,1148,91,2,2,0,1,100,NoArch
202887b8ca27eb6de808ba7a2e737b13ae9eb8c0,1,1,1,0,0,0,0,5,10,2,1,1,0,358,36,2,2,2,0,2376,2374,2,1,1,0,1,100,NoArch
5564c7ec010e2af40352615a6c90dbea4d2290e7,0,0,0,0,0,0,0,0,0,0,0,0,0,0,57,0,0,0,0,0,0,0,0,0,0,1,100,NoArch
1cbf43b6e7731c68661c74bdfa41399f6398172f,2,2,2,0,0,0,0,2,15,28,1,2,1,306,11,5,18,18,0,1939,1931,8,9,9,0,1,100,NoArch
94f0f40fec44c7eecb4e886df62f52a28226974c,2,51,3,48,0,0,0,1,30,9,1,2,0.999010271,477,10,3,51,45,6,3522,3112,410,25,23,2,1,100,NoArch
07e93de8b49560eee23237817fc24fbe763f2891,4,104,36,68,0,0,0,2,18,83,1,2,0.864242296,1161,12,6,90,83,7,7128,6667,461,47,44,3,1,100,NoArch
d412fb2fe642417460532044cac162bb68f4bec4,142,3296,2471,825,3,1,4,3,68,282,10,79,5.321546339,36897,16,0,3220,3185,35,238787,235690,3097,2005,1973,32,1,88.25265643,Arch
7895a3586e19a7f66fc2a400c90d8334f255d943,0,0,0,0,0,0,0,0,0,0,0,0,0,0,75,0,0,0,0,0,0,0,0,0,0,0,100,NoArch
d07def12901485a9d59ab2b54602d535f00e5986,1,2,2,0,0,0,0,7,27,0,1,1,0,601,76,1,16,16,0,2859,2851,8,9,9,0,0,100,NoArch
b34d53fa9c1821e7e7191ede1b99bdc96212ce3e,3,77,0,77,1,0,1,33,69,0,2,3,0.273285904,1014,19,5,109,108,1,6536,6100,436,38,37,1,1,100,NoArch
b376cefc3e899aa28992796925708746561d6087,1,1,1,0,0,0,0,18,29,1,1,1,0,1583,37,3,262,262,0,7022,7022,0,256,256,0,0,100,NoArch
6eca06d074520140d7bc67b48bd2b9a5b76f0a87,1,13,1,12,0,0,0,7,9,2,1,1,0,250,20,5,11,10,1,2141,2088,53,3,3,0,1,100,NoArch
64035474310739d0885b57df924b1553834ef6de,0,0,0,0,0,0,0,0,0,0,0,0,0,0,21,6,0,0,0,0,0,0,0,0,0,1,100,NoArch
7462fdefc39c75dca986d65551d871b8c47d4f55,3,40,36,4,0,0,0,1,10,97,1,3,1.186702752,1217,72,5,85,87,2,8532,8519,13,44,44,0,1,100,NoArch
ac65189458eff9962e442a6ca3973cb236749840,0,0,0,0,0,0,0,0,0,0,0,0,0,0,22,7,0,0,0,0,0,0,0,0,0,1,100,NoArch
d424fe6072ef74e1e2bdb290aa584bff9eca113f,2,7,3,4,0,0,0,2,16,3,1,1,0.721928095,613,73,6,56,56,0,4216,4174,42,30,30,0,1,100,NoArch
70d9c2e7473154178bafaef40a15fc3e10a9df6a,0,0,0,0,0,0,0,0,0,0,0,0,0,0,23,8,0,0,0,0,0,0,0,0,0,1,100,NoArch
7173d1338abaf2a880bdb86e9c650065d7b0bf14,0,0,0,0,0,0,0,0,0,0,0,0,0,0,36,2,0,0,0,0,0,0,0,0,0,1,100,NoArch
4f215e2938f78e13bea940013855cb14a6724601,3,47,1,46,0,0,0,10,14,59,1,3,1.056245314,1446,24,9,131,127,4,10567,10223,344,44,42,2,1,100,NoArch
62a1ad8b3a2a3c1dabba0a4622117636920b6c13,7,73,9,64,0,0,0,5,31,60,2,6,2.737351145,2858,38,4,395,387,8,16269,15860,409,311,308,3,1,100,NoArch
6a71412f7804c9cbd34e4c6fc01545a994523bb4,4,45,7,38,0,0,0,11,15,14,1,3,1.342682816,1648,8,0,131,127,4,11766,11463,303,56,55,1,1,100,NoArch
98ec017bc8c245119b4b76339d90217fd7ea4e03,4,78,10,68,1,0,1,1,24,12,1,2,1.764357231,1225,74,7,131,126,5,5764,5483,281,76,73,3,1,99.88547433,NoArch
2033d35dc39ea1c5e9b20f7425e99f5cc522d689,1,1,0,1,0,0,0,8,10,209,1,1,0,244,0,0,27,27,0,1080,1074,6,23,23,0,1,100,NoArch
2cecb751879cc645227c467fc29c0705baad8030,0,0,0,0,0,0,0,0,0,0,0,0,0,0,9,1,0,0,0,0,0,0,0,0,0,1,100,NoArch
e6ee7bdb516a7eb03ee2cddb0545d46a26325590,4,52,11,41,0,0,0,2,39,10,1,3,1.339406536,991,75,7,101,97,4,5374,5081,293,56,54,2,1,100,NoArch
287d2dd79c5b257c6fe9cb48631b68f50c594ead,0,0,0,0,0,0,0,0,0,0,0,0,0,0,25,9,0,0,0,0,0,0,0,0,0,1,100,NoArch
650c4455c600b0346fed8b5b6aa4cc0bf3452e8c,1,5,1,4,0,0,0,8,8,447,1,1,0,359,39,5,40,40,0,2359,2353,6,13,13,0,1,100,NoArch
32bd8ce088e0f1d82577575ac048e1a44d44e380,4,72,42,30,0,0,0,2,25,10,1,3,1.214564592,1141,76,8,103,95,8,5408,5306,102,73,65,8,1,100,NoArch
bc313727e3e89640edad85364022e057c9864ee9,2,4,3,1,0,0,0,3,7,18,1,1,0.985228136,249,11,3,10,9,1,1247,1239,8,2,2,0,1,100,NoArch
0bd20827abee66b8a71bde12251c79428cc6de36,0,0,0,0,0,0,0,0,0,0,0,0,0,0,12,4,0,0,0,0,0,0,0,0,0,1,100,NoArch
a0f598d371938060a17aca7603c080c22488cf57,1,4,3,1,0,0,0,11,19,15,1,1,0,507,10,2,52,51,1,3110,3064,46,15,15,0,1,100,NoArch
a4dcbb5c5a2a94e4f69524194d8777d082af31ab,14,620,60,560,3,0,3,1,31,464,2,6,2.840290243,4265,0,0,600,543,57,24432,21557,2875,455,418,37,1,99.43052392,NoArch
1d6978cde4c98c82c184f6404f49ef0f4832fbd6,6,70,15,55,0,0,0,11,40,2,1,4,2.354050586,1784,77,9,130,124,6,9248,8943,305,66,64,2,1,91.85261003,Arch
05d6e1819078591c904f3601f5f4a1eb28be3495,2,8,0,8,0,0,0,7,70,427,1,1,0.811278124,838,3,1,108,106,2,4939,4895,44,32,31,1,1,100,NoArch
2b21ae1775aeb108a4b0e3f89889651a19f93b2f,2,9,0,9,0,0,0,10,12,676,2,2,0.918295834,399,0,0,56,54,2,1698,1666,32,43,41,2,1,100,NoArch
60e0254e67b488dfab7a7102c9f517b07174f398,4,153,6,147,1,0,1,1,6,416,2,4,1.03366816,404,0,0,39,29,10,3254,2366,888,28,19,9,1,99.95535714,NoArch
f2621da32f33bf16fb53f8a71eaf7bca24e6d166,8,33,39,6,0,0,0,3,41,97,1,7,2.783441585,2211,40,6,120,120,0,13195,13229,34,73,73,0,1,100,NoArch
6e2443468280dfd768afe9ac4d17df7fbbbb51bf,1,12,0,12,0,0,0,16,24,859,1,1,0,443,1,1,20,18,2,2035,1969,66,19,18,1,1,100,NoArch
221ddd9bf3899e3672210404d51e686770ba446d,3,61,38,23,0,0,0,1,20,187,2,3,1.048902015,1681,37,1,106,107,1,11670,11412,258,42,42,0,1,100,NoArch
990820476a41b318017ba63dd446911141c929ce,1,1,2,1,0,0,0,9,21,1,1,1,0,1044,38,2,42,42,0,7626,7645,19,21,21,0,1,100,NoArch
55ecbc662e30068ce0ed49166d254202bd598a8c,2,51,5,46,1,0,1,1,12,136,1,2,0.491237342,225,2,2,30,28,2,1261,1036,225,24,23,1,1,99.88856697,NoArch
ea9e5d0e8b7557ef82631ac173d67f15bad13690,27,587,73,514,6,0,6,2,32,305,2,12,4.082473794,4029,58,1,482,438,44,24612,21970,2642,377,353,24,1,99.73351099,NoArch
8f7ad8b178ac3d394f88ac1c21f701138126fa04,4,28,22,6,0,0,0,4,31,16,1,4,1.549866168,685,4,2,68,67,1,4118,4089,29,31,31,0,1,99.9778467,NoArch
16e90d30eaa14e5c1c4632ad0a90497df601c637,5,252,19,233,1,0,1,3,4,155,2,4,2.019534447,449,59,2,60,34,26,4871,3066,1805,24,14,10,1,99.91144565,NoArch
1d3cd065724f3bd4f5cab90f95b5d5c8d0b389ea,1,5,5,0,0,0,0,9,11,147,1,1,0,372,1,0,44,44,0,2795,2769,26,22,22,0,1,100,NoArch
8c0dbaa9b3b6ced3826d0bc04e0a91272bbcab73,12,180,29,151,0,0,0,2,10,92,2,7,2.759728939,1617,60,3,145,132,13,11704,10274,1430,75,66,9,1,100,NoArch
de07e61382307d36e664dd31adf7fc4045443fcc,2,34,0,34,0,0,0,3,5,22,1,2,0.602430802,370,11,3,42,38,4,2892,2664,228,21,20,1,1,100,NoArch
c50c24908a4eb1ed769efb8878e6075d3e162d55,1,3,3,0,0,0,0,4,4,0,1,1,0,166,77,2,9,9,0,1133,1133,0,6,6,0,0,100,NoArch
047d956e01b6d7c92320686d8321b2bbe9d2188e,0,0,0,0,0,0,0,0,0,0,0,0,0,0,13,4,0,0,0,0,0,0,0,0,0,1,100,NoArch
371526789d663dee85041eb31c27c52c81ef87ef,14,246,33,213,0,0,0,2,30,105,2,10,3.055693701,4299,13,3,344,325,19,26487,25073,1414,175,169,6,1,89.41200242,Arch
b4562e86e4b58d6151fdeea12e727b8c8881a213,14,33,246,213,0,0,0,3,31,0,2,10,3.055693701,4512,78,3,325,344,19,25073,26487,1414,169,175,6,1,89.41200242,Arch
3b2a4f2b6b49e13997292ecafa9accdd3e7b9efd,1,0,81,81,0,1,1,2,3,698,1,1,0,81,41,7,0,7,7,0,221,221,0,5,5,1,99.95573263,NoArch
7c6eebf98cdf4fcd727a7ff15962b918f7bf7aaf,1,3,3,0,0,0,0,4,21,1,1,1,0,776,22,0,52,52,0,4524,4524,0,24,24,0,0,100,NoArch
783c9cb3693ff7d82cc3d43a4964c64a4da19436,14,243,29,214,0,0,0,3,32,0,2,10,3.040572626,4299,14,4,345,325,20,26504,25073,1431,176,169,7,1,89.40343782,Arch
942a024e74af52e09cabbfe967f5da0ef108bdbb,1,10,4,6,0,0,0,5,14,0,1,1,0,225,78,8,26,23,3,1377,1330,47,10,10,0,1,100,NoArch
9b01d2a04520db6230cd16ef2b29013c013b1944,4,14,4,10,0,0,0,3,33,12,1,3,1.974937501,1282,14,5,37,37,0,7354,7278,76,19,19,0,1,100,NoArch
5804ad8e32ae05758ebc5e47f5d4fb4db371ab52,18,568,89,479,5,0,5,14,71,141,4,12,3.543086075,6956,2,0,793,750,43,45005,42705,2300,507,485,22,1,99.79572888,NoArch
ffa934182ad9abe78c0592772e9328dd6b0d27e6,8,432,39,393,2,0,2,7,25,49,2,5,2.249306723,2089,26,7,191,130,61,15234,12878,2356,85,72,13,1,99.87053819,NoArch
ca440ccf881c67c308e72beaf6a561e12e1b4da2,10,82,455,373,0,2,2,7,24,118,4,7,2.632108879,2853,26,7,174,232,58,15862,18084,2222,87,99,12,1,99.77786005,NoArch
c8a2033c275e21a752893fc89311e1f6846f5a78,3,99,2,97,1,0,1,1,9,51,2,3,1.114673716,760,1,0,63,60,3,6462,5804,658,30,28,2,1,90.31896137,Arch
b0089b894ad12da11fbd6a0fb08508c7adee68e6,2,14,3,11,0,0,0,5,34,20,1,2,0.672294817,1687,3,1,270,269,1,7735,7633,102,263,263,0,0,100,NoArch
aff1a1ed29a5a64932c64195be744969fcc0b08b,4,35,19,16,0,0,0,4,34,8,1,3,1.321160733,1292,0,0,37,37,0,7454,7354,100,19,19,0,1,100,NoArch
7395a56dfb488887aa0e733e52023b167293f737,5,20,35,15,0,0,0,3,33,194,2,4,1.428246159,1458,11,1,47,47,0,7998,8089,91,25,25,0,1,100,NoArch
f0a2f378ea57b577ef2275dbaf42cd960df9cfd5,8,432,39,393,2,0,2,7,25,49,2,5,2.249306723,2089,28,9,191,130,61,15234,12878,2356,85,72,13,1,99.83096211,NoArch
ac75bda9290c20c3260aece838acbcef9f034041,2,73,63,10,0,0,0,11,20,248,1,2,0.26086291,671,79,7,43,42,1,4921,4815,106,17,16,1,1,100,NoArch
632bfd1a65f55deff60bd56e514738b9c8730140,4,35,19,16,0,0,0,4,34,8,1,3,1.321160733,1292,80,8,37,37,0,7454,7354,100,19,19,0,1,100,NoArch
52524b659d2cb64403e8ba87d2fefe6d536156e9,6,245,62,183,2,0,2,6,42,11,1,4,1.842621892,1154,23,1,64,47,17,8708,7724,984,29,22,7,1,99.9296864,NoArch
93967404a7bcf75627677239d3438c3f301c3725,1,1,3,2,0,0,0,1,2,7,1,1,0,84,29,10,2,2,0,596,620,24,2,2,0,1,100,NoArch
2debb9b3edcd141aee9335ab9adf01610f28959a,14,149,53,96,0,0,0,3,13,296,4,10,3.011923335,3428,3,0,290,270,20,25057,24051,1006,150,147,3,1,99.95779403,NoArch
c1810f210e34a72c16ce2fa5a7efb61f717e83b0,1,1,1,0,0,0,0,3,3,573,1,1,0,86,2,1,10,10,0,384,384,0,5,5,0,0,100,NoArch
75040ee9e5caa0783009b6ef529d6605e82d4135,26,365,299,66,0,0,0,3,35,126,5,12,3.536496903,6425,79,4,650,650,0,29196,28842,354,601,601,0,1,96.75404047,Arch
d024439764ceeca6366cb33689b729a1c69a6272,7,167,54,113,0,0,0,10,36,18,2,4,2.169575626,3463,1,1,476,463,13,18423,17602,821,378,369,9,1,100,NoArch
23a4a96eb416c13d8b1f921cc51286f93d61d9b3,1,2,2,0,0,0,0,9,16,2,1,1,0,158,0,0,9,9,0,1061,1063,2,1,1,0,1,99.96065574,NoArch
a62a6cff32e7d7f62ffdf6362fb8876497fd0528,2,20,30,10,0,0,0,2,12,35,1,2,0.904381458,459,24,2,57,58,1,2735,2808,73,17,16,1,0,100,NoArch
38cd74b56328d154c004f04f1335784529d8e93d,1,7,0,7,0,0,0,20,37,3,1,1,0,1637,4,1,268,268,0,7330,7284,46,262,262,0,0,99.17600973,NoArch
3b264e80d9ccc58ebd0dff3b00f50ad9d481e03c,6,25,21,4,0,0,0,3,20,450,2,6,1.478460947,1466,14,0,132,135,3,7264,7203,61,78,81,3,1,99.90256125,NoArch
c8aaf00819b7af9c5575662868aa40f702a8aa1e,4,20,15,5,0,0,0,4,36,10,1,4,1.708420938,1118,0,0,49,50,1,6142,6058,84,28,28,0,1,100,NoArch
50c2b76d725a71608a38217370b1ac45cedae405,14,28,242,214,0,0,0,4,37,12,2,10,3.051779948,4546,1,1,328,348,20,25283,26714,1431,169,176,7,1,93.22847241,Arch
af837d2f1825d14ae8403b2290cf5eab39780343,7,172,62,110,0,0,0,2,72,33,1,6,2.170055598,3605,15,1,315,303,12,26622,25694,928,165,161,4,1,99.69376037,NoArch
572a2144124b90b2dbef8183ee19a95b21de2716,0,0,0,0,0,0,0,0,0,0,0,0,0,0,30,6,0,0,0,0,0,0,0,0,0,1,100,NoArch
2099bf41db76e9a6e946aa41c318b7c0e18be04d,2,1,35,34,0,0,0,3,17,58,1,2,0.183122068,588,1,1,51,56,5,3182,3420,238,31,34,3,1,100,NoArch
d5026e9a24850bdcce9f6df3686bf2235d7d01c4,48,883,181,702,1,0,1,2,40,69,3,17,4.937551753,9081,61,3,1060,978,82,56616,51400,5216,708,670,38,1,97.19312382,Arch
a086d255c89d12eb42cad8c5ae0e000f3b83bbe6,8,166,6,160,2,0,2,15,73,153,4,6,2.666345625,4098,0,0,411,396,15,27749,26826,923,221,210,11,1,99.90063875,NoArch
634163a990569aa4463b58830396f455dd15340c,2,27,3,24,0,0,0,2,10,54,1,2,0.836640742,737,15,2,52,51,1,4220,4063,157,36,35,1,1,99.92914836,NoArch
858e84b5b2f1c5fbd4266922b494ad0d16f5b92a,6,57,16,41,0,0,0,3,26,20,2,5,2.007995859,3044,81,3,313,308,5,16833,16631,202,170,167,3,1,100,NoArch
d58a8348dc729c83c60025fc8dbed3ecec28578b,1,5,0,5,0,0,0,4,9,399,1,1,0,347,62,4,60,59,1,1809,1776,33,57,56,1,1,100,NoArch
4f1350f7c1f43f3da618d33fe6a6c5e566ee7e8c,0,0,0,0,0,0,0,0,0,0,0,0,0,0,22,0,0,0,0,0,0,0,0,0,0,0,100,NoArch
5a94b6bf54b18739da55ebde10adf93f133e3204,0,0,0,0,0,0,0,0,0,0,0,0,0,0,12,1,0,0,0,0,0,0,0,0,0,1,100,NoArch
2370a9facbe4418f994f29c426e9b2a255e3abb0,6,22,31,9,0,0,0,3,16,237,1,4,2.247255527,1218,82,4,123,126,3,6457,6481,24,77,77,0,1,100,NoArch
151f22e43ace6ec55a92fbe50c63b8e21cace59c,0,0,0,0,0,0,0,0,0,0,0,0,0,0,31,5,0,0,0,0,0,0,0,0,0,1,100,NoArch
fe5d2e7f53eb36d9e35acd8d944e59d988dba475,1,1,1,0,0,0,0,3,27,3,1,1,0,676,15,2,67,67,0,3143,3143,0,38,38,0,1,100,NoArch
c89bf1de20a1c9eb7873b4671ad3d37bc7111245,5,105,15,90,1,0,1,1,9,55,1,3,1.23811376,519,83,5,46,43,3,3087,2514,573,18,17,1,1,89.02136884,Arch
5a2f3d439e2eb339f989c78801752f84b6dcee38,2,20,2,18,0,0,0,4,10,88,2,2,0.994030211,519,32,6,51,51,0,3310,3224,86,26,26,0,1,100,NoArch
6d592c5896d033c7f781d4a9eef4a43916c084ed,1,1,0,1,0,0,0,4,4,250,1,1,0,56,1,0,3,3,0,263,249,14,3,3,0,1,100,NoArch
2c910ee3af6f1e4159d57802e24d4bddabb8fcb8,5,29,20,9,0,0,0,36,74,18,3,4,1.967705264,2363,33,7,286,284,2,13084,12989,95,134,133,1,1,100,NoArch
71e14cf866d2ddeee7238a3f15b59912c2537943,9,20,19,1,0,0,0,3,22,344,1,4,2.834950131,1934,2,1,209,209,0,11297,11277,20,102,102,0,1,100,NoArch
66207ed91a75ce8e91ccc0c417dc0d310dc36a5c,14,1445,503,942,5,0,5,10,17,118,3,7,3.179001854,3629,3,0,494,399,95,30648,24754,5894,200,162,38,1,98.9720747,NoArch
b2f7fcb8c8b7bab65005593c220c51d7f70319c5,1,8,8,0,0,0,0,3,3,296,1,1,0,392,3,2,49,51,2,2176,2198,22,13,13,0,0,100,NoArch
a14b19fdd5d68717d3b850a69d4ce27ca3b3d595,24,265,0,265,2,0,2,4,39,21,4,8,3.82103512,6335,2,1,643,632,11,30161,28867,1294,602,597,5,1,99.67404358,NoArch
a91296f14a037a148d949b2380ad503677e688c7,0,0,0,0,0,0,0,0,0,0,0,0,0,0,0,0,0,0,0,0,0,0,0,0,0,1,100,NoArch
a5638b995b5373826d435734fc6cdfbb5fbf7acb,2,2,0,2,0,0,0,8,10,75,1,2,1,497,17,0,18,18,0,3988,3976,12,6,6,0,0,100,NoArch
5353243449ea16c415b4fb5517eb6d2e2723ba76,1,2,1,1,0,0,0,10,14,20,1,1,0,484,12,0,59,59,0,4040,4010,30,33,33,0,1,100,NoArch
61148c1c43c9ff5ba04b6c174e9e2a006db9e7b3,47,935,404,531,0,0,0,4,42,183,5,30,3.79226223,16044,63,2,1689,1613,76,107234,102649,4585,1009,978,31,1,86.40022204,Arch
024cf01f0282264da87b13688983df61d2c080fd,1,1,1,0,0,0,0,2,3,401,1,1,0,308,0,0,37,37,0,1549,1549,0,4,4,0,0,100,NoArch
9d2a65a6a6ff9add81411147f1cddd03f7c08e6c,23,1962,83,1879,15,0,15,1,39,35,2,11,4.042441442,2962,84,5,334,175,159,26348,17046,9302,209,109,100,1,99.45589257,NoArch
ab2e0d0ba2697ba0750ec52fbb3b3a0187734a4b,1,11,9,2,0,0,0,9,10,96,1,1,0,157,85,6,20,20,0,867,860,7,7,7,0,1,100,NoArch
925873bb3cacbe7d2cd95d7bf0c0e5a40f56da12,0,0,0,0,0,0,0,0,0,0,0,0,0,0,18,1,0,0,0,0,0,0,0,0,0,1,100,NoArch
59ff8423f96055fedc7a8ebf0db08666ae725726,0,0,0,0,0,0,0,0,0,0,0,0,0,0,34,5,0,0,0,0,0,0,0,0,0,1,100,NoArch
60758b36ea033a5985eabc53da5f6036ffaa5c0d,3,24,20,4,0,0,0,1,18,230,1,2,1.536749209,671,86,7,71,69,2,2821,2798,23,40,40,0,1,100,NoArch
00cd35f90ad0cd96a943edd148bf881fc4b7bb5b,6,118,5,113,2,0,2,6,40,29,1,4,1.690256112,1130,0,0,50,44,6,6384,5983,401,29,24,5,1,91.82532128,Arch
8fef50e237b2342ea3366be32950a2b87a9608c4,27,405,109,296,1,0,1,3,41,240,7,23,3.52427775,9592,3,2,838,825,13,62826,60869,1957,570,557,13,1,92.28462095,Arch
8105cf588e28820b9c021c9ed0e59e3f8b6efa71,1,3,3,0,0,0,0,8,8,66,1,1,0,107,0,0,27,27,0,525,522,3,11,11,0,1,100,NoArch
91c221341293e80c28cce19f1642199495a96f66,4,82,27,55,0,0,0,2,20,59,1,2,1.544096612,1067,87,6,78,75,3,5972,5661,311,53,50,3,1,100,NoArch
eedfadeb46d5538bc7efb2c455469f1b42e9385e,4,56,9,47,0,0,0,8,18,10,1,3,1.224301485,2244,16,1,191,190,1,16177,15892,285,86,85,1,1,100,NoArch
7739518879cf1c30576b938d705947192a2dd9ad,3,11,0,11,0,0,0,9,41,40,1,3,1.322179346,1107,17,2,23,23,0,6182,6107,75,14,14,0,1,100,NoArch
efbbb67420b7082a3960f3d32215dabd959f5525,1,8,1,7,0,0,0,6,22,3,1,1,0,207,88,7,16,15,1,1325,1296,29,10,10,0,1,100,NoArch
bbadac7de1bb57300ca7e796ebb401fdbb66a0f8,3,21,0,21,0,0,0,2,42,33,2,3,1.519046164,2865,35,5,411,407,4,14104,13973,131,341,339,2,1,100,NoArch
f109c6cb0d187aedfbbcfab48ef5c5bf717e9cca,0,0,0,0,0,0,0,0,0,0,0,0,0,0,36,6,0,0,0,0,0,0,0,0,0,0,100,NoArch
44e41dc9bb7c64f8b517d4a44742019f4dee4f70,3,23,9,14,0,0,0,8,24,30,1,3,1.415341398,3273,3,0,255,253,2,22475,22431,44,144,142,2,1,100,NoArch
c2370402ea16839ec6bb0808bdcd9e7c9556092e,0,0,0,0,0,0,0,0,0,0,0,0,0,0,37,7,0,0,0,0,0,0,0,0,0,1,100,NoArch
7bdae69053afc5ef604a15806d78317cb976f2ce,7,266,233,33,1,0,1,6,31,32,2,3,1.379694502,3105,64,3,232,234,2,23344,23284,60,140,141,1,1,99.98220007,NoArch
8b19ec9ca07070a9819502e82091dd14d559ef94,4,83,9,74,0,0,0,6,23,138,1,4,1.723375156,1857,18,3,110,108,2,12514,11877,637,66,64,2,1,100,NoArch
c4e45a0010d3f13f84d90fbf417c4e5e6c547fda,9,235,38,197,2,0,2,4,44,5,2,7,2.043180342,2516,89,8,188,177,11,15381,14168,1213,107,100,7,1,99.93773904,NoArch
f7f5d4cc6db1230e653346953d87c6ff480c56eb,2,65,0,65,0,0,0,4,16,56,1,2,0.721928095,571,19,4,47,42,5,4579,4041,538,30,27,3,1,99.87497767,NoArch
6353fc865f43854e0e185af33e8ad091c8870d78,3,6,6,0,0,0,0,2,7,65,1,3,1.584962501,637,19,2,49,49,0,3817,3805,12,29,29,0,1,100,NoArch
dde57b293cd22ef1bd89f44054f109a52fc20e56,2,208,38,170,0,0,0,16,32,57,1,2,0.987759316,1793,3,0,175,149,26,14762,13650,1112,107,94,13,1,100,NoArch
fe508376faaa3c36e9f821f3d6fee731983798c4,31,595,245,350,1,0,1,6,43,324,4,17,4.024823242,12479,65,4,1061,1016,45,86736,84283,2453,540,519,21,2,99.95514891,NoArch
b21ae68e6710cab12a95eb62552541b47ef891cb,0,0,0,0,0,0,0,0,0,0,0,0,0,0,80,0,0,0,0,0,0,0,0,0,0,0,100,NoArch
aa857beee00a764cee90d6e790ee4b0ab4ad4862,0,0,0,0,0,0,0,0,0,0,0,0,0,0,4,0,0,0,0,0,0,0,0,0,0,1,100,NoArch
bec23bda50b5252013af54dcf39c3a645eea6c7e,5,67,43,24,0,0,0,1,22,96,3,5,1.639242093,1837,90,9,215,212,3,9979,9861,118,108,108,0,1,100,NoArch
826a04d1425f47fdd80c293569a359021d1b6586,14,1130,32,1098,9,0,9,1,43,29,2,9,3.312173088,4778,23,1,596,512,84,37435,31278,6157,452,394,58,1,89.70684039,Arch
245e1fd17dbf19d9008eaae3bc009bc2be2e663f,1,4,7,3,0,0,0,37,75,34,1,1,0,777,4,2,85,85,0,4745,4795,50,22,22,0,1,100,NoArch
1ff2d3459a89e384f7f0b4805aa8fe5e6f488f46,6,126,23,103,0,0,0,1,24,307,2,4,2.276126107,2372,18,0,216,204,12,16319,15373,946,104,102,2,2,100,NoArch
91bb0d13184c57ec08f02db3337e734bc20739c4,50,257,257,0,0,0,0,6,76,40,7,25,4.86249743,16542,17,0,1507,1507,0,108288,108288,0,900,900,0,1,100,NoArch
b4c14eaa29ed4f3b0f8f44dbfdd75ee68702645b,6,98,38,60,0,0,0,10,18,60,1,3,1.870517328,1564,5,3,154,148,6,9065,8733,332,111,107,4,1,100,NoArch
02331fc223ca1272e3a9039c6563b9d511a8fbef,19,645,119,526,2,0,2,2,45,155,2,16,3.399509917,4627,91,9,501,434,67,28814,25611,3203,259,228,31,1,96.67152897,Arch
b8b9d6db83657cfdf35832eb26eb7e46ca318048,14,213,32,181,0,0,0,6,46,24,2,10,3.238191142,4643,16,0,341,324,17,29785,28760,1025,182,175,7,1,99.94878361,NoArch
5574e092fb40c24dfb417f160e4ac229d9cbcc0c,1,3,3,0,0,0,0,1,2,171,1,1,0,37,38,7,0,0,0,48,39,9,0,0,0,1,100,NoArch
1df5ded433eced3bbb66137bc741e616beab9a70,8,99,10,89,2,0,2,1,3,121,3,3,2.559133329,4854,66,3,318,318,0,38312,37881,431,161,161,0,1,96.41545282,Arch
0dcd6a8fcaff0a8ac2e0fdccbfd14634722185b2,2,50,7,43,1,0,1,1,17,12,1,2,0.831474388,320,39,7,52,51,1,1942,1869,73,21,20,1,1,99.94989352,NoArch
b7586a563253082a00d62ac81e3b5acbb378472a,9,20,46,26,0,0,0,5,47,0,2,7,2.856958077,3224,92,8,203,206,3,19212,19374,162,104,107,3,1,100,NoArch
20feb1a8970b7ec658d4d3f1994eaedd24b9874a,3,991,2,989,2,0,2,1,2,10,1,2,0.984718091,66,93,9,167,5,162,5485,270,5215,33,4,29,1,99.94993742,NoArch
3f8ca1a3552bb866163d3b1648f68d9c4824e21d,0,0,0,0,0,0,0,0,0,0,0,0,0,0,40,6,0,0,0,0,0,0,0,0,0,1,100,NoArch
9ce548edb1b534029fa0f0617dadc3d54cdb8999,0,0,0,0,0,0,0,0,0,0,0,0,0,0,41,7,0,0,0,0,0,0,0,0,0,0,100,NoArch
70b6bd485f8d1ef9a9b15999edda2472d0b4d65a,33,1145,343,802,9,0,9,3,45,207,2,17,4.027586724,8980,5,1,876,820,56,64992,60204,4788,633,591,42,1,99.61461959,NoArch
55d2e786dbae584d2c4917a15d599ab7bb1877fb,0,0,0,0,0,0,0,0,0,0,0,0,0,0,42,8,0,0,0,0,0,0,0,0,0,1,100,NoArch
32a50d8ddbbf706bd350e9cf0762f51ab66afcc9,0,0,0,0,0,0,0,0,0,0,0,0,0,0,43,9,0,0,0,0,0,0,0,0,0,1,100,NoArch
11ea74958d2aadffb3abe757cface5e2835784db,3,29,3,26,0,0,0,12,48,11,1,3,1.049886625,792,17,1,81,77,4,4894,4654,240,39,38,1,1,100,NoArch
41a9986a7641f3232b1edd2a737fd4b7aa430dbf,1,66,0,66,1,0,1,1,1,0,1,1,0,0,44,10,6,0,6,115,0,115,3,0,3,1,99.97529644,NoArch
b4441abcf74951ec0ce28593b96baa84456a97d3,4,83,0,83,1,0,1,1,46,3,1,3,0.989692929,1966,4,1,301,297,4,9237,8850,387,294,290,4,1,97.05249842,Arch
21db6d7a84d4a83ec98c110e92ff9c92d05dd530,50,1081,199,882,3,0,3,8,49,57,4,34,4.578583525,15631,20,4,1619,1531,88,92492,87377,5115,1005,958,47,1,97.22222222,Arch
a18bc839d18bee634d0e35d4761bd156f0230f79,2,3,0,3,0,0,0,8,11,180,1,2,0.918295834,146,0,0,8,8,0,601,584,17,6,6,0,1,100,NoArch
73d898322b69f8d3831bf209dceb069ea61f5064,0,0,0,0,0,0,0,0,0,0,0,0,0,0,5,2,0,0,0,0,0,0,0,0,0,0,100,NoArch
1196736185272afaeda37328f1c52ccd5c6dc017,13,377,111,266,0,0,0,11,77,108,4,9,2.581463473,6555,67,3,781,749,32,43349,41430,1919,373,361,12,1,100,NoArch
0e1c592c697c8e55491d869fb18126c3ff1d87a2,1,0,59,59,0,1,1,3,3,1114,1,1,0,59,25,0,0,5,5,0,232,232,0,5,5,0,96.60291897,Arch
abbc8328e67fcf10b065671715ed0bd1bb80d897,0,0,0,0,0,0,0,0,0,0,0,0,0,0,0,0,0,0,0,0,0,0,0,0,0,0,100,NoArch
d1b4aa59bfe6bcad076196e1007eb9f08de6622b,3,13,4,9,0,0,0,2,11,700,1,2,1.332820405,294,4,1,25,23,2,1617,1474,143,13,13,0,1,100,NoArch
5448cdde7e45c39b8bf8275d9f3ee425c9bfa90e,16,75,35,40,0,0,0,3,19,558,2,9,3.530363085,3092,21,5,334,327,7,17889,17650,239,188,185,3,2,100,NoArch
8255a86cb4d7f2173f0adcf0d752096b0b4df78c,5,46,163,117,0,0,0,3,19,417,1,3,1.654926109,2014,63,0,137,140,3,13718,14670,952,80,83,3,1,100,NoArch
a5e496fe23c3cd89ceff0e4c49d27df325ba5bd8,1,16,1,15,0,0,0,14,16,0,1,1,0,835,5,2,103,100,3,5717,5601,116,63,61,2,1,100,NoArch
c9fa3cffaf01ca5b84cf93ccd4c2823bf6cac71d,3,8,2,6,0,0,0,7,17,33,3,3,1.485475297,935,68,4,116,114,2,7167,7132,35,57,56,1,1,100,NoArch
aa11989eade1bd268d83e6aafe15f2ea60be67d2,3,87,3,84,0,0,0,11,18,47,2,3,1.227386455,1706,39,0,147,140,7,13147,12458,689,83,77,6,1,100,NoArch
29332498af420596f42c3b0ff4a2fe804d7d7dfc,3,68,3,65,0,0,0,6,18,3,2,3,1.417237887,1282,94,6,92,89,3,8732,8146,586,59,58,1,1,100,NoArch
4783176554e7d4ae7b7296cf633d750ae27e65d9,53,2251,460,1791,14,1,15,13,48,277,4,30,4.671909947,12512,7,0,1430,1309,121,85788,77846,7942,875,809,66,1,96.28970427,Arch
9e8308527a3a19bf58397ededfbf91a70568060e,3,0,162,162,0,0,0,8,16,162,1,3,1.487988089,1238,6,3,70,85,15,8747,10037,1290,35,43,8,1,94.15881904,Arch
b3e430f24bfedd94d3ceae028dce2e0053e268a6,5,30,5,25,0,0,0,1,3,629,2,3,2.200931311,484,40,1,47,44,3,2086,2003,83,34,31,3,1,100,NoArch
dc3cbb28e79b7d17569a027e1b408ab33bee18cd,1,2,2,0,0,0,0,1,1,0,1,1,0,343,26,1,12,12,0,2719,2719,0,11,11,0,0,99.95138551,NoArch
c0fc9cdaf3f2e77074e43624b167207c2fb8a784,3,5,3,2,0,0,0,17,78,425,1,3,1.5,1245,16,0,139,139,0,7652,7635,17,41,41,0,0,99.95138551,NoArch
b651336454ec01c4331d2f46b0281a0065500c79,1,13,3,10,0,0,0,37,79,0,1,1,0,787,69,5,86,86,0,5006,4836,170,22,22,0,1,100,NoArch
76bc686a77a485544c9e75cfefa59fa021470a0c,11,88,15,73,0,0,0,3,49,16,2,10,2.423479597,6323,41,2,697,687,10,37182,36645,537,477,474,3,1,100,NoArch
0544d70d8f4204f4e5edfe9144c17f1ed221eb7c,38,581,371,210,0,0,0,16,80,41,6,24,3.707441058,16584,6,2,1555,1555,0,105963,104492,1471,955,955,0,0,100,NoArch
6602e55cd29d8ee028730cf8b0ebfed48f3c8ab0,0,0,0,0,0,0,0,0,0,0,0,0,0,0,1,0,0,0,0,0,0,0,0,0,0,1,100,NoArch
6a4100bb9143b5daffa4c656589ba6ee93fa5838,2,5,2,3,0,0,0,1,13,29,1,2,0.591672779,534,95,5,53,54,1,3640,3633,7,27,27,0,0,100,NoArch
d4c2974eae98bde4ae21cd38c88e77227eb4b2c6,1,1,1,0,0,0,0,6,6,483,1,1,0,140,17,1,4,4,0,907,907,0,1,1,0,0,100,NoArch
968927801470953f137368cf146778a7f01aa63f,3,22,10,12,0,0,0,2,23,20,2,3,1.505240815,1010,7,3,107,104,3,7254,7152,102,47,46,1,1,100,NoArch
642b1b671de8c6a35ae7858c9b03d3dff70889dd,5,10,7,3,0,0,0,4,51,147,2,4,2.043057694,5078,70,5,524,524,0,31319,31283,36,427,427,0,1,100,NoArch
8eed4406949992086fe36b8da0029de98f443588,13,295,129,166,0,0,0,2,23,134,2,6,2.575853208,3939,42,3,336,326,10,26392,25294,1098,123,120,3,1,100,NoArch
b7da6cb33d27002525e40913dd63f077aeba26f0,0,0,0,0,0,0,0,0,0,0,0,0,0,0,18,2,0,0,0,0,0,0,0,0,0,1,100,NoArch
9056c68744a3f31ac2625e004ec6e155d2e86be9,18,423,163,260,3,1,4,1,52,0,3,13,2.931241098,3772,8,1,465,449,16,20294,19089,1205,356,348,8,1,99.59687271,NoArch
5cc96e85c13e56e866ca15063bf08c204d967377,10,1339,13,1326,9,0,9,1,13,3,1,6,3.143916164,152,8,4,76,5,71,7931,674,7257,43,2,41,1,99.75505205,NoArch
18e6b79947b4aa0cbaeebd1918fcb14864d3f171,0,0,0,0,0,0,0,0,0,0,0,0,0,0,81,1,0,0,0,0,0,0,0,0,0,0,100,NoArch
23dca6c237517bc9d9407556af6b1042f09ae76b,24,806,301,505,8,0,8,37,81,205,5,10,3.815354957,2858,9,2,297,266,31,19511,16743,2768,111,91,20,1,91.70574836,Arch
8d82d19ee4da8910c7101b24ab976ac7cf54e732,0,0,0,0,0,0,0,0,0,0,0,0,0,0,19,1,0,0,0,0,0,0,0,0,0,0,100,NoArch
b02ec689b3270bc72ed67739d4520fb14e1f3aae,0,0,0,0,0,0,0,0,0,0,0,0,0,0,20,2,0,0,0,0,0,0,0,0,0,0,100,NoArch
d603060a43032881bb66023ed2d7c07654f5179d,2,13,1,12,0,0,0,4,7,311,2,2,0.591672779,385,19,3,29,29,0,2532,2369,163,19,19,0,1,100,NoArch
85a933c53dac93a711886af079d4fe4341603f29,1,4,2,2,0,0,0,13,50,28,1,1,0,380,0,0,43,43,0,2527,2507,20,22,22,0,1,100,NoArch
a2fc88033ec98e8fb75b97675cd5ec73b9ce3eba,1,1,1,0,0,0,0,14,24,18,1,1,0,572,9,4,78,78,0,3627,3627,0,35,35,0,1,100,NoArch
17cd53892980abe5332fbaea81a79ae80cf348a4,0,0,0,0,0,0,0,0,0,0,0,0,0,0,71,4,0,0,0,0,0,0,0,0,0,0,100,NoArch
73c0e1e4432d97958ab1fec6ce9350ecd5bc656b,1,6,2,4,0,0,0,3,8,18,1,1,0,162,10,5,5,5,0,1148,1144,4,2,2,0,1,100,NoArch
79a45bde3a8327ca02b0eb663f2cd8277547d401,109,3131,1204,1927,0,0,0,3,82,25,10,73,4.92399632,35864,21,2,3023,3023,0,236308,231449,4859,1863,1863,0,0,98.93206764,NoArch
2e69c23a29de350dcc9b92a3b1cb12c133eca036,29,116,116,0,0,0,0,13,54,18,3,12,4.362470452,6475,22,3,638,638,0,33905,33905,0,497,497,0,0,100,NoArch
c9c9efa3ab8947c69e86e6f068199a6d75a7fbdc,0,0,0,0,0,0,0,0,0,0,0,0,0,0,23,4,0,0,0,0,0,0,0,0,0,0,100,NoArch
178767948e906f673d6d4a357c65c11bc574f619,0,0,0,0,0,0,0,0,0,0,0,0,0,0,24,5,0,0,0,0,0,0,0,0,0,0,100,NoArch
09e625becd8d7e86a8f94610a098966723bb2b89,0,0,0,0,0,0,0,0,0,0,0,0,0,0,20,2,0,0,0,0,0,0,0,0,0,0,100,NoArch
4d508ef673efc3f73dcceff217e8c4cbfc44b38c,1,2,2,0,0,0,0,2,2,32,1,1,0,29,64,1,0,0,0,77,77,0,0,0,0,0,100,NoArch
b02ec689b3270bc72ed67739d4520fb14e1f3aae,1,2,2,0,0,0,0,1,1,0,1,1,0,29,20,2,0,0,0,77,77,0,0,0,0,0,100,NoArch
66f951322a3872073b86896fa5c10b51a0f6e4ab,19,305,233,72,1,0,1,2,26,61,2,14,3.34047325,5817,96,6,433,426,7,36062,35707,355,263,256,7,1,99.92587102,NoArch
99663d370b5de14cc85f28bb36f1022c2c0bf478,2,117,6,111,1,0,1,1,2,358,1,2,0.534943699,67,0,0,9,4,5,1218,336,882,5,1,4,1,99.80828786,NoArch
5ee35a0a92ab0de6c36885a515fad04c08109c78,2,13,1,12,0,0,0,4,7,307,2,2,0.591672779,385,19,3,29,29,0,2532,2369,163,19,19,0,1,100,NoArch
b7a0d76fc99144fc2eb223cda62ac9d67528c6a2,1,4,2,2,0,0,0,13,50,23,1,1,0,380,0,0,43,43,0,2527,2507,20,22,22,0,1,100,NoArch
1fed44af84b4726d40c57f1dad012c8e4a510f91,8,343,133,210,2,0,2,2,51,14,1,7,2.345035474,1808,22,2,153,132,21,12519,11163,1356,92,77,15,1,99.88268074,NoArch
b15c3cf9a9772843e853ae502887b2a05bc14208,1,1,1,0,0,0,0,14,24,17,1,1,0,572,9,4,78,78,0,3627,3627,0,35,35,0,1,100,NoArch
7dddd5440650ae18099ba1ee27ad811220fa9e7c,0,0,0,0,0,0,0,0,0,0,0,0,0,0,71,4,0,0,0,0,0,0,0,0,0,0,100,NoArch
9762e4c08c0ff953cc62e72b1295db4fd4c002c5,6,184,108,76,0,0,0,5,28,0,1,6,1.423558586,1586,97,5,112,108,4,9626,9898,272,75,68,7,0,100,NoArch
37c29e75dcbd9f045bb1737bb734e2b408081182,1,6,2,4,0,0,0,3,8,17,1,1,0,162,10,5,5,5,0,1148,1144,4,2,2,0,1,100,NoArch
d603060a43032881bb66023ed2d7c07654f5179d,28,456,931,475,0,4,4,1,49,11,4,22,3.645180187,7756,19,3,579,616,37,44899,47244,2345,326,359,33,1,99.61668878,NoArch
c350d05dd3301f14fa9d688746c9de2416db3f11,132,4050,1654,2396,4,0,4,3,82,36,10,87,5.377777957,41388,21,2,3465,3428,37,271627,264447,7180,2133,2100,33,0,98.54089904,NoArch
79a45bde3a8327ca02b0eb663f2cd8277547d401,26,451,920,469,0,4,4,1,51,13,3,20,3.586528593,7018,21,2,496,533,37,40148,42469,2321,289,322,33,0,99.61691469,NoArch
49829f8822bc6bc9389a794e9c08b06c1b1909cf,26,919,450,469,4,0,4,2,52,70,3,20,3.58531093,6549,45,3,533,496,37,42469,40148,2321,322,289,33,1,99.61691469,NoArch
e39d0a2f2852ef51c524e5b16a1cecb099674eed,29,116,116,0,0,0,0,13,54,18,3,12,4.362470452,6475,22,3,638,638,0,33905,33905,0,497,497,0,0,100,NoArch
2e69c23a29de350dcc9b92a3b1cb12c133eca036,26,451,920,469,0,4,4,1,51,13,3,20,3.586528593,7018,22,3,496,533,37,40148,42469,2321,289,322,33,0,99.61691469,NoArch
c7c517f14c3fb5260fa7f3abca5d50a299870b38,28,973,454,519,4,0,4,2,52,67,3,22,3.6511907,7607,98,4,656,612,44,48428,45830,2598,384,349,35,1,99.61691469,NoArch
ab3fbb88950ca351723f2f46da9f40ba325a03b5,12,239,235,4,1,1,2,3,28,60,1,7,2.861163152,2547,18,1,170,169,1,15347,14862,485,93,93,0,1,91.72485131,Arch
be8c1e499fc94483c2a26687072942515b793368,0,0,0,0,0,0,0,0,0,0,0,0,0,0,2,1,0,0,0,0,0,0,0,0,0,0,100,NoArch
05e6f44d5377804d4c8f727fba27679d1cdd1de3,1,7,2,5,0,0,0,2,2,2,1,1,0,68,99,5,5,4,1,264,249,15,3,2,1,0,100,NoArch
de94787a85b272f79181dff73907b0f20855ee78,5,83,21,62,0,0,0,3,55,310,2,5,1.872550236,2909,7,1,361,354,7,14581,14197,384,327,320,7,1,100,NoArch
15bf01dcb770c22e2cf8ed861c84ba3565927f5b,1,7,0,7,0,0,0,6,11,106,1,1,0,294,72,4,43,42,1,2116,2048,68,25,24,1,1,100,NoArch
04ede8eecf5ad7d710f34ea3d00b8f19365af2f2,0,0,0,0,0,0,0,0,0,0,0,0,0,0,0,0,0,0,0,0,0,0,0,0,0,1,100,NoArch
178767948e906f673d6d4a357c65c11bc574f619,40,687,1284,597,2,5,7,1,54,41,4,29,4.338183277,12588,24,5,1084,1138,54,68295,71845,3550,736,780,44,0,91.43154336,Arch
a60fab3a5c6df1b9b3d32f192d4c6ca4ff1d6f6d,41,1296,687,609,5,2,7,2,55,92,4,30,4.363348088,12550,100,6,1229,1174,55,75994,72389,3605,821,776,45,1,91.43154336,Arch
486bc7dc3b4cf41642069c5fa1be204aebe6da5d,0,0,0,0,0,0,0,0,0,0,0,0,0,0,23,4,0,0,0,0,0,0,0,0,0,0,100,NoArch
694300477f61a9169c15cac1ddf67368dbf5dd1b,0,0,0,0,0,0,0,0,0,0,0,0,0,0,0,0,0,0,0,0,0,0,0,0,0,1,100,NoArch
be57e422004e93e2fefb2d52052e1e3b8916f6b0,1,0,1,1,0,0,0,13,24,323,1,1,0,1118,1,1,95,95,0,5885,5898,13,64,64,0,1,100,NoArch
cc5256a7d8aff1f817b023148be7f1e0396b203d,0,0,0,0,0,0,0,0,0,0,0,0,0,0,46,1,0,0,0,0,0,0,0,0,0,1,100,NoArch
73fdcf37dfa8ca4585533401f1ddabef081b72b4,2,4,4,0,0,0,0,7,11,598,1,1,0.811278124,453,19,1,42,42,0,1801,1801,0,22,22,0,1,100,NoArch
0f39137ba854a2f808e2108c6aa10f4260b00844,2,7,2,5,0,0,0,3,22,47,2,2,0.918295834,742,101,6,89,89,0,3459,3437,22,45,45,0,1,100,NoArch
55a80a817d21cfcc1c8990da36ba58af82c5a3e3,0,0,0,0,0,0,0,0,0,0,0,0,0,0,1,1,0,0,0,0,0,0,0,0,0,1,100,NoArch
9850e90e2e0fa602a5346911810bd65c5f3e0ea8,3,19,131,112,0,0,0,7,28,17,1,3,1.2178176,694,0,0,33,36,3,3802,4631,829,16,16,0,1,100,NoArch
562e28f07918be76ab674d509a0e237d51533e02,1,2,1,1,0,0,0,11,13,48,1,1,0,103,3,1,14,15,1,369,368,1,7,7,0,1,100,NoArch
69cbcc95169488e7ffa3347ddf98be4167a99997,0,0,0,0,0,0,0,0,0,0,0,0,0,0,18,0,0,0,0,0,0,0,0,0,0,1,100,NoArch
57668d02a0aa723dd4b2245dc7659fe18113eb59,9,348,74,274,0,0,0,1,53,152,1,8,2.610234193,3553,102,6,280,251,29,22144,20555,1589,149,134,15,1,100,NoArch
bf5a52e51bbeaa089995335a0a4c55884792e505,1,18,4,14,0,0,0,13,17,131,1,1,0,108,4,2,11,9,2,864,730,134,4,4,0,1,100,NoArch
d59c8044f8dafbd4ebef979d3ee2eb09b410884e,2,8,3,5,0,0,0,1,3,66,2,2,0.994030211,216,6,0,18,18,0,846,782,64,18,18,0,1,99.77037887,NoArch
f66e1ce9bf56fb4478d8b14d791644cc817924ca,4,90,11,79,0,0,0,6,30,17,1,4,1.193931506,2442,103,6,179,171,8,16671,16236,435,94,91,3,1,100,NoArch
38c9b85aa8aa8f72876b112e376f300076fafacd,0,0,0,0,0,0,0,0,0,0,0,0,0,0,65,0,0,0,0,0,0,0,0,0,0,1,100,NoArch
21fd6edfe7721c674b40877fbbdbac71b36bf782,2,3,3,0,0,0,0,25,56,31,1,1,0.918295834,2488,6,0,305,305,0,10423,10423,0,299,299,0,1,100,NoArch
7a1bd225cab6b1737d689d3659351a8c950a4d78,42,946,443,503,6,0,6,3,54,65,2,24,4.175985481,10051,20,2,867,840,27,58863,57108,1755,441,417,24,1,99.7839436,NoArch
79b896f071c73a29f7af22e2f5328bd42746fadb,1,2,1,1,0,0,0,6,23,51,1,1,0,254,104,6,24,23,1,1332,1322,10,13,13,0,1,100,NoArch
11398e84801167756f554c727e829ba2d6c700c6,0,0,0,0,0,0,0,0,0,0,0,0,0,0,66,1,0,0,0,0,0,0,0,0,0,0,100,NoArch
6bd3ca98d69679630ce5c35e7a0dabcc0cfa6c5d,10,1701,1321,380,5,0,5,1,13,74,2,6,2.261638031,2333,67,2,153,142,11,18949,15718,3231,85,81,4,1,99.45342747,NoArch
073c318d9fd83d40b1dde1cc149def617ce31e8f,4,12,0,12,0,0,0,4,26,710,2,4,1.918295834,944,68,3,79,79,0,6958,6900,58,29,29,0,1,94.72270198,Arch
e9bf1c1186532e6958d5671fd6244958cba16dbe,2,5,6,1,0,0,0,22,46,155,2,2,0.994030211,1127,105,6,144,145,1,5664,5656,8,83,83,0,1,100,NoArch
7592ddd776148bf750043d31d74211670b961c46,0,0,0,0,0,0,0,0,0,0,0,0,0,0,69,4,0,0,0,0,0,0,0,0,0,1,100,NoArch
f218693f5d20491802c48bb02b50a32e573100db,2,8,4,4,0,0,0,1,1,0,1,2,1,998,73,1,56,56,0,8244,8217,27,36,36,0,0,99.93380771,NoArch
cf002b6918ffcdb7528857861372dd73ddb7e31d,19,444,247,197,2,0,2,1,15,662,1,4,3.851933941,3160,70,5,172,157,15,22419,21415,1004,106,92,14,1,99.87601256,NoArch
eb5e7eec0a080989a4ad3c867699b814dc502ba1,9,17,17,0,0,0,0,2,26,406,2,6,2.799979385,1847,20,0,197,197,0,10909,10907,2,103,103,0,0,100,NoArch
ea59a7ff5f59a4b7f5491107f93e82c47ffc255b,3,23,1,22,0,0,0,2,2,1020,1,2,1.56320209,376,82,0,21,18,3,2271,2153,118,19,16,3,1,100,NoArch
cf3a2ead32f432757668d49a9138f891110aa9a5,1,8,2,6,0,0,0,5,12,17,1,1,0,411,106,5,44,44,0,2383,2321,62,13,13,0,1,100,NoArch
81acb4cafe07241b411345fd99a48c1e27b07c48,0,0,0,0,0,0,0,0,0,0,0,0,0,0,83,1,0,0,0,0,0,0,0,0,0,0,100,NoArch
db2ab9a15092c1423ee308b1bba7dd7e2f5027a8,6,234,14,220,2,0,2,1,53,11,1,6,1.489355026,1700,107,6,126,107,19,11081,9874,1207,72,64,8,1,99.95878328,NoArch
3c4eb60913cac9cd22c768ae404b9e4078df7a9d,1,3,3,0,0,0,0,6,6,61,1,1,0,182,21,1,5,5,0,664,664,0,5,5,0,0,100,NoArch
4abcb4f6591448ef1d9bbc9aa237758ae75ecba7,1,0,2,2,0,0,0,2,2,229,1,1,0,98,12,0,8,8,0,433,447,14,4,4,0,0,100,NoArch
57c8113ee1941615a03f0efc2e3d46b634e940eb,9,68,61,7,0,0,0,1,25,512,2,4,1.918579118,2161,71,6,129,132,3,16180,16144,36,78,79,1,1,95.31122956,Arch
56d08fbe708625fe49f7c60d3f769c3dff554c19,8,301,110,191,0,0,0,1,24,244,3,7,2.57037491,2036,10,0,243,225,18,13048,12018,1030,129,114,15,1,100,NoArch
512ca42d14a29e5d8da02198345024f2f83999d9,1,4,4,0,0,0,0,14,54,5,1,1,0,713,4,0,16,16,0,3392,3393,1,9,9,0,0,100,NoArch
44b9bc145e0d101bcc688f11c6a30ebcbb7a4a7d,1,1,12,11,0,0,0,2,2,497,1,1,0,125,42,0,12,14,2,535,625,90,6,8,2,1,100,NoArch
cf1543185217c8acd306218a7d00d1022dd35584,0,0,0,0,0,0,0,0,0,0,0,0,0,0,11,0,0,0,0,0,0,0,0,0,0,1,100,NoArch
bd1d2d4952e2664e2049e79ac571578cddca4500,1,10,6,4,0,0,0,9,10,490,1,1,0,239,12,1,14,14,0,1648,1622,26,9,9,0,0,100,NoArch
e528dd798ab8ce6e4d444d2d771c107c503e8f25,41,4069,21,4048,33,0,33,1,83,35,5,18,4.803467566,3898,7,1,877,488,389,38919,20176,18743,588,362,226,1,94.63982103,Arch
06240417e9393de223c9cf6e1b66858d0417768e,2,57,4,53,0,0,0,11,25,206,1,2,0.912734156,2615,8,0,197,192,5,20648,20253,395,98,97,1,1,100,NoArch
b30c5bdaef77aee9f564ac24f80f5c364014bb17,12,355,65,290,1,0,1,6,55,27,1,10,3.194143622,3854,108,6,254,229,25,25123,23184,1939,148,136,12,1,98.53028127,NoArch
dbcf60f370e93ab490cf82e677387a07ea743cda,2,6,6,0,0,0,0,10,10,336,1,2,1,680,5,1,76,76,0,4402,4402,0,24,24,0,0,100,NoArch
6228b17a3ddb4c336b30e5b8c650e003e38b5e3e,1,1,1,0,0,0,0,16,24,95,1,1,0,431,6,2,48,48,0,2554,2554,0,20,20,0,0,100,NoArch
9d5c3e5cb92a4247bb1fc9a4a0e2eb3d2fbce1d6,1,12,0,12,0,0,0,5,13,11,1,1,0,417,109,6,45,44,1,2425,2383,42,13,13,0,1,100,NoArch
4f991ee3525c6225c7bf3b46e272f7d5b919196e,3,40,15,25,0,0,0,4,6,193,2,3,1.452613804,385,2,0,35,30,5,2473,2242,231,17,14,3,1,100,NoArch
280f66e0f80932498fd691561c1ddb47815873f0,1,4,4,0,0,0,0,14,56,5,1,1,0,723,110,7,16,16,0,3442,3441,1,9,9,0,0,100,NoArch
c79017cb74229993e8201602fb1f04d47aedd092,2,23,13,10,0,0,0,8,18,96,1,2,0.943601631,692,0,0,57,56,1,4958,4886,72,29,29,0,1,100,NoArch
9f3c4a2a7f565f7bcc32189a202a3d400ece23f1,6,31,9,22,0,0,0,3,47,98,3,5,2.283451697,5199,22,2,412,408,4,39589,39459,130,203,202,1,1,100,NoArch
89651c94085f3f775328e5fbc2113aa9d1a6a962,1,7,2,5,0,0,0,2,4,276,1,1,0,93,111,8,11,10,1,428,409,19,5,5,0,1,100,NoArch
35a04c43a5c750d265e855b313a84a5135075225,1,1,1,0,0,0,0,8,13,0,1,1,0,272,23,3,18,18,0,2195,2195,0,14,14,0,1,100,NoArch
5d60491f5b76ef0f77174d71567d0673d9315bcd,7,320,126,194,1,0,1,8,16,217,1,5,2.089542678,1469,11,1,174,149,25,10786,9709,1077,111,94,17,1,99.97348418,NoArch
9735f4b8efaa3d333e496c1159bd9ae0b222519a,10,286,129,157,1,0,1,1,2,9,2,6,2.088504823,1749,8,1,218,200,18,9135,8321,814,112,103,9,1,94.61530602,Arch
d90fd1f68c882c2e98aaa5b648e814bf4dac0515,0,0,0,0,0,0,0,0,0,0,0,0,0,0,94,0,0,0,0,0,0,0,0,0,0,0,100,NoArch
627f20f9c54a87dded3350b73a6327f5b95632f6,5,84,78,6,0,0,0,6,33,205,2,4,1.997481697,2291,112,9,260,267,7,12991,12976,15,73,69,4,1,100,NoArch
76554aa31a858d9946c3b95102bc1b18ce28a432,0,0,0,0,0,0,0,0,0,0,0,0,0,0,24,4,0,0,0,0,0,0,0,0,0,0,100,NoArch
86a7351c39c760b74ee45a5d67cef31228ad1ee3,1,1,2,1,0,0,0,15,29,5,1,1,0,472,25,5,39,39,0,2107,2116,9,23,23,0,0,100,NoArch
916f12b7dd4b635c790b17876fa49fb786233e94,35,586,1536,950,3,12,15,1,16,393,2,17,4.16813403,4253,12,2,315,391,76,21527,28136,6609,213,248,35,1,88.37680768,Arch
2d5ac551955e8c7be7be60edc5aaf17d2ed7f650,2,85,1,84,0,0,0,16,37,90,2,2,0.159350063,2926,9,1,280,274,6,20532,19786,746,160,159,1,1,100,NoArch
2791fb9a964b39ef9aaec83eafd080013186b2eb,9,344,129,215,2,0,2,4,58,28,1,5,2.464543306,4721,26,6,441,422,19,25839,24815,1024,373,354,19,1,99.72422246,NoArch
4deaa30c8d7f51987201e99ce2f3bf9cc5a97d18,0,0,0,0,0,0,0,0,0,0,0,0,0,0,0,0,0,0,0,0,0,0,0,0,0,1,100,NoArch
b8dad628e584e0acfa8ef6ba0056f7cb6efafad0,34,972,419,553,4,0,4,6,35,86,2,17,4.051737901,8408,74,1,832,794,38,56349,52612,3737,499,471,28,1,89.61998593,Arch
57d5da68aa646adfd327394daea720cb3d592b1d,13,236,61,175,2,0,2,2,5,126,2,7,2.970432774,1344,84,2,130,113,17,8211,7020,1191,85,79,6,2,88.64517693,Arch
8a652171cfecc68fd06c6632afa77b1456e714a6,1,1,1,0,0,0,0,14,19,112,1,1,0,322,7,2,51,51,0,1892,1892,0,20,20,0,0,100,NoArch
61d009608899bc70c1372d5cb00a2f35e188c30c,4,78,1,77,1,0,1,1,59,262,1,4,1.13331007,2408,27,7,312,308,4,10509,10124,385,301,297,4,1,99.96649916,NoArch
3a150ee1812993553f36cdc8d321766c267d3f4f,1,12,16,4,0,0,0,5,6,448,1,1,0,215,8,3,20,21,1,1256,1313,57,7,7,0,1,99.94975716,NoArch
c7a5c8273b0d67cd436caec650ffb36e1a74f9e0,0,0,0,0,0,0,0,0,0,0,0,0,0,0,2,0,0,0,0,0,0,0,0,0,0,1,100,NoArch
3354fac42f9a2c4dbc8ac73ca4749160e9b9459b,16,689,365,324,1,0,1,1,57,34,1,8,2.75471295,6380,113,7,474,442,32,40711,38965,1746,265,241,24,1,98.78677082,NoArch
5091ab73112c8e6eea8a53229c441b0c501d1807,2,15,3,12,0,0,0,5,6,61,2,2,0.99107606,584,75,1,55,52,3,3925,3837,88,14,14,0,1,100,NoArch
5a94043f38fa8e23c8e0b184225230aa43873368,0,0,0,0,0,0,0,0,0,0,0,0,0,0,9,4,0,0,0,0,0,0,0,0,0,1,100,NoArch
55df8f61e1ba948b3f202321a8d492a0ea5c35aa,1,1,1,0,0,0,0,2,2,1241,1,1,0,299,0,0,43,43,0,1697,1697,0,19,19,0,0,100,NoArch
e813dae36d5fa1f584e221e24e0919e43f7d0503,8,59,19,40,1,0,1,13,56,41,1,6,2.365147364,2663,114,6,298,298,0,15354,15300,54,147,147,0,0,99.93406956,NoArch
5515a0d319cbac835c65f6d21898ac1399d77ea3,0,0,0,0,0,0,0,0,0,0,0,0,0,0,115,7,0,0,0,0,0,0,0,0,0,1,100,NoArch
eeafd24f4c3a65e107867e30eb499b4aec69d7e5,7,1197,776,421,0,0,0,11,25,235,2,5,1.408522455,3747,13,2,516,376,140,30204,25397,4807,293,237,56,1,87.72508242,Arch
b4b23e401bb66793c924dfe5b78d641c65e207a6,3,9,0,9,0,0,0,5,20,308,1,2,1.435520504,1042,7,0,92,92,0,9317,9168,149,55,55,0,1,100,NoArch
f52cb32f5f0c9e31b5addf29adbb886ca6d167dd,3,4,3,1,0,0,0,4,20,126,1,2,1.556656707,832,4,0,114,114,0,5600,5585,15,56,56,0,1,100,NoArch
06c2cc2c8b1ad88bb4c9bbdb496053a079767e9b,6,39,13,26,0,0,0,6,60,428,1,2,2.042067214,2847,8,1,340,336,4,12576,12402,174,328,324,4,1,100,NoArch
440525ccbb001884840efadcb51eda44bba5e624,6,172,101,71,1,0,1,1,18,87,2,6,1.512438229,1470,116,8,134,132,2,8684,8347,337,53,52,1,1,97.79811267,Arch
31a301f0aa955450e52c28ee5857526034d523f0,5,86,16,70,0,0,0,5,35,106,1,4,1.757862648,2655,117,9,239,228,11,15228,15061,167,142,136,6,1,100,NoArch
bc4966ea7353016c7589ef750719e400024e09e0,2,38,0,38,0,0,0,4,16,92,1,2,0.398459274,551,14,1,56,52,4,4195,3823,372,33,32,1,1,99.9822695,NoArch
aa546554ff23e62c374e323ec47d0081fb200227,12,27,36,9,0,0,0,2,48,331,4,8,3.38548646,3142,0,0,333,333,0,17201,17247,46,166,166,0,1,100,NoArch
7e887b54d70ab79e77bd9ac78f7ff6616c852503,2,2,2,0,0,0,0,17,38,84,2,2,1,2959,0,0,210,210,0,22302,22302,0,129,129,0,0,100,NoArch
36be28712196ff4427c41b0aa885c7fcd7356d7f,3,4,4,0,0,0,0,18,39,24,3,3,1.5,2201,10,3,192,192,0,15836,15836,0,123,123,0,0,100,NoArch
9067657a5ff313990c819065ad12d71fa8bb0f06,2,27,1,26,0,0,0,2,13,179,1,2,0.749595257,424,1,1,19,18,1,3437,3245,192,16,15,1,1,100,NoArch
f0585facd6e8ff8c226e1e6c7b66933eac8ea4c6,7,52,21,31,0,0,0,11,31,231,2,7,2.134456201,3949,76,2,426,421,5,27901,27644,257,226,223,3,1,97.42511372,Arch
2aa660f99db76f198906c14005e944dffbe383e2,0,0,0,0,0,0,0,0,0,0,0,0,0,0,85,1,0,0,0,0,0,0,0,0,0,0,100,NoArch
dd1bd62684fdd2115dcc4bad264493d25cc97858,5,176,0,176,1,0,1,12,40,88,2,4,2.075126504,3407,10,1,342,323,19,26064,24804,1260,215,203,12,1,99.96673043,NoArch
2f07e1267fa1a372ff06ca5af2bacf0f91929f89,2,2,2,0,0,0,0,5,9,122,1,2,1,136,11,4,7,7,0,815,815,0,6,6,0,0,100,NoArch
def08d703d71265ee40efa95932416e2e76e22e4,2,3,0,3,0,0,0,9,12,150,1,2,0.918295834,149,0,0,8,8,0,618,601,17,6,6,0,0,100,NoArch
47ed91799943271f219419cf209793a98b3f09b5,0,0,0,0,0,0,0,0,0,0,0,0,0,0,27,0,0,0,0,0,0,0,0,0,0,1,100,NoArch
73e8ba76206682c66eb06b53f2bdec890a567235,2,7,3,4,0,0,0,2,16,165,1,2,0.970950594,334,13,0,25,25,0,1734,1706,28,9,9,0,1,100,NoArch
46808dcb1fe22491326a9e831dd4dde4c70796fb,23,416,848,432,2,8,10,1,18,188,2,14,3.851837777,2780,13,0,235,271,36,16083,19811,3728,184,198,14,1,98.6053588,NoArch
5f32162a2fad0cd6db87972d29336dc09599bf8a,96,3267,2042,1225,8,1,9,7,61,125,9,57,4.477749213,34770,77,1,3392,3207,185,243244,235080,8164,1899,1801,98,4,98.58200303,NoArch
e91e611afbee2958322b2e32f41faabc5918f6b4,5,32,25,7,0,0,0,2,10,202,2,4,2.117639614,842,0,0,133,130,3,4691,4645,46,47,46,1,1,100,NoArch
2e152177fb9a1138e46d21f4608fea41cc32af15,31,457,781,324,4,13,17,6,35,75,2,8,4.374378789,4644,14,1,411,435,24,30322,31860,1538,176,185,9,1,99.27259163,NoArch
10e3a9a3fbaa5bd0269f86707bdf65b66fa25b22,1,1,1,0,0,0,0,9,12,2,1,1,0,240,12,2,29,29,0,1185,1185,0,20,20,0,0,100,NoArch
a818020f72d37c8fd7a88414b769be9b23ee0ba6,3,22,6,16,0,0,0,3,13,491,1,2,1.018424695,420,78,2,55,50,5,2891,2711,180,30,29,1,1,100,NoArch
2a392d8e8eb7e02e2447a81009268cd1c81129d3,4,12,10,2,0,0,0,7,58,96,1,4,1.789929075,1271,118,0,67,66,1,6808,6779,29,37,37,0,1,100,NoArch
ad63938890151c4c13e78acfd448259c3af80f80,11,188,152,36,0,0,0,2,34,85,2,11,2.855565141,3092,119,1,325,323,2,18613,18401,212,166,165,1,1,100,NoArch
ceace1c653a3ce3c97e6ee5a244d71ff1806be4f,4,111,31,80,0,0,0,5,25,28,1,3,1.668921307,3296,0,0,285,275,10,24557,24099,458,151,145,6,1,99.96248359,NoArch
5b8bc664a8dca97789c2472d633868fb8f553652,1,4,0,4,0,0,0,2,3,3,1,1,0,140,120,2,12,11,1,546,534,12,8,8,0,1,100,NoArch
f14d4e65e7edab58aa86c495e4bd4caa79086d6b,1,1,1,0,0,0,0,17,24,16,1,1,0,717,7,0,59,59,0,3054,3055,1,37,37,0,1,100,NoArch
48a3906cccb6abd04f0a86922f6af3a175d6f7b2,3,3,3,0,0,0,0,12,15,360,3,3,1.584962501,1106,13,2,96,96,0,6390,6390,0,39,39,0,0,100,NoArch
252c4ed380ef3983b0c639d5fd4dee23bc113308,1,1,1,0,0,0,0,7,13,19,1,1,0,344,0,0,20,20,0,1266,1266,0,20,20,0,1,100,NoArch
8a487eafa7b85a8936953a9595b16a2079dc7e7e,0,0,0,0,0,0,0,0,0,0,0,0,0,0,79,2,0,0,0,0,0,0,0,0,0,1,100,NoArch
e6711b171a6a3aaed4bbba1f16664374ffd601dc,2,30,10,20,0,0,0,5,7,246,2,2,0.848548178,295,11,1,33,32,1,2148,1938,210,14,13,1,1,100,NoArch
cff384d23f464692b792abc4b4a7ca6731ed8067,4,12,10,2,0,0,0,2,25,21,3,4,1.764694686,2431,80,3,162,162,0,14432,14478,46,88,88,0,1,100,NoArch
abf3e3fe71cd92a4129cf110a5206fbcfb3b1ae2,15,218,116,102,0,0,0,14,59,133,4,12,3.071857295,7216,121,3,657,645,12,39802,39414,388,320,314,6,1,100,NoArch
f897e6d73ebc26d32017774d452389023f53f742,6,48,2,46,0,0,0,5,60,191,2,6,1.888811905,2628,122,4,151,148,3,15052,14812,240,91,88,3,1,100,NoArch
2c370cbae084a41162fedbcc0b1e66558629dcbe,10,57,47,10,0,0,0,6,61,29,1,8,2.971937359,5388,123,5,352,355,3,31034,30951,83,205,204,1,1,100,NoArch
9aa7cfb80224629573c6d02c576858fe9afb1afa,1,2,2,0,0,0,0,3,3,86,1,1,0,157,1,0,16,16,0,946,946,0,6,6,0,0,100,NoArch
2eda3de7f91335c17458f106f4edde8d8ffbb978,34,540,334,206,2,0,2,1,60,84,3,24,4.302313485,10068,124,6,882,860,22,58626,58250,376,511,498,13,1,97.69,Arch
5276850415649a45106073e1176089247930add3,0,0,0,0,0,0,0,0,0,0,0,0,0,0,0,0,0,0,0,0,0,0,0,0,0,1,100,NoArch
3025f4d7961b221743fe3cc248e0bb2e8ee6411b,2,11,5,6,0,0,0,13,61,0,1,2,1,613,125,7,70,70,0,3523,3478,45,40,40,0,1,100,NoArch
dfdfbbedaef6d2618b5254fc7b56a1d6a44a56f2,0,0,0,0,0,0,0,0,0,0,0,0,0,0,1,1,0,0,0,0,0,0,0,0,0,1,100,NoArch
588a34aa95c608b595da66e6d42c9f06c9ef1546,0,0,0,0,0,0,0,0,0,0,0,0,0,0,126,8,0,0,0,0,0,0,0,0,0,1,100,NoArch
335e80ea1bdc2327763e55fb9d32e3be75bb07db,1,1,4,3,0,0,0,2,4,227,1,1,0,451,1,1,62,62,0,2132,2165,33,40,40,0,1,100,NoArch
3a78be9203a9c3cea33fa6120c89f7702275fc31,4,50,43,7,0,0,0,2,7,359,1,1,1.582873791,463,127,9,39,39,0,1936,2010,74,27,24,3,1,100,NoArch
60d4cb505afcd11197a7742f9d6063125acbb91d,1,1,1,0,0,0,0,4,5,684,1,1,0,122,0,0,3,3,0,790,790,0,1,1,0,0,100,NoArch
1e2be85a0f1b290fa568cfae68f4219ac2b5f210,0,0,0,0,0,0,0,0,0,0,0,0,0,0,1,1,0,0,0,0,0,0,0,0,0,1,100,NoArch
46f0496a0838431cd8886ca882a902d801c4dfb8,3,3,3,0,0,0,0,7,9,39,1,3,1.584962501,673,14,2,73,73,0,4314,4314,0,25,25,0,0,100,NoArch
3686c25faee64589af6b2526e60062e7e50e51d1,18,227,459,232,0,1,1,1,4,91,1,7,3.107776728,2849,9,0,267,300,33,12933,13740,807,128,155,27,1,99.76518305,NoArch
e355ab52db4af71880ac6e9b67991221d4b9c569,18,416,58,358,3,0,3,5,62,11,2,12,3.38888767,6009,128,10,491,460,31,34993,33371,1622,277,260,17,1,89.23038166,Arch
b68c5a68f9ba21f253256a49aacd9f4aee49e039,6,195,62,133,0,0,0,13,22,172,2,5,1.597454034,3887,2,2,413,406,7,31601,30858,743,248,244,4,1,100,NoArch
f5d7362ee88568003c9310d4f9ada385d1180f61,5,371,288,83,1,0,1,8,42,58,2,2,1.355079877,2836,72,0,238,238,0,22480,21692,788,161,161,0,1,99.9382144,NoArch
aa3c4ecda57c412b5822348d40cdf983c0035fb7,9,776,806,30,2,0,2,6,34,11,1,4,1.520140608,2550,129,11,194,185,9,14145,15274,1129,144,111,33,1,88.23440568,Arch
b480294e792b6344d37560587f8f6e170e210d14,0,0,0,0,0,0,0,0,0,0,0,0,0,0,28,0,0,0,0,0,0,0,0,0,0,1,100,NoArch
84ca981cd017dc542b86adbd3b2141791feebf89,1,1,1,0,0,0,0,7,15,23,1,1,0,344,3,3,20,20,0,1266,1266,0,20,20,0,1,100,NoArch
499af7c039da12e397dca0819d77723bce92c145,2,39,12,27,0,0,0,10,25,158,1,2,0.752212173,815,0,0,93,92,1,5457,5275,182,45,44,1,1,100,NoArch
1e285dc3999c56a3302b5ed9e5c38a6bcb884f92,1,15,6,9,0,0,0,13,22,733,1,1,0,234,12,1,29,30,1,1320,1299,21,6,6,0,1,100,NoArch
5ed35bff836f898d420e9a7ef8c47dc2ded7dca3,42,1137,1072,65,8,5,13,2,37,161,3,21,4.571641789,8048,15,0,740,730,10,50921,53004,2083,450,420,30,1,86.63069544,Arch
c9d641cc30ba5b1e65aa87b2c6d48a3bdd788564,9,201,52,149,0,0,0,7,28,22,1,8,2.320712759,3985,4,4,309,300,9,27281,26613,668,150,145,5,1,100,NoArch
91845e241da242cede95f705b0637331ce9222ff,1,17,2,15,0,0,0,5,23,89,1,1,0,493,1,0,55,54,1,3572,3432,140,31,30,1,0,100,NoArch
d8560377c306e49b7e58448b6897e9c0e7719f61,8,178,65,113,1,0,1,3,43,257,3,5,2.194036284,3500,73,1,334,324,10,26361,25711,650,208,204,4,1,99.84788561,NoArch
1bb05325637740498cac548872cf7223e34950d0,12,62,33,29,0,0,0,14,25,352,2,5,3.194439786,2555,81,2,224,222,2,15046,14692,354,110,108,2,1,95.7782516,Arch
220bf6a7e6f5cdf0efbbbee9df6852a8b2288570,0,0,0,0,0,0,0,0,0,0,0,0,0,0,29,1,0,0,0,0,0,0,0,0,0,1,100,NoArch
4b5512e6857ce8265d048ecbcdb2b8cccb199d2e,2,6,6,0,0,0,0,12,22,837,1,2,1,269,15,2,19,19,0,1721,1721,0,18,18,0,0,100,NoArch
e3fc74668fc43fefd73087ff725245b8ed85b4a1,12,33,62,29,0,0,0,14,26,0,2,5,3.194439786,2584,82,3,222,224,2,14692,15046,354,108,110,2,2,95.7782516,Arch
b1c4acf0aeb0f3d650c8e704828b1c2b0d2b5b40,0,0,0,0,0,0,0,0,0,0,0,0,0,0,30,2,0,0,0,0,0,0,0,0,0,1,100,NoArch
643b1a4df264876ad6f1be8b879ee9fc7133e639,0,0,0,0,0,0,0,0,0,0,0,0,0,0,16,1,0,0,0,0,0,0,0,0,0,0,100,NoArch
ae000795d7fb69d14a8e30c5a69cfe73aeaf1bad,1,1,1,0,0,0,0,8,9,230,1,1,0,117,18,0,4,4,0,305,305,0,4,4,0,1,100,NoArch
909c3ba45e9056dd38e5f35e22c993a3b5a614ac,6,131,28,103,0,0,0,6,41,210,1,5,2.285031146,2798,130,9,248,240,8,16926,16181,745,109,103,6,1,100,NoArch
af3ffe5e422645b4a2d4aed75a9827aede55afa5,0,0,0,0,0,0,0,0,0,0,0,0,0,0,86,0,0,0,0,0,0,0,0,0,0,0,100,NoArch
e5b6b8602c242c89cdb45440df8d2996a6c301f1,8,115,22,93,0,0,0,3,63,38,1,6,2.505694745,3396,131,8,220,209,11,19726,18996,730,134,131,3,1,99.8781231,NoArch
0223c442ec9a746834d1b2f2582c5267b692823a,72,2496,1868,628,15,10,25,1,38,264,2,43,5.325928537,15779,17,2,1391,1394,3,111345,110634,711,805,784,21,1,86.32659895,Arch
69ee790a47a5fa90a6acd954a9330cce3ae31c3b,17,591,142,449,1,0,1,9,26,226,3,9,3.498501547,5692,83,2,617,558,59,39462,35698,3764,327,297,30,1,99.26283458,NoArch
29574af239ae4596034a17999484ed069ec7123f,18,281,61,220,0,0,0,4,34,42,1,12,2.897583834,7658,84,3,670,655,15,53280,51920,1360,359,352,7,1,100,NoArch
5b1992a92d36efe03626e2e5282c71392dde81c1,3,17,10,7,0,0,0,18,84,122,2,3,0.968270247,2892,15,0,261,260,1,19790,19703,87,141,140,1,1,100,NoArch
f6326693efe657cc0dbd45f1d394fcff7266e523,7,563,3,560,6,0,6,1,2,257,1,3,2.555478821,46,5,4,53,2,51,2094,96,1998,37,2,35,1,99.87764377,NoArch
92a3c458bde7ca4d2bb72f4dbe486073f6a5ec4f,6,179,43,136,1,0,1,2,64,14,1,5,2.139055764,1346,132,8,74,66,8,7804,7092,712,39,32,7,1,99.98254799,NoArch
87c6f9cd077e2e8f3244f3f5c4e1d1ea5b2da4db,11,162,89,73,0,1,1,2,30,129,1,6,2.866791395,1640,133,9,160,151,9,7739,7380,359,94,89,5,1,98.84398013,NoArch
13b637ddc3ab9fba51e303cfa0343a496e476d26,0,0,0,0,0,0,0,0,0,0,0,0,0,0,31,3,0,0,0,0,0,0,0,0,0,1,100,NoArch
5302b9a4efdb2b13a17561709459e8a1a55d060e,1,5,6,1,0,0,0,9,19,9,1,1,0,424,16,1,54,55,1,3048,3103,55,20,20,0,1,100,NoArch
35111131c389704b2f5d4062c8ab73582f61ef13,2,9,4,5,0,0,0,15,26,242,2,2,0.779349837,1569,85,4,119,118,1,9782,9727,55,80,80,0,1,100,NoArch
2eaf0fd939f680638e711f66cbdef1f7931b1ed1,1,12,10,2,0,0,0,12,18,11,1,1,0,1630,6,4,81,81,0,13169,13131,38,40,40,0,1,100,NoArch
f239187da8052680bde355efbaa33149d37b4280,3,16,10,6,0,0,0,2,12,1055,1,3,1.447974571,432,16,2,40,40,0,1629,1577,52,19,19,0,1,99.99158816,NoArch
f9bc3e03e52469a387524b5d0d2a6aafd9a9e71d,1,6,0,6,0,0,0,9,13,79,1,1,0,240,86,5,30,29,1,1223,1185,38,21,20,1,0,100,NoArch
d194643b49834a772657b61a90cd1e64aa754282,16,1126,2,1124,5,0,5,9,62,59,2,15,3.012678835,6025,13,0,880,708,172,39653,31068,8585,615,555,60,1,99.87388599,NoArch
dee3a14aaee149d3034191e5ca40fe87bd7e63fa,2,38,16,22,0,0,0,4,10,224,1,2,0.918295834,454,1,0,33,29,4,3782,3631,151,15,12,3,1,100,NoArch
1f17467f735c28df0a7c52ac09ec3e49c99b793a,4,150,1,149,3,0,3,2,3,83,3,4,1.850227769,82,2,0,12,2,10,1214,596,618,7,2,5,1,99.91605104,NoArch
6351e5f4d042b14cd0f6715c36f23d75fcc8e091,9,154,46,108,0,0,0,6,50,193,2,8,2.328561983,3082,3,1,412,395,17,17120,16430,690,252,241,11,1,99.96644014,NoArch
b12a25b0b17f98dace51b2d6e260509d4089e0cd,0,0,0,0,0,0,0,0,0,0,0,0,0,0,0,0,0,0,0,0,0,0,0,0,0,0,100,NoArch
5517d292f917821879d41af515f4ed7331d54ba2,1,0,3,3,0,0,0,4,5,499,1,1,0,108,14,1,11,11,0,533,565,32,7,7,0,1,99.99161074,NoArch
7fc7e9b2bc6c5aeabd6f490376e9e0ae76e07874,3,8,1,7,0,0,0,1,5,40,1,3,1.224394445,406,134,6,33,32,1,2295,2264,31,17,16,1,1,100,NoArch
f2fb1aac26fdde87a800939b4a2016092b4fe9d4,2,35,0,35,0,0,0,3,14,228,1,2,0.512709142,233,0,0,19,17,2,1717,1323,394,11,10,1,1,100,NoArch
acc40625f594576353919323c2b34c43309f18d5,1,2,0,2,0,0,0,2,2,308,1,1,0,233,15,2,22,22,0,1879,1853,26,8,8,0,1,100,NoArch
8932c4f7b57ef5290f48f35c9a8362bd28b0ca42,1,0,5,5,0,0,0,6,12,251,1,1,0,129,135,6,11,12,1,458,472,14,8,9,1,1,100,NoArch
689020f30314477f4578b84bf3805a8d7d653c3f,3,96,0,96,1,0,1,6,28,14,2,3,0.776973436,811,136,6,77,65,12,6608,6085,523,41,36,5,1,99.9832271,NoArch
dbf8c44bdb3019f2ce93d6b1224d9d478c0340fa,9,702,80,622,4,0,4,3,36,19,1,6,2.75962943,1857,137,7,232,182,50,11527,8570,2957,145,109,36,1,98.68894396,NoArch
33436aa359093246f31b53530d8890a4ce07cfcb,9,80,702,622,0,4,4,3,37,0,1,6,2.75962943,2479,138,8,182,232,50,8570,11527,2957,109,145,36,1,98.68894396,NoArch
2c1e25932996cbf47c7cd56d944d1d9103f01c34,1,38,5,33,0,0,0,10,28,46,1,1,0,375,21,0,2,2,0,2740,2498,242,1,1,0,1,100,NoArch
f67da0c7d0831db0b4eba7111c634eb50eaec760,4,133,3,130,2,0,2,2,6,114,1,3,1.685594882,330,22,1,41,29,12,2327,1900,427,23,14,9,1,99.95809236,NoArch
3af6568d316f410184e3d4dcfdbf00a8802b1fb8,7,32,66,34,0,0,0,1,63,25,1,7,2.550115432,2520,139,9,233,240,7,11957,12116,159,154,155,1,1,100,NoArch
b7ee341e14507f2562f8c3a3212daf8686631e05,16,189,46,143,1,0,1,5,64,273,5,15,2.758264605,7166,43,0,847,831,16,49792,49172,620,439,430,9,1,99.85741843,NoArch
844346c3ab100a857b547137aca003c45e523eb9,0,0,0,0,0,0,0,0,0,0,0,0,0,0,17,2,0,0,0,0,0,0,0,0,0,1,100,NoArch
08c35a55b3133ddaead0581c9129e88a869421a1,5,51,16,35,0,0,0,2,63,221,1,3,2.0095248,2863,17,2,343,339,4,12553,12312,241,325,321,4,1,100,NoArch
9a8963d05eb93849e84151a63eecf12afe1017ce,1,1,0,1,0,0,0,14,65,1,1,1,0,492,140,10,55,55,0,3049,3037,12,30,30,0,1,100,NoArch
f41539a9cb5fd619bb0ec0c9af5484f316490303,2,2,2,0,0,0,0,17,26,288,1,1,1,241,0,0,15,15,0,1191,1191,0,10,10,0,1,100,NoArch
e0285800fb5609fcf27b523109e369a8d7d6b27d,15,1185,70,1115,9,0,9,1,23,103,4,7,3.085559616,1767,0,0,347,254,93,19663,11975,7688,87,47,40,1,88.34862385,Arch
cf2ecd77badcaa713ce12d7c9126aa57662d3a3f,0,0,0,0,0,0,0,0,0,0,0,0,0,0,9,0,0,0,0,0,0,0,0,0,0,1,100,NoArch
c7bf2c76876227b30fc030a9a01ac60f9a8d2956,1,7,2,5,0,0,0,14,66,6,1,1,0,493,141,11,55,55,0,3106,3049,57,30,30,0,1,100,NoArch
7aaf47e716a303b5fea5150a5093a849f60ff607,1,1,5,4,0,0,0,8,29,12,1,1,0,324,23,2,44,44,0,1971,1998,27,14,14,0,1,100,NoArch
6d109c6de5078560abab96f96dc2a9bfe9ed8e57,22,170,59,111,0,0,0,9,40,34,1,18,3.762245283,8968,87,4,919,907,12,61154,60408,746,479,472,7,1,90.91015442,Arch
e057a10499729301ebe96d7cd54902b113af1811,5,47,11,36,1,0,1,2,18,119,3,4,1.877684047,1704,142,12,191,191,0,9224,9101,123,102,102,0,1,99.97869621,NoArch
2f95967dfe0b5286bbb3b0f48a2de7cb8fcc7b7c,6,100,64,36,0,0,0,7,30,6,1,6,2.165601163,3042,44,1,258,254,4,21721,21612,109,110,108,2,1,100,NoArch
dfe3b84715e8fecfa96ef615c217f5eaf0da94e8,6,195,52,143,1,0,1,2,85,75,2,5,2.075384258,4229,1,0,523,516,7,23317,22662,655,358,352,6,1,93.40274199,Arch
bb6a19e7d71a91f23e17bf2fe5dcb8ecf4affde2,14,280,81,199,2,0,2,5,11,221,1,9,3.153775357,3522,18,3,254,242,12,26885,25602,1283,147,141,6,1,99.720028,NoArch
fd0f5df26d9bc307a6a5b39089c8263e3b7574d4,3,20,7,13,0,0,0,2,5,701,2,3,1.319521298,188,10,1,18,15,3,864,761,103,7,7,0,1,100,NoArch
a40ac62e0ce7ec807a00803d23ed223d7c607459,9,1005,32,973,4,0,4,15,27,116,1,4,2.869730968,1751,16,3,274,161,113,18009,11988,6021,124,56,68,1,99.86002799,NoArch
187bedf79531e089eb40acf03ca72c2d54400b0e,4,18,17,1,0,0,0,3,17,31,1,3,1.404665333,4499,19,4,302,302,0,32350,32305,45,166,166,0,1,100,NoArch
2d362af00ae61ab76ff45fd83f142d3af4bd0909,1,0,0,0,0,0,0,1,1,0,1,1,0,81,24,3,11,11,0,324,324,0,5,5,0,1,99.96005592,NoArch
90f9b4562abaef955cbff54f539ec867d8708b60,11,158,26,132,0,0,0,3,67,45,2,8,2.996422602,3075,25,4,286,270,16,19561,18820,741,147,141,6,1,97.23324397,Arch
77b0440eb4fdbb01d41aa27b4fa2a8d45a20b293,8,188,76,112,0,0,0,5,31,83,2,7,1.450981183,2119,45,2,247,229,18,12148,11668,480,130,119,11,1,100,NoArch
90529aa55263b5ea6e02277b27017e5178b0586c,1,3,0,3,0,0,0,16,26,59,1,1,0,575,4,2,79,78,1,3692,3650,42,35,35,0,1,100,NoArch
6b93ccca9b26b47099e9791d4363e0616e77e408,4,8,91,83,0,1,1,3,30,160,1,3,1.540298037,838,26,5,67,74,7,4451,4755,304,41,48,7,1,99.97683577,NoArch
bc511edc85261c6332b5438591249f76dd03d447,5,66,8,58,0,0,0,5,43,80,1,5,1.594770785,1819,143,11,103,98,5,11391,11148,243,66,64,2,1,100,NoArch
4f217fe718b0b4e9656c2a45f7b89cb5df15a4f2,2,6,6,0,0,0,0,7,65,23,2,2,0.650022422,2572,88,5,318,318,0,10679,10679,0,312,312,0,1,100,NoArch
9720820975be61c9a211a24785a28cf0e8b0d7b3,2,38,7,31,0,0,0,11,16,301,1,2,0.353359335,687,7,2,70,69,1,4335,4128,207,37,37,0,1,100,NoArch
93fd3517e319473fed74e62bf09e41e4348c843c,0,0,0,0,0,0,0,0,0,0,0,0,0,0,89,4,0,0,0,0,0,0,0,0,0,1,100,NoArch
0e8461e9abc97537954a2c1dd716aed53e52dc62,2,6,6,0,0,0,0,28,66,48,1,1,1,2675,17,4,322,322,0,11143,11143,0,316,316,0,1,100,NoArch
994922a1593824744f93fd1408fcf1807cf4ebc1,2,4,3,1,0,0,0,5,8,48,1,2,0.863120569,644,8,2,41,41,0,5494,5494,0,18,18,0,1,100,NoArch
c2f9094b493ed28a63bdaed10ce4349261c3cea6,3,87,3,84,1,0,1,2,5,76,2,2,0.363485129,1008,144,11,198,189,9,6169,5728,441,19,15,4,1,99.97683577,NoArch
0bb6d8ff80cd49dd05d2cfa427d36f2c97dd77a8,2,2,2,0,0,0,0,4,7,225,2,2,1,397,5,3,29,29,0,2600,2600,0,10,10,0,1,100,NoArch
a14d1040b909658920a8c95a9b9914d0806ca6fd,0,0,0,0,0,0,0,0,0,0,0,0,0,0,9,3,0,0,0,0,0,0,0,0,0,1,100,NoArch
a0dae41409a4f2d509aae1b16a4b509ec774c454,1,0,4,4,0,0,0,10,16,14,1,1,0,337,18,5,46,47,1,2668,2721,53,11,11,0,1,100,NoArch
3c4319729c7b5ae1ae39e46bd0ac3451fa1df032,1,2,2,0,0,0,0,2,2,1228,1,1,0,77,0,0,3,3,0,362,362,0,2,2,0,0,100,NoArch
53d2d6ae241f86aaf337abc50d3f00232fa87d00,5,59,23,36,0,0,0,9,20,28,2,4,1.735517592,2721,90,5,226,229,3,20527,20347,180,114,112,2,1,100,NoArch
38b6934352abd27b98332cce005f18102b388679,4,61,19,42,0,0,0,18,67,99,2,3,1.609736621,3884,13,0,482,479,3,19021,18708,313,394,391,3,1,100,NoArch
bff8769ed438aae36bbfc1ebefca63889418df18,5,80,23,57,0,0,0,2,19,96,1,3,1.318100305,2204,91,5,168,164,4,15806,15394,412,89,88,1,1,100,NoArch
6f5e661010a85f3426131111baff962a6d6ba91e,2,9,1,8,0,0,0,3,68,14,1,2,0.721928095,597,145,11,60,59,1,3729,3665,64,33,33,0,1,100,NoArch
cbcbec4d3831d6236a2dbf1f17d50b447800994a,0,0,0,0,0,0,0,0,0,0,0,0,0,0,1,0,0,0,0,0,0,0,0,0,0,0,100,NoArch
04eb5fdc651bce3b34f17c1828879b18f1b1b6f8,14,37,24,13,0,0,0,5,37,33,1,10,3.714612251,7893,92,5,643,643,0,54144,54037,107,380,380,0,1,100,NoArch
ce7d2333078e4e1f16de1bce6d448c5eef1e4111,9,23,19,4,0,0,0,5,68,161,2,7,2.905520471,5507,93,6,494,494,0,33210,33176,34,381,380,1,1,100,NoArch
aec5d11da2e8a025fb6c8659a648f9e2d36990d6,1,3,1,2,0,0,0,11,29,36,1,1,0,408,0,0,3,2,1,2754,2740,14,1,1,0,0,100,NoArch
4d884bdaa9affae9ce920c83f799ff9e1be99861,0,0,0,0,0,0,0,0,0,0,0,0,0,0,18,1,0,0,0,0,0,0,0,0,0,0,100,NoArch
826414cff5adb5006066bdedb843ed864709b048,1,2,0,2,0,0,0,13,13,145,1,1,0,96,0,0,7,7,0,345,338,7,5,5,0,0,100,NoArch
1ee12cfa6fa8d18546af11a7ae03cb0e4969460f,10,731,3,728,7,0,7,3,8,82,3,8,2.646510341,531,19,0,111,50,61,6698,2644,4054,76,34,42,1,99.71134973,NoArch
f715cf607f0692e6500a295a0ab5604f3979df3a,4,104,28,76,0,0,0,4,10,1313,1,3,1.356314983,699,10,3,63,58,5,4260,3817,443,45,43,2,1,99.97697444,NoArch
2d3f2a3275ba615245fcabda96b8282cb86940ad,3,24,4,20,0,0,0,7,69,47,2,3,0.946372936,3061,94,7,350,345,5,14679,14598,81,330,328,2,1,100,NoArch
71a2ae0fd6163d3108c6557ce6295f649246adcb,4,25,11,14,0,0,0,6,44,29,1,4,1.563027603,1766,146,9,113,110,3,10380,10298,82,83,81,2,1,100,NoArch
8772cec4bdfe71d4dfcc1b92cb39075c71a363b9,3,16,7,9,0,0,0,2,24,33,1,3,1.491013871,1430,147,9,173,172,1,8203,8165,38,89,88,1,1,100,NoArch
24def0b30dabd3c447fbfbde636868f1913e9074,15,211,90,121,0,0,0,18,69,302,5,9,2.426960448,6083,20,1,666,649,17,42639,41930,709,303,292,11,1,92.13277574,Arch
4e067ca581975596df04a30296a537fe1905bbfe,5,156,32,124,0,0,0,6,38,69,1,4,1.813627173,2684,24,0,237,225,12,16748,15722,1026,122,115,7,1,100,NoArch
7a00f867aef79f2c0f411f0f9ff22572fb61093e,2,6,3,3,0,0,0,4,35,78,2,2,0.918295834,937,148,8,104,103,1,4890,4880,10,45,45,0,1,100,NoArch
bf008762dfa3215823d47184e6f4e6d4f7bd03fc,5,77,39,38,0,0,0,3,27,61,2,5,1.701067356,2410,149,9,239,232,7,14099,13850,249,107,106,1,1,100,NoArch
eba354e922e5bf28f961e5ac7905b110315d71cf,6,148,43,105,0,0,0,4,6,113,2,4,1.483777325,1372,20,2,92,85,7,10983,10062,921,61,58,3,1,100,NoArch
459b34240bc041be0fba7312f096980da024a5d9,26,423,123,300,1,0,1,8,33,126,2,15,4.131036104,10471,11,4,917,894,23,68189,66822,1367,480,463,17,1,99.97897982,NoArch
c8617d93904bbc17088bc7e8727b04e0a2be3395,6,84,56,28,0,0,0,14,22,398,2,6,2.278915931,2344,12,5,278,276,2,18677,18401,276,163,161,2,1,100,NoArch
0230d40b74ee0bf99ff1d3d06ad1a7db26bef017,3,59,18,41,0,0,0,4,34,38,1,3,0.650838804,1488,13,6,103,98,5,9926,9758,168,40,39,1,1,100,NoArch
3dc626243742613dcef5bf56acf57c47de0262db,7,22,8,14,0,0,0,4,9,131,3,3,2.708612699,1756,21,2,154,154,0,11005,10854,151,94,94,0,1,100,NoArch
6cc97cc0c9a7f904b8e69f29c5c875f260758f39,0,0,0,0,0,0,0,0,0,0,0,0,0,0,0,0,0,0,0,0,0,0,0,0,0,0,100,NoArch
f4b974ac7bde019e5b1ff0813297994cfbcfceff,1,17,4,13,0,0,0,2,2,293,1,1,0,137,0,0,11,10,1,1057,982,75,2,2,0,1,99.97199272,NoArch
ae0c67d9fc7c75dca46655135fd7ab63832aebb2,7,337,73,264,1,0,1,1,51,145,3,5,2.067761662,2172,87,0,265,244,21,13865,11779,2086,145,127,18,1,99.98600616,NoArch
1a5484d2db1dbf7b6f2b8d87b2fb7dba8ad455aa,0,0,0,0,0,0,0,0,0,0,0,0,0,0,10,0,0,0,0,0,0,0,0,0,0,0,100,NoArch
305d160081d29c26a247cc7a5d085e1fb370820a,1,1,3,2,0,0,0,5,5,1661,1,1,0,77,1,1,10,10,0,294,303,9,8,8,0,0,100,NoArch
74b59a44ec4047a53288d1d7cb69269b35c82bc6,0,0,0,0,0,0,0,0,0,0,0,0,0,0,36,0,0,0,0,0,0,0,0,0,0,1,100,NoArch
0411f73c7d33e36bd8d12e7eae948518704a9548,4,57,5,52,0,0,0,5,65,47,1,3,1.756492308,2535,150,9,136,132,4,13866,13583,283,80,77,3,1,100,NoArch
520538b15dd83af47c32113aeebba96149493ffa,2,7,4,3,0,0,0,5,46,10,1,2,0.945660305,1557,151,10,128,127,1,9291,9268,23,47,47,0,1,100,NoArch
887787e8b9b786f20f5fe3fb6d61c820f49aa4cb,3,51,5,46,0,0,0,15,21,141,1,2,1.313992636,1560,0,0,99,94,5,10834,10496,338,40,39,1,1,100,NoArch
2533a9cc17dd491b620b42df1a7b17350a1e69a1,1,12,12,0,0,0,0,9,14,484,1,1,0,346,19,1,43,43,0,2225,2225,0,16,16,0,0,100,NoArch
8281cbf7624c3a4eb90bf58671daf76843d00819,3,6,0,6,0,0,0,3,10,53,1,3,1.584962501,587,152,11,40,40,0,2348,2297,51,27,27,0,1,100,NoArch
02f7ca2b0518b0a61d539e9f0781b70835aea287,1,0,4,4,0,0,0,2,2,58,1,1,0,58,74,0,1,2,1,226,257,31,1,1,0,1,100,NoArch
a2c91a7a9b582cc25dbdf27534dd71265a23a39c,2,94,11,83,0,0,0,18,46,12,1,2,0.951762676,1998,14,1,192,185,7,15781,15121,660,113,111,2,1,100,NoArch
7f3b89fad7dd8238bd0c90585e4b7f914d23093e,2,25,3,22,0,0,0,3,8,10,1,2,0.749595257,657,14,7,47,46,1,6050,5845,205,19,19,0,1,100,NoArch
89452063b4fcc6d10634c1d3eda8ba736ac0dc44,1,1,1,0,0,0,0,7,10,0,1,1,0,281,21,3,33,33,0,2057,2059,2,12,12,0,0,100,NoArch
fc9ca6a07aab51db4bc36ade71c6c661f9e4ed42,16,118,51,67,0,0,0,5,70,27,5,15,2.758499875,7338,95,8,873,867,6,50901,50609,292,443,439,4,1,100,NoArch
fe57e9beea54ac54ac0c0d204b7338deb7f36369,1,2,2,0,0,0,0,16,27,61,1,1,0,1133,22,4,98,98,0,5960,5959,1,64,64,0,1,100,NoArch
3bdab01a498d605faede833af2d88cd8ec9237a0,4,124,57,67,0,0,0,8,70,205,1,4,1.325429199,3155,2,1,375,374,1,16741,16426,315,331,326,5,1,100,NoArch
772af935d531c627100136fa2ff90ef826b4b536,7,102,27,75,0,0,0,19,47,50,2,4,2.423377107,4045,18,0,407,399,8,28788,28270,518,240,238,2,1,99.97902391,NoArch
0d1e7ecdab89026b52c5e26c4374690f77b4737c,1,1,1,0,0,0,0,15,21,38,1,1,0,263,2,0,28,28,0,1722,1722,0,12,12,0,0,100,NoArch
e22150fe15da2985b20077d2e0734fcd46b85a6f,7,132,28,104,0,0,0,5,71,335,1,5,2.083249964,5691,23,5,570,563,7,34572,33677,895,456,452,4,1,100,NoArch
6aa710eae01382d0e8cd3bb0f71b5ee3d5105b11,0,0,0,0,0,0,0,0,0,0,0,0,0,0,19,1,0,0,0,0,0,0,0,0,0,0,100,NoArch
c88c2af8bfa37ee74259cb2ccbd79a74ebb1c722,1,8,5,3,0,0,0,16,28,1,1,1,0,1133,24,6,99,98,1,5981,5960,21,64,64,0,1,100,NoArch
9de995134888b6e36fac1f50722b4d3577d00ab3,4,101,32,69,0,0,0,9,17,45,2,4,1.726335813,1267,19,3,162,157,5,8314,8151,163,63,62,1,1,100,NoArch
9ed28b1570d57adc42e6ee1de6edd7d49fd70304,0,0,0,0,0,0,0,0,0,0,0,0,0,0,15,2,0,0,0,0,0,0,0,0,0,1,100,NoArch
ca9bfa2a4000575dbaa379c91898786f040a9917,25,1227,91,1136,9,0,9,15,72,106,4,18,4.035217836,5068,20,2,670,579,91,33520,26404,7116,515,463,52,1,92.10844414,Arch
969a5bf11e1c1e2f65b33cd75f36da76931332d0,0,0,0,0,0,0,0,0,0,0,0,0,0,0,20,2,0,0,0,0,0,0,0,0,0,0,100,NoArch
fbff0799b999c5cc49d5a36fd2538f9bf5c6c60d,4,66,7,59,0,0,0,1,6,81,1,2,0.991272767,632,11,1,59,54,5,3756,3286,470,37,35,2,1,99.81855296,NoArch
18cf59507fe32971da79c0e7c039730e57c5d207,2,14,5,9,0,0,0,2,2,1254,1,1,0.998000884,161,3,2,9,9,0,924,884,40,8,8,0,1,100,NoArch
5078d29eb429d7eca46c3d5c3aa72d94e088d43e,4,81,7,74,1,0,1,1,3,53,1,2,1.084806355,256,75,1,28,25,3,1725,1290,435,10,7,3,1,99.92032779,NoArch
0cf2f103e07483f24b904b45f348bcc041e0c7ad,0,0,0,0,0,0,0,0,0,0,0,0,0,0,6,2,0,0,0,0,0,0,0,0,0,1,100,NoArch
323be33f185fbb4d3dd51acd5bcc8ad9a6fc3fe5,3,0,6,6,0,0,0,3,11,6,1,3,1.584962501,593,153,10,40,40,0,2297,2348,51,27,27,0,1,100,NoArch
0bb506fa00de5c195c8e409c13091c2e264472d0,2,41,2,39,0,0,0,4,24,38,2,2,0.968164732,670,154,11,60,57,3,4515,4134,381,49,49,0,1,99.81842941,NoArch
a234833f0a9d6fb772d6579c576c70de160befbc,0,0,0,0,0,0,0,0,0,0,0,0,0,0,7,3,0,0,0,0,0,0,0,0,0,1,100,NoArch
9af219b7c10f44756afabcc9bcd11cba552aa12c,0,0,0,0,0,0,0,0,0,0,0,0,0,0,25,5,0,0,0,0,0,0,0,0,0,1,100,NoArch
90f2ea2f12cde2104bf84b1254176673a82f4b55,4,147,118,29,0,0,0,1,4,108,1,3,1.608539034,744,12,2,100,92,8,3304,3459,155,55,50,5,1,99.9547204,NoArch
973f78f5caa4b9483bef3b27e98bafcef0f2f136,7,81,31,50,1,0,1,2,7,521,2,5,2.400799385,948,15,8,83,83,0,6647,6393,254,50,50,0,1,99.8754388,NoArch
60b23b979739601f413cdc30da1eae0c18fcb5e6,2,43,40,3,0,0,0,2,3,35,1,2,0.163860513,451,4,3,69,69,0,4288,4307,19,11,11,0,1,100,NoArch
ff94d92980816adc5a2feebe062835e083d8b8c6,3,63,57,6,0,0,0,5,20,8,1,3,1.128759989,3292,26,6,263,264,1,25066,24992,74,138,138,0,1,100,NoArch
435ea1543c034194d7ca0b589b7b043fc49c07ac,7,134,188,54,0,1,1,3,86,38,2,5,2.596842092,5716,96,8,601,603,2,34605,34505,100,450,450,0,1,96.03551518,Arch
7286b56d305481a749f871d28bf170d6b4fff9e6,0,0,0,0,0,0,0,0,0,0,0,0,0,0,13,3,0,0,0,0,0,0,0,0,0,1,100,NoArch
51297736ca7f72076376d4d245b3c161bdfe57b2,1,30,29,1,0,0,0,11,15,125,1,1,0,299,5,4,41,40,1,1637,1598,39,22,22,0,1,100,NoArch
bef373fa1d86354fef0844e10e43a79e30cf70fd,1,0,3,3,0,0,0,4,5,0,1,1,0,357,21,3,17,17,0,2919,2950,31,9,9,0,0,100,NoArch
abc0175cf7a3577ac5078f6a4cd43569105ccf7e,0,0,0,0,0,0,0,0,0,0,0,0,0,0,14,4,0,0,0,0,0,0,0,0,0,1,100,NoArch
83f8ed2ae3ba7fb20813cbb8768deae6244b020c,13,1520,1,1519,12,0,12,1,7,32,2,5,3.47772034,123,15,5,109,10,99,9543,571,8972,74,7,67,1,99.73557465,NoArch
a9bd20804baf65aec20be7f4fba500380c03bfb0,9,125,43,82,0,0,0,14,42,11,2,7,2.88057999,8314,97,9,848,838,10,59547,59129,418,466,460,6,1,100,NoArch
88067f57a23575aae3c371a7c7871e4207ca3bea,1,2,2,0,0,0,0,30,74,1,1,1,0,2217,21,3,299,299,0,9361,9361,0,293,293,0,1,100,NoArch
a2eb2b0b0af03be261d9d456c8ad75b3695793f7,3,29,3,26,0,0,0,10,25,22,2,3,0.868392729,1334,155,12,137,134,3,9385,9212,173,58,57,1,1,100,NoArch
264e1ce63c24b09d891068aca1fc40b815a958f7,2,0,6,6,0,0,0,2,2,0,1,2,0.918295834,204,0,0,9,9,0,1148,1229,81,8,8,0,1,100,NoArch
b972aa5bf239657d527ba1d078755dbe7e20e657,1,0,1,1,0,0,0,8,12,46,1,1,0,129,27,7,8,8,0,1090,1095,5,5,5,0,1,100,NoArch
7bb90e8cafaf1dfd5000ff740441161dd43a7dd5,4,49,74,25,0,0,0,13,43,40,1,4,1.97866449,1665,98,10,221,226,5,12162,12215,53,91,94,3,1,100,NoArch
f692078d32044dfa2f3ac3029a7420abc4cdb89a,3,76,7,69,0,0,0,5,11,522,2,3,1.294822755,1433,99,11,109,99,10,9891,9478,413,79,73,6,1,100,NoArch
6a0f0798660bd6efedf1dc51adb397fb704aa5de,2,51,7,44,0,0,0,19,60,12,1,2,0.91244118,2614,100,12,272,267,5,19037,18810,227,135,133,2,1,100,NoArch
8e1379384a35b816ba27e7de0573f740380cb819,2,121,2,119,0,0,0,4,13,22,1,2,0.281193796,900,101,13,47,38,9,7553,6551,1002,20,14,6,1,100,NoArch
e0125a7911d77afd4a82a49caaccaa3c10df0377,13,775,7,768,5,0,5,4,75,144,3,10,2.422902291,3618,25,1,474,422,52,20427,16272,4155,389,349,40,1,98.99944924,NoArch
6f5d8d04cd4b6689335bb80738946e1a914b43b0,18,150,103,47,0,0,0,20,87,87,6,11,3.432178659,7990,6,5,828,828,0,52338,52206,132,387,385,2,1,100,NoArch
8340ccb503962876cf83de40949264836f88c04d,17,116,80,36,0,0,0,15,28,50,2,6,3.79973608,5772,102,14,453,451,2,38082,37692,390,233,231,2,1,96.86293914,Arch
38585e4e57c86e0846b5561c4d1750676d88e5f4,0,0,0,0,0,0,0,0,0,0,0,0,0,0,1,1,0,0,0,0,0,0,0,0,0,1,100,NoArch
f5da9b50faf68aee56a8b198445201a95f5d87e7,0,0,0,0,0,0,0,0,0,0,0,0,0,0,156,12,0,0,0,0,0,0,0,0,0,1,100,NoArch
e554c7f468950a47df49fd3e951933138801d65a,2,24,1,23,0,0,0,11,22,18,2,2,0.989587521,547,2,0,65,60,5,3971,3800,171,26,25,1,1,100,NoArch
e9efbdb63c95d2971ac67576783e122a6e271738,2,1,4,3,0,0,0,15,72,7,1,2,0.970950594,1248,157,13,72,72,0,6652,6687,35,39,39,0,1,100,NoArch
3d75aca40d2bdbb91bfdc06352453ae84d9bf530,4,62,46,16,0,0,0,10,38,476,2,3,1.219269468,973,16,8,105,105,0,7403,7320,83,35,35,0,1,100,NoArch
5755ff25a49aa495e418acde7ef8d246e16b4973,12,956,500,456,3,1,4,10,34,4,2,12,2.374539774,3276,7,6,408,388,20,23228,21848,1380,222,208,14,1,95.7956778,Arch
a88691fed38cc7b8a1f26bfcbb9a7504a0acdd8d,1,3,4,1,0,0,0,5,6,6,1,1,0,391,103,14,32,32,0,2731,2745,14,11,11,0,0,100,NoArch
f8e0176eb031f2d59774af9b1d512844f1003231,8,208,15,193,1,0,1,14,41,18,2,7,2.09065136,3415,104,14,383,369,14,22053,20849,1204,248,239,9,1,99.95578743,NoArch
d1e83e4ba0b881f9410f0ae9f3799c967b6891cb,33,510,121,389,1,0,1,15,76,143,4,18,4.119841272,16425,22,4,1420,1380,40,116554,113967,2587,887,870,17,1,99.90278392,NoArch
445208a0d20b457daeeb5f70995302c92dd19f31,3,205,59,146,0,0,0,12,19,861,1,2,0.772931068,400,17,9,54,40,14,3789,2530,1259,20,17,3,1,100,NoArch
8402cac407ba9ae3288c317a9493db3613f1938b,0,0,0,0,0,0,0,0,0,0,0,0,0,0,0,0,0,0,0,0,0,0,0,0,0,1,100,NoArch
9028e6e1e43dd9322509d6549f2a71d20b3e392b,3,8,10,2,0,0,0,2,3,223,2,2,1.546631615,127,16,6,7,7,0,355,337,18,6,6,0,1,99.97348887,NoArch
257a6a74569cdb500b06c53b92d05f6f5833aa31,1,3,3,0,0,0,0,4,6,52,1,1,0,456,1,0,62,62,0,2208,2205,3,40,40,0,1,100,NoArch
9c059ef8e574616ceac5595204273244e37fd6a5,1,10,13,3,0,0,0,21,42,0,1,1,0,1174,105,15,119,122,3,6309,6329,20,65,65,0,1,100,NoArch
3a8d64e584295dd3979a2d893497d90070d15621,0,0,0,0,0,0,0,0,0,0,0,0,0,0,76,2,0,0,0,0,0,0,0,0,0,1,100,NoArch
2c7656c35faf625184f0356ca0693be6a70206c6,16,208,154,54,0,0,0,19,44,17,2,14,3.298479812,11706,18,10,974,974,0,80646,79988,658,491,490,1,2,100,NoArch
780a2ac5b208b06f53ee64186b5392ebc37eadbc,9,600,13,587,3,0,3,1,19,16,1,7,1.681590357,1932,20,2,320,211,109,17149,11975,5174,122,103,19,1,99.93817893,NoArch
fdddb2f23428cac491f1c774f2c75f85ad6bd9d6,0,0,0,0,0,0,0,0,0,0,0,0,0,0,2,0,0,0,0,0,0,0,0,0,0,0,100,NoArch
6acd432ca2fcefc249ef007e1436bf260d25bcf9,1,1,1,0,0,0,0,23,44,5,1,1,0,1171,0,0,119,119,0,6310,6310,0,65,65,0,0,100,NoArch
e8de211f5331c47b81b633992e33c9387098832d,1,12,16,4,0,0,0,2,3,248,1,1,0,124,106,16,16,23,7,796,819,23,2,2,0,0,100,NoArch
4dfdd45784c90250e74e0c0477176b2b85cfaac6,0,0,0,0,0,0,0,0,0,0,0,0,0,0,107,17,0,0,0,0,0,0,0,0,0,0,100,NoArch
adb330363e2a57b58889b4961ca9a08dc80ac317,0,0,0,0,0,0,0,0,0,0,0,0,0,0,158,13,0,0,0,0,0,0,0,0,0,0,100,NoArch
92dbb412cc74e896b588963b2a79c6019ddc0632,0,0,0,0,0,0,0,0,0,0,0,0,0,0,3,1,0,0,0,0,0,0,0,0,0,0,100,NoArch
69d14353bcc20c07d53b7835940c4117cfbf5110,1,1,1,0,0,0,0,18,33,41,1,1,0,578,22,3,54,54,0,2807,2807,0,34,34,0,0,100,NoArch
63a7df79e5e97159b39ae4354462b52d18899f22,0,0,0,0,0,0,0,0,0,0,0,0,0,0,23,4,0,0,0,0,0,0,0,0,0,1,100,NoArch
c38ebbc2353fccf9ca91b21307d316bae27e9074,2,4,0,4,0,0,0,3,3,132,1,2,1,206,23,5,7,7,0,1205,1165,40,4,4,0,1,100,NoArch
df70e32ae00f124d6de325ebf1fd3ccf434ed00a,1,2,2,0,0,0,0,30,77,22,1,1,0,2251,8,6,307,307,0,9503,9503,0,298,298,0,1,100,NoArch
7df81a6b6ff5405e9da93289789ec84a280cf8d7,1,3,3,0,0,0,0,5,7,22,1,1,0,456,24,6,62,62,0,2205,2208,3,40,40,0,1,100,NoArch
9d7f681ca6d3d8c244854040298569f54ba701b8,2,19,17,2,0,0,0,12,13,24,1,2,0.581321499,404,108,13,38,37,1,2333,2292,41,22,22,0,1,100,NoArch
7d2c2489025fe5b183367b4f4dfbf64804d8c33b,4,27,6,21,0,0,0,6,78,353,1,3,1.919776003,3273,11,0,360,358,2,15582,15475,107,351,349,2,1,100,NoArch
1ee35c484b9e4eefb033086c5e0388afac70e642,1,1,1,0,0,0,0,2,2,21,1,1,0,430,9,7,92,92,0,4499,4499,0,9,9,0,0,100,NoArch
3e2116e69fb33009ba3336720f2c7d8d00909232,0,0,0,0,0,0,0,0,0,0,0,0,0,0,0,0,0,0,0,0,0,0,0,0,0,0,100,NoArch
318818be44d065f1be523f7aa9eb949e09859cbb,8,91,13,78,0,0,0,8,79,11,1,7,2.248905591,7290,17,7,753,746,7,40835,40439,396,517,512,5,1,100,NoArch
6c79a68ad91bac8f3bb0e4a97915e6ede90cfe6a,7,34,40,6,0,0,0,4,73,95,1,5,2.439530438,2041,159,9,172,175,3,11259,11204,55,101,102,1,1,99.99117543,NoArch
fe2aae4cea9617cbb469f7b4c6aa072d4c2f3f55,2,22,11,11,0,0,0,2,9,0,1,1,0.532835063,364,160,10,37,36,1,1865,1842,23,19,18,1,0,100,NoArch
2a4e7186883eb97eca7a5072844f47c77fbf1ef4,5,25,5,20,0,0,0,15,74,20,1,4,1.952389217,1213,161,11,126,125,1,6713,6664,49,66,65,1,1,100,NoArch
1bf13d1a0f15e64433f915b32066caa8b7d76174,0,0,0,0,0,0,0,0,0,0,0,0,0,0,8,2,0,0,0,0,0,0,0,0,0,0,100,NoArch
7de5d1760191128c86ef40ac2f9cb57e87328e3e,8,221,28,193,0,0,0,2,25,50,2,6,1.629449128,3081,109,14,262,245,17,21717,20136,1581,158,155,3,1,92.96437556,Arch
008df11e196d0ee81aa22cdd64bd27ca11d121dd,2,43,1,42,1,0,1,4,5,158,1,2,0.266764988,90,10,8,3,0,3,362,293,69,2,0,2,1,99.98497822,NoArch
342acbee33b0f76f7b3a3b328e2e988cc5fdef8f,1,0,3,3,0,0,0,17,28,33,1,1,0,622,9,3,83,84,1,3842,3884,42,37,37,0,1,100,NoArch
a49e5ac7160a5937ebfe2f72deb36dc0ab119f2e,2,5,5,0,0,0,0,3,4,703,1,2,0.721928095,933,19,5,123,123,0,5574,5574,0,60,60,0,2,100,NoArch
474af05eb50af3943d4eedad9bafdf188d67f273,1,6,15,9,0,0,0,13,23,128,1,1,0,243,16,2,30,29,1,1299,1320,21,6,6,0,1,100,NoArch
31947a09a699f59578fe99c5834e171ab5f82280,1,5,1,4,0,0,0,4,7,51,1,1,0,823,77,3,44,44,0,6889,6873,16,28,28,0,0,100,NoArch
7034d1a1be7ecefc346aea95a9ff30bdf758204a,2,2,2,0,0,0,0,7,22,11,2,2,1,1181,88,1,59,59,0,7705,7705,0,42,42,0,1,100,NoArch
b88d4beb23a5ba48fbe642d1f83e55a332b7ce5d,7,169,62,107,0,0,0,1,7,118,1,4,1.96650748,1240,18,8,135,118,17,7035,6331,704,68,63,5,1,100,NoArch
e131507d4672316b6a0f2b2f3f63d8ad34e49b85,8,117,6,111,0,0,0,14,46,10,2,7,1.649511991,5238,110,15,513,506,7,34716,34099,617,236,232,4,1,100,NoArch
148e069f31f9b2166c3833a4103deeb1cc7e43b3,3,10,10,0,0,0,0,6,6,626,2,3,1.076297626,858,0,0,75,75,0,5673,5673,0,38,38,0,1,100,NoArch
40879bca148932c9ad5a13e761cb34f99bc68932,1,0,3,3,0,0,0,40,88,25,1,1,0,828,89,2,88,89,1,5089,5112,23,23,23,0,1,100,NoArch
fba2dd17a38c937fa8e9a4f482f3ec0a2594e8fb,8,9,204,195,0,2,2,1,75,62,1,5,2.053584659,1454,162,8,117,127,10,7206,8179,973,61,69,8,1,98.85048835,NoArch
9dbb7bc88f4c9a14dfb862e8303e1c06a2894220,0,0,0,0,0,0,0,0,0,0,0,0,0,0,4,2,0,0,0,0,0,0,0,0,0,0,100,NoArch
cc3896be2a023f8819883d745178503286ac2ab1,0,0,0,0,0,0,0,0,0,0,0,0,0,0,5,3,0,0,0,0,0,0,0,0,0,0,100,NoArch
eca16932884d51f01ff33d9cd4c9d54cb20d7726,1,1,1,0,0,0,0,23,44,3,1,1,0,1171,0,0,119,119,0,6310,6310,0,65,65,0,0,100,NoArch
52aae36b53e22bd7dab8c024ca64f40a1ade13be,1,12,16,4,0,0,0,2,3,247,1,1,0,124,106,16,16,23,7,796,819,23,2,2,0,0,100,NoArch
38e75ea80681111f0b5cac753d738ce7a39bf6ac,0,0,0,0,0,0,0,0,0,0,0,0,0,0,107,17,0,0,0,0,0,0,0,0,0,0,100,NoArch
6acd432ca2fcefc249ef007e1436bf260d25bcf9,1,16,12,4,0,0,0,2,2,620,1,1,0,120,0,0,23,16,7,819,796,23,2,2,0,0,100,NoArch
536af4b954abaa0d92a313bd5827173a232c6700,0,0,0,0,0,0,0,0,0,0,0,0,0,0,158,13,0,0,0,0,0,0,0,0,0,0,100,NoArch
3433f00cb5366fa190a7b2d5254255041a705deb,1,1,1,0,0,0,0,18,33,28,1,1,0,578,22,4,54,54,0,2807,2807,0,34,34,0,0,100,NoArch
a398aad1fcbd5ff36eb7bc750fcc418d78b3a97e,0,0,0,0,0,0,0,0,0,0,0,0,0,0,23,5,0,0,0,0,0,0,0,0,0,1,100,NoArch
ea009b55a385564f76beb99468f363edd3c4828a,2,4,0,4,0,0,0,3,3,121,1,2,1,206,23,5,7,7,0,1205,1165,40,4,4,0,1,100,NoArch
24380c20606d63c7c129cb45a73f786f223e7d39,1,2,2,0,0,0,0,30,77,12,1,1,0,2251,8,6,307,307,0,9503,9503,0,298,298,0,1,100,NoArch
9b254b6fc5779b6105b2fa9aeff5ad5b79407f84,1,3,3,0,0,0,0,5,7,12,1,1,0,456,24,6,62,62,0,2205,2208,3,40,40,0,1,100,NoArch
f4c25ba3fd11e2da1adcf2e089969a0b7f3dc62e,2,19,17,2,0,0,0,12,13,16,1,2,0.581321499,404,108,14,38,37,1,2333,2292,41,22,22,0,1,100,NoArch
5284730175df4637eee43b179c774606b07a10a9,4,27,6,21,0,0,0,6,78,348,1,3,1.919776003,3273,11,0,360,358,2,15582,15475,107,351,349,2,1,100,NoArch
772f5ca24ee76c5c3676a9136fd994f7cd55a0e3,1,1,1,0,0,0,0,2,2,14,1,1,0,430,9,7,92,92,0,4499,4499,0,9,9,0,0,100,NoArch
61a03bc072c8d446a7334fdf7a284fca0a91f8c0,0,0,0,0,0,0,0,0,0,0,0,0,0,0,0,0,0,0,0,0,0,0,0,0,0,0,100,NoArch
91d2e61433e74abb44cb4d0ae236ee8f4a94e1f8,8,91,13,78,0,0,0,8,79,11,1,7,2.248905591,7290,17,7,753,746,7,40835,40439,396,517,512,5,1,100,NoArch
934fe54cc57b508875383cd807735b1323fef754,7,34,40,6,0,0,0,4,73,90,1,5,2.439530438,2041,159,11,172,175,3,11259,11204,55,101,102,1,1,99.99117543,NoArch
f74b3d12aa89a96daafe43c69d37d816b9f4018b,2,22,11,11,0,0,0,2,9,0,1,1,0.532835063,364,160,12,37,36,1,1865,1842,23,19,18,1,0,100,NoArch
0699521f83eab843279ff7d78ac2b92fc80ad79b,5,25,5,20,0,0,0,15,74,19,1,4,1.952389217,1213,161,12,126,125,1,6713,6664,49,66,65,1,1,100,NoArch
ca427240c026bc6ba6e19b9b8b0a069a6330147a,0,0,0,0,0,0,0,0,0,0,0,0,0,0,8,2,0,0,0,0,0,0,0,0,0,0,100,NoArch
e483f7c776ed53015d08b78fc33729892dc2143c,8,221,28,193,0,0,0,2,25,49,2,6,1.629449128,3080,109,14,262,245,17,21717,20136,1581,158,155,3,1,92.96437556,Arch
bed7f9897a9127130c3d241df7634d44aa12167b,2,43,1,42,1,0,1,4,5,157,1,2,0.266764988,90,10,8,3,0,3,362,293,69,2,0,2,1,99.98497822,NoArch
2f96f4300b37207703b477979f2461bdd294ccf9,1,0,3,3,0,0,0,17,28,30,1,1,0,622,9,3,83,84,1,3842,3884,42,37,37,0,1,100,NoArch
383d5edc169b79c4022f81a1580ab1bc2afebc30,2,5,5,0,0,0,0,3,4,701,1,2,0.721928095,933,19,8,123,123,0,5574,5574,0,60,60,0,2,100,NoArch
5616830ae18ab3cbe1592d4e463a940342d25edc,1,6,15,9,0,0,0,13,23,127,1,1,0,243,16,2,30,29,1,1299,1320,21,6,6,0,1,100,NoArch
a799fae31610b2c38ca5aa52c87fa92363a41a70,1,5,1,4,0,0,0,4,7,50,1,1,0,824,77,3,44,44,0,6889,6873,16,28,28,0,0,100,NoArch
0fd6b2d71e50a3b09336b74074a2f5117ba57f5c,2,2,2,0,0,0,0,7,22,11,2,2,1,1181,88,1,59,59,0,7705,7705,0,42,42,0,1,100,NoArch
94f45e928c917c87934badb2bb4bc8c767a14e3a,7,169,62,107,0,0,0,1,7,119,1,4,1.96650748,1240,18,8,135,118,17,7035,6331,704,68,63,5,1,100,NoArch
1d4fb827e73b2ae510f0e2c6510a448c0b5bd5b3,8,117,6,111,0,0,0,14,46,9,2,7,1.649511991,5238,110,15,513,506,7,34716,34099,617,236,232,4,1,100,NoArch
568181a3e7c1d43a4ee8573d3746600be4f94379,3,10,10,0,0,0,0,6,6,626,2,3,1.076297626,858,0,0,75,75,0,5673,5673,0,38,38,0,1,100,NoArch
36b69d80332468439d9e1674b7d1845198379152,1,0,3,3,0,0,0,40,88,25,1,1,0,828,89,2,88,89,1,5089,5112,23,23,23,0,1,100,NoArch
69d14353bcc20c07d53b7835940c4117cfbf5110,52,223,795,572,0,1,1,40,87,88,8,40,4.304541445,20881,22,3,2057,2109,52,123170,126779,3609,1178,1200,22,0,92.94003084,Arch
7de5d1760191128c86ef40ac2f9cb57e87328e3e,8,221,28,193,0,0,0,2,25,50,2,6,1.629449128,3080,109,14,262,245,17,21717,20136,1581,158,155,3,1,92.96437556,Arch
31947a09a699f59578fe99c5834e171ab5f82280,1,5,1,4,0,0,0,4,7,51,1,1,0,824,77,3,44,44,0,6889,6873,16,28,28,0,0,100,NoArch
a8fb69656f522648233f0310ca3756188d954281,6,1026,0,1026,5,0,5,1,75,0,1,3,1.889780569,509,2,1,158,57,101,9243,3145,6098,95,31,64,1,99.90996399,NoArch
63b15607ff6c251c8965f76066b1c882dc356266,4,459,3,456,2,0,2,41,89,207,2,3,1.719833661,865,2,0,121,90,31,7584,5185,2399,40,24,16,1,99.94007042,NoArch
734c9f5f2d6c3ea87c23cef962e69b0b68f72581,3,263,0,263,3,0,3,1,1,0,1,3,1.399503289,0,0,0,20,0,20,1483,0,1483,10,0,10,1,99.94762439,NoArch
f0e46bf522064488eaed8136da7eb119b2806ce9,0,0,0,0,0,0,0,0,0,0,0,0,0,0,37,0,0,0,0,0,0,0,0,0,0,1,100,NoArch
84b531ae758230bda67bd842d761d68dea5581d0,3,60,3,57,0,0,0,10,27,753,1,3,0.541173085,2259,3,2,117,116,1,16879,16401,478,66,65,1,1,100,NoArch
57c4bf8152280de738f7ae313f5bf0046bb4675d,2,17,0,17,0,0,0,15,29,203,1,2,0.787126586,1021,21,2,66,62,4,7861,7698,163,31,30,1,1,100,NoArch
2d66451a518988e2bf2eb5acc2d246e4c091f900,1,2,2,0,0,0,0,10,15,50,1,1,0,500,25,7,56,56,0,3372,3370,2,26,26,0,0,100,NoArch
4a437f25d376a2d06cbc119dba6edbc4187bc35a,0,0,0,0,0,0,0,0,0,0,0,0,0,0,22,0,0,0,0,0,0,0,0,0,0,0,100,NoArch
6dab307e6f9aa3dd9582f0240430dd86de83624c,1,4,0,4,0,0,0,2,2,5,1,1,0,132,28,3,13,13,0,885,868,17,6,6,0,0,100,NoArch
e8473b9a2b5bf0ad9370377899f6a7ea4d1ceba1,8,9,204,195,0,2,2,1,76,59,1,5,2.053584659,1455,162,9,117,127,10,7218,8191,973,61,69,8,1,98.8553045,NoArch
fba2dd17a38c937fa8e9a4f482f3ec0a2594e8fb,19,8,1831,1823,0,10,10,0,88,8,5,15,3.33752798,6933,162,8,377,534,157,35586,46226,10640,173,265,92,1,99.79747975,NoArch
c9e18d1e7de66c7eca151f7f8ffe3dc849a2e319,20,1832,10,1822,10,0,10,1,89,205,5,16,3.349524863,6135,2,1,680,523,157,52216,41588,10628,318,226,92,1,99.79747975,NoArch
c56d93e7b8f030273f78f9afd888b89c532563c8,0,0,0,0,0,0,0,0,0,0,0,0,0,0,163,8,0,0,0,0,0,0,0,0,0,0,100,NoArch
082faa385102dfe511fcb250b3ddc0368cf17729,0,0,0,0,0,0,0,0,0,0,0,0,0,0,5,0,0,0,0,0,0,0,0,0,0,1,100,NoArch
7c3f0777aae956c5e5b2b2ba587f9b9bf2516433,4,44,33,11,0,0,0,2,3,39,1,3,1.882840719,583,111,13,51,51,0,3562,3498,64,35,35,0,1,99.97005988,NoArch
bd084704210ee0247a4b31a6a32e5de3afd7048c,3,4,8,4,0,0,0,2,4,511,1,1,1.584962501,951,164,9,177,177,0,5254,5286,32,24,24,0,1,90.30180346,Arch
9c8ad0f0faab29e812628d26534a0f6fca9faf60,2,71,3,68,0,0,0,11,14,517,1,2,0.639457132,2106,0,0,96,91,5,16236,15618,618,56,55,1,1,100,NoArch
5ac9ce728922dba6368cc2c410507eee9cb8debe,1,1,1,0,0,0,0,12,13,0,1,1,0,1818,38,1,56,56,0,14728,14724,4,39,39,0,0,100,NoArch
f612a20815d35667ce49f0dbf51b6877bf7b1ab4,2,14,2,12,0,0,0,5,24,641,1,2,0.811278124,331,0,0,36,34,2,2066,1944,122,10,10,0,1,100,NoArch
68f8597b12edebba759b942f6337540f21a2db96,0,0,0,0,0,0,0,0,0,0,0,0,0,0,22,2,0,0,0,0,0,0,0,0,0,1,100,NoArch
3fb2f974ca8ce8faf625c4ab48ce866567b72fc3,0,0,0,0,0,0,0,0,0,0,0,0,0,0,0,0,0,0,0,0,0,0,0,0,0,0,100,NoArch
8321d20c2cced15150621c9ad828f5ba9d79399a,0,0,0,0,0,0,0,0,0,0,0,0,0,0,112,9,0,0,0,0,0,0,0,0,0,0,100,NoArch
ea154bcb5d753f8df74e1bb03944b61119a69b75,0,0,0,0,0,0,0,0,0,0,0,0,0,0,113,10,0,0,0,0,0,0,0,0,0,0,100,NoArch
456d74ce4e62b49b3cb3def9d0c9f5768c98c097,2,52,5,47,1,0,1,1,6,30,2,2,0.707669,284,23,3,20,19,1,2288,2141,147,10,9,1,1,99.9284095,NoArch
c7473a7b0c648be400af2a70b8b4a59ac57dcdde,1,34,20,14,0,0,0,20,51,43,1,1,0,1877,29,1,166,165,1,14414,14304,110,106,105,1,1,100,NoArch
f194566ed4b2d910925f337fc3b9202084860abd,9,12,2,10,0,0,0,42,90,95,2,9,2.896291529,4363,0,0,456,456,0,26989,26815,174,197,197,0,1,100,NoArch
be368264f4cbde83ceb91d273ce5bd27dca75242,9,104,33,71,0,0,0,14,27,36,2,4,2.141029921,5209,114,10,625,601,24,37759,37197,562,329,321,8,1,100,NoArch
3ad9b121f15c3c4f0eadba799dd4d96d5b9d6b1f,1,1,1,0,0,0,0,3,11,120,1,1,0,140,27,0,12,12,0,654,654,0,6,6,0,1,100,NoArch
3ce05269247540b2fa5b7fd923d6ca8972e7ead2,1,16,8,8,0,0,0,6,8,41,1,1,0,356,115,11,41,38,3,2748,2706,42,12,12,0,0,100,NoArch
3ba29096905ce5fd617c7c2e8f745a963af102f1,3,37,3,34,0,0,0,15,23,79,2,3,1.522336807,1941,17,1,221,217,4,15153,14854,299,109,106,3,1,100,NoArch
72901a33a1feeef317db73986fe1f7b91bbc092b,1,36,0,36,1,0,1,1,1,0,1,1,0,0,26,3,1,0,1,59,0,59,1,0,1,1,99.97615641,NoArch
2d864f75247fd2feff6509235c7df84ec8707738,16,540,728,188,2,1,3,1,52,79,2,14,2.735745623,4554,11,3,483,554,71,23768,26878,3110,255,259,4,1,99.26849742,NoArch
c48a2a125a9d41f4fb4bf7d6a1d01bf75ba1877a,1,90,54,36,0,0,0,7,9,41,1,1,0,403,20,2,27,32,5,2953,2826,127,12,11,1,1,100,NoArch
9797fdfbb27ca8f5f06875ad958b597becc27a8d,5,21,3,18,0,0,0,9,80,263,2,4,1.78067213,2910,19,2,421,420,1,13186,13061,125,351,350,1,1,100,NoArch
9bdcee00c010fd6d7c817ee882550dd78e35ad91,5,31,38,7,0,0,0,2,48,187,2,4,1.904302668,2165,165,7,255,253,2,11915,11966,51,127,126,1,1,99.97587455,NoArch
2dcb3f0062074b59676bb65b0afee86994571fd6,1,3,0,3,0,0,0,4,36,66,1,1,0,582,166,8,66,66,0,2660,2643,17,36,36,0,1,100,NoArch
b5f05fd153df29a8be377404a14a0ced2f00b4bf,4,808,10,798,2,0,2,1,16,81,3,4,1.172959724,433,27,4,128,58,70,6354,2297,4057,52,32,20,1,99.91563216,NoArch
8dd0444ef96db4028bd28d5e4d8653c290764152,4,25,10,15,0,0,0,2,29,235,2,2,1.215959583,2259,167,9,226,224,2,12793,12740,53,157,155,2,1,100,NoArch
15444c951f4500e58c73b419fb4fa2c4d6c86260,0,0,0,0,0,0,0,0,0,0,0,0,0,0,23,1,0,0,0,0,0,0,0,0,0,1,100,NoArch
b22c2c611bc8d5be1a8cdc5f50aea5607ba4b756,6,54,21,33,0,0,0,7,40,9,2,5,0.803085199,3794,21,2,325,323,2,25421,25355,66,118,116,2,1,100,NoArch
dd961291914df656418c9a1cacd39eaf8a806809,10,225,29,196,0,0,0,10,22,206,2,6,2.976324132,3495,3,1,384,356,28,23048,21839,1209,154,144,10,1,100,NoArch
46de25d5fd7fc5aedc574fc6bb76e14efb46bb37,1,3,1,2,0,0,0,18,30,6,1,1,0,1150,0,0,101,101,0,6024,6023,1,66,66,0,1,100,NoArch
29bc5fd912df9517acb9e15ead97f1849f21056b,3,21,3,18,0,0,0,3,47,101,1,3,1.308502445,1661,0,0,103,101,2,9857,9690,167,69,68,1,1,100,NoArch
c8d6bd88988f19f5163553b4438981e780dfda0c,3,20,13,7,0,0,0,10,49,37,2,3,0.954505629,1910,168,9,184,181,3,9600,9536,64,110,109,1,1,100,NoArch
bc8bf043d5512f7afbb9d94882c4e43ee61d6f06,1,1,1,0,0,0,0,7,23,31,1,1,0,412,22,3,31,31,0,1595,1595,0,28,28,0,1,100,NoArch
dbec6c512b1e5a93a60034a9894e10a65db34ea4,1,2,2,0,0,0,0,10,15,5,1,1,0,273,4,2,36,36,0,1387,1387,0,23,23,0,1,100,NoArch
9a2030ab3190acf600ce4820be9a08929595763e,4,86,14,72,1,0,1,7,13,293,1,2,1.357731956,248,1,1,27,20,7,1339,1072,267,20,13,7,1,99.95185364,NoArch
3b89457e2b6d885d41d0f3cd95e2c71a53b097bf,1,56,17,39,0,0,0,18,23,744,1,1,0,328,28,3,43,36,7,2450,2199,251,26,23,3,1,100,NoArch
27907dea4cb7b52fa61521e738e2d94ef203992b,0,0,0,0,0,0,0,0,0,0,0,0,0,0,78,1,0,0,0,0,0,0,0,0,0,1,100,NoArch
f5b07a77bc11c8faada58e53e9463008c9cee78d,0,0,0,0,0,0,0,0,0,0,0,0,0,0,1,1,0,0,0,0,0,0,0,0,0,1,100,NoArch
ea2eba1a5532d0f0f66268a456877773763dec08,9,63,40,23,0,0,0,9,31,56,2,4,2.208936703,3827,169,10,344,341,3,23546,23491,55,216,212,4,1,100,NoArch
a8a192aef5e48d2ccc5656cbe1a872862e158f52,1,2,3,1,0,0,0,3,4,18,1,1,0,169,18,2,8,8,0,493,504,11,7,7,0,0,100,NoArch
294d71294835df55b238e04b8e42ff04ea073e82,1,4,0,4,0,0,0,10,11,113,1,1,0,421,24,3,34,34,0,3580,3541,39,17,17,0,1,100,NoArch
7e7ad1558c0dcc06e059f631e43e44dc04100aa4,5,38,31,7,0,0,0,3,50,13,2,4,1.904302668,2160,116,7,254,256,2,11994,11943,51,126,127,1,2,99.9879692,NoArch
d0087d40402133453c3ca3da1a566545f0ca9d64,10,214,13,201,2,0,2,1,77,237,2,7,2.297477268,1580,170,8,174,164,10,9861,8861,1000,103,95,8,1,91.93151418,Arch
e4cfb421c0d17c248ab660ae54a4a2d49aff1561,0,0,0,0,0,0,0,0,0,0,0,0,0,0,28,1,0,0,0,0,0,0,0,0,0,1,100,NoArch
9246b164925d0ffe444b0f015f0b0a0338575216,5,90,1,89,0,0,0,6,17,206,2,5,1.945220214,847,25,4,87,75,12,6309,5646,663,46,43,3,1,100,NoArch
6eba8345cb815b7a375b27f55e6483ab72eee83e,2,76,22,54,0,0,0,4,52,44,1,1,0.475431646,2245,117,7,190,183,7,17727,17333,394,119,115,4,1,100,NoArch
7784249e55c8dc6c1e5fa1142f7a93d78ca66471,2,370,0,370,2,0,2,1,1,0,1,2,0.900219172,0,23,3,29,0,29,1765,0,1765,19,0,19,1,99.94225217,NoArch
47852446e845f856a4b04c1a8cfba7b66445d46d,1,18,4,14,0,0,0,4,7,0,1,1,0,404,118,8,24,23,1,3373,3266,107,13,12,1,1,100,NoArch
d1d48ed4947b81e10fba83b7a462839a55ff9115,11,256,62,194,1,0,1,16,51,133,1,10,1.83321571,3500,24,4,417,406,11,23322,22227,1095,202,197,5,1,99.88459319,NoArch
733732be7ba61275e3855d316654970360b525f3,2,17,1,16,0,0,0,1,3,0,1,2,0.503258335,307,25,5,26,26,0,1762,1577,185,16,16,0,1,100,NoArch
dc40397fa9d0c731b94931e715ce0c142165ebac,1,1,1,0,0,0,0,3,4,220,1,1,0,113,119,8,15,15,0,591,590,1,6,6,0,1,100,NoArch
77abb5ccb90aa0e0ae00c2d5cbbba6ec26c86fe4,3,24,8,16,0,0,0,4,11,123,3,3,1.405639062,993,120,9,54,52,2,6997,6827,170,27,27,0,1,100,NoArch
f57e28fe396951ce6e4690373b6e75035362409f,0,0,0,0,0,0,0,0,0,0,0,0,0,0,79,1,0,0,0,0,0,0,0,0,0,0,100,NoArch
bb99836841b03946f742f797ba83b9057e5bcfbb,1,66,61,5,0,0,0,3,3,245,1,1,0,365,80,2,12,13,1,3007,2886,121,11,12,1,1,100,NoArch
478f9f369570b604981f16aa1fe03329e18ce5f2,1,4,14,10,0,0,0,4,5,5,1,1,0,52,171,9,2,4,2,110,148,38,1,1,0,0,100,NoArch
03f71ef1a268ae1375c0a890807d54f935b93022,0,0,0,0,0,0,0,0,0,0,0,0,0,0,121,10,0,0,0,0,0,0,0,0,0,1,100,NoArch
4a48f99a596b5596fb654b56a6533b908bb9d8f3,2,121,62,59,0,0,0,8,12,2,1,2,0.981808408,559,26,6,41,43,2,3892,3655,237,19,18,1,2,100,NoArch
3ca92108b21e265048b8ce36b2ef27d2fdfe5de0,0,0,0,0,0,0,0,0,0,0,0,0,0,0,3,1,0,0,0,0,0,0,0,0,0,0,100,NoArch
f166ddad12ebb0b1e2a3cd4f03c2bd6ca9318379,1,0,14,14,0,0,0,18,40,83,1,1,0,641,4,2,82,84,2,3576,3648,72,50,52,2,0,100,NoArch
982ae3d1eb8c8f0a5a459d78ecd38a5e7ab092cb,0,0,0,0,0,0,0,0,0,0,0,0,0,0,122,11,0,0,0,0,0,0,0,0,0,0,100,NoArch
f3f6112b75fa7e050956ec2e218606a57d1fd0f3,0,0,0,0,0,0,0,0,0,0,0,0,0,0,19,2,0,0,0,0,0,0,0,0,0,1,100,NoArch
32a44bbe062c997b5a41266290fbe34d6323bfa6,6,118,14,104,1,0,1,15,20,62,2,3,1.226259522,1990,81,3,173,171,2,15123,14313,810,114,113,1,1,99.98076923,NoArch
7d046f914a059b2623d7f2a7627c44b15ccc0ddb,7,28,118,90,0,1,1,15,39,70,2,4,1.564504451,2721,0,0,255,255,0,17961,18699,738,165,164,1,1,99.98076923,NoArch
92f54ce3d8489e0dabcdc1f5cb5076a2ac756545,7,118,28,90,1,0,1,15,40,64,2,4,1.564504451,2631,0,0,255,255,0,18699,17961,738,164,165,1,1,99.98076923,NoArch
f1286c2c764d6be9f23b41c76f4de1c8734c1f3b,3,16,3,13,0,0,0,8,41,27,1,3,0.953013885,1156,172,9,115,113,2,6676,6611,65,42,42,0,1,100,NoArch
15eb7e81fc2f51a5c42d25c0b4d18441209762f1,3,294,87,207,0,0,0,3,15,251,1,2,0.792146529,442,29,2,31,17,14,3522,2501,1021,12,3,9,1,98.73358786,NoArch
b5890cd17d07af2f220c47c70cda8d1b58e5fd1a,0,0,0,0,0,0,0,0,0,0,0,0,0,0,26,4,0,0,0,0,0,0,0,0,0,1,100,NoArch
1a5f8693aa09bc85ad18e5a820473b6344e787ef,5,184,19,165,1,0,1,1,19,271,2,4,1.492431576,1092,123,12,118,103,15,7421,6357,1064,55,47,8,1,99.9819462,NoArch
5d93edc539d1f5d053e5f90a6a20691d7ac8b1b8,0,0,0,0,0,0,0,0,0,0,0,0,0,0,5,2,0,0,0,0,0,0,0,0,0,1,100,NoArch
57f43de1eaabce9c6fd8529bd281596dfb0c779e,0,0,0,0,0,0,0,0,0,0,0,0,0,0,1,1,0,0,0,0,0,0,0,0,0,0,100,NoArch
032b883bd16030c99f9252e7c92f0520c89aa85e,4,73,2,71,1,0,1,3,53,48,1,3,1.782023069,1602,5,2,214,207,7,7892,7610,282,122,118,4,1,99.69330687,NoArch
4721073b4397d76bbd813a988cb79cc9a9558358,1,0,19,19,0,0,0,18,41,12,1,1,0,627,6,3,78,82,4,3446,3576,130,49,50,1,0,100,NoArch
7b07aac28686ed5474747fd2355b7828e5386ba4,4,44,1,43,0,0,0,15,52,44,2,3,1.689276324,3211,173,5,413,410,3,22896,22546,350,240,238,2,1,100,NoArch
c81df99e50f2df84d85f08ff3a839595dad974d7,2,33,51,18,0,0,0,18,42,11,2,2,0.325551713,914,174,6,121,125,4,5218,5307,89,61,61,0,1,100,NoArch
282aa68552e3872cf2758824de1d2efd004ae1c1,0,0,0,0,0,0,0,0,0,0,0,0,0,0,6,2,0,0,0,0,0,0,0,0,0,1,100,NoArch
6409fc733d27eea6ebc71551affdf5aec4bb2fd5,3,74,0,74,1,0,1,13,17,464,1,3,0.875686556,478,0,0,57,50,7,3574,3194,380,36,31,5,1,99.69344514,NoArch
1f7afba5e4c13c317c5378c7088dddb13b71d558,0,0,0,0,0,0,0,0,0,0,0,0,0,0,10,0,0,0,0,0,0,0,0,0,0,1,100,NoArch
32505d5adbbf433912d2d2f9f74adb8581bbd64e,4,63,32,31,0,0,0,14,34,55,2,3,1.866003782,1714,7,3,223,220,3,8739,8583,156,117,115,2,1,100,NoArch
05942e018c6b5ef9112e0472360684513531d261,2,26,3,23,0,0,0,2,3,135,1,2,0.216396932,100,11,1,7,4,3,656,477,179,3,2,1,1,100,NoArch
3d7a8695cdd76cdf359f9d1bb7108a49b41d64c4,1,0,1,1,0,0,0,2,3,58,1,1,0,219,124,8,25,25,0,1578,1602,24,11,11,0,0,100,NoArch
9412281cb14b1eabf9a23a3484e752a2636f2445,0,0,0,0,0,0,0,0,0,0,0,0,0,0,26,0,0,0,0,0,0,0,0,0,0,1,100,NoArch
a29b27c7cafacce0d165b40d44e3647ea6d9b538,1,0,5,5,0,0,0,3,5,18,1,1,0,147,7,4,15,16,1,663,688,25,8,9,1,0,100,NoArch
504747ecf4c93d53f0fc565cdcf12544549b7903,0,0,0,0,0,0,0,0,0,0,0,0,0,0,8,3,0,0,0,0,0,0,0,0,0,1,100,NoArch
62b3c9058c0a16b6d2158e8282461dd035003390,164,1503,6332,4829,1,26,27,0,88,68,11,95,6.008076666,55392,2,0,5119,5477,358,317928,343291,25363,2733,2955,222,1,93.52352845,Arch
caea27592967ca2da230aa4ce91a782e4615a737,0,0,0,0,0,0,0,0,0,0,0,0,0,0,37,0,0,0,0,0,0,0,0,0,0,1,100,NoArch
c55a012b517e56d4a74f3ff31463b3c9f85ceff3,2,17,0,17,0,0,0,15,29,273,1,2,0.787126586,1021,21,0,66,62,4,7861,7698,163,31,30,1,1,100,NoArch
efd83a4b5b92b2d207b13e32706e40b904bb4ceb,1,2,2,0,0,0,0,10,15,119,1,1,0,500,25,0,56,56,0,3372,3370,2,26,26,0,0,100,NoArch
287bd94e3fa2ad1c8ac21ba40d527a2289699d9a,0,0,0,0,0,0,0,0,0,0,0,0,0,0,22,0,0,0,0,0,0,0,0,0,0,0,100,NoArch
d67f1c8b000de4506cb649d56d87510ccc94e97c,0,0,0,0,0,0,0,0,0,0,0,0,0,0,28,0,0,0,0,0,0,0,0,0,0,0,100,NoArch
34b7bce4bd1d2a1e1a1fc26dd1402f7d42fa54cb,0,0,0,0,0,0,0,0,0,0,0,0,0,0,163,0,0,0,0,0,0,0,0,0,0,1,100,NoArch
db1877dfe98387f7a2a9eb924777e29cddf20148,1,1,2,1,0,0,0,12,16,716,1,1,0,1025,2,0,146,146,0,5990,6002,12,53,53,0,1,100,NoArch
465a791ad7fcd380078967dc2664df57e45684f6,4,44,33,11,0,0,0,2,3,87,1,3,1.882840719,583,111,0,51,51,0,3562,3498,64,35,35,0,1,99.93988127,NoArch
9864d30fc169f51a6588848dfd2445360e133e27,3,4,8,4,0,0,0,2,4,572,1,1,1.584962501,951,164,1,177,177,0,5254,5286,32,24,24,0,1,90.32258065,Arch
5ca17ab06671df233b0033a65a98e51baf8c28f5,2,71,3,68,0,0,0,11,14,545,1,2,0.639457132,2106,0,0,96,91,5,16236,15618,618,56,55,1,1,100,NoArch
0246f23753a032bc77442ab04571426e45b3ad0d,1,1,1,0,0,0,0,12,13,0,1,1,0,1818,38,1,56,56,0,14728,14724,4,39,39,0,0,100,NoArch
e3c67a09fb4b559a0c44e9d21b070e7e3e8c289e,2,14,2,12,0,0,0,5,24,703,1,2,0.811278124,331,0,0,36,34,2,2066,1944,122,10,10,0,1,100,NoArch
243fb1cba2e255d98988c9fbec5cf957e01f9ad8,0,0,0,0,0,0,0,0,0,0,0,0,0,0,22,1,0,0,0,0,0,0,0,0,0,1,100,NoArch
cbaa100709a5e9e519cff95834ca2ebc4b11ed57,2,52,5,47,1,0,1,1,6,59,2,2,0.707669,284,23,2,20,19,1,2288,2141,147,10,9,1,1,99.92799712,NoArch
d5fe221edfbf2e7f0102b4f6105fb31ef825b748,9,12,2,10,0,0,0,41,89,151,2,9,2.896291529,4354,0,0,455,455,0,26927,26753,174,197,197,0,1,100,NoArch
f1f4470f5984e0079e3dbea97407ee572ef3e753,9,104,33,71,0,0,0,14,27,92,2,4,2.141029921,5209,112,1,625,601,24,37759,37197,562,329,321,8,1,100,NoArch
c8de9f6d1a40061bf98651e90aea5fe217e82886,3,37,3,34,0,0,0,15,23,136,2,3,1.522336807,1941,17,0,221,217,4,15153,14854,299,109,106,3,1,100,NoArch
4c627debcb009a0209f7ddfcb5a4ab77df675ebd,5,21,3,18,0,0,0,9,80,317,2,4,1.78067213,2910,19,0,421,420,1,13186,13061,125,351,350,1,1,100,NoArch
2262fa76428feb31c720cb37760de3252c1e18ef,1,3,0,3,0,0,0,4,36,121,1,1,0,582,165,2,66,66,0,2660,2643,17,36,36,0,1,100,NoArch
f1896dbf8f29daf3953bad85a0f51c2bfa0829cb,4,808,10,798,2,0,2,1,16,109,3,4,1.172959724,433,26,1,128,58,70,6354,2297,4057,52,32,20,1,99.91609733,NoArch
8736a0be799e2dc12d5545052bf8ce89ec54306b,4,25,10,15,0,0,0,2,29,289,2,2,1.215959583,2259,166,3,226,224,2,12793,12740,53,157,155,2,1,100,NoArch
82b983869a32549e89ab6e897fa05e90c2e36b03,0,0,0,0,0,0,0,0,0,0,0,0,0,0,23,1,0,0,0,0,0,0,0,0,0,1,100,NoArch
8a09cdba606bf77adfa8e5e6e089bb5163930964,6,54,21,33,0,0,0,7,40,36,2,5,0.803085199,3794,20,0,325,323,2,25421,25355,66,118,116,2,1,100,NoArch
923a05305f004ba3b0c7bfdd9375a0a67ff06b29,10,225,29,196,0,0,0,10,22,254,2,6,2.976324132,3495,2,0,384,356,28,23048,21839,1209,154,144,10,1,100,NoArch
abfa64d3fc7da9ddab9783c13c7749459c19616d,1,3,1,2,0,0,0,18,30,0,1,1,0,1150,0,0,101,101,0,6024,6023,1,66,66,0,1,100,NoArch
2b260512f6465dc8615c9c594af4c82ee57cf3e1,3,21,3,18,0,0,0,3,47,148,1,3,1.308502445,1661,0,0,103,101,2,9857,9690,167,69,68,1,1,100,NoArch
ef6257535c921a2cba79f3eca9899371829d1b23,3,20,13,7,0,0,0,10,48,64,2,3,0.954505629,1906,167,4,183,180,3,9578,9514,64,110,109,1,1,100,NoArch
9af6075fb2e2a107f70158087955ae95683c777a,1,2,2,0,0,0,0,10,15,0,1,1,0,273,3,1,36,36,0,1387,1387,0,23,23,0,1,100,NoArch
94cbcef242889da9f8cea8eb95d7551eb2128f66,1,56,17,39,0,0,0,18,23,786,1,1,0,328,27,2,43,36,7,2450,2199,251,26,23,3,1,100,NoArch
bb1621250196eaacc7fe6bb11a0f48a1c36b14ca,0,0,0,0,0,0,0,0,0,0,0,0,0,0,78,0,0,0,0,0,0,0,0,0,0,1,100,NoArch
cd35b2777a4c49bcd2c52d40ad4d9e6548add14c,9,63,40,23,0,0,0,9,31,81,2,4,2.208936703,3791,168,5,349,346,3,23419,23364,55,215,211,4,1,100,NoArch
6f117b04a2c33e11228afe89d966c3cefe760cbf,1,2,3,1,0,0,0,3,4,0,1,1,0,169,18,1,8,8,0,493,504,11,7,7,0,0,100,NoArch
afe004ddb2950452d3651d99d8ac3992b8159a46,1,4,0,4,0,0,0,10,11,152,1,1,0,421,24,3,34,34,0,3580,3541,39,17,17,0,1,100,NoArch
eca2f2cc65796c566af733520608bc78d600063a,10,214,13,201,2,0,2,1,76,275,2,7,2.297477268,1579,169,6,174,164,10,9849,8849,1000,103,95,8,1,92.01154957,Arch
38e2fa44086839f0acfb8613aab8b255aeaac90f,5,90,1,89,0,0,0,6,17,241,2,5,1.945220214,847,25,4,87,75,12,6309,5646,663,46,43,3,1,100,NoArch
1c091129204cd80553414b395fa8e11e7dcf7834,2,370,0,370,2,0,2,1,1,0,1,2,0.900219172,0,21,1,29,0,29,1765,0,1765,19,0,19,1,99.93245851,NoArch
73d69ef13a14d02fe1935b2ff4b9e274e4d29fa4,1,32,18,14,0,0,0,4,6,104,1,1,0,354,113,2,18,17,1,3032,2919,113,10,9,1,1,100,NoArch
22f934a53cda9505f982f82a76f9ae3fcf872800,11,256,62,194,1,0,1,16,49,155,1,10,1.83321571,3500,22,2,417,406,11,23322,22227,1095,202,197,5,1,99.8843039,NoArch
47ca52027bbc7831acf75fd1e738b78129426db6,2,17,1,16,0,0,0,1,3,0,1,2,0.503258335,307,23,3,26,26,0,1762,1577,185,16,16,0,1,100,NoArch
d1c89c0f761c13c39d2936176dbb09a6d53f4bdd,1,1,1,0,0,0,0,3,4,254,1,1,0,113,114,3,15,15,0,591,590,1,6,6,0,1,100,NoArch
05b099b623c7b70c46d6e4a4619fca1f2d0fad38,3,22,6,16,0,0,0,4,10,132,3,3,1.378783493,907,115,4,53,51,2,6529,6359,170,23,23,0,1,100,NoArch
8006eaa42f40122716f6dc9ed910df193811a286,0,0,0,0,0,0,0,0,0,0,0,0,0,0,79,1,0,0,0,0,0,0,0,0,0,0,100,NoArch
e49aa6132f19dff18c43c59c1ef4997623b545da,1,66,61,5,0,0,0,3,3,277,1,1,0,365,80,2,12,13,1,3007,2886,121,11,12,1,1,100,NoArch
17b4bc3985e21f151a3f07487d22d937f6daf5ee,1,4,14,10,0,0,0,4,5,0,1,1,0,52,170,7,2,4,2,110,148,38,1,1,0,0,100,NoArch
d6564ac20c67e17a108cf8781540b26699d8abc3,0,0,0,0,0,0,0,0,0,0,0,0,0,0,116,5,0,0,0,0,0,0,0,0,0,1,100,NoArch
36c6cc4c242f0fe3f9106c5062d94801f7b457b0,2,126,61,65,0,0,0,8,11,0,1,2,0.977417818,523,24,4,46,48,2,3827,3528,299,18,17,1,2,100,NoArch
c881cc30152189b72a2a22df3b49efea5bff4ba9,0,0,0,0,0,0,0,0,0,0,0,0,0,0,117,6,0,0,0,0,0,0,0,0,0,0,100,NoArch
8f39f661df21b4a19720c2e7ad2cecf8570778e9,0,0,0,0,0,0,0,0,0,0,0,0,0,0,19,2,0,0,0,0,0,0,0,0,0,1,100,NoArch
b7254815ea94ad046475b0d8809e0044966f8af1,6,118,14,104,1,0,1,15,20,76,2,3,1.226259522,1990,81,3,173,171,2,15123,14313,810,114,113,1,1,99.98072103,NoArch
f2ad064d6a587f1dd338e3d8cec8ef9cc38bdc36,0,0,0,0,0,0,0,0,0,0,0,0,0,0,0,0,0,0,0,0,0,0,0,0,0,1,100,NoArch
06b77ff68f7d1938e8017bbdb5b8df15c9771ab9,3,16,3,13,0,0,0,8,41,0,1,3,0.953013885,1156,171,8,115,113,2,6676,6611,65,42,42,0,1,100,NoArch
88a5e2092bafc00d1fdb2b84d21e5a0354aebb2d,4,44,1,43,0,0,0,15,50,24,2,3,1.689276324,3211,172,9,413,410,3,22896,22546,350,240,238,2,1,100,NoArch
623f3aeea3608cba0a75699107c8c1d01d039236,2,33,51,18,0,0,0,17,40,55,2,2,0.325551713,947,173,10,127,131,4,5420,5509,89,64,64,0,1,100,NoArch
f3a5cdba6926551e743929d2302c63b2f3d3ef71,0,0,0,0,0,0,0,0,0,0,0,0,0,0,10,0,0,0,0,0,0,0,0,0,0,1,100,NoArch
0c27f6938e09449da8973ddd97da5285e61a8816,4,63,32,31,0,0,0,14,34,24,2,3,1.866003782,1714,4,2,223,220,3,8739,8583,156,117,115,2,1,100,NoArch
e7c237b6166be3c532813a7c9e5eb084dc6a5b23,1,0,1,1,0,0,0,2,3,0,1,1,0,219,118,7,25,25,0,1578,1602,24,11,11,0,0,100,NoArch
10fa8cbdb04252dc64d38ec268701589d361b665,0,0,0,0,0,0,0,0,0,0,0,0,0,0,26,0,0,0,0,0,0,0,0,0,0,1,100,NoArch
5c0e4ce0055f0481a4cd6b7b44f5d0b266fd8f44,62,3299,1029,2270,17,1,18,1,90,104,7,42,4.867694035,15440,125,9,1735,1599,136,103965,93499,10466,927,803,124,1,97.45691663,Arch
674c1492348b5b2a93358c9dd51a1adfe6a8ecf2,24,3031,75,2956,16,0,16,4,48,64,2,9,3.973661858,3179,4,0,710,347,363,31295,17298,13997,313,100,213,1,99.65854973,NoArch
436becf3ea07469906804888fe9c5409a5115e7a,11,209,78,131,0,0,0,16,43,119,2,7,3.076689576,7153,24,0,859,831,28,52438,51350,1088,460,449,11,1,100,NoArch
0f0088fe4b740c4acec0cb25988250db8fb483b6,1,3,3,0,0,0,0,2,9,38,1,1,0,273,30,2,25,25,0,1758,1758,0,10,10,0,1,100,NoArch
a4e622ac61ecaf8520d137421f16bc206b864732,44,1176,47,1129,11,0,11,6,81,367,4,21,4.27884273,8720,12,0,1016,912,104,55051,48900,6151,683,615,68,4,94.19463401,Arch
e88b5fd450ef56241c5ba54709920a5f38cd5754,1,18,2,16,0,0,0,3,9,182,1,1,0,147,31,2,12,11,1,703,632,71,6,6,0,1,100,NoArch
2444f40a4be5bbf0bf210dee5690267a9a1e35c8,16,368,272,96,4,4,8,1,82,166,1,8,3.481626547,3803,2,0,434,426,8,18053,17461,592,387,384,3,1,92.98853062,Arch
ef9923fc5551851ec4ee71896a62c0615da45ee8,7,169,8,161,1,0,1,9,23,99,1,4,2.262501694,2344,0,0,199,185,14,18055,16937,1118,94,88,6,1,99.8427673,NoArch
bfa169d808c72d09e1370a2b1ecd6a080d45fe02,1,1,1,0,0,0,0,2,2,166,1,1,0,75,2,2,2,2,0,452,452,0,1,1,0,1,100,NoArch
188d0338c4a483ae11969e9fc130b334995499f0,0,0,0,0,0,0,0,0,0,0,0,0,0,0,39,0,0,0,0,0,0,0,0,0,0,1,100,NoArch
1622b52c9cf90a96b3b4f8db3228253db4a93e6e,0,0,0,0,0,0,0,0,0,0,0,0,0,0,12,2,0,0,0,0,0,0,0,0,0,1,100,NoArch
fe9406dd33c0fe860e924e46f7b2908bf3155265,0,0,0,0,0,0,0,0,0,0,0,0,0,0,13,3,0,0,0,0,0,0,0,0,0,1,100,NoArch
1e2d2c437d5ec73452b276cdaff5a789ea3979ac,2,7,4,3,0,0,0,9,24,8,1,2,0.845350937,1637,1,1,95,95,0,12309,12256,53,58,58,0,1,100,NoArch
0273f2e65d97374ed20813c952ca18666d876626,0,0,0,0,0,0,0,0,0,0,0,0,0,0,82,1,0,0,0,0,0,0,0,0,0,0,100,NoArch
2b2ae34cb96762787a09101200dcefaca23373c0,1,11,1,10,0,0,0,5,5,122,1,1,0,70,1,1,6,5,1,353,310,43,5,5,0,1,100,NoArch
29ab6fb9adb7e4697bd0bb2d32aa59351650f613,1,6,3,3,0,0,0,7,11,52,1,1,0,65,40,1,2,2,0,405,382,23,2,2,0,1,100,NoArch
7329d229d5780eb817110c7ed0e55cfa4afa2f67,0,0,0,0,0,0,0,0,0,0,0,0,0,0,126,3,0,0,0,0,0,0,0,0,0,0,100,NoArch
aaf5727495bc547889b815160ddf855b1799a79d,1,14,6,8,0,0,0,6,8,531,1,1,0,213,30,0,23,20,3,1587,1537,50,12,12,0,1,100,NoArch
bf4e3d63e7ac2af1363efce5135005204dc1ee92,1,4,1,3,0,0,0,2,4,97,1,1,0,265,27,0,34,34,0,1283,1282,1,27,27,0,1,100,NoArch
37b15ff458d8d332cbc884de07a43d78a8ebe5ce,2,17,8,9,0,0,0,2,4,51,1,2,0.634309555,321,0,0,26,25,1,2161,2086,75,11,11,0,1,100,NoArch
a66212d2046c54c733997328d8b101fa54916ff3,1,4,3,1,0,0,0,14,23,88,1,1,0,202,127,4,23,23,0,1231,1240,9,10,10,0,1,100,NoArch
0e297c0c4ca590e4d6b3050647d207e3e0b50912,2,19,9,10,0,0,0,16,23,46,2,2,0.966618633,858,175,2,119,117,2,4588,4504,84,44,44,0,1,100,NoArch
75133f9942015caa93a3802b61730bcf37ade1ec,2,5,0,5,0,0,0,6,17,66,1,2,0.970950594,2790,31,1,211,211,0,21182,21101,81,117,117,0,1,100,NoArch
eee715b3ffa6f4a917ef2992bcb637996699c32a,1,4,0,4,0,0,0,4,4,42,1,1,0,155,0,0,14,13,1,1137,1109,28,2,2,0,1,100,NoArch
205e48f53f24086419c01dd8652748347ecd295f,2,8,1,7,0,0,0,2,2,96,1,2,0.99107606,766,1,0,85,84,1,4891,4839,52,51,51,0,1,100,NoArch
50fa5a6aa75ac506a326450f115c986e5e5f9ea0,1,3,0,3,0,0,0,10,15,137,1,1,0,346,0,0,43,43,0,2251,2225,26,16,16,0,0,100,NoArch
b6891d253fef16f7dbbbec2def69a474c593c97e,7,51,11,40,0,0,0,4,83,65,1,6,2.379036189,6959,128,4,660,654,6,42727,42374,353,511,509,2,1,100,NoArch
2954027b92ada82c41d0a72cc0b837564a730a89,3,101,14,87,0,0,0,5,20,704,2,3,0.865661989,1060,129,5,55,48,7,9170,8336,834,26,21,5,1,100,NoArch
8718c30324ccea24c847ad4c540145a161a0a331,4,36,47,11,0,0,0,4,29,60,2,4,1.779974316,2864,130,6,175,175,0,20367,20485,118,78,78,0,1,100,NoArch
4500e615437562b62c6043ee70b53c870f555891,180,1589,8535,6946,5,49,54,0,89,79,11,92,6.352304974,52787,3,1,4511,5188,677,291587,326671,35084,2374,2807,433,0,93.58988102,Arch
9f9e41c7a36b80ce58fa118b9b55e51994c67115,0,0,0,0,0,0,0,0,0,0,0,0,0,0,5,3,0,0,0,0,0,0,0,0,0,1,100,NoArch
d91bb0e7eb94a416aae1f9d236147c776354d8d0,5,31,38,7,0,0,0,3,51,224,2,4,1.904302668,2172,119,8,257,255,2,11998,12049,51,127,126,1,1,100,NoArch
f0c2912d35467ff5f6514c01ab440eb1ca8d0d8f,176,8506,1741,6765,49,5,54,1,90,143,11,88,6.340619773,43968,8,2,4944,4299,645,315279,281235,34044,2685,2267,418,0,93.58988102,Arch
7be8944723d5cd5c1c54f4f94bdafe78351570ac,167,1652,8318,6666,5,49,54,0,89,88,11,86,6.249788651,44800,24,0,3631,4254,623,237780,270931,33151,1908,2318,410,1,93.58988102,Arch
d6d210ff0addaae3031b6107b61dae99e0c8aa5b,1,3,3,0,0,0,0,2,9,24,1,1,0,273,27,0,25,25,0,1758,1758,0,10,10,0,1,100,NoArch
d7afc58d0c9cf7f6625a08e77b821a14548fafc0,166,8316,1650,6666,49,5,54,1,90,147,11,84,6.247011906,37861,4,0,4229,3606,623,269173,236022,33151,2308,1898,410,1,93.58988102,Arch
dd67878bd8a88c2c5492ac297aa5887b497af3eb,165,1647,8316,6669,5,49,54,0,89,88,11,85,6.24539031,43896,120,9,3523,4146,623,232399,265577,33178,1847,2257,410,0,93.58988102,Arch
4fc506f30fe1ee9011e9b10beb484e653c7518ac,7,169,8,161,1,0,1,9,23,89,1,4,2.262501694,2344,0,0,199,185,14,18055,16937,1118,94,88,6,1,99.8748556,NoArch
b0175849477cc53db24486a157431dfdea2ddbad,1,1,1,0,0,0,0,2,2,183,1,1,0,75,0,0,2,2,0,452,452,0,1,1,0,1,100,NoArch
872d984641d7d151fb196b496953869f71724439,2,7,4,3,0,0,0,9,24,0,1,2,0.845350937,1637,1,1,95,95,0,12309,12256,53,58,58,0,1,100,NoArch
135d120f751117d9fbf354be099287cf96e18c1d,0,0,0,0,0,0,0,0,0,0,0,0,0,0,82,4,0,0,0,0,0,0,0,0,0,0,100,NoArch
014d7657214d46060ee699c88f6f847343d6851c,1,11,1,10,0,0,0,5,5,133,1,1,0,70,0,0,6,5,1,353,310,43,5,5,0,1,100,NoArch
fb084e0d93c4217f668614eb06eed9bdcf009278,0,0,0,0,0,0,0,0,0,0,0,0,0,0,121,10,0,0,0,0,0,0,0,0,0,0,100,NoArch
b78a9dc7096af513d064fda94d7e13d206ea50db,1,14,6,8,0,0,0,6,8,537,1,1,0,213,29,1,23,20,3,1587,1537,50,12,12,0,1,100,NoArch
f91b3f348f3d283f28cc5b12751ce1d3952e684a,1,4,1,3,0,0,0,2,4,100,1,1,0,265,25,5,34,34,0,1283,1282,1,27,27,0,1,100,NoArch
7d8780aaf63446b0c86c79cc9ea5e659fc4f8bb8,2,17,8,9,0,0,0,2,4,24,1,2,0.634309555,321,0,0,26,25,1,2161,2086,75,11,11,0,1,100,NoArch
d4d665ecb1d5aaef45ac5ad2bb691d4c9af6f7be,1,4,3,1,0,0,0,14,23,24,1,1,0,202,122,11,23,23,0,1231,1240,9,10,10,0,1,100,NoArch
8fdcbb1e0c48c71d2f50bdc5d69823d23b437896,2,19,9,10,0,0,0,16,23,24,2,2,0.966618633,858,174,11,119,117,2,4588,4504,84,44,44,0,1,100,NoArch
c4673b228d2da65804272d07809748fa7e61b5f8,2,5,0,5,0,0,0,6,17,285,1,2,0.970950594,2789,30,2,210,210,0,21176,21095,81,117,117,0,1,100,NoArch
f39538edca68df2eac2fe9a20b173262ebac17d2,1,4,0,4,0,0,0,3,3,142,1,1,0,150,0,0,12,11,1,1085,1057,28,2,2,0,1,100,NoArch
1e9dc96570b5f22450d7ffc503e014c1a91c3de2,1,3,0,3,0,0,0,10,15,139,1,1,0,346,0,0,43,43,0,2251,2225,26,16,16,0,0,100,NoArch
49e09d9e78271b3dac3114dcb810b291a63e8355,4,37,47,10,0,0,0,4,29,18,2,4,1.779157512,2782,123,12,174,174,0,19952,20059,107,74,74,0,1,100,NoArch
b2b23f5d3a14fae721df34a162e0ed717efe488f,148,8074,1565,6509,48,5,53,1,90,165,9,75,6.133670696,31350,2,2,3616,3011,605,225486,193317,32169,2021,1616,405,1,93.74665382,Arch
2467c137e465927f84df88d1985481a1d47954da,1,2,0,2,0,0,0,12,19,22,1,1,0,327,83,1,42,42,0,2476,2442,34,18,18,0,1,100,NoArch
76a72641f1964f27df21ccfcf390ded00f32a9fa,0,0,0,0,0,0,0,0,0,0,0,0,0,0,29,0,0,0,0,0,0,0,0,0,0,1,100,NoArch
b1df60672bdff3cac339958bf8e8a125cf3ca012,1,2,2,0,0,0,0,3,3,75,1,1,0,93,25,1,0,0,0,157,157,0,0,0,0,0,100,NoArch
2e561defe93ae8137137578aa3e673862cdef834,3,72,42,30,0,0,0,20,91,91,1,2,1.196537405,3036,131,7,284,278,6,22100,21922,178,152,149,3,1,100,NoArch
518488c6334e3d11dde959dd2080f6b6ba2372eb,2,21,1,20,0,0,0,2,8,298,1,2,0.574635698,312,32,2,48,45,3,1998,1900,98,34,32,2,1,100,NoArch
4f6cdd73a352bee132213438e6d11a8aef56de8b,1,2,2,0,0,0,0,14,19,32,1,1,0,386,26,2,56,55,1,2374,2372,2,10,10,0,1,100,NoArch
03a83ffeb5c5ee1f2efccc32f8c927d435185c9b,0,0,0,0,0,0,0,0,0,0,0,0,0,0,14,4,0,0,0,0,0,0,0,0,0,1,100,NoArch
827549949c4ac472fdc528a35ae421b20e2cc83a,27,152,67,85,0,0,0,42,92,234,5,22,4.230558606,7413,33,3,817,807,10,41933,41061,872,546,542,4,1,98.36993434,NoArch
46bb00e4df65999849dc740bd809e86a01e4fbfb,0,0,0,0,0,0,0,0,0,0,0,0,0,0,34,4,0,0,0,0,0,0,0,0,0,1,100,NoArch
98ec21507932ee942ca643c88ba9049746d44059,5,59,46,13,0,0,0,2,42,37,1,5,1.528705405,3651,132,8,287,285,2,26131,26066,65,110,110,0,1,100,NoArch
0d8ca8da4e0f6651bc1f06dba5e7e37881225fdc,3,166,0,166,1,0,1,1,8,82,1,3,1.49361106,400,5,1,60,40,20,2896,1974,922,42,30,12,1,99.94674619,NoArch
36790709f76f71e72026f3f54218ea8b8e247ed2,1,15,4,11,0,0,0,5,6,284,1,1,0,269,15,5,46,44,2,1538,1477,61,7,6,1,1,100,NoArch
cf362fb2d5540d69b30604a227037bdff600735e,11,12,11,1,0,0,0,2,14,431,5,11,3.100559523,2282,3,3,322,322,0,14879,14892,13,65,65,0,0,100,NoArch
977d3c6dad0b9fe3aa1d6f6eca614cc286c3df3d,0,0,0,0,0,0,0,0,0,0,0,0,0,0,1,0,0,0,0,0,0,0,0,0,0,1,100,NoArch
604d9885f1fd722a9b8a4f01da04837b233c5f0f,2,22,3,19,0,0,0,2,5,228,1,2,0.970950594,439,133,9,34,32,2,2721,2606,115,10,10,0,1,100,NoArch
e9a7f49f55770ed31e70aed174c953395bbb0098,3,62,10,52,0,0,0,4,9,36,1,2,1.535529302,701,6,2,77,73,4,4347,3876,471,46,45,1,1,100,NoArch
56f93f4ebd21ca0680424cf092d7e0ef06bf3ae4,2,12,0,12,0,0,0,6,19,38,1,2,0.650022422,2659,134,10,190,190,0,20420,20282,138,108,108,0,0,100,NoArch
251d4eb3b64704b9dd51bf6f6ecb5bf47089b745,5,149,10,139,0,0,0,7,85,46,2,5,1.46587506,4005,28,1,523,512,11,19982,19079,903,423,419,4,1,97.373522,Arch
cc8ecf265ff6e4d9e298c6e1732c1dcf6abe2032,201,1758,8818,7060,5,49,54,0,89,73,12,112,6.427409888,52104,0,0,4363,5029,666,279906,315932,36026,2163,2595,432,0,96.04509333,Arch
6ecefd94effc14704c90940555bff6b60757d4b4,1,52,1,51,0,0,0,5,9,10,1,1,0,364,1,1,24,18,6,3328,2998,330,13,10,3,0,100,NoArch
3e7d28bf2f6feb3e655be337c760bc55c4fe4189,0,0,0,0,0,0,0,0,0,0,0,0,0,0,2,2,0,0,0,0,0,0,0,0,0,0,100,NoArch
4e9b42849d892a802d73d9b5df69d75046b03855,1,0,188,188,0,0,0,3,3,331,1,1,0,299,4,2,13,43,30,606,1697,1091,5,19,14,0,100,NoArch
92093a60a09da6c0cc16e439d405d3878fa5fb75,0,0,0,0,0,0,0,0,0,0,0,0,0,0,4,0,0,0,0,0,0,0,0,0,0,1,100,NoArch
e7241a50f8ac061dc0915e050cf2f3dce0f73254,2,48,1,47,0,0,0,13,17,84,2,2,0.246022578,760,2,2,68,64,4,5679,5245,434,36,35,1,1,100,NoArch
063a05e67fc0bb49fd6ccd6d06c51125b3614178,1,2,0,2,0,0,0,11,18,35,1,1,0,325,83,5,41,41,0,2444,2410,34,18,18,0,1,100,NoArch
491194a5786b39cc80ebdc38f2c6987e679d2f56,0,0,0,0,0,0,0,0,0,0,0,0,0,0,28,3,0,0,0,0,0,0,0,0,0,1,100,NoArch
d93e43b299b26f2ec15bdf43421d4499dd3a041d,1,2,2,0,0,0,0,3,3,35,1,1,0,93,25,1,0,0,0,157,157,0,0,0,0,0,100,NoArch
82a50d9646f145c2c540d74fdd531d5e8c8a906f,3,72,42,30,0,0,0,20,90,102,1,2,1.196537405,3009,124,13,281,275,6,21881,21703,178,150,147,3,1,100,NoArch
37b086ffb9be7d0152ab133f63df16914a4fee73,2,21,1,20,0,0,0,2,7,358,1,2,0.574635698,306,31,3,47,44,3,1941,1843,98,33,31,2,1,100,NoArch
9bfc50e19f55b6ef00100efc7614f737f1fcf49d,1,2,2,0,0,0,0,14,19,35,1,1,0,386,26,2,56,55,1,2374,2372,2,10,10,0,1,100,NoArch
644f81bac434384b61697adf8c223c756e174f56,26,150,65,85,0,0,0,41,91,246,5,21,4.175234564,7296,32,4,804,794,10,41302,40434,868,535,531,4,1,99.74978347,NoArch
3c1c1cc8edbcf4037a23dad1971e1dbaaa0e31aa,0,0,0,0,0,0,0,0,0,0,0,0,0,0,33,5,0,0,0,0,0,0,0,0,0,1,100,NoArch
fc58f4ccc4898888db609b7730775e8cb87bbcf6,5,59,46,13,0,0,0,2,42,25,1,5,1.528705405,3651,125,14,287,285,2,26131,26066,65,110,110,0,1,100,NoArch
85487e4347be9d7a38b2fa44d8eca5bf13582894,3,166,0,166,1,0,1,1,8,84,1,3,1.49361106,400,5,1,60,40,20,2896,1974,922,42,30,12,1,99.95187217,NoArch
78e86a479f9d7ed19cb5d41520156d1da7a75ccf,1,15,4,11,0,0,0,5,6,289,1,1,0,269,11,1,46,44,2,1538,1477,61,7,6,1,1,100,NoArch
eb5b9c06b30c8899d79cad4093a329c35fa78fd4,0,0,0,0,0,0,0,0,0,0,0,0,0,0,12,2,0,0,0,0,0,0,0,0,0,1,100,NoArch
bc95571caade9ceef00abf24e3e6e82fc9643c05,165,8264,1423,6841,48,5,53,1,92,171,11,89,6.201546212,35900,30,1,4210,3567,643,253730,219554,34176,2219,1799,420,1,95.99815157,Arch
7a8b94c82d2f907b67150ea1ce28e966e8cf92a9,3,47,1,46,0,0,0,16,43,44,2,3,1.145114541,1491,135,11,212,210,2,10162,9849,313,103,101,2,1,100,NoArch
f230eca9b5a02d68788875be78c142aa10522fc3,0,0,0,0,0,0,0,0,0,0,0,0,0,0,31,2,0,0,0,0,0,0,0,0,0,0,100,NoArch
c8df9b09d7f532f147e0edc8129081f354ca56d6,2,19,3,16,0,0,0,2,2,1398,1,1,0.574635698,179,1,0,17,14,3,832,743,89,11,10,1,1,100,NoArch
eac1a02a53e6ae501eee986dd75cf1cc907f3fcf,170,1426,8329,6903,5,48,53,0,91,71,11,94,6.231160931,44473,84,6,3791,4439,648,230146,264724,34578,1910,2333,423,1,95.99815157,Arch
b7658bcc84c18225d36ab733b6d0b0978fe68521,0,0,0,0,0,0,0,0,0,0,0,0,0,0,1,1,0,0,0,0,0,0,0,0,0,1,100,NoArch
2b98d909886c34a8a64c520f459cdf9a1a3a9c6c,3,62,10,52,0,0,0,4,9,37,1,2,1.535529302,701,6,2,77,73,4,4347,3876,471,46,45,1,1,100,NoArch
b6fde073961b8ddb5a2175f8ed0d6ea59e5798a4,2,12,0,12,0,0,0,6,18,24,1,2,0.650022422,2659,126,15,190,190,0,20420,20282,138,108,108,0,0,100,NoArch
c39e342b154cd88d1905122d30b8887f8028d204,2,32,14,18,0,0,0,2,5,112,1,2,0.426228657,731,29,4,88,87,1,4066,4015,51,33,33,0,1,100,NoArch
44a85c7ab04fe32aea7ed492d2d9fa3e546c0d94,0,0,0,0,0,0,0,0,0,0,0,0,0,0,30,5,0,0,0,0,0,0,0,0,0,0,100,NoArch
358b43e3b18ea49a09ab83726a55e217c5fdbc06,2,19,3,16,0,0,0,2,2,1398,1,1,0.574635698,179,1,0,17,14,3,832,743,89,11,10,1,1,100,NoArch
f1e3762a947d9bc978beb5bb5ae845b8d5dd6290,166,8301,1409,6892,49,5,54,1,92,179,10,89,6.192315277,37810,12,0,4576,3929,647,266340,232313,34027,2435,2007,428,1,95.23898258,Arch
67ad4992e1dec5b1fe214fb00e6b3c1d21d50b80,1,0,1,1,0,0,0,7,9,18,1,1,0,221,136,12,23,23,0,1578,1587,9,12,12,0,0,100,NoArch
f74cd573201efa31ed71ccda767df0483e36fd56,0,0,0,0,0,0,0,0,0,0,0,0,0,0,84,2,0,0,0,0,0,0,0,0,0,1,100,NoArch
c9bc62629935401e98461b9c49d6a3c98ed7efef,0,0,0,0,0,0,0,0,0,0,0,0,0,0,0,0,0,0,0,0,0,0,0,0,0,1,100,NoArch
4b2fd37fb4e1300b54308d4a68a68f38c24cbf78,1,0,1,1,0,0,0,8,10,506,1,1,0,85,9,2,12,12,0,421,429,8,3,3,0,0,100,NoArch
27628fa1d307563b74f2da7c4b619f98ffb8e1cc,167,1409,8300,6891,5,49,54,0,91,78,10,91,6.192616806,44786,127,16,3941,4588,647,232742,266761,34019,2010,2438,428,0,95.23898258,Arch
6cdcd89afa40a75c95f3c060976ef72f1b2318b6,173,8527,1678,6849,50,5,55,1,92,182,11,91,6.270542113,39325,13,1,4736,4102,634,275065,241625,33440,2492,2069,423,1,92.43218391,Arch
a392e9ba46e4f91bdc520badcf8ed03ac8b49e85,4,171,30,141,0,0,0,4,25,479,2,4,1.225290479,2033,19,0,155,140,15,15736,14660,1076,89,76,13,1,99.97358457,NoArch
4b0111974fa4e7046640c600834d586c6735c708,8,153,51,102,0,0,0,3,49,265,1,4,2.685884816,3021,1,0,365,355,10,18266,17592,674,88,87,1,1,100,NoArch
017ddbbfac0e1039b86cfc3d9fd4497ec95dc947,6,10,10,0,0,0,0,4,5,663,4,6,2.521928095,974,27,3,79,79,0,6212,6212,0,34,34,0,0,100,NoArch
9fe28e56b49c7bf68ae2d83bfe89755314aa793b,4,125,0,125,1,0,1,1,86,14,1,3,1.11367935,3069,4,4,387,378,9,13733,13126,607,361,353,8,1,99.98239747,NoArch
2969fb3835b96dbd31fdbca536e8f370abb264c6,1,31,21,10,0,0,0,5,37,96,1,1,0,585,0,0,68,66,2,2692,2660,32,37,36,1,1,100,NoArch
8a40d955069fc4a70b379e3ded28937ce92a5917,0,0,0,0,0,0,0,0,0,0,0,0,0,0,35,5,0,0,0,0,0,0,0,0,0,1,100,NoArch
12e95771ee415bc005b7fd35d275fbbc177b0727,0,0,0,0,0,0,0,0,0,0,0,0,0,0,36,6,0,0,0,0,0,0,0,0,0,1,100,NoArch
397795c7d03180bbb8e819fc9256453a222f38a2,7,957,119,838,3,0,3,1,30,66,3,7,2.21765664,1943,32,3,277,213,64,17487,11434,6053,143,102,41,1,99.87684729,NoArch
100470a46d943b7840cf300c18a67e0db0c198a6,198,1907,9972,8065,5,54,59,0,91,80,11,106,6.470864398,54185,34,6,4811,5545,734,283596,325478,41882,2352,2839,487,1,92.34515714,Arch
0a4553b73eae36e8610cb6a9f42196b35f02ffd8,4,68,3,65,0,0,0,20,92,76,2,3,1.520950583,3970,128,9,405,397,8,28131,27571,560,186,184,2,1,95.9894806,Arch
209f91cb3374e94f1597e59a82a82d6846c4b994,199,9977,1977,8000,54,5,59,1,92,180,11,104,6.481512492,46970,37,7,5651,4925,726,330163,288841,41322,2868,2383,485,1,93.13369153,Arch
97dab479315c76cab12f0e23243df2dffddb0e8d,199,1975,9975,8000,5,54,59,0,92,79,11,106,6.480807172,54970,35,6,4925,5651,726,288841,330163,41322,2383,2868,485,1,93.13369153,Arch
59cfa4b7e4404456c26c9c8df17182ed6e68ccd1,7,957,119,838,3,0,3,1,30,32,3,7,2.21765664,1944,31,3,277,213,64,17498,11445,6053,143,102,41,1,99.94983517,NoArch
c3fca6d6b5dea09b9581438c89fa5188ecd8f2d2,4,86,14,72,1,0,1,7,13,359,1,2,1.357731956,248,1,0,27,20,7,1339,1072,267,20,13,7,1,99.97137131,NoArch
91253ef05d2af82df2d530c847cd1440956b95e8,1,18,2,16,0,0,0,3,9,222,1,1,0,147,28,1,12,11,1,703,632,71,6,6,0,1,100,NoArch
ab3f9fde98c05a75703022de15dacd87414deb7c,0,0,0,0,0,0,0,0,0,0,0,0,0,0,3,3,0,0,0,0,0,0,0,0,0,0,100,NoArch
195dac90fa89a05ee10ff9b37ad65fdfd07014ef,188,8917,1838,7079,50,5,55,1,92,197,11,99,6.387633825,45108,38,8,5370,4716,654,314121,279171,34950,2726,2289,437,0,93.22234496,Arch
5ce45c440baeb38f57335c1a702ec91b721add65,14,0,0,0,0,0,0,1,1,0,1,4,0,980,41,2,51,51,0,4600,4600,0,38,38,0,1,92.69345095,Arch
7d163ee3de1df456d1b01dabaf4fd9ec0e0c185b,1,7,10,3,0,0,0,11,16,0,1,1,0,481,33,4,35,35,0,3484,3487,3,27,27,0,0,100,NoArch
53f75f84b801f4255407fc8ec3848a85d8078d78,0,0,0,0,0,0,0,0,0,0,0,0,0,0,34,5,0,0,0,0,0,0,0,0,0,1,100,NoArch
5e0171a5ee3b63a3bb3ff28980f43f28bbb00fba,0,0,0,0,0,0,0,0,0,0,0,0,0,0,16,4,0,0,0,0,0,0,0,0,0,1,100,NoArch
822230d9eac051dd9df6bb956f71cb7c99812808,1,6,6,0,0,0,0,16,24,32,1,1,0,346,28,3,55,55,0,2003,1999,4,22,22,0,0,100,NoArch
28b3b6ad8f24b94a0a5db1a4dab3931bf4825510,1,6,5,1,0,0,0,17,29,16,1,1,0,420,1,0,86,86,0,3570,3577,7,60,60,0,0,100,NoArch
d2dda55794ce77e13546ad9d6935bfbb2b120896,0,0,0,0,0,0,0,0,0,0,0,0,0,0,17,3,0,0,0,0,0,0,0,0,0,1,100,NoArch
ed92c217edf3469b1376ed90813bbd44b5661060,1,2,2,0,0,0,0,2,2,1641,1,1,0,110,0,0,19,19,0,587,592,5,7,7,0,0,100,NoArch
75caa7d3d81bc8c76c1af5f3a5404e8d48dd0fcf,2,8,6,2,0,0,0,15,25,803,2,2,0.863120569,718,14,2,97,97,0,4000,3998,2,38,38,0,1,100,NoArch
36a9f63e45b97a37df7e53691625172e2934b605,1,8,4,4,0,0,0,25,55,21,1,1,0,1213,176,1,128,126,2,6534,6500,34,68,68,0,1,100,NoArch
d36533735f5e60a8dc8ed6a7faca276c118c55c7,3,130,5,125,1,0,1,11,19,70,2,3,0.434422741,422,3,0,60,54,6,3993,3020,973,22,18,4,1,99.97892518,NoArch
20e798386684911046a7edef2129fb3496359dda,4,22,4,18,0,0,0,8,56,189,2,4,1.599091974,2230,29,4,259,256,3,12958,12840,118,136,135,1,1,100,NoArch
f18447406dd3305c93e69ff109fe031ff470e2ad,0,0,0,0,0,0,0,0,0,0,0,0,0,0,2,1,0,0,0,0,0,0,0,0,0,1,100,NoArch
3d93e857cc372eb01960fad0cfd7584bbd8b0002,1,10,7,3,0,0,0,12,14,336,1,1,0,85,43,0,6,6,0,550,551,1,4,4,0,0,100,NoArch
3b56320bd8f189786985fd44fcd47e7abd09efb0,0,0,0,0,0,0,0,0,0,0,0,0,0,0,0,0,0,0,0,0,0,0,0,0,0,1,100,NoArch
45f054ffdef568e066a53c63c6e6f8d2b1ee67ea,1,21,9,12,0,0,0,10,15,114,1,1,0,364,177,2,43,43,0,1853,1869,16,43,43,0,1,100,NoArch
a09c2319119d3e1a4cd9200f95e71663da4d7458,4,55,108,53,0,0,0,13,45,37,1,2,1.527676431,2017,18,4,253,255,2,9827,10133,306,158,160,2,1,100,NoArch
caeea946fb592e53d612ff111cee9975d522ca6a,5,13,12,1,0,0,0,2,20,77,2,5,2.062683189,1167,7,3,92,92,0,7168,7145,23,63,63,0,1,100,NoArch
4bea7587384842ac82590b0a9e785b8f73690885,9,347,38,309,2,0,2,19,31,126,4,8,2.485957067,2850,15,3,347,324,23,20835,19264,1571,197,180,17,1,92.12972526,Arch
7647562dad9e0615273bd76f75e7280f5ae7b7ce,7,597,46,551,0,0,0,6,87,40,2,5,2.054467558,5260,5,3,705,635,70,32596,28550,4046,504,478,26,1,99.98987034,NoArch
1d3049540f2b9d36a81ff720e55d9db9f8151fd6,227,2085,10134,8049,5,53,58,0,92,70,11,111,6.608858674,62340,129,10,5758,6514,756,334869,376252,41383,2870,3353,483,1,89.76100629,Arch
db93ad2f4bc9b3c357f065882c3d8cbb1c0b9c07,228,10136,2087,8049,53,5,58,1,92,166,11,109,6.610683592,54422,44,1,6528,5771,757,377281,335892,41389,3356,2873,483,1,89.76100629,Arch
101be1a0139ad550a509cf3d2c2a101ea62930b4,228,2082,10127,8045,5,53,58,0,92,71,11,112,6.60721131,62471,175,1,5773,6528,755,335926,377281,41355,2873,3356,483,1,89.76100629,Arch
a8ee57f3ea1f9a47d42d92ab508025aa968e26e7,2,129,4,125,1,0,1,11,19,82,2,2,0.328041566,333,1,0,51,46,5,3609,2649,960,15,11,4,1,99.97138974,NoArch
f28ea4d5a94d93d8fa7dd562e927b110312459c1,1,21,9,12,0,0,0,10,15,63,1,1,0,364,176,2,43,43,0,1853,1869,16,43,43,0,1,100,NoArch
6df46394eec649658d355c4df4ca0acb77467db4,5,17,13,4,0,0,0,7,19,79,2,5,2.16753028,1162,7,3,91,91,0,7136,7090,46,63,63,0,1,100,NoArch
5dada430ec3b2e34cd64b2f589163cebcf51c469,1,0,125,125,0,1,1,2,2,0,1,1,0,125,0,0,0,5,5,0,956,956,0,4,4,0,99.97138974,NoArch
b670801afc110870f354766c872f386d18261add,0,0,0,0,0,0,0,0,0,0,0,0,0,0,1,1,0,0,0,0,0,0,0,0,0,0,100,NoArch
a08a2b730674d57a0c40545023b21f0bac34e7df,223,10087,2058,8029,53,5,58,1,92,177,11,106,6.58443947,52963,35,6,6391,5636,755,368511,327190,41321,3259,2776,483,0,89.76100629,Arch
31b57a256fcda477f7fda7a34c8d50b0255de6b2,0,0,0,0,0,0,0,0,0,0,0,0,0,0,19,5,0,0,0,0,0,0,0,0,0,1,100,NoArch
b7a79aa94301a80c396476878fadeea5debb799a,2,18,8,10,0,0,0,33,62,313,1,1,0.51594693,973,45,2,117,116,1,5712,5661,51,34,34,0,1,100,NoArch
14d08bb64c4bea20a692b3d3bced5cc9800cd541,1,1,1,0,0,0,0,33,88,3,1,1,0,2355,46,3,330,330,0,9966,9966,0,315,315,0,0,100,NoArch
a66004a34072766674c56082edb1962ee61b2e83,1,4,76,72,0,0,0,10,12,104,1,1,0,425,47,4,26,34,8,2904,3580,676,16,17,1,1,99.69644845,NoArch
2071e3bfdaedff7b77925b7d0fd002d1138d7f0c,0,0,0,0,0,0,0,0,0,0,0,0,0,0,39,7,0,0,0,0,0,0,0,0,0,1,100,NoArch
79bf6ab00bc4f964448f1f62d0b8e1f9ef3a58b9,1,21,26,5,0,0,0,6,8,107,1,1,0,147,6,3,16,14,2,836,859,23,8,8,0,1,100,NoArch
8547f11752bca1462f61c1042ef7b44bc7078e51,0,0,0,0,0,0,0,0,0,0,0,0,0,0,30,5,0,0,0,0,0,0,0,0,0,1,100,NoArch
4b9085057a30c557fc2fe2436743cad5b9362f6f,0,0,0,0,0,0,0,0,0,0,0,0,0,0,36,6,0,0,0,0,0,0,0,0,0,1,100,NoArch
64b1426005c9a1dea678c94c4b00d5e9b3ad8a78,0,0,0,0,0,0,0,0,0,0,0,0,0,0,178,2,0,0,0,0,0,0,0,0,0,0,100,NoArch
56cd8ffae0aa1dc92633ebe880a5188cb9e74f5c,10,285,39,246,0,0,0,11,54,325,2,7,2.602897024,3999,31,4,406,392,14,25712,24106,1606,235,225,10,1,99.88891133,NoArch
e72553accf9626ecfddeebe27ff2c9a5f33fc154,0,0,0,0,0,0,0,0,0,0,0,0,0,0,137,4,0,0,0,0,0,0,0,0,0,1,100,NoArch
f7a77961e3654ad2574e1c18609228816266fadc,0,0,0,0,0,0,0,0,0,0,0,0,0,0,138,4,0,0,0,0,0,0,0,0,0,2,100,NoArch
cfde45b548fe5c425c0415e45993d4bbec1a1c5a,0,0,0,0,0,0,0,0,0,0,0,0,0,0,32,5,0,0,0,0,0,0,0,0,0,1,100,NoArch
e00a9042e9a4e97f6f8ccaed4ac51a9aa8c2da76,8,205,24,181,0,0,0,8,31,103,1,8,1.634141883,3990,139,4,330,309,21,30121,28800,1321,151,142,9,1,100,NoArch
7bd389fb4756193cbe22576911e51da863d1c345,2,6,6,0,0,0,0,7,44,110,2,2,0.650022422,1094,7,3,115,115,0,6335,6336,1,38,38,0,0,100,NoArch
87db4ded426ee7422712d8fdeef6004c88ddeca7,1,3,3,0,0,0,0,4,6,45,1,1,0,172,1,0,16,16,0,1239,1233,6,2,2,0,0,100,NoArch
1f7b6b215497c98efa275fc16c96b275daaa9390,3,235,8,227,1,0,1,5,14,67,1,2,0.412803031,829,33,6,81,68,13,8217,6593,1624,44,38,6,1,99.97982244,NoArch
6f1010799861b9e4b331d0bf5a473211200c15d1,0,0,0,0,0,0,0,0,0,0,0,0,0,0,0,0,0,0,0,0,0,0,0,0,0,1,100,NoArch
bc7882cbe924ce8000f4a738b8673fe7a5cf69fb,9,247,228,19,1,1,2,10,89,110,1,6,2.552393395,4967,16,4,543,559,16,26924,27822,898,445,455,10,2,99.95965302,NoArch
26c3f797b0fda964cf601836d6314ff6241e9d5d,0,0,0,0,0,0,0,0,0,0,0,0,0,0,20,4,0,0,0,0,0,0,0,0,0,1,100,NoArch
bf409e84239a0e27de86a7a1fb1613ba228955b9,0,0,0,0,0,0,0,0,0,0,0,0,0,0,10,1,0,0,0,0,0,0,0,0,0,0,100,NoArch
920f45926a3112b6d045ca3b434bc7c4e55e5e3c,0,0,0,0,0,0,0,0,0,0,0,0,0,0,140,3,0,0,0,0,0,0,0,0,0,1,100,NoArch
78e6ab0e677679ba76b7630fb9494297aa60c54a,0,0,0,0,0,0,0,0,0,0,0,0,0,0,17,3,0,0,0,0,0,0,0,0,0,1,100,NoArch
9363804b1de4d3d249d77d02953219c1e7b25bcb,1,3,1,2,0,0,0,2,2,1443,1,1,0,95,141,4,8,8,0,276,267,9,8,8,0,0,100,NoArch
84fb390e42cbbb72d1aaf4cf8f44cd6fba049595,242,2415,11052,8637,6,55,61,0,92,66,11,114,6.738487595,68054,2,2,6113,6904,791,372924,418030,45106,3022,3524,502,0,89.75389252,Arch
dd4ce1bdfd59cd386437169856201476df68ffa7,242,11054,2417,8637,55,6,61,1,92,173,11,111,6.738753593,59417,142,5,6904,6113,791,418030,372924,45106,3524,3022,502,1,89.75389252,Arch
f87c47352aab70883777d80e353f9833e5aa1caa,15,745,138,607,0,0,0,12,45,110,3,9,2.372920887,5667,29,0,554,511,43,40905,37153,3752,303,288,15,1,89.98611937,Arch
3f21e5f14c5aeda53d25416cae16f866a7e2f7f0,1,2,1,1,0,0,0,1,2,396,1,1,0,67,143,6,6,6,0,237,228,9,6,6,0,0,100,NoArch
4a9f8263822200877c8ac7714aa5dbd946db7cdc,1,23,5,18,0,0,0,8,9,54,1,1,0,126,21,5,19,16,3,681,636,45,8,7,1,1,100,NoArch
0bd38f26ca4076dc45ee1cba4f8525550b96ce40,68,216,175,41,1,0,1,2,50,330,3,27,5.457965945,14226,85,0,1181,1180,1,91901,91833,68,567,566,1,1,97.53099068,Arch
2b52a569819a1a21becdb95e6183655b582671d4,0,0,0,0,0,0,0,0,0,0,0,0,0,0,40,1,0,0,0,0,0,0,0,0,0,1,100,NoArch
e78b2f1b5572fd1c0b5a549bf5cd4772531399ec,3,57,0,57,0,0,0,20,93,49,1,2,1.221269258,3542,41,2,373,366,7,24986,24484,502,162,160,2,1,100,NoArch
c0e8b03d93223777bd1e8e5c9dbb7edcb9e37e47,1,15,10,5,0,0,0,5,5,432,1,1,0,158,1,0,23,22,1,942,850,92,8,8,0,1,100,NoArch
ed7aa138e80d6fefab58951dde42c404ccca2ece,1,2,0,2,0,0,0,43,94,0,1,1,0,875,1,0,99,99,0,5494,5469,25,25,25,0,0,100,NoArch
ecbad9526ae2c4531c00618f178fd34e10a21db3,0,0,0,0,0,0,0,0,0,0,0,0,0,0,22,5,0,0,0,0,0,0,0,0,0,1,100,NoArch
d3cfe07436fcf671f8f9bea12251fad2452391b6,0,0,0,0,0,0,0,0,0,0,0,0,0,0,18,3,0,0,0,0,0,0,0,0,0,1,100,NoArch
4b388c104e024f32ae0705f6627e48b72b3408b4,1,1,1,0,0,0,0,12,16,38,1,1,0,706,144,7,38,38,0,3249,3249,0,38,38,0,1,100,NoArch
7ce0f4522b54c73d6d7461b6a5bfdf426e61e9a0,2,53,1,52,0,0,0,21,55,65,1,2,0.445064857,2103,5,0,180,175,5,15970,15528,442,112,110,2,1,100,NoArch
f140c58d9e137a7111b7a53c4bcb8faef50fa8e4,1,5,3,2,0,0,0,3,3,13,1,1,0,133,145,8,8,7,1,735,720,15,3,3,0,1,100,NoArch
4e61e5c9ea100c9ff4c511f86fc89bbfafa044f1,1,1,1,0,0,0,0,14,24,22,1,1,0,646,146,9,46,46,0,2608,2608,0,38,38,0,1,100,NoArch
16138db4f25eb3e47c88cc03e3f245eb0ba5f71a,0,0,0,0,0,0,0,0,0,0,0,0,0,0,147,10,0,0,0,0,0,0,0,0,0,2,100,NoArch
72f7348830a5a2ca320720d34d12f8317e11ceff,0,0,0,0,0,0,0,0,0,0,0,0,0,0,30,1,0,0,0,0,0,0,0,0,0,1,100,NoArch
caef3d5c58820ac5828fb74e5ac6aaae8c9e845f,2,76,121,45,0,1,1,4,10,190,2,2,0.977109456,495,86,1,25,34,9,3782,3759,23,11,15,4,1,99.95680812,NoArch
a68e1dc2dba475b9a63779f3afa0b5c558a7cd3b,45,1613,670,943,7,0,7,11,90,319,5,24,4.389418936,15665,19,3,1698,1647,51,97271,92966,4305,1133,1087,46,1,91.08852382,Arch
819e8018ff926fea21c95e75ae1b7991afb227c2,18,175,190,15,0,0,0,17,41,340,2,13,3.297991553,8360,20,4,906,915,9,58178,58783,605,480,480,0,4,100,NoArch
d681824982c1af64e894725d3678da33110d6ccd,3,45,21,24,0,0,0,10,19,145,2,3,1.220054451,983,21,5,105,99,6,5600,5479,121,39,39,0,1,100,NoArch
5927bdd1c0fab202474af47b9e035680b345c563,48,2180,511,1669,2,0,2,3,91,260,2,22,4.264488365,15568,31,2,1707,1518,189,99121,88845,10276,990,911,79,1,91.16283562,Arch
69dfcda116584c59983f682253998f2c5b0dce6e,21,467,195,272,1,0,1,3,31,193,3,7,3.102575354,4979,22,6,412,391,21,33999,32806,1193,201,192,9,1,99.93866912,NoArch
b8601a9f58ae4dc5099cc7f828df7fd8d0aeb798,105,564,504,60,1,0,1,14,95,215,9,69,6.105932475,32839,37,1,2711,2711,0,220819,220297,522,1446,1447,1,1,90.54798492,Arch
0880a8a5e453bd146c0cbcb7e26cc8ee6c2560cc,0,0,0,0,0,0,0,0,0,0,0,0,0,0,0,0,0,0,0,0,0,0,0,0,0,1,100,NoArch
de206acbae06f733ba14cec2650eef9a0139db7a,4,249,48,201,0,0,0,17,39,565,2,3,1.321733609,1629,8,0,182,147,35,13980,12605,1375,65,57,8,1,100,NoArch
538db185cad6274d4e5083afc7d583aba13c78cd,4,15,5,10,0,0,0,44,96,46,3,3,1.860964047,1598,0,0,157,155,2,10143,10026,117,51,51,0,1,100,NoArch
24f738fe68d03fa15755d8a53aeb6e25921c6e94,5,92,16,76,1,0,1,13,97,113,1,3,2.208392,1880,148,8,234,223,11,12075,11662,413,65,62,3,1,93.88575152,Arch
773b3179834d6e0d2912a7a9d4b3b3873d0c2a21,7,35,37,2,0,0,0,11,40,188,5,7,2.155872586,2911,9,0,272,272,0,16445,16446,1,140,139,1,1,100,NoArch
3f263b82ce6687a8275419ce53ba23348561bdcb,7,440,390,50,1,0,1,16,32,36,1,4,2.091574841,2626,23,7,265,264,1,16329,16194,135,106,108,2,1,93.00307865,Arch
3bd8fc1c3eb1d647d4f181b20fd54c6860cf24dc,1,7,12,5,0,0,0,1,2,564,1,1,0,90,24,0,2,2,0,375,413,38,2,2,0,1,100,NoArch
8ab6f17149e7edbdc80351bdf0d2e5c4c4a33908,2,26,0,26,0,0,0,45,98,88,2,2,0.779349837,1130,2,0,163,160,3,7561,7284,277,45,44,1,1,99.95314404,NoArch
0ab1a8ec80fcf3432846f12c40eff9b66992d87f,3,16,6,10,0,0,0,3,11,323,1,2,1.381460855,658,149,8,95,94,1,3909,3834,75,77,76,1,1,100,NoArch
1636876e8aa7a97c9982268a9fcecfb8f1f6e6ed,2,519,1,518,1,0,1,27,40,111,1,1,0.036393403,496,9,1,131,65,66,6252,3364,2888,48,26,22,1,100,NoArch
ab730479587c3fc7588e267ae07f83bb0631ef32,2,7,6,1,0,0,0,2,14,1780,1,2,0.89049164,168,150,9,9,9,0,791,769,22,4,4,0,0,100,NoArch
6a32cfe0201bd84ad9199af76a585d4b5a3a54d7,3,4,4,0,0,0,0,8,13,72,1,3,1.5,1020,151,10,62,62,0,4871,4871,0,50,50,0,1,100,NoArch
60831d69060aeb8f112fd7aff9c9323cd213ddb2,4,75,45,30,0,0,0,1,16,88,1,3,1.935259825,589,152,11,41,38,3,3848,3417,431,15,15,0,1,100,NoArch
973087f385f0e42bd42e2d57008a756e182041ff,8,142,45,97,1,0,1,19,33,1,1,3,2.187426848,2070,24,6,254,242,12,12516,12143,373,102,90,12,1,99.79375645,NoArch
464027ec375b375475999c78c56612506753f77e,5,382,64,318,1,0,1,1,5,43,2,4,1.114672038,699,25,7,89,76,13,5352,3779,1573,53,44,9,1,91.19610128,Arch
b3b44236fe031f84e99008eed85e14ec4519e40f,10,65,23,42,0,0,0,7,50,416,1,7,3.049921266,3086,179,0,213,212,1,16780,16583,197,144,142,2,1,100,NoArch
0ababcfaa7c8cb34c399c0da57202fd48676f5d2,10,204,18,186,0,0,0,4,92,49,1,6,2.878678611,8863,153,9,835,810,25,53308,52064,1244,633,622,11,1,100,NoArch
e7ec3a82dc274b8d683d74e59ee7bf35d7827ce0,15,272,25,247,2,0,2,7,47,193,2,10,2.994220051,7520,154,10,753,730,23,48855,47271,1584,474,460,14,1,99.87827145,NoArch
d971974063411597bdb5633e71a7e26688b2b136,2,41,41,0,0,0,0,8,32,32,1,2,0.993123177,746,23,1,101,102,1,4431,4454,23,43,44,1,1,100,NoArch
1c778590d1a7a7eb744432e59b4947bb6af30431,3,30,10,20,0,0,0,4,40,571,1,2,1.425574164,1075,24,0,102,101,1,8917,8720,197,33,32,1,1,100,NoArch
2fe7a3a41f36f0dcbbc89e4dbe51b70f2de997db,3,12,0,12,0,0,0,15,23,39,2,2,1.584962501,918,24,2,103,101,2,6055,5945,110,31,31,0,1,100,NoArch
ba4e732ba75e12a02d07c09f2662678bdcafbdc2,7,65,17,48,0,0,0,2,28,354,4,5,2.579222994,1297,155,11,140,133,7,7857,7511,346,76,71,5,1,90.08097166,Arch
10474e09625dc863f9b2cbd6078d0a9b72c36fd6,1,1,1,0,0,0,0,11,12,26,1,1,0,375,25,3,22,22,0,1593,1593,0,22,22,0,1,100,NoArch
b431246710f37def64b28ea26923ef5602404d24,0,0,0,0,0,0,0,0,0,0,0,0,0,0,26,4,0,0,0,0,0,0,0,0,0,1,100,NoArch
89ed6f062eead82f441c695e027bbbd67a272dfc,3,30,7,23,0,0,0,8,41,26,3,3,1.206847832,803,25,1,91,90,1,6401,6226,175,34,33,1,1,100,NoArch
9518f786102566398fa20001533d5d86f68deb5b,1,2,1,1,0,0,0,14,16,14,1,1,0,93,0,0,7,7,0,613,596,17,4,4,0,1,100,NoArch
ce9762d588800daa71db5bded8b68f755aa5ba17,1,0,2,2,0,0,0,14,17,0,1,1,0,94,48,0,7,7,0,606,613,7,4,4,0,0,100,NoArch
6aba00e84fade0b800e2d73c2f16be948af48d54,44,129,116,13,0,0,0,4,42,282,5,32,5.117174546,13627,38,1,1060,1060,0,100090,100090,0,518,518,0,0,100,NoArch
55777fec0519c1aa26a4bd4415d545b658dfec29,6,75,2,73,0,0,0,3,99,255,1,4,1.725204536,4288,1,0,430,423,7,29991,29472,519,203,198,5,1,100,NoArch
76e2faa28dc1050e9e6ebe5b33dac1972b781eba,16,119,99,20,0,0,0,27,51,58,6,12,3.778095649,7273,10,2,750,750,0,50833,50438,395,340,339,1,1,100,NoArch
93ee09fee879b922ff011e04dbbb54194fac481b,1,7,13,6,0,0,0,4,4,773,1,1,0,108,3,0,23,24,1,480,516,36,14,15,1,1,100,NoArch
94806d5cf7650976892c24d7e77c3bba22cee53d,0,0,0,0,0,0,0,0,0,0,0,0,0,0,34,0,0,0,0,0,0,0,0,0,0,1,100,NoArch
5ca4480a3818ba9192780a40941abbef44c75dc3,1,1,1,0,0,0,0,19,32,180,1,1,0,1151,32,0,101,101,0,6017,6017,0,66,66,0,1,100,NoArch
0db1e978c6c26e7bdcbbaa5f048e0e11e6dee073,1,23,0,23,1,0,1,1,1,0,1,1,0,0,42,0,0,0,0,25,0,25,0,0,0,1,99.9862164,NoArch
bcfd8efe66c4429ac8eabf82f87309019760234c,1,4,0,4,0,0,0,5,6,140,1,1,0,206,87,1,23,22,1,690,675,15,12,12,0,0,100,NoArch
e639d993873913805de1ebd286f1e8a791ef6a24,0,0,0,0,0,0,0,0,0,0,0,0,0,0,0,0,0,0,0,0,0,0,0,0,0,1,100,NoArch
0a97a9893a0425ed54c911b48d6e070f1d947311,2,63,16,47,0,0,0,4,17,161,1,2,0.614571561,728,11,3,103,98,5,4145,3842,303,33,30,3,1,100,NoArch
3b401d839c1a3a5a8060f671b13df71b76bf88ac,2,32,5,27,0,0,0,21,48,6,1,2,0.98678672,1201,27,4,160,155,5,6708,6503,205,81,80,1,1,100,NoArch
27bd7b538e46524d6863e36e334b4a6da665ed32,15,327,127,200,2,0,2,1,93,41,2,9,3.309727313,8759,88,2,983,962,21,53272,52275,997,645,632,13,1,99.89665151,NoArch
cb6ca7f0d1d57b7c7eb850015f3bfe75cacf542a,9,113,63,50,0,0,0,7,55,119,3,7,2.960940079,3286,28,5,349,342,7,18899,18607,292,185,183,2,1,100,NoArch
fe02c64fea7e2393255ff32f161b624367d12b7a,0,0,0,0,0,0,0,0,0,0,0,0,0,0,29,6,0,0,0,0,0,0,0,0,0,0,100,NoArch
538ec44fa8a23926b584c3bcdd24feb9894d4c51,12,199,11,188,3,0,3,5,94,104,3,6,2.840484418,4603,89,3,594,574,20,21623,20963,660,443,433,10,1,99.93114844,NoArch
9a05940a74c7258e6ca9810473e4beeb4d43dcd7,24,239,138,101,0,0,0,2,57,49,5,16,3.522163189,13265,39,2,914,901,13,104139,103770,369,472,471,1,1,99.96559791,NoArch
3363c664681b8b58238d54776671428fbaac3365,4,14,5,9,0,0,0,2,7,146,1,2,1.799015671,703,12,4,56,55,1,3655,3647,8,32,32,0,1,100,NoArch
aaddaf524a07daa1ffad6d6f5e04f6b130e5b069,26,827,1091,264,3,3,6,16,34,36,3,8,4.083150782,5817,26,4,517,580,63,32232,34999,2767,265,300,35,1,99.90370727,NoArch
ba0afe142672b61d291a7cc8ac3a85394e90af7d,1,4,2,2,0,0,0,14,26,19,1,1,0,668,42,0,48,48,0,2758,2748,10,39,39,0,1,100,NoArch
433c2573ef5d1f25cba42f169679a4afe5ff2e24,1,1,2,1,0,0,0,6,10,38,1,1,0,117,1,1,4,4,0,493,509,16,4,4,0,1,100,NoArch
2844a77b43cfe4926f3a67d17695be1d6c141ba3,0,0,0,0,0,0,0,0,0,0,0,0,0,0,180,1,0,0,0,0,0,0,0,0,0,1,100,NoArch
ed106f671e929d2a6277ae189242201a02a7b58f,16,311,35,276,2,0,2,12,38,254,3,11,3.407387346,5142,43,1,465,434,31,34876,32907,1969,240,226,14,1,99.96563574,NoArch
de8161ae96c4cec1e4c9e40069f286439f0c3261,1,3,2,1,0,0,0,8,9,42,1,1,0,131,2,0,14,13,1,743,737,6,4,4,0,0,100,NoArch
fba5822ee34167b07e65eefc63d7e3d43abd9387,4,44,16,28,0,0,0,35,66,9,2,2,1.819055884,1238,40,2,157,149,8,6713,6532,181,52,51,1,1,100,NoArch
5009138d044b4d859237f0f581aeeb71065dc526,5,26,4,22,0,0,0,3,19,220,2,5,2.220651215,1825,4,1,160,156,4,10043,9943,100,85,85,0,1,100,NoArch
f15125c0cd6e7d2ec1acfaa1d6a814793f03c853,13,16,802,786,0,6,6,5,51,131,1,5,2.440962439,3245,0,0,203,311,108,13736,17407,3671,83,181,98,1,99.89004192,NoArch
83279971a183c68225dde737149467624f915c2e,8,197,126,71,0,0,0,4,21,305,3,4,2.114498794,1675,0,0,191,187,4,10059,9810,249,79,70,9,1,100,NoArch
66ac1446dd0688968a4991e92abfa38ad92a3d1d,2,7,7,0,0,0,0,2,15,36,1,2,0.863120569,169,156,8,9,9,0,791,791,0,4,4,0,0,100,NoArch
0938f55a2b033745b5e2dafad8ce31e60bb394ac,10,31,30,1,0,0,0,2,10,430,1,6,3.160842039,1159,90,3,69,69,0,7687,7579,108,37,37,0,1,100,NoArch
359fbfde798b50edc06ee1d0520efcd971a289bc,12,786,9,777,4,0,4,11,95,81,3,10,2.326275811,5270,13,5,769,671,98,33820,29266,4554,566,488,78,1,99.93815708,NoArch
76b6ad649135ec0ed425c3c173d91f1e0ce67c5d,0,0,0,0,0,0,0,0,0,0,0,0,0,0,43,1,0,0,0,0,0,0,0,0,0,1,100,NoArch
17cb5cb43377746763722a8f96741e7d521a702d,1,2,0,2,0,0,0,7,24,32,1,1,0,2578,157,8,187,187,0,19890,19879,11,105,105,0,1,100,NoArch
d36fe24c9e5cbd5a20d14818671c28eca6f364ff,2,16,4,12,0,0,0,2,17,27,1,2,0.721928095,321,158,9,18,17,1,2011,1887,124,10,10,0,1,100,NoArch
bf16bc122a2135ad3bc3f84d55a91f25d2543d55,7,202,31,171,1,0,1,5,96,220,3,6,1.764633822,5363,20,0,546,533,13,31754,30410,1344,426,422,4,1,99.98626751,NoArch
801fdab55c97d1abd815f90ae64c0ecbe8e84f94,3,59,21,38,1,0,1,4,4,98,1,1,1.259572228,131,5,2,7,7,0,790,764,26,6,6,0,1,99.98627128,NoArch
0c950181aabc371caa9a1508a8086ec931d763ae,0,0,0,0,0,0,0,0,0,0,0,0,0,0,30,7,0,0,0,0,0,0,0,0,0,1,100,NoArch
0dee8edc9741ee99e1e2bf98efd9673003fcb1e7,7,118,15,103,0,0,0,8,97,219,2,6,2.028612444,6635,46,0,668,661,7,38197,37501,696,498,495,3,1,100,NoArch
7e1ea06eb98419af74385fe967bcbdf1fe3ca953,1,19,14,5,0,0,0,8,26,55,1,1,0,498,41,3,41,41,0,2003,1983,20,38,38,0,0,100,NoArch
14dbbdf4c7a45ab5a10889f8e558984455315829,3,61,2,59,0,0,0,22,100,22,1,2,0.541173085,3267,159,9,317,311,6,24427,23910,517,166,161,5,1,100,NoArch
4d1f74ebeaee857380f69d7c596eaaf0135ca59e,2,59,22,37,1,0,1,2,2,118,1,2,0.967988492,99,49,1,9,6,3,606,550,56,5,3,2,1,99.96569704,NoArch
4affdd0c8f02ccca4705515dcb6492c199e2cede,3,49,19,30,0,0,0,2,57,105,2,3,1.498751273,1712,181,2,248,246,2,8822,8764,58,130,126,4,1,100,NoArch
b87e95d621e9fd2d1aebca4c49f599b6437aaf83,0,0,0,0,0,0,0,0,0,0,0,0,0,0,182,3,0,0,0,0,0,0,0,0,0,1,100,NoArch
9678c3fbcf7e0de0fc84f2f50badac626d02a7ed,1,2,2,0,0,0,0,4,8,41,1,1,0,181,160,8,17,17,0,1360,1352,8,2,2,0,0,100,NoArch
01cbddef78f5c66c15f22937f078dd7dbde203e8,0,0,0,0,0,0,0,0,0,0,0,0,0,0,0,0,0,0,0,0,0,0,0,0,0,0,100,NoArch
dabae8042386503bd16d4c5e3a3bf836125f2f7e,0,0,0,0,0,0,0,0,0,0,0,0,0,0,33,1,0,0,0,0,0,0,0,0,0,1,100,NoArch
4e8accc179d8f60c874d748167018196900b7d12,1,10,10,0,0,0,0,7,11,28,1,1,0,492,42,4,51,51,0,3018,2988,30,28,28,0,1,100,NoArch
2a93b8efb278bcb4463f88660b21824f7cfc902f,0,0,0,0,0,0,0,0,0,0,0,0,0,0,44,2,0,0,0,0,0,0,0,0,0,1,100,NoArch
62605be413b72e1b476367e86a481178c740efc1,0,0,0,0,0,0,0,0,0,0,0,0,0,0,161,8,0,0,0,0,0,0,0,0,0,2,100,NoArch
943b99775b7b0cf4340a9af76b6dd235cf91e350,1,1,1,0,0,0,0,3,8,248,1,1,0,119,0,0,12,12,0,672,672,0,6,6,0,1,100,NoArch
521338b4d9fafb4f1f43c45be30d6ee1dc3d298f,0,0,0,0,0,0,0,0,0,0,0,0,0,0,10,0,0,0,0,0,0,0,0,0,0,1,100,NoArch
85e8a5c4de8fa59b769676149060eca13809cba6,22,300,215,85,0,0,0,1,33,212,4,11,3.306066539,5454,27,1,604,596,8,33809,33380,429,313,310,3,1,99.50481617,NoArch
aa1810d73766937426690f296e2889f314c43f36,0,0,0,0,0,0,0,0,0,0,0,0,0,0,11,1,0,0,0,0,0,0,0,0,0,1,100,NoArch
36944856096c8ae2085bf0dbd9c635eb5cc750e1,3,253,5,248,1,0,1,1,43,94,1,2,0.99631437,619,14,4,81,68,13,6558,4921,1637,30,21,9,1,99.98658078,NoArch
45d1216e91babcfb92470a7b5c314fefa27fce0d,0,0,0,0,0,0,0,0,0,0,0,0,0,0,1,0,0,0,0,0,0,0,0,0,0,1,100,NoArch
a4ee7463aee936b6160e529814016a7cb2f06694,1,101,0,101,0,0,0,3,10,45,1,1,0,237,183,3,19,19,0,1575,1575,0,10,10,0,1,100,NoArch
742810070bf43bbc13f22ee5514dd997c27b1db2,4,258,12,246,0,0,0,18,33,154,2,4,0.738234683,4372,15,5,446,432,14,36351,34456,1895,234,231,3,1,100,NoArch
b50f4b491c969675d00cec9655f70855de4db88a,11,120,244,124,0,2,2,10,22,100,1,8,2.857819332,2054,91,4,159,163,4,14169,15083,914,105,107,2,1,99.91270481,NoArch
92cdc5987a2b5a6faecec96224f545ab49ee6ef2,3,68,5,63,0,0,0,16,98,23,1,3,1.236878417,3518,0,0,435,431,4,19658,19215,443,370,367,3,1,100,NoArch
6a5cfb45b9f4784757d2f2d49495d72e23375309,2,3,3,0,0,0,0,13,19,66,1,2,0.918295834,858,44,2,60,60,0,7109,7096,13,40,40,0,0,100,NoArch
1379300b5b4357243ab7279f9a39011296731741,4,131,48,83,1,0,1,10,14,150,1,3,1.315306012,928,162,6,138,127,11,6281,5829,452,88,83,5,1,99.98655914,NoArch
c77b2591d057fdc1c014a80284024e19254e3606,14,99,113,14,0,1,1,13,42,424,4,12,3.214915074,2388,92,5,184,182,2,12641,12530,111,110,108,2,1,97.9566963,Arch
2f99e8458ac3cd51000227fce90576e8e1e056be,3,6,6,0,0,0,0,2,19,129,1,2,1.584962501,462,163,7,38,38,0,3130,3106,24,14,14,0,1,100,NoArch
d5444ff7ff832a2e14b5c78449713fdf82bcaec4,2,2,1,1,0,0,0,12,15,209,1,1,0.918295834,333,164,8,45,45,0,1301,1291,10,29,29,0,1,100,NoArch
193215201cfff5f686a70d5054c0a3a3d91d25a6,1,1,1,0,0,0,0,3,6,53,1,1,0,268,1,1,25,25,0,1217,1217,0,15,15,0,0,100,NoArch
4a59876c8b6045fad55777c5eb241ef5d5aa401b,11,340,61,279,0,0,0,5,25,251,1,7,2.803399491,2767,165,9,290,260,30,21339,18920,2419,132,121,11,1,100,NoArch
8f1e4f5b3e4e32e34f98191abb475f95f3690390,2,43,2,41,0,0,0,3,6,30,1,2,0.894451885,255,1,1,46,38,8,1632,1353,279,29,26,3,1,99.26089008,NoArch
05e395ae5f56ca2e99e3e5e0838c14da74d2eedd,1,21,16,5,0,0,0,18,29,77,1,1,0,504,43,4,61,61,0,2558,2567,9,22,22,0,1,100,NoArch
18dc89cf7908e000a545acf4aa161c242c415dd5,2,38,1,37,1,0,1,1,20,140,1,2,0.477071306,121,25,0,12,9,3,805,664,141,6,5,1,1,99.98390212,NoArch
44b8ab6048feac431d2c22a5762872bb4d16d86c,4,12,4,8,0,0,0,6,78,433,3,4,1.75,1491,34,1,128,128,0,7565,7523,42,94,94,0,1,100,NoArch
257052a94d4e177bdf7269e000a8e02e94a20e90,4,424,79,345,1,0,1,1,22,41,2,4,1.090447494,1105,44,5,184,148,36,7938,6088,1850,79,59,20,1,99.96781202,NoArch
f7088a957c1381ceb4ee1ac613292cfc07938032,3,447,18,429,2,0,2,2,3,47,1,1,0.731777973,589,166,10,104,52,52,5195,2871,2324,28,16,12,1,99.92759453,NoArch
a81a6326d5e61b18b804632a8b6411906291d23c,3,159,3,156,2,0,2,1,44,4,1,2,1.471409115,513,12,2,74,67,7,5136,4270,866,23,19,4,1,99.91155423,NoArch
3fdc9332e58930aa8e4fef0d0f85ffbec78c6e7b,14,452,217,235,0,0,0,15,36,189,3,8,3.407268471,7740,2,2,594,578,16,54372,53429,943,257,243,14,1,90.34657798,Arch
3cfb52c413b49840f17d00e2ee6be7d4224a0ac1,5,88,15,73,0,0,0,2,52,420,1,5,1.707604739,2354,2,2,187,181,6,14074,13629,445,130,124,6,0,100,NoArch
3b2da9f13847475be3dcef13b3d25df8818cecc7,2,30,6,24,0,0,0,5,14,312,1,2,0.943601631,319,35,2,31,29,2,1712,1583,129,16,14,2,1,88.80229696,Arch
85f47b53df9eb676565ced6205a980cba60e410d,11,141,105,36,0,0,0,5,26,139,5,8,1.344336362,4662,28,2,370,367,3,36314,36174,140,194,192,2,1,100,NoArch
10d866f083248d37923d694165e362a21f3d529d,14,321,11,310,3,0,3,8,67,99,2,10,2.629665596,3908,20,0,295,269,26,22662,20761,1901,177,163,14,1,99.91215548,NoArch
1d57bd17c2da860df1d5f03e1bb8c181ae7bfa14,5,36,14,22,0,0,0,4,12,0,2,4,2.080887219,669,184,4,49,49,0,3428,3403,25,29,29,0,1,100,NoArch
f8945eca088ec0c87cc6ecb6a8a3536ab02c0bf4,0,0,0,0,0,0,0,0,0,0,0,0,0,0,167,11,0,0,0,0,0,0,0,0,0,0,100,NoArch
527bd34b1c5b757c6e13236455888797ac6d5b45,0,0,0,0,0,0,0,0,0,0,0,0,0,0,28,0,0,0,0,0,0,0,0,0,0,0,100,NoArch
907e60c252e80be5ef3a848d773e0f866eb609f9,3,44,19,25,0,0,0,9,21,325,1,3,1.169637878,825,21,1,73,67,6,5771,5541,230,38,36,2,1,100,NoArch
51ee5005a63da7f2c7677c80bec50f9729e13685,0,0,0,0,0,0,0,0,0,0,0,0,0,0,32,0,0,0,0,0,0,0,0,0,0,1,100,NoArch
876a891979a3f88664c41560d35fd6225ea51258,2,53,14,39,0,0,0,10,48,43,1,2,0.992111692,2982,168,12,218,215,3,19913,19638,275,86,84,2,1,100,NoArch
a4ba0fff07861bdff338074fb5d84726f430883f,1,19,0,19,0,0,0,4,6,223,1,1,0,42,185,4,8,2,6,237,110,127,1,1,0,1,100,NoArch
be9a26488566891766cafae879efd3687d74095e,2,26,6,20,0,0,0,8,24,59,1,2,0.69621226,655,6,2,65,64,1,4995,4792,203,36,35,1,1,100,NoArch
62f534d00228653059c4fed944d444632bc07091,7,66,10,56,0,0,0,3,99,243,3,6,2.591833632,3837,0,0,454,446,8,17277,16911,366,402,397,5,1,100,NoArch
6faed3d90ab99844017465e63c6a0604bdc3a68c,0,0,0,0,0,0,0,0,0,0,0,0,0,0,13,3,0,0,0,0,0,0,0,0,0,1,100,NoArch
f44980763030663d8f6ee72555cbb4c280945267,1,1,1,0,0,0,0,4,6,194,1,1,0,142,4,0,15,15,0,659,663,4,8,8,0,0,100,NoArch
b4362fac45cfa75655869603e8c9a7a3a106fa98,1,21,2,19,0,0,0,4,8,45,1,1,0,159,93,3,4,3,1,1395,1245,150,4,3,1,1,100,NoArch
0986d5a01d7f83bd1b049e8acb7e9250ba43b9f3,10,44,8,36,0,0,0,4,79,148,1,9,2.847408301,4606,3,3,323,321,2,28412,28183,229,179,178,1,1,99.96710526,NoArch
6a46130037e6be48d6c014e513dbca6e940b83d8,3,12,16,4,0,0,0,6,39,129,3,3,1.442604943,2047,169,13,142,140,2,13814,13827,13,73,73,0,1,100,NoArch
051ad0b033993fcc7c68bdc96368fc6f0b822a55,7,136,53,83,0,0,0,14,32,45,3,7,1.625074099,3077,1,0,261,258,3,23735,22652,1083,132,130,2,1,88.55399634,Arch
4b471772aa130dc4bb577edbd42f2a617f205da0,5,81,5,76,1,0,1,4,4,909,1,2,1.153481768,220,50,1,17,12,5,1313,929,384,14,11,3,1,88.46936699,Arch
c9ffdc493eb8d1971b281e3b84275f4ef5905e4b,7,236,7,229,3,0,3,1,42,132,1,6,2.20479734,1400,51,2,151,137,14,10937,9855,1082,69,59,10,1,90.07352941,Arch
6f57bbfac4881388d73a9e0768498fe47fe6bb5a,1,8,9,1,0,0,0,14,19,93,1,1,0,296,1,1,32,32,0,1324,1334,10,27,27,0,1,100,NoArch
3539578ccbcca4738a3e22a63635f96b313234c0,13,81,43,38,0,0,0,46,101,55,4,10,2.810268871,8040,170,11,902,888,14,44983,44666,317,599,597,2,1,100,NoArch
f0bcee3c014cf59bdad3eaf8212d94a589073f0b,2,30,24,6,0,0,0,7,101,15,1,2,0.228538144,2725,29,2,368,368,0,12631,12609,22,337,337,0,1,100,NoArch
a66fd40692dba064dfa71d277ef5f25e067e702b,18,415,255,160,2,0,2,4,53,60,4,13,3.376953747,10555,30,3,1176,1171,5,75692,75418,274,597,593,4,1,98.35584263,NoArch
53826d69e4120fd2a67986237fa85795209d9dab,1,13,8,5,0,0,0,7,9,261,1,1,0,364,16,2,41,41,0,2828,2748,80,12,12,0,1,100,NoArch
29040762fa511f89e678dc15ca5ae7f9f097fb8a,4,22,3,19,0,0,0,16,102,82,2,3,1.851314689,3467,171,12,448,445,3,17034,16936,98,380,378,2,1,100,NoArch
34bc75285312a74e146369418ee82d87708ae1ba,1,13,1,12,0,0,0,4,12,204,1,1,0,108,2,1,15,13,2,575,464,111,6,6,0,1,100,NoArch
b6bdb46f7fe85faa79b96a008a51648872cc1c4f,7,1,32,31,0,0,0,5,80,7,1,6,2.381051228,3049,0,0,143,144,1,18849,19089,240,85,85,0,1,99.97321429,NoArch
fe53bd2dea4915a34eafe3c8cebf11ddc1b2a3bd,11,473,25,448,3,0,3,1,81,82,1,9,2.286408095,2602,186,4,269,223,46,15382,13320,2062,164,133,31,1,99.91970021,NoArch
25385805aab3ff00ca9accc406d0f7b0cf2d9e55,0,0,0,0,0,0,0,0,0,0,0,0,0,0,14,4,0,0,0,0,0,0,0,0,0,1,100,NoArch
ed26c5265c0d442740ecf110b4c87de865f4f3d9,0,0,0,0,0,0,0,0,0,0,0,0,0,0,94,3,0,0,0,0,0,0,0,0,0,1,100,NoArch
575bc6346825796e091a12be5a53b04980f82637,24,1050,532,518,1,0,1,3,103,108,3,15,3.048475502,10437,45,1,1169,1160,9,66623,61274,5349,727,709,18,2,93.37194948,Arch
08fd80c913aec05f36042111ef82d78bc0f55ad8,0,0,0,0,0,0,0,0,0,0,0,0,0,0,15,5,0,0,0,0,0,0,0,0,0,1,100,NoArch
4324e874ae58774fb3b0af98907123b7e6317b6f,1,3,1,2,0,0,0,2,2,120,1,1,0,42,172,11,0,0,0,77,68,9,0,0,0,1,100,NoArch
548000b0d635067acf7574c4cf5122759e79b52b,5,178,25,153,3,0,3,4,43,2,1,4,2.305129413,631,52,2,85,76,9,4757,4209,548,40,34,6,1,89.57335655,Arch
8859b48b2a13494c89603799684f317f8777726a,8,200,3,197,0,0,0,19,26,135,2,4,2.41550918,2964,0,0,288,257,31,21648,19869,1779,110,102,8,1,92.56623604,Arch
ca0b8fccee72de897a6019de470fc11f1638bdeb,0,0,0,0,0,0,0,0,0,0,0,0,0,0,16,6,0,0,0,0,0,0,0,0,0,0,100,NoArch
034addaef5834eff09cfd9ac5cc2656df95ca0e8,4,38,11,27,0,0,0,6,104,27,3,4,1.368714991,3741,31,4,488,485,3,19383,19142,241,408,407,1,1,100,NoArch
ec244071919f71984f278d328c7f0d5c70e2f2a5,15,28,14,14,0,0,0,1,41,66,2,9,3.563540392,7296,187,4,818,817,1,39198,39027,171,302,301,1,1,99.67139043,NoArch
4e09545be4aedea231f5d8f512ba53181ca12e33,0,0,0,0,0,0,0,0,0,0,0,0,0,0,46,2,0,0,0,0,0,0,0,0,0,1,100,NoArch
fa5e75068e661400eac037d676e20d556f3b0fc4,2,85,5,80,0,0,0,19,27,352,1,1,0.802353443,844,45,2,70,64,6,5121,4616,505,52,46,6,1,100,NoArch
9dc6df5dca27ec4d543001e03f0cd3718e6b9232,3,80,2,78,1,0,1,1,59,197,2,3,1.219303704,2232,173,11,210,202,8,17409,16949,460,129,125,4,1,99.91803279,NoArch
83cff3afee15e129034eb51e68a1734c55d85da2,2,113,0,113,1,0,1,4,6,2,1,2,0.762423324,125,53,3,13,5,8,1378,772,606,9,5,4,1,95.02590674,Arch
18cdad92068d299307a7ebd94703dab04b52690c,0,0,0,0,0,0,0,0,0,0,0,0,0,0,5,1,0,0,0,0,0,0,0,0,0,1,100,NoArch
faed6996eed1196c81bbcc39dda78628ade8a9eb,3,154,13,141,2,0,2,1,10,12,1,3,1.496215941,170,2,2,26,15,11,1587,917,670,17,10,7,1,99.94749554,NoArch
b00180342e9e8e8e783731e698fecc02a3c1b0e2,1,14,11,3,0,0,0,4,7,0,1,1,0,150,54,4,7,7,0,963,954,9,7,7,0,1,100,NoArch
56cb49485d74c28500101b81afe2cc41d90fb431,0,0,0,0,0,0,0,0,0,0,0,0,0,0,0,0,0,0,0,0,0,0,0,0,0,1,100,NoArch
5d59bf67aeecafb65a2231d808b538878eca49fb,1,33,14,19,0,0,0,2,5,109,1,1,0,500,32,4,35,32,3,2911,2777,134,12,11,1,1,100,NoArch
93277b2bcd9e5140c99c734784e3c89e9a9d1e7f,2,32,3,29,0,0,0,5,11,315,1,2,0.985228136,294,7,1,25,22,3,1987,1811,176,14,13,1,1,100,NoArch
e8918b6c2c30968caccc4fc3c166082503b4cc9d,3,96,4,92,1,0,1,1,44,7,1,3,1.477157746,649,55,5,84,77,7,4776,4334,442,38,33,5,1,95.00257069,Arch
e7bb0413af889c3a595e9fb3ea41145da992d8c9,5,123,17,106,0,0,0,6,46,21,1,5,1.93059563,5599,174,12,490,484,6,38282,37403,879,266,262,4,1,100,NoArch
eee96e9af3990809df9cc2e7f874d875596d9df1,5,224,137,87,2,0,2,3,40,17,1,3,2.287209758,976,47,2,120,116,4,5307,5133,174,72,68,4,1,99.72721762,NoArch
e60acc12582372634c51c5fd35e56d474bf6c1e3,2,28,9,19,0,0,0,4,5,114,1,2,0.956888666,319,29,1,18,16,2,2420,2248,172,11,10,1,1,100,NoArch
6c8224cae6e4cd849fe01bd9b647fe69b7fd188b,1,0,18,18,0,0,0,15,21,197,1,1,0,174,17,5,13,14,1,1216,1398,182,4,5,1,1,100,NoArch
1ba82206176b10c0c7392225de75756fcde70192,0,0,0,0,0,0,0,0,0,0,0,0,0,0,175,10,0,0,0,0,0,0,0,0,0,1,100,NoArch
465d553df8c2b157a49e837e1a91cee46ba889d4,2,18,16,2,0,0,0,10,70,18,1,2,0.936667382,1287,188,4,38,38,0,8208,8148,60,31,31,0,1,100,NoArch
4b75cb6f23a0708fd55659cadf691d30086f5f13,0,0,0,0,0,0,0,0,0,0,0,0,0,0,2,0,0,0,0,0,0,0,0,0,0,0,100,NoArch
003c6ee73e6809f90347e2e81696d2eb8ab2af2d,0,0,0,0,0,0,0,0,0,0,0,0,0,0,56,6,0,0,0,0,0,0,0,0,0,0,100,NoArch
22c3ce73dbaca70ec0eceee721bb9fbd344c2331,1,5,1,4,0,0,0,46,102,22,1,1,0,915,176,10,111,110,1,5854,5836,18,26,26,0,1,100,NoArch
30cf39301e311e26b29a65b3e4a229da92f925d1,0,0,0,0,0,0,0,0,0,0,0,0,0,0,177,11,0,0,0,0,0,0,0,0,0,1,100,NoArch
d40adfa2d717da683787afbc6bb58e409b9430c5,0,0,0,0,0,0,0,0,0,0,0,0,0,0,178,12,0,0,0,0,0,0,0,0,0,1,100,NoArch
3b59b769528e0953bf921bd96ffb68e12c3524d4,4,381,0,381,2,0,2,1,3,77,2,3,1.589704298,340,57,7,43,28,15,3634,1772,1862,24,18,6,1,99.67568663,NoArch
6ed7106e5904ce5bf4741b368245101b9ec5836d,0,0,0,0,0,0,0,0,0,0,0,0,0,0,8,0,0,0,0,0,0,0,0,0,0,1,100,NoArch
9bdda2a312bd830bc1659a5305fc28b4469d07be,1,1,1,0,0,0,0,2,2,651,1,1,0,125,0,0,19,19,0,314,314,0,10,10,0,1,100,NoArch
5e8ff8d793f5c50edef2865bb8733301a43f495c,10,96,63,33,0,0,0,1,58,168,3,7,3.079468517,4519,33,5,495,493,2,26130,25966,164,220,220,0,1,100,NoArch
d514570e909c7ca6eb1d41623029979ca3612806,2,36,2,34,0,0,0,3,8,8,1,2,0.981940787,189,48,3,34,28,6,1199,948,251,21,19,2,1,100,NoArch
55dca969f9d25ea352dc0e343ef1f1e8539630fd,2,14,0,14,0,0,0,5,71,242,1,2,0.591672779,864,3,1,21,21,0,4374,4290,84,13,13,0,1,100,NoArch
296a0e6bcf6f390288941e5ab8683390dcb6a788,0,0,0,0,0,0,0,0,0,0,0,0,0,0,46,1,0,0,0,0,0,0,0,0,0,1,100,NoArch
91849c3d666a363c535610bc24be54c5d9aaa913,3,50,2,48,1,0,1,1,32,125,1,2,0.944456706,520,0,0,14,11,3,3635,3428,207,3,2,1,1,99.97972014,NoArch
8ca9a54db016fc644070085fe2d596b0e5643e00,1,145,29,116,0,0,0,3,4,25,1,1,0,757,17,1,97,86,11,5179,4362,817,35,32,3,0,100,NoArch
95e6e538109af9fe60aa99219e4aa1d7ce9511e2,2,272,76,196,0,0,0,8,105,62,1,2,0.712636835,2696,47,2,381,364,17,13385,11971,1414,347,340,7,1,99.97972014,NoArch
5ba2d9ab2f9f22cf81968a68e0303d750a2bd9e9,5,400,38,362,0,0,0,12,22,622,2,5,2.066919716,2293,48,3,279,243,36,20674,17978,2696,104,92,12,1,100,NoArch
bf191f8d4662fd1e9c28f3cacce9179dc8cab561,1,2,1,1,0,0,0,15,25,293,1,1,0,242,2,0,32,32,0,1361,1352,9,6,6,0,1,100,NoArch
7446ff95a7b099d8016b7ca48fdeed9b290d710f,70,810,856,46,2,2,4,2,54,258,2,27,5.207319526,14359,95,2,1196,1204,8,94991,96296,1305,738,738,0,1,92.27748691,Arch
9ece77561a673fbfd666c5c57dac1a36e6cedce6,0,0,0,0,0,0,0,0,0,0,0,0,0,0,8,2,0,0,0,0,0,0,0,0,0,0,100,NoArch
6fe4d6e2f645db47b94f5c4d7743747308ef3d86,1,2,1,1,0,0,0,5,13,47,1,1,0,352,0,0,21,21,0,1754,1740,14,10,10,0,1,100,NoArch
2551c26183cd11d47598128dfd08811fd3d83c69,1,20,15,5,0,0,0,2,4,328,1,1,0,120,179,10,15,16,1,902,796,106,2,2,0,1,99.89982971,NoArch
316e38c71e2fec9d7a13417d409374f28875c4f1,2,79,71,8,0,0,0,3,13,60,1,2,0.2108423,633,180,11,102,97,5,3863,3780,83,77,76,1,1,100,NoArch
099c2c099ad842f18b76bc2529b6eeb968f328eb,3,9,65,56,0,0,0,12,23,40,2,3,0.989312733,1097,34,5,120,122,2,5320,5787,467,47,48,1,1,100,NoArch
1b6e201160ef18b0c7d86d1cafd104609489dad7,4,119,66,53,0,0,0,10,41,50,2,4,1.131518143,2449,35,6,246,238,8,16694,16418,276,103,102,1,1,100,NoArch
15d1c186255ced3a8e08020ed68de9cd380dc250,1,0,1,1,0,0,0,5,8,369,1,1,0,387,49,4,26,26,0,2629,2644,15,18,18,0,0,100,NoArch
799c78e6888ef6a375c6779c3cfe7067756d4be9,172,1612,265,1347,24,0,24,1,1,0,1,46,4.897274169,29589,189,3,2741,2610,131,161094,156653,4441,1509,1385,124,1,87.54933065,Arch
a118d56b071bad6a4701c3578e43e5fdfe416e6c,0,0,0,0,0,0,0,0,0,0,0,0,0,0,181,11,0,0,0,0,0,0,0,0,0,0,100,NoArch
26e5d2e6fcc399e7886594a5454a16d29aaa8702,3,114,89,25,0,0,0,2,9,45,2,3,0.918723883,530,0,0,38,32,6,3605,3544,61,18,15,3,1,99.9621952,NoArch
ca0931d332234d0b743b4a035901a3bc9325d47c,9,521,384,137,1,0,1,19,106,85,2,6,1.762028655,7190,22,0,756,746,10,46606,45611,995,562,557,5,1,99.97478091,NoArch
9b6e138af27e600410a63f96065baf057300c071,4,104,9,95,0,0,0,8,13,229,1,4,1.473877996,811,50,5,71,63,8,6958,6176,782,33,30,3,1,99.98739443,NoArch
5f570ea151d0212ab1bb2d1f5693035626b76d31,30,1214,818,396,3,0,3,5,107,389,7,22,3.449301806,10452,0,0,1057,1033,24,64186,62954,1232,658,635,23,1,93.23878133,Arch
f96ba7abf043246e98f550f858e047411a12c550,2,37,13,24,0,0,0,7,9,575,2,2,0.242292189,293,49,3,43,38,5,1854,1698,156,17,16,1,1,100,NoArch
52f0498330cc6e2112d9e5228386436babdb9133,1,2,1,1,0,0,0,9,17,25,1,1,0,569,182,9,55,55,0,3273,3256,17,30,30,0,0,100,NoArch
a1c42fcc0708f1838391e3e5c3cb7541b1fcd78f,2,14,39,25,0,0,0,1,21,37,2,2,0.993570476,982,190,2,118,121,3,4753,4886,133,62,64,2,0,94.76323657,Arch
fe2c3989e364e323f73552dbb9128d9662089eef,5,130,120,10,0,0,0,10,60,53,2,2,1.547724565,4074,50,3,301,301,0,32198,32234,36,189,189,0,1,100,NoArch
ccc3728002533978cb35b3b4c22cb4d0ef087347,4,75,25,50,0,0,0,4,23,36,2,4,1.472119474,2578,36,4,293,289,4,16321,16135,186,106,104,2,1,100,NoArch
b14706502b56e257224018616cd5e7e7966bff43,0,0,0,0,0,0,0,0,0,0,0,0,0,0,96,1,0,0,0,0,0,0,0,0,0,1,100,NoArch
686da41696e17daa182f84796cd2721b945d71b1,4,19,249,230,0,2,2,10,61,721,2,3,1.537168192,2632,97,2,206,218,12,18609,20166,1557,135,147,12,1,99.79903537,NoArch
44ab3b73ed8510e28c2c115da25aa66c0ce9d7b7,0,0,0,0,0,0,0,0,0,0,0,0,0,0,51,6,0,0,0,0,0,0,0,0,0,1,100,NoArch
ff136658a0a513f888a142e77380131a41801db9,2,22,7,15,0,0,0,10,62,0,1,1,0.578794625,2402,98,3,209,206,3,18713,18609,104,136,135,1,1,100,NoArch
4ddd094ba2a805116f63c04805a08bf9c2651fc8,1,2,0,2,0,0,0,22,63,0,1,1,0,2136,52,6,190,190,0,16404,16394,10,122,122,0,1,100,NoArch
9b3dd2e0b7d89228a64f1162a50c5c96a27786de,4,221,106,115,0,0,0,2,28,28,1,4,1.667138855,2286,53,7,129,123,6,18494,17699,795,60,58,2,1,100,NoArch
608d4bf32d65cac2829c79994bd3a43c0d2db03b,1,11,8,3,0,0,0,3,4,801,1,1,0,169,54,8,21,21,0,1199,1189,10,10,10,0,1,100,NoArch
5e86cdd1e95511424e354d99816d9495e13ae6ae,12,169,27,142,2,0,2,1,4,5,2,8,2.741472607,2906,191,3,156,146,10,17056,16248,808,105,99,6,1,99.85935302,NoArch
eaa4c4f2e2ccdb42f62d91c001a0350de183e4dc,19,719,391,328,2,0,2,19,30,148,4,12,3.064441337,7125,55,9,653,626,27,51284,49539,1745,331,308,23,1,92.86940106,Arch
483ee843e62511f6d5bc487d90aba1a636ebac22,1,2,0,2,0,0,0,2,2,11,1,1,0,261,0,0,20,20,0,972,965,7,11,11,0,1,100,NoArch
2fd9a4de5ca8b35ca0260f10915f6a4703abbd18,0,0,0,0,0,0,0,0,0,0,0,0,0,0,0,0,0,0,0,0,0,0,0,0,0,1,100,NoArch
8896864d7b8e8c1a9bf0e2a05353f70a1fabdf22,6,31,41,10,0,0,0,18,50,64,2,4,2.210001633,2880,192,4,324,331,7,16967,17079,112,146,146,0,1,100,NoArch
8b38ddedc2fd1ef048a756faa3531afc06b2c26b,1,46,38,8,0,0,0,2,7,28,1,1,0,518,37,5,37,35,2,2898,2911,13,12,12,0,1,100,NoArch
f20c9867d7c347c43b22f70270aefb9b7f658461,1,2,2,0,0,0,0,1,2,29,1,1,0,190,58,4,13,13,0,1010,1006,4,4,4,0,1,100,NoArch
e5c3f9089b63800767ec88e269a98bbbd6b1e5e1,20,1870,6,1864,10,0,10,1,1,0,1,11,3.122584705,1011,18,1,208,60,148,16315,5803,10512,160,45,115,1,99.52145955,NoArch
12cc8e715bfcd71a6b9232a37bd42aa237ab09d9,3,3,2,1,0,0,0,2,8,0,2,3,1.521928095,520,19,2,36,36,0,3045,3044,1,28,28,0,0,99.9402896,NoArch
51034fecf12c6f5cd90cf12540babfcda5f5e667,0,0,0,0,0,0,0,0,0,0,0,0,0,0,38,6,0,0,0,0,0,0,0,0,0,1,100,NoArch
0c09a973fb0470a47411f734d2d5e1429e3522e2,5,108,17,91,0,0,0,10,38,29,2,4,2.171553172,5117,193,5,443,437,6,37437,36931,506,155,154,1,1,100,NoArch
57b4f39c3121f84f2455990f6825f6ad372c0d42,5,20,22,2,0,0,0,9,13,32,1,4,2.093069208,638,9,1,40,40,0,4326,4448,122,23,23,0,1,100,NoArch
189d5297b8826f5345fcb132dc7318fc4253c94e,7,4,21,17,0,0,0,8,10,365,1,4,2.609025574,1591,39,6,98,101,3,11661,11723,62,51,54,3,1,100,NoArch
4d940bbf8a934087e606e2a9a9ba698a0911caa3,5,73,24,49,0,0,0,1,3,7,1,5,1.703603065,2759,194,6,128,120,8,15520,15085,435,83,79,4,1,99.95520717,NoArch
484b3407e00ce0d0c646bf6b8f7f2145070d2d2c,5,44,30,14,0,0,0,5,14,345,2,3,1.625040889,889,56,10,73,71,2,5896,5858,38,27,27,0,1,100,NoArch
85c4a6cfc1ecc4d5eb15c9e059e59c6cb2a9a0a8,0,0,0,0,0,0,0,0,0,0,0,0,0,0,183,8,0,0,0,0,0,0,0,0,0,0,100,NoArch
9da2dd416ec76ec68393e38f8e1e94c7de141eb0,0,0,0,0,0,0,0,0,0,0,0,0,0,0,27,0,0,0,0,0,0,0,0,0,0,1,100,NoArch
f2a93ead3b5a6964a72b3543ada58aa334edef9c,1,9,1,8,0,0,0,4,5,159,1,1,0,83,184,8,8,8,0,453,400,53,8,8,0,1,100,NoArch
d31cde284c4992f81bb989ce92f646a0d382634c,0,0,0,0,0,0,0,0,0,0,0,0,0,0,20,2,0,0,0,0,0,0,0,0,0,0,100,NoArch
1d0f4ccfe0e81f1b83ff6f0fb1e3383da9802e62,0,0,0,0,0,0,0,0,0,0,0,0,0,0,1,0,0,0,0,0,0,0,0,0,0,1,100,NoArch
2e2d08cb7260e3316fdc9116c4061aed0ceb5214,1,56,39,17,0,0,0,2,2,10,1,1,0,187,13,0,16,14,2,1125,1019,106,7,6,1,1,100,NoArch
4ed84b216db335521bd4c51169c40e63dc86f27d,2,48,17,31,0,0,0,10,14,55,1,2,0.89049164,1869,57,11,178,173,5,11224,10982,242,81,80,1,1,100,NoArch
6ccbae4d2ac13d1e6b0a7c87fcb072319f410451,23,1116,203,913,9,0,9,14,64,109,5,16,3.356606781,6178,99,4,700,614,86,47021,42029,4992,375,329,46,1,99.45322448,NoArch
d074089c62db9aabe3b6c47ec8323f4487fa2b0b,10,316,45,271,1,0,1,4,19,882,2,7,1.551948204,1337,185,6,133,114,19,9363,7906,1457,67,62,5,1,99.98497596,NoArch
72e0b52b18a7383158cfa91b9a61ec16fa7d2576,0,0,0,0,0,0,0,0,0,0,0,0,0,0,21,3,0,0,0,0,0,0,0,0,0,1,100,NoArch
3bf9c5ffe80e84e9b0ba34e115e1a7a417f343e8,2,30,43,13,0,0,0,1,4,3,1,2,0.40985537,581,195,6,38,39,1,3000,3136,136,17,17,0,1,100,NoArch
8f8a8158e2ced440918735cbf42f9b8d4a0f804c,0,0,0,0,0,0,0,0,0,0,0,0,0,0,45,0,0,0,0,0,0,0,0,0,0,1,100,NoArch
7c7ecb11d5359690a42f0e427605760f13a5b196,1,2,2,0,0,0,0,2,3,249,1,1,0,110,1,0,0,0,0,542,543,1,0,0,0,1,100,NoArch
1b2fb71afcc515b8efe3fd20416137049c87cc1e,1,2,2,0,0,0,0,1,2,1,1,1,0,70,100,5,6,6,0,301,310,9,4,4,0,0,100,NoArch
fcb003ec767f56cbfc56b10711b373d9a477a628,2,23,15,8,0,0,0,10,21,13,1,1,0.74248757,1674,40,6,164,164,0,10769,10742,27,61,61,0,1,100,NoArch
0802510ca9d55554e87e9aee9cbf9e694dd8a785,3,36,7,29,0,0,0,2,6,195,1,2,1.280743307,485,22,4,56,51,5,3720,3485,235,18,17,1,1,100,NoArch
e5a2baeed0861e332000cb0fe3e3f263e82c15fc,12,7,122,115,0,0,0,3,48,183,4,10,2.134678563,4933,41,7,505,512,7,29100,29684,584,279,283,4,1,99.93991287,NoArch
941c254c33a83909c58dea6b7eb2b1ffa7b5aaec,0,0,0,0,0,0,0,0,0,0,0,0,0,0,23,5,0,0,0,0,0,0,0,0,0,1,100,NoArch
5c1b482a1bb46ca879472547a0c6f94f5294a83d,4,23,15,8,0,0,0,1,5,10,1,4,1.449391139,1964,196,7,107,108,1,11411,11343,68,73,73,0,1,100,NoArch
4fed8dd31996bdd3e16e4921237628588195653f,8,62,15,47,0,0,0,8,67,196,4,6,2.667819735,1776,186,7,199,196,3,10737,10370,367,75,75,0,1,100,NoArch
7fa363923cb14ec5b4e930a1ff3dcaa91a770634,1,31,4,27,0,0,0,5,9,106,1,1,0,181,2,0,20,17,3,1557,1360,197,3,2,1,1,100,NoArch
b9fbada2f2974f516e9541359892b905af19710e,2,20,12,8,0,0,0,1,19,22,2,2,0.811278124,462,197,8,31,30,1,3034,3022,12,20,20,0,0,100,NoArch
04478a45d9ec0817a88ce9464e8c63c285a108b4,0,0,0,0,0,0,0,0,0,0,0,0,0,0,51,2,0,0,0,0,0,0,0,0,0,0,100,NoArch
8b796e96865c44982b4dd8314e60573594e9f153,2,85,371,286,0,1,1,1,8,172,1,2,0.436176954,567,42,8,22,38,16,1871,2993,1122,8,13,5,1,99.96994967,NoArch
eae8488536c711a104c9e4f3429af3ad5c420841,1,22,0,22,0,0,0,4,7,3,1,1,0,871,18,1,100,97,3,5284,5176,108,36,35,1,1,100,NoArch
2b60641d17f60fc0d90ad470d6dead95805495fa,2,34,0,34,0,0,0,4,9,1106,2,2,0.997502546,1039,19,2,119,115,4,6094,5878,216,43,42,1,1,100,NoArch
17d11f4839753553f7a58052a01f94bc653e1a55,1,0,1,1,0,0,0,2,2,29,1,1,0,242,4,0,21,21,0,1258,1265,7,11,11,0,0,100,NoArch
31d4a16deb5144d02baf0f1a1afeb103205267b1,8,613,0,613,8,0,8,1,1,0,2,4,2.628612184,0,101,6,55,0,55,2813,0,2813,33,0,33,1,99.27770672,NoArch
9ff6a48f6083c70ea5f0cb74fd83bb8dfa3d2071,1,3,3,0,0,0,0,3,5,255,1,1,0,220,2,1,26,26,0,1616,1618,2,11,11,0,1,100,NoArch
2d73c8ae86f493c8ccfffca2bc5f5f90e9fe4f10,7,217,28,189,0,0,0,20,49,109,2,6,1.478335886,4394,28,1,593,580,13,32593,31298,1295,326,315,11,1,100,NoArch
9830005e9b74f74defcd9d761b6d9d9689b89da9,0,0,0,0,0,0,0,0,0,0,0,0,0,0,58,11,0,0,0,0,0,0,0,0,0,1,100,NoArch
4fb1a590b181a495178c36233362eea2952501cb,1,36,0,36,1,0,1,1,1,0,1,1,0,0,59,12,1,0,1,59,0,59,1,0,1,1,99.98494883,NoArch
d80c80699f46e052e0745e90fc8ab32a17b3640f,1,3,3,0,0,0,0,7,15,78,1,1,0,908,187,8,37,37,0,7322,7322,0,20,20,0,0,100,NoArch
2c4554fadaf296fbb58e806b5191d123d1202a8e,0,0,0,0,0,0,0,0,0,0,0,0,0,0,0,0,0,0,0,0,0,0,0,0,0,1,100,NoArch
2dbb273d26ea38ecf28af704876861554250449c,9,106,24,82,0,0,0,7,55,89,2,8,2.14750071,8997,20,2,724,717,7,64728,64108,620,362,360,2,1,100,NoArch
f6ff95f97cc49d8db690bc2d27b716b34618938d,0,0,0,0,0,0,0,0,0,0,0,0,0,0,60,11,0,0,0,0,0,0,0,0,0,0,100,NoArch
4569734d60cdf1bd0d7187bfeb5d3ac5f0be8191,6,138,20,118,0,0,0,4,56,4,1,5,1.561279038,4590,188,9,564,547,17,33439,32570,869,235,232,3,1,100,NoArch
ce45f7f129e4d83705fc6a2a3dc6cfd7414480e1,2,57,1,56,0,0,0,13,21,428,2,2,0.216396932,404,6,0,33,31,2,2777,2284,493,20,18,2,1,100,NoArch
3cdb590e153c77c85c0d3d6365ada132079c300a,2,21,14,7,0,0,0,25,45,70,1,1,0.512709142,690,189,10,84,83,1,5782,5673,109,24,24,0,1,100,NoArch
80011df995f6a610a30799eb3b11cdd8a2703630,16,255,74,181,1,0,1,21,40,384,2,12,3.300794637,7474,24,6,770,750,20,52352,51067,1285,362,356,6,1,99.92493056,NoArch
73a21092f8f708d6c90ff2ab95b677b58237be9a,4,49,1,48,0,0,0,21,49,72,2,4,1.333037829,3786,190,11,341,337,4,27773,27370,403,181,179,2,1,100,NoArch
7889c7852f0b8aa0a449e56f9d41fd6dbd648882,0,0,0,0,0,0,0,0,0,0,0,0,0,0,29,2,0,0,0,0,0,0,0,0,0,1,100,NoArch
51a701cef18024f07217906e4684529ad4b5d580,2,214,0,214,2,0,2,1,1,0,1,2,0.925887858,0,0,0,17,0,17,1170,0,1170,14,0,14,1,99.93256406,NoArch
1da196c1e81bff60386b9404b252451531ab9ca9,0,0,0,0,0,0,0,0,0,0,0,0,0,0,0,0,0,0,0,0,0,0,0,0,0,1,100,NoArch
28dafa774ee058a4d00fc15b1d7fffc0c020ec3e,38,1942,150,1792,4,0,4,22,108,224,4,25,4.219847182,17980,52,3,2225,2035,190,118792,106224,12568,1357,1256,101,2,92.24667349,Arch
a048e940fd6e3f62e443bca5831e99144900a33f,8,168,25,143,0,0,0,11,41,2,2,6,2.553873623,5087,53,4,443,433,10,34380,33276,1104,165,160,5,1,99.97028232,NoArch
98b4e9796e1e3e1f69954afa698ace5b28bde4a0,9,351,368,17,1,1,2,15,20,161,2,5,2.200005559,1808,25,7,211,203,8,11710,11731,21,84,78,6,1,99.90095087,NoArch
6df14f15a3761580085d38bffceca9d19c7ad24e,17,350,62,288,1,0,1,1,52,144,3,10,2.894779388,6078,198,9,540,511,29,39671,37909,1762,291,273,18,1,99.91091755,NoArch
23b31225df4e7cd7f7e5013ea30b482bc0ebb09d,2,6,6,0,0,0,0,3,32,256,2,2,1,584,35,0,64,64,0,3411,3411,0,27,27,0,1,100,NoArch
7dfb1680031cae8f0803786d406854f005156537,1,1,0,1,0,0,0,6,10,22,1,1,0,240,191,10,12,12,0,1472,1457,15,7,7,0,1,100,NoArch
dfdd2de99ced45424131915a036a0eb2b96b2ca6,0,0,0,0,0,0,0,0,0,0,0,0,0,0,54,5,0,0,0,0,0,0,0,0,0,1,100,NoArch
9275b8fc7e2920a49ccf0b472e49c783e6c933d1,0,0,0,0,0,0,0,0,0,0,0,0,0,0,102,6,0,0,0,0,0,0,0,0,0,1,100,NoArch
444ff496a444ff82385421844aef5b4db01d8892,49,7444,55,7389,29,0,29,1,109,20,3,26,4.947544913,10935,30,3,2529,1400,1129,103992,55088,48904,1268,843,425,4,94.55131335,Arch
fb45fc9cb9581abc40922ddcbee21dfc016d4edc,3,20,1,19,0,0,0,9,110,1,2,3,1.125490807,4247,61,12,544,541,3,20232,20146,86,437,434,3,1,100,NoArch
b1e7e1f14eb093e50f74f23a7622c4e38886553a,0,0,0,0,0,0,0,0,0,0,0,0,0,0,62,13,0,0,0,0,0,0,0,0,0,1,100,NoArch
020786a5f9d25bf140decf24d65e07dd738e4f9d,6,136,16,120,0,0,0,23,48,39,2,5,1.468065091,4413,21,3,369,358,11,28243,27406,837,212,207,5,1,100,NoArch
eef3f9c74acfe0ebec77694044b416696cfc7c2d,4,12,2,10,0,0,0,2,24,199,3,4,1.842370993,491,4,0,17,16,1,2430,2363,67,13,13,0,1,99.96144578,NoArch
c19f505b5ad8c292d259b68c57f6d768a2a1dbf4,1,34,4,30,0,0,0,4,9,8,1,1,0,909,63,14,107,101,6,5570,5405,165,37,36,1,1,100,NoArch
20964df7707b0cdb460cecfaa724537244adb0a4,10,927,214,713,8,2,10,1,2,0,3,5,3.138876125,214,6,0,75,17,58,5036,1170,3866,54,14,40,1,99.78842085,NoArch
74eb09be9b40a205365bf920ed98cfff564f79cf,3,98,16,82,0,0,0,13,29,52,2,3,1.448453749,1337,55,6,124,118,6,11112,10291,821,50,48,2,1,100,NoArch
cc3737be506475c11c12471be6d0296ea14c7f39,28,1026,451,575,1,0,1,4,43,42,5,19,3.737734269,17241,43,8,1721,1611,110,124261,121356,2905,765,759,6,1,99.91366906,NoArch
84064a9b081c246f306855ae125f0dae5eb8f6d0,4,99,32,67,0,0,0,35,111,16,2,4,1.379525249,4350,192,11,587,583,4,23014,22521,493,423,420,3,1,100,NoArch
c34eb07598adfd975fa1b9f5235dfc48a7a247bd,2,22,19,3,0,0,0,11,49,1,2,2,0.926212213,2191,64,15,229,229,0,11872,11868,4,89,89,0,0,99.99041043,NoArch
8add740d2257214fb3b6238091b0c526dee88a26,0,0,0,0,0,0,0,0,0,0,0,0,0,0,7,1,0,0,0,0,0,0,0,0,0,1,100,NoArch
b28f0d6ceb7750075be82b7bd4160a4475801159,31,531,91,440,1,0,1,35,104,125,5,21,3.459269448,14150,47,0,1713,1664,49,92090,89205,2885,826,802,24,1,99.95206596,NoArch
3449e86989f86121a9b9a93de602bc8497021a27,9,43,46,3,0,0,0,11,27,12,4,8,2.621797976,4361,26,8,571,571,0,26350,26343,7,220,220,0,1,100,NoArch
325b3d610a285aa6442b6db325c43379dfd63c6c,5,95,91,4,0,0,0,1,3,30,1,4,1.674426716,1019,27,9,68,68,0,6017,6048,31,52,52,0,1,100,NoArch
3195f51562b8cd7e62a46d41ae91e6d25be77988,8,196,28,168,1,0,1,1,61,91,2,5,2.240119683,3738,31,0,525,508,17,21507,20576,931,227,221,6,1,99.96168215,NoArch
92ca426ab7ef54c8ce928f770783f4f83510d8ae,0,0,0,0,0,0,0,0,0,0,0,0,0,0,8,2,0,0,0,0,0,0,0,0,0,1,100,NoArch
898be6174a62e8079cdc33648e73787829ee6963,7,271,51,220,0,0,0,9,55,5,2,6,1.833306211,5566,56,7,498,478,20,35758,34122,1636,268,261,7,1,100,NoArch
8baeb816d553f202c7bd4b6564d6955be46d74b5,0,0,0,0,0,0,0,0,0,0,0,0,0,0,44,8,0,0,0,0,0,0,0,0,0,1,100,NoArch
209d54164842621d4107c0bc992dba78d58e223e,0,0,0,0,0,0,0,0,0,0,0,0,0,0,103,7,0,0,0,0,0,0,0,0,0,0,100,NoArch
0048b78d18499280f09df8866952968e8efdb45b,2,12,7,5,0,0,0,8,34,96,1,1,0.74248757,589,193,3,72,70,2,3478,3455,23,27,27,0,1,100,NoArch
3b6634de6b33a317f15cdf2cc1e447b392b58c32,0,0,0,0,0,0,0,0,0,0,0,0,0,0,0,0,0,0,0,0,0,0,0,0,0,0,100,NoArch
52205897a7fb199d31f44cf6da1a926ebd960848,33,1226,633,593,1,0,1,15,45,66,3,16,3.021149871,15032,45,2,1380,1340,40,101258,97953,3305,642,608,34,1,97.84067698,Arch
414f4bf63fe6b1eb77a5884e14807c766d9749ea,0,0,0,0,0,0,0,0,0,0,0,0,0,0,104,2,0,0,0,0,0,0,0,0,0,1,100,NoArch
642b9deb631baf923b12bcbe41c9db23b7eb72a3,0,0,0,0,0,0,0,0,0,0,0,0,0,0,0,0,0,0,0,0,0,0,0,0,0,1,100,NoArch
2fcea79f0c6040549a4175b686823f015a538c51,0,0,0,0,0,0,0,0,0,0,0,0,0,0,105,3,0,0,0,0,0,0,0,0,0,1,100,NoArch
32a1191b73573572d201ecb6ee25b153172ae79a,1,1,1,0,0,0,0,1,2,34,1,1,0,246,46,3,16,16,0,1584,1584,0,2,2,0,1,100,NoArch
b881e6d542f4cffbd292a1fb73e81e8aa19f2ccf,3,33,13,20,0,0,0,1,5,228,2,3,1.201670054,1531,199,1,135,134,1,7927,7733,194,21,20,1,1,100,NoArch
ab2f313ccfaba05dce94ae54de7fc1bcfba6ee58,2,19,3,16,0,0,0,2,2,72,1,1,0.902393283,652,31,2,119,117,2,3816,3705,111,10,9,1,1,100,NoArch
c539e8bdb5ea0940f3c88d8dabd635a77d7c4a8f,3,140,11,129,0,0,0,20,34,32,2,3,1.007814008,2594,65,4,304,295,9,17446,16595,851,160,157,3,1,100,NoArch
63fc2ae1845761b36dec588382231eddda670dae,5,63,4,59,0,0,0,5,28,289,1,2,2.076178475,2025,36,1,144,139,5,13112,12730,382,74,72,2,1,100,NoArch
5a62b413ddef6fe38460ba01324a52c3e372da6e,1,167,0,167,1,0,1,1,1,0,1,1,0,0,194,4,10,0,10,920,0,920,5,0,5,1,99.97036159,NoArch
510e886e66bb920e0af0d78d771a051ec91d2781,1,137,19,118,0,0,0,4,11,34,1,1,0,922,66,5,125,107,18,6237,5482,755,41,37,4,1,100,NoArch
716ebe588baca0f27b8cdb8037e16b6f27dea1f0,1,1,1,0,0,0,0,6,11,0,1,1,0,252,195,5,26,26,0,1210,1210,0,25,25,0,1,100,NoArch
40699ebfe95f1629edcf687fafa3e0f47c2fa98c,0,0,0,0,0,0,0,0,0,0,0,0,0,0,67,6,0,0,0,0,0,0,0,0,0,1,100,NoArch
e1092258d25abe524a09c0d58819d8d32755d4f4,8,92,33,59,0,0,0,17,36,71,5,8,2.537434208,4989,57,5,338,333,5,37256,36346,910,179,179,0,1,100,NoArch
04e11c1e077dfa42c60b8354c11ce37a8505f0fb,0,0,0,0,0,0,0,0,0,0,0,0,0,0,1,0,0,0,0,0,0,0,0,0,0,1,100,NoArch
8a56f3286cdc79d4a0888099cd7839eb6facbb13,1,44,18,26,0,0,0,4,7,125,1,1,0,61,200,2,10,8,2,384,237,147,2,1,1,1,100,NoArch
0f9798f825bda76e08b8fa74716f5cb8cb733ec3,4,59,57,2,0,0,0,11,56,6,2,3,1.274926588,5800,47,4,514,515,1,38550,38597,47,180,179,1,1,100,NoArch
40c239fd64f5784bdd6467e92f68f226ec50b385,0,0,0,0,0,0,0,0,0,0,0,0,0,0,1,0,0,0,0,0,0,0,0,0,0,1,100,NoArch
57343f912c971f13ed0186abbfef52efb0ee5c1b,0,0,0,0,0,0,0,0,0,0,0,0,0,0,68,7,0,0,0,0,0,0,0,0,0,0,100,NoArch
0a87f1fb6bb54c2204f8c6677b26f119b568ae84,15,173,177,4,0,0,0,4,112,29,3,13,3.334039016,12701,48,5,1360,1364,4,71069,71324,255,811,815,4,1,99.96048992,NoArch
9ad7ae872187330aeea69188e820bbd0c2b19458,1,19,0,19,0,0,0,2,2,69,1,1,0,72,106,4,5,5,0,410,410,0,2,2,0,1,100,NoArch
a2c226132fc7a9eb38a0cf946c73b0abe353d380,5,34,4,30,0,0,0,2,113,107,1,4,2.127773932,3751,69,8,459,455,4,17309,17133,176,403,401,2,1,94.37608319,Arch
8897141ffc2970918fbb26a636226576af39f5a4,1,1,2,1,0,0,0,18,35,0,1,1,0,462,37,2,58,58,0,2735,2735,0,23,23,0,0,100,NoArch
ac6b5050b568a1fa042c110e78f4531196fef994,12,291,147,144,2,1,3,10,62,250,2,7,3.149375204,5554,49,6,710,696,14,31413,30856,557,437,426,11,1,99.92281568,NoArch
65ba16da79a3619bc10714c29cb94d3245b35300,0,0,0,0,0,0,0,0,0,0,0,0,0,0,50,7,0,0,0,0,0,0,0,0,0,1,100,NoArch
0cb266ec90f46e72852a07bcd68334b427a81c0a,2,5,4,1,0,0,0,3,7,137,1,1,0.99107606,248,196,6,27,25,2,1794,1741,53,7,7,0,1,99.99228514,NoArch
edecf5202843574a9b9b6781e8f744f98f1b7896,1,12,4,8,0,0,0,4,13,0,1,1,0,1039,70,9,126,125,1,6284,6232,52,41,41,0,1,100,NoArch
61e3a3fbf3ac6a872ebe66bec029f290050b9c4b,5,75,51,24,0,0,0,3,21,112,1,4,1.647985066,3057,197,7,351,352,1,18863,18548,315,142,143,1,1,100,NoArch
52ca32d48a36051e010641101c76f3b108d4c8fe,0,0,0,0,0,0,0,0,0,0,0,0,0,0,0,0,0,0,0,0,0,0,0,0,0,1,100,NoArch
baffd67ad4ec08bd8e97927def4505b79fa89824,0,0,0,0,0,0,0,0,0,0,0,0,0,0,198,8,0,0,0,0,0,0,0,0,0,0,100,NoArch
ed02556863e57252ed5982a27d8226989b9537ae,0,0,0,0,0,0,0,0,0,0,0,0,0,0,51,8,0,0,0,0,0,0,0,0,0,1,100,NoArch
1261d8133cdbafdcca545b15649d7a82ae521799,4,118,20,98,0,0,0,1,58,30,2,4,1.375373589,1715,58,6,187,181,6,11543,10679,864,71,68,3,1,99.97686613,NoArch
0151d3543287212d8b4b33ba4397239f3a1b0b36,7,88,22,66,0,0,0,21,36,23,2,6,2.375626628,6014,199,9,705,695,10,47229,46694,535,334,330,4,1,100,NoArch
c19e4061d645a0525800395576beaa02b1cfc59b,2,32,0,32,0,0,0,30,63,0,2,2,0.543564443,2167,52,9,295,289,6,11896,11757,139,129,127,2,1,100,NoArch
4f9144a6b87cd86f0c096bcda72e4f420109dbe9,3,70,2,68,0,0,0,48,105,29,2,3,1.463806233,2243,9,3,317,311,6,14953,14547,406,90,86,4,1,100,NoArch
3f046a3de35f13584f451f3aeb3aff2357c39ec1,0,0,0,0,0,0,0,0,0,0,0,0,0,0,107,5,0,0,0,0,0,0,0,0,0,1,100,NoArch
86844544fee9888d3d69e7740a7d296723036e85,0,0,0,0,0,0,0,0,0,0,0,0,0,0,2,1,0,0,0,0,0,0,0,0,0,0,100,NoArch
92f98f9ab088b58c3e4e04bb7d4c7f6360ac8a53,1,2,1,1,0,0,0,48,106,0,1,1,0,928,10,4,112,112,0,5902,5894,8,26,26,0,1,100,NoArch
5fa53f6c199421f62e54b33d1839f406f4bec8a1,0,0,0,0,0,0,0,0,0,0,0,0,0,0,108,6,0,0,0,0,0,0,0,0,0,1,100,NoArch
7baf05aafafb8fb96bbbac6f0f0c99975741b4ae,10,94,73,21,0,0,0,3,36,150,1,4,2.734856931,2204,53,10,180,181,1,14592,14418,174,81,80,1,1,100,NoArch
1f4b4d99d05c5fdb22cc67658ac2a8a770eedb37,0,0,0,0,0,0,0,0,0,0,0,0,0,0,54,11,0,0,0,0,0,0,0,0,0,1,100,NoArch
32d04fcb7cdd0e29aa932dbc4cd1df6eb93b9782,2,12,2,10,0,0,0,1,6,46,1,2,0.591672779,524,201,3,39,38,1,2819,2792,27,19,19,0,1,100,NoArch
362798e94643a9922035a3d02633c031e6152358,8,38,88,50,0,0,0,17,28,0,5,8,2.551204773,4564,202,4,251,254,3,33298,34101,803,145,145,0,0,100,NoArch
0fb8bb0aa310143427147ff79dadd7c9ba728a5e,1,10,3,7,0,0,0,1,2,72,1,1,0,140,203,5,13,12,1,720,654,66,6,6,0,1,100,NoArch
e9c48c7afde89edeaf4b76aa564096b7ea656c63,1,10,2,8,0,0,0,6,7,402,1,1,0,213,71,10,29,27,2,1092,1049,43,13,13,0,1,100,NoArch
ccb64dd90c7504e7f26e3de3f1778a5e8b25832a,2,42,41,1,0,0,0,8,114,16,1,2,0.495173479,3034,72,11,402,400,2,14236,14179,57,365,366,1,1,99.86086419,NoArch
59721fceb41f81cfb01f36d6318a2883e68c496a,2,15,4,11,0,0,0,22,37,0,1,1,0.629249224,1632,73,12,297,296,1,13357,13343,14,177,176,1,0,100,NoArch
c501736e7962d6c0bd0cb2257583decd240fbbea,1,13,7,6,0,0,0,3,3,27,1,1,0,479,200,10,58,57,1,3423,3382,41,24,24,0,1,100,NoArch
462f26696b9525cb54a33ca70eea2b72f0df96ab,0,0,0,0,0,0,0,0,0,0,0,0,0,0,28,3,0,0,0,0,0,0,0,0,0,1,100,NoArch
8c186eba32ba71b80c79e8e8915923185fb44c6b,0,0,0,0,0,0,0,0,0,0,0,0,0,0,29,4,0,0,0,0,0,0,0,0,0,1,100,NoArch
d6ba8d8bb7d6026ea98bd03e3de87d800513dccb,9,368,351,17,1,1,2,15,22,31,2,5,2.200005559,1832,109,7,211,219,8,11951,11930,21,79,85,6,1,99.92247461,NoArch
bafe564daf9007810f3011c0bfd67c23f8a56a73,0,0,0,0,0,0,0,0,0,0,0,0,0,0,110,8,0,0,0,0,0,0,0,0,0,0,100,NoArch
fbc6595b34fe3e6482cee8b17afcf3b0eb12872b,0,0,0,0,0,0,0,0,0,0,0,0,0,0,111,9,0,0,0,0,0,0,0,0,0,0,100,NoArch
d886e9eb8df9d74d2b8a00a98e851704af183364,0,0,0,0,0,0,0,0,0,0,0,0,0,0,201,8,0,0,0,0,0,0,0,0,0,0,100,NoArch
7bc940c7e4fb26dfa850689161dec754005b406b,1,85,1,84,0,0,0,8,10,70,1,1,0,482,38,2,29,26,3,4471,3869,602,16,15,1,1,100,NoArch
4a4407288a10feac3b8e781c03347424be84eba5,0,0,0,0,0,0,0,0,0,0,0,0,0,0,39,3,0,0,0,0,0,0,0,0,0,0,100,NoArch
23b0dfc337737e2d1e5b792f999c311df62f9498,1,16,9,7,0,0,0,22,66,55,1,1,0,2205,202,9,197,196,1,17046,16978,68,126,126,0,0,100,NoArch
06adf27051da79fafe132acff004a365692a760a,0,0,0,0,0,0,0,0,0,0,0,0,0,0,203,10,0,0,0,0,0,0,0,0,0,1,100,NoArch
d979feee3483debe7c8aa0f3d25ebed18e41bcfe,1,0,5,5,0,0,0,22,67,0,1,1,0,2212,59,3,197,197,0,17021,17046,25,126,126,0,1,100,NoArch
bdc0f9336a1fcd86d8fd216124ae4f7f7a6ea64b,0,0,0,0,0,0,0,0,0,0,0,0,0,0,55,11,0,0,0,0,0,0,0,0,0,1,100,NoArch
52cb67bf48411b4c8e7da8df12ed00b72d4e186c,0,0,0,0,0,0,0,0,0,0,0,0,0,0,74,9,0,0,0,0,0,0,0,0,0,1,100,NoArch
54753a5a3089bffb9922f1182ee59bd6b68db632,0,0,0,0,0,0,0,0,0,0,0,0,0,0,75,10,0,0,0,0,0,0,0,0,0,1,100,NoArch
46deea05c402e986395875b35f8bdab6cd8bbda5,3,200,17,183,0,0,0,1,60,15,2,3,0.752377724,1665,60,4,185,176,9,12091,10485,1606,73,67,6,1,98.05833197,NoArch
c0cadbca6560ace603acc056af5597befa6be6e7,0,0,0,0,0,0,0,0,0,0,0,0,0,0,112,9,0,0,0,0,0,0,0,0,0,1,100,NoArch
40c80f6627956e4cdb7a931c40b7363e81272c58,0,0,0,0,0,0,0,0,0,0,0,0,0,0,56,11,0,0,0,0,0,0,0,0,0,1,100,NoArch
a462584e04a2ba75d4a8b51aeeb203bb254d0f72,0,0,0,0,0,0,0,0,0,0,0,0,0,0,76,11,0,0,0,0,0,0,0,0,0,1,100,NoArch
4c40d1645cbe6827095bfe9296eefc876dd5bd7d,1,4,3,1,0,0,0,4,14,19,1,1,0,1047,77,12,126,126,0,6287,6284,3,41,41,0,1,100,NoArch
89a27a1ccf4bdc32c60158aad3ca6e8a7068c206,3,40,2,38,0,0,0,2,3,83,1,3,1.008760027,996,204,5,101,96,5,4382,4201,181,57,54,3,1,100,NoArch
5c57920fe7a953623d4bbc3b5f50088f4f218290,0,0,0,0,0,0,0,0,0,0,0,0,0,0,1,0,0,0,0,0,0,0,0,0,0,1,100,NoArch
fcaeaea62f42e0bd1e49970ebcc1830519c80f2a,1,12,5,7,0,0,0,2,2,91,1,1,0,169,0,0,12,12,0,791,777,14,6,6,0,1,100,NoArch
2ec27cc436dcd70a61a628c3228a9c3096eb3361,8,153,97,56,1,0,1,7,48,175,2,6,1.970140909,4468,57,12,592,590,2,26199,25999,200,195,193,2,1,99.9826419,NoArch
8fdbbd2e831d7a5b51bb023017c8f653787e8e6c,0,0,0,0,0,0,0,0,0,0,0,0,0,0,113,9,0,0,0,0,0,0,0,0,0,0,100,NoArch
c872dc14ef648ae130539ecdafa39f58964e201d,1,1,1,0,0,0,0,7,10,456,1,1,0,313,204,11,22,22,0,1776,1776,0,22,22,0,1,100,NoArch
6fccca6c04724a304c117b77a8cb42b0e433a719,5,14,22,8,0,0,0,48,107,177,4,4,1.386274094,4556,58,13,567,567,0,24863,24885,22,256,256,0,1,100,NoArch
f8ce1c53eca05d319dccd0111173567e1ceaa921,0,0,0,0,0,0,0,0,0,0,0,0,0,0,114,10,0,0,0,0,0,0,0,0,0,0,100,NoArch
304c5bf20ee6c8c45cb3d03213b52d6ea85530c4,1,2,1,1,0,0,0,5,8,195,1,1,0,122,61,4,16,16,0,615,612,3,6,6,0,1,100,NoArch
0fb2d5bae12e6d6e10ba929e47c361997829b708,7,126,19,107,0,0,0,1,41,47,2,7,2.184470123,2893,32,1,392,379,13,20748,20030,718,134,130,4,2,100,NoArch
5bd7a677b260f6252979a6f9d2245fc34e6e6b19,2,29,10,19,0,0,0,13,42,11,1,2,0.6789539,1369,78,13,201,199,2,9080,9014,66,64,62,2,1,100,NoArch
25501c99e9e353bb8cf3757404cc0cd1835e03b3,0,0,0,0,0,0,0,0,0,0,0,0,0,0,59,14,0,0,0,0,0,0,0,0,0,1,100,NoArch
4081e99254a6a95f7dc367f503addf1a28bf6249,0,0,0,0,0,0,0,0,0,0,0,0,0,0,79,14,0,0,0,0,0,0,0,0,0,0,100,NoArch
aee15623ce74de3b04e1c542215f238877fdff03,0,0,0,0,0,0,0,0,0,0,0,0,0,0,205,12,0,0,0,0,0,0,0,0,0,1,100,NoArch
91bac98bcc2d8b478a523bf0536259dbce223653,0,0,0,0,0,0,0,0,0,0,0,0,0,0,115,11,0,0,0,0,0,0,0,0,0,1,100,NoArch
16dbaab7799de4f477af82145726b230711350a4,0,0,0,0,0,0,0,0,0,0,0,0,0,0,80,15,0,0,0,0,0,0,0,0,0,1,100,NoArch
51556d13bf2b5b97c43b9f43f2be16546ea829a0,0,0,0,0,0,0,0,0,0,0,0,0,0,0,116,12,0,0,0,0,0,0,0,0,0,1,100,NoArch
8d6d9b98ac7df881e1b67c0dad80606bbe767fda,0,0,0,0,0,0,0,0,0,0,0,0,0,0,117,5,0,0,0,0,0,0,0,0,0,0,100,NoArch
8683fb1d49b408a5012185104b13ae59c376a709,2,12,7,5,0,0,0,8,34,72,1,1,0.74248757,589,193,11,72,70,2,3478,3455,23,27,27,0,1,100,NoArch
7612549bcccbed37072677b3efda631f4c0cbc14,0,0,0,0,0,0,0,0,0,0,0,0,0,0,0,0,0,0,0,0,0,0,0,0,0,0,100,NoArch
9e87d164b3f39d795ef70a1f22ba57353d6e198f,33,1226,633,593,1,0,1,15,45,46,3,16,3.021149871,15033,45,9,1380,1340,40,101258,97953,3305,642,608,34,1,97.84067698,Arch
ca273274b0b37c9c7025c5e2bf7befa871f8aa5a,0,0,0,0,0,0,0,0,0,0,0,0,0,0,104,8,0,0,0,0,0,0,0,0,0,1,100,NoArch
939b3d1b07f9c0a11050be0f45e0c5843bc5422e,0,0,0,0,0,0,0,0,0,0,0,0,0,0,0,0,0,0,0,0,0,0,0,0,0,1,100,NoArch
b2f09a1feeb90e33ee2e6b65a9ee906cc3022a63,0,0,0,0,0,0,0,0,0,0,0,0,0,0,105,9,0,0,0,0,0,0,0,0,0,1,100,NoArch
d43b4cd95e2d23aafcd3aef390b94bb255354e97,1,1,1,0,0,0,0,1,2,11,1,1,0,246,46,10,16,16,0,1584,1584,0,2,2,0,1,100,NoArch
e33149be9a5b8718f3b97e335ae249db0cef4b2d,3,33,13,20,0,0,0,1,5,207,2,3,1.201670054,1531,199,8,135,134,1,7927,7733,194,21,20,1,1,100,NoArch
531381faffe634e0976a756d4213f5ff0ebd54f4,2,19,3,16,0,0,0,2,2,50,1,1,0.902393283,652,31,4,119,117,2,3816,3705,111,10,9,1,1,100,NoArch
9d744bb35ce54d347c5ef50adeba3f2a8840d043,3,140,11,129,0,0,0,20,34,11,2,3,1.007814008,2594,65,14,304,295,9,17446,16595,851,160,157,3,1,100,NoArch
6a8396420c12bbac46b1cad46f1a5a88769959f6,5,63,4,59,0,0,0,5,28,269,1,2,2.076178475,2025,36,1,144,139,5,13112,12730,382,74,72,2,1,100,NoArch
b3c834a2426197b69e9ce2120e8e404a99e4dd88,1,167,0,167,1,0,1,1,1,0,1,1,0,0,194,11,10,0,10,920,0,920,5,0,5,1,99.97036159,NoArch
cd2c346df670b4b8b46066ae097edd8e95bcc6f4,1,137,19,118,0,0,0,4,11,14,1,1,0,922,66,14,125,107,18,6237,5482,755,41,37,4,1,100,NoArch
ef06e4a5261008a7c64cc84a3cb62e106e121f93,1,1,1,0,0,0,0,6,11,3,1,1,0,252,195,12,26,26,0,1210,1210,0,25,25,0,1,100,NoArch
672974c4129135eac6e9d62dd23cc5d3e7a10863,0,0,0,0,0,0,0,0,0,0,0,0,0,0,67,11,0,0,0,0,0,0,0,0,0,1,100,NoArch
df87095ef03b73b779bcddb65b7ac372686eade2,8,92,33,59,0,0,0,17,36,56,5,8,2.537434208,4989,57,6,338,333,5,37256,36346,910,179,179,0,1,100,NoArch
7a6272fba150fa9d7acd0b57cc4041ec49019faf,0,0,0,0,0,0,0,0,0,0,0,0,0,0,1,1,0,0,0,0,0,0,0,0,0,1,100,NoArch
67215abaf0bff74b85ffc51b2e674a37b0a124c1,1,44,18,26,0,0,0,4,7,107,1,1,0,61,200,7,10,8,2,384,237,147,2,1,1,1,100,NoArch
d7cc767dbc7687a03bf3701267e683a96d8dfab9,4,59,57,2,0,0,0,11,56,4,2,3,1.274926588,5800,47,9,514,515,1,38550,38597,47,180,179,1,1,100,NoArch
26eb7b8183767c1275aaeaa4c7cd39aee0a10792,0,0,0,0,0,0,0,0,0,0,0,0,0,0,1,0,0,0,0,0,0,0,0,0,0,1,100,NoArch
1cc7542357af201c88b8e55ff2055c354ee38b88,0,0,0,0,0,0,0,0,0,0,0,0,0,0,68,12,0,0,0,0,0,0,0,0,0,0,100,NoArch
81b25c543a5eabd6d0dfe460ad7f9776d8cf5573,15,173,177,4,0,0,0,4,112,21,3,13,3.334039016,12701,48,9,1360,1364,4,71069,71324,255,811,815,4,1,99.96048992,NoArch
5e65aefc61e973a959c11f08c2aa9f19fefc09fc,1,19,0,19,0,0,0,2,2,55,1,1,0,72,106,7,5,5,0,410,410,0,2,2,0,1,100,NoArch
3e97c88c4ff9cbeb312805daf6d52da5f1bcb0bd,5,34,4,30,0,0,0,2,113,97,1,4,2.127773932,3751,69,13,459,455,4,17309,17133,176,403,401,2,1,94.37608319,Arch
15c264535ffbe73eac4dee6f15e0d2e65a8d4c78,1,1,2,1,0,0,0,18,35,11,1,1,0,462,37,2,58,58,0,2735,2735,0,23,23,0,0,100,NoArch
7a9d48d126b1474f1bb7cfbe8b1c0b0391ef49d2,12,291,147,144,2,1,3,10,62,243,2,7,3.149375204,5554,49,9,710,696,14,31413,30856,557,437,426,11,1,99.92281568,NoArch
976840e8eb5fee9bfb2ed029e65aec5b7033faf2,0,0,0,0,0,0,0,0,0,0,0,0,0,0,50,10,0,0,0,0,0,0,0,0,0,1,100,NoArch
12731f5b891b41ecbbf6f79e5b33b6eb581771e8,2,5,4,1,0,0,0,3,7,126,1,1,0.99107606,248,196,11,27,25,2,1794,1741,53,7,7,0,1,99.99228514,NoArch
63a099c5b73d47abbf99e757c860953c013e106f,1,12,4,8,0,0,0,4,13,5,1,1,0,1039,70,13,126,125,1,6284,6232,52,41,41,0,1,100,NoArch
2245a9515f1d048b3f0a832c5087c227fbab132e,5,75,51,24,0,0,0,3,21,110,1,4,1.647985066,3057,197,12,351,352,1,18863,18548,315,142,143,1,1,100,NoArch
5c41e30ac5c29629ab1f993aa20b692ae3565d92,0,0,0,0,0,0,0,0,0,0,0,0,0,0,0,0,0,0,0,0,0,0,0,0,0,1,100,NoArch
52ea1e496496ddf3e8a55e0d0144251464d8cb1b,0,0,0,0,0,0,0,0,0,0,0,0,0,0,198,13,0,0,0,0,0,0,0,0,0,0,100,NoArch
458fdd5611e4f246cc35a6e5436731eb5d526ab5,0,0,0,0,0,0,0,0,0,0,0,0,0,0,51,11,0,0,0,0,0,0,0,0,0,1,100,NoArch
3d8fc78c6675cf2df79bd359276bc1ba3440befd,4,118,20,98,0,0,0,1,58,26,2,4,1.375373589,1715,58,7,187,181,6,11543,10679,864,71,68,3,1,99.97686613,NoArch
f91e9e63e136ea558bc5c5fdfd97641dcbbc6813,7,88,22,66,0,0,0,21,36,20,2,6,2.375626628,6015,199,13,705,695,10,47229,46694,535,334,330,4,1,100,NoArch
101b82a6797bb3d1ffb3b4ff61cbfdf99916f029,2,32,0,32,0,0,0,30,63,2,2,2,0.543564443,2167,52,12,295,289,6,11896,11757,139,129,127,2,1,100,NoArch
d16740976e3aa89f2d934b0f1c48208dfe40bc5f,3,70,2,68,0,0,0,48,105,23,2,3,1.463806233,2243,9,3,317,311,6,14953,14547,406,90,86,4,1,100,NoArch
84783b9779b528ab85298a4630f62fe9c2299560,0,0,0,0,0,0,0,0,0,0,0,0,0,0,107,6,0,0,0,0,0,0,0,0,0,1,100,NoArch
25dce94ba21750f5cc06212cd53aab4be804f0a7,0,0,0,0,0,0,0,0,0,0,0,0,0,0,2,1,0,0,0,0,0,0,0,0,0,0,100,NoArch
2d46d5287eceafee9b52c2ff5b245721114f5b99,1,2,1,1,0,0,0,48,106,1,1,1,0,928,10,4,112,112,0,5902,5894,8,26,26,0,1,100,NoArch
2e6e302efec2fa848ded4f88a95540ad2adb7798,0,0,0,0,0,0,0,0,0,0,0,0,0,0,108,7,0,0,0,0,0,0,0,0,0,1,100,NoArch
7b78dff45f646597d442e3a2b950c5917eea92f6,10,94,73,21,0,0,0,3,36,153,1,4,2.734856931,2205,53,11,180,181,1,14592,14418,174,81,80,1,1,100,NoArch
434e782b7d0d631e2106375ffa46332b67fcac1d,0,0,0,0,0,0,0,0,0,0,0,0,0,0,54,12,0,0,0,0,0,0,0,0,0,1,100,NoArch
43de2b470288aa3914ba712b7d2a1a806e317e53,2,12,2,10,0,0,0,1,6,42,1,2,0.591672779,524,201,4,39,38,1,2819,2792,27,19,19,0,1,100,NoArch
0281725c6bc3d5bc0c2a94a53a819fe6949976ba,8,38,88,50,0,0,0,17,28,9,5,8,2.551204773,4564,202,4,251,254,3,33298,34101,803,145,145,0,0,100,NoArch
6f9b02decb5bb2b83709b1b6ec04a97e4d102c11,1,10,3,7,0,0,0,1,2,70,1,1,0,140,203,5,13,12,1,720,654,66,6,6,0,1,100,NoArch
c7f41f9018e62354cb1df335a5a8c6fd07aa261a,1,10,2,8,0,0,0,6,7,400,1,1,0,213,71,13,29,27,2,1092,1049,43,13,13,0,1,100,NoArch
bab691692e31ae3e432bb6cf4c90436fba408a2c,2,42,41,1,0,0,0,8,114,21,1,2,0.495173479,3034,72,14,402,400,2,14236,14179,57,365,366,1,1,99.86086419,NoArch
571cbe4c119012d53a919e556d6419ce7894bf16,2,15,4,11,0,0,0,22,37,4,1,1,0.629249224,1632,73,15,297,296,1,13357,13343,14,177,176,1,0,100,NoArch
a081c2b9b54dcf5720230a2c7e0229c765208e24,1,13,7,6,0,0,0,3,3,27,1,1,0,479,200,11,58,57,1,3423,3382,41,24,24,0,1,100,NoArch
44b3630b5dc5748ea27e65614cb37e9fd9e3f07b,0,0,0,0,0,0,0,0,0,0,0,0,0,0,28,3,0,0,0,0,0,0,0,0,0,1,100,NoArch
0048b78d18499280f09df8866952968e8efdb45b,105,1294,2983,1689,1,4,5,1,111,125,10,57,5.400808159,49464,193,3,4928,5080,152,295905,306202,10297,2448,2532,84,1,95.26297756,Arch
52205897a7fb199d31f44cf6da1a926ebd960848,33,1226,633,593,1,0,1,15,45,66,3,16,3.021149871,15033,45,2,1380,1340,40,101258,97953,3305,642,608,34,1,97.84067698,Arch
0151d3543287212d8b4b33ba4397239f3a1b0b36,7,88,22,66,0,0,0,21,36,23,2,6,2.375626628,6015,199,9,705,695,10,47229,46694,535,334,330,4,1,100,NoArch
7baf05aafafb8fb96bbbac6f0f0c99975741b4ae,10,94,73,21,0,0,0,3,36,150,1,4,2.734856931,2205,53,10,180,181,1,14592,14418,174,81,80,1,1,100,NoArch
6621f3cdbba1d913a4bc7f534c4837d010f45fd9,0,0,0,0,0,0,0,0,0,0,0,0,0,0,29,4,0,0,0,0,0,0,0,0,0,1,100,NoArch
d6ba8d8bb7d6026ea98bd03e3de87d800513dccb,9,368,351,17,1,1,2,15,22,31,2,5,2.200005559,1833,109,7,211,219,8,11951,11930,21,79,85,6,1,99.92247461,NoArch
f0ab4a6e9ef433ac943d2409051418f7f80a6902,10,354,369,15,1,1,2,9,21,139,2,6,2.237275507,2202,0,0,278,270,8,13586,13584,2,102,96,6,1,99.92247461,NoArch
bafe564daf9007810f3011c0bfd67c23f8a56a73,10,369,354,15,1,1,2,8,22,145,2,6,2.237275507,2187,110,8,270,278,8,13584,13586,2,96,102,6,0,99.92247461,NoArch
d6a64f765ee150e9d415efc55b6b4cc5c8e770ec,9,351,368,17,1,1,2,15,21,126,2,5,2.200005559,1850,109,7,219,211,8,11930,11951,21,85,79,6,1,99.92247461,NoArch
9e8664f4d2503940881ee97280e2b9bb61dc2b9e,0,0,0,0,0,0,0,0,0,0,0,0,0,0,110,8,0,0,0,0,0,0,0,0,0,0,100,NoArch
57612c5c323a2caab5e9c25d2b6617b0105d38e8,2,97,1,96,0,0,0,7,17,45,1,2,0.475431646,1250,201,9,75,71,4,10201,9441,760,36,34,2,1,100,NoArch
e8ab915aff8afc831e06f6d358ad649e91d486c2,0,0,0,0,0,0,0,0,0,0,0,0,0,0,202,10,0,0,0,0,0,0,0,0,0,0,100,NoArch
99dd1cb6e63600681aa11b3a03bc16d1401d8055,1,85,1,84,0,0,0,8,10,59,1,1,0,482,38,2,29,26,3,4471,3869,602,16,15,1,1,100,NoArch
b8e465fdfcac1961fe05ed44993c8c6139e13b31,0,0,0,0,0,0,0,0,0,0,0,0,0,0,39,3,0,0,0,0,0,0,0,0,0,0,100,NoArch
05dfc39c296c74e2a667cb92e7ef7798f9ea1cd7,1,16,9,7,0,0,0,22,66,53,1,1,0,2205,203,10,197,196,1,17046,16978,68,126,126,0,0,100,NoArch
b00d03fd62795f739076423994841bf8cc1151d4,0,0,0,0,0,0,0,0,0,0,0,0,0,0,204,11,0,0,0,0,0,0,0,0,0,1,100,NoArch
1718bcab847962ce65237ebddd90034bd065d4da,1,0,5,5,0,0,0,22,67,0,1,1,0,2212,59,3,197,197,0,17021,17046,25,126,126,0,1,100,NoArch
7ecb47cd21a2c387e46d600aea628f0ded27e302,0,0,0,0,0,0,0,0,0,0,0,0,0,0,55,11,0,0,0,0,0,0,0,0,0,1,100,NoArch
ef6c5611dc66755dc8a1fac0986d638e7d3e7dd8,0,0,0,0,0,0,0,0,0,0,0,0,0,0,74,9,0,0,0,0,0,0,0,0,0,1,100,NoArch
52d878c52bdc2c65fd154aa731d70b311a0db8a1,0,0,0,0,0,0,0,0,0,0,0,0,0,0,75,10,0,0,0,0,0,0,0,0,0,1,100,NoArch
4f44e6aeb5adbcb45861f2c2f8011a6bf616b69c,3,200,17,183,0,0,0,1,60,20,2,3,0.752377724,1665,60,4,185,176,9,12091,10485,1606,73,67,6,1,98.06023899,NoArch
9af7b09aecc5e3e7bee8cda129d139fecc550887,0,0,0,0,0,0,0,0,0,0,0,0,0,0,111,8,0,0,0,0,0,0,0,0,0,1,100,NoArch
d886e9eb8df9d74d2b8a00a98e851704af183364,15,400,748,348,1,1,2,22,65,20,3,11,3.101942518,7458,201,8,646,671,25,50623,53613,2990,307,322,15,0,97.97723364,Arch
81bf771e56cb091a4f0f98746b93d146866729ef,10,447,368,79,1,1,2,15,21,80,2,6,2.446819435,2758,56,12,260,248,12,20030,19291,739,107,99,8,1,99.9132321,NoArch
6f3fe880d2008b760bf96e30612cc5ea9a8c2d95,0,0,0,0,0,0,0,0,0,0,0,0,0,0,76,11,0,0,0,0,0,0,0,0,0,1,100,NoArch
28fdddfee093bee38c99ab07545df71ade00d383,1,4,3,1,0,0,0,4,14,26,1,1,0,1047,77,12,126,126,0,6287,6284,3,41,41,0,1,100,NoArch
7a9e411e9d7c687efa1309c53ac2615e37c29cf9,3,40,2,38,0,0,0,2,3,82,1,3,1.008760027,996,204,5,101,96,5,4382,4201,181,57,54,3,1,100,NoArch
6a3ce928b16d4060b5af94f4c92802da9510406b,0,0,0,0,0,0,0,0,0,0,0,0,0,0,1,0,0,0,0,0,0,0,0,0,0,1,100,NoArch
408663c42b93dfffd55547e6e0262d3ef0388c78,1,12,5,7,0,0,0,2,2,91,1,1,0,169,0,0,12,12,0,791,777,14,6,6,0,1,100,NoArch
f7544e23ac6899b2d8b28a01c79caad1facd1379,8,153,97,56,1,0,1,7,48,178,2,6,1.970140909,4468,57,12,592,590,2,26199,25999,200,195,193,2,1,99.98265695,NoArch
40c80f6627956e4cdb7a931c40b7363e81272c58,23,475,656,181,1,2,3,4,47,26,5,16,3.370982143,9619,56,11,1072,1091,19,56552,57689,1137,393,406,13,1,99.89589659,NoArch
a9506aa545b724547401ff1060efc75d5ba3ded1,11,448,369,79,1,1,2,15,21,115,2,7,2.465591285,3071,205,11,282,270,12,21806,21067,739,129,121,8,1,99.91326221,NoArch
4b296f79ccfbb3cbd4465c6f02912024fb6b68b4,5,14,22,8,0,0,0,48,107,181,4,4,1.386274094,4556,58,11,567,567,0,24863,24885,22,256,256,0,1,99.99133148,NoArch
c872dc14ef648ae130539ecdafa39f58964e201d,15,390,461,71,1,1,2,48,106,19,4,10,2.654709286,7385,204,11,815,827,12,44176,44893,717,355,363,8,1,99.8959327,NoArch
4e1ac467da0047b04fd6ad02f194c523e2e49f3e,10,447,368,79,1,1,2,15,21,80,2,6,2.446819435,2758,112,6,260,248,12,20030,19291,739,107,99,8,0,99.8959327,NoArch
de5fa1fe03a9f2805316069cf9523c0e3be83dfc,1,2,1,1,0,0,0,5,8,193,1,1,0,122,61,4,16,16,0,615,612,3,6,6,0,1,100,NoArch
037f89ee7c823b2b45befd9706fadfae6e21e5c1,7,126,19,107,0,0,0,1,41,49,2,7,2.184470123,2893,32,0,392,379,13,20748,20030,718,134,130,4,2,100,NoArch
c4bc2deea0b856107cd8a4293b7577a5a3ea1358,2,29,10,19,0,0,0,13,42,14,1,2,0.6789539,1369,78,10,201,199,2,9080,9014,66,64,62,2,1,100,NoArch
c05a4e7b6fd5ea4b4c161b7698173f991dd8ed21,0,0,0,0,0,0,0,0,0,0,0,0,0,0,59,12,0,0,0,0,0,0,0,0,0,1,100,NoArch
f8ce1c53eca05d319dccd0111173567e1ceaa921,19,398,604,206,1,1,2,1,40,27,2,15,3.094705117,6317,114,10,660,687,27,42345,43871,1526,247,261,14,0,99.8959327,NoArch
20781a5fa6cfcb0069855e57a1974db435de37c9,10,447,368,79,1,1,2,15,21,80,2,6,2.446819435,2758,79,11,260,248,12,20030,19291,739,107,99,8,0,99.8959327,NoArch
7523542c1daff5569ed1cb16fb78ffd1b22f4186,0,0,0,0,0,0,0,0,0,0,0,0,0,0,206,10,0,0,0,0,0,0,0,0,0,1,100,NoArch
505ee672ac0af0d491725763ca5ab8ab403141ab,0,0,0,0,0,0,0,0,0,0,0,0,0,0,113,7,0,0,0,0,0,0,0,0,0,1,100,NoArch
4081e99254a6a95f7dc367f503addf1a28bf6249,10,368,447,79,1,1,2,15,22,24,2,6,2.446819435,2837,79,14,248,260,12,19291,20030,739,99,107,8,0,99.8959327,NoArch
8633bd6e065291956ef9c521cfb830a2552784c2,10,447,368,79,1,1,2,15,21,80,2,6,2.446819435,2758,80,11,260,248,12,20030,19291,739,107,99,8,1,99.8959327,NoArch
16dbaab7799de4f477af82145726b230711350a4,10,368,447,79,1,1,2,15,22,24,2,6,2.446819435,2837,80,15,248,260,12,19291,20030,739,99,107,8,1,99.8959327,NoArch
5e5c177e4b95d73e95cb89e9c03665a9a69a631a,10,447,368,79,1,1,2,15,21,80,2,6,2.446819435,2758,0,0,260,248,12,20030,19291,739,107,99,8,1,99.8959327,NoArch
51556d13bf2b5b97c43b9f43f2be16546ea829a0,10,368,447,79,1,1,2,15,22,24,2,6,2.446819435,2837,116,12,248,260,12,19291,20030,739,99,107,8,1,99.8959327,NoArch
bda3db078e927421c10932cfcb3019cfddb125b6,12,452,369,83,1,1,2,2,21,71,3,8,2.498611398,3683,0,0,291,279,12,24546,23772,774,125,117,8,0,99.8959327,NoArch
d994c58cc020e645e3cc4f71511e5bb5ff8dc3c3,1,5,0,5,0,0,0,2,2,104,1,1,0,327,0,0,46,46,0,2101,2052,49,14,14,0,1,100,NoArch
9054b85961f6822125c6a45729869d9285247ab4,2,1,5,4,0,0,0,3,5,2,1,2,1,929,30,2,31,31,0,4481,4516,35,18,18,0,1,100,NoArch
f2ba0fead24072e37c68477d0cfc3489fa098938,9,65,45,20,0,0,0,6,14,341,1,7,2.764061622,1156,7,0,60,60,0,7426,7369,57,35,33,2,1,99.96534096,NoArch
762623a15cfeba6f3fe936c238d660685ae62b50,0,0,0,0,0,0,0,0,0,0,0,0,0,0,207,7,0,0,0,0,0,0,0,0,0,1,100,NoArch
77e333298d0323a374e735f59beb2aaf0d89e99e,0,0,0,0,0,0,0,0,0,0,0,0,0,0,32,0,0,0,0,0,0,0,0,0,0,1,100,NoArch
6ec039ba4202bcb881044189f52210430a7d33b8,0,0,0,0,0,0,0,0,0,0,0,0,0,0,2,0,0,0,0,0,0,0,0,0,0,0,100,NoArch
e1ccf2e00b1aefbed64b8071c6bc54bd64610daa,8,119,7,112,0,0,0,1,10,88,2,6,2.484226874,3689,205,3,219,211,8,23398,22546,852,135,132,3,1,100,NoArch
924e2e96a63eb5c1b24496ec302e91b6f7a65953,0,0,0,0,0,0,0,0,0,0,0,0,0,0,2,0,0,0,0,0,0,0,0,0,0,0,100,NoArch
cacbd9868733d2e990b7859a6f2c443ee4900997,1,3,1,2,0,0,0,18,26,217,1,1,0,297,0,0,44,44,0,2074,2060,14,12,12,0,1,100,NoArch
52953c8f5e8d9d62a6913649235891be8960d50f,1,1,1,0,0,0,0,4,7,2,1,1,0,786,0,0,16,16,0,3757,3757,0,9,9,0,1,100,NoArch
4e928a6fe1ddd7e126ab155bb1c03f8630bb873d,6,16,16,0,0,0,0,5,115,227,3,3,2.077819531,5029,0,0,509,509,0,21839,21839,0,462,462,0,1,100,NoArch
8d6d9b98ac7df881e1b67c0dad80606bbe767fda,33,438,656,218,1,1,2,17,114,40,4,22,3.658105859,12356,117,5,1056,1076,20,69299,71010,1711,729,742,13,0,99.87861973,NoArch
b27e8b51d80efe556d8166fe37ac82ffc8572893,35,684,439,245,1,1,2,18,115,174,4,24,3.752301989,13075,21,0,1137,1117,20,77211,75312,1899,775,762,13,0,99.8525969,NoArch
e421d536eae236d0b2e29d9a4f59ed65822fd883,1,3,9,6,0,0,0,3,4,93,1,1,0,189,1,1,14,15,1,941,968,27,7,7,0,1,100,NoArch
a1d82b4dc5050b67668e5de5aacf62cdcbd4cb2b,1,1,0,1,0,0,0,29,47,79,1,1,0,556,81,7,75,75,0,3836,3827,9,29,29,0,0,100,NoArch
f492c52ee4d2f3d6dfbbf574833f837322166fbd,1,2,0,2,0,0,0,39,116,3,1,1,0,2589,0,0,381,381,0,11209,11196,13,350,350,0,1,100,NoArch
33ff4752baa80a0092d1fbb3692974b7fa6a7781,3,79,2,77,1,0,1,1,3,67,1,3,0.996940588,527,0,0,66,63,3,3162,2854,308,26,24,2,1,99.98267498,NoArch
6af1ff7a663da57438db8847ca0dfda5a6e381f5,0,0,0,0,0,0,0,0,0,0,0,0,0,0,114,3,0,0,0,0,0,0,0,0,0,0,100,NoArch
9732ba12dac5a79fae7c74cbf61cdb2f2db908c3,0,0,0,0,0,0,0,0,0,0,0,0,0,0,1,0,0,0,0,0,0,0,0,0,0,1,100,NoArch
3343cbb47b75b9d65a73a7a98ed9dae0b5ec58a9,0,0,0,0,0,0,0,0,0,0,0,0,0,0,62,1,0,0,0,0,0,0,0,0,0,0,100,NoArch
8c9209db28c10f211272bf0a18bdcb5b18f5440f,0,0,0,0,0,0,0,0,0,0,0,0,0,0,115,3,0,0,0,0,0,0,0,0,0,1,100,NoArch
1562bb658f8f29f57763eaa6f9bd5a2ed7e80a7c,1,4,4,0,0,0,0,17,28,144,1,1,0,414,63,2,51,50,1,3300,3284,16,24,24,0,1,100,NoArch
f66e83dc6521a57a52385d61d7905fd34ff0e2f2,8,79,43,36,0,0,0,4,16,841,1,8,2.560665835,1684,82,4,180,178,2,11279,11100,179,133,133,0,1,100,NoArch
d794f4fbf9d8ce4c90507e4de36121ac1fc2fd4b,1,2,2,0,0,0,0,36,70,93,1,1,0,831,2,0,113,113,0,5015,5029,14,29,29,0,0,100,NoArch
abb4893b25df47328d01890f0d01fbc4e5d99135,17,121,12,109,0,0,0,19,37,264,2,12,3.213408017,3202,1,0,322,315,7,20481,19992,489,161,157,4,1,100,NoArch
248b0591b031ef5d017bc4f710b9b0496e751c39,0,0,0,0,0,0,0,0,0,0,0,0,0,0,0,0,0,0,0,0,0,0,0,0,0,1,100,NoArch
c319ee9cea78544406e30dd36cc603fd0a0283db,0,0,0,0,0,0,0,0,0,0,0,0,0,0,116,3,0,0,0,0,0,0,0,0,0,1,100,NoArch
52fe1c9faeb83fe51b520e18d0c37b67ad3fcfe4,6,209,3,206,3,0,3,9,71,369,1,3,2.387963131,3104,208,2,336,313,23,23241,22396,845,163,157,6,1,99.93940968,NoArch
9625d16937954a54420384b41f964e48cba8cc2f,0,0,0,0,0,0,0,0,0,0,0,0,0,0,3,0,0,0,0,0,0,0,0,0,0,1,100,NoArch
80f99893a06b984da7332d7db05d6ac309810da0,0,0,0,0,0,0,0,0,0,0,0,0,0,0,1,0,0,0,0,0,0,0,0,0,0,0,100,NoArch
569a76a9a5389efb74ec88b81c616f8ead58df5c,1,2,0,2,0,0,0,6,10,110,1,1,0,318,209,2,24,24,0,2389,2370,19,21,21,0,0,92.5008259,Arch
75eaa0bffe86306c5df7a52c42ee41b7c7dc24c1,1,10,7,3,0,0,0,2,2,1657,1,1,0,91,2,1,10,9,1,402,396,6,6,6,0,1,100,NoArch
4c708402758545c5097579d1a92e8d710ef1f61d,1,8,0,8,0,0,0,2,2,147,1,1,0,264,31,0,11,9,2,1805,1772,33,10,9,1,0,100,NoArch
6b47ef6ed223e10a05b91acc3331cff2fa069d87,2,21,1,20,0,0,0,3,6,56,1,2,0.994030211,2105,1,1,103,102,1,13822,13647,175,72,72,0,1,100,NoArch
6285a239a35c5808ba2eea00193a51564c716ab6,18,204,173,31,0,0,0,2,65,301,3,9,3.177977283,4629,210,3,625,615,10,27466,27008,458,290,288,2,1,95.26523189,Arch
6fd21d0f1043d0a06b93332d86e63d7b708fcbe8,3,15,3,12,0,0,0,2,2,147,1,3,1.122113677,1024,0,0,111,109,2,6168,6107,61,66,64,2,1,100,NoArch
4258a715174e0a97271112148ab20ef9307e2bd8,1,19,9,10,0,0,0,15,27,61,1,1,0,619,0,0,84,81,3,3127,3077,50,29,28,1,1,100,NoArch
4a8589f22254851b55dfce06bd91db57659df8c9,12,194,166,28,2,1,3,9,13,156,1,6,2.425487044,2098,60,0,134,138,4,15637,16348,711,69,73,4,1,99.90896359,NoArch
7f0c1f3ddfe5e80453b0e34f7938824106a7e25e,0,0,0,0,0,0,0,0,0,0,0,0,0,0,1,1,0,0,0,0,0,0,0,0,0,1,100,NoArch
b10ca7e69f43cf2f14b09d0a610102ab058b1511,3,31,9,22,0,0,0,1,69,70,1,2,1.336666482,2619,211,3,239,235,4,20120,19883,237,154,152,2,1,100,NoArch
ecd47e7aae39455262470410ab73c13c0287ad36,0,0,0,0,0,0,0,0,0,0,0,0,0,0,22,0,0,0,0,0,0,0,0,0,0,1,100,NoArch
0cec955fa26b2370a0ada56e6909a39cdd445047,5,30,4,26,0,0,0,7,16,314,1,4,1.999919261,1643,212,4,243,238,5,9800,9619,181,116,114,2,2,100,NoArch
701f8c039d1cd0104cff4d04f60b159c9e38d84e,26,126,87,39,1,0,1,2,10,122,1,20,4.036274178,7511,5,0,630,632,2,42970,42574,396,361,363,2,1,94.58489779,Arch
8ad0bb97453ee2d625cf2b41374d781d186aef5d,1,1,1,0,0,0,0,4,4,87,1,1,0,485,0,0,58,58,0,3421,3423,2,24,24,0,0,100,NoArch
7fb436d3cf66748f32776cf3db2d943f97b52160,6,40,11,29,0,0,0,4,5,334,2,5,2.127896304,1761,6,1,99,97,2,10412,10247,165,66,64,2,1,99.96901467,NoArch
a704e3740c7b45fa080ff5e57ff14d32530300a1,1,1,1,0,0,0,0,2,3,1,1,1,0,255,7,2,25,25,0,1137,1137,0,9,9,0,1,100,NoArch
5c4813f1011baaa00856f88c69873923baafdba4,3,52,13,39,0,0,0,22,108,196,1,3,1.177329366,3266,213,5,341,334,7,23923,23570,353,166,165,1,1,99.96901467,NoArch
52e63b39d6189beb3b381944ed553bb0052b12c9,27,41,41,0,0,0,0,12,61,155,2,18,4.589020907,10915,0,0,1143,1143,0,70734,70486,248,468,468,0,1,100,NoArch
6e16e719cd614329018cd34a7c57d342fe2fa376,3,96,3,93,0,0,0,10,117,295,1,2,1.465281976,3741,0,0,498,487,11,17860,17380,480,416,406,10,1,100,NoArch
75f847691f0bdaf226d4713a8cb8c7639cffd5e5,0,0,0,0,0,0,0,0,0,0,0,0,0,0,40,0,0,0,0,0,0,0,0,0,0,1,100,NoArch
1fded18dff5bae064479d52b4e44f9fcf5bbb1b7,1,3,1,2,0,0,0,7,9,183,1,1,0,114,0,0,28,28,0,606,580,26,15,15,0,0,99.80472765,NoArch
61030d8e7a5a05e215efed672267ac163b0cbcf6,41,1510,237,1273,12,1,13,2,118,267,3,25,4.336124421,9724,8,0,1298,1191,107,60405,53372,7033,875,799,76,1,93.38842975,Arch
43e08193ef712c19bf986c65a184991c6de960b6,2,50,0,50,0,0,0,2,21,72,2,2,0.468995594,476,206,0,33,32,1,3463,3091,372,22,21,1,1,100,NoArch
a7a42e4490cc8a96b12b8ebbecb4b90d8e8ecbdb,0,0,0,0,0,0,0,0,0,0,0,0,0,0,41,1,0,0,0,0,0,0,0,0,0,2,100,NoArch
ad773b3d9622ebed9a8419eb5095aa6dbb8d08f0,8,170,16,154,1,0,1,14,119,80,2,7,2.031950358,5647,14,0,817,799,18,28756,27924,832,576,564,12,1,99.98591152,NoArch
fdd96cc97ef6a5033b9657e22278bdffd71a41f3,1,1,1,0,0,0,0,1,2,170,1,1,0,119,207,1,12,12,0,670,672,2,6,6,0,1,100,NoArch
d52d13302db2eba94b25ddb680c58682760076e1,4,16,8,8,0,0,0,1,7,106,2,4,1.829172272,810,208,2,83,82,1,4542,4463,79,40,39,1,1,100,NoArch
d422f69a0dd51694c035db0e15b8127e1ebed277,0,0,0,0,0,0,0,0,0,0,0,0,0,0,2,2,0,0,0,0,0,0,0,0,0,1,100,NoArch
99555c897acf9bdd576e7ab233dc448d537e7aea,1,3,0,3,0,0,0,19,58,10,1,1,0,528,2,1,81,81,0,3744,3718,26,35,35,0,1,100,NoArch
f8b939961553fc3f647862c65d0040783eb726b4,0,0,0,0,0,0,0,0,0,0,0,0,0,0,214,6,0,0,0,0,0,0,0,0,0,0,100,NoArch
ebbe56e8622441a57fda63b0392cd6f7c265ec1e,5,18,10,8,0,0,0,2,59,189,3,5,2.123946782,1375,209,3,178,178,0,9720,9765,45,99,99,0,0,99.97886431,NoArch
f1f8a1abb7636b43463ee86bf6db453ddb1256e1,1,3,0,3,0,0,0,20,38,36,1,1,0,464,210,4,57,57,0,2771,2765,6,24,24,0,1,100,NoArch
a1017c66aaa377dad7e5e62f773bb714d53fc353,1,4,0,4,0,0,0,2,3,103,1,1,0,147,3,0,13,13,0,771,720,51,6,6,0,0,100,NoArch
008616c4f68a134290c46b0a258e92f2be67b4c3,0,0,0,0,0,0,0,0,0,0,0,0,0,0,2,0,0,0,0,0,0,0,0,0,0,1,100,NoArch
199f64255e9996813d6c0b43949ec93a00ac1952,0,0,0,0,0,0,0,0,0,0,0,0,0,0,4,1,0,0,0,0,0,0,0,0,0,1,100,NoArch
551aa959c57721a5cc4d3f63f79e0201978980a2,1,3,10,7,0,0,0,2,4,1,1,1,0,151,211,5,12,13,1,705,771,66,6,6,0,1,100,NoArch
6573469e73ea51ed6d1c24504e8be5abfa91c642,0,0,0,0,0,0,0,0,0,0,0,0,0,0,3,0,0,0,0,0,0,0,0,0,0,1,100,NoArch
6f37863ba8ded3f5550cf608b3e42fe197331ed4,1,0,2,2,0,0,0,10,24,15,1,1,0,1709,212,6,205,205,0,9555,9565,10,91,91,0,1,100,NoArch
1da0b21edd6693e9025e45889cc7b1c37658a4e1,1,15,2,13,0,0,0,3,4,22,1,1,0,507,1,1,57,55,2,3669,3564,105,32,31,1,1,100,NoArch
c7576f7613ba76ab7db6608598182d8970ce1bd9,3,10,4,6,0,0,0,1,60,33,2,3,1.148834854,2858,213,7,357,356,1,16122,16106,16,165,164,1,1,100,NoArch
85b146d3d508e68b2f1ff10f232c37c6a474b77b,17,1275,968,307,6,5,11,1,29,230,1,9,3.327139847,2858,4,1,311,280,31,19819,18351,1468,118,103,15,1,99.78128969,NoArch
7d02b1fd3c74abfbd118f69a10a8c106cc900a3e,2,1,4,3,0,0,0,48,109,617,2,2,0.970950594,1099,215,6,132,132,0,6875,6879,4,31,31,0,0,100,NoArch
2af98303d3881e5d1da7d2e08f904b18f8b79488,1,39,8,31,0,0,0,18,35,225,1,1,0,434,59,0,56,51,5,2958,2783,175,18,17,1,1,100,NoArch
b5adba3e55e57b67618e114f29397912a9f7f7c0,0,0,0,0,0,0,0,0,0,0,0,0,0,0,117,0,0,0,0,0,0,0,0,0,0,0,100,NoArch
8ec625d4d53be9ca7987c86484ac459fafbd8ecc,0,0,0,0,0,0,0,0,0,0,0,0,0,0,23,1,0,0,0,0,0,0,0,0,0,1,100,NoArch
922f765ead3c471aa0d9aa44b1782d381bbfa9d9,0,0,0,0,0,0,0,0,0,0,0,0,0,0,3,2,0,0,0,0,0,0,0,0,0,1,100,NoArch
32a5d268f54b781e7893ffe08a8767987e153e04,0,0,0,0,0,0,0,0,0,0,0,0,0,0,0,0,0,0,0,0,0,0,0,0,0,1,100,NoArch
271d1a79c0bf486d8a11c39e4569ec70cba25cd1,0,0,0,0,0,0,0,0,0,0,0,0,0,0,118,1,0,0,0,0,0,0,0,0,0,1,100,NoArch
3ef137d1565dd1aa21456d06c52b930337987c5b,1,5,1,4,0,0,0,2,2,188,1,1,0,270,0,0,26,26,0,1257,1244,13,13,13,0,1,100,NoArch
42c7129e25ef42a74dd32d17d2816946cd818ab9,0,0,0,0,0,0,0,0,0,0,0,0,0,0,64,0,0,0,0,0,0,0,0,0,0,1,100,NoArch
752f956f036e5aaf8dcc480ab0baf0c1e3d7cec9,0,0,0,0,0,0,0,0,0,0,0,0,0,0,83,0,0,0,0,0,0,0,0,0,0,1,100,NoArch
716e995a3869f1b84e4182957948c704aa2a162b,3,3,5,2,0,0,0,3,6,271,3,3,1.561278124,138,0,0,7,7,0,192,193,1,4,4,0,0,100,NoArch
47b764ec333d1fcaf13ec94d013424faf3b42584,26,130,130,0,0,0,0,6,39,332,6,19,2.518842968,13047,0,0,1118,1118,0,98003,98003,0,614,614,0,1,100,NoArch
af1128acf95ade0e52920638c2a7a0badaf53869,8,546,188,358,2,0,2,10,20,91,1,5,2.349042764,1746,216,5,268,230,38,13565,11494,2071,155,133,22,1,99.30530429,NoArch
676d5cefe0294f495db04ec6476afdc00cbf0dd2,4,13,28,15,0,0,0,25,61,69,2,4,1.698683915,2320,214,8,249,251,2,12184,12290,106,139,139,0,1,100,NoArch
c05ebf2417f4b170c396dfb60c738ca55bd52309,1,2,0,2,0,0,0,4,4,30,1,1,0,111,217,6,7,7,0,824,802,22,2,2,0,1,100,NoArch
eb219010d2491165dbdc00a6b9547a9072e012ac,1,8,3,5,0,0,0,8,12,21,1,1,0,644,215,9,85,85,0,4238,4243,5,25,25,0,1,100,NoArch
0caa55ecb42cdecbc027521535200540a2467832,0,0,0,0,0,0,0,0,0,0,0,0,0,0,30,0,0,0,0,0,0,0,0,0,0,1,100,NoArch
c20db99a7b79b9545e6fae0d762250ceb55a8b79,23,1700,14,1686,11,0,11,1,62,120,2,14,3.688452289,5505,2,0,584,480,104,40449,30458,9991,323,264,59,1,99.6962738,NoArch
10363c1412b8f9b5b16b3e2e075b895e0cc9a293,24,23,1702,1679,0,11,11,48,110,131,3,15,3.720607885,8141,218,7,599,701,102,36579,46524,9945,291,350,59,1,99.6962738,NoArch
18635b533ebbae9f89959f0a93f3ab5cc8461e9a,23,1700,14,1686,11,0,11,1,62,120,2,14,3.688452289,5505,3,1,584,480,104,40449,30458,9991,323,264,59,1,99.6962738,NoArch
f30b3aef3e5e12e9119d6b5294c94a0282719e00,5,26,12,14,0,0,0,2,47,349,1,3,1.806759867,1155,0,0,129,128,1,8827,8761,66,41,40,1,0,100,NoArch
a6bc9e8e818be42f26995f927c406ab1c3ddb7d6,0,0,0,0,0,0,0,0,0,0,0,0,0,0,3,0,0,0,0,0,0,0,0,0,0,1,100,NoArch
cf837b49008fd351a3f89beb5e4e5c17c30b9a3c,4,26,25,1,0,0,0,5,120,184,2,3,0.514274832,3216,65,1,432,432,0,14209,14209,0,391,391,0,1,99.97042295,NoArch
4e42ed5eae36f706ec35e5d09d8dc206b7fea130,1,31,17,14,0,0,0,8,13,5,1,1,0,649,216,10,88,85,3,4309,4238,71,26,25,1,1,100,NoArch
98c5c6c6543177ff4320b73b13bc153938300fe4,3,112,8,104,1,0,1,2,7,459,1,2,1.206908425,222,10,0,27,19,8,1896,1273,623,20,13,7,1,99.93344672,NoArch
31e13db1f0e12e107cc02c60dec3e52a8914a5b2,1,0,2,2,0,0,0,48,111,5,1,1,0,957,66,2,119,119,0,6111,6121,10,27,27,0,1,100,NoArch
8d2f00904882b9946331bfb325c0033f72aa29fe,3,39,8,31,0,0,0,8,16,244,2,2,0.925255801,1033,0,0,109,104,5,5186,4830,356,81,79,2,1,100,NoArch
85962ee55d098d457a598bc19d5597ff1b361ed5,0,0,0,0,0,0,0,0,0,0,0,0,0,0,24,1,0,0,0,0,0,0,0,0,0,1,100,NoArch
57dbe57bed963f529b2921b6bb6253a90a1a45af,0,0,0,0,0,0,0,0,0,0,0,0,0,0,1,0,0,0,0,0,0,0,0,0,0,1,100,NoArch
1767ff5e7c7d7a06d0267380eb3b830392a3bf28,0,0,0,0,0,0,0,0,0,0,0,0,0,0,61,0,0,0,0,0,0,0,0,0,0,1,100,NoArch
554caa34218e477bbd5eb9b724836f2c365c896d,0,0,0,0,0,0,0,0,0,0,0,0,0,0,11,1,0,0,0,0,0,0,0,0,0,0,100,NoArch
93fe5a497e8f2f97d90f3dd66d966f9f4cc24bc9,2,20,23,3,0,0,0,2,5,44,1,2,0.693127415,1076,8,0,123,123,0,5683,5661,22,62,62,0,1,100,NoArch
58014c147af677a426e0dd22fb59b8d92d0dd18a,2,25,10,15,0,0,0,1,4,206,1,2,0.970950594,471,60,1,23,22,1,2767,2675,92,13,13,0,1,100,NoArch
8fa8f2603199638e2467fba0db8948a84455213e,0,0,0,0,0,0,0,0,0,0,0,0,0,0,32,0,0,0,0,0,0,0,0,0,0,0,100,NoArch
48062a570817ba776f23ff95963d540fddbe1eac,0,0,0,0,0,0,0,0,0,0,0,0,0,0,1,1,0,0,0,0,0,0,0,0,0,1,100,NoArch
62d792368bd1ebf2dead648b436e623e9a1a003e,2,4,1,3,0,0,0,10,14,648,1,2,0.721928095,154,0,0,8,8,0,642,625,17,6,6,0,1,100,NoArch
0a72458291ace85faec5155a2d7865b95f420b9b,1,1,1,0,0,0,0,10,11,0,1,1,0,57,119,2,1,1,0,290,290,0,1,1,0,1,100,NoArch
7e86884604057c0a7a373d4e84d8f3e112170ca7,2,10,20,10,0,0,0,8,9,239,1,1,0.987137774,236,3,0,19,19,0,1134,1144,10,9,9,0,1,100,NoArch
329da34ee0f8d935fa7ec1853104addfb5b45400,1,1,1,0,0,0,0,11,27,17,1,1,0,1707,217,11,205,205,0,9555,9555,0,91,91,0,1,100,NoArch
918c4f4e0ba5dd30fc733cc3e208650e2154dd5c,0,0,0,0,0,0,0,0,0,0,0,0,0,0,4,2,0,0,0,0,0,0,0,0,0,1,100,NoArch
795a99ba73183b5f7697bb3964843a43a64e74e9,4,22,4,18,0,0,0,11,112,118,1,2,1.802045624,2543,0,0,302,299,3,16704,16541,163,88,87,1,1,100,NoArch
0d069b5e57e96984d508434a9b76c48a282bd45b,4,32,2,30,0,0,0,4,12,37,1,3,1.851226816,1634,218,7,95,93,2,8108,7908,200,53,52,1,1,100,NoArch
dfcd6d9a8605e93fcb21b8cc27ac474d4ffa2a76,1,29,0,29,1,0,1,1,1,0,1,1,0,0,67,3,1,0,1,59,0,59,1,0,1,1,99.9852224,NoArch
7276d0eaa662298b64a6aca7e7180556f03603b1,3,11,5,6,0,0,0,7,8,1116,1,1,1.561278124,257,0,0,13,13,0,1202,1150,52,4,4,0,1,100,NoArch
7f8630cc57fbb9d29e8dc7ca87b582264da073fd,16,59,67,8,0,0,0,17,121,219,4,16,3.385141805,10704,219,6,1218,1221,3,66670,66850,180,752,754,2,1,100,NoArch
51602a34f7b2c296b1f1438e85ef2f12c4dff741,1,1,1,0,0,0,0,8,8,21,1,1,0,86,3,0,6,6,0,415,415,0,5,5,0,1,100,NoArch
91a5f3db1dd69813e343ff9df0a2c1b26caea8ca,319,2857,8026,5169,8,42,50,0,114,93,12,161,6.938236036,90702,118,0,8199,8631,432,537643,567707,30064,4335,4583,248,1,93.82528919,Arch
c9889799b4974e7ad27ccf48cd18bf619ccc1a89,0,0,0,0,0,0,0,0,0,0,0,0,0,0,0,0,0,0,0,0,0,0,0,0,0,1,100,NoArch
ec12b82e58970cfbd7e75bf39e8ace9dc37cd4dc,1,5,0,5,0,0,0,2,2,221,1,1,0,327,0,0,46,46,0,2101,2052,49,14,14,0,1,100,NoArch
1f173127e4980eff0b6ad99ce9db1bda8dae0d32,0,0,0,0,0,0,0,0,0,0,0,0,0,0,206,0,0,0,0,0,0,0,0,0,0,1,100,NoArch
16dfd461af011f3a64c84e980fb823fc93c054cc,0,0,0,0,0,0,0,0,0,0,0,0,0,0,2,0,0,0,0,0,0,0,0,0,0,0,100,NoArch
d754b8c1fc692a172a9317c4f2c89a6fa61a4a10,8,119,7,112,0,0,0,1,10,190,2,6,2.484226874,3689,205,0,219,211,8,23398,22546,852,135,132,3,1,100,NoArch
77e277ab9cf4c61fc04bd317f066e565c1322076,1,3,1,2,0,0,0,18,26,327,1,1,0,297,0,0,44,44,0,2074,2060,14,12,12,0,1,100,NoArch
c5089da8528701272957c6fd01a13b9fe6befa16,1,1,1,0,0,0,0,2,5,0,1,1,0,786,0,0,16,16,0,3757,3757,0,9,9,0,1,100,NoArch
0acac9328163b37b0412548b2958cfdb9de866ae,6,16,16,0,0,0,0,3,115,314,3,3,2.077819531,5029,0,0,509,509,0,21839,21839,0,462,462,0,1,100,NoArch
ea822a37800e4900505d25aebc6e06a75f2da10b,3,28,1,27,0,0,0,2,7,144,1,3,1.372553188,1723,21,0,77,77,0,9958,9770,188,42,42,0,0,99.97396511,NoArch
25c7182ace657744fcac15d2b6f4fa9cc292d718,1,3,9,6,0,0,0,3,4,198,1,1,0,189,1,0,14,15,1,941,968,27,7,7,0,1,100,NoArch
aebc521960126cf5ed22663f8805b7f59759a668,1,1,0,1,0,0,0,29,47,182,1,1,0,556,81,0,75,75,0,3836,3827,9,29,29,0,0,100,NoArch
f790e9d3d068ad1ba0db346d52f084ca02103abc,1,2,0,2,0,0,0,39,116,0,1,1,0,2589,0,0,381,381,0,11209,11196,13,350,350,0,1,100,NoArch
a7e2669ac31f3759efaaaf14c523473cb6cffa16,3,79,2,77,1,0,1,1,3,135,1,3,0.996940588,527,0,0,66,63,3,3162,2854,308,26,24,2,1,99.98264491,NoArch
2b51e0623b3b884a8cff734eae37e823889db124,0,0,0,0,0,0,0,0,0,0,0,0,0,0,119,1,0,0,0,0,0,0,0,0,0,0,100,NoArch
b8b77957e21bdf4d3979174a63ad11cf2d167d50,0,0,0,0,0,0,0,0,0,0,0,0,0,0,62,0,0,0,0,0,0,0,0,0,0,0,100,NoArch
97d71d85d013ae6b2d6aa3c23c144571252ea46b,0,0,0,0,0,0,0,0,0,0,0,0,0,0,120,2,0,0,0,0,0,0,0,0,0,1,100,NoArch
3e9db9557ca38054654797f850ec4461acac2198,1,4,4,0,0,0,0,17,28,233,1,1,0,414,63,1,51,50,1,3300,3284,16,24,24,0,1,100,NoArch
98c2931d548605c64db4acd6744e8b4552727d51,8,79,43,36,0,0,0,4,16,927,1,8,2.560665835,1684,82,1,180,178,2,11279,11100,179,133,133,0,1,100,NoArch
00e2e0adc84b4bdbde0baf3fad8f06cefee1e8f6,1,2,2,0,0,0,0,36,70,178,1,1,0,831,2,0,113,113,0,5015,5029,14,29,29,0,0,100,NoArch
cde187f55ed8245fab31ab34e53bafb5cb4bcada,17,121,12,109,0,0,0,19,37,344,2,12,3.213408017,3202,1,0,322,315,7,20481,19992,489,161,157,4,1,100,NoArch
497020293e7e9b9dfaa3130877ae6017b720db65,0,0,0,0,0,0,0,0,0,0,0,0,0,0,0,0,0,0,0,0,0,0,0,0,0,1,100,NoArch
7c0e443c11646633a6b38fece33e70f7e6facf9a,0,0,0,0,0,0,0,0,0,0,0,0,0,0,121,3,0,0,0,0,0,0,0,0,0,1,100,NoArch
56e2cc4f20cff330bfe39dd94ecbea4017645fd3,0,0,0,0,0,0,0,0,0,0,0,0,0,0,3,0,0,0,0,0,0,0,0,0,0,1,100,NoArch
efe6cb650cb0b8994060c8d31e7e7c1fe41ed10f,0,0,0,0,0,0,0,0,0,0,0,0,0,0,1,0,0,0,0,0,0,0,0,0,0,0,100,NoArch
891c4151943c07c4837b760f819947b088a7c112,1,2,0,2,0,0,0,6,10,190,1,1,0,318,207,1,24,24,0,2389,2370,19,21,21,0,0,92.49817917,Arch
7af52f1b8a4d25ed1200fa25758ee411019663ae,1,10,7,3,0,0,0,2,2,1732,1,1,0,91,2,1,10,9,1,402,396,6,6,6,0,1,100,NoArch
2f0f3b535b75e4913620b5c331d4a9323dcadb04,1,8,0,8,0,0,0,2,2,222,1,1,0,264,30,0,11,9,2,1805,1772,33,10,9,1,0,100,NoArch
38c139060f9df1ef78eec660c8adc04481a7174e,2,21,1,20,0,0,0,3,6,74,1,2,0.994030211,2105,1,1,103,102,1,13822,13647,175,72,72,0,1,100,NoArch
78ec3a8c52e971380be28927aac0d39ca58eeb12,18,204,173,31,0,0,0,2,65,373,3,9,3.177977283,4629,208,2,625,615,10,27466,27008,458,290,288,2,1,95.26382901,Arch
23399624e8777f4113091ff1b7c785cb89e29fc7,3,15,3,12,0,0,0,2,2,222,1,3,1.122113677,1024,0,0,111,109,2,6168,6107,61,66,64,2,1,100,NoArch
542efdd9e7b8d51f9e71ea75d2a571a1c842bc92,1,19,9,10,0,0,0,15,27,130,1,1,0,619,0,0,84,81,3,3127,3077,50,29,28,1,1,100,NoArch
e4d44b99ad9d3316aabc64560eb92454d1d2e3e4,12,194,166,28,2,1,3,9,13,204,1,6,2.425487044,2098,60,0,134,138,4,15637,16348,711,69,73,4,1,99.90882312,NoArch
16037bbff5fe88ddef084dee1922304d52410081,0,0,0,0,0,0,0,0,0,0,0,0,0,0,1,1,0,0,0,0,0,0,0,0,0,1,100,NoArch
3ceb7b1df7970f203deeaf320c0af551122b1479,3,31,9,22,0,0,0,1,68,128,1,2,1.336666482,2576,209,3,228,224,4,19876,19639,237,151,149,2,1,100,NoArch
96035e4a90d32cd67bee0c810093f61d475b6843,5,30,4,26,0,0,0,7,16,357,1,4,1.999919261,1643,210,4,243,238,5,9800,9619,181,116,114,2,2,100,NoArch
8cb8e04bee544b9fb2360a32979e4d739038d61f,26,126,87,39,1,0,1,2,8,163,1,20,4.036274178,7511,5,0,630,632,2,42970,42574,396,361,363,2,1,94.61493436,Arch
9118c7c8395b15ca042c3fd6a78091938da4ac10,1,1,1,0,0,0,0,4,4,149,1,1,0,485,0,0,58,58,0,3421,3423,2,24,24,0,0,100,NoArch
61763a8904102409cca79ab2dc98bfd17d3920ec,6,40,11,29,0,0,0,4,5,376,2,5,2.127896304,1761,6,1,99,97,2,10412,10247,165,66,64,2,1,100,NoArch
a170a182fa96059c09c8de75072a3f1f9c490bc5,1,1,1,0,0,0,0,2,3,0,1,1,0,255,7,2,25,25,0,1137,1137,0,9,9,0,1,100,NoArch
f906476aa4c10c666ab61d039d69621d1d431bcc,3,52,13,39,0,0,0,22,108,236,1,3,1.177329366,3223,211,5,330,323,7,23679,23326,353,163,162,1,1,100,NoArch
87b4263ef9fda5e7452e1f495fd9db51bcc6d062,26,40,40,0,0,0,0,12,61,214,2,18,4.53418372,10570,0,0,1108,1108,0,68589,68347,242,454,454,0,1,100,NoArch
bf4f9732b1fc960faa7da6850644e40742a0d71f,0,0,0,0,0,0,0,0,0,0,0,0,0,0,40,0,0,0,0,0,0,0,0,0,0,1,100,NoArch
dea1836b7100f0dcfef25bf7671f056d414ac7f1,1,3,1,2,0,0,0,7,9,238,1,1,0,114,0,0,28,28,0,606,580,26,15,15,0,0,100,NoArch
3b27ba4a396b299beeb2dc807774e863261282e5,2,50,0,50,0,0,0,2,21,94,2,2,0.468995594,476,206,1,33,32,1,3463,3091,372,22,21,1,1,100,NoArch
c4bc06cc9896a314fbb5a5c3ab7431a023bb8a3e,0,0,0,0,0,0,0,0,0,0,0,0,0,0,41,1,0,0,0,0,0,0,0,0,0,2,100,NoArch
1ee673b2719861fb111d221bf4a1c4d345228580,1,1,1,0,0,0,0,1,2,222,1,1,0,119,207,2,12,12,0,670,672,2,6,6,0,1,100,NoArch
70b2e8dd3c06ab789d6fe5f138205a03c6c584e0,4,47,24,23,0,0,0,1,7,196,2,4,1.371440812,795,208,3,83,76,7,4542,4300,242,40,34,6,1,100,NoArch
0a41dca5bc6d99fa5813a0694ca3c49c1e1e3f7b,0,0,0,0,0,0,0,0,0,0,0,0,0,0,2,2,0,0,0,0,0,0,0,0,0,1,100,NoArch
6f784a8c9f06f6122aca45c468c42cd2339c991d,1,3,0,3,0,0,0,19,58,0,1,1,0,528,2,1,81,81,0,3744,3718,26,35,35,0,1,100,NoArch
7ad732e637932e2c4afd5db017e90b06b255f41f,0,0,0,0,0,0,0,0,0,0,0,0,0,0,212,6,0,0,0,0,0,0,0,0,0,0,100,NoArch
1d7f9e44a669fd0612806242b343e07574faca7d,5,18,10,8,0,0,0,2,59,206,3,5,2.123946782,1375,209,4,178,178,0,9720,9765,45,99,99,0,0,99.97928749,NoArch
0676d5be60b224a700ff1efbad1df9cda10ec2f3,1,3,0,3,0,0,0,20,38,0,1,1,0,464,210,5,57,57,0,2771,2765,6,24,24,0,1,100,NoArch
eaf183f9d015f240fedc3f65ea145f5d93ab77ca,1,4,0,4,0,0,0,2,3,149,1,1,0,147,3,0,13,13,0,771,720,51,6,6,0,0,100,NoArch
679e7e8cd4d74c167460aa05ddba04995b75a4ab,0,0,0,0,0,0,0,0,0,0,0,0,0,0,4,1,0,0,0,0,0,0,0,0,0,1,100,NoArch
631ae88338b8ee2ed21e5be199f940d3c5d7ac33,1,3,10,7,0,0,0,2,4,0,1,1,0,151,211,6,12,13,1,705,771,66,6,6,0,1,100,NoArch
e4079da780df6a7b85bd96bcc459f12687bb1159,0,0,0,0,0,0,0,0,0,0,0,0,0,0,2,0,0,0,0,0,0,0,0,0,0,1,100,NoArch
3d56c519db4537e78ed040b83aecdc35c0cab53b,1,0,2,2,0,0,0,10,24,0,1,1,0,1709,212,7,205,205,0,9555,9565,10,91,91,0,1,100,NoArch
59abb095ac093eb88c3c8879079d8926d52afba6,1,15,2,13,0,0,0,3,4,0,1,1,0,507,1,1,57,55,2,3669,3564,105,32,31,1,1,100,NoArch
b0633f535c0e86a642743ca42544a932fee97e11,3,10,4,6,0,0,0,1,60,43,2,3,1.148834854,2858,213,8,357,356,1,16122,16106,16,165,164,1,1,100,NoArch
702608da7c2e5bd434b91cb7d521d3ea9ea5f67e,2,1,4,3,0,0,0,48,109,626,2,2,0.970950594,1099,213,7,132,132,0,6875,6879,4,31,31,0,0,100,NoArch
1f31aa4f59b2c482e4d8f9993eb6bbf7e23d8da7,1,39,8,31,0,0,0,18,35,265,1,1,0,434,59,0,56,51,5,2958,2783,175,18,17,1,1,100,NoArch
76c2931275de5fb104a535742db6c60a5d7d0a4c,0,0,0,0,0,0,0,0,0,0,0,0,0,0,122,4,0,0,0,0,0,0,0,0,0,0,100,NoArch
66b43d333250f211ce3d33b279b360289cdc9c41,0,0,0,0,0,0,0,0,0,0,0,0,0,0,22,0,0,0,0,0,0,0,0,0,0,1,100,NoArch
ac27d9e79e7c00f7b6c94ad53e211d3d64138a1c,0,0,0,0,0,0,0,0,0,0,0,0,0,0,3,3,0,0,0,0,0,0,0,0,0,1,100,NoArch
a5257d1606df5dcc2b53663c2fe5c722ade12407,0,0,0,0,0,0,0,0,0,0,0,0,0,0,0,0,0,0,0,0,0,0,0,0,0,1,100,NoArch
9052f7b0bba18220781227e660674579bb272444,1,5,1,4,0,0,0,2,2,222,1,1,0,270,0,0,26,26,0,1257,1244,13,13,13,0,1,100,NoArch
4b7d150c91eaee226ee55ed5930668ec3c325006,0,0,0,0,0,0,0,0,0,0,0,0,0,0,83,2,0,0,0,0,0,0,0,0,0,1,100,NoArch
f9bc63097a586f71602a560dbe2d39150422271c,3,3,5,2,0,0,0,3,6,302,3,3,1.561278124,138,0,0,7,7,0,192,193,1,4,4,0,0,100,NoArch
eca1091f4bebc20b33491d775eefc7e7f6296c3b,26,130,130,0,0,0,0,6,39,355,6,19,2.518842968,13052,0,0,1118,1118,0,98071,98071,0,613,613,0,1,100,NoArch
65df5cc2624b5d56e6a97e733c56c84d5be2751c,8,546,188,358,2,0,2,10,20,88,1,5,2.349042764,1746,214,8,268,230,38,13565,11494,2071,155,133,22,1,99.0060917,NoArch
a55d2f01185d9cff414a8c8e01aa2de8cd4c6a94,4,13,28,15,0,0,0,25,61,75,2,4,1.698683915,2320,214,9,249,251,2,12184,12290,106,139,139,0,1,100,NoArch
efb97a2eb0c1ba82a1f6b2cfd1fc935f4ec056cb,1,2,0,2,0,0,0,4,4,0,1,1,0,111,215,9,7,7,0,824,802,22,2,2,0,1,100,NoArch
6219f6cd13976c4085d229cab4f0c164514accb2,1,8,3,5,0,0,0,7,11,0,1,1,0,641,215,10,84,84,0,4221,4226,5,25,25,0,1,100,NoArch
e85b131f035b0c49bb893c8d4be8f551fd95bfaf,0,0,0,0,0,0,0,0,0,0,0,0,0,0,30,0,0,0,0,0,0,0,0,0,0,1,100,NoArch
723e54a0de1312b6c0c5dc270d9ad85253a33f71,1,9,2,7,0,0,0,48,110,0,1,1,0,950,216,10,119,117,2,6121,6075,46,27,27,0,1,100,NoArch
d2364befa81e005c013f6e52b6052849ddf89e82,5,26,12,14,0,0,0,2,47,377,1,3,1.806759867,1155,0,0,129,128,1,8827,8761,66,41,40,1,0,100,NoArch
db019262b650c6c30e2f87d08c9c174edec5b712,1,31,17,14,0,0,0,7,12,0,1,1,0,646,216,11,87,84,3,4292,4221,71,26,25,1,1,100,NoArch
209ce34dba75068bcf6401d5cb1ce4380d9924cb,3,39,8,31,0,0,0,8,15,293,2,2,0.925255801,1007,0,0,108,103,5,5122,4766,356,80,78,2,1,100,NoArch
9c746b87011b7d96f7f277095b63fa7037bbaa44,0,0,0,0,0,0,0,0,0,0,0,0,0,0,1,1,0,0,0,0,0,0,0,0,0,1,100,NoArch
f16a9939b71479e7b7fc8d5066739aa75aa1c1a8,0,0,0,0,0,0,0,0,0,0,0,0,0,0,61,1,0,0,0,0,0,0,0,0,0,1,100,NoArch
0ebf8419d716482ba12e0453d3460edaafc09e56,0,0,0,0,0,0,0,0,0,0,0,0,0,0,10,0,0,0,0,0,0,0,0,0,0,0,100,NoArch
a9f575797c95dc0628666b75ce5218931b6a0091,2,25,10,15,0,0,0,1,4,223,1,2,0.970950594,471,60,1,23,22,1,2767,2675,92,13,13,0,1,100,NoArch
27fd101149bc61ad4216fd5355520e118cea015f,0,0,0,0,0,0,0,0,0,0,0,0,0,0,31,1,0,0,0,0,0,0,0,0,0,0,100,NoArch
06327281b51de68e1e33c7e927c1953ec4f69aa4,0,0,0,0,0,0,0,0,0,0,0,0,0,0,1,1,0,0,0,0,0,0,0,0,0,1,100,NoArch
ba70ceda35c095f82bb16b3b7aa048eea0608d63,2,10,20,10,0,0,0,8,9,254,1,1,0.987137774,236,3,0,19,19,0,1134,1144,10,9,9,0,1,100,NoArch
2cac57632eebeda766789ecf4c4119489ddcf04b,1,1,1,0,0,0,0,10,26,0,1,1,0,1707,217,12,205,205,0,9555,9555,0,91,91,0,1,100,NoArch
7194d2e17544cd3aa3163eb1a06c9f95cd8abd49,0,0,0,0,0,0,0,0,0,0,0,0,0,0,4,4,0,0,0,0,0,0,0,0,0,1,100,NoArch
27c745cf0d1481b82f7fd5cce6268f63d773b6bd,4,22,4,18,0,0,0,11,111,100,1,2,1.802045624,2529,0,0,298,295,3,16581,16418,163,88,87,1,1,100,NoArch
1e737c3bcc831e12810a446d4b282821071c1b68,4,32,2,30,0,0,0,4,9,0,1,3,1.851226816,1567,218,13,95,93,2,7772,7572,200,53,52,1,1,100,NoArch
55be49d4393aa1fd6394b7c658b2a884f2aec5fe,3,11,5,6,0,0,0,7,8,1120,1,1,1.561278124,257,0,0,13,13,0,1202,1150,52,4,4,0,1,100,NoArch
6c4200f64d0d191f34344a7584a400f62e2d0c53,16,59,67,8,0,0,0,17,117,220,4,16,3.385141805,10600,219,14,1203,1206,3,65926,66106,180,743,745,2,1,99.96692393,NoArch
ae656c5d40db34bcc2cc20eab8569437b0a284e1,1,1,1,0,0,0,0,7,7,436,1,1,0,83,3,1,6,6,0,387,387,0,5,5,0,1,100,NoArch
4e053c0d3a08a8f1e7e3c9215721740081b9d2a4,1,0,2,2,0,0,0,6,12,0,1,1,0,320,84,3,24,24,0,2370,2389,19,21,21,0,0,100,NoArch
3759a38b99cf9bb7540cd1881879cc0547a25e70,124,5633,1696,3937,36,7,43,1,121,181,8,71,5.877498245,30947,46,0,3441,3132,309,206925,184907,22018,1925,1734,191,1,92.45933522,Arch
80783c27f5211ae5cd01d692223a106df5dff4a2,1,7,4,3,0,0,0,5,5,66,1,1,0,485,3,0,58,58,0,3465,3421,44,24,24,0,1,100,NoArch
bd26d633d71b7783000b3334573d791ac9108bcd,0,0,0,0,0,0,0,0,0,0,0,0,0,0,0,0,0,0,0,0,0,0,0,0,0,1,100,NoArch
5d18b80343bdb43c69d979da013752a5f8f11c07,0,0,0,0,0,0,0,0,0,0,0,0,0,0,84,1,0,0,0,0,0,0,0,0,0,1,100,NoArch
73b0be3c962112efe541ae04fe0ea6f298558f17,2,38,0,38,0,0,0,7,12,167,2,2,0.629249224,974,0,0,103,98,5,6474,6074,400,61,61,0,1,100,NoArch
22c45a7704cf4d5ec6fb56ee7cc1bf17d826315d,1,1,1,0,0,0,0,2,3,230,1,1,0,255,220,6,15,15,0,1814,1814,0,7,7,0,1,100,NoArch
21ab0ff8be73082b46fe83ab6a3546648b4d4eaa,1,2,2,0,0,0,0,3,3,83,1,1,0,189,68,3,13,13,0,1446,1446,0,2,2,0,1,99.97785161,NoArch
132c0aa8c7cc34f462f5ab44e8db8b75c2ffba38,1,6,19,13,0,0,0,4,5,114,1,1,0,183,0,0,12,14,2,887,941,54,7,7,0,1,100,NoArch
4f7ea8c79a9d13accf72d094296993c588d87beb,9,295,303,8,0,0,0,2,53,103,2,8,1.12672725,6145,62,1,730,732,2,40985,40996,11,319,315,4,1,99.96306965,NoArch
4f6fc726d0d3d2dd427210228bbb36cf18893a92,4,63,1,62,0,0,0,2,122,400,2,4,1.197823047,3164,219,3,454,446,8,15485,14972,513,380,377,3,1,99.96300681,NoArch
21b903fddbc0522909ab924e0d774b75902826f6,4,141,46,95,0,0,0,2,4,155,2,3,1.39606936,1218,220,4,114,102,12,9807,9149,658,50,45,5,1,100,NoArch
7da97c8096ad4eabb49b42c86013679ed5009451,7,87,22,65,0,0,0,16,26,325,2,6,2.606352415,1992,221,5,175,159,16,14135,13436,699,102,99,3,1,100,NoArch
e5710a8e7c588c2a08cd57944be5cfcbc37402a5,1,2,0,2,0,0,0,5,6,7,1,1,0,488,120,1,58,58,0,3465,3465,0,24,24,0,0,100,NoArch
4f5cad80293c9ac6232593f3c968c1369bb02c4c,0,0,0,0,0,0,0,0,0,0,0,0,0,0,25,1,0,0,0,0,0,0,0,0,0,0,100,NoArch
6db0720f61e31097a0b07635c4ce9acce581df1d,151,2095,6276,4181,7,36,43,0,117,73,9,93,6.076502119,45869,46,0,4167,4513,346,258605,282872,24267,2207,2413,206,1,92.44464128,Arch
7607b67883b387b2ecf6140ddbbdafcfd2813c92,1,7,4,3,0,0,0,5,5,12,1,1,0,485,3,0,58,58,0,3465,3421,44,24,24,0,1,100,NoArch
8d01b07b93565ee5f753df8cecba5f4c18f9f0e8,0,0,0,0,0,0,0,0,0,0,0,0,0,0,85,4,0,0,0,0,0,0,0,0,0,1,100,NoArch
3a8fb97b0eddaa7c9257505b22899c85adafc6e5,2,38,0,38,0,0,0,7,12,160,2,2,0.629249224,974,0,0,103,98,5,6474,6074,400,61,61,0,1,100,NoArch
834b13a1c0edb60b73e837a1a548030d9953db9b,1,1,1,0,0,0,0,2,3,233,1,1,0,255,220,15,15,15,0,1814,1814,0,7,7,0,1,100,NoArch
c86ed44ce53e3aa444559f9482a01cd029075544,1,2,2,0,0,0,0,3,3,12,1,1,0,189,64,2,13,13,0,1446,1446,0,2,2,0,1,99.96694943,NoArch
048ab3dc62676dfcb300bf8f516e0fcf9e195b20,1,6,19,13,0,0,0,4,5,12,1,1,0,183,0,0,12,14,2,887,941,54,7,7,0,1,100,NoArch
d3f9e77bc58c2884f2c81a04d9c2443f0d3d63d0,9,295,303,8,0,0,0,2,52,106,2,8,1.12672725,6141,62,2,727,729,2,40946,40957,11,319,315,4,1,99.93382596,NoArch
8ad2aa390172ad9616ae713a9ecd1a6169de7a42,4,63,1,62,0,0,0,2,118,384,2,4,1.197823047,3129,217,11,447,439,8,15323,14810,513,373,370,3,1,99.95587911,NoArch
9f646d4b4fa571ad4602f807542c9a5b5a2223fb,4,141,46,95,0,0,0,2,4,152,2,3,1.39606936,1218,218,12,114,102,12,9807,9149,658,50,45,5,1,100,NoArch
e3ce7a186751e27558fab32d5f9d96e961cd4f8c,7,87,22,65,0,0,0,16,26,319,2,6,2.606352415,1992,219,13,175,159,16,14135,13436,699,102,99,3,1,100,NoArch
2b689c22dc8bb17fee6ada8bbdbadc32649d3baa,1,2,0,2,0,0,0,5,6,0,1,1,0,488,123,5,58,58,0,3465,3465,0,24,24,0,0,100,NoArch
f85cd9b16d2bd0c49fb6a05a4be627dffb4c2065,127,5659,1711,3948,36,7,43,1,122,175,8,74,5.902836108,32606,222,3,3616,3308,308,217624,195536,22088,2018,1827,191,2,92.46987952,Arch
1349b596a1c18c6be75039c1c4644ecdf78411ff,2,3,2,1,0,0,0,21,30,54,1,2,0.970950594,1506,121,2,119,119,0,10244,10235,9,47,47,0,1,100,NoArch
35afdb4316d496bbb37ebb9e1598d84bd8a4000d,3,37,13,24,0,0,0,2,123,286,2,3,1.191113692,3452,63,2,482,480,2,16443,16318,125,412,411,1,1,100,NoArch
ad27bc352c507fc906495152ccf9d2e6789a9b71,126,1712,5674,3962,7,36,43,0,118,88,8,73,5.901635031,35732,220,14,3219,3530,311,189732,211884,22152,1788,1980,192,2,92.46987952,Arch
06ddb7296c14c5a39c706da604e4d766c24ff6d7,2,3,2,1,0,0,0,20,29,201,1,2,0.970950594,1582,124,6,129,129,0,10811,10802,9,49,49,0,1,100,NoArch
98ae2cb5104f34a6914f777601338e58f8d89191,3,37,13,24,0,0,0,2,119,284,2,3,1.191113692,3417,63,3,475,473,2,16281,16156,125,405,404,1,1,100,NoArch
39ebc28b6f24b4ae62cb71569c71f55c735d0a43,0,0,0,0,0,0,0,0,0,0,0,0,0,0,86,5,0,0,0,0,0,0,0,0,0,0,100,NoArch
f5ab921300654e61a448ac447eb4532a60e49b9c,124,5633,1696,3937,36,7,43,1,123,177,8,71,5.877498245,30949,0,0,3438,3129,309,206833,184815,22018,1927,1736,191,0,92.46987952,Arch
8ff17b047091b4b90e6e972d8b43d416714a0613,1,1,1,0,0,0,0,2,3,228,1,1,0,42,0,0,3,3,0,144,144,0,1,1,0,0,100,NoArch
c608dbd6c2d00f29f350ad1ed0fd04f7eb3c1b6b,0,0,0,0,0,0,0,0,0,0,0,0,0,0,221,4,0,0,0,0,0,0,0,0,0,1,100,NoArch
ba47904fa2a5e089b245884107f86e4fff918e04,1,9,5,4,0,0,0,2,8,71,1,1,0,395,1,0,25,24,1,2152,2100,52,11,10,1,1,100,NoArch
2b3a85528a32405bad8aee16f19a849322b517b5,0,0,0,0,0,0,0,0,0,0,0,0,0,0,1,0,0,0,0,0,0,0,0,0,0,1,100,NoArch
08fe281091bf08af743b83a0786216cc2aadfa62,1,22,17,5,0,0,0,9,13,198,1,1,0,169,223,4,18,20,2,1054,1039,15,12,12,0,1,100,NoArch
97ccf5dd184d1ff3578bdf8a1944cc15f8a5da97,0,0,0,0,0,0,0,0,0,0,0,0,0,0,85,1,0,0,0,0,0,0,0,0,0,1,100,NoArch
7b98ecfc2a92daf5b04f3823f71fab0ab96e3fac,127,1720,5666,3946,7,36,43,0,119,87,8,74,5.904752065,35501,0,0,3176,3484,308,188098,210183,22085,1759,1951,192,0,92.46987952,Arch
c68f22aeb818da44c93d0d899873a03b97ffc31b,1,1,1,0,0,0,0,2,3,236,1,1,0,42,0,0,3,3,0,144,144,0,1,1,0,0,100,NoArch
e68e0ca374a0626502a5e36389921fe3605cf97b,0,0,0,0,0,0,0,0,0,0,0,0,0,0,221,16,0,0,0,0,0,0,0,0,0,1,100,NoArch
0be352e0ec40abe5cc6cddadeff9a12872e86ed2,1,9,5,4,0,0,0,2,8,25,1,1,0,395,1,0,25,24,1,2152,2100,52,11,10,1,1,100,NoArch
807bc71dde6c0a2bb8fa429fe754ed35d7fc6302,0,0,0,0,0,0,0,0,0,0,0,0,0,0,0,0,0,0,0,0,0,0,0,0,0,1,100,NoArch
58e25ba8563bb45b629fd534eb12423aeb948e6e,1,22,17,5,0,0,0,9,13,175,1,1,0,169,221,15,18,20,2,1054,1039,15,12,12,0,1,100,NoArch
cd1514484fff1ae6e66b4e56ae11013bdf4ac6e9,0,0,0,0,0,0,0,0,0,0,0,0,0,0,87,6,0,0,0,0,0,0,0,0,0,1,100,NoArch
fd8f7c5f6c0bbfbed829f5d1a1d250ca4752d503,124,5633,1696,3937,36,7,43,1,123,177,8,71,5.877498245,30949,86,2,3438,3129,309,206833,184815,22018,1927,1736,191,1,92.46987952,Arch
b3c77338bfe932061ddc1858e19a3ba8651d0d0d,124,1697,5634,3937,7,36,43,0,119,90,8,72,5.877519927,34886,88,7,3129,3438,309,184815,206833,22018,1736,1927,191,1,92.46987952,Arch
ba9cb9569027b8e6b740f0358a18cff016c189b9,0,0,0,0,0,0,0,0,0,0,0,0,0,0,89,8,0,0,0,0,0,0,0,0,0,0,100,NoArch
5aaac21d1dad8d462f96d47bca7d55494a8a8ae1,152,5730,1790,3940,36,7,43,1,123,222,10,85,6.000027309,36326,0,0,3794,3483,311,242535,220394,22141,2150,1959,191,1,92.36357193,Arch
c82e3462e3d56b1f6c92d80720a9503da8e57765,1,2,3,1,0,0,0,3,3,200,1,1,0,339,1,1,80,80,0,2100,2111,11,6,6,0,0,100,NoArch
14d8735a1c1bd093624a0ef51a256733099d8516,1,3,1,2,0,0,0,9,13,36,1,1,0,865,0,0,16,15,1,4210,4178,32,8,8,0,0,100,NoArch
e89f5627e4f1824c36e2e60cfaee3e9f3e977e87,2,22,6,16,0,0,0,3,5,221,1,1,0.940285959,351,2,1,37,36,1,2715,2500,215,18,18,0,1,99.97777942,NoArch
0d859fe58be8aded257593d9c6e407ce2be71be0,1,22,0,22,0,0,0,23,71,93,1,1,0,2279,1,0,215,214,1,17726,17548,178,132,131,1,1,100,NoArch
4774c4248f3ea2ce863c6f76679639ae1cdddf9c,2,56,2,54,0,0,0,5,36,183,1,2,0.91244118,835,1,1,71,68,3,6358,5965,393,30,29,1,1,100,NoArch
264b15df87aa01fe06191f1499b422bcefaba4f7,1,20,6,14,0,0,0,22,40,62,1,1,0,467,1,1,61,57,4,2884,2771,113,26,24,2,1,100,NoArch
f16b1e898216fd722fb12faf2861eb213171c1c5,0,0,0,0,0,0,0,0,0,0,0,0,0,0,1,0,0,0,0,0,0,0,0,0,0,0,100,NoArch
25bbff64cf9bb05adda36af4d830abd81655a2d7,1,6,11,5,0,0,0,22,41,4,1,1,0,481,222,4,59,61,2,2848,2884,36,25,26,1,1,100,NoArch
0811bb38fb61c19cb2759b96c268682a47516efe,3,12,6,6,0,0,0,4,42,44,1,2,1.530493057,918,223,4,109,107,2,4884,4838,46,47,46,1,1,99.98519177,NoArch
7b946cf35142139ab90320d943c90d905722989f,0,0,0,0,0,0,0,0,0,0,0,0,0,0,1,1,0,0,0,0,0,0,0,0,0,1,100,NoArch
c291b056996f7c5c2c25ad75f5ac57dd64028327,1,1,1,0,0,0,0,30,48,139,1,1,0,557,42,0,75,75,0,3840,3836,4,29,29,0,1,100,NoArch
2bf0a1906dc65bb676119729ad7e829c6bf6c2a4,0,0,0,0,0,0,0,0,0,0,0,0,0,0,4,1,0,0,0,0,0,0,0,0,0,1,100,NoArch
0ff34b697416fc697dfa96a80496b74598a95263,0,0,0,0,0,0,0,0,0,0,0,0,0,0,5,1,0,0,0,0,0,0,0,0,0,1,100,NoArch
7689e62cd998036966a39a61187e6d6a812e3415,1,12,5,7,0,0,0,19,25,50,1,1,0,465,43,1,45,44,1,3033,3007,26,17,17,0,1,100,NoArch
fec49dc12b19801a75c3f61c9da0d47ef0c1d2f8,2,173,0,173,2,0,2,1,1,0,1,1,0.895626846,0,5,0,19,0,19,622,0,622,19,0,19,1,99.96300954,NoArch
622d27a099f5dec96f992fd423b666083da4b24a,164,1816,6044,4228,7,38,45,0,119,113,10,90,6.117231007,44010,90,5,3891,4232,341,242574,266297,23723,2103,2317,214,0,92.31722429,Arch
c5c4cfec915fad198ccb57d00bc8d875a78e794b,165,6060,1834,4226,38,7,45,1,123,209,10,90,6.131377919,40017,33,0,4262,3921,341,267847,244133,23714,2321,2107,214,1,92.31722429,Arch
d4f0326b4bbbabefc5c75617b2b5d6b8bf55fe11,7,51,51,0,0,0,0,2,56,90,3,6,2.042650322,5222,6,1,549,550,1,32567,32652,85,276,276,0,1,100,NoArch
efafb79eeb872b124c642143387c85cc51aaca59,1,6,0,6,0,0,0,2,2,273,1,1,0,138,0,0,1,1,0,737,680,57,1,1,0,0,99.97040763,NoArch
7481eacf23794a5957eba39c401100ad2219e887,1,1,1,0,0,0,0,4,5,92,1,1,0,520,0,0,57,57,0,3677,3669,8,32,32,0,1,100,NoArch
d7facb8cb8a8a4f0e2f53677839ea5cbe67baaa5,1,1,1,0,0,0,0,20,32,238,1,1,0,519,2,1,63,63,0,2660,2666,6,23,23,0,0,100,NoArch
7c6bedff252b3ccdb2de74fff438d2eafb489d9b,1,2,2,0,0,0,0,4,4,21,1,1,0,338,4,0,80,80,0,2100,2100,0,6,6,0,1,100,NoArch
f1103281d2aebf177231b6c3b6df5cce299957cf,4,102,19,83,0,0,0,3,6,176,1,4,1.454870211,1373,0,0,134,125,9,7145,6604,541,92,86,6,1,100,NoArch
7601e9e4c71f86a0aa9657d97f3bf51d51833ed0,0,0,0,0,0,0,0,0,0,0,0,0,0,0,87,2,0,0,0,0,0,0,0,0,0,0,100,NoArch
17ac5a4573323c3d3391b841d28e7e3a667ab176,1,14,0,14,0,0,0,22,35,212,1,1,0,1164,12,0,110,108,2,6197,6103,94,68,67,1,1,100,NoArch
ba4d5bd847a3844796a3d176db26b494c84814b4,1,2,2,0,0,0,0,16,26,391,1,1,0,479,0,0,36,36,0,4110,4110,0,12,12,0,1,100,NoArch
5c204f14161be0afd3eb1d377305ed0f6ed87546,2,18,1,17,0,0,0,7,50,24,1,2,0.485460761,674,0,0,74,74,0,5481,5354,127,23,23,0,1,100,NoArch
7c4aaa9715cac6729c0809a92857b4aedbbbb24d,1,2,0,2,0,0,0,2,4,116,1,1,0,271,9,0,23,23,0,1814,1792,22,10,10,0,1,100,NoArch
4640a3bbb8e212030f94848a0112784d98772de8,34,2528,0,2528,32,0,32,1,57,10,2,14,4.80839641,617,3,0,305,67,238,16648,5105,11543,178,37,141,1,99.43344861,NoArch
092e35c1e300f1eb1a7474136826fed26bc10ccd,1,0,1,1,0,0,0,1,2,0,1,1,0,154,4,1,14,14,0,817,823,6,10,10,0,0,100,NoArch
c7e430bb46ab721e4716ac89e1067d75a79b3179,34,0,2527,2527,0,32,32,2,58,0,2,14,4.80869993,3144,4,0,67,305,238,5105,16642,11537,37,178,141,1,99.43344861,NoArch
c9590790f8dc114ee827b5843c6be710b7819f1d,2,21,3,18,0,0,0,7,21,440,2,2,0.41381685,1043,0,0,98,96,2,7611,7535,76,52,51,1,1,100,NoArch
1dbd9d407a354f01380148dbf2754a10bc8d600e,3,45,1,44,0,0,0,4,19,82,2,3,1.201670054,1432,224,3,93,87,6,11582,11313,269,49,45,4,0,100,NoArch
1bb017d396562b891065187bac417c52edea24da,0,0,0,0,0,0,0,0,0,0,0,0,0,0,0,0,0,0,0,0,0,0,0,0,0,1,100,NoArch
38ff18a19902f3db3b1c497d153cd73e411e8622,0,0,0,0,0,0,0,0,0,0,0,0,0,0,1,1,0,0,0,0,0,0,0,0,0,1,100,NoArch
eeb78f23e62998fe3238306c7983102f6f43d112,3,188,5,183,1,0,1,15,36,32,1,2,0.398199755,2955,69,0,230,218,12,24328,22744,1584,110,104,6,1,99.98520053,NoArch
af9f09047d7324269cb00a7cb2547a6461c178f6,0,0,0,0,0,0,0,0,0,0,0,0,0,0,1,1,0,0,0,0,0,0,0,0,0,1,100,NoArch
6456bd3a5199d60ff55d6c576e139025a1c940c7,29,1116,385,731,3,2,5,3,14,106,2,15,3.897159995,6453,5,1,543,479,64,39165,35429,3736,319,287,32,1,99.82264262,NoArch
30ebdc708bcac5e08c7b1352d726d1c2909f548f,1,8,6,2,0,0,0,8,18,208,1,1,0,996,3,1,40,40,0,8088,8042,46,22,22,0,1,100,NoArch
59978ef4a91fab67c4bb028f13de54fe8234a40d,3,6,6,0,0,0,0,2,15,96,1,3,1.251629167,1673,5,1,77,77,0,10456,10489,33,42,42,0,1,100,NoArch
eeafaeacd21cc166a0a2d6419ab866258e9ebe69,0,0,0,0,0,0,0,0,0,0,0,0,0,0,2,2,0,0,0,0,0,0,0,0,0,1,100,NoArch
e8fbd4daf49802f60f800ccc92e66369d44f07f6,0,0,0,0,0,0,0,0,0,0,0,0,0,0,33,0,0,0,0,0,0,0,0,0,0,0,100,NoArch
360df576a9439b0ad79c32a95b58d53778c7e236,0,0,0,0,0,0,0,0,0,0,0,0,0,0,34,1,0,0,0,0,0,0,0,0,0,0,100,NoArch
c86edfc28e811c86d82f98ea07d44dae4f3c5cb1,15,48,155,107,0,2,2,1,13,473,2,7,3.212495508,1359,64,0,86,90,4,7126,7358,232,63,67,4,1,98.09994432,NoArch
142adf4ccbf92050dd14d1997c0438565fdfc2cd,0,0,0,0,0,0,0,0,0,0,0,0,0,0,35,2,0,0,0,0,0,0,0,0,0,1,100,NoArch
1c43c590aca7ac13f474eb5818b6f3859c5dbf40,1,325,0,325,1,0,1,1,1,0,1,1,0,0,34,1,33,0,33,2245,0,2245,11,0,11,1,96.30846126,Arch
559b26fb7c450bf1caa9f1845664ecee069d372d,0,0,0,0,0,0,0,0,0,0,0,0,0,0,1,1,0,0,0,0,0,0,0,0,0,0,100,NoArch
0a9e568ff5436ee4f5443c91b6c6853dc0b4da3a,0,0,0,0,0,0,0,0,0,0,0,0,0,0,224,0,0,0,0,0,0,0,0,0,0,1,100,NoArch
7a6eb0f6e1cb14890506713d169b203ba87d6f42,0,0,0,0,0,0,0,0,0,0,0,0,0,0,5,0,0,0,0,0,0,0,0,0,0,1,100,NoArch
72fa19bcc9586e693f4afc99232c2467e93d2148,4,7,0,7,0,0,0,4,15,118,2,4,1.950212065,1179,6,1,87,87,0,8202,8111,91,46,46,0,1,100,NoArch
8f4e2a189e0d89665aaa2a2487c13971ab87b1ef,0,0,0,0,0,0,0,0,0,0,0,0,0,0,47,0,0,0,0,0,0,0,0,0,0,1,100,NoArch
26c967bac60de394ca78e79d27647067680ed630,2,312,0,312,2,0,2,1,1,0,1,1,0.692809885,0,35,2,25,0,25,1456,0,1456,17,0,17,1,93.98336578,Arch
3a1fd22841ab40b98589f5dc17717548500bde4b,2,1,3,2,0,0,0,3,8,71,1,2,1,866,2,0,101,100,1,4005,4025,20,55,55,0,1,99.98977714,NoArch
8846849a03f559e3835a95a8ca672ec6ff00668d,1,121,53,68,0,0,0,4,5,256,1,1,0,555,70,1,21,25,4,5477,4735,742,8,7,1,1,100,NoArch
b14ed47f211b662e064941c2b9e2fc6c5db7ba9b,0,0,0,0,0,0,0,0,0,0,0,0,0,0,2,1,0,0,0,0,0,0,0,0,0,1,100,NoArch
09dc001430dab2fef1d36d463538cfe403606e22,0,0,0,0,0,0,0,0,0,0,0,0,0,0,6,2,0,0,0,0,0,0,0,0,0,1,100,NoArch
08eba914edf6c0c404fe0a9c88896a5dd0821c8f,0,0,0,0,0,0,0,0,0,0,0,0,0,0,36,3,0,0,0,0,0,0,0,0,0,1,100,NoArch
efb971901818479e37714fab3b655ed3dc57477b,1,7,8,1,0,0,0,2,3,207,1,1,0,144,3,0,10,10,0,576,576,0,7,7,0,1,100,NoArch
ed823f1c6f99fe1626a07b347d4ce063f47c42f8,5,89,54,35,0,0,0,4,27,365,2,5,1.648075827,981,65,1,91,90,1,6879,6771,108,48,47,1,1,100,NoArch
fd7d25ab630cdd7a3adf21d8a30e03ab718d65d4,6,71,45,26,0,0,0,3,6,1231,1,4,2.037487181,803,3,0,55,53,2,4744,4357,387,46,44,2,1,100,NoArch
e3eb14ad2d5bd25fcfd6bb2eb6e991558c0684ed,0,0,0,0,0,0,0,0,0,0,0,0,0,0,0,0,0,0,0,0,0,0,0,0,0,1,100,NoArch
637660b7aa0b5259af6b9ef943f8a8c76bc19924,0,0,0,0,0,0,0,0,0,0,0,0,0,0,26,0,0,0,0,0,0,0,0,0,0,1,100,NoArch
e71f04768e7ba9b6278298bbafd0182e9000e31b,1,1,1,0,0,0,0,17,27,26,1,1,0,479,27,1,36,36,0,4110,4110,0,12,12,0,0,100,NoArch
03a94d9ff5bc673fc68da6681eea7b7d881e1881,1,15,1,14,0,0,0,6,8,231,1,1,0,221,26,0,31,29,2,1183,1092,91,13,13,0,1,100,NoArch
3948b8935a79e0773e1e4d77bb1ded5edd7e8d4f,2,20,1,19,0,0,0,5,11,244,1,2,0.863120569,193,2,0,26,24,2,930,802,128,17,16,1,1,100,NoArch
6a01f7029c0585f6bff88af5be0c85af6a5ba4be,1,3,1,2,0,0,0,4,5,1054,1,1,0,151,7,2,11,10,1,652,644,8,6,6,0,0,100,NoArch
cdaaa3c4c7f31e7bfdcc9ecd06df347e037e34bd,0,0,0,0,0,0,0,0,0,0,0,0,0,0,13,1,0,0,0,0,0,0,0,0,0,1,100,NoArch
8547899a39168c8399d32ee7ee22f35dfe3f7c84,0,0,0,0,0,0,0,0,0,0,0,0,0,0,1,0,0,0,0,0,0,0,0,0,0,1,100,NoArch
397fd3014225c2c2ac3b563541425f2ce51eba54,5,106,31,75,0,0,0,5,28,465,1,2,0.700939144,1696,1,0,142,138,4,14241,13722,519,43,40,3,1,100,NoArch
62a0c962aceae5d1c803d48c943c2155ec3ef5f1,3,110,29,81,0,0,0,15,55,99,1,3,1.523293038,2339,14,2,314,302,12,15968,15460,508,216,213,3,1,100,NoArch
bdf73b26501de62799c4968c197a6ab085019bb7,2,397,0,397,1,0,1,4,5,11,1,2,0.901509906,329,1,0,44,18,26,4597,2296,2301,29,9,20,1,99.97955846,NoArch
47792a318656ecae0203d44f637742a152bbb0e4,30,1930,81,1849,6,0,6,2,64,110,2,14,3.152794275,7095,225,1,879,661,218,51216,40271,10945,387,310,77,1,95.00414785,Arch
c00ea8498527d44de127ba34700dfe5000db3652,0,0,0,0,0,0,0,0,0,0,0,0,0,0,3,1,0,0,0,0,0,0,0,0,0,1,100,NoArch
c0e15879668537d6de96db2994fc68209ad0baa5,79,2914,2798,116,8,5,13,15,113,255,8,37,5.659606274,16947,2,1,1660,1672,12,110608,109090,1518,825,822,3,1,94.59178858,Arch
e0954040a9ce490843a56d3497715bbc9eb7ffc0,0,0,0,0,0,0,0,0,0,0,0,0,0,0,4,2,0,0,0,0,0,0,0,0,0,1,100,NoArch
c091e4cc3029fcad734667068b7177ea6f871a33,2,54,0,54,1,0,1,1,3,2,1,2,0.380946586,90,0,0,14,11,3,656,380,276,5,3,2,1,99.9569012,NoArch
6187622178e4e802f4a32a5fa8c856846bf12bd5,2,22,22,0,0,0,0,3,14,143,2,2,0.574635698,281,3,2,30,30,0,1429,1429,0,11,11,0,0,100,NoArch
45fdcf68a1ce7e780f472b4af67edb4946a4fbc3,1,396,0,396,1,0,1,1,1,0,1,1,0,0,28,2,47,0,47,2709,0,2709,14,0,14,1,100,NoArch
fbda4ad5bd7cfb8a06badbaaefafafe95ea93b6b,1,16,12,4,0,0,0,2,2,0,1,1,0,396,88,0,47,47,0,2769,2709,60,14,14,0,1,100,NoArch
23c9c5c2962e1ac053cb4395fa148b9015272990,12,48,62,14,0,0,0,3,62,146,3,11,2.989759892,9144,4,1,775,776,1,59969,60080,111,324,325,1,1,100,NoArch
8570c3aab432c2313d20f80ace70704fbc61974c,0,0,0,0,0,0,0,0,0,0,0,0,0,0,37,3,0,0,0,0,0,0,0,0,0,1,100,NoArch
3670e82af5b0298190def96a536fba553b745826,0,0,0,0,0,0,0,0,0,0,0,0,0,0,44,0,0,0,0,0,0,0,0,0,0,1,100,NoArch
b18c32379ff167c8338b8d18e1f88bb88eb07618,0,0,0,0,0,0,0,0,0,0,0,0,0,0,0,0,0,0,0,0,0,0,0,0,0,1,100,NoArch
7eeaff9ee0ee12e93e6bd7a6e8fa5f15a2081a0b,80,3270,44,3226,28,0,28,1,10,28,3,25,4.25846285,13325,226,2,1893,985,908,81789,47327,34462,710,408,302,1,98.06197423,NoArch
e74ad324c33c3c51d762c4b3349b92a25888ed10,10,655,39,616,7,0,7,1,3,69,1,3,3.049158411,655,1,0,62,31,31,7283,3580,3703,31,12,19,1,99.75827641,NoArch
5673819736571287c80568750bde0dde3b1c2b39,0,0,0,0,0,0,0,0,0,0,0,0,0,0,7,1,0,0,0,0,0,0,0,0,0,1,100,NoArch
c744848c5915c6e8b50d77c2502e772e76107ca7,2,10,2,8,0,0,0,1,3,183,1,2,0.918295834,285,227,2,45,43,2,1203,1167,36,23,22,1,1,100,NoArch
a9985863967052783bad0e0a4381c9f602c31280,12,168,399,231,1,5,6,1,4,27,1,3,3.461462065,1365,228,3,61,68,7,6406,7567,1161,30,36,6,0,99.69541015,NoArch
f20acb8dc35f7107301b103140f28b92cc7b4983,0,0,0,0,0,0,0,0,0,0,0,0,0,0,4,0,0,0,0,0,0,0,0,0,0,1,100,NoArch
fc8d96246a1a97ac1e569a19e58aefbfc33706eb,1,18,16,2,0,0,0,7,8,15,1,1,0,470,1,0,55,54,1,3368,3394,26,21,20,1,1,100,NoArch
b686c07407bc4d84f7fb181628d373f35ff9f1de,10,185,94,91,0,0,0,1,45,186,2,9,2.614179358,4979,36,3,609,606,3,33314,32403,911,223,221,2,1,99.7476606,NoArch
6566fc6625072b76dd121f0b28ce7b1ef11b6259,0,0,0,0,0,0,0,0,0,0,0,0,0,0,5,3,0,0,0,0,0,0,0,0,0,1,100,NoArch
126b88b48ddf3af4ad6b48551cab09eea4c800c9,37,918,670,248,2,0,2,15,124,220,8,23,3.823267961,26230,31,0,2167,2154,13,185047,183531,1516,1260,1248,12,1,94.74304805,Arch
10aec07fd2557c1b91d76ec5ab1a4902e918c488,0,0,0,0,0,0,0,0,0,0,0,0,0,0,2,0,0,0,0,0,0,0,0,0,0,0,100,NoArch
046044c83d6382d455cfb0ff5c1130ddf926fcf3,13,23,57,34,0,0,0,3,32,111,5,10,2.900646991,4523,4,3,288,290,2,27966,28236,270,145,145,0,1,100,NoArch
63f95ab801c0266bd4f03762b7a353f831b61784,0,0,0,0,0,0,0,0,0,0,0,0,0,0,4,0,0,0,0,0,0,0,0,0,0,2,100,NoArch
51244eba820b49cf5f5fbdfa6482482a74efaee7,2,65,14,51,1,0,1,1,3,11,1,2,0.885883479,224,5,3,13,14,1,1616,1321,295,13,14,1,1,99.92615157,NoArch
a270eeeef97ebf87e1ab6c3595ff895b3692c946,0,0,0,0,0,0,0,0,0,0,0,0,0,0,71,1,0,0,0,0,0,0,0,0,0,0,100,NoArch
994c56148859a8b7d6b6b5c068a7715167e9bb70,7,179,65,114,0,0,0,5,27,50,2,5,1.711765763,2725,2,0,188,178,10,18612,17531,1081,131,128,3,1,99.65917465,NoArch
ee956b8951f673bf69cd7104255cfef298d09a8c,0,0,0,0,0,0,0,0,0,0,0,0,0,0,0,0,0,0,0,0,0,0,0,0,0,1,100,NoArch
e70a427956be8206e15aaf158680d2d7f4dbe215,8,461,40,421,0,0,0,3,9,246,2,8,2.337657483,3425,229,4,315,257,58,22432,19578,2854,177,157,20,1,99.91712707,NoArch
aaccc63ad5afe6b15c379520722943b88df9c9f9,0,0,0,0,0,0,0,0,0,0,0,0,0,0,33,0,0,0,0,0,0,0,0,0,0,1,100,NoArch
05606708fabdd3b6414cce04802ac85617976d04,3,8,24,16,0,0,0,4,57,66,1,2,0.668564443,1385,230,5,134,137,3,6030,6165,135,74,75,1,1,100,NoArch
4898ea52f77758e682ca1ffc59c6f30d184c7638,0,0,0,0,0,0,0,0,0,0,0,0,0,0,0,0,0,0,0,0,0,0,0,0,0,1,100,NoArch
b781b310452f117dd11c2cd5322b0cb4bea5c423,1,8,4,4,0,0,0,4,10,63,1,1,0,442,2,1,27,27,0,2413,2345,68,13,13,0,1,99.99076809,NoArch
726e8e3590bad14e2ab39bb733873a13d079a548,1,2,0,2,0,0,0,1,2,37,1,1,0,154,6,4,7,7,0,1285,1272,13,7,7,0,0,100,NoArch
0faa562b6fc4bf3368d099bf9b43381baf77dd1a,5,50,41,9,0,0,0,5,11,23,1,4,2.224336394,2309,231,6,195,194,1,11900,11937,37,107,105,2,1,100,NoArch
6aec9d754f4a091136c2dba9643b27ae66db255b,2,21,13,8,0,0,0,1,17,3,2,2,0.936667382,718,232,7,75,74,1,3392,3316,76,40,40,0,1,100,NoArch
80368a049d0764b45ae0ce998a0e7d5897858615,0,0,0,0,0,0,0,0,0,0,0,0,0,0,0,0,0,0,0,0,0,0,0,0,0,1,100,NoArch
4bda6afe0b2858d31337fe42979929523ba07f6d,35,868,555,313,4,2,6,4,65,281,3,22,3.819008404,5699,66,0,571,540,31,38494,37508,986,378,354,24,1,99.55735891,NoArch
ded197800aaacd270ea601037caeb59f84af7788,0,0,0,0,0,0,0,0,0,0,0,0,0,0,15,0,0,0,0,0,0,0,0,0,0,1,100,NoArch
3964c476e01c6f4de339df0b4777f9587fb1e68c,4,91,11,80,0,0,0,3,33,106,2,3,1.335251407,2200,225,0,237,226,11,14824,14081,743,87,83,4,0,100,NoArch
9282611baec5069156f627a2c96ee8cdd480bf90,16,2006,10,1996,8,0,8,1,29,75,2,8,2.796707492,3478,10,0,558,312,246,31932,19413,12519,270,164,106,1,96.33442371,Arch
1959b843b706babed8c16ee31c6fc266871d709f,1,5,0,5,0,0,0,6,9,263,1,1,0,123,32,1,17,16,1,632,615,17,6,6,0,1,100,NoArch
382d19e85b06d0fc7f4ad37bb4e4eae3f5e76b78,5,349,36,313,2,0,2,5,20,185,2,4,1.710479579,1098,5,1,100,67,33,8587,6650,1937,58,41,17,1,99.90942029,NoArch
6c3578069e985a3ec2a115585bd0fa8753d50ff6,8,110,120,10,0,0,0,2,11,0,1,4,1.953127379,3696,233,7,339,344,5,22663,22735,72,176,175,1,1,99.96982195,NoArch
e3675fe9b014f0d6c24caeaa23578a54e194e92c,8,57,19,38,0,0,0,1,66,99,3,8,2.238904815,4360,234,7,401,397,4,24443,24285,158,198,196,2,1,100,NoArch
2b828ccb98b48f122f2fcc5c268b8e2bf8fd8854,0,0,0,0,0,0,0,0,0,0,0,0,0,0,89,0,0,0,0,0,0,0,0,0,0,1,100,NoArch
473be87aa5d71939c2e8a367851b0e3b96744bc0,0,0,0,0,0,0,0,0,0,0,0,0,0,0,1,0,0,0,0,0,0,0,0,0,0,0,100,NoArch
348519f3cde1fba7a3c22f259f19ac6563f4db03,1,28,0,28,0,0,0,3,12,5,1,1,0,1481,235,8,64,63,1,8949,8780,169,52,51,1,1,100,NoArch
2394c629731f3f1705517e1366e1cad3950ddec7,0,0,0,0,0,0,0,0,0,0,0,0,0,0,7,3,0,0,0,0,0,0,0,0,0,1,100,NoArch
de37774e120e0c21354f0ae31326736d5023e786,2,2,1,1,0,0,0,2,28,242,2,2,0.918295834,808,67,1,88,88,0,4890,4881,9,49,49,0,1,100,NoArch
c7fe3fd01dc0b7b3d1c4c579391337a0f9c609dd,1,6,0,6,0,0,0,6,9,64,1,1,0,235,27,0,32,31,1,1208,1183,25,14,13,1,1,100,NoArch
a33bdd32e37a0a7859256f9db32d2bef0a44c1fa,34,690,820,130,1,4,5,5,30,624,4,19,3.909298526,5881,68,2,646,658,12,33183,34444,1261,324,322,2,1,94.78785662,Arch
2bf7920bd9dcd1c357854c5aacba87251b60faf4,1,4,0,4,0,0,0,3,6,134,1,1,0,293,0,0,31,31,0,1850,1817,33,13,13,0,0,100,NoArch
f52b93fd1020946ed6a45a25b5e7df35716a0d65,0,0,0,0,0,0,0,0,0,0,0,0,0,0,28,1,0,0,0,0,0,0,0,0,0,1,100,NoArch
50cdb867c733536d93a83fbbe86cf46af04784e1,4,190,50,140,0,0,0,22,38,177,2,3,0.822540255,4086,90,1,517,508,9,30644,29663,981,238,236,2,1,100,NoArch
2e0dd297149f71bee2de0b7e52c86eb5f58a8894,3,3,2,1,0,0,0,6,67,105,2,3,1.521928095,2441,226,1,308,308,0,14532,14519,13,136,136,0,1,100,NoArch
36e656aa7732f8cd30dbbbebc8c8e230e91d015a,0,0,0,0,0,0,0,0,0,0,0,0,0,0,227,2,0,0,0,0,0,0,0,0,0,1,100,NoArch
8e0b47e3609be579da1b66deb9b077b83f87ea90,0,0,0,0,0,0,0,0,0,0,0,0,0,0,6,1,0,0,0,0,0,0,0,0,0,0,100,NoArch
51b578316102a42cd71f042425f14b4cc0689e6a,0,0,0,0,0,0,0,0,0,0,0,0,0,0,38,0,0,0,0,0,0,0,0,0,0,1,100,NoArch
41653fc708854828bacb23ed624ca6b3a67d6737,1,2,2,0,0,0,0,26,52,50,1,1,0,743,69,3,71,71,0,3723,3723,0,45,45,0,0,100,NoArch
d5c904e10e04980d360129a2ed6b73432b1d2206,9,97,151,54,0,0,0,15,74,162,3,6,1.610199899,4875,8,4,438,448,10,36206,36474,268,280,283,3,0,99.96647108,NoArch
eea4a692c09694c778354c726fdcd4a3d75e13d0,46,1084,854,230,1,2,3,1,68,241,5,20,3.819340584,9658,70,4,1205,1178,27,55705,55447,258,624,581,43,1,99.6898055,NoArch
716dd3512b9ae6a519f083ccc601c4c6ff9a8ab1,1,3,0,3,0,0,0,4,6,7,1,1,0,301,72,1,7,7,0,2221,2206,15,4,4,0,0,100,NoArch
6b84384022f0ee6e709d215d66c07b718c4e8467,9,152,98,54,0,0,0,15,75,0,3,6,1.602568115,4821,9,5,448,438,10,36474,36206,268,283,280,3,0,99.96645984,NoArch
39f2a06c85d237c51c3bf2b1e2f6876e7eb65e06,0,0,0,0,0,0,0,0,0,0,0,0,0,0,71,5,0,0,0,0,0,0,0,0,0,1,100,NoArch
a36762a8628ba743f773acb8e0d1de1d71575359,7,40,30,10,0,0,0,3,19,217,2,6,2.324756361,2265,73,2,104,104,0,13819,13610,209,43,43,0,1,99.77255497,NoArch
d5c7c79d875125999a239392170399a90d04a5c6,13,57,23,34,0,0,0,3,33,20,5,10,2.900646991,4491,10,6,290,288,2,28268,27998,270,145,145,0,1,100,NoArch
af10a97e7ac00271f05964818cc2d3311707e81d,2,26,1,25,0,0,0,19,34,320,1,2,0.950956048,1218,1,1,94,92,2,9839,9646,193,32,31,1,1,100,NoArch
340c3dbbe17d70099400a2754e5abb0f4e6a0712,4,7,6,1,0,0,0,7,34,0,1,3,1.884313528,2116,6,2,150,150,0,15619,15601,18,93,93,0,1,100,NoArch
a5348cc6854e7b35b008fb922868d3b9b2a714f9,0,0,0,0,0,0,0,0,0,0,0,0,0,0,2,2,0,0,0,0,0,0,0,0,0,1,100,NoArch
859157ec01125ee98d2c38bbe767ab7eb0452924,0,0,0,0,0,0,0,0,0,0,0,0,0,0,7,1,0,0,0,0,0,0,0,0,0,0,100,NoArch
f0e843249c4f64495ee8329ac4231237262c7bd1,0,0,0,0,0,0,0,0,0,0,0,0,0,0,11,7,0,0,0,0,0,0,0,0,0,0,100,NoArch
f1f0109ab89f7317c89c6d1d51545a24f12b4692,0,0,0,0,0,0,0,0,0,0,0,0,0,0,3,3,0,0,0,0,0,0,0,0,0,1,100,NoArch
da28e38fe3d25e3ab212dc02312f0ae395371072,1,1,1,0,0,0,0,40,125,42,1,1,0,2675,74,3,393,393,0,11734,11734,0,361,361,0,1,100,NoArch
2d745057eae3f6644339ceaba2dfcb6450871442,0,0,0,0,0,0,0,0,0,0,0,0,0,0,72,6,0,0,0,0,0,0,0,0,0,1,100,NoArch
a0ffd05b7773c4c83714a60dcaa79332ee3aada3,6,4,56,52,0,0,0,17,126,149,3,5,2.218239556,4775,236,7,571,579,8,25452,25709,257,455,459,4,1,100,NoArch
ba11082282d48af41126b94e233ea12fcf89c279,2,1,17,16,0,0,0,2,11,16,1,2,1,937,237,8,92,97,5,3916,4002,86,51,53,2,1,100,NoArch
1a5a9f7f03ec114afa9182af072ea4110b1fdd0d,2,47,22,25,0,0,0,16,64,42,1,2,0.375051406,3758,4,4,277,275,2,26144,25852,292,104,103,1,1,100,NoArch
a54c963543039cc6dce50d51830bb272f71baec2,0,0,0,0,0,0,0,0,0,0,0,0,0,0,8,0,0,0,0,0,0,0,0,0,0,1,100,NoArch
1a910fd47396e012b58477c709dd340f3a0281af,1,1,1,0,0,0,0,1,1,0,1,1,0,107,1,1,10,10,0,807,807,0,2,2,0,1,99.9661476,NoArch
2a08a65f719b5c155dde85a0dc318af5033c31d5,4,7,7,0,0,0,0,13,15,376,2,3,1.842370993,1211,0,0,179,179,0,8467,8467,0,45,45,0,0,100,NoArch
76a28daeb08e7192d75dfc447624c827643bef0d,1,14,1,13,0,0,0,6,11,411,1,1,0,379,1,1,45,42,3,2866,2810,56,34,33,1,1,100,NoArch
f6e7227ed548ea5bac66e224df42e2985fb814a9,1,3,1,2,0,0,0,19,29,7,1,1,0,407,91,2,47,46,1,2736,2728,8,30,30,0,0,100,NoArch
b513232449a4d85648dfb4675c0bdb1073efbcf2,1,18,8,10,0,0,0,1,2,67,1,1,0,377,238,9,28,28,0,2210,2136,74,14,14,0,1,100,NoArch
1fda9ee9bb100d78638467965d2d6dc09f3f07dc,0,0,0,0,0,0,0,0,0,0,0,0,0,0,8,2,0,0,0,0,0,0,0,0,0,1,100,NoArch
71c2c3102b854a02116c7deb00dfa72b333b4382,10,104,158,54,0,0,0,15,76,0,3,7,1.685527299,6039,12,6,501,511,10,44418,44628,210,315,318,3,1,99.9661476,NoArch
eee6a02f77c625c86258a5e9b6ae5013c1268c5c,7,8,8,0,0,0,0,15,29,584,4,6,2.75,2187,13,7,219,219,0,13310,13290,20,122,122,0,1,100,NoArch
6e7ac457352e007939ba3c44c9dc197de7b88ed3,14,364,60,304,0,0,0,2,127,443,2,10,3.114813506,9802,75,3,1305,1278,27,62695,60341,2354,843,827,16,1,100,NoArch
e7c8df7e8b886261a9b0da7696a75e73eca04f11,7,83,46,37,0,0,0,2,51,134,3,5,1.765237788,4957,73,7,358,354,4,31694,31495,199,189,186,3,2,100,NoArch
74d7b4d751ac3d3d701db6a4c54e858d089a7e07,4,4,4,0,0,0,0,2,4,995,3,4,1.905639062,370,0,0,23,23,0,1979,1973,6,15,15,0,1,99.9661476,NoArch
1ea1e659c2862e512b3989038a4499bc33a67e6a,3,107,31,76,0,0,0,1,13,53,2,3,1.174271831,506,14,8,61,57,4,3856,3120,736,47,43,4,1,99.68638752,NoArch
e5faf2cc8470f83323b34305a135461c7e43d14e,4,53,3,50,1,0,1,11,128,108,1,2,1.367345521,3888,7,2,508,504,4,18431,18260,171,425,421,4,1,99.98302495,NoArch
717f159bfd171299d6e748eaf31363321418cea0,3,35,26,9,0,0,0,20,31,29,3,3,0.802811642,344,15,9,17,17,0,2523,2515,8,14,14,0,1,99.94063269,NoArch
924c30c7ea3236151cc3670e3f7e4b96d00d2d95,2,17,13,4,0,0,0,7,11,418,2,2,0.353359335,458,92,3,25,25,0,2671,2651,20,16,16,0,1,100,NoArch
cdaec5a8da060157eb7426b5b70419c5f8868e04,16,228,5,223,1,0,1,1,129,109,3,11,1.027486938,4727,1,0,574,507,67,25005,20045,4960,445,419,26,1,96.95096827,Arch
51599af2818562b6cea9bd01bd81af363209a2d2,3,129,1,128,2,0,2,1,2,160,1,3,1.096514667,110,5,5,17,10,7,955,287,668,16,10,6,1,99.95191537,NoArch
0a5ce000bfbd8a9696f08c763b1863939465627a,3,51,7,44,1,0,1,4,4,4,2,3,0.815143547,228,6,6,20,18,2,1187,1125,62,13,11,2,1,99.95194618,NoArch
07eedd3ef6a57467582c8abad3ef0f42b98a0044,8,60,30,30,0,0,0,3,68,57,2,8,2.777114515,4483,239,8,354,350,4,27562,27443,119,210,206,4,1,100,NoArch
ea1fbc71ecf9eec20815e2bc51bb8489e4ca1804,0,0,0,0,0,0,0,0,0,0,0,0,0,0,34,0,0,0,0,0,0,0,0,0,0,1,100,NoArch
70b5cf6dabf03ac54d5472b147bf52303de14e63,0,0,0,0,0,0,0,0,0,0,0,0,0,0,2,1,0,0,0,0,0,0,0,0,0,0,100,NoArch
cfd0c1ee34460332053491fd1e68c2607c14e958,1,21,0,21,0,0,0,16,30,32,1,1,0,632,74,8,89,87,2,3344,3294,50,34,33,1,2,100,NoArch
c39e88dcf0c196bca08aced6e16d47fc72f5e83e,2,22,2,20,0,0,0,11,12,133,1,2,0.870864469,1113,27,0,187,186,1,6679,6563,116,139,138,1,1,100,NoArch
ce4330d62b9f2ecd58d9c81b316a56ab3f4d6abe,1,1,0,1,0,0,0,6,11,2,1,1,0,568,240,9,61,61,0,3680,3675,5,33,33,0,1,100,NoArch
765dd2eae6937eae12e2bf0b9141b7bd388be73d,1,28,20,8,0,0,0,9,15,10,1,1,0,174,228,3,21,18,3,1251,1057,194,12,12,0,1,100,NoArch
3383b2388bd0b107646edf38e98bdb5ee88281bc,0,0,0,0,0,0,0,0,0,0,0,0,0,0,76,4,0,0,0,0,0,0,0,0,0,0,100,NoArch
7097eec4cd6aca453f4b297c828eaa621809d3dc,1,2,2,0,0,0,0,13,21,48,1,1,0,897,241,3,16,16,0,4412,4412,0,8,8,0,1,100,NoArch
c647af536e08a289537512b97a74bd1ba3ede0e6,1,10,5,5,0,0,0,2,2,60,1,1,0,152,242,4,21,21,0,898,875,23,9,9,0,1,100,NoArch
cdf2657420cd967dc84332767c5f93c8fa905809,3,32,19,13,0,0,0,14,40,169,1,3,1.548565226,2687,93,1,319,320,1,16742,16705,37,136,134,2,1,100,NoArch
a701201fac89e5f8f0d60c1b9192bff848df8b3e,1,6,1,5,0,0,0,12,13,30,1,1,0,74,94,2,2,2,0,462,418,44,2,2,0,0,100,NoArch
9fe7c2f32b941354bc1ba1fc709e082ba2bcb16a,1,18,0,18,0,0,0,2,2,102,1,1,0,50,77,2,2,2,0,260,260,0,2,2,0,0,100,NoArch
7a7e55d8b20b231bbc5cbededc480636d5d916c0,7,347,72,275,3,0,3,1,21,119,1,4,2.682581602,1279,78,3,209,178,31,9770,8225,1545,124,110,14,1,99.9200128,NoArch
85b2612bbe82121325d2faa085b4767a06ea8053,1,2,0,2,0,0,0,2,2,107,1,1,0,239,79,4,33,33,0,1771,1763,8,15,15,0,1,100,NoArch
6875fe43d02f74777726dfce0a332b176667eef2,1,3,0,3,0,0,0,6,11,35,1,1,0,118,1,0,6,5,1,1182,1144,38,4,4,0,1,100,NoArch
5125fba450862b15f3347141b253b4e68d114dce,2,70,3,67,0,0,0,5,10,329,1,2,0.40985537,568,229,1,50,49,1,4620,3941,679,21,20,1,1,100,NoArch
46200a14114c1ca22d438ba897a456c75945068d,0,0,0,0,0,0,0,0,0,0,0,0,0,0,80,5,0,0,0,0,0,0,0,0,0,2,100,NoArch
9f284a0125e8aedc68b19c07ce57789db33ff584,2,60,0,60,0,0,0,11,32,69,1,2,0.286396957,4363,230,2,397,396,1,30514,30090,424,197,196,1,1,100,NoArch
92843dc4095e497d684d51318708611163d6fd8b,4,9,5,4,0,0,0,7,12,2260,1,2,1.950212065,546,8,1,75,75,0,2322,2299,23,46,46,0,1,100,NoArch
8ce363a169f670d5b0e8fee1137f47c61792c79c,0,0,0,0,0,0,0,0,0,0,0,0,0,0,3,0,0,0,0,0,0,0,0,0,0,0,100,NoArch
6234064d141040cd0f84b2ecedc61607ae2378eb,1,2,3,1,0,0,0,5,12,69,1,1,0,450,0,0,27,27,0,2408,2413,5,13,13,0,1,100,NoArch
78a56ba082538fbdea384e69ee690c6f909adb33,3,47,9,38,0,0,0,3,12,59,1,3,1.504215579,2012,3,0,209,206,3,12326,12048,278,100,98,2,1,100,NoArch
79ef1a784b4a1a2b5299c6acf98250bdae790c9a,1,4,2,2,0,0,0,14,28,228,1,1,0,570,75,2,67,67,0,3809,3809,0,28,28,0,1,100,NoArch
ea90f1ecd738668d59423e1aed36bb430a00c549,2,7,1,6,0,0,0,2,5,38,1,2,0.811278124,346,9,0,16,16,0,2353,2299,54,16,16,0,1,100,NoArch
bf56e6fe24348e7d226c2bda8491207524231fd0,0,0,0,0,0,0,0,0,0,0,0,0,0,0,0,0,0,0,0,0,0,0,0,0,0,1,100,NoArch
e49c2826e415046eceade2d123e213d80c6b108d,5,81,34,47,0,0,0,2,3,57,1,2,2.208702893,1592,243,5,208,204,4,10969,10640,329,81,79,2,1,96.35442618,Arch
d3b0ee7ee616c2c4529ad4763bbe0ea304498bc1,0,0,0,0,0,0,0,0,0,0,0,0,0,0,35,1,0,0,0,0,0,0,0,0,0,1,100,NoArch
d013cf5cec47e3320116d1e19e3d7aa0c57f7fcd,0,0,0,0,0,0,0,0,0,0,0,0,0,0,39,0,0,0,0,0,0,0,0,0,0,1,100,NoArch
9d5d4b9219711760a31a1405a11b448580aac909,1,1,0,1,0,0,0,4,4,126,1,1,0,375,0,0,31,31,0,2575,2569,6,15,15,0,1,100,NoArch
0b244193761d446e26670c64b68f6be61b5d64d3,4,35,1,34,0,0,0,4,13,101,1,4,1.747769015,1220,4,1,109,105,4,6814,6550,264,59,57,2,1,100,NoArch
9091202a5f04a6e766953cfe51500dbb7ad53930,0,0,0,0,0,0,0,0,0,0,0,0,0,0,10,1,0,0,0,0,0,0,0,0,0,1,100,NoArch
4d6aac90d9027077d361952454d8a9b1fc99dff5,2,15,4,11,0,0,0,4,4,959,1,2,0.981940787,235,244,6,12,12,0,1722,1631,91,7,7,0,1,100,NoArch
76cc3c9c4da80cfb620ecc5dcedf3e79176e1370,1,3,2,1,0,0,0,3,3,227,1,1,0,56,5,2,4,3,1,273,289,16,3,3,0,1,100,NoArch
cd14c26ea52017bd3472710f7769f71f2bcc68be,0,0,0,0,0,0,0,0,0,0,0,0,0,0,2,0,0,0,0,0,0,0,0,0,0,1,100,NoArch
ccfaf0161278fdcfa42fc2924f686b4f0e941fcf,0,0,0,0,0,0,0,0,0,0,0,0,0,0,95,3,0,0,0,0,0,0,0,0,0,1,100,NoArch
afd5eabbc0333a6db5508ac472502a38c8e06129,5,22,4,18,0,0,0,50,115,136,3,5,1.77301149,2577,16,4,251,251,0,16637,16446,191,99,99,0,1,100,NoArch
bbf6c880e43d20eddc0e3bcb46bd5f2935e957ab,9,67,51,16,0,0,0,8,33,447,1,5,2.192358617,4402,81,6,285,287,2,32410,32236,174,149,149,0,1,100,NoArch
0cbe468b6cfb58a57aafff14acec792b233456d6,8,228,5,223,2,0,2,4,130,194,2,6,2.112302892,6309,231,3,673,652,21,39218,37982,1236,476,465,11,1,95.72610986,Arch
b124f5e4871eedc362207f036520fab71939b6b4,2,7,3,4,0,0,0,16,53,0,1,2,0.468995594,4305,232,4,353,352,1,28453,28428,25,149,149,0,1,100,NoArch
4dd0a2f46e4c08199b61e4555a06d5a45ad89b6f,4,55,12,43,0,0,0,2,6,877,3,4,1.32370849,831,82,7,66,62,4,5007,4596,411,32,30,2,1,99.91358107,NoArch
6cf5c2447a687003338bb5ce4797ad9ce66aaf7d,7,195,36,159,0,0,0,5,23,316,4,5,2.205818591,2115,6,3,233,214,19,13150,12281,869,143,130,13,1,91.24069059,Arch
ce52f63f7902332380322525afb6b18ebf726028,2,30,13,17,0,0,0,15,47,69,1,2,0.693127415,1406,9,2,199,199,0,9271,9241,30,66,65,1,1,100,NoArch
c272d8e13368739068e38aadb3b1f933eca8ced5,0,0,0,0,0,0,0,0,0,0,0,0,0,0,17,5,0,0,0,0,0,0,0,0,0,0,100,NoArch
dbc1697431a017d2f13a1f5267e88161b003f253,2,28,0,28,0,0,0,2,7,284,1,2,0.985228136,672,2,1,84,78,6,4656,4487,169,29,27,2,1,100,NoArch
1b32114507b10bef3c45a5abd7301aa35e7d3165,2,6,2,4,0,0,0,3,36,16,2,2,0.811278124,2890,245,7,220,220,0,17411,17384,27,95,95,0,1,100,NoArch
7777c78e5c9cc7908bbd6ba65315c7beabbc75fd,0,0,0,0,0,0,0,0,0,0,0,0,0,0,36,2,0,0,0,0,0,0,0,0,0,1,100,NoArch
741d3023fbfee2bccda4a6645c1e0e1fc25c88fd,0,0,0,0,0,0,0,0,0,0,0,0,0,0,1,0,0,0,0,0,0,0,0,0,0,1,100,NoArch
58ca196b59000cf83fc97065267ea214dd438d4c,1,3,1,2,0,0,0,6,13,3,1,1,0,449,40,1,27,27,0,2413,2408,5,13,13,0,0,100,NoArch
449ba61d44954abb0175688b31e70e6d1c0638db,0,0,0,0,0,0,0,0,0,0,0,0,0,0,83,7,0,0,0,0,0,0,0,0,0,1,100,NoArch
528aaf7bc6a2307b17b3e178c7bbddc2d10fcb82,2,16,0,16,0,0,0,2,4,259,1,2,0.543564443,535,10,2,54,53,1,2729,2683,46,21,20,1,1,100,NoArch
4970ab0417fb0f7d55938765b3cde6dbb0f48d68,1,3,2,1,0,0,0,7,8,111,1,1,0,288,4,0,31,31,0,2327,2318,9,10,10,0,1,100,NoArch
79ffeabba4f300d2dd01a24a30800e7a1245eb79,3,71,24,47,0,0,0,3,7,16,1,3,1.084363223,517,84,8,23,23,0,4253,3740,513,23,23,0,1,100,NoArch
0c1e65581d4f96f55b9dd6f85562be8fdc529557,1,15,7,8,0,0,0,24,36,44,1,1,0,1159,85,9,63,63,0,8193,8094,99,35,35,0,1,100,NoArch
354b03fadb00c5cfb5bbd7147cf97aa45aacd839,1,1,1,0,0,0,0,5,6,111,1,1,0,227,18,3,27,27,0,1690,1690,0,11,11,0,0,100,NoArch
ae71461057e8434d78866513f48bbfec2fee8e69,0,0,0,0,0,0,0,0,0,0,0,0,0,0,5,1,0,0,0,0,0,0,0,0,0,1,100,NoArch
8a277f6b65bb5ef5ff0d6475ee48eff8c1c72e37,0,0,0,0,0,0,0,0,0,0,0,0,0,0,86,10,0,0,0,0,0,0,0,0,0,0,100,NoArch
bf86efef719b7760ea379bfa08c537431eeee09a,0,0,0,0,0,0,0,0,0,0,0,0,0,0,87,10,0,0,0,0,0,0,0,0,0,0,100,NoArch
504f31b31be2faa782767520a43d863857372375,2,64,27,37,0,0,0,2,4,510,1,2,0.935531564,345,76,0,21,19,2,2246,1929,317,19,17,2,1,100,NoArch
d47e6808eeec0247c9cc14854b5cce937bb371a9,0,0,0,0,0,0,0,0,0,0,0,0,0,0,96,0,0,0,0,0,0,0,0,0,0,1,100,NoArch
ce8bf956d804cf17467b1a956db52f58f3a7236c,2,6,1,5,0,0,0,3,14,265,1,2,0.985228136,694,0,0,66,66,0,4488,4413,75,38,38,0,1,100,NoArch
3e1a8db89af88fe94a15470bd12a19597ba297dd,3,39,1,38,0,0,0,3,15,283,1,2,1.188376372,2373,0,0,135,133,2,15919,15620,299,89,88,1,1,100,NoArch
83bb38a227ef903c121a65717026d0ed59e65f98,0,0,0,0,0,0,0,0,0,0,0,0,0,0,0,0,0,0,0,0,0,0,0,0,0,1,100,NoArch
59fe24dc46a956428edebf1ea4c57da41b9b948e,0,0,0,0,0,0,0,0,0,0,0,0,0,0,11,0,0,0,0,0,0,0,0,0,0,1,100,NoArch
791eafc495e1a979eef8cc42a07a6eac8ecfa20c,0,0,0,0,0,0,0,0,0,0,0,0,0,0,1,0,0,0,0,0,0,0,0,0,0,0,100,NoArch
49fd4110b4d8e71f67c5eb1331be10d41439b4d8,2,9,3,6,0,0,0,6,17,250,1,2,0.918295834,619,0,0,40,38,2,5068,5036,32,10,10,0,0,100,NoArch
4b6696f04fe9bf36b764221799ef56aa67847cee,1,42,23,19,0,0,0,6,10,528,1,1,0,208,0,0,20,20,0,1785,1557,228,3,3,0,1,99.96497782,NoArch
1c804a8243f92333539b6bbfc4e261b98afe813c,2,2,6,4,0,0,0,9,15,135,1,2,1,694,0,0,69,70,1,4416,4442,26,34,35,1,1,100,NoArch
ab246556639feaef6f51aa30afc89a675edd1da4,0,0,0,0,0,0,0,0,0,0,0,0,0,0,16,0,0,0,0,0,0,0,0,0,0,1,100,NoArch
b2b2aad2a4f566c7927ec9612349738f9d6f00ae,1,1,1,0,0,0,0,8,13,226,1,1,0,579,0,0,70,70,0,3093,3091,2,25,25,0,0,100,NoArch
52390b6bf8db9266c2e71f359e45021fa3fe74f6,2,54,18,36,0,0,0,6,52,443,1,2,0.309543429,669,97,1,82,76,6,5657,5419,238,26,23,3,1,100,NoArch
c6bce6bf68dedf7a781a233c4aa6c144b7c2dc4d,2,38,6,32,0,0,0,6,11,181,1,2,0.902393283,241,98,2,22,15,7,1798,1566,232,10,8,2,1,99.6966161,NoArch
a43cfec9b2e3452990f9474d7925511c7afea75d,2,7,4,3,0,0,0,2,3,1215,1,2,0.994030211,288,0,0,19,19,0,1169,1152,17,10,10,0,1,100,NoArch
3f32adc214cc73d2a05c01f7c2780f3fd5440174,2,56,3,53,0,0,0,4,5,0,1,2,0.887417927,871,1,1,72,70,2,7306,6776,530,37,36,1,1,100,NoArch
48083d86741f505b29fcb413de789c9a41da0772,3,28,2,26,0,0,0,25,116,216,1,2,1.110552251,4115,2,0,456,453,3,29280,29094,186,189,188,1,1,100,NoArch
40c693b7c98f3a6057f31b59f6aed31ce68c1d1f,3,39,12,27,0,0,0,5,16,123,1,3,1.417740156,2756,2,2,218,215,3,15747,15573,174,115,114,1,1,100,NoArch
87272a1ffed9738c93dffc6b5c98989885ea6958,0,0,0,0,0,0,0,0,0,0,0,0,0,0,88,0,0,0,0,0,0,0,0,0,0,0,100,NoArch
7e5c43c922a3724f74e827ec1a326f4d85d065c3,4,38,31,7,0,0,0,4,22,79,1,4,1.725721336,2251,246,0,90,91,1,14792,14642,150,46,46,0,1,99.8365059,NoArch
010302272762257d1f775cc1fa3710d6e13c7590,0,0,0,0,0,0,0,0,0,0,0,0,0,0,247,1,0,0,0,0,0,0,0,0,0,1,100,NoArch
b12faa230c3332ebf86b4d57e42f067413992d47,10,106,41,65,1,0,1,6,23,105,1,8,2.583945535,4651,1,0,225,218,7,28413,28177,236,135,133,2,1,99.97664097,NoArch
5e274066fbc7c1b688fdc6caff3a165f47217440,25,219,212,7,0,0,0,4,53,798,1,2,3.450797497,6119,99,3,458,458,0,47240,47240,0,156,156,0,0,100,NoArch
39312d139e0d9edd06d3ba8a3e6d8195e03de623,0,0,0,0,0,0,0,0,0,0,0,0,0,0,100,4,0,0,0,0,0,0,0,0,0,1,100,NoArch
78b4a99685b0dd360d6fb85f6e1a0f3301aec388,5,537,26,511,1,0,1,1,12,1869,1,2,1.28414801,557,101,5,93,36,57,6126,2372,3754,41,23,18,1,99.24961895,NoArch
49ed03fc8c3543c0540ac3de0519dd478991e6fb,1,45,30,15,0,0,0,14,24,0,1,1,0,897,248,2,16,16,0,4452,4408,44,8,8,0,1,100,NoArch
0b7a500503fab01726d6e111656d1f9ed86d04f0,0,0,0,0,0,0,0,0,0,0,0,0,0,0,89,1,0,0,0,0,0,0,0,0,0,1,100,NoArch
093eea11c3771a7322a0ae514e149733e880b842,0,0,0,0,0,0,0,0,0,0,0,0,0,0,45,0,0,0,0,0,0,0,0,0,0,1,100,NoArch
25150011fb10a6ce516233bc644ff7855eddb9d6,1,0,1,1,0,0,0,6,10,0,1,1,0,436,249,3,21,21,0,3085,3094,9,12,12,0,1,100,NoArch
e15718c2957362bc9fb3e83d470231b625ffa076,0,0,0,0,0,0,0,0,0,0,0,0,0,0,11,0,0,0,0,0,0,0,0,0,0,1,100,NoArch
982713b24a3812ca28e23e4c0c1f88f7dcf57626,1,10,0,10,0,0,0,2,2,224,1,1,0,297,12,1,18,18,0,1493,1389,104,18,18,0,1,100,NoArch
592bf903c01fd239dee810e16a23a2499a971508,1,8,5,3,0,0,0,14,25,0,1,1,0,912,1,0,16,16,0,4511,4452,59,8,8,0,1,99.83504183,NoArch
e87569a665eb566f7e09d754d7b6a6751659b15a,2,18,38,20,0,0,0,6,26,0,1,2,0.491237342,1350,250,4,36,37,1,7429,7596,167,20,20,0,1,100,NoArch
a5242ba3e92629d524c598afb89e901d0273dd09,2,103,5,98,0,0,0,13,18,154,1,2,0.445064857,1142,0,0,87,86,1,8660,7842,818,26,25,1,1,100,NoArch
0f6851e1ff9202233f4ff23b5fe312556a6701ed,1,8,3,5,0,0,0,12,16,174,1,1,0,705,1,1,82,82,0,4552,4525,27,31,31,0,1,100,NoArch
0786488e121a72e6a770bc3d38b02a932bf689d8,12,56,20,36,0,0,0,1,2,114,1,5,3.275478003,2324,251,5,360,360,0,12614,12196,418,144,144,0,1,99.51633833,NoArch
7303ece2735ce9ecf9c750f038d0ceec250f7bb2,0,0,0,0,0,0,0,0,0,0,0,0,0,0,2,1,0,0,0,0,0,0,0,0,0,1,100,NoArch
68b1f1444d9351fa668a4601fddb4f9b8f62187c,0,0,0,0,0,0,0,0,0,0,0,0,0,0,77,1,0,0,0,0,0,0,0,0,0,1,100,NoArch
686b9c8a758c4257ba1fb8a46a6a0c9aec5a7d0d,5,43,35,8,0,0,0,21,29,348,3,4,1.818455443,1631,2,0,75,76,1,9701,9620,81,72,73,1,1,100,NoArch
989f1bba5c2b12541b8619f146d63af398eb2a75,2,3,1,2,0,0,0,7,27,121,2,2,0.811278124,1325,233,0,34,34,0,7350,7333,17,14,14,0,1,100,NoArch
739ddc7cdd840649a00d63b4c34d4ccb63d81821,1,3,3,0,0,0,0,6,18,0,1,1,0,1557,252,6,66,66,0,9275,9277,2,54,54,0,1,100,NoArch
a07441a794e231d9e770c71db8345b5f5eae6e63,2,9,14,5,0,0,0,2,7,1360,2,2,0.998635964,551,19,0,24,24,0,3778,3834,56,13,13,0,1,99.97639282,NoArch
8ef49838f494a7d4712e9665d5aded87fa51ad97,7,36,195,159,0,0,0,6,24,114,4,5,2.205818591,2272,234,1,213,232,19,12277,13146,869,129,142,13,1,90.96512708,Arch
2cfada92f6c90052765fd8d0fb410437b51e5661,4,17,4,13,0,0,0,20,117,230,1,3,1.572351663,2537,78,2,319,317,2,16062,16015,47,81,80,1,0,100,NoArch
c7c5a8ae167047630bf8a453267597f0ab293702,0,0,0,0,0,0,0,0,0,0,0,0,0,0,3,1,0,0,0,0,0,0,0,0,0,1,100,NoArch
19a088800d6a32516fc27822322fb4aeb29f8b64,1,29,0,29,0,0,0,16,31,166,1,1,0,653,37,0,91,89,2,3448,3344,104,36,34,2,1,100,NoArch
b20cfb3430b8efd8836ba89dea24928a7289e336,0,0,0,0,0,0,0,0,0,0,0,0,0,0,90,2,0,0,0,0,0,0,0,0,0,1,100,NoArch
e14c6f0b16cb2d8e1925549825c4d7a927d25768,0,0,0,0,0,0,0,0,0,0,0,0,0,0,12,1,0,0,0,0,0,0,0,0,0,1,100,NoArch
90092cf823330cce65c78bd3000d2b6889695db0,17,41,72,31,0,0,0,2,18,441,1,7,3.379136917,2862,13,2,347,347,0,17058,17277,219,136,136,0,1,100,NoArch
0894b26511b7e56e909a19ef7c9ba56c81482a08,5,76,37,39,0,0,0,16,59,288,2,4,2.148505519,3774,1,0,411,410,1,24933,24747,186,214,211,3,1,100,NoArch
824abbf448c67d7e0c14e9568957a5fe9fdaffca,0,0,0,0,0,0,0,0,0,0,0,0,0,0,0,0,0,0,0,0,0,0,0,0,0,0,100,NoArch
6c386639723a4299399ac9dc0a5187e0a5ce85e8,1,3,1,2,0,0,0,25,78,0,1,1,0,2327,235,2,216,216,0,17961,17913,48,133,133,0,1,100,NoArch
f808ddd0d3b7c5b1cf6779bdb27c93a6f3f786c7,1,5,11,6,0,0,0,2,3,229,1,1,0,118,13,2,13,15,2,523,558,35,6,6,0,2,100,NoArch
cd88d1234d9600bba828388271d35fca5f9ba5da,3,56,8,48,0,0,0,2,4,135,1,2,1.486901539,1324,253,7,182,180,2,9161,8852,309,68,67,1,1,100,NoArch
72e059c2e290ca9b15f23d9768ace0cffffab11a,1,4,2,2,0,0,0,7,8,517,1,1,0,274,236,3,9,9,0,2625,2625,0,9,9,0,1,100,NoArch
f5bb934587941a6e9cad4b71c4848f13e432a163,0,0,0,0,0,0,0,0,0,0,0,0,0,0,0,0,0,0,0,0,0,0,0,0,0,1,100,NoArch
aa939206cb388caf76511f76dab978f5b6309385,1,1,1,0,0,0,0,12,14,364,1,1,0,557,237,4,31,31,0,4726,4726,0,17,17,0,1,100,NoArch
7ce610f6d7a87f53ff43355dd2fd03ddb2d7c835,1,5,5,0,0,0,0,3,3,175,1,1,0,209,102,6,14,14,0,926,926,0,14,14,0,0,100,NoArch
6917c47e985e9f747eeac81c3e92a47df24f0090,4,27,18,9,0,0,0,6,32,154,1,2,1.288269553,898,0,0,98,98,0,6493,6417,76,39,38,1,1,100,NoArch
97aa6337642390b66c50b685f59a68f36992d7bf,1,1,1,0,0,0,0,8,9,227,1,1,0,472,0,0,55,55,0,3368,3368,0,21,21,0,1,100,NoArch
94be4a85045e606cb43ab10e035cfa98a6813ea4,4,157,2,155,0,0,0,19,54,174,2,3,1.544172874,1970,238,5,217,209,8,15981,14521,1460,103,100,3,1,97.7321238,Arch
fba75642dae802d3eeb5035518a133fe35698df8,5,53,12,41,0,0,0,3,17,469,1,5,1.588691548,1114,239,6,120,117,3,6996,6804,192,45,44,1,1,100,NoArch
f7c578bbef2361212934ba5e0444d68c1a509184,2,47,15,32,1,0,1,1,14,92,1,2,0.972806322,200,3,3,36,36,0,1217,1101,116,11,10,1,1,98.2651973,NoArch
1337565fc619b82b824dba93c1c3814cac5d4335,15,627,209,418,2,0,2,4,69,266,2,7,2.928286927,4597,91,3,525,485,40,34137,30892,3245,265,247,18,1,94.6986787,Arch
6335662fb3a64e7c50f570234b1e325b6b81ffcc,3,148,23,125,0,0,0,9,55,0,1,2,1.451258876,1204,92,4,118,107,11,10835,9868,967,41,34,7,1,100,NoArch
161c6239797ccf461c0be52b4818e7c9aca3581f,2,35,6,29,0,0,0,4,15,450,1,2,0.281193796,273,240,7,18,16,2,2074,1805,269,12,10,2,1,100,NoArch
6c732325bb99dd3964883d17e4fec40592b8c3e4,0,0,0,0,0,0,0,0,0,0,0,0,0,0,20,1,0,0,0,0,0,0,0,0,0,1,100,NoArch
6a020354f41d2b73e782bfacc9db1f43ff455a26,0,0,0,0,0,0,0,0,0,0,0,0,0,0,29,0,0,0,0,0,0,0,0,0,0,0,100,NoArch
b421aa6ebe37fbdc9f8f8d73e29d12220f307877,2,8,1,7,0,0,0,2,15,0,1,2,0.99107606,232,254,8,37,36,1,1261,1217,44,11,11,0,1,100,NoArch
c597eb5d206b528d201a47194e144b8aed732c0e,7,194,38,156,0,0,0,6,25,0,4,5,2.252563908,2113,7,0,232,213,19,13186,12277,909,141,129,12,1,99.93897655,NoArch
586f8bef3c4451c0f85759dc4d60a0583d4447ff,2,27,1,26,0,0,0,3,4,186,1,2,0.749595257,514,2,0,67,65,2,3153,2981,172,32,31,1,1,100,NoArch
671745123b1e968299507c467b893964918ec97b,2,30,1,29,0,0,0,7,14,273,2,2,0.554778163,552,93,5,42,38,4,3785,3620,165,13,12,1,1,99.97386532,NoArch
cec4fc6e0e3d17a8699a50b7595f4edd49edc5a9,0,0,0,0,0,0,0,0,0,0,0,0,0,0,3,0,0,0,0,0,0,0,0,0,0,0,100,NoArch
76336bf05ecbb8e630f665c039ffae5d1fd2674e,1,1,1,0,0,0,0,8,11,0,1,1,0,168,2,1,23,23,0,940,940,0,7,7,0,1,100,NoArch
c2c5eea12f2e7793886f658d7741d4c85957c1a6,0,0,0,0,0,0,0,0,0,0,0,0,0,0,14,3,0,0,0,0,0,0,0,0,0,1,100,NoArch
b17095afa03172841d1ba6e67dd0f1a21da22114,1,1,1,0,0,0,0,8,15,0,1,1,0,445,0,0,27,27,0,2393,2395,2,13,13,0,1,100,NoArch
0e7ce1b3dca2fb58182ce7cd464caf4192395820,2,27,1,26,0,0,0,2,2,1210,1,2,0.591672779,266,3,0,18,16,2,1707,1480,227,9,8,1,1,100,NoArch
60895bbb35b9f945e60e28d6545d8ee66400405f,9,125,16,109,0,0,0,1,19,214,1,6,2.686352523,4325,255,9,563,549,14,26566,25891,675,114,112,2,1,96.84085943,Arch
996e1382df46540b691726959b2bb2398b588a1c,3,39,1,38,0,0,0,26,79,285,2,3,0.941138843,3327,0,0,361,358,3,24167,23819,348,177,174,3,1,100,NoArch
bdebf4d2ba0c026ebd8ef1340648c43de6064b14,0,0,0,0,0,0,0,0,0,0,0,0,0,0,79,3,0,0,0,0,0,0,0,0,0,1,100,NoArch
8757ec66090ab0b711c8f6ef6b584f3922d3759e,8,136,37,99,0,0,0,11,28,176,2,5,2.310529452,3017,1,0,205,193,12,17679,17056,623,91,91,0,1,100,NoArch
63b001797b273149dd229aff9be1b4a99012a096,0,0,0,0,0,0,0,0,0,0,0,0,0,0,3,2,0,0,0,0,0,0,0,0,0,1,100,NoArch
afc82858bca69b905a56e23323b6ec486ea9bfa6,0,0,0,0,0,0,0,0,0,0,0,0,0,0,1,0,0,0,0,0,0,0,0,0,0,0,100,NoArch
9661ec1804f389b2a68758da9dbee418429e518f,58,252,177,75,0,0,0,1,69,425,2,29,4.882725453,15656,256,10,1391,1391,0,95832,95832,0,635,635,0,1,100,NoArch
be528cdc03a8869ce9ee4fe4e18cb576e8eca77c,29,385,179,206,0,0,0,5,80,270,5,21,3.905792796,14990,80,4,1541,1516,25,98387,97517,870,834,818,16,1,100,NoArch
f0d85e50c85beccdeeb8da37c70b748c268a0f22,1,1,1,0,0,0,0,3,4,322,1,1,0,155,9,0,12,12,0,1096,1092,4,4,4,0,1,100,NoArch
6bbb4325b0ff35100a39993673fddcb5bf7b9ec6,2,70,5,65,0,0,0,14,35,84,2,2,0.747806158,1017,30,1,99,94,5,7011,6600,411,40,39,1,1,100,NoArch
64ce7676bbbb340d92f9e8281211486a855bb51d,1,22,0,22,0,0,0,6,6,243,1,1,0,166,15,4,10,9,1,1298,1137,161,6,6,0,1,100,NoArch
fc1685e7d3cfbc18ef28f45d478c2b6eaf245d94,0,0,0,0,0,0,0,0,0,0,0,0,0,0,81,5,0,0,0,0,0,0,0,0,0,1,100,NoArch
6005022ba66ce2667da3993f22e37171c270417b,1,8,6,2,0,0,0,15,26,0,1,1,0,509,0,0,60,60,0,3822,3810,12,36,36,0,1,100,NoArch
c0d79f5e308d2b928d3c45b666aa06beee9b3fb1,1,14,0,14,0,0,0,6,8,566,1,1,0,220,4,0,18,17,1,1516,1448,68,12,11,1,1,100,NoArch
8151fa42a8ffd718ac57b4e5d222c825c4dcb72a,0,0,0,0,0,0,0,0,0,0,0,0,0,0,103,7,0,0,0,0,0,0,0,0,0,0,100,NoArch
b848f51cd538cd79aec454f5583d90a85245deb7,0,0,0,0,0,0,0,0,0,0,0,0,0,0,94,6,0,0,0,0,0,0,0,0,0,0,100,NoArch
467e382ea13cfed9598a1da405f83fd56006ea0e,2,12,8,4,0,0,0,1,3,168,1,2,0.881290899,224,7,0,18,18,0,1118,1101,17,11,11,0,1,99.99046711,NoArch
a298bd7d399e95974f4a1be20c70ab378840e2e7,0,0,0,0,0,0,0,0,0,0,0,0,0,0,3,0,0,0,0,0,0,0,0,0,0,1,100,NoArch
9ea134c02a7728a80ae8de6a8c08d5c1a584d445,2,4,0,4,0,0,0,2,2,904,2,2,1,168,4,0,3,3,0,807,761,46,2,2,0,1,100,NoArch
541e114f9a309bda3915ecf0f915fdda338e8790,3,82,0,82,1,0,1,1,10,977,1,2,1.266614201,114,104,8,6,3,3,947,474,473,6,3,3,1,99.96187935,NoArch
9c225f65b5fee119c201cbb2b27f9c9d2bd6027b,1,1,1,0,0,0,0,21,70,0,1,1,0,643,0,0,93,93,0,4426,4426,0,39,39,0,0,100,NoArch
f9b2b910a6029d056bcfab90b49d9a966ba14868,1,24,4,20,0,0,0,4,15,466,1,1,0,1048,31,2,130,126,4,6380,6287,93,41,41,0,1,100,NoArch
3bd9130f5c2aec5df4bcdf1beec78d656b28f422,17,139,71,68,0,0,0,9,40,549,3,11,3.561836871,7651,46,1,783,770,13,57071,56636,435,426,422,4,1,100,NoArch
1d8d279012e53091544c487751d90d25bdfc286a,3,32,7,25,0,0,0,20,76,196,1,2,1.460484681,1887,0,0,243,240,3,12289,12108,181,77,75,2,1,100,NoArch
6d37d06fb738357ed8877d6f0e595597d9015c1b,1,9,0,9,0,0,0,2,3,690,1,1,0,58,0,0,9,6,3,366,285,81,1,1,0,1,100,NoArch
f13ec2544f384026548db8a4cb045595f70250fc,1,7,5,2,0,0,0,4,4,279,1,1,0,107,0,0,9,9,0,738,724,14,3,3,0,1,100,NoArch
16328a87c05f2a57a5105644ba9aaacaafba8764,2,30,11,19,0,0,0,5,17,494,2,2,0.872161788,947,105,9,75,74,1,8061,7946,115,39,38,1,1,100,NoArch
e16d63b4cf34f589622104dc6fa5f321cc9f3f1e,7,60,266,206,0,2,2,2,2,122,2,7,1.783763104,990,82,6,116,145,29,4298,5277,979,29,38,9,1,96.73644757,Arch
95ac58e50305fdde896ecf18a83a098172709e8f,1,81,38,43,0,0,0,7,11,305,1,1,0,233,2,2,9,8,1,2230,1832,398,7,6,1,1,100,NoArch
0afc5819ddbe8b712a3535296885ca98a1f2e912,1,3,1,2,0,0,0,21,38,0,1,1,0,484,4,0,59,58,1,3056,3048,8,18,18,0,1,100,NoArch
d614242f2159b46151e88226797bab8d3bbe2de5,1,0,2,2,0,0,0,11,18,0,1,1,0,301,4,4,45,45,0,1804,1819,15,12,12,0,1,100,NoArch
34c6ce909c3f79ec8845dd2eb9fedef3ebd9eb46,1,1,1,0,0,0,0,3,3,1877,1,1,0,87,6,0,6,6,0,344,338,6,5,5,0,1,100,NoArch
394ebb3c6b97476bf86d7270ee863afb5770b390,2,14,2,12,0,0,0,4,7,0,1,2,1,1226,257,11,154,152,2,6504,6470,34,61,61,0,1,100,NoArch
59c85a4f5cd61049616cddb4b72a96491c156d79,1,1,1,0,0,0,0,11,18,0,1,1,0,368,106,10,27,27,0,3002,3002,0,17,17,0,0,100,NoArch
17a23daa8e09334366208f736a3cb1725a69ffd0,1,1,2,1,0,0,0,33,71,0,1,1,0,1091,95,7,176,176,0,5279,5282,3,90,90,0,1,100,NoArch
73d8758123086b44ca2996784dbf8afb2515ba0d,0,0,0,0,0,0,0,0,0,0,0,0,0,0,0,0,0,0,0,0,0,0,0,0,0,1,100,NoArch
ebdb9f41a27991f4d3e54a91624993bad44bcb10,6,82,47,35,0,0,0,2,32,474,3,5,2.247529003,1512,96,8,144,140,4,9034,8771,263,72,72,0,1,100,NoArch
ec628848a531673a7c3409e6aee3302f8ae2d80e,3,93,1,92,0,0,0,2,2,519,1,2,0.501149523,472,3,1,43,37,6,5401,4235,1166,21,16,5,1,100,NoArch
b7687d939a42c33da69844e60191d425f8c28ff5,0,0,0,0,0,0,0,0,0,0,0,0,0,0,83,7,0,0,0,0,0,0,0,0,0,1,100,NoArch
c758a96a3cad5b9f602e51ce23e90c1c44c1f11b,11,15,81,66,0,0,0,4,7,1489,1,5,3.327584887,985,4,2,87,98,11,3604,3826,222,57,67,10,1,100,NoArch
8e3c36553a6da64a459459b18c505bbbbeb5d630,0,0,0,0,0,0,0,0,0,0,0,0,0,0,16,5,0,0,0,0,0,0,0,0,0,1,100,NoArch
be67657536ad88b79ce5f3a5759e64a36063bd1a,2,56,3,53,0,0,0,4,5,134,1,2,0.213579815,246,258,12,13,12,1,2111,1722,389,8,7,1,1,100,NoArch
ba7774867ad03d0c6d35b9bfece05853274c55a8,0,0,0,0,0,0,0,0,0,0,0,0,0,0,1,1,0,0,0,0,0,0,0,0,0,1,100,NoArch
f7a6637622d5ed096b5b66050cde93c4ab92e859,3,49,11,38,0,0,0,2,4,131,1,2,1.482393702,260,259,13,16,10,6,1534,1298,236,10,8,2,1,99.9912142,NoArch
702e40c71bd2de2fe8bb624f942f4dc0a5d9001b,2,27,3,24,0,0,0,1,4,0,1,2,0.881290899,228,8,1,22,18,4,1268,1118,150,12,11,1,1,100,NoArch
9b886d1f721d09e423d635272246d826a13c28dc,2,55,8,47,1,0,1,1,5,0,1,2,0.668127334,402,2,1,53,51,2,2397,2211,186,15,13,2,1,99.98243148,NoArch
6572693eb5187237dea767b61f25c8821cb56023,5,19,20,1,0,0,0,52,118,91,3,5,2.131567108,2859,260,14,378,383,5,17866,17868,2,123,123,0,1,100,NoArch
7db20e9601856b14e0d4a09daee2cd318dc0e254,2,25,20,5,0,0,0,16,35,0,1,2,0.970950594,3243,107,11,281,281,0,21690,21593,97,129,129,0,1,100,NoArch
8b21bb7128c7a026d1b3e2225b5f5075099e6e66,4,113,13,100,1,0,1,8,131,254,1,3,1.683962421,3412,5,0,440,435,5,17027,16377,650,408,403,5,1,99.97365648,NoArch
a084dd6a93aa0c9587026a2d77c625c109d7f14f,3,81,1,80,1,0,1,21,42,94,1,2,0.827585563,1357,3,0,201,190,11,7765,7432,333,94,88,6,1,100,NoArch
c11537b08226ebecaa12d0fa7e4f8f7e743f9e0b,2,32,5,27,0,0,0,7,9,271,2,2,0.179256067,365,1,1,37,34,3,2261,2103,158,27,26,1,1,100,NoArch
fd0a953df65f2d227d16db2bd24aa72a65cba9e5,17,365,238,127,1,0,1,2,32,447,5,10,2.307390799,5187,2,0,428,419,9,37103,36293,810,259,253,6,1,99.96489072,NoArch
3db232ee7d29649a77d1c0b2bf81d5c2a8ddaf62,2,9,6,3,0,0,0,3,16,0,1,2,0.566509507,239,0,0,37,37,0,1292,1261,31,11,11,0,1,100,NoArch
094ed24185e0f9d744b208837da126f0171ba4e7,1,6,0,6,0,0,0,10,10,855,1,1,0,107,5,1,29,27,2,562,529,33,12,11,1,1,100,NoArch
93e94eb709035209196345e280f9a3afa2385862,2,53,0,53,0,0,0,9,16,418,2,2,0.987380023,468,14,3,59,50,9,3396,3041,355,19,17,2,1,100,NoArch
fe9cbbc40b330ad92158858ef91a03db8e5389bb,0,0,0,0,0,0,0,0,0,0,0,0,0,0,5,0,0,0,0,0,0,0,0,0,0,0,100,NoArch
53a3dae62a11ca6b73e313b02fac5d4f72dfe148,0,0,0,0,0,0,0,0,0,0,0,0,0,0,6,1,0,0,0,0,0,0,0,0,0,0,100,NoArch
e524a62ba88957556c948c905ae2033325c7676e,1,6,2,4,0,0,0,19,26,19,1,1,0,405,108,12,23,23,0,1793,1785,8,23,23,0,1,100,NoArch
0bd1c533c2aa68f39325d4d7b38b9bc3f197fd6e,5,62,26,36,0,0,0,4,14,423,1,5,2.233900195,709,2,2,58,54,4,5147,4915,232,42,39,3,1,94.60123739,Arch
62e1192088ecc4db9d1d7f3f8365a7ed6ee31e60,61,1348,1325,23,2,3,5,3,56,454,2,9,5.541886213,11963,0,0,800,804,4,85696,85411,285,344,354,10,1,98.00594999,NoArch
5a8fab6d63b4beaebb4b3ff8a9b9ba7893dbdc7c,5,16,5,11,0,0,0,5,12,350,2,5,2.035939163,636,261,15,64,63,1,3976,3906,70,48,47,1,0,100,NoArch
34ff529bc302387b6c59616f84427cc2451a803e,8,85,62,23,0,0,0,2,37,144,2,8,2.471034198,4433,97,9,419,421,2,30537,30320,217,156,156,0,1,100,NoArch
e67b6f560e4553de95e4979a38419c871ccd19fe,3,6,6,0,0,0,0,3,7,276,1,2,1.584962501,405,1,1,32,32,0,2086,2098,12,25,25,0,1,100,NoArch
19b63fb40b4ee441c4e5fa2c13e0ce25a62bba67,1,3,1,2,0,0,0,2,3,0,1,1,0,165,3,3,10,9,1,1385,1344,41,7,7,0,1,100,NoArch
ffeb7eb098f1614b5f22d7cd858e18a9e7bb9a5c,4,56,0,56,0,0,0,2,38,116,1,3,1.071023829,2058,0,0,199,187,12,13534,13139,395,91,88,3,1,100,NoArch
4e92eb882c8eef5a7722c11609e17a37a6b852b2,1,2,2,0,0,0,0,26,39,0,1,1,0,1186,38,1,63,63,0,8366,8366,0,35,35,0,0,100,NoArch
464d99273aa04511481d7d57d349b8864a9c01f1,4,23,32,9,0,0,0,2,40,0,1,3,1.272331727,2114,21,2,194,199,5,13564,13534,30,90,91,1,1,99.96844181,NoArch
4f616f7e32ba3f4fc32db387583d4e0b9c84bb0a,0,0,0,0,0,0,0,0,0,0,0,0,0,0,0,0,0,0,0,0,0,0,0,0,0,1,100,NoArch
8c7dca28808f5ff55b3a7f00b1b9da6df4b59085,0,0,0,0,0,0,0,0,0,0,0,0,0,0,109,13,0,0,0,0,0,0,0,0,0,0,100,NoArch
218240e17cd2a60600fef6df2b330994f1289820,3,34,31,3,0,0,0,23,38,77,1,3,0.446776494,1831,4,3,180,177,3,9565,9408,157,113,113,0,1,100,NoArch
4cc269249da85f9b4c84d805eecf45129f51e7d3,0,0,0,0,0,0,0,0,0,0,0,0,0,0,3,3,0,0,0,0,0,0,0,0,0,1,100,NoArch
274325a8ec9a3d715a150b91eba65eea274fdff4,2,97,31,66,0,0,0,3,5,274,1,2,0.995592754,452,2,2,31,27,4,3298,2719,579,27,24,3,1,100,NoArch
5271f0fc5e990a314438985a77f999cee7b82f2d,7,168,114,54,0,0,0,4,39,221,2,3,1.295987366,2943,5,1,318,309,9,18014,17380,634,165,161,4,1,100,NoArch
da71afd53c5e1b2d0cd72d22ddf9278ca2ef664c,17,474,105,369,2,0,2,2,132,295,4,13,3.184557375,5818,17,1,784,752,32,32114,29832,2282,582,564,18,1,93.31887564,Arch
7facad1a1e92d281bbd9b4be152ebb438b194a23,0,0,0,0,0,0,0,0,0,0,0,0,0,0,84,8,0,0,0,0,0,0,0,0,0,1,100,NoArch
fad706c295e301c7727f41944c7ea640c2c2cb15,1,2,1,1,0,0,0,13,17,376,1,1,0,656,110,14,39,39,0,2786,2784,2,32,32,0,1,100,NoArch
bdaef2970e519709d8e80bf2bec7bb469d7bfbd1,0,0,0,0,0,0,0,0,0,0,0,0,0,0,9,2,0,0,0,0,0,0,0,0,0,0,100,NoArch
e87a3671dc7cf736d4befac8461b04fc153bd88c,0,0,0,0,0,0,0,0,0,0,0,0,0,0,4,1,0,0,0,0,0,0,0,0,0,1,100,NoArch
21a3bff73f2b731e64d7ea4e29647d65fb51b613,0,0,0,0,0,0,0,0,0,0,0,0,0,0,41,0,0,0,0,0,0,0,0,0,0,1,100,NoArch
a91b03ff6b719302fdc81efa8f688034f4592e42,3,6,4,2,0,0,0,9,34,642,1,3,1.570950594,3783,241,8,233,234,1,29551,29539,12,133,133,0,1,100,NoArch
a25c26dcb5ad8ec657eaaf33d189dfb300e80924,2,229,5,224,1,0,1,4,8,302,1,2,0.834135194,153,61,0,25,7,18,2446,963,1483,13,7,6,1,99.87580946,NoArch
9d31073d9918f28295784dd5730afa09204983ea,2,5,229,224,0,1,1,4,9,0,1,2,0.834135194,377,62,1,7,25,18,963,2446,1483,7,13,6,1,99.87580946,NoArch
f1448749b05ea0771fcd7c59d833063a7990ae07,7,204,13,191,2,0,2,4,50,2,1,4,1.838749998,934,63,2,107,98,9,6955,5837,1118,51,45,6,1,99.75168499,NoArch
fcdd8497b826be19b9be91b97e96cb20ed755d7b,1,3,3,0,0,0,0,17,23,505,1,1,0,2047,0,0,62,62,0,16587,16587,0,42,42,0,1,100,NoArch
57fa1e7eea1c88fb04ec9d4f0ec71b096773c14a,1,1,1,0,0,0,0,8,13,19,1,1,0,433,85,9,22,22,0,2756,2756,0,11,11,0,0,100,NoArch
e370c5543287cf76e195225e6200ad4da768f205,1,1,1,0,0,0,0,8,9,407,1,1,0,150,0,0,7,7,0,499,499,0,5,5,0,0,100,NoArch
870ef0cff0664c47412b43c6589fc9d69d7bd4dd,0,0,0,0,0,0,0,0,0,0,0,0,0,0,262,16,0,0,0,0,0,0,0,0,0,1,100,NoArch
bead716226db943c1e2011f3281ce632d040c131,0,0,0,0,0,0,0,0,0,0,0,0,0,0,86,10,0,0,0,0,0,0,0,0,0,1,100,NoArch
23d70585a5331b8bf9b7d2de29c14e46ebf3b05e,0,0,0,0,0,0,0,0,0,0,0,0,0,0,111,15,0,0,0,0,0,0,0,0,0,1,100,NoArch
728352399c2ab8677f13265ad29dd5765da691a1,1,3,3,0,0,0,0,8,10,0,1,1,0,150,1,1,7,7,0,499,499,0,5,5,0,0,100,NoArch
bd93c84b6d4a7ee39fdf4aeddbb93811d9931b1b,3,58,2,56,0,0,0,23,41,377,2,3,0.869553965,1970,33,0,272,267,5,15441,15072,369,155,152,3,1,100,NoArch
6a647c5ddaef454fe2a6e4c67fa68ed748975e13,2,22,13,9,0,0,0,2,3,393,1,2,0.512709142,572,39,2,94,93,1,3383,3326,57,21,20,1,0,100,NoArch
c122ff675d44194b575c7099909badbafbab1f31,1,1,1,0,0,0,0,7,10,217,1,1,0,128,6,1,17,17,0,638,632,6,6,6,0,0,100,NoArch
1eb3010b8c30113b53dcf6ebc3faa486412192fd,3,54,1,53,0,0,0,20,28,6,2,3,0.355489435,1525,0,0,147,146,1,11183,10774,409,84,83,1,1,100,NoArch
1a4356f5f31b5167c17a3efc2d57544e746c5729,0,0,0,0,0,0,0,0,0,0,0,0,0,0,22,3,0,0,0,0,0,0,0,0,0,1,100,NoArch
830e35c3f1d5663c9e96d36da4af67928e9d598b,0,0,0,0,0,0,0,0,0,0,0,0,0,0,40,3,0,0,0,0,0,0,0,0,0,1,100,NoArch
19b74eac35af4afad8a41cfe009e0f2812648c44,1,10,2,8,0,0,0,14,16,204,1,1,0,193,1,1,13,11,2,1366,1284,82,9,9,0,1,99.96442547,NoArch
d75f5ae0a1a295a3280a855833874f8536e60c49,3,64,4,60,0,0,0,11,60,141,1,3,1.094089897,3506,242,9,274,270,4,28230,27618,612,158,155,3,1,100,NoArch
88c1ca257a4c5cf0da6e245fafcf1421b5378c8b,3,5,5,0,0,0,0,52,119,256,2,3,1.521928095,1590,87,11,213,213,0,8995,8993,2,78,78,0,1,100,NoArch
ebf4120d51a60363ef2ca259ac79de9ec8529758,1,1,1,0,0,0,0,6,6,322,1,1,0,409,7,2,13,13,0,3308,3308,0,12,12,0,0,100,NoArch
77fa3899ce2c657278f08869b975d8edccf5df42,3,34,27,7,0,0,0,6,17,18,1,3,1.301728854,1241,2,1,79,78,1,7979,7923,56,41,40,1,1,100,NoArch
472c782cec33d167438ebf8ebd6a4b592d3b37ab,0,0,0,0,0,0,0,0,0,0,0,0,0,0,17,6,0,0,0,0,0,0,0,0,0,1,100,NoArch
903dd3bded49c0d263748d58ee337b157c78d302,1,1,1,0,0,0,0,8,8,0,1,1,0,66,2,0,7,7,0,406,404,2,3,3,0,1,100,NoArch
f6c9b512103ed5e95141f0b8c0b53a2a8d5ac8b3,1,60,0,60,1,0,1,1,1,0,1,1,0,0,1,1,1,0,1,289,0,289,1,0,1,1,99.98220324,NoArch
0b819e6cb4c49acd9e3dfee2d11986b14b56e520,2,27,1,26,0,0,0,10,16,503,1,2,0.966618633,535,4,4,32,30,2,3614,3424,190,23,22,1,1,100,NoArch
69b90f6c714096a3ab7c312a98760a7d34a6cb75,0,0,0,0,0,0,0,0,0,0,0,0,0,0,112,16,0,0,0,0,0,0,0,0,0,0,100,NoArch
ed7e6c9323663b7747b171b191f3c3249029b45e,3,6,5,1,0,0,0,3,14,274,1,3,1.435371391,939,3,2,102,102,0,4372,4367,5,57,57,0,1,100,NoArch
33666c8642f728181a0b4b922ecc27783c8a565e,1,14,1,13,0,0,0,5,5,19,1,1,0,236,243,10,13,11,2,1401,1308,93,12,11,1,1,100,NoArch
1c12e8483abc7c204c9e221893ff90bbd73b9c1f,1,17,6,11,0,0,0,31,57,0,1,1,0,638,244,11,82,81,1,5568,5454,114,26,26,0,1,100,NoArch
31ba568338f95ce6da01d0e0910c13c1f2c5e5f9,1,38,26,12,0,0,0,13,26,414,1,1,0,280,113,17,25,25,0,2214,2187,27,10,10,0,1,100,NoArch
0239652ec3e9d1a5e9d9e287241c9e23ef5e00cf,1,13,20,7,0,0,0,7,7,189,1,1,0,111,114,18,7,7,0,697,794,97,4,4,0,1,100,NoArch
5ed94cd15d89251c69bee2d6b0bfa0631c81c621,2,57,37,20,0,0,0,18,34,9,1,2,0.633290575,2570,5,0,128,126,2,19353,19286,67,67,65,2,1,100,NoArch
c439855da67b7d1970dacfd8b6f2c33aa75a8488,7,80,6,74,1,0,1,2,36,124,2,6,2.315353834,3412,115,19,243,239,4,24605,24260,345,160,156,4,1,99.92895835,NoArch
8295329b6c8e1dd8330d3b7c7b820de7b810d414,3,118,309,191,1,0,1,9,14,900,2,3,0.866028442,576,98,10,23,78,55,1706,2725,1019,12,26,14,1,99.92909059,NoArch
856c1f529d8422575017548a9453a6e043b6c745,1,1,1,0,0,0,0,3,6,19,1,1,0,118,245,12,15,15,0,831,841,10,2,2,0,0,100,NoArch
ab3002147763f9a5ffade583931c3471f1ba4fd8,2,49,14,35,0,0,0,27,81,18,1,2,0.399938047,3223,3,3,341,339,2,23871,23546,325,166,164,2,1,100,NoArch
b36c1dbf4b0a89683483535abf57a50d780d0b2c,7,111,164,53,0,0,0,5,40,0,2,3,1.319727604,2997,246,13,309,318,9,17380,18014,634,161,165,4,2,100,NoArch
0ae83cb7e9bd6cfa6404e129315e8eed781fa3a9,0,0,0,0,0,0,0,0,0,0,0,0,0,0,8,3,0,0,0,0,0,0,0,0,0,1,100,NoArch
2e0e8ab7c0f86aadc69bcedbac81b919f9fbde00,6,197,5,192,1,0,1,26,133,180,1,6,1.921445679,3776,6,0,566,537,29,20641,19615,1026,447,434,13,1,99.96455472,NoArch
0f1130d2670c1be1c42badc3dcd8970c7f84fa2f,3,11,3,8,0,0,0,16,27,85,3,3,1.530618995,799,0,0,73,73,0,5248,5179,69,28,28,0,1,100,NoArch
790c4a20558da39c170b17098dd51f5ca9ade7b6,0,0,0,0,0,0,0,0,0,0,0,0,0,0,88,12,0,0,0,0,0,0,0,0,0,1,100,NoArch
26bbcec8756c2a7ecdf03267421117acfe4e0f2c,0,0,0,0,0,0,0,0,0,0,0,0,0,0,247,14,0,0,0,0,0,0,0,0,0,1,100,NoArch
c8a52837013618e301e306b040907eaabc48c161,1,1,1,0,0,0,0,14,36,22,1,1,0,1703,0,0,206,206,0,9474,9474,0,89,89,0,1,100,NoArch
eff20567c23cca3d5d6b2d3364e3b95e197be1af,2,10,10,0,0,0,0,5,14,12,1,2,0.721928095,1262,99,11,81,81,0,9711,9671,40,41,41,0,0,100,NoArch
d83df6f8d9f176c07b07e53da3420cb835a73630,1,19,26,7,0,0,0,4,9,3,1,1,0,424,0,0,37,39,2,2107,2198,91,22,22,0,1,100,NoArch
6fee77b76fa25be677b324804eae9801ca6b9f4c,1,5,1,4,0,0,0,26,53,208,1,1,0,743,89,13,71,71,0,3735,3723,12,45,45,0,1,100,NoArch
c48534d4bb1b74b8049e5da8ccd623e9445fb0af,0,0,0,0,0,0,0,0,0,0,0,0,0,0,15,4,0,0,0,0,0,0,0,0,0,1,100,NoArch
7f73dcd8c3e999cdd1f5164c06987f69d5313a20,0,0,0,0,0,0,0,0,0,0,0,0,0,0,100,12,0,0,0,0,0,0,0,0,0,1,100,NoArch
290fc652722a4bd6f79b90a4eec880bd6b3bb693,0,0,0,0,0,0,0,0,0,0,0,0,0,0,9,4,0,0,0,0,0,0,0,0,0,0,100,NoArch
ee08024ef6363a067e004821cd4d4f1847c684e8,0,0,0,0,0,0,0,0,0,0,0,0,0,0,10,5,0,0,0,0,0,0,0,0,0,0,100,NoArch
28cb191df76ae2626b9d712a17af576212dc82f0,0,0,0,0,0,0,0,0,0,0,0,0,0,0,11,6,0,0,0,0,0,0,0,0,0,0,100,NoArch
51105621af08eb77a8007ac965a8e5d0882c5d97,10,359,219,140,2,1,3,4,14,498,2,9,2.984466777,938,90,6,77,84,7,5872,5253,619,45,33,12,1,99.77901529,NoArch
baeff4331dd25742f8280553281b773bc5e570a5,0,0,0,0,0,0,0,0,0,0,0,0,0,0,12,7,0,0,0,0,0,0,0,0,0,0,100,NoArch
a5978cd2308f0f2e501e12040f1fafae8afb86e9,0,0,0,0,0,0,0,0,0,0,0,0,0,0,13,4,0,0,0,0,0,0,0,0,0,0,100,NoArch
7ae627179e7a70837afd557211f1b3a55a2ec010,920,36541,9538,27003,166,20,186,1,145,169,13,276,8.470134047,180833,0,0,19468,17141,2327,1297286,1149727,147559,10347,9139,1208,1,86.77820678,Arch
8130415b457c9a43ad8555664d24140e5d50aef6,19,104,155,51,0,0,0,2,29,187,4,14,3.31479194,7634,53,6,642,648,6,54740,55098,358,389,394,5,1,99.87945104,NoArch
0b3f8c1cda3718387a8b48565004178a0a68a2a5,0,0,0,0,0,0,0,0,0,0,0,0,0,0,26,0,0,0,0,0,0,0,0,0,0,0,100,NoArch
60cabeb208cf2809448ecd1ef61e42ad16702982,2,3,5,2,0,0,0,8,12,665,2,2,0.954434003,295,9,0,25,25,0,2096,2114,18,4,4,0,0,100,NoArch
bd57282f248e4a886c4fdb989789b8550dae6d60,1,2,2,0,0,0,0,15,45,32,1,1,0,1383,24,0,157,157,0,8424,8424,0,43,43,0,1,100,NoArch
f2b2ec9539d97bae3952c00085cdfc6c786e9239,4,95,46,49,0,0,0,4,12,321,1,3,1.92128935,916,6,0,18,16,2,6126,5802,324,6,6,0,1,100,NoArch
495b6fbb062c843d19de420acfefd3a6a2ee3c58,2,20,2,18,0,0,0,6,10,272,1,1,1,457,10,1,53,51,2,3584,3422,162,16,16,0,1,100,NoArch
fb28ad8f7377752526d2a3bd334e4fb983f132f3,1,92,19,73,0,0,0,7,20,6,1,1,0,1069,132,2,136,130,6,6811,6399,412,42,41,1,1,100,NoArch
f5b1b4960236c6908591b5259abbddf0f930eab8,0,0,0,0,0,0,0,0,0,0,0,0,0,0,54,3,0,0,0,0,0,0,0,0,0,0,100,NoArch
870b05e1fcd11685d97560dd6707479d059a44aa,1,30,0,30,0,0,0,2,2,285,1,1,0,101,0,0,15,11,4,495,300,195,11,9,2,0,100,NoArch
41bea2fec54ae6c2376f5c88bd5a524b60b74a11,3,54,1,53,0,0,0,2,3,1041,1,2,1.241754962,211,11,0,24,13,11,1388,947,441,9,7,2,1,100,NoArch
c501d11eba5aab7cfd597597cf4a53a32ba6f38e,4,9,24,15,0,0,0,6,14,110,1,4,1.683228657,1338,288,2,78,78,0,8015,8069,54,27,27,0,1,100,NoArch
a0df6ecfb47ac9e393b5eb977850cb8fbe7d3f72,5,105,56,49,1,0,1,7,30,169,2,5,1.721880165,1056,15,0,125,126,1,7711,7396,315,85,84,1,1,99.96291833,NoArch
2f5e487445a19e2fa5b2c26143efeb4fe9aeda63,0,0,0,0,0,0,0,0,0,0,0,0,0,0,0,0,0,0,0,0,0,0,0,0,0,1,100,NoArch
a80bb4f717ad8a89770176a1238c4b08874044e8,40,4162,11,4151,35,0,35,1,28,32,1,13,4.432077054,3591,4,0,773,307,466,39472,20904,18568,332,165,167,1,99.22673295,NoArch
ab61f61df9686793406300c0018924a119b02855,5,162,30,132,0,0,0,4,78,109,3,5,1.744973834,2556,133,1,355,346,9,15622,14818,804,163,157,6,1,100,NoArch
2a486770cc1421dff9fbeddb1cedec7d0bf456ee,2,40,7,33,0,0,0,9,29,35,1,2,0.488908591,1898,289,2,85,84,1,11455,11261,194,68,67,1,1,100,NoArch
e0fe1612ebf40caf4e588c249b6a06c0287a46fd,0,0,0,0,0,0,0,0,0,0,0,0,0,0,55,2,0,0,0,0,0,0,0,0,0,1,100,NoArch
a090ad049e26f6188a25998e8b25c6450871c41a,1,3,2,1,0,0,0,33,53,68,1,1,0,552,10,0,77,77,0,3902,3898,4,31,31,0,0,100,NoArch
f745e6457353804359b20575c597b38507237aba,4,137,4,133,0,0,0,4,20,95,2,4,1.756937276,1632,7,1,216,208,8,11880,10698,1182,69,67,2,1,99.95424179,NoArch
3e49e4c26dae1080e2b1a9389a75f56464c167a5,2,22,2,20,0,0,0,7,19,47,1,2,0.918295834,1066,8,2,91,90,1,6187,6001,186,55,54,1,1,100,NoArch
cf20c95f48d3344b7e07e6dcc6c5219ffa063e4b,2,2,2,0,0,0,0,4,47,1333,1,2,1,1708,0,0,161,161,0,8050,8050,0,95,95,0,0,100,NoArch
f75671454c9ffef4b1317c829c3b06cc4828bf21,0,0,0,0,0,0,0,0,0,0,0,0,0,0,23,0,0,0,0,0,0,0,0,0,0,1,100,NoArch
4e2a5bb488b5314b267475e56db9c1dc14ddefc5,1,2,2,0,0,0,0,4,6,129,1,1,0,289,24,1,47,47,0,1757,1757,0,10,10,0,0,100,NoArch
8ae1e8c67618a86b7c45a697d8722dd8aec0a27a,0,0,0,0,0,0,0,0,0,0,0,0,0,0,25,2,0,0,0,0,0,0,0,0,0,1,100,NoArch
633fe09514e09d676928d8a28bf7574bef6ac762,1,1,0,1,0,0,0,29,72,70,1,1,0,1203,2,0,133,133,0,7367,7358,9,45,45,0,0,100,NoArch
d426ea610df31a81dcefc03fe609113ef7fc1254,1,3,2,1,0,0,0,2,2,683,1,1,0,60,11,1,5,5,0,231,231,0,5,5,0,1,100,NoArch
ff403c82d8a64569669e6371d4b8e85cba0c0656,1,4,3,1,0,0,0,6,11,182,1,1,0,234,290,2,31,30,1,1082,1079,3,18,18,0,1,100,NoArch
dc0f880c1b2879ef2d91c5c5e83b4f72b3b58b9c,1,6,0,6,0,0,0,2,2,98,1,1,0,165,0,0,13,12,1,856,830,26,9,8,1,1,100,NoArch
672751975d0b5aac725ea9e9ea0d209d4f7098f2,2,34,2,32,0,0,0,12,31,78,2,2,0.710676854,1136,11,2,116,115,1,7740,7498,242,57,56,1,1,100,NoArch
aa945b84e6339033010fd04cb77daeb393c02f74,3,46,1,45,0,0,0,17,51,98,1,3,1.472218768,1590,12,2,205,199,6,10066,9680,386,126,123,3,1,100,NoArch
2d1dd2a8ab11feb025d021d94d5fd6f2bfa9c66f,1,6,0,6,0,0,0,9,12,79,1,1,0,395,1,1,34,33,1,2835,2809,26,16,15,1,1,100,NoArch
b9c32fb943595605a1026d568f0c1d084a3751c3,3,109,5,104,1,0,1,1,15,54,1,3,0.824608471,214,13,3,18,14,4,2025,1374,651,10,8,2,1,99.98168498,NoArch
d5bc4d9a180d4f1520accd05afbcc44fa38077fc,1,8,8,0,0,0,0,6,6,74,1,1,0,547,1,0,24,24,0,4100,4100,0,12,12,0,0,100,NoArch
9a0e1ce4887891a4281503fb0049ac32dd785850,12,176,44,132,0,0,0,15,66,162,1,8,2.75151735,5251,26,3,514,502,12,32490,31413,1077,303,297,6,1,99.96338673,NoArch
7a9aabd9b2595158a2610be12d567df4d974e258,4,176,37,139,0,0,0,10,20,35,2,4,1.819316039,2878,134,2,313,305,8,23292,22518,774,104,101,3,1,100,NoArch
e15a3cdc02b3bfdc957f3a4497860a7b261f5750,3,6,3,3,0,0,0,2,3,521,1,3,1.584962501,1155,0,0,123,123,0,6044,6005,39,39,39,0,1,100,NoArch
a06556334f8bbdf1f12be698070d128bf6716e0e,1,5,2,3,0,0,0,24,35,100,1,1,0,196,10,0,9,9,0,1348,1322,26,8,8,0,1,100,NoArch
2450b19dcddf23c87557544f5aa4cf76d3670c93,3,9,20,11,0,0,0,9,17,274,1,3,1.31625222,526,14,4,14,15,1,3723,3802,79,9,10,1,0,100,NoArch
d65668611e3e0f514d2b20fc3cf0f360146f532e,0,0,0,0,0,0,0,0,0,0,0,0,0,0,3,0,0,0,0,0,0,0,0,0,0,1,100,NoArch
f18e9284208f1fbd1f0bc0e30b317dae623f6ea4,2,74,10,64,0,0,0,7,30,53,1,2,0.878360939,2667,12,0,138,133,5,18408,17926,482,94,90,4,0,100,NoArch
eacae1e0dc44e29bbe5cfc29475666bb16ee478d,3,364,0,364,2,0,2,8,10,49,2,3,1.023453278,126,9,0,51,0,51,2574,405,2169,22,0,22,1,99.9542669,NoArch
00332f146536857878b6a45547156822bb40052c,0,0,0,0,0,0,0,0,0,0,0,0,0,0,0,0,0,0,0,0,0,0,0,0,0,0,100,NoArch
6c0323963c5e2ee0209da25ec8dc06b47261bea1,0,0,0,0,0,0,0,0,0,0,0,0,0,0,1,1,0,0,0,0,0,0,0,0,0,0,100,NoArch
70d450e8389173700f7fc6ed4c50027ae4b40f95,2,6,3,3,0,0,0,3,3,382,1,2,0.99107606,292,0,0,18,18,0,1768,1707,61,9,9,0,1,100,NoArch
669e567672557ffa6d58fd37918f6b37eb842d39,2,6,2,4,0,0,0,19,37,110,2,2,1,1724,9,2,78,78,0,7933,7925,8,56,56,0,1,100,NoArch
b6db9b1ff87cef2c27a619039404f9f977937a14,0,0,0,0,0,0,0,0,0,0,0,0,0,0,109,0,0,0,0,0,0,0,0,0,0,0,100,NoArch
6aa8e9681b2f24975d1c6a216d3b6de53f6b5702,4,88,97,9,1,0,1,3,17,177,2,4,1.858198111,956,13,1,66,64,2,5804,5955,151,41,39,2,1,99.98171846,NoArch
febc55c779215c152e17f7eb6ff0fa09123fe0fb,1,4,1,3,0,0,0,3,6,241,1,1,0,216,1,1,25,25,0,1344,1322,22,11,11,0,1,100,NoArch
83dc08b1f6509f9bb451eaf835bbccb54ff57e2d,1,40,0,40,0,0,0,2,2,132,1,1,0,170,6,0,19,19,0,1211,1211,0,8,8,0,1,100,NoArch
fcc508c8c0a549a1e14ff1dcb2a66c30c99ad421,1,24,25,1,0,0,0,7,21,45,1,1,0,1142,135,2,136,136,0,6811,6811,0,42,42,0,0,100,NoArch
202ae47b47323128f996940ee9cc9bf2db53d835,1,2,2,0,0,0,0,10,13,512,1,1,0,330,11,1,24,24,0,1874,1874,0,24,24,0,1,100,NoArch
7c213d5ff72cb713bf40ca74f4510f7fefbf5f33,1,57,0,57,0,0,0,28,43,109,1,1,0,1229,12,2,70,65,5,9211,8833,378,38,36,2,1,99.6253655,NoArch
502933d2f70acb0f0fcf930fef70c6ab9127fb3b,1,86,3,83,0,0,0,3,3,587,1,1,0,260,22,0,30,22,8,2202,1337,865,16,14,2,1,99.42331952,NoArch
f750773109abd78f5f1b41bb31b27711a7201126,2,37,6,31,0,0,0,16,27,106,1,2,0.99648599,1406,291,3,204,198,6,9178,8994,184,83,82,1,1,100,NoArch
16d33ba3cb953435660566ba2ec63a45204a7814,34,2553,127,2426,27,1,28,1,146,20,3,20,4.755484451,5483,16,1,1050,798,252,38712,26659,12053,715,556,159,1,92.63133781,Arch
d2a3d11977d277202eba002ae75090284694655f,2,7,0,7,0,0,0,16,38,7,1,2,0.591672779,1400,8,0,71,71,0,7397,7350,47,37,37,0,0,100,NoArch
6cb4580defcb0bc5e38d3dd6931e75abc9f80535,1,1,1,0,0,0,0,4,4,1013,1,1,0,176,0,0,13,13,0,1151,1151,0,7,7,0,1,100,NoArch
c9bc03ed8681ab64eea2520f5511464915389c51,27,1957,915,1042,6,1,7,56,147,181,5,17,3.225824728,13729,9,1,1557,1450,107,94614,89282,5332,932,850,82,1,97.63759895,Arch
ec5022b4fdd94c106bf243038aadf781f31b5be9,10,64,62,2,0,0,0,2,148,62,5,9,2.667257686,12076,27,4,1266,1266,0,75409,75407,2,786,786,0,0,100,NoArch
27a8866a1e1e46feff807d121dcdd6505f354bc5,3,75,21,54,0,0,0,7,73,18,1,3,1.050148126,5322,110,1,437,435,2,39713,39412,301,156,155,1,1,100,NoArch
124ab5fda667d2774f2b41d447bd178066e756db,4,24,7,17,0,0,0,4,6,108,2,2,1.632702111,708,1,1,55,51,4,3861,3804,57,31,29,2,1,100,NoArch
43d23a49a0213da8585aa7240924ac0439cc21f9,2,6,0,6,0,0,0,4,5,224,1,2,1,895,1,0,96,96,0,5978,5908,70,54,54,0,1,100,NoArch
9ee36de98ab360a86d0bf6d61c873a85cdc2d97e,0,0,0,0,0,0,0,0,0,0,0,0,0,0,2,2,0,0,0,0,0,0,0,0,0,0,100,NoArch
f8028a400ebe7a64d7745fae90e769306a8a07a7,26,914,556,358,1,1,2,3,59,343,3,16,3.171096341,12965,108,0,1008,978,30,89965,88487,1478,525,511,14,2,99.91253644,NoArch
86be85548202f4726ed1ab702c3c439c3fbea4d2,4,7,5,2,0,0,0,18,52,63,1,3,1.918295834,5641,270,0,333,333,0,45633,45607,26,163,163,0,1,100,NoArch
0e9bb024fb990c8cd33b3ba84f3b759eedaecc63,9,277,110,167,0,0,0,1,31,219,2,8,2.264793553,5964,292,2,491,470,21,40293,38965,1328,241,236,5,1,99.98834227,NoArch
e62b9da66b6dbf7838fc82aca2a5644e4aad7e59,7,68,49,19,0,0,0,3,82,81,2,7,1.629323948,2312,14,2,214,234,20,13580,13586,6,132,129,3,1,100,NoArch
b1552eff7af5fee8f8b11d051a147240ef619689,3,15,6,9,0,0,0,4,37,353,2,3,1.493709546,1006,109,1,123,122,1,6503,6467,36,69,68,1,1,100,NoArch
6f4c60e1835f87cd649b8d71b2118a0a26ec41ea,4,217,3,214,2,0,2,1,17,70,1,2,1.714812062,381,136,2,74,57,17,3333,2411,922,57,43,14,1,98.00985713,NoArch
f0f8d618b30eee73baf02806d915a8b12034edad,0,0,0,0,0,0,0,0,0,0,0,0,0,0,110,2,0,0,0,0,0,0,0,0,0,1,100,NoArch
d03c8f9c155295d40d90f48bcba250945689a94a,1,1,1,0,0,0,0,2,3,6,1,1,0,2540,56,0,230,230,0,20088,20092,4,140,140,0,0,100,NoArch
6f6652a84aa5e738cdb6932f41880ae24415b06c,9,189,17,172,0,0,0,3,74,28,2,7,2.224411074,12230,271,1,1090,1082,8,86928,85513,1415,527,522,5,2,99.99328949,NoArch
febff4afd2a71085fdba05dc08e857f8267216d3,3,214,2,212,2,0,2,1,2,37,1,2,1.068076192,173,6,0,42,15,27,1604,782,822,23,12,11,1,99.96645871,NoArch
a70355f44571036d7f99b3ca3cb240674bd1cf91,20,73,55,18,0,0,0,4,54,434,6,12,3.977788669,4386,111,3,393,393,0,28468,28457,11,203,203,0,1,99.96646996,NoArch
1d28d51d00c8ef88ebe75dc137c1d75c5f29166e,1,1,1,0,0,0,0,4,5,377,1,1,0,36,12,0,1,1,0,96,77,19,1,1,0,1,100,NoArch
6593e8ba9d9ecb9ece628005810e47631bc65ead,0,0,0,0,0,0,0,0,0,0,0,0,0,0,293,2,0,0,0,0,0,0,0,0,0,0,100,NoArch
c18d6153e105ac34fb410c60ce8a153327931782,33,1881,72,1809,13,0,13,1,149,246,3,18,4.568157869,7137,35,0,959,828,131,46201,37266,8935,670,598,72,1,94.00516012,Arch
811dcc591cd2d195b439d91050b491b5abda2b10,0,0,0,0,0,0,0,0,0,0,0,0,0,0,112,4,0,0,0,0,0,0,0,0,0,0,100,NoArch
8917971e9f7835e6b88445f58c127e94be403b25,1,2,1,1,0,0,0,5,7,121,1,1,0,169,28,2,9,9,0,1170,1157,13,6,6,0,1,100,NoArch
4f6b831ea11d8a99e828b4cb37dd770f8075dd43,1,6,0,6,0,0,0,11,14,12,1,1,0,400,0,0,35,34,1,2886,2827,59,16,16,0,1,100,NoArch
fc1831b22c3f8700bb90ebe97d5c9b1cb2b7cbda,1,6,4,2,0,0,0,6,7,140,1,1,0,590,113,5,71,71,0,3383,3375,8,37,37,0,0,100,NoArch
5e3ca8343668e09b37fc913981edd0761fa59359,0,0,0,0,0,0,0,0,0,0,0,0,0,0,114,6,0,0,0,0,0,0,0,0,0,0,100,NoArch
146f39d49e53eeef40bddd657b9ab11e217f3bc3,10,85,67,18,0,0,0,3,83,17,2,9,2.252819007,7976,272,2,851,850,1,52405,52443,38,529,527,2,1,100,NoArch
d439fab2421a4484a38f1ad69fa95bd2a4fb275f,0,0,0,0,0,0,0,0,0,0,0,0,0,0,57,1,0,0,0,0,0,0,0,0,0,1,100,NoArch
2fc20c186b77017f7f1c6f6abe8559a9e8cfe578,21,381,222,159,1,1,2,3,150,262,4,8,3.723762912,7692,273,3,947,926,21,45942,45635,307,688,693,5,1,95.33232628,Arch
25afb357df9fda99a3bebb51417e622c64a1afa2,1,14,3,11,0,0,0,25,35,124,1,1,0,411,111,2,58,56,2,2745,2605,140,12,12,0,1,100,NoArch
20969c2605939a8d6c9d74fb2be7d5a2875bac8c,2,12,8,4,0,0,0,7,12,121,1,2,0.970950594,283,115,7,31,31,0,1815,1808,7,7,7,0,1,100,NoArch
26b719a7fbafdfee480f07a143975f3e85adb3b2,5,397,30,367,2,0,2,1,14,562,2,5,1.715013297,379,58,2,93,42,51,4311,1803,2508,48,27,21,1,99.96675753,NoArch
1769ff8fb90733d16d17d9a1a8f77a1bae760559,0,0,0,0,0,0,0,0,0,0,0,0,0,0,116,8,0,0,0,0,0,0,0,0,0,1,100,NoArch
a79f80937550a1e7164b197d46ce012ed4c4831b,5,20,19,1,0,0,0,20,75,47,2,5,1.884833685,6778,29,3,572,572,0,47588,47613,25,240,240,0,1,99.96676858,NoArch
65044d38fbefc6af644be02197bb8b1911746202,3,118,26,92,0,0,0,24,38,87,1,3,1.231527283,3295,0,0,163,155,8,25323,24660,663,83,79,4,1,100,NoArch
f49b5d3434285f6670f1d1c8d6204d5e975bd73f,1,59,5,54,0,0,0,9,10,1,1,1,0,141,30,4,19,11,8,1009,648,361,9,7,2,1,100,NoArch
2f22b07385fb62cdab02b68be8cf746f74c79ea7,5,32,20,12,0,0,0,11,45,68,2,3,2.010615829,2022,137,3,191,189,2,11786,11752,34,95,95,0,1,100,NoArch
c95abd3213f4806f535c6d7cb8b346616c3368fb,20,77,600,523,0,2,2,4,151,0,4,8,3.290777457,7851,112,3,865,947,82,42708,45942,3234,662,688,26,2,95.39448849,Arch
8c640b51331a031dbebabd41dcdf4bdf327cb181,0,0,0,0,0,0,0,0,0,0,0,0,0,0,13,1,0,0,0,0,0,0,0,0,0,1,100,NoArch
31b02d1798ed88c9b63e89cc9283cc1c4ac3546f,22,187,106,81,1,0,1,1,81,28,3,14,3.846038415,4240,17,1,529,523,6,22794,22352,442,328,323,5,1,99.59923332,NoArch
e00ee2d88e2def54e455547a2d243909334c6e86,1,6,2,4,0,0,0,2,3,0,1,1,0,111,59,3,10,10,0,415,395,20,10,10,0,1,100,NoArch
7e35874c7ba68dfa32b3b27ece35112cc434a7c6,7,33,33,0,0,0,0,2,152,0,3,7,2.261597334,4883,138,3,590,590,0,24439,24439,0,478,478,0,1,100,NoArch
d4dcb3d1190261687ee4f46ba7a2e89d8424aafb,9,39,5,34,0,0,0,4,153,154,3,6,2.858398165,6086,139,4,670,670,0,27431,27261,170,590,590,0,1,100,NoArch
3a08bdc3f971b3534e8fb6f34772340cfdf055a9,13,120,40,80,1,0,1,8,154,157,1,5,2.981953838,4111,117,9,518,512,6,20668,20364,304,445,439,6,1,91.65778441,Arch
2e59c8e6b9de48b904f1c37bb185841a1f09ff33,0,0,0,0,0,0,0,0,0,0,0,0,0,0,140,5,0,0,0,0,0,0,0,0,0,0,100,NoArch
98643c630560604029513c37d65227f0ca204f53,4,69,1,68,0,0,0,2,44,352,1,3,1.119567702,1853,6,0,156,153,3,13307,12747,560,68,66,2,1,100,NoArch
45da30dc3ecfd4e7315d8f33d95504a5ac7cbd1a,10,458,49,409,1,0,1,2,48,312,3,7,2.383375604,3860,141,6,368,338,30,26002,23359,2643,226,210,16,1,98.12680933,NoArch
897d78401a2a3ca3082604e08ce3022d58b55007,0,0,0,0,0,0,0,0,0,0,0,0,0,0,142,7,0,0,0,0,0,0,0,0,0,0,100,NoArch
