CommitID,NMF,TotalAddLines,TotalDeleteLines,LC,FileAdd,FileDelete,NAD,NDVE,NUC,AGE,NMS,NMD,Entropy ,MLMF,EXP,REXP,CommitComplexity,LastCommitComplexity,CFC,CommitTokenCount,LastCommitTokenCount,NCC,CommitMethodNum,LastCommitMethodNum,NMC,NIR,a2a,Tag
f91e9e63e136ea558bc5c5fdfd97641dcbbc6813,7,88,22,66,0,0,0,21,36,20,2,6,2.375626628,6015,199,13,705,695,10,47229,46694,535,334,330,4,1,100.0,NoArch
cd35b2777a4c49bcd2c52d40ad4d9e6548add14c,9,63,40,23,0,0,0,9,31,81,2,4,2.208936703,3791,168,5,349,346,3,23419,23364,55,215,211,4,1,100.0,NoArch
9412281cb14b1eabf9a23a3484e752a2636f2445,0,0,0,0,0,0,0,0,0,0,0,0,0.0,0,26,0,0,0,0,0,0,0,0,0,0,1,100.0,NoArch
3f4966ddeaef02ee95a5e873387dad0c81c14fb6,0,0,0,0,0,0,0,0,0,0,0,0,0.0,0,3,0,0,0,0,0,0,0,0,0,0,0,100.0,NoArch
57668d02a0aa723dd4b2245dc7659fe18113eb59,9,348,74,274,0,0,0,1,53,152,1,8,2.610234193,3553,102,6,280,251,29,22144,20555,1589,149,134,15,1,100.0,NoArch
4dfdd45784c90250e74e0c0477176b2b85cfaac6,0,0,0,0,0,0,0,0,0,0,0,0,0.0,0,107,17,0,0,0,0,0,0,0,0,0,0,100.0,NoArch
b6fde073961b8ddb5a2175f8ed0d6ea59e5798a4,2,12,0,12,0,0,0,6,18,24,1,2,0.650022422,2659,126,15,190,190,0,20420,20282,138,108,108,0,0,100.0,NoArch
c05a4e7b6fd5ea4b4c161b7698173f991dd8ed21,0,0,0,0,0,0,0,0,0,0,0,0,0.0,0,59,12,0,0,0,0,0,0,0,0,0,1,100.0,NoArch
d5f202821b11659693a2e934d4b8f4c99f19755e,23,270,43,227,2,0,2,29,58,253,3,8,3.021218621,3987,41,3,482,446,36,22549,21188,1361,227,217,10,0,99.93587688,NoArch
ff403c82d8a64569669e6371d4b8e85cba0c0656,1,4,3,1,0,0,0,6,11,182,1,1,0.0,234,290,2,31,30,1,1082,1079,3,18,18,0,1,100.0,NoArch
03a83ffeb5c5ee1f2efccc32f8c927d435185c9b,0,0,0,0,0,0,0,0,0,0,0,0,0.0,0,14,4,0,0,0,0,0,0,0,0,0,1,100.0,NoArch
929eca43fe8fb9cac6eedd50656a6616616d0b11,3,45,1,44,0,0,0,6,17,168,1,3,1.034023831,1362,4,0,128,126,2,9793,9515,278,61,59,2,1,100.0,NoArch
abc0175cf7a3577ac5078f6a4cd43569105ccf7e,0,0,0,0,0,0,0,0,0,0,0,0,0.0,0,14,4,0,0,0,0,0,0,0,0,0,1,100.0,NoArch
20871a17b2ec2b0998b80d941bac51434b0854d5,1,1,1,0,0,0,0,5,5,82,1,1,0.0,217,0,0,36,36,0,1248,1260,12,26,26,0,1,100.0,NoArch
38e75ea80681111f0b5cac753d738ce7a39bf6ac,0,0,0,0,0,0,0,0,0,0,0,0,0.0,0,107,17,0,0,0,0,0,0,0,0,0,0,100.0,NoArch
cf837b49008fd351a3f89beb5e4e5c17c30b9a3c,4,26,25,1,0,0,0,5,120,184,2,3,0.514274832,3216,65,1,432,432,0,14209,14209,0,391,391,0,1,99.97042295,NoArch
f1f8a1abb7636b43463ee86bf6db453ddb1256e1,1,3,0,3,0,0,0,20,38,36,1,1,0.0,464,210,4,57,57,0,2771,2765,6,24,24,0,1,100.0,NoArch
e484e91807caeda5afd905b649c97902ec0cdde5,2,13,2,11,0,0,0,6,30,55,1,2,0.566509507,1220,11,2,137,135,2,6859,6788,71,90,88,2,0,100.0,NoArch
a5257d1606df5dcc2b53663c2fe5c722ade12407,0,0,0,0,0,0,0,0,0,0,0,0,0.0,0,0,0,0,0,0,0,0,0,0,0,0,1,100.0,NoArch
85b2612bbe82121325d2faa085b4767a06ea8053,1,2,0,2,0,0,0,2,2,107,1,1,0.0,239,79,4,33,33,0,1771,1763,8,15,15,0,1,100.0,NoArch
f750773109abd78f5f1b41bb31b27711a7201126,2,37,6,31,0,0,0,16,27,106,1,2,0.99648599,1406,291,3,204,198,6,9178,8994,184,83,82,1,1,100.0,NoArch
31b57a256fcda477f7fda7a34c8d50b0255de6b2,0,0,0,0,0,0,0,0,0,0,0,0,0.0,0,19,5,0,0,0,0,0,0,0,0,0,1,100.0,NoArch
78fd12259404cad8117862fdf0b948cbe115e453,2,4,4,0,0,0,0,3,3,91,1,2,0.543564443,1469,2,0,100,99,1,10488,10446,42,50,50,0,1,100.0,NoArch
fcc497eff11f128b2c1feaa5ced6c340b6b41849,3,39,3,36,0,0,0,6,9,81,1,3,1.503889287,908,4,0,100,95,5,5338,5202,136,45,43,2,1,100.0,NoArch
62a1ad8b3a2a3c1dabba0a4622117636920b6c13,7,73,9,64,0,0,0,5,31,60,2,6,2.737351145,2858,38,4,395,387,8,16269,15860,409,311,308,3,1,100.0,NoArch
037f89ee7c823b2b45befd9706fadfae6e21e5c1,7,126,19,107,0,0,0,1,41,49,2,7,2.184470123,2893,32,0,392,379,13,20748,20030,718,134,130,4,2,100.0,NoArch
a298bd7d399e95974f4a1be20c70ab378840e2e7,0,0,0,0,0,0,0,0,0,0,0,0,0.0,0,3,0,0,0,0,0,0,0,0,0,0,1,100.0,NoArch
06bdba3cef187d4b7ca906dc7012b880bbc7fe93,0,0,0,0,0,0,0,0,0,0,0,0,0.0,0,30,0,0,0,0,0,0,0,0,0,0,0,100.0,NoArch
7895a3586e19a7f66fc2a400c90d8334f255d943,0,0,0,0,0,0,0,0,0,0,0,0,0.0,0,75,0,0,0,0,0,0,0,0,0,0,0,100.0,NoArch
6ec039ba4202bcb881044189f52210430a7d33b8,0,0,0,0,0,0,0,0,0,0,0,0,0.0,0,2,0,0,0,0,0,0,0,0,0,0,0,100.0,NoArch
3a776f6eb2793b31ca4a76fbbe59e205b83ab75b,0,0,0,0,0,0,0,0,0,0,0,0,0.0,0,26,0,0,0,0,0,0,0,0,0,0,1,100.0,NoArch
55dca969f9d25ea352dc0e343ef1f1e8539630fd,2,14,0,14,0,0,0,5,71,242,1,2,0.591672779,864,3,1,21,21,0,4374,4290,84,13,13,0,1,100.0,NoArch
fb084e0d93c4217f668614eb06eed9bdcf009278,0,0,0,0,0,0,0,0,0,0,0,0,0.0,0,121,10,0,0,0,0,0,0,0,0,0,0,100.0,NoArch
41bea2fec54ae6c2376f5c88bd5a524b60b74a11,3,54,1,53,0,0,0,2,3,1041,1,2,1.241754962,211,11,0,24,13,11,1388,947,441,9,7,2,1,100.0,NoArch
f7b6b680632115da7eb63eceadf95bd99f02d355,1,20,20,0,0,0,0,5,5,158,1,1,0.0,638,3,2,21,21,0,5098,5098,0,17,17,0,0,100.0,NoArch
79b896f071c73a29f7af22e2f5328bd42746fadb,1,2,1,1,0,0,0,6,23,51,1,1,0.0,254,104,6,24,23,1,1332,1322,10,13,13,0,1,100.0,NoArch
3c803421e0e138c223c9bec90f9b7c8a6751317d,1,4,4,0,0,0,0,9,13,0,1,1,0.0,321,6,1,17,17,0,1491,1491,0,17,17,0,0,100.0,NoArch
51b578316102a42cd71f042425f14b4cc0689e6a,0,0,0,0,0,0,0,0,0,0,0,0,0.0,0,38,0,0,0,0,0,0,0,0,0,0,1,100.0,NoArch
a5257d1606df5dcc2b53663c2fe5c722ade12407,0,0,0,0,0,0,0,0,0,0,0,0,0.0,0,0,0,0,0,0,0,0,0,0,0,0,1,100.0,NoArch
23f2ef3efbea5e9a686bac195cdf97605f20d91d,1,0,118,118,0,1,1,7,12,914,1,1,0.0,118,22,4,0,11,11,0,681,681,0,3,3,1,99.96920234,NoArch
fcc497eff11f128b2c1feaa5ced6c340b6b41849,3,39,3,36,0,0,0,6,9,81,1,3,1.503889287,908,4,0,100,95,5,5338,5202,136,45,43,2,1,100.0,NoArch
af5ef4d49d9c7eb610c446d8058216f39bb2fcfa,2,40,22,18,0,0,0,2,12,129,1,2,0.740865686,330,3,1,20,20,0,2101,1972,129,10,9,1,1,100.0,NoArch
61a03bc072c8d446a7334fdf7a284fca0a91f8c0,0,0,0,0,0,0,0,0,0,0,0,0,0.0,0,0,0,0,0,0,0,0,0,0,0,0,0,100.0,NoArch
8c3001363d80b29733470221c192a72f541381c5,44,427,208,219,1,0,1,10,22,56,8,29,4.574029071,13349,15,1,1256,1226,30,86554,85810,744,686,671,15,1,99.78670459,NoArch
673d62f3c3ab07abb3fcd319607e657339bc0682,2,3,0,3,0,0,0,7,10,2,1,2,0.918295834,143,0,0,8,8,0,584,567,17,6,6,0,0,100.0,NoArch
6a3ce928b16d4060b5af94f4c92802da9510406b,0,0,0,0,0,0,0,0,0,0,0,0,0.0,0,1,0,0,0,0,0,0,0,0,0,0,1,100.0,NoArch
b18c32379ff167c8338b8d18e1f88bb88eb07618,0,0,0,0,0,0,0,0,0,0,0,0,0.0,0,0,0,0,0,0,0,0,0,0,0,0,1,100.0,NoArch
d03c8f9c155295d40d90f48bcba250945689a94a,1,1,1,0,0,0,0,2,3,6,1,1,0.0,2540,56,0,230,230,0,20088,20092,4,140,140,0,0,100.0,NoArch
e4ea7a2971ce20d89a46556e19f2ad22014d9123,1,1,1,0,0,0,0,8,15,0,1,1,0.0,546,26,9,71,71,0,3116,3116,0,44,44,0,0,100.0,NoArch
0f39137ba854a2f808e2108c6aa10f4260b00844,2,7,2,5,0,0,0,3,22,47,2,2,0.918295834,742,101,6,89,89,0,3459,3437,22,45,45,0,1,100.0,NoArch
c647af536e08a289537512b97a74bd1ba3ede0e6,1,10,5,5,0,0,0,2,2,60,1,1,0.0,152,242,4,21,21,0,898,875,23,9,9,0,1,100.0,NoArch
f97dd25d41816f51f4c233d69456dd9892b201b5,2,20,0,20,0,0,0,2,15,44,2,2,0.468995594,840,6,5,59,58,1,4880,4695,185,26,25,1,1,100.0,NoArch
b9fbada2f2974f516e9541359892b905af19710e,2,20,12,8,0,0,0,1,19,22,2,2,0.811278124,462,197,8,31,30,1,3034,3022,12,20,20,0,0,100.0,NoArch
a1483f2c5f3b921d1117d31f75453e45e5717259,11,48,27,21,0,0,0,1,39,20,3,8,3.236265308,5709,66,11,454,453,1,39840,39686,154,223,223,0,1,100.0,NoArch
b686c07407bc4d84f7fb181628d373f35ff9f1de,10,185,94,91,0,0,0,1,45,186,2,9,2.614179358,4979,36,3,609,606,3,33314,32403,911,223,221,2,1,99.7476606,NoArch
5a0d3f1cf963e0061364d915ac86a465dd079bac,2,48,28,20,0,0,0,3,6,92,1,2,0.926819064,441,15,1,42,34,8,2910,2683,227,30,30,0,1,100.0,NoArch
cc4aa45ae28bbd4135d1c65f38a2dcd5de749418,2,3,0,3,0,0,0,5,5,493,1,2,0.918295834,123,0,0,9,9,0,442,425,17,6,6,0,1,100.0,NoArch
71a2ae0fd6163d3108c6557ce6295f649246adcb,4,25,11,14,0,0,0,6,44,29,1,4,1.563027603,1766,146,9,113,110,3,10380,10298,82,83,81,2,1,100.0,NoArch
9a05940a74c7258e6ca9810473e4beeb4d43dcd7,24,239,138,101,0,0,0,2,57,49,5,16,3.522163189,13265,39,2,914,901,13,104139,103770,369,472,471,1,1,99.96559791,NoArch
329da34ee0f8d935fa7ec1853104addfb5b45400,1,1,1,0,0,0,0,11,27,17,1,1,0.0,1707,217,11,205,205,0,9555,9555,0,91,91,0,1,100.0,NoArch
3b36cb805d066a3112e3a355ef502dbe4b2c1824,8,126,87,39,0,0,0,3,18,156,3,7,1.572673885,3072,32,2,264,256,8,18109,18001,108,142,141,1,1,100.0,NoArch
0894b26511b7e56e909a19ef7c9ba56c81482a08,5,76,37,39,0,0,0,16,59,288,2,4,2.148505519,3774,1,0,411,410,1,24933,24747,186,214,211,3,1,100.0,NoArch
359fbfde798b50edc06ee1d0520efcd971a289bc,12,786,9,777,4,0,4,11,95,81,3,10,2.326275811,5270,13,5,769,671,98,33820,29266,4554,566,488,78,1,99.93815708,NoArch
6de9f5d9e5cb1f82d7c32d04b114e7d4a181619b,10,138,99,39,3,1,4,3,5,44,1,5,2.671716056,1008,3,0,83,85,2,5992,5896,96,43,43,0,1,99.00332226,NoArch
b7586a563253082a00d62ac81e3b5acbb378472a,9,20,46,26,0,0,0,5,47,0,2,7,2.856958077,3224,92,8,203,206,3,19212,19374,162,104,107,3,1,100.0,NoArch
99dd1cb6e63600681aa11b3a03bc16d1401d8055,1,85,1,84,0,0,0,8,10,59,1,1,0.0,482,38,2,29,26,3,4471,3869,602,16,15,1,1,100.0,NoArch
2126f13e130ea0394bb395aa38bc6df4052576e6,3,28,34,6,0,0,0,6,47,93,1,2,0.482750854,2208,8,3,206,208,2,14725,14614,111,103,105,2,1,100.0,NoArch
c4bc06cc9896a314fbb5a5c3ab7431a023bb8a3e,0,0,0,0,0,0,0,0,0,0,0,0,0.0,0,41,1,0,0,0,0,0,0,0,0,0,2,100.0,NoArch
40c80f6627956e4cdb7a931c40b7363e81272c58,23,475,656,181,1,2,3,4,47,26,5,16,3.370982143,9619,56,11,1072,1091,19,56552,57689,1137,393,406,13,1,99.89589659,NoArch
5ae34db76481d19932e0e250b1601f1a041ce709,1,14,18,4,0,0,0,3,4,1219,1,1,0.0,111,56,7,8,8,0,380,457,77,5,5,0,0,100.0,NoArch
76c2931275de5fb104a535742db6c60a5d7d0a4c,0,0,0,0,0,0,0,0,0,0,0,0,0.0,0,122,4,0,0,0,0,0,0,0,0,0,0,100.0,NoArch
57a8b9cc8c6a1526bd9e2174321a5b675d716943,2,10,6,4,0,0,0,6,16,84,2,2,0.811278124,709,11,0,63,64,1,4173,4163,10,30,30,0,0,100.0,NoArch
eca1091f4bebc20b33491d775eefc7e7f6296c3b,26,130,130,0,0,0,0,6,39,355,6,19,2.518842968,13052,0,0,1118,1118,0,98071,98071,0,613,613,0,1,100.0,NoArch
d2525c31b7dad7bae2d4899d8df2a353ca39af50,0,0,0,0,0,0,0,0,0,0,0,0,0.0,0,92,4,0,0,0,0,0,0,0,0,0,0,100.0,NoArch
b513232449a4d85648dfb4675c0bdb1073efbcf2,1,18,8,10,0,0,0,1,2,67,1,1,0.0,377,238,9,28,28,0,2210,2136,74,14,14,0,1,100.0,NoArch
fba5822ee34167b07e65eefc63d7e3d43abd9387,4,44,16,28,0,0,0,35,66,9,2,2,1.819055884,1238,40,2,157,149,8,6713,6532,181,52,51,1,1,100.0,NoArch
f14d4e65e7edab58aa86c495e4bd4caa79086d6b,1,1,1,0,0,0,0,17,24,16,1,1,0.0,717,7,0,59,59,0,3054,3055,1,37,37,0,1,100.0,NoArch
25385805aab3ff00ca9accc406d0f7b0cf2d9e55,0,0,0,0,0,0,0,0,0,0,0,0,0.0,0,14,4,0,0,0,0,0,0,0,0,0,1,100.0,NoArch
1e79cbc259b92f75e5fd387c0271b163532aebb9,0,0,0,0,0,0,0,0,0,0,0,0,0.0,0,9,0,0,0,0,0,0,0,0,0,0,1,100.0,NoArch
d4d665ecb1d5aaef45ac5ad2bb691d4c9af6f7be,1,4,3,1,0,0,0,14,23,24,1,1,0.0,202,122,11,23,23,0,1231,1240,9,10,10,0,1,100.0,NoArch
84064a9b081c246f306855ae125f0dae5eb8f6d0,4,99,32,67,0,0,0,35,111,16,2,4,1.379525249,4350,192,11,587,583,4,23014,22521,493,423,420,3,1,100.0,NoArch
0a200c32e5043eca194c0dc287ba7114067c1851,0,0,0,0,0,0,0,0,0,0,0,0,0.0,0,31,1,0,0,0,0,0,0,0,0,0,0,100.0,NoArch
f6e7227ed548ea5bac66e224df42e2985fb814a9,1,3,1,2,0,0,0,19,29,7,1,1,0.0,407,91,2,47,46,1,2736,2728,8,30,30,0,0,100.0,NoArch
cf20c95f48d3344b7e07e6dcc6c5219ffa063e4b,2,2,2,0,0,0,0,4,47,1333,1,2,1.0,1708,0,0,161,161,0,8050,8050,0,95,95,0,0,100.0,NoArch
94f45e928c917c87934badb2bb4bc8c767a14e3a,7,169,62,107,0,0,0,1,7,119,1,4,1.96650748,1240,18,8,135,118,17,7035,6331,704,68,63,5,1,100.0,NoArch
83e411e21bc51d081955a0716157e5e2e6593926,0,0,0,0,0,0,0,0,0,0,0,0,0.0,0,122,14,0,0,0,0,0,0,0,0,0,1,100.0,NoArch
7d163ee3de1df456d1b01dabaf4fd9ec0e0c185b,1,7,10,3,0,0,0,11,16,0,1,1,0.0,481,33,4,35,35,0,3484,3487,3,27,27,0,0,100.0,NoArch
e23967b9e9fcc95dbe71369098c8d12cba90eb95,0,0,0,0,0,0,0,0,0,0,0,0,0.0,0,37,5,0,0,0,0,0,0,0,0,0,1,100.0,NoArch
6b5abb5d92043b5360d4059280a1f39e35974eae,0,0,0,0,0,0,0,0,0,0,0,0,0.0,0,0,0,0,0,0,0,0,0,0,0,0,0,100.0,NoArch
f27c7a16c6d437efaa83e50a7117b83e5201ac49,8,286,28,258,1,0,1,2,16,57,4,6,2.182838382,3014,1,1,232,213,19,22391,21137,1254,137,124,13,1,99.87234043,NoArch
274325a8ec9a3d715a150b91eba65eea274fdff4,2,97,31,66,0,0,0,3,5,274,1,2,0.995592754,452,2,2,31,27,4,3298,2719,579,27,24,3,1,100.0,NoArch
4081e99254a6a95f7dc367f503addf1a28bf6249,10,368,447,79,1,1,2,15,22,24,2,6,2.446819435,2837,79,14,248,260,12,19291,20030,739,99,107,8,0,99.8959327,NoArch
78eb53df30f09ca25664d71a13f776211b05a17b,1,18,0,18,0,0,0,2,2,51,1,1,0.0,27,22,4,3,3,0,97,97,0,2,2,0,0,100.0,NoArch
55777fec0519c1aa26a4bd4415d545b658dfec29,6,75,2,73,0,0,0,3,99,255,1,4,1.725204536,4288,1,0,430,423,7,29991,29472,519,203,198,5,1,100.0,NoArch
6f5d8d04cd4b6689335bb80738946e1a914b43b0,18,150,103,47,0,0,0,20,87,87,6,11,3.432178659,7990,6,5,828,828,0,52338,52206,132,387,385,2,1,100.0,NoArch
0d8ca8da4e0f6651bc1f06dba5e7e37881225fdc,3,166,0,166,1,0,1,1,8,82,1,3,1.49361106,400,5,1,60,40,20,2896,1974,922,42,30,12,1,99.94674619,NoArch
d886e9eb8df9d74d2b8a00a98e851704af183364,0,0,0,0,0,0,0,0,0,0,0,0,0.0,0,201,8,0,0,0,0,0,0,0,0,0,0,100.0,NoArch
a0df6ecfb47ac9e393b5eb977850cb8fbe7d3f72,5,105,56,49,1,0,1,7,30,169,2,5,1.721880165,1056,15,0,125,126,1,7711,7396,315,85,84,1,1,99.96291833,NoArch
48797b1ae1bf3ad08908d43e3fdc5824e3d79eee,3,16,2,14,0,0,0,6,40,729,1,2,1.41526895,802,1,1,114,112,2,4027,3949,78,113,111,2,0,100.0,NoArch
04834817c89ef22cc71362702b675548e637b603,0,0,0,0,0,0,0,0,0,0,0,0,0.0,0,7,0,0,0,0,0,0,0,0,0,0,0,100.0,NoArch
6875fe43d02f74777726dfce0a332b176667eef2,1,3,0,3,0,0,0,6,11,35,1,1,0.0,118,1,0,6,5,1,1182,1144,38,4,4,0,1,100.0,NoArch
92ca426ab7ef54c8ce928f770783f4f83510d8ae,0,0,0,0,0,0,0,0,0,0,0,0,0.0,0,8,2,0,0,0,0,0,0,0,0,0,1,100.0,NoArch
d424fe6072ef74e1e2bdb290aa584bff9eca113f,2,7,3,4,0,0,0,2,16,3,1,1,0.721928095,613,73,6,56,56,0,4216,4174,42,30,30,0,1,100.0,NoArch
ae656c5d40db34bcc2cc20eab8569437b0a284e1,1,1,1,0,0,0,0,7,7,436,1,1,0.0,83,3,1,6,6,0,387,387,0,5,5,0,1,100.0,NoArch
1072f2748a3e6802b0c1c9492edf7573779645ac,1,3,3,0,0,0,0,6,7,35,1,1,0.0,352,0,0,43,43,0,1406,1402,4,25,25,0,1,100.0,NoArch
d90fd1f68c882c2e98aaa5b648e814bf4dac0515,0,0,0,0,0,0,0,0,0,0,0,0,0.0,0,94,0,0,0,0,0,0,0,0,0,0,0,100.0,NoArch
6df14f15a3761580085d38bffceca9d19c7ad24e,17,350,62,288,1,0,1,1,52,144,3,10,2.894779388,6078,198,9,540,511,29,39671,37909,1762,291,273,18,1,99.91091755,NoArch
a43cfec9b2e3452990f9474d7925511c7afea75d,2,7,4,3,0,0,0,2,3,1215,1,2,0.994030211,288,0,0,19,19,0,1169,1152,17,10,10,0,1,100.0,NoArch
a06556334f8bbdf1f12be698070d128bf6716e0e,1,5,2,3,0,0,0,24,35,100,1,1,0.0,196,10,0,9,9,0,1348,1322,26,8,8,0,1,100.0,NoArch
ca427240c026bc6ba6e19b9b8b0a069a6330147a,0,0,0,0,0,0,0,0,0,0,0,0,0.0,0,8,2,0,0,0,0,0,0,0,0,0,0,100.0,NoArch
93fe5a497e8f2f97d90f3dd66d966f9f4cc24bc9,2,20,23,3,0,0,0,2,5,44,1,2,0.693127415,1076,8,0,123,123,0,5683,5661,22,62,62,0,1,100.0,NoArch
1bb017d396562b891065187bac417c52edea24da,0,0,0,0,0,0,0,0,0,0,0,0,0.0,0,0,0,0,0,0,0,0,0,0,0,0,1,100.0,NoArch
b4b23e401bb66793c924dfe5b78d641c65e207a6,3,9,0,9,0,0,0,5,20,308,1,2,1.435520504,1042,7,0,92,92,0,9317,9168,149,55,55,0,1,100.0,NoArch
96a46d870122914dd7cc1f9f20a5489b8fe03187,0,0,0,0,0,0,0,0,0,0,0,0,0.0,0,98,10,0,0,0,0,0,0,0,0,0,1,100.0,NoArch
51ea27d665d8053895dd047ca85e3338b357a81d,25,1209,133,1076,8,0,8,5,45,0,2,9,3.103545903,4296,3,0,599,493,106,32357,25897,6460,235,188,47,1,98.18659031,NoArch
9bde6d616c5ee2ef131037af5b5527a0717cc527,11,171,0,171,3,0,3,5,12,233,4,8,2.911708825,617,64,1,34,34,0,2754,2080,674,21,21,0,1,99.45498587,NoArch
7173d1338abaf2a880bdb86e9c650065d7b0bf14,0,0,0,0,0,0,0,0,0,0,0,0,0.0,0,36,2,0,0,0,0,0,0,0,0,0,1,100.0,NoArch
e9efbdb63c95d2971ac67576783e122a6e271738,2,1,4,3,0,0,0,15,72,7,1,2,0.970950594,1248,157,13,72,72,0,6652,6687,35,39,39,0,1,100.0,NoArch
28ccf8c5216eaedf16b16b0220f03311fcba6787,2,28,1,27,1,0,1,1,8,36,1,2,0.362051252,347,33,14,46,43,3,2309,2212,97,18,16,2,1,99.84550019,NoArch
fcedbfcb58109f6af0b0a1e69915b40a0fcd5ccb,1,0,1,1,0,0,0,2,2,337,1,1,0.0,242,6,0,28,28,0,966,971,5,17,17,0,0,100.0,NoArch
5a8fab6d63b4beaebb4b3ff8a9b9ba7893dbdc7c,5,16,5,11,0,0,0,5,12,350,2,5,2.035939163,636,261,15,64,63,1,3976,3906,70,48,47,1,0,100.0,NoArch
eafd7bf289f901edfedc350beec30fa3cc09bb85,6,17,17,0,0,0,0,2,2,24,1,5,1.853688226,1191,14,2,84,84,0,5117,5117,0,48,48,0,0,100.0,NoArch
fc1685e7d3cfbc18ef28f45d478c2b6eaf245d94,0,0,0,0,0,0,0,0,0,0,0,0,0.0,0,81,5,0,0,0,0,0,0,0,0,0,1,100.0,NoArch
e3675fe9b014f0d6c24caeaa23578a54e194e92c,8,57,19,38,0,0,0,1,66,99,3,8,2.238904815,4360,234,7,401,397,4,24443,24285,158,198,196,2,1,100.0,NoArch
49ed03fc8c3543c0540ac3de0519dd478991e6fb,1,45,30,15,0,0,0,14,24,0,1,1,0.0,897,248,2,16,16,0,4452,4408,44,8,8,0,1,100.0,NoArch
e00a9042e9a4e97f6f8ccaed4ac51a9aa8c2da76,8,205,24,181,0,0,0,8,31,103,1,8,1.634141883,3990,139,4,330,309,21,30121,28800,1321,151,142,9,1,100.0,NoArch
6566fc6625072b76dd121f0b28ce7b1ef11b6259,0,0,0,0,0,0,0,0,0,0,0,0,0.0,0,5,3,0,0,0,0,0,0,0,0,0,1,100.0,NoArch
5d717a28f45137bea71dffa31b0ae7ccbf1bda00,2,3,0,3,0,0,0,7,7,39,1,2,0.918295834,125,0,0,9,9,0,455,438,17,6,6,0,1,100.0,NoArch
e217db56ab30ec9630411aefc16516747b3112e0,0,0,0,0,0,0,0,0,0,0,0,0,0.0,0,91,2,0,0,0,0,0,0,0,0,0,1,100.0,NoArch
09dc001430dab2fef1d36d463538cfe403606e22,0,0,0,0,0,0,0,0,0,0,0,0,0.0,0,6,2,0,0,0,0,0,0,0,0,0,1,100.0,NoArch
23c9c5c2962e1ac053cb4395fa148b9015272990,12,48,62,14,0,0,0,3,62,146,3,11,2.989759892,9144,4,1,775,776,1,59969,60080,111,324,325,1,1,100.0,NoArch
506447fd4fde4cd922f7aa8f4e17a7f06666dc97,3,85,48,37,0,0,0,3,11,5,2,3,1.050618104,1826,135,0,136,131,5,12418,12400,18,64,61,3,1,100.0,NoArch
c0c0095fa96636d620c5ff428610d75aee902d74,0,0,0,0,0,0,0,0,0,0,0,0,0.0,0,12,0,0,0,0,0,0,0,0,0,0,0,100.0,NoArch
c1810f210e34a72c16ce2fa5a7efb61f717e83b0,1,1,1,0,0,0,0,3,3,573,1,1,0.0,86,2,1,10,10,0,384,384,0,5,5,0,0,100.0,NoArch
3cfb52c413b49840f17d00e2ee6be7d4224a0ac1,5,88,15,73,0,0,0,2,52,420,1,5,1.707604739,2354,2,2,187,181,6,14074,13629,445,130,124,6,0,100.0,NoArch
445208a0d20b457daeeb5f70995302c92dd19f31,3,205,59,146,0,0,0,12,19,861,1,2,0.772931068,400,17,9,54,40,14,3789,2530,1259,20,17,3,1,100.0,NoArch
f20acb8dc35f7107301b103140f28b92cc7b4983,0,0,0,0,0,0,0,0,0,0,0,0,0.0,0,4,0,0,0,0,0,0,0,0,0,0,1,100.0,NoArch
ff688107fa99742cccaa0a80075f58efb017ebab,0,0,0,0,0,0,0,0,0,0,0,0,0.0,0,5,4,0,0,0,0,0,0,0,0,0,0,100.0,NoArch
bc4966ea7353016c7589ef750719e400024e09e0,2,38,0,38,0,0,0,4,16,92,1,2,0.398459274,551,14,1,56,52,4,4195,3823,372,33,32,1,1,99.9822695,NoArch
06240417e9393de223c9cf6e1b66858d0417768e,2,57,4,53,0,0,0,11,25,206,1,2,0.912734156,2615,8,0,197,192,5,20648,20253,395,98,97,1,1,100.0,NoArch
ba70ceda35c095f82bb16b3b7aa048eea0608d63,2,10,20,10,0,0,0,8,9,254,1,1,0.987137774,236,3,0,19,19,0,1134,1144,10,9,9,0,1,100.0,NoArch
d9411c38dbe6684ed2b0b59b27fbb1a46ac16c34,4,219,0,219,3,0,3,1,1,0,1,4,1.539466518,74,14,0,24,8,16,1480,301,1179,20,4,16,1,98.34127741,NoArch
88067f57a23575aae3c371a7c7871e4207ca3bea,1,2,2,0,0,0,0,30,74,1,1,1,0.0,2217,21,3,299,299,0,9361,9361,0,293,293,0,1,100.0,NoArch
1d28d51d00c8ef88ebe75dc137c1d75c5f29166e,1,1,1,0,0,0,0,4,5,377,1,1,0.0,36,12,0,1,1,0,96,77,19,1,1,0,1,100.0,NoArch
e8fcf04b5709d795a1de086824b6eff462c8c835,3,17,12,5,0,0,0,1,9,27,1,3,1.537755967,1208,59,8,144,144,0,6254,6253,1,68,68,0,1,99.87868985,NoArch
7d02b1fd3c74abfbd118f69a10a8c106cc900a3e,2,1,4,3,0,0,0,48,109,617,2,2,0.970950594,1099,215,6,132,132,0,6875,6879,4,31,31,0,0,100.0,NoArch
4d1fba24c958c17652b693d22af378e6c2ceb749,3,294,3,291,1,0,1,1,15,39,1,3,0.433486786,683,0,0,80,63,17,5939,4126,1813,32,26,6,0,99.59774739,NoArch
caef3d5c58820ac5828fb74e5ac6aaae8c9e845f,2,76,121,45,0,1,1,4,10,190,2,2,0.977109456,495,86,1,25,34,9,3782,3759,23,11,15,4,1,99.95680812,NoArch
18cdad92068d299307a7ebd94703dab04b52690c,0,0,0,0,0,0,0,0,0,0,0,0,0.0,0,5,1,0,0,0,0,0,0,0,0,0,1,100.0,NoArch
1b61eb45e0643a76cfc949e61d2ddd51f7d7183e,2,18,4,14,0,0,0,9,50,34,1,2,0.976020648,1051,0,0,159,156,3,5879,5786,93,131,130,1,0,100.0,NoArch
58e25ba8563bb45b629fd534eb12423aeb948e6e,1,22,17,5,0,0,0,9,13,175,1,1,0.0,169,221,15,18,20,2,1054,1039,15,12,12,0,1,100.0,NoArch
a49e5ac7160a5937ebfe2f72deb36dc0ab119f2e,2,5,5,0,0,0,0,3,4,703,1,2,0.721928095,933,19,5,123,123,0,5574,5574,0,60,60,0,2,100.0,NoArch
91bb0d13184c57ec08f02db3337e734bc20739c4,50,257,257,0,0,0,0,6,76,40,7,25,4.86249743,16542,17,0,1507,1507,0,108288,108288,0,900,900,0,1,100.0,NoArch
aec5d11da2e8a025fb6c8659a648f9e2d36990d6,1,3,1,2,0,0,0,11,29,36,1,1,0.0,408,0,0,3,2,1,2754,2740,14,1,1,0,0,100.0,NoArch
e4fd195d9fd0cc1128b8c6797d88e56402b166bd,4,82,16,66,0,0,0,7,9,20,1,4,1.687679551,1812,5,3,188,179,9,12947,12535,412,87,79,8,0,99.91423671,NoArch
23f2ef3efbea5e9a686bac195cdf97605f20d91d,1,0,118,118,0,1,1,7,12,914,1,1,0.0,118,22,4,0,11,11,0,681,681,0,3,3,1,99.96920234,NoArch
6946dd75576cecceffdeb0bf06299f483ddeb444,39,253,332,79,0,0,0,2,59,264,5,22,3.781126339,10021,0,0,1037,1052,15,58148,58761,613,516,516,0,0,100.0,NoArch
784e3ad0b65ce8f7e0de2e2935032fb2573d5a26,134,1023,801,222,0,0,0,3,8,96,1,26,6.553225913,25205,4,3,2589,2589,0,141638,141638,0,1589,1589,0,1,100.0,NoArch
784e3ad0b65ce8f7e0de2e2935032fb2573d5a26,134,1023,801,222,0,0,0,3,8,96,1,26,6.553225913,25205,4,3,2589,2589,0,141638,141638,0,1589,1589,0,1,100.0,NoArch
227785c022939cd2ba153c2a4f7791ab3394c6c7,0,0,0,0,0,0,0,0,0,0,0,0,0.0,0,14,0,0,0,0,0,0,0,0,0,0,0,100.0,NoArch
06240417e9393de223c9cf6e1b66858d0417768e,2,57,4,53,0,0,0,11,25,206,1,2,0.912734156,2615,8,0,197,192,5,20648,20253,395,98,97,1,1,100.0,NoArch
fa419213f62d2006aeea228180302024977feb16,6,393,7,386,3,0,3,1,12,146,3,4,1.708540705,606,29,1,86,60,26,5855,3752,2103,45,33,12,1,99.63390594,NoArch
f3777f44fe3229e9582a03d5734a4580eaa8503a,15,6,40,34,0,0,0,2,22,236,2,9,3.108884766,2578,26,0,321,321,0,15011,15326,315,138,138,0,0,100.0,NoArch
ce45f7f129e4d83705fc6a2a3dc6cfd7414480e1,2,57,1,56,0,0,0,13,21,428,2,2,0.216396932,404,6,0,33,31,2,2777,2284,493,20,18,2,1,100.0,NoArch
93ee09fee879b922ff011e04dbbb54194fac481b,1,7,13,6,0,0,0,4,4,773,1,1,0.0,108,3,0,23,24,1,480,516,36,14,15,1,1,100.0,NoArch
ff94d92980816adc5a2feebe062835e083d8b8c6,3,63,57,6,0,0,0,5,20,8,1,3,1.128759989,3292,26,6,263,264,1,25066,24992,74,138,138,0,1,100.0,NoArch
37b086ffb9be7d0152ab133f63df16914a4fee73,2,21,1,20,0,0,0,2,7,358,1,2,0.574635698,306,31,3,47,44,3,1941,1843,98,33,31,2,1,100.0,NoArch
0bb506fa00de5c195c8e409c13091c2e264472d0,2,41,2,39,0,0,0,4,24,38,2,2,0.968164732,670,154,11,60,57,3,4515,4134,381,49,49,0,1,99.81842941,NoArch
c4e45a0010d3f13f84d90fbf417c4e5e6c547fda,9,235,38,197,2,0,2,4,44,5,2,7,2.043180342,2516,89,8,188,177,11,15381,14168,1213,107,100,7,1,99.93773904,NoArch
f30b3aef3e5e12e9119d6b5294c94a0282719e00,5,26,12,14,0,0,0,2,47,349,1,3,1.806759867,1155,0,0,129,128,1,8827,8761,66,41,40,1,0,100.0,NoArch
7fed7352bd506e20e5316bb0b3ed9e5c1e9c76df,4,48,13,35,0,0,0,8,28,172,2,3,1.286882853,1983,51,6,319,310,9,10822,10624,198,283,279,4,1,100.0,NoArch
92c69f57038d055e680f75627426e97679196ce0,0,0,0,0,0,0,0,0,0,0,0,0,0.0,0,2,0,0,0,0,0,0,0,0,0,0,0,100.0,NoArch
193215201cfff5f686a70d5054c0a3a3d91d25a6,1,1,1,0,0,0,0,3,6,53,1,1,0.0,268,1,1,25,25,0,1217,1217,0,15,15,0,0,100.0,NoArch
cf837b49008fd351a3f89beb5e4e5c17c30b9a3c,4,26,25,1,0,0,0,5,120,184,2,3,0.514274832,3216,65,1,432,432,0,14209,14209,0,391,391,0,1,99.97042295,NoArch
dd1bd62684fdd2115dcc4bad264493d25cc97858,5,176,0,176,1,0,1,12,40,88,2,4,2.075126504,3407,10,1,342,323,19,26064,24804,1260,215,203,12,1,99.96673043,NoArch
cbcbec4d3831d6236a2dbf1f17d50b447800994a,0,0,0,0,0,0,0,0,0,0,0,0,0.0,0,1,0,0,0,0,0,0,0,0,0,0,0,100.0,NoArch
b376cefc3e899aa28992796925708746561d6087,1,1,1,0,0,0,0,18,29,1,1,1,0.0,1583,37,3,262,262,0,7022,7022,0,256,256,0,0,100.0,NoArch
8fa8f2603199638e2467fba0db8948a84455213e,0,0,0,0,0,0,0,0,0,0,0,0,0.0,0,32,0,0,0,0,0,0,0,0,0,0,0,100.0,NoArch
01c868ab86e33161b03d422c03af41f01947ea06,1,1,1,0,0,0,0,9,12,2,1,1,0.0,371,51,4,32,32,0,3186,3186,0,11,11,0,1,100.0,NoArch
cf1dde03231b54cacecf53e0f9b8320eba4a7590,0,0,0,0,0,0,0,0,0,0,0,0,0.0,0,31,1,0,0,0,0,0,0,0,0,0,0,100.0,NoArch
0015c9b00e46bde88089680e790a7fb3ad12e5ef,0,0,0,0,0,0,0,0,0,0,0,0,0.0,0,66,1,0,0,0,0,0,0,0,0,0,0,100.0,NoArch
6b84384022f0ee6e709d215d66c07b718c4e8467,9,152,98,54,0,0,0,15,75,0,3,6,1.602568115,4821,9,5,448,438,10,36474,36206,268,283,280,3,0,99.96645984,NoArch
1e2be85a0f1b290fa568cfae68f4219ac2b5f210,0,0,0,0,0,0,0,0,0,0,0,0,0.0,0,1,1,0,0,0,0,0,0,0,0,0,1,100.0,NoArch
46deea05c402e986395875b35f8bdab6cd8bbda5,3,200,17,183,0,0,0,1,60,15,2,3,0.752377724,1665,60,4,185,176,9,12091,10485,1606,73,67,6,1,98.05833197,NoArch
7f079632a6420f118aca3d7befe2c1593d0640aa,19,55,49,6,0,0,0,4,23,83,5,16,3.968274177,8258,13,2,474,474,0,60134,60101,33,237,237,0,0,100.0,NoArch
7034d1a1be7ecefc346aea95a9ff30bdf758204a,2,2,2,0,0,0,0,7,22,11,2,2,1.0,1181,88,1,59,59,0,7705,7705,0,42,42,0,1,100.0,NoArch
994922a1593824744f93fd1408fcf1807cf4ebc1,2,4,3,1,0,0,0,5,8,48,1,2,0.863120569,644,8,2,41,41,0,5494,5494,0,18,18,0,1,100.0,NoArch
fc8d96246a1a97ac1e569a19e58aefbfc33706eb,1,18,16,2,0,0,0,7,8,15,1,1,0.0,470,1,0,55,54,1,3368,3394,26,21,20,1,1,100.0,NoArch
2fe7a3a41f36f0dcbbc89e4dbe51b70f2de997db,3,12,0,12,0,0,0,15,23,39,2,2,1.584962501,918,24,2,103,101,2,6055,5945,110,31,31,0,1,100.0,NoArch
74eb09be9b40a205365bf920ed98cfff564f79cf,3,98,16,82,0,0,0,13,29,52,2,3,1.448453749,1337,55,6,124,118,6,11112,10291,821,50,48,2,1,100.0,NoArch
169e3f66bbdc2a8c4163e8966461b1d891e0ca11,3,22,1,21,0,0,0,2,39,245,1,2,1.402934238,411,56,1,19,17,2,2773,2645,128,11,9,2,0,100.0,NoArch
c39778c150ad2d5f38af4628fea21de4c191d3ca,5,134,0,134,1,0,1,2,35,87,1,4,1.905603617,1122,0,0,182,167,15,6251,5617,634,175,162,13,1,99.85722444,NoArch
0f0088fe4b740c4acec0cb25988250db8fb483b6,1,3,3,0,0,0,0,2,9,38,1,1,0.0,273,30,2,25,25,0,1758,1758,0,10,10,0,1,100.0,NoArch
69ee790a47a5fa90a6acd954a9330cce3ae31c3b,17,591,142,449,1,0,1,9,26,226,3,9,3.498501547,5692,83,2,617,558,59,39462,35698,3764,327,297,30,1,99.26283458,NoArch
897d78401a2a3ca3082604e08ce3022d58b55007,0,0,0,0,0,0,0,0,0,0,0,0,0.0,0,142,7,0,0,0,0,0,0,0,0,0,0,100.0,NoArch
8c7cef3e50471d3645b207d97d515107764688c9,4,18,12,6,0,0,0,14,33,8,1,2,1.784640699,2517,11,0,233,235,2,15804,15775,29,115,115,0,0,100.0,NoArch
80011df995f6a610a30799eb3b11cdd8a2703630,16,255,74,181,1,0,1,21,40,384,2,12,3.300794637,7474,24,6,770,750,20,52352,51067,1285,362,356,6,1,99.92493056,NoArch
35a04c43a5c750d265e855b313a84a5135075225,1,1,1,0,0,0,0,8,13,0,1,1,0.0,272,23,3,18,18,0,2195,2195,0,14,14,0,1,100.0,NoArch
2f96f4300b37207703b477979f2461bdd294ccf9,1,0,3,3,0,0,0,17,28,30,1,1,0.0,622,9,3,83,84,1,3842,3884,42,37,37,0,1,100.0,NoArch
76554aa31a858d9946c3b95102bc1b18ce28a432,0,0,0,0,0,0,0,0,0,0,0,0,0.0,0,24,4,0,0,0,0,0,0,0,0,0,0,100.0,NoArch
69b90f6c714096a3ab7c312a98760a7d34a6cb75,0,0,0,0,0,0,0,0,0,0,0,0,0.0,0,112,16,0,0,0,0,0,0,0,0,0,0,100.0,NoArch
6f34be1b8dd55304317c40565dad23c09ddda5bf,2,134,1,133,0,0,0,6,8,87,1,2,0.894451885,1562,1,0,77,68,9,13200,12586,614,48,43,5,1,100.0,NoArch
291a88ba941a6ededdbf6d06c5684ea38f90502a,2,50,4,46,0,0,0,5,47,35,1,2,0.935711051,2701,3,0,205,201,4,18424,18107,317,81,78,3,0,100.0,NoArch
abb4893b25df47328d01890f0d01fbc4e5d99135,17,121,12,109,0,0,0,19,37,264,2,12,3.213408017,3202,1,0,322,315,7,20481,19992,489,161,157,4,1,100.0,NoArch
8eed4406949992086fe36b8da0029de98f443588,13,295,129,166,0,0,0,2,23,134,2,6,2.575853208,3939,42,3,336,326,10,26392,25294,1098,123,120,3,1,100.0,NoArch
7b2a947aed5649f8cbbade748e464e1228da6e5d,11,53,49,4,1,0,1,2,19,64,1,7,2.587943063,6922,26,2,371,380,9,49906,49869,37,210,214,4,1,99.85079081,NoArch
924e2e96a63eb5c1b24496ec302e91b6f7a65953,0,0,0,0,0,0,0,0,0,0,0,0,0.0,0,2,0,0,0,0,0,0,0,0,0,0,0,100.0,NoArch
8c6138cb01997e0ef35c396b2048cf956b53d28f,1,28,8,20,0,0,0,7,12,49,1,1,0.0,94,6,2,8,8,0,511,502,9,3,3,0,0,100.0,NoArch
d5bc4d9a180d4f1520accd05afbcc44fa38077fc,1,8,8,0,0,0,0,6,6,74,1,1,0.0,547,1,0,24,24,0,4100,4100,0,12,12,0,0,100.0,NoArch
b9b9b24993993051ba9378f4e8ed1b103d811795,1,27,28,1,0,0,0,1,2,0,1,1,0.0,276,1,1,15,15,0,1753,1730,23,6,6,0,0,100.0,NoArch
858eda85d7a5e4ee3be9aa28e7e7311bc8fb8983,6,349,100,249,1,0,1,1,32,167,2,4,2.372396726,2257,25,4,208,178,30,14699,13382,1317,124,108,16,1,99.22161172,NoArch
bf65269f66075069b421dfa25f90b105bc4ec662,0,0,0,0,0,0,0,0,0,0,0,0,0.0,0,13,0,0,0,0,0,0,0,0,0,0,1,100.0,NoArch
c4bc06cc9896a314fbb5a5c3ab7431a023bb8a3e,0,0,0,0,0,0,0,0,0,0,0,0,0.0,0,41,1,0,0,0,0,0,0,0,0,0,2,100.0,NoArch
9129edb595b2bf7879903680609797ffde5d6cd9,0,0,0,0,0,0,0,0,0,0,0,0,0.0,0,132,4,0,0,0,0,0,0,0,0,0,0,100.0,NoArch
77e333298d0323a374e735f59beb2aaf0d89e99e,0,0,0,0,0,0,0,0,0,0,0,0,0.0,0,32,0,0,0,0,0,0,0,0,0,0,1,100.0,NoArch
6917c47e985e9f747eeac81c3e92a47df24f0090,4,27,18,9,0,0,0,6,32,154,1,2,1.288269553,898,0,0,98,98,0,6493,6417,76,39,38,1,1,100.0,NoArch
ce9762d588800daa71db5bded8b68f755aa5ba17,1,0,2,2,0,0,0,14,17,0,1,1,0.0,94,48,0,7,7,0,606,613,7,4,4,0,0,100.0,NoArch
9ea134c02a7728a80ae8de6a8c08d5c1a584d445,2,4,0,4,0,0,0,2,2,904,2,2,1.0,168,4,0,3,3,0,807,761,46,2,2,0,1,100.0,NoArch
e057a10499729301ebe96d7cd54902b113af1811,5,47,11,36,1,0,1,2,18,119,3,4,1.877684047,1704,142,12,191,191,0,9224,9101,123,102,102,0,1,99.97869621,NoArch
70a1040998deb4585f6622e23f887dba21556cbd,1,15,11,4,0,0,0,3,3,27,1,1,0.0,65,11,9,4,4,0,223,199,24,4,4,0,0,100.0,NoArch
b2c47a24be53016d1c9220cb98d9fb7cd587e748,0,0,0,0,0,0,0,0,0,0,0,0,0.0,0,10,0,0,0,0,0,0,0,0,0,0,1,100.0,NoArch
7ef76a4de0c1000abe81513472712cf5602ef97c,0,0,0,0,0,0,0,0,0,0,0,0,0.0,0,21,0,0,0,0,0,0,0,0,0,0,0,100.0,NoArch
f665db071fac50ab1e74ed17bdda2eea9ed0ebb2,2,12,1,11,0,0,0,3,6,17,1,1,0.961236605,238,10,6,9,9,0,1239,1148,91,2,2,0,1,100.0,NoArch
49e855c3488ebe53af3a72fc3b5a22ba47a45e01,2,30,6,24,0,0,0,6,6,66,2,2,0.503258335,245,22,0,33,29,4,1247,1126,121,16,14,2,1,100.0,NoArch
8c3001363d80b29733470221c192a72f541381c5,44,427,208,219,1,0,1,10,22,56,8,29,4.574029071,13349,15,1,1256,1226,30,86554,85810,744,686,671,15,1,99.78670459,NoArch
e970e1f48302aec3af7eeca009a2c793757cd501,0,0,0,0,0,0,0,0,0,0,0,0,0.0,0,0,0,0,0,0,0,0,0,0,0,0,1,100.0,NoArch
4e7fcde4a6c69a070987fb97d978564f105ce547,0,0,0,0,0,0,0,0,0,0,0,0,0.0,0,2,0,0,0,0,0,0,0,0,0,0,1,100.0,NoArch
9af7b09aecc5e3e7bee8cda129d139fecc550887,0,0,0,0,0,0,0,0,0,0,0,0,0.0,0,111,8,0,0,0,0,0,0,0,0,0,1,100.0,NoArch
8006eaa42f40122716f6dc9ed910df193811a286,0,0,0,0,0,0,0,0,0,0,0,0,0.0,0,79,1,0,0,0,0,0,0,0,0,0,0,100.0,NoArch
870e97b5f82f7657ac1547c5ab38c0797aea5c27,1,0,12,12,0,0,0,6,6,151,1,1,0.0,293,32,3,32,34,2,1911,1973,62,15,16,1,0,100.0,NoArch
bead4331ba17c67b31425722f9bc22d3c303979d,1,5,3,2,0,0,0,5,9,2,1,1,0.0,950,94,1,40,40,0,6709,6729,20,20,20,0,0,100.0,NoArch
73d898322b69f8d3831bf209dceb069ea61f5064,0,0,0,0,0,0,0,0,0,0,0,0,0.0,0,5,2,0,0,0,0,0,0,0,0,0,0,100.0,NoArch
588a34aa95c608b595da66e6d42c9f06c9ef1546,0,0,0,0,0,0,0,0,0,0,0,0,0.0,0,126,8,0,0,0,0,0,0,0,0,0,1,100.0,NoArch
08fe281091bf08af743b83a0786216cc2aadfa62,1,22,17,5,0,0,0,9,13,198,1,1,0.0,169,223,4,18,20,2,1054,1039,15,12,12,0,1,100.0,NoArch
57668d02a0aa723dd4b2245dc7659fe18113eb59,9,348,74,274,0,0,0,1,53,152,1,8,2.610234193,3553,102,6,280,251,29,22144,20555,1589,149,134,15,1,100.0,NoArch
2a2f31d919dbabde76284f3b7fdae1e45dc9ceb1,1,1,5,4,0,0,0,13,20,30,1,1,0.0,307,10,0,48,48,0,1645,1678,33,38,38,0,0,100.0,NoArch
191470d1fc9b3596eb4da2413e8bef286ccc7135,0,0,0,0,0,0,0,0,0,0,0,0,0.0,0,0,0,0,0,0,0,0,0,0,0,0,1,100.0,NoArch
7e1ea06eb98419af74385fe967bcbdf1fe3ca953,1,19,14,5,0,0,0,8,26,55,1,1,0.0,498,41,3,41,41,0,2003,1983,20,38,38,0,0,100.0,NoArch
0921272442b424000f39fea73c5abc30037d67f1,28,586,633,47,0,2,2,8,18,15,3,18,3.475373225,5756,4,1,441,437,4,34425,34342,83,275,275,0,0,99.84350548,NoArch
ea2eba1a5532d0f0f66268a456877773763dec08,9,63,40,23,0,0,0,9,31,56,2,4,2.208936703,3827,169,10,344,341,3,23546,23491,55,216,212,4,1,100.0,NoArch
8b0a502c4fd5352863009030a32e219bbf822a6c,1,3,0,3,0,0,0,2,10,1,1,1,0.0,446,4,2,47,47,0,1996,1992,4,27,27,0,1,100.0,NoArch
2f96f4300b37207703b477979f2461bdd294ccf9,1,0,3,3,0,0,0,17,28,30,1,1,0.0,622,9,3,83,84,1,3842,3884,42,37,37,0,1,100.0,NoArch
1cc7542357af201c88b8e55ff2055c354ee38b88,0,0,0,0,0,0,0,0,0,0,0,0,0.0,0,68,12,0,0,0,0,0,0,0,0,0,0,100.0,NoArch
227785c022939cd2ba153c2a4f7791ab3394c6c7,0,0,0,0,0,0,0,0,0,0,0,0,0.0,0,14,0,0,0,0,0,0,0,0,0,0,0,100.0,NoArch
6b93ccca9b26b47099e9791d4363e0616e77e408,4,8,91,83,0,1,1,3,30,160,1,3,1.540298037,838,26,5,67,74,7,4451,4755,304,41,48,7,1,99.97683577,NoArch
e177466fd266ebf3a8d371ce1bf2ecf3bdfe90ed,11,228,16,212,1,0,1,7,9,42,2,9,2.35801252,3653,20,4,339,325,14,25918,24570,1348,216,204,12,1,99.91871571,NoArch
fba75642dae802d3eeb5035518a133fe35698df8,5,53,12,41,0,0,0,3,17,469,1,5,1.588691548,1114,239,6,120,117,3,6996,6804,192,45,44,1,1,100.0,NoArch
822312761113baea86145279a156c9c63d1a331d,1,2,0,2,0,0,0,3,4,34,1,1,0.0,67,70,13,7,7,0,226,219,7,5,5,0,0,100.0,NoArch
63fa2b618626b2b8e9530ec105e0d4995eebb643,2,18,0,18,0,0,0,2,3,65,1,2,0.650022422,333,8,2,32,31,1,1554,1493,61,24,23,1,1,100.0,NoArch
859157ec01125ee98d2c38bbe767ab7eb0452924,0,0,0,0,0,0,0,0,0,0,0,0,0.0,0,7,1,0,0,0,0,0,0,0,0,0,0,100.0,NoArch
7889c7852f0b8aa0a449e56f9d41fd6dbd648882,0,0,0,0,0,0,0,0,0,0,0,0,0.0,0,29,2,0,0,0,0,0,0,0,0,0,1,100.0,NoArch
47ca52027bbc7831acf75fd1e738b78129426db6,2,17,1,16,0,0,0,1,3,0,1,2,0.503258335,307,23,3,26,26,0,1762,1577,185,16,16,0,1,100.0,NoArch
8b21bb7128c7a026d1b3e2225b5f5075099e6e66,4,113,13,100,1,0,1,8,131,254,1,3,1.683962421,3412,5,0,440,435,5,17027,16377,650,408,403,5,1,99.97365648,NoArch
98c2931d548605c64db4acd6744e8b4552727d51,8,79,43,36,0,0,0,4,16,927,1,8,2.560665835,1684,82,1,180,178,2,11279,11100,179,133,133,0,1,100.0,NoArch
b10ca7e69f43cf2f14b09d0a610102ab058b1511,3,31,9,22,0,0,0,1,69,70,1,2,1.336666482,2619,211,3,239,235,4,20120,19883,237,154,152,2,1,100.0,NoArch
de42adc2302528541145a714078cc6d10cbb8d9a,0,0,0,0,0,0,0,0,0,0,0,0,0.0,0,22,2,0,0,0,0,0,0,0,0,0,1,100.0,NoArch
fec49dc12b19801a75c3f61c9da0d47ef0c1d2f8,2,173,0,173,2,0,2,1,1,0,1,1,0.895626846,0,5,0,19,0,19,622,0,622,19,0,19,1,99.96300954,NoArch
53396061cc169efc99849406561ec5ec7cf437ad,2,1,3,2,0,0,0,2,2,12,2,2,0.0,224,9,5,12,12,0,974,1002,28,12,12,0,0,99.95135004,NoArch
4a8bec7ea58950c7450f5edec93e9dd00cef2972,3,15,8,7,0,0,0,6,27,150,2,3,1.409844941,875,4,0,88,88,0,4934,4909,25,43,42,1,0,100.0,NoArch
e0a5e0d3435acc5f01812aa46d96cc7d5eb65860,1,1,1,0,0,0,0,9,13,175,1,1,0.0,356,0,0,39,38,1,2061,2048,13,10,10,0,1,100.0,NoArch
06bdba3cef187d4b7ca906dc7012b880bbc7fe93,0,0,0,0,0,0,0,0,0,0,0,0,0.0,0,30,0,0,0,0,0,0,0,0,0,0,0,100.0,NoArch
9ee36de98ab360a86d0bf6d61c873a85cdc2d97e,0,0,0,0,0,0,0,0,0,0,0,0,0.0,0,2,2,0,0,0,0,0,0,0,0,0,0,100.0,NoArch
5448cdde7e45c39b8bf8275d9f3ee425c9bfa90e,16,75,35,40,0,0,0,3,19,558,2,9,3.530363085,3092,21,5,334,327,7,17889,17650,239,188,185,3,2,100.0,NoArch
fe57e9beea54ac54ac0c0d204b7338deb7f36369,1,2,2,0,0,0,0,16,27,61,1,1,0.0,1133,22,4,98,98,0,5960,5959,1,64,64,0,1,100.0,NoArch
209ce34dba75068bcf6401d5cb1ce4380d9924cb,3,39,8,31,0,0,0,8,15,293,2,2,0.925255801,1007,0,0,108,103,5,5122,4766,356,80,78,2,1,100.0,NoArch
febc55c779215c152e17f7eb6ff0fa09123fe0fb,1,4,1,3,0,0,0,3,6,241,1,1,0.0,216,1,1,25,25,0,1344,1322,22,11,11,0,1,100.0,NoArch
53d2d6ae241f86aaf337abc50d3f00232fa87d00,5,59,23,36,0,0,0,9,20,28,2,4,1.735517592,2721,90,5,226,229,3,20527,20347,180,114,112,2,1,100.0,NoArch
71b5d92a15844ef1847721f2fac21b8a2956a8b7,0,0,0,0,0,0,0,0,0,0,0,0,0.0,0,7,1,0,0,0,0,0,0,0,0,0,1,100.0,NoArch
8255a86cb4d7f2173f0adcf0d752096b0b4df78c,5,46,163,117,0,0,0,3,19,417,1,3,1.654926109,2014,63,0,137,140,3,13718,14670,952,80,83,3,1,100.0,NoArch
de42adc2302528541145a714078cc6d10cbb8d9a,0,0,0,0,0,0,0,0,0,0,0,0,0.0,0,22,2,0,0,0,0,0,0,0,0,0,1,100.0,NoArch
66c7fa2322d0dce8ebb29f9b15a711f5f7b72884,1,4,1,3,0,0,0,9,39,34,1,1,0.0,428,71,14,42,41,1,2126,2115,11,25,25,0,0,100.0,NoArch
b1446be2b4d50e60b54146c66a6e6412d41b3a17,1,1,1,0,0,0,0,3,4,6,1,1,0.0,461,90,1,83,83,0,2795,2795,0,17,17,0,1,100.0,NoArch
e3eb14ad2d5bd25fcfd6bb2eb6e991558c0684ed,0,0,0,0,0,0,0,0,0,0,0,0,0.0,0,0,0,0,0,0,0,0,0,0,0,0,1,100.0,NoArch
117a68d5038960fa0cb14e00c0e27b9a772e1bf2,0,0,0,0,0,0,0,0,0,0,0,0,0.0,0,90,2,0,0,0,0,0,0,0,0,0,0,100.0,NoArch
a70355f44571036d7f99b3ca3cb240674bd1cf91,20,73,55,18,0,0,0,4,54,434,6,12,3.977788669,4386,111,3,393,393,0,28468,28457,11,203,203,0,1,99.96646996,NoArch
8485b9e2630a0619ad59ffb29739477b46d6a527,2,32,1,31,0,0,0,1,19,74,2,2,0.439496987,358,26,0,32,32,0,2348,2087,261,11,11,0,0,99.48246118,NoArch
6456bd3a5199d60ff55d6c576e139025a1c940c7,29,1116,385,731,3,2,5,3,14,106,2,15,3.897159995,6453,5,1,543,479,64,39165,35429,3736,319,287,32,1,99.82264262,NoArch
a33a55fcb59c9de341bc3169defda94df2910e65,1,9,3,6,0,0,0,4,9,1206,1,1,0.0,311,67,1,30,30,0,1748,1676,72,12,12,0,0,100.0,NoArch
f1f0109ab89f7317c89c6d1d51545a24f12b4692,0,0,0,0,0,0,0,0,0,0,0,0,0.0,0,3,3,0,0,0,0,0,0,0,0,0,1,100.0,NoArch
03a94d9ff5bc673fc68da6681eea7b7d881e1881,1,15,1,14,0,0,0,6,8,231,1,1,0.0,221,26,0,31,29,2,1183,1092,91,13,13,0,1,100.0,NoArch
98643c630560604029513c37d65227f0ca204f53,4,69,1,68,0,0,0,2,44,352,1,3,1.119567702,1853,6,0,156,153,3,13307,12747,560,68,66,2,1,100.0,NoArch
d7cc767dbc7687a03bf3701267e683a96d8dfab9,4,59,57,2,0,0,0,11,56,4,2,3,1.274926588,5800,47,9,514,515,1,38550,38597,47,180,179,1,1,100.0,NoArch
5fdf5a192706d8c8a0432297cca1e6e097de0e58,1,0,38,38,0,1,1,5,5,197,1,1,0.0,38,4,0,0,1,1,0,106,106,0,1,1,1,99.9137931,NoArch
20b9b399c980270afdd60cc5fbce783c700a8376,7,59,15,44,0,0,0,12,49,153,1,5,2.720009443,1878,8,2,198,191,7,12824,12406,418,80,78,2,1,98.60226469,NoArch
78e6ab0e677679ba76b7630fb9494297aa60c54a,0,0,0,0,0,0,0,0,0,0,0,0,0.0,0,17,3,0,0,0,0,0,0,0,0,0,1,100.0,NoArch
41f36770e09b41aee8f5c8789f2b5f8bf151fb3c,1,1,1,0,0,0,0,5,8,39,1,1,0.0,305,0,0,26,26,0,1666,1666,0,26,26,0,0,100.0,NoArch
1562bb658f8f29f57763eaa6f9bd5a2ed7e80a7c,1,4,4,0,0,0,0,17,28,144,1,1,0.0,414,63,2,51,50,1,3300,3284,16,24,24,0,1,100.0,NoArch
9f9e41c7a36b80ce58fa118b9b55e51994c67115,0,0,0,0,0,0,0,0,0,0,0,0,0.0,0,5,3,0,0,0,0,0,0,0,0,0,1,100.0,NoArch
6a3ce928b16d4060b5af94f4c92802da9510406b,0,0,0,0,0,0,0,0,0,0,0,0,0.0,0,1,0,0,0,0,0,0,0,0,0,0,1,100.0,NoArch
f4bb44c1b1ea3d2645fe209c30e20289a3b30d2c,0,0,0,0,0,0,0,0,0,0,0,0,0.0,0,51,1,0,0,0,0,0,0,0,0,0,0,100.0,NoArch
a405d3873b176a410abc5ef5239066f94214454c,0,0,0,0,0,0,0,0,0,0,0,0,0.0,0,15,12,0,0,0,0,0,0,0,0,0,0,100.0,NoArch
50fa5a6aa75ac506a326450f115c986e5e5f9ea0,1,3,0,3,0,0,0,10,15,137,1,1,0.0,346,0,0,43,43,0,2251,2225,26,16,16,0,0,100.0,NoArch
7a5af806cfe54474014db5c70641c0c6269fff03,2,77,0,77,0,0,0,2,8,42,1,2,0.972449715,488,11,3,39,35,4,3994,3355,639,27,25,2,1,100.0,NoArch
4fc506f30fe1ee9011e9b10beb484e653c7518ac,7,169,8,161,1,0,1,9,23,89,1,4,2.262501694,2344,0,0,199,185,14,18055,16937,1118,94,88,6,1,99.8748556,NoArch
3cdb590e153c77c85c0d3d6365ada132079c300a,2,21,14,7,0,0,0,25,45,70,1,1,0.512709142,690,189,10,84,83,1,5782,5673,109,24,24,0,1,100.0,NoArch
6409fc733d27eea6ebc71551affdf5aec4bb2fd5,3,74,0,74,1,0,1,13,17,464,1,3,0.875686556,478,0,0,57,50,7,3574,3194,380,36,31,5,1,99.69344514,NoArch
8736a0be799e2dc12d5545052bf8ce89ec54306b,4,25,10,15,0,0,0,2,29,289,2,2,1.215959583,2259,166,3,226,224,2,12793,12740,53,157,155,2,1,100.0,NoArch
0e6909d3e241c794ed1b9318fcb9142a36cb0133,0,0,0,0,0,0,0,0,0,0,0,0,0.0,0,0,0,0,0,0,0,0,0,0,0,0,0,100.0,NoArch
a70355f44571036d7f99b3ca3cb240674bd1cf91,20,73,55,18,0,0,0,4,54,434,6,12,3.977788669,4386,111,3,393,393,0,28468,28457,11,203,203,0,1,99.96646996,NoArch
ef06e4a5261008a7c64cc84a3cb62e106e121f93,1,1,1,0,0,0,0,6,11,3,1,1,0.0,252,195,12,26,26,0,1210,1210,0,25,25,0,1,100.0,NoArch
191470d1fc9b3596eb4da2413e8bef286ccc7135,0,0,0,0,0,0,0,0,0,0,0,0,0.0,0,0,0,0,0,0,0,0,0,0,0,0,1,100.0,NoArch
39312d139e0d9edd06d3ba8a3e6d8195e03de623,0,0,0,0,0,0,0,0,0,0,0,0,0.0,0,100,4,0,0,0,0,0,0,0,0,0,1,100.0,NoArch
a1017c66aaa377dad7e5e62f773bb714d53fc353,1,4,0,4,0,0,0,2,3,103,1,1,0.0,147,3,0,13,13,0,771,720,51,6,6,0,0,100.0,NoArch
142adf4ccbf92050dd14d1997c0438565fdfc2cd,0,0,0,0,0,0,0,0,0,0,0,0,0.0,0,35,2,0,0,0,0,0,0,0,0,0,1,100.0,NoArch
b5d4da79586192f17c0db458c1d4fcdbb334c3e2,1,3,2,1,0,0,0,2,3,0,1,1,0.0,191,1,1,16,16,0,1158,1158,0,9,9,0,0,100.0,NoArch
4a59876c8b6045fad55777c5eb241ef5d5aa401b,11,340,61,279,0,0,0,5,25,251,1,7,2.803399491,2767,165,9,290,260,30,21339,18920,2419,132,121,11,1,100.0,NoArch
c1516df8ac55757ebd07d8aa459a0ceedeccab7b,4,131,3,128,0,0,0,11,15,56,1,3,1.368769412,1417,1,0,180,172,8,8900,8153,747,165,162,3,1,99.31536157,NoArch
3a78be9203a9c3cea33fa6120c89f7702275fc31,4,50,43,7,0,0,0,2,7,359,1,1,1.582873791,463,127,9,39,39,0,1936,2010,74,27,24,3,1,100.0,NoArch
75f847691f0bdaf226d4713a8cb8c7639cffd5e5,0,0,0,0,0,0,0,0,0,0,0,0,0.0,0,40,0,0,0,0,0,0,0,0,0,0,1,100.0,NoArch
ec5022b4fdd94c106bf243038aadf781f31b5be9,10,64,62,2,0,0,0,2,148,62,5,9,2.667257686,12076,27,4,1266,1266,0,75409,75407,2,786,786,0,0,100.0,NoArch
0863b1cfd947402c66221afa8d1f18fd2bd8273b,5,8,18,10,0,0,0,5,6,66,2,2,2.192005835,2397,1,1,250,250,0,17033,17110,77,97,97,0,1,100.0,NoArch
822312761113baea86145279a156c9c63d1a331d,1,2,0,2,0,0,0,3,4,34,1,1,0.0,67,70,13,7,7,0,226,219,7,5,5,0,0,100.0,NoArch
c597eb5d206b528d201a47194e144b8aed732c0e,7,194,38,156,0,0,0,6,25,0,4,5,2.252563908,2113,7,0,232,213,19,13186,12277,909,141,129,12,1,99.93897655,NoArch
9059bce977cee98e2d65769622c46a1941c563dd,3,246,7,239,1,0,1,1,15,28,1,3,0.654572645,302,19,1,30,22,8,3890,2182,1708,6,2,4,1,99.93079585,NoArch
20feb1a8970b7ec658d4d3f1994eaedd24b9874a,3,991,2,989,2,0,2,1,2,10,1,2,0.984718091,66,93,9,167,5,162,5485,270,5215,33,4,29,1,99.94993742,NoArch
69cbcc95169488e7ffa3347ddf98be4167a99997,0,0,0,0,0,0,0,0,0,0,0,0,0.0,0,18,0,0,0,0,0,0,0,0,0,0,1,100.0,NoArch
1769ff8fb90733d16d17d9a1a8f77a1bae760559,0,0,0,0,0,0,0,0,0,0,0,0,0.0,0,116,8,0,0,0,0,0,0,0,0,0,1,100.0,NoArch
017ee8e66193fd7056c08ec1f36a1d9d6ee58969,4,4,4,0,0,0,0,11,18,19,3,4,2.0,3108,37,12,233,233,0,22997,22997,0,104,104,0,0,100.0,NoArch
97d71d85d013ae6b2d6aa3c23c144571252ea46b,0,0,0,0,0,0,0,0,0,0,0,0,0.0,0,120,2,0,0,0,0,0,0,0,0,0,1,100.0,NoArch
ed745dfdbf254bfc2ec6d9c7baed8ccbf571abab,6,224,5,219,2,0,2,3,3,12,1,4,2.177004183,516,0,0,53,40,13,4802,3117,1685,34,26,8,1,98.06877061,NoArch
a1f287d359f9c5e55b6d3d19871feca5cf3d250c,0,0,0,0,0,0,0,0,0,0,0,0,0.0,0,81,2,0,0,0,0,0,0,0,0,0,0,100.0,NoArch
1ee35c484b9e4eefb033086c5e0388afac70e642,1,1,1,0,0,0,0,2,2,21,1,1,0.0,430,9,7,92,92,0,4499,4499,0,9,9,0,0,100.0,NoArch
f9bc63097a586f71602a560dbe2d39150422271c,3,3,5,2,0,0,0,3,6,302,3,3,1.561278124,138,0,0,7,7,0,192,193,1,4,4,0,0,100.0,NoArch
9ece77561a673fbfd666c5c57dac1a36e6cedce6,0,0,0,0,0,0,0,0,0,0,0,0,0.0,0,8,2,0,0,0,0,0,0,0,0,0,0,100.0,NoArch
f22c3e933e828d1342bed67874b9ab3fee0ad099,0,0,0,0,0,0,0,0,0,0,0,0,0.0,0,30,0,0,0,0,0,0,0,0,0,0,1,100.0,NoArch
5471d8f0c2ed43435622069bee8b68a8ba5141f4,1,5,0,5,0,0,0,2,2,98,1,1,0.0,79,19,1,10,9,1,267,250,17,7,6,1,0,100.0,NoArch
6f6652a84aa5e738cdb6932f41880ae24415b06c,9,189,17,172,0,0,0,3,74,28,2,7,2.224411074,12230,271,1,1090,1082,8,86928,85513,1415,527,522,5,2,99.99328949,NoArch
62ecb2da62117e65117f7f6070469ac27a3ea5dd,1,5,0,5,0,0,0,6,20,75,1,1,0.0,675,0,0,87,86,1,3907,3863,44,35,35,0,0,100.0,NoArch
25385805aab3ff00ca9accc406d0f7b0cf2d9e55,0,0,0,0,0,0,0,0,0,0,0,0,0.0,0,14,4,0,0,0,0,0,0,0,0,0,1,100.0,NoArch
f4f9dd9d83a6a852c0e733802c6c49747cde5531,1,1,1,0,0,0,0,6,6,738,1,1,0.0,76,2,1,12,12,0,252,250,2,7,7,0,1,100.0,NoArch
5cf2f2618b6a59a831543b588fb3bb85bdf5f1e8,3,127,19,108,0,0,0,3,15,128,1,2,1.135011145,1915,45,2,158,144,14,14903,14159,744,106,96,10,1,100.0,NoArch
968927801470953f137368cf146778a7f01aa63f,3,22,10,12,0,0,0,2,23,20,2,3,1.505240815,1010,7,3,107,104,3,7254,7152,102,47,46,1,1,100.0,NoArch
653981373339b8ce74b1227278d435f5c34d2deb,1,3,1,2,0,0,0,3,3,263,1,1,0.0,26,29,1,0,0,0,21,21,0,0,0,0,0,100.0,NoArch
af46078a828abb45e9e90915fd7e5f6f2a83d1ee,1,2,1,1,0,0,0,4,7,273,1,1,0.0,368,68,1,47,47,0,2386,2382,4,12,12,0,0,100.0,NoArch
1f5b0c77d6c87a936f2d34287ec6a1df1cb18b33,6,37,24,13,0,0,0,13,27,0,1,3,1.737797591,4702,0,0,381,378,3,31290,31100,190,174,173,1,1,100.0,NoArch
f7f5d4cc6db1230e653346953d87c6ff480c56eb,2,65,0,65,0,0,0,4,16,56,1,2,0.721928095,571,19,4,47,42,5,4579,4041,538,30,27,3,1,99.87497767,NoArch
3fd2fd6e9dbf8c03bcc742b883fa2a0598ad99be,6,74,71,3,0,0,0,3,17,43,1,2,2.172545182,1703,1,1,120,121,1,11475,11555,80,53,53,0,0,100.0,NoArch
6cb4580defcb0bc5e38d3dd6931e75abc9f80535,1,1,1,0,0,0,0,4,4,1013,1,1,0.0,176,0,0,13,13,0,1151,1151,0,7,7,0,1,100.0,NoArch
87272a1ffed9738c93dffc6b5c98989885ea6958,0,0,0,0,0,0,0,0,0,0,0,0,0.0,0,88,0,0,0,0,0,0,0,0,0,0,0,100.0,NoArch
e524a62ba88957556c948c905ae2033325c7676e,1,6,2,4,0,0,0,19,26,19,1,1,0.0,405,108,12,23,23,0,1793,1785,8,23,23,0,1,100.0,NoArch
9bde6d616c5ee2ef131037af5b5527a0717cc527,11,171,0,171,3,0,3,5,12,233,4,8,2.911708825,617,64,1,34,34,0,2754,2080,674,21,21,0,1,99.45498587,NoArch
19a088800d6a32516fc27822322fb4aeb29f8b64,1,29,0,29,0,0,0,16,31,166,1,1,0.0,653,37,0,91,89,2,3448,3344,104,36,34,2,1,100.0,NoArch
ba514cfea0fbb3a71a93fc7b5d5fe06dc1fdfffd,46,106,107,1,0,0,0,4,16,0,8,23,4.941003726,13790,14,12,1504,1504,0,81383,81631,248,815,815,0,0,100.0,NoArch
8ee777a9bbe2b995f3f1984c83db1de46e27c104,69,3365,1892,1473,17,5,22,2,7,88,5,30,5.135222748,9493,42,14,954,878,76,64923,57637,7286,460,386,74,0,91.77545692,Arch
ccd8cb240726deda35fabd2860edcbf4adeb1013,45,1254,1171,83,4,5,9,2,8,0,5,23,4.673832341,8345,43,15,739,746,7,51644,50613,1031,346,363,17,0,93.7357631,Arch
48fbb0f4258499366477b00e164bccbfacccd792,15,1496,23,1473,11,0,11,1,4,12,2,8,3.425484789,728,44,16,222,81,141,10897,3555,7342,127,39,88,0,96.41350211,Arch
11d2fd34281aa8a7365c46f033a65eab29898042,30,1074,95,979,10,0,10,2,9,18,2,15,4.11089273,3871,10,0,457,393,64,25334,19877,5457,272,228,44,0,91.79600887,Arch
eb46e7c72bbbe3149ebf66a6d90167966ba65938,46,1110,418,692,6,2,8,3,10,6,4,26,4.732054237,8674,11,1,762,700,62,57435,53557,3878,374,338,36,0,93.98843931,Arch
69d3950a325a9b3cb22b6948abba1b22145783cf,26,1739,261,1478,16,1,17,1,13,38,3,10,3.971180778,2123,24,1,374,269,105,19236,12209,7027,183,129,54,0,93.04152637,Arch
6f36e1eaaf6d4a83de3f41e61e650c16db5b4120,22,1344,130,1214,6,0,6,2,14,53,3,15,3.555962385,4070,14,2,514,417,97,30863,23069,7794,285,221,64,0,93.89312977,Arch
431a9adc5600387d8960b599a6b046bd4fe25fb3,137,2638,10209,7571,6,63,69,1,7,6,6,46,6.301135464,19909,41,0,1198,1779,581,70710,112132,41422,586,952,366,0,76.96969697,Arch
21898907c1d1dd1dd962b441db29c6663756cdb8,141,10983,2672,8311,66,6,72,2,17,31,6,46,6.348365142,12413,0,0,1840,1201,639,117261,71082,46179,978,588,390,0,76.32211538,Arch
f3c851d75487790ab9f4d95817abef2ad2d8ca80,141,2645,11005,8360,6,66,72,1,7,4,6,46,6.342974219,20773,10,0,1201,1847,646,71080,117511,46431,588,983,395,0,76.32211538,Arch
0e3f635adbc231ad513948c39e8b2d93573a035b,141,11005,2645,8360,66,6,72,2,18,31,6,46,6.342747085,12413,17,3,1847,1201,646,117509,71080,46429,983,588,395,0,76.32211538,Arch
4c3b367efb369f6bede4bf0169e682adf1123cc1,141,2644,11004,8360,6,66,72,1,7,4,6,46,6.342463124,20773,42,1,1201,1847,646,71080,117509,46429,588,983,395,0,76.32211538,Arch
d6f94b998dc3b98308b86c4a6cd11e2a250a8913,142,11041,2649,8392,66,6,72,2,18,33,6,46,6.351422584,13090,0,0,1977,1331,646,121858,75185,46673,1108,713,395,0,76.32211538,Arch
c00f1a9ed972dac9a8c4c238c762cb390b62f54c,41,805,404,401,2,0,2,2,27,72,5,24,3.427788953,10600,28,1,919,900,19,67319,66198,1121,456,428,28,0,95.37572254,Arch
48eedf39f2ed86eab6cc2a13cae5fe6625919a1f,61,611,1442,831,0,3,3,2,25,47,5,30,4.391719546,14870,2,0,1256,1307,51,85574,90080,4506,633,678,45,0,95.50140581,Arch
e8b3ddd7cbf4232d3e02fa9bcb71c100a5aea26f,61,1433,602,831,3,0,3,2,28,95,5,30,4.413241675,14039,30,0,1307,1256,51,90080,85574,4506,678,633,45,0,95.50140581,Arch
0b26b60a5c253717d890d658a6e6a55caa310518,4,103,40,63,0,0,0,7,19,95,2,4,1.782209115,2260,8,2,216,207,9,17137,16402,735,96,91,5,0,94.15262636,Arch
86209640f76d64767a24c344ec0e2b22c2a381e6,24,776,471,305,3,1,4,1,20,130,2,16,2.922513688,5255,32,0,477,435,42,36054,34540,1514,256,237,19,0,90.54470709,Arch
a2e0f523a03ddbb6586210bb6726c4c162225ab0,78,4955,2874,2081,2,9,11,2,25,56,5,36,3.631874677,17194,72,0,1905,1528,377,110578,104263,6315,922,789,133,0,90.9178744,Arch
b1cf097b0cb685ebfb0e507ac8ad777de6baa8ac,82,3116,4953,1837,10,2,12,2,29,105,5,40,3.770442776,19891,1,0,1613,1979,366,110074,114468,4394,825,951,126,0,90.55876686,Arch
64e0573aca01dfd07b23ec41e20acb307829733e,28,693,329,364,5,2,7,1,32,230,6,14,3.81887031,5647,36,2,484,466,18,37167,35245,1922,244,235,9,0,92.4783028,Arch
1b756db2219352b695b9da28f00f2449d2b1c4f5,6,27,6,21,0,0,0,4,30,87,1,3,2.439116288,1413,32,2,146,143,3,8809,8677,132,122,119,3,0,91.48753224,Arch
987f5d6b965b49e0ba86e5d06ef5e685fb465f2e,22,971,278,693,6,0,6,2,31,58,4,13,3.894154591,3374,33,3,388,341,47,22370,18601,3769,261,227,34,0,94.90333919,Arch
788e4f2d2eeeeee685b9f5d2e09b56be230e34d4,193,4972,5966,994,4,0,4,5,49,171,7,63,6.370780482,36965,0,0,3316,3316,0,213811,213792,19,1795,1795,0,0,90.67357513,Arch
6c226ca21a84b18bde0ff3a3c569f3e6957a480f,8,1972,1164,808,4,0,4,10,25,12,2,3,2.15075704,2197,1,1,227,184,43,19621,17521,2100,127,89,38,0,97.91666667,Arch
c66004d79a2b1d30584df5e99e782d399d0b8ce7,8,556,101,455,2,0,2,3,10,104,1,2,2.820786968,862,2,0,108,81,27,9154,6806,2348,50,30,20,0,97.04918033,Arch
04655e9e85e8e4aacc8c66209ccd0f4fb0b28671,17,614,119,495,2,0,2,1,50,72,2,10,3.542457983,4194,36,1,485,421,64,27683,25106,2577,242,204,38,0,96.52945924,Arch
75df72f575d67042dcbbfd2123fc304992048ae4,3,161,10,151,1,0,1,2,7,78,1,3,0.80750076,531,37,1,41,34,7,4259,3316,943,21,18,3,0,92.4351585,Arch
dfc0c61eb7d8ef6e66e96252f0fc89c260786704,46,2617,1251,1366,20,7,27,5,36,21,4,19,4.828453297,6280,3,0,572,484,88,46919,41505,5414,295,231,64,0,95.17833554,Arch
7243ce40c93f60e8d3e47c2405dc92b4e38e1b10,13,51,456,405,0,4,4,3,23,559,3,7,2.678557847,2016,53,1,158,178,20,8619,11179,2560,93,103,10,0,96.01873536,Arch
30c5f8b7bd051271de7f9012221c2a47d9f92ea9,12,156,24,132,2,0,2,2,28,168,5,8,2.884790401,3053,30,0,362,346,16,18399,17887,512,157,152,5,0,95.22673031,Arch
3a0044216cb2f707639d48e2869f4ee6f25cfc19,47,2141,249,1892,14,0,14,2,24,257,6,19,4.895804592,5789,31,0,640,500,140,47261,35827,11434,336,253,83,0,92.25473322,Arch
f1410bfdcde0745625d46b9f3f5e996eb368663f,9,112,23,89,1,0,1,8,42,357,1,7,2.477964632,2672,72,3,272,262,10,15766,15258,508,210,204,6,1,95.35374868,Arch
9ef51deb841765e85a1d1c8ab337677a687dfb66,1,48,0,48,1,0,1,1,1,0,1,1,0.0,0,0,0,4,0,4,138,0,138,4,0,4,0,93.24988824,Arch
64fec640975b42b0645c75416eb8bbf0b8092c66,105,8538,864,7674,50,0,50,1,66,228,5,29,5.557498163,18632,45,3,2425,1721,704,160122,117817,42305,1377,936,441,0,93.15512353,Arch
145034c5faebefe51b6f1557f156bc19c787d671,52,1663,966,697,4,2,6,5,67,230,5,27,4.919918466,17891,47,4,1692,1622,70,122445,118634,3811,1007,966,41,0,95.13274336,Arch
f2d91a455ec17e66ad319f47a2d5ad45d62c9ca3,7,461,30,431,3,0,3,7,48,164,1,3,2.552052231,1738,0,0,240,202,38,11761,9420,2341,195,162,33,0,93.22033898,Arch
51d122b5c39525720ce946755f57326ce24f6e38,2,52,42,10,0,0,0,1,16,6,2,2,0.382380675,402,61,7,45,44,1,2496,2462,34,17,17,0,0,92.66963843,Arch
04fc86b43d0afc39b76a7d85e82e8b94dee42923,9,21,257,236,0,5,5,1,24,8,1,1,2.771473732,2231,63,8,126,142,16,12679,13516,837,73,85,12,0,91.61793372,Arch
a0d7ab238473f22347e140b0e1e273ab80583eb7,27,1955,423,1532,9,0,9,1,71,14,4,15,3.482781545,7440,68,13,811,664,147,54592,46928,7664,417,340,77,1,91.03182257,Arch
17e878f721c110f274251d2ba6c7c50fcd58cb8f,1,81,0,81,1,0,1,1,1,0,1,1,0.0,0,0,0,9,0,9,364,0,364,4,0,4,0,97.28971963,Arch
722b6be04a0083f96438fe026cafd4cec5ef6093,125,754,758,4,0,0,0,3,74,93,7,43,6.464148964,34174,0,0,2916,2915,1,214293,213666,627,1518,1518,0,1,97.72329247,Arch
a4f9d7575f39bb79089714049ffea12ba5f25ec8,863,72616,72326,290,433,405,838,1,75,0,19,166,9.110925089,72301,82,4,6437,12849,6412,412280,821635,409355,3619,7231,3612,1,21.68674699,Arch
6edf0b9defe8c82b0ef0076a6300c00c1641a6e6,5,440,130,310,1,0,1,2,2,24,3,3,1.67373174,1461,35,0,151,122,29,10583,9337,1246,75,52,23,3,95.61808118,Arch
6f2b166005043b85056e23c420195a9e569e443b,24,2227,2333,106,1,0,1,2,4,49,1,7,3.29973938,9240,1,0,533,544,11,64323,65730,1407,288,274,14,1,97.68518519,Arch
e4c91ed13f16e1d0d55d9d690395bb62ab2b4fa0,18,25,25,0,0,0,0,1,4,2,6,10,4.00385619,5426,41,1,276,276,0,43926,43926,0,147,147,0,1,94.36677632,Arch
1cfd311b40d814b87ede942f770324abdd1affea,44,140,828,688,0,8,8,2,6,73,7,26,4.453749305,11569,124,8,829,874,45,80430,84392,3962,399,425,26,0,92.42236025,Arch
c23da694ccbbf1f0ebcc5ed770dd56c74c1e06d7,49,1287,404,883,8,0,8,3,7,0,7,27,4.275580434,12938,121,5,1159,1091,68,97334,92183,5151,621,579,42,1,92.18362283,Arch
290278fc6cd90c6dad09618275d2016c295c0b0d,6,138,25,113,0,0,0,8,13,49,2,2,1.951117297,1311,5,1,141,125,16,11377,10337,1040,49,46,3,1,95.81190301,Arch
d09eacdc13b9f19f69a317c8d08bda69a43678bc,5,590,111,479,2,0,2,1,7,89,1,2,1.992518575,516,8,0,90,46,44,5879,3086,2793,38,19,19,1,95.11363636,Arch
c2c0f6b13d5b72b3098ed1b343b0a89679f854b3,77,855,822,33,1,1,2,2,24,23,9,32,5.347266381,26005,45,1,2207,2208,1,169348,169380,32,1082,1091,9,1,97.35595896,Arch
20ed2516d38b9ce4b3e185bd89b62264b8bd3f25,3,216,67,149,0,0,0,3,17,101,1,2,0.669766555,911,3,3,91,79,12,8766,7762,1004,32,24,8,1,94.80349345,Arch
71170fafe77e11ea1a458a38e3395a471d94a047,88,288,300,12,0,2,2,5,21,27,5,32,5.501260829,24975,47,0,2079,2075,4,160533,160145,388,1088,1085,3,1,87.29478944,Arch
8306205d7abb0acbb73a1d178e3eb90f2bc29a5e,7,153,12,141,1,0,1,6,16,39,2,5,2.315202103,2746,8,0,318,303,15,18198,17565,633,132,124,8,1,96.82034976,Arch
ccbf543607db2c3479094a3216f733f6844b6f06,14,0,0,0,0,0,0,1,1,0,1,4,0.0,2825,56,4,316,316,0,17613,17613,0,130,130,0,1,97.81942078,Arch
e9f114f3dd8673b8b66b024e62cc1e3e808e7ea9,43,132,889,757,0,7,7,1,22,40,7,25,4.268802626,12523,12,0,1015,1072,57,78504,82476,3972,482,509,27,1,94.64512041,Arch
2137ecfa2296b1b2d281fcd2d2a35a9282d2b477,43,889,132,757,7,0,7,1,19,26,7,25,4.268802626,11766,7,2,1072,1015,57,82476,78504,3972,509,482,27,1,94.64512041,Arch
3639241d24178292223996fd591a7d0c6e27a528,44,158,896,738,0,7,7,1,22,40,8,26,4.31427228,13045,6,1,1074,1129,55,81638,85487,3849,493,518,25,1,94.64512041,Arch
44700d531a74f24762903df2729577a0d96e4ec0,47,1392,158,1234,10,0,10,1,22,24,8,28,4.276719341,12307,2,0,1155,1074,81,89047,81638,7409,529,493,36,1,94.60297767,Arch
a355c7611c55151e6cfd5942c9eb067b622ae57b,55,251,1593,1342,0,10,10,1,22,37,8,32,4.606635689,16349,48,1,1313,1395,82,100725,109900,9175,624,658,34,1,94.60297767,Arch
fb7fba365f89afaf97cc969ecc09f3bbfc4a5dbd,56,1596,252,1344,10,0,10,1,22,26,8,32,4.61894358,15147,49,1,1401,1319,82,110855,101667,9188,662,628,34,1,94.60297767,Arch
99b7e9eb9ef8827c1e06b7e8621b6be6403b061e,48,308,211,97,1,0,1,5,23,83,6,28,4.984503241,16563,13,1,1671,1655,16,100683,100248,435,920,910,10,1,96.09209331,Arch
cf765df6062f896ad6bf0a8ddf711aad19dbf59b,7,475,33,442,2,0,2,1,20,64,2,4,2.2782776,1828,4,0,203,165,38,14391,12319,2072,130,109,21,1,92.86921257,Arch
55e6d348155f63eb128cd208687d02206bad66a5,9,132,475,343,2,2,4,0,19,32,3,6,2.710873243,2270,11,3,169,203,34,12649,14518,1869,113,130,17,1,92.78002699,Arch
1e321c2fc0f9fedcbb8a0339c90a28a9be5afd64,10,286,45,241,1,0,1,4,20,166,1,3,2.065610219,1354,1,0,212,179,33,7237,6178,1059,183,163,20,1,94.38459027,Arch
a752b7b18c5c74c0c9115168188fa4a15a670225,7,475,33,442,2,0,2,1,20,64,2,4,2.2782776,1828,11,1,203,165,38,14391,12319,2072,130,109,21,1,93.0479183,Arch
71b5d92a15844ef1847721f2fac21b8a2956a8b7,123,608,3254,2646,0,16,16,1,22,29,10,57,5.758990858,33121,7,1,2834,3049,215,191761,207434,15673,1521,1640,119,1,89.15537018,Arch
8b00791ef47f708f54ffbfb5789ed65f958740b3,124,3257,615,2642,16,0,16,1,25,38,10,57,5.766961496,30561,1,1,3055,2840,215,207740,192100,15640,1645,1526,119,0,89.15537018,Arch
41202da7788193da77f1ae4b784127bb93eaae2c,168,1242,4245,3003,0,19,19,1,22,16,10,65,6.222605537,45149,8,1,3826,4059,233,266649,284452,17803,2064,2192,128,0,88.93897365,Arch
bc82e2be6cf080ab99092758368e91f509a2004c,169,4313,1244,3069,20,0,20,1,27,38,10,66,6.211450863,42146,4,2,4067,3826,241,284832,266649,18183,2200,2064,136,1,91.72259508,Arch
8b0a4009a9c662f45a0b7bbbb6f01c2b07c36809,9,110,81,29,1,0,1,5,21,35,1,7,2.071052094,3930,27,1,435,437,2,23293,23162,131,264,266,2,1,94.30865922,Arch
07c3c5d797f612f9b73b2805b65275c2029c2442,18,134,57,77,1,0,1,11,24,18,1,9,3.716316821,4420,28,2,420,413,7,27374,26972,402,214,207,7,1,94.22084623,Arch
e057c27603301d8b49e9b50b78a3ffce247b1059,263,532,531,1,0,0,0,2,28,34,8,78,7.626172658,59964,51,1,5438,5438,0,372343,372023,320,2977,2977,0,1,87.54940711,Arch
575d87cf7d6f0f743cb7cec6520d80e6fcc3e20a,3,277,0,277,3,0,3,1,1,0,1,2,1.357798413,0,3,0,19,0,19,1292,0,1292,9,0,9,1,96.75845242,Arch
4e5c8671ef3213ffa5c40f09aae27aacfa20f907,5,103,59,44,1,0,1,9,22,20,1,3,1.936385057,1182,15,0,108,114,6,9536,9529,7,39,37,2,1,93.13116551,Arch
17bf9303423821483f17785f8536b7bfed45e42e,39,2703,859,1844,28,0,28,2,29,3,2,9,4.728831123,6858,134,0,637,530,107,54229,44639,9590,346,260,86,1,92.32821881,Arch
661b0b3bab85c8fd958a9e256dab99790ea92713,20,907,520,387,7,0,7,2,30,5,3,11,3.539774238,5577,54,1,513,493,20,36977,35323,1654,250,235,15,1,95.05962521,Arch
644c1cc8bd1965271c4433edccb17aa8fda5f403,5,304,6,298,2,0,2,1,15,4,1,4,1.382624037,508,17,2,53,44,9,5626,3735,1891,23,17,6,1,92.26150767,Arch
19d29ac7d0ac451324d25bfe85b51b1eca10bc67,15,1004,180,824,2,0,2,5,24,18,4,11,2.369738319,6753,11,2,764,704,60,47292,42697,4595,415,389,26,1,97.63677566,Arch
19ca0b56296bf89c611406bb86c3626f87d562ee,58,789,601,188,5,0,5,8,31,10,3,20,3.705225361,11147,55,1,977,969,8,72794,71523,1271,585,575,10,1,96.97275479,Arch
f921469afcd03baaf2a4f3266c8ba97e516d6935,5,432,12,420,2,0,2,1,17,32,1,4,1.591354734,537,20,1,57,46,11,6656,3725,2931,25,17,8,1,90.78508639,Arch
f6c87b56c1f79697428eafde8d167dbcfe93b282,534,19929,33328,13399,81,183,264,1,22,0,11,123,8.075533922,84044,10,0,6357,8580,2223,429023,583500,154477,3481,4811,1330,0,77.123804,Arch
e783ab174946a0b767396239c0132c31c8d26458,534,33320,19921,13399,186,81,267,1,34,0,11,123,8.075980613,70648,4,0,7274,7672,398,510740,502284,8456,4080,4205,125,1,77.123804,Arch
dd7952ec9de7f9858ded98b49923e8978fd1df78,534,19867,33414,13547,81,186,267,1,22,0,11,123,8.073102195,84189,8,0,6357,8604,2247,428990,584631,155641,3481,4824,1343,1,77.123804,Arch
cebce61a3496f8788f5b96d6aedce0a8394fc325,48,308,211,97,1,0,1,5,23,259,6,28,4.984503241,16527,13,0,1670,1654,16,100402,99967,435,920,910,10,1,95.00674764,Arch
0050e00afdc728793f9928cbb594e657c7219c41,2,100,1,99,1,0,1,1,20,0,1,2,0.968586717,228,4,1,30,24,6,1884,1439,445,15,12,3,1,87.90573588,Arch
fa6aba751d8de16d9d109a8cfc21150b17b59cff,528,32722,19583,13139,181,79,260,1,34,0,11,122,8.025296913,70607,0,0,7250,7659,409,510064,502167,7897,4068,4196,128,0,68.60167945,Arch
2e5f6011575cc9fb6adbae822718ea08ac00c4be,528,19596,32733,13137,79,181,260,1,24,0,11,122,8.025138687,83746,0,0,6355,8545,2190,429510,582384,152874,3481,4790,1309,1,68.60167945,Arch
f92b9fdcc4d7c0dff9953e42205fca22472525c9,528,32739,19768,12971,182,79,261,1,34,0,11,122,8.02636946,70646,57,1,7239,7677,438,509344,503628,5716,4064,4203,139,0,68.5516235,Arch
8d0e23173b3f21d7cdb24942913eb1132a111a32,3,29,9,20,0,0,0,13,22,30,2,3,1.344127981,1091,136,1,103,99,4,7405,7230,175,58,56,2,1,92.93163384,Arch
77d7500d3bbcedda81fa182908984e658d6689e5,528,19807,32796,12989,79,182,261,1,24,0,11,122,8.028709571,83636,8,1,6357,8545,2188,430131,582446,152315,3483,4792,1309,1,70.14812002,Arch
295d00beea1c84f83d707f7c6e70292787f1e3e0,528,32802,19803,12999,182,79,261,1,34,0,11,122,8.029366568,70647,2,1,7243,7677,434,509571,503629,5942,4066,4203,137,1,70.14812002,Arch
0d4848b68b625a17d05b38864a84a6cc71189bfa,33,99,78,21,0,0,0,1,15,21,5,18,4.36430565,7418,14,2,497,497,0,51789,51466,323,304,304,0,1,92.6889715,Arch
29edf4b3b8ade64ec7822d6b7b2a125d5ca781c4,16,1381,65,1316,5,0,5,9,27,41,2,12,2.982676131,3060,14,0,438,330,108,27907,18576,9331,301,241,60,1,94.29991231,Arch
5fbb5a76f9ded25e9b6bd15e2db40e1a7c7a0f4d,557,22480,37168,14688,96,206,302,1,24,1,11,136,8.15310234,85850,2,0,6382,8873,2491,432972,613446,180474,3500,5003,1503,1,67.18694573,Arch
57132f79bb2dad6cfb215480b435a778714a442d,558,37350,22624,14726,207,96,303,1,36,1,11,136,8.155959632,71321,22,2,7395,7925,530,524817,525544,727,4156,4353,197,1,63.81498158,Arch
4095de4d45f174b45dd1310a6a99c4fecfb2466a,572,22903,38742,15839,98,214,312,1,24,0,11,138,8.213384521,88191,134,0,6502,9087,2585,439223,630044,190821,3556,5130,1574,1,68.08349146,Arch
46572d04c4fed19941cb136882d4895d36b5c2fb,572,38285,22962,15323,213,98,311,1,36,0,11,138,8.208448675,72868,59,1,7554,8082,528,536424,533820,2604,4256,4431,175,0,68.14562002,Arch
0a77a3bbaba64d9b5930429d465b5f4071d494f8,572,22964,38287,15323,98,213,311,1,24,0,11,138,8.207212991,88191,11,1,6558,9087,2529,442037,630044,188007,3580,5130,1550,0,68.14562002,Arch
6c450957ced051de6231ad047bce22752210b786,572,38290,22966,15324,213,98,311,1,36,0,11,138,8.208889576,72868,19,5,7554,8082,528,536424,533827,2597,4256,4431,175,1,68.14562002,Arch
03f136361a5fed594855992ab10bee8bb5060c5b,72,286,260,26,0,0,0,1,31,12,6,32,4.35778426,20086,20,6,1235,1235,0,144497,144166,331,732,732,0,1,95.21817095,Arch
bde7a7043e100242fec8fc0111e489a269a1d997,8,510,144,366,6,1,7,1,13,43,3,4,2.595493999,214,4,0,37,12,25,2951,1216,1735,29,6,23,1,95.86082783,Arch
7b1a049be9fa3f59da7d881e0fb3ec507f519012,593,26020,41756,15736,112,232,344,1,24,0,12,142,8.249460351,88721,1,1,6565,9333,2768,442520,656919,214399,3583,5283,1700,1,66.17142857,Arch
7fb1251c6ed769ea6877126957a03c5f95d42d8f,593,41756,26019,15737,232,112,344,1,36,0,12,142,8.250625074,72985,16,2,7594,8298,704,539211,557458,18247,4282,4561,279,1,66.17142857,Arch
b43a63ec9ff83f92884b5b5c27d7accbbf3afe47,593,26021,41757,15736,112,232,344,1,24,0,12,142,8.249447496,88722,12,2,6565,9333,2768,442531,656941,214410,3583,5283,1700,1,66.17142857,Arch
1a9fef48e767c2bb56b9fba5cac48540c5d6c6c1,593,41756,26020,15736,232,112,344,1,36,0,12,142,8.250619547,72986,17,3,7594,8298,704,539211,557480,18269,4282,4561,279,0,66.17142857,Arch
5a04fc7dc84cf0cc4e4c66703a96de36cfc546ff,592,26006,41722,15716,112,232,344,1,24,0,12,142,8.246641816,88286,0,0,6512,9280,2768,440917,655327,214410,3566,5266,1700,0,66.17142857,Arch
8cb86b4d36de2ee7f8360b715f9f85c635c71a90,592,41721,26005,15716,232,112,344,1,36,0,12,142,8.247814681,72570,0,0,7541,8245,704,537597,555866,18269,4265,4544,279,0,66.17142857,Arch
742c2040995167871db976fc0eb280347401ffc4,63,240,247,7,0,0,0,1,25,11,4,22,4.95132721,19721,21,4,1198,1198,0,138031,138044,13,721,721,0,1,93.78176383,Arch
6dcd0a3524fe7be0bbbd3e673ed7e1d4b035e0cb,601,29282,45284,16002,121,242,363,1,24,0,12,141,8.242249814,88366,138,4,6503,9527,3024,439717,681377,241660,3556,5414,1858,1,68.00404585,Arch
e9cab67b8095b30205af27498dc0b279d188a454,601,45230,29313,15917,242,121,363,1,36,0,12,141,8.243115369,72394,1,0,7543,8440,897,537990,575996,38006,4258,4656,398,1,68.02698145,Arch
84ca5b0cae72d9b33271045efee93a4cf1a0cff5,601,29323,45300,15977,121,243,364,1,24,0,12,141,8.243428483,88319,14,3,6506,9603,3097,439682,685390,245708,3558,5456,1898,0,67.97165035,Arch
7d40f19f395460bc78a12ac452831a9f0393ab49,601,45325,29317,16008,243,121,364,1,36,0,12,141,8.24403179,72342,7,0,7548,8512,964,538234,579891,41657,4259,4704,445,1,67.97165035,Arch
937566ee15c6a873258cb22f0cf78623f3c169fc,601,29320,45312,15992,121,243,364,1,24,0,12,141,8.241877602,88350,1,0,6513,9606,3093,439802,685583,245781,3560,5457,1897,1,67.97165035,Arch
22cd824d993bf43d88121ea89bad3a1f23a28518,601,45421,29459,15962,243,122,365,1,36,0,12,141,8.2465982,72358,2,1,7545,8526,981,538191,580182,41991,4261,4708,447,1,67.99594458,Arch
37838cea6094ddc66191df42e8b2c84f132d1623,18,919,624,295,4,0,4,2,20,51,2,9,3.036372933,4960,2,0,359,347,12,36249,34799,1450,162,154,8,1,96.1058264,Arch
ce0c840ec1425536d7db33c2140497c48a164fdb,606,30077,46333,16256,123,248,371,1,24,0,12,143,8.276421452,88614,15,3,6513,9627,3114,439802,687624,247822,3560,5473,1913,0,64.85054862,Arch
df2e0c760e7df0bd1b200867b3f0d2ca3a3f1fce,606,46335,30074,16261,248,123,371,1,36,0,12,143,8.277710113,72358,1,0,7558,8535,977,539703,580710,41007,4269,4712,443,1,64.85054862,Arch
f3a701757b9fb838acc4fb2975f378009d71f104,9,513,43,470,2,0,2,2,21,52,2,5,1.823141902,1851,27,2,171,157,14,17204,14045,3159,85,73,12,1,93.06989089,Arch
2603cfb33e272632d7f36a53e1b13fe86dbb8627,53,1034,490,544,4,0,4,21,39,99,8,30,4.67675707,16139,13,0,1487,1431,56,104331,101309,3022,743,702,41,1,93.2347925,Arch
b399b4ad43b8caa69f129e756e51ad4bc8c81de2,7,138,72,66,1,0,1,1,5,3,1,4,2.212994362,753,29,4,41,37,4,5342,4638,704,31,27,4,1,93.78898129,Arch
1ec89e9a94161aa5d48b8f170bf67633b389d997,44,2021,586,1435,11,1,12,2,34,71,4,17,4.766209811,12986,2,0,1251,1138,113,93673,84492,9181,766,698,68,1,94.01686874,Arch
2fc2b01d8647aafe2862db14fc169aa40d4ae3d5,84,6105,56,6049,65,0,65,1,41,27,6,31,5.882469828,4815,77,0,1092,532,560,61608,28306,33302,570,234,336,1,95.50236718,Arch
ccd70a7e486850ca6ce4d7fcc806e396ff0b6aa0,23,626,136,490,6,0,6,2,37,86,2,11,3.834263733,4091,5,0,455,423,32,25347,23075,2272,341,318,23,1,94.04151404,Arch
539621bd33893d99a07b8f739a1e965ca72acdc9,136,6839,777,6062,44,0,44,2,43,84,7,47,6.140715711,23786,63,3,2898,2344,554,179347,144054,35293,1703,1372,331,12,91.41401892,Arch
379cf0786fe9fea94ec8c0da7d467ae2fb30dd0b,54,4178,467,3711,29,3,32,1,35,17,3,18,5.183131611,3931,27,5,702,366,336,44956,22693,22263,379,214,165,1,96.03208105,Arch
1f7add92916c37b05be270d9c75a9042134ec506,366,6106,4909,1197,37,20,57,5,50,9,6,119,6.988191966,50456,25,1,4043,4099,56,314786,313226,1560,2371,2384,13,1,72.83480353,Arch
b58daf29ba7f0100d16deb793757d93d073c9a03,3,5,9,4,0,0,0,2,3,61,2,3,1.148834854,302,5,3,23,23,0,1803,1834,31,11,11,0,0,97.92499524,Arch
c5e10d668f9366f29bdf7721f7efe4140782527b,6,112,156,44,0,0,0,4,17,27,4,5,1.599431388,2315,45,1,165,177,12,17230,17583,353,115,117,2,1,94.13654618,Arch
33ec88fc3840c47a54b5862e4d276889c4121231,20,725,14,711,3,0,3,7,27,85,2,9,3.447083676,6592,7,0,691,633,58,47655,42768,4887,479,434,45,1,96.65441176,Arch
4d05680038752077ceaebef261b66a5afc761e10,44,4100,37,4063,38,0,38,1,2,15,3,23,5.000188698,1020,6,0,438,88,350,29189,4790,24399,245,62,183,1,93.04647785,Arch
fce1453fa608fcff5df4d5aca8c88107d4151b09,34,111,70,41,1,0,1,11,55,54,5,22,3.199908395,6709,11,0,558,557,1,44533,44325,208,273,273,0,1,96.0882462,Arch
236d1b0dec409efb9c7a9febd260b1060da6a9c1,13,39,34,5,0,0,0,3,4,126,1,12,3.554866136,1625,15,0,140,140,0,10488,10252,236,81,81,0,1,96.94052939,Arch
14d5d1100c69839d2bcfea26af0efdcd2057650d,7,444,8,436,2,0,2,1,13,120,1,3,1.383897724,464,21,0,64,30,34,5099,2519,2580,31,16,15,1,97.50631313,Arch
e4e2fbc3bb2c4796c6813114dd1c37ffa5a1e03a,21,2105,1,2104,18,0,18,1,3,14,2,10,3.832975705,299,16,1,215,23,192,15073,1649,13424,131,21,110,1,91.47920927,Arch
286055ce34bdbbac68c995a2710fc7be07734b12,21,1322,317,1005,14,0,14,1,8,12,2,7,4.081134069,2096,14,2,341,277,64,16760,12112,4648,283,243,40,1,94.02258905,Arch
6cdf59d92b1c260abae82bba7d30d8ac280bddbf,8,339,6,333,3,0,3,5,9,39,1,6,2.750209643,3502,19,4,421,398,23,24467,22384,2083,325,306,19,1,91.18753358,Arch
605b617cfa9a25bff48e618beccfaa7b4eaeee56,29,591,298,293,2,0,2,3,13,262,4,20,3.520188396,9623,8,0,817,760,57,67582,66081,1501,467,442,25,1,95.93768487,Arch
ff8313caf1dfe0b13fa9f160489a74600b0e8756,5,188,2,186,2,0,2,1,4,18,2,4,1.368324929,543,17,0,65,53,12,4904,3666,1238,49,43,6,1,90.1086335,Arch
17df517b812c9a37dd64014f0d5c35a3cfac0c4e,154,190,180,10,0,0,0,10,22,47,5,70,7.053074064,23554,15,1,2184,2184,0,143356,143274,82,1261,1261,0,1,89.56441149,Arch
7ce3ac778eb475bf23ffa31243dc0843ec7d089a,37,509,97,412,3,0,3,10,19,0,8,30,3.864618158,8933,16,2,786,753,33,58747,56090,2657,371,348,23,1,95.18026565,Arch
5ca0625b277efa3a73d2ae0fbdfa4c6163f312d2,55,767,570,197,1,0,1,10,20,40,9,39,4.857406777,17012,68,2,1573,1540,33,111970,110907,1063,864,846,18,0,95.45619117,Arch
641abe8ab7c1c4d9915c6582389476fa5f7ae067,6,1096,0,1096,4,0,4,1,4,18,1,4,2.081430583,213,0,0,117,20,97,8902,1060,7842,62,11,51,1,97.08772557,Arch
7aeb3ccff33c740c07456d7c9ec22e9d574e6650,10,57,1224,1167,0,4,4,1,9,32,3,8,2.437698933,2854,18,0,94,205,111,10736,19002,8266,45,99,54,0,97.08772557,Arch
e302c6bc12c7eb764781898fdee8ee302ef4ec10,10,1224,57,1167,4,0,4,2,9,68,3,8,2.437698933,1687,20,2,205,94,111,19002,10736,8266,99,45,54,1,97.08772557,Arch
162dc18fc6a1e1d0db420a4735bc8c5a0ba7cf12,14,57,1514,1457,0,6,6,1,9,22,3,10,2.797235818,3270,98,5,107,248,141,11274,20612,9338,53,126,73,0,96.84154176,Arch
c8ee40f8ae34607072a27d4e7ccb21fc4df13ca1,14,1514,57,1457,6,0,6,2,9,48,3,10,2.797235818,1813,72,4,248,107,141,20612,11274,9338,126,53,73,0,96.84154176,Arch
2ee1c3fb0cb9740dc6d924f5e6e638aec19ed9b3,7,266,26,240,1,0,1,7,16,83,1,6,2.02990305,4109,3,0,482,463,19,27749,26615,1134,360,345,15,1,90.43592634,Arch
bc0325f6ea0a734f106f21a2fcd4ead413a6cf7b,36,3489,266,3223,22,1,23,3,19,39,3,16,4.474198452,3040,4,0,589,321,268,35493,18630,16863,315,172,143,1,88.37130802,Arch
4c5b6923ccfaaa6616a934a3f690b1a795a42d41,30,1435,393,1042,5,0,5,1,30,33,3,17,4.064485216,5133,5,1,554,484,70,35740,30549,5191,291,247,44,1,96.62387066,Arch
ffcfb58bacab377bc72d20041baa54a3fd8fc812,61,1517,306,1211,5,0,5,30,60,118,8,43,4.510494186,25341,11,0,2298,2180,118,180279,172612,7667,1340,1269,71,1,96.41501476,Arch
2efd0760acb5de06adc0f0a4a045df792ff3b6ab,17,1503,10,1493,13,0,13,2,6,30,2,8,3.328744245,863,19,0,191,94,97,15087,5264,9823,127,73,54,1,89.24343798,Arch
617cc24ad1a28196b872df5663e9e0f48cd7f0fa,5,213,30,183,0,0,0,6,22,395,1,4,1.533258943,2331,12,0,196,174,22,18589,17412,1177,129,118,11,1,97.56808106,Arch
7a11de12764d8f68f296c6e68a22822318bfbefa,38,2296,152,2144,16,0,16,2,11,9,2,15,4.744907999,5503,10,4,672,484,188,43659,31561,12098,364,274,90,1,93.70056889,Arch
899ae70fdb70c1511c099a64230fd91b2fe8d4ee,12,272,8,264,2,0,2,1,14,232,2,9,3.274850949,1682,51,1,277,247,30,10107,8549,1558,159,145,14,1,95.37659487,Arch
11ad4ed26b6046201945f0e14449e1cbc5b6f1f2,2,75,9,66,0,0,0,3,6,99,1,2,0.99631652,460,17,2,47,41,6,4105,3650,455,19,16,3,1,93.17048853,Arch
12ff562d2bd77b6dc8676eac79cbd631185dac3c,8,169,83,86,0,0,0,1,7,15,1,5,2.110115219,2172,13,3,122,116,6,13997,13403,594,75,73,2,1,96.4490995,Arch
20786ab8a2a1e7735ab846e92802fb9f4449adc9,17,437,164,273,1,0,1,1,17,60,2,13,2.512908207,3696,15,5,377,342,35,22975,21622,1353,187,177,10,1,87.08549042,Arch
fc6c5f4285098d18cd7f6e81785f59e68a3b6862,69,195,198,3,0,0,0,1,18,4,1,25,5.665575449,13657,16,5,1205,1205,0,72879,72904,25,604,604,0,1,93.85645654,Arch
74241947c123c860a1b0344f25cef316440a70d6,77,4523,377,4146,29,0,29,3,62,70,6,55,5.320703045,21065,13,1,2382,1997,385,167583,141726,25857,1491,1258,233,1,86.61123367,Arch
f1e0018f12b66770ba3785be7aa8f5f6a80bab6f,4,168,20,148,0,0,0,1,3,8,1,4,1.285724484,807,19,8,53,38,15,5390,4198,1192,42,33,9,1,91.6832868,Arch
1277c62398c58690cd5a6aa78048335d5313ca05,3,170,5,165,1,0,1,1,2,272,1,3,0.988101791,106,0,0,23,8,15,1363,270,1093,21,8,13,1,91.67332268,Arch
8bc65b93189e249be43fe6cba2387ca83babc2c8,2,7,7,0,0,0,0,1,6,21,1,1,0.985228136,653,0,0,77,77,0,4638,4638,0,33,33,0,1,94.76577963,Arch
fe16d0de7c76105775c887b700751241bc82624c,1,0,319,319,0,1,1,8,8,158,1,1,0.0,319,19,1,0,36,36,0,2049,2049,0,11,11,0,94.80519481,Arch
da65d3cae99e8fee0ede9b5ed8630a3716d284c8,59,826,1942,1116,0,7,7,31,62,22,4,36,5.011623601,15634,5,2,1386,1445,59,86270,89635,3365,743,778,35,0,97.84779232,Arch
920537cac83d59ac05676fb952d5479c41adf757,62,2067,1249,818,7,1,8,31,63,47,5,38,4.991628277,15202,0,0,1518,1456,62,94786,91324,3462,806,771,35,1,97.84779232,Arch
0a5863939b8da149f6dab3ec0fdb86d77baa9739,10,36,1146,1110,0,7,7,2,8,166,1,6,3.071270476,1439,9,1,8,95,87,2199,8490,6291,3,42,39,1,87.60480026,Arch
b98c9ab4392727b6b9731aea88deaa5337a91dcf,10,103,34,69,0,0,0,2,17,66,2,6,2.819443722,2758,44,6,273,263,10,14933,14739,194,153,148,5,1,93.85365854,Arch
ad77cf42ba7d8eab086be1f6d91f465bf29164ed,13,340,276,64,1,0,1,1,18,14,2,8,2.961391075,3323,45,5,346,325,21,18617,18269,348,179,173,6,1,97.02993182,Arch
081061e14bd54be4ee8f4eef6253d5ec9d395ee7,5,116,0,116,0,0,0,8,24,287,1,3,1.24203675,1042,7,1,92,83,9,8514,7545,969,62,57,5,1,96.58369317,Arch
afa6bc0b100450b5d80a27bf5b87cbd4a0fbb3a5,4,184,10,174,1,0,1,1,15,176,2,3,0.92257839,682,58,0,91,81,10,6252,4737,1515,54,46,8,1,97.26556695,Arch
441076b2ccf66949310030fc6680bb68c259d8da,6,230,83,147,2,0,2,5,9,97,1,3,1.971324609,1657,59,1,136,125,11,12707,12028,679,78,69,9,1,90.68718905,Arch
57611d10b5ae5cb3580dcbd4abb4cdc131cbd575,2,284,0,284,2,0,2,1,1,0,1,2,0.953126983,0,3,0,16,0,16,1436,0,1436,12,0,12,1,90.75590551,Arch
7261f0850727aea611cd34e1bb07d684b44534f6,18,814,102,712,7,0,7,32,66,83,5,16,3.458041202,4457,33,2,571,510,61,28444,24915,3529,387,357,30,1,97.18598857,Arch
0c4f2fdc15982870b59d3458303973af95984266,14,772,63,709,5,0,5,5,32,69,2,7,3.344168456,1934,3,2,144,103,41,14599,10870,3729,70,50,20,1,95.11815113,Arch
aa6342c3c9af53e7064546becf987e26534d0764,16,156,291,135,0,1,1,2,33,27,2,8,3.331105652,2931,65,10,216,227,11,15397,16370,973,117,122,5,2,95.29164607,Arch
d412fb2fe642417460532044cac162bb68f4bec4,142,3296,2471,825,3,1,4,3,68,282,10,79,5.321546339,36897,16,0,3220,3185,35,238787,235690,3097,2005,1973,32,1,88.25265643,Arch
1d6978cde4c98c82c184f6404f49ef0f4832fbd6,6,70,15,55,0,0,0,11,40,2,1,4,2.354050586,1784,77,9,130,124,6,9248,8943,305,66,64,2,1,91.85261003,Arch
371526789d663dee85041eb31c27c52c81ef87ef,14,246,33,213,0,0,0,2,30,105,2,10,3.055693701,4299,13,3,344,325,19,26487,25073,1414,175,169,6,1,89.41200242,Arch
b4562e86e4b58d6151fdeea12e727b8c8881a213,14,33,246,213,0,0,0,3,31,0,2,10,3.055693701,4512,78,3,325,344,19,25073,26487,1414,169,175,6,1,89.41200242,Arch
783c9cb3693ff7d82cc3d43a4964c64a4da19436,14,243,29,214,0,0,0,3,32,0,2,10,3.040572626,4299,14,4,345,325,20,26504,25073,1431,176,169,7,1,89.40343782,Arch
c8a2033c275e21a752893fc89311e1f6846f5a78,3,99,2,97,1,0,1,1,9,51,2,3,1.114673716,760,1,0,63,60,3,6462,5804,658,30,28,2,1,90.31896137,Arch
75040ee9e5caa0783009b6ef529d6605e82d4135,26,365,299,66,0,0,0,3,35,126,5,12,3.536496903,6425,79,4,650,650,0,29196,28842,354,601,601,0,1,96.75404047,Arch
50c2b76d725a71608a38217370b1ac45cedae405,14,28,242,214,0,0,0,4,37,12,2,10,3.051779948,4546,1,1,328,348,20,25283,26714,1431,169,176,7,1,93.22847241,Arch
d5026e9a24850bdcce9f6df3686bf2235d7d01c4,48,883,181,702,1,0,1,2,40,69,3,17,4.937551753,9081,61,3,1060,978,82,56616,51400,5216,708,670,38,1,97.19312382,Arch
c89bf1de20a1c9eb7873b4671ad3d37bc7111245,5,105,15,90,1,0,1,1,9,55,1,3,1.23811376,519,83,5,46,43,3,3087,2514,573,18,17,1,1,89.02136884,Arch
61148c1c43c9ff5ba04b6c174e9e2a006db9e7b3,47,935,404,531,0,0,0,4,42,183,5,30,3.79226223,16044,63,2,1689,1613,76,107234,102649,4585,1009,978,31,1,86.40022204,Arch
00cd35f90ad0cd96a943edd148bf881fc4b7bb5b,6,118,5,113,2,0,2,6,40,29,1,4,1.690256112,1130,0,0,50,44,6,6384,5983,401,29,24,5,1,91.82532128,Arch
8fef50e237b2342ea3366be32950a2b87a9608c4,27,405,109,296,1,0,1,3,41,240,7,23,3.52427775,9592,3,2,838,825,13,62826,60869,1957,570,557,13,1,92.28462095,Arch
826a04d1425f47fdd80c293569a359021d1b6586,14,1130,32,1098,9,0,9,1,43,29,2,9,3.312173088,4778,23,1,596,512,84,37435,31278,6157,452,394,58,1,89.70684039,Arch
02331fc223ca1272e3a9039c6563b9d511a8fbef,19,645,119,526,2,0,2,2,45,155,2,16,3.399509917,4627,91,9,501,434,67,28814,25611,3203,259,228,31,1,96.67152897,Arch
1df5ded433eced3bbb66137bc741e616beab9a70,8,99,10,89,2,0,2,1,3,121,3,3,2.559133329,4854,66,3,318,318,0,38312,37881,431,161,161,0,1,96.41545282,Arch
b4441abcf74951ec0ce28593b96baa84456a97d3,4,83,0,83,1,0,1,1,46,3,1,3,0.989692929,1966,4,1,301,297,4,9237,8850,387,294,290,4,1,97.05249842,Arch
21db6d7a84d4a83ec98c110e92ff9c92d05dd530,50,1081,199,882,3,0,3,8,49,57,4,34,4.578583525,15631,20,4,1619,1531,88,92492,87377,5115,1005,958,47,1,97.22222222,Arch
0e1c592c697c8e55491d869fb18126c3ff1d87a2,1,0,59,59,0,1,1,3,3,1114,1,1,0.0,59,25,0,0,5,5,0,232,232,0,5,5,0,96.60291897,Arch
4783176554e7d4ae7b7296cf633d750ae27e65d9,53,2251,460,1791,14,1,15,13,48,277,4,30,4.671909947,12512,7,0,1430,1309,121,85788,77846,7942,875,809,66,1,96.28970427,Arch
9e8308527a3a19bf58397ededfbf91a70568060e,3,0,162,162,0,0,0,8,16,162,1,3,1.487988089,1238,6,3,70,85,15,8747,10037,1290,35,43,8,1,94.15881904,Arch
23dca6c237517bc9d9407556af6b1042f09ae76b,24,806,301,505,8,0,8,37,81,205,5,10,3.815354957,2858,9,2,297,266,31,19511,16743,2768,111,91,20,1,91.70574836,Arch
ab3fbb88950ca351723f2f46da9f40ba325a03b5,12,239,235,4,1,1,2,3,28,60,1,7,2.861163152,2547,18,1,170,169,1,15347,14862,485,93,93,0,1,91.72485131,Arch
178767948e906f673d6d4a357c65c11bc574f619,40,687,1284,597,2,5,7,1,54,41,4,29,4.338183277,12588,24,5,1084,1138,54,68295,71845,3550,736,780,44,0,91.43154336,Arch
a60fab3a5c6df1b9b3d32f192d4c6ca4ff1d6f6d,41,1296,687,609,5,2,7,2,55,92,4,30,4.363348088,12550,100,6,1229,1174,55,75994,72389,3605,821,776,45,1,91.43154336,Arch
073c318d9fd83d40b1dde1cc149def617ce31e8f,4,12,0,12,0,0,0,4,26,710,2,4,1.918295834,944,68,3,79,79,0,6958,6900,58,29,29,0,1,94.72270198,Arch
57c8113ee1941615a03f0efc2e3d46b634e940eb,9,68,61,7,0,0,0,1,25,512,2,4,1.918579118,2161,71,6,129,132,3,16180,16144,36,78,79,1,1,95.31122956,Arch
e528dd798ab8ce6e4d444d2d771c107c503e8f25,41,4069,21,4048,33,0,33,1,83,35,5,18,4.803467566,3898,7,1,877,488,389,38919,20176,18743,588,362,226,1,94.63982103,Arch
9735f4b8efaa3d333e496c1159bd9ae0b222519a,10,286,129,157,1,0,1,1,2,9,2,6,2.088504823,1749,8,1,218,200,18,9135,8321,814,112,103,9,1,94.61530602,Arch
916f12b7dd4b635c790b17876fa49fb786233e94,35,586,1536,950,3,12,15,1,16,393,2,17,4.16813403,4253,12,2,315,391,76,21527,28136,6609,213,248,35,1,88.37680768,Arch
b8dad628e584e0acfa8ef6ba0056f7cb6efafad0,34,972,419,553,4,0,4,6,35,86,2,17,4.051737901,8408,74,1,832,794,38,56349,52612,3737,499,471,28,1,89.61998593,Arch
57d5da68aa646adfd327394daea720cb3d592b1d,13,236,61,175,2,0,2,2,5,126,2,7,2.970432774,1344,84,2,130,113,17,8211,7020,1191,85,79,6,2,88.64517693,Arch
eeafd24f4c3a65e107867e30eb499b4aec69d7e5,7,1197,776,421,0,0,0,11,25,235,2,5,1.408522455,3747,13,2,516,376,140,30204,25397,4807,293,237,56,1,87.72508242,Arch
440525ccbb001884840efadcb51eda44bba5e624,6,172,101,71,1,0,1,1,18,87,2,6,1.512438229,1470,116,8,134,132,2,8684,8347,337,53,52,1,1,97.79811267,Arch
f0585facd6e8ff8c226e1e6c7b66933eac8ea4c6,7,52,21,31,0,0,0,11,31,231,2,7,2.134456201,3949,76,2,426,421,5,27901,27644,257,226,223,3,1,97.42511372,Arch
2eda3de7f91335c17458f106f4edde8d8ffbb978,34,540,334,206,2,0,2,1,60,84,3,24,4.302313485,10068,124,6,882,860,22,58626,58250,376,511,498,13,1,97.69,Arch
e355ab52db4af71880ac6e9b67991221d4b9c569,18,416,58,358,3,0,3,5,62,11,2,12,3.38888767,6009,128,10,491,460,31,34993,33371,1622,277,260,17,1,89.23038166,Arch
aa3c4ecda57c412b5822348d40cdf983c0035fb7,9,776,806,30,2,0,2,6,34,11,1,4,1.520140608,2550,129,11,194,185,9,14145,15274,1129,144,111,33,1,88.23440568,Arch
5ed35bff836f898d420e9a7ef8c47dc2ded7dca3,42,1137,1072,65,8,5,13,2,37,161,3,21,4.571641789,8048,15,0,740,730,10,50921,53004,2083,450,420,30,1,86.63069544,Arch
1bb05325637740498cac548872cf7223e34950d0,12,62,33,29,0,0,0,14,25,352,2,5,3.194439786,2555,81,2,224,222,2,15046,14692,354,110,108,2,1,95.7782516,Arch
e3fc74668fc43fefd73087ff725245b8ed85b4a1,12,33,62,29,0,0,0,14,26,0,2,5,3.194439786,2584,82,3,222,224,2,14692,15046,354,108,110,2,2,95.7782516,Arch
0223c442ec9a746834d1b2f2582c5267b692823a,72,2496,1868,628,15,10,25,1,38,264,2,43,5.325928537,15779,17,2,1391,1394,3,111345,110634,711,805,784,21,1,86.32659895,Arch
e0285800fb5609fcf27b523109e369a8d7d6b27d,15,1185,70,1115,9,0,9,1,23,103,4,7,3.085559616,1767,0,0,347,254,93,19663,11975,7688,87,47,40,1,88.34862385,Arch
6d109c6de5078560abab96f96dc2a9bfe9ed8e57,22,170,59,111,0,0,0,9,40,34,1,18,3.762245283,8968,87,4,919,907,12,61154,60408,746,479,472,7,1,90.91015442,Arch
dfe3b84715e8fecfa96ef615c217f5eaf0da94e8,6,195,52,143,1,0,1,2,85,75,2,5,2.075384258,4229,1,0,523,516,7,23317,22662,655,358,352,6,1,93.40274199,Arch
90f9b4562abaef955cbff54f539ec867d8708b60,11,158,26,132,0,0,0,3,67,45,2,8,2.996422602,3075,25,4,286,270,16,19561,18820,741,147,141,6,1,97.23324397,Arch
24def0b30dabd3c447fbfbde636868f1913e9074,15,211,90,121,0,0,0,18,69,302,5,9,2.426960448,6083,20,1,666,649,17,42639,41930,709,303,292,11,1,92.13277574,Arch
ca9bfa2a4000575dbaa379c91898786f040a9917,25,1227,91,1136,9,0,9,15,72,106,4,18,4.035217836,5068,20,2,670,579,91,33520,26404,7116,515,463,52,1,92.10844414,Arch
435ea1543c034194d7ca0b589b7b043fc49c07ac,7,134,188,54,0,1,1,3,86,38,2,5,2.596842092,5716,96,8,601,603,2,34605,34505,100,450,450,0,1,96.03551518,Arch
8340ccb503962876cf83de40949264836f88c04d,17,116,80,36,0,0,0,15,28,50,2,6,3.79973608,5772,102,14,453,451,2,38082,37692,390,233,231,2,1,96.86293914,Arch
5755ff25a49aa495e418acde7ef8d246e16b4973,12,956,500,456,3,1,4,10,34,4,2,12,2.374539774,3276,7,6,408,388,20,23228,21848,1380,222,208,14,1,95.7956778,Arch
7de5d1760191128c86ef40ac2f9cb57e87328e3e,8,221,28,193,0,0,0,2,25,50,2,6,1.629449128,3081,109,14,262,245,17,21717,20136,1581,158,155,3,1,92.96437556,Arch
e483f7c776ed53015d08b78fc33729892dc2143c,8,221,28,193,0,0,0,2,25,49,2,6,1.629449128,3080,109,14,262,245,17,21717,20136,1581,158,155,3,1,92.96437556,Arch
69d14353bcc20c07d53b7835940c4117cfbf5110,52,223,795,572,0,1,1,40,87,88,8,40,4.304541445,20881,22,3,2057,2109,52,123170,126779,3609,1178,1200,22,0,92.94003084,Arch
7de5d1760191128c86ef40ac2f9cb57e87328e3e,8,221,28,193,0,0,0,2,25,50,2,6,1.629449128,3080,109,14,262,245,17,21717,20136,1581,158,155,3,1,92.96437556,Arch
bd084704210ee0247a4b31a6a32e5de3afd7048c,3,4,8,4,0,0,0,2,4,511,1,1,1.584962501,951,164,9,177,177,0,5254,5286,32,24,24,0,1,90.30180346,Arch
d0087d40402133453c3ca3da1a566545f0ca9d64,10,214,13,201,2,0,2,1,77,237,2,7,2.297477268,1580,170,8,174,164,10,9861,8861,1000,103,95,8,1,91.93151418,Arch
62b3c9058c0a16b6d2158e8282461dd035003390,164,1503,6332,4829,1,26,27,0,88,68,11,95,6.008076666,55392,2,0,5119,5477,358,317928,343291,25363,2733,2955,222,1,93.52352845,Arch
9864d30fc169f51a6588848dfd2445360e133e27,3,4,8,4,0,0,0,2,4,572,1,1,1.584962501,951,164,1,177,177,0,5254,5286,32,24,24,0,1,90.32258065,Arch
eca2f2cc65796c566af733520608bc78d600063a,10,214,13,201,2,0,2,1,76,275,2,7,2.297477268,1579,169,6,174,164,10,9849,8849,1000,103,95,8,1,92.01154957,Arch
5c0e4ce0055f0481a4cd6b7b44f5d0b266fd8f44,62,3299,1029,2270,17,1,18,1,90,104,7,42,4.867694035,15440,125,9,1735,1599,136,103965,93499,10466,927,803,124,1,97.45691663,Arch
a4e622ac61ecaf8520d137421f16bc206b864732,44,1176,47,1129,11,0,11,6,81,367,4,21,4.27884273,8720,12,0,1016,912,104,55051,48900,6151,683,615,68,4,94.19463401,Arch
2444f40a4be5bbf0bf210dee5690267a9a1e35c8,16,368,272,96,4,4,8,1,82,166,1,8,3.481626547,3803,2,0,434,426,8,18053,17461,592,387,384,3,1,92.98853062,Arch
4500e615437562b62c6043ee70b53c870f555891,180,1589,8535,6946,5,49,54,0,89,79,11,92,6.352304974,52787,3,1,4511,5188,677,291587,326671,35084,2374,2807,433,0,93.58988102,Arch
f0c2912d35467ff5f6514c01ab440eb1ca8d0d8f,176,8506,1741,6765,49,5,54,1,90,143,11,88,6.340619773,43968,8,2,4944,4299,645,315279,281235,34044,2685,2267,418,0,93.58988102,Arch
7be8944723d5cd5c1c54f4f94bdafe78351570ac,167,1652,8318,6666,5,49,54,0,89,88,11,86,6.249788651,44800,24,0,3631,4254,623,237780,270931,33151,1908,2318,410,1,93.58988102,Arch
d7afc58d0c9cf7f6625a08e77b821a14548fafc0,166,8316,1650,6666,49,5,54,1,90,147,11,84,6.247011906,37861,4,0,4229,3606,623,269173,236022,33151,2308,1898,410,1,93.58988102,Arch
dd67878bd8a88c2c5492ac297aa5887b497af3eb,165,1647,8316,6669,5,49,54,0,89,88,11,85,6.24539031,43896,120,9,3523,4146,623,232399,265577,33178,1847,2257,410,0,93.58988102,Arch
b2b23f5d3a14fae721df34a162e0ed717efe488f,148,8074,1565,6509,48,5,53,1,90,165,9,75,6.133670696,31350,2,2,3616,3011,605,225486,193317,32169,2021,1616,405,1,93.74665382,Arch
251d4eb3b64704b9dd51bf6f6ecb5bf47089b745,5,149,10,139,0,0,0,7,85,46,2,5,1.46587506,4005,28,1,523,512,11,19982,19079,903,423,419,4,1,97.373522,Arch
cc8ecf265ff6e4d9e298c6e1732c1dcf6abe2032,201,1758,8818,7060,5,49,54,0,89,73,12,112,6.427409888,52104,0,0,4363,5029,666,279906,315932,36026,2163,2595,432,0,96.04509333,Arch
bc95571caade9ceef00abf24e3e6e82fc9643c05,165,8264,1423,6841,48,5,53,1,92,171,11,89,6.201546212,35900,30,1,4210,3567,643,253730,219554,34176,2219,1799,420,1,95.99815157,Arch
eac1a02a53e6ae501eee986dd75cf1cc907f3fcf,170,1426,8329,6903,5,48,53,0,91,71,11,94,6.231160931,44473,84,6,3791,4439,648,230146,264724,34578,1910,2333,423,1,95.99815157,Arch
f1e3762a947d9bc978beb5bb5ae845b8d5dd6290,166,8301,1409,6892,49,5,54,1,92,179,10,89,6.192315277,37810,12,0,4576,3929,647,266340,232313,34027,2435,2007,428,1,95.23898258,Arch
27628fa1d307563b74f2da7c4b619f98ffb8e1cc,167,1409,8300,6891,5,49,54,0,91,78,10,91,6.192616806,44786,127,16,3941,4588,647,232742,266761,34019,2010,2438,428,0,95.23898258,Arch
6cdcd89afa40a75c95f3c060976ef72f1b2318b6,173,8527,1678,6849,50,5,55,1,92,182,11,91,6.270542113,39325,13,1,4736,4102,634,275065,241625,33440,2492,2069,423,1,92.43218391,Arch
100470a46d943b7840cf300c18a67e0db0c198a6,198,1907,9972,8065,5,54,59,0,91,80,11,106,6.470864398,54185,34,6,4811,5545,734,283596,325478,41882,2352,2839,487,1,92.34515714,Arch
0a4553b73eae36e8610cb6a9f42196b35f02ffd8,4,68,3,65,0,0,0,20,92,76,2,3,1.520950583,3970,128,9,405,397,8,28131,27571,560,186,184,2,1,95.9894806,Arch
209f91cb3374e94f1597e59a82a82d6846c4b994,199,9977,1977,8000,54,5,59,1,92,180,11,104,6.481512492,46970,37,7,5651,4925,726,330163,288841,41322,2868,2383,485,1,93.13369153,Arch
97dab479315c76cab12f0e23243df2dffddb0e8d,199,1975,9975,8000,5,54,59,0,92,79,11,106,6.480807172,54970,35,6,4925,5651,726,288841,330163,41322,2383,2868,485,1,93.13369153,Arch
195dac90fa89a05ee10ff9b37ad65fdfd07014ef,188,8917,1838,7079,50,5,55,1,92,197,11,99,6.387633825,45108,38,8,5370,4716,654,314121,279171,34950,2726,2289,437,0,93.22234496,Arch
5ce45c440baeb38f57335c1a702ec91b721add65,14,0,0,0,0,0,0,1,1,0,1,4,0.0,980,41,2,51,51,0,4600,4600,0,38,38,0,1,92.69345095,Arch
4bea7587384842ac82590b0a9e785b8f73690885,9,347,38,309,2,0,2,19,31,126,4,8,2.485957067,2850,15,3,347,324,23,20835,19264,1571,197,180,17,1,92.12972526,Arch
1d3049540f2b9d36a81ff720e55d9db9f8151fd6,227,2085,10134,8049,5,53,58,0,92,70,11,111,6.608858674,62340,129,10,5758,6514,756,334869,376252,41383,2870,3353,483,1,89.76100629,Arch
db93ad2f4bc9b3c357f065882c3d8cbb1c0b9c07,228,10136,2087,8049,53,5,58,1,92,166,11,109,6.610683592,54422,44,1,6528,5771,757,377281,335892,41389,3356,2873,483,1,89.76100629,Arch
101be1a0139ad550a509cf3d2c2a101ea62930b4,228,2082,10127,8045,5,53,58,0,92,71,11,112,6.60721131,62471,175,1,5773,6528,755,335926,377281,41355,2873,3356,483,1,89.76100629,Arch
a08a2b730674d57a0c40545023b21f0bac34e7df,223,10087,2058,8029,53,5,58,1,92,177,11,106,6.58443947,52963,35,6,6391,5636,755,368511,327190,41321,3259,2776,483,0,89.76100629,Arch
84fb390e42cbbb72d1aaf4cf8f44cd6fba049595,242,2415,11052,8637,6,55,61,0,92,66,11,114,6.738487595,68054,2,2,6113,6904,791,372924,418030,45106,3022,3524,502,0,89.75389252,Arch
dd4ce1bdfd59cd386437169856201476df68ffa7,242,11054,2417,8637,55,6,61,1,92,173,11,111,6.738753593,59417,142,5,6904,6113,791,418030,372924,45106,3524,3022,502,1,89.75389252,Arch
f87c47352aab70883777d80e353f9833e5aa1caa,15,745,138,607,0,0,0,12,45,110,3,9,2.372920887,5667,29,0,554,511,43,40905,37153,3752,303,288,15,1,89.98611937,Arch
0bd38f26ca4076dc45ee1cba4f8525550b96ce40,68,216,175,41,1,0,1,2,50,330,3,27,5.457965945,14226,85,0,1181,1180,1,91901,91833,68,567,566,1,1,97.53099068,Arch
a68e1dc2dba475b9a63779f3afa0b5c558a7cd3b,45,1613,670,943,7,0,7,11,90,319,5,24,4.389418936,15665,19,3,1698,1647,51,97271,92966,4305,1133,1087,46,1,91.08852382,Arch
5927bdd1c0fab202474af47b9e035680b345c563,48,2180,511,1669,2,0,2,3,91,260,2,22,4.264488365,15568,31,2,1707,1518,189,99121,88845,10276,990,911,79,1,91.16283562,Arch
b8601a9f58ae4dc5099cc7f828df7fd8d0aeb798,105,564,504,60,1,0,1,14,95,215,9,69,6.105932475,32839,37,1,2711,2711,0,220819,220297,522,1446,1447,1,1,90.54798492,Arch
24f738fe68d03fa15755d8a53aeb6e25921c6e94,5,92,16,76,1,0,1,13,97,113,1,3,2.208392,1880,148,8,234,223,11,12075,11662,413,65,62,3,1,93.88575152,Arch
3f263b82ce6687a8275419ce53ba23348561bdcb,7,440,390,50,1,0,1,16,32,36,1,4,2.091574841,2626,23,7,265,264,1,16329,16194,135,106,108,2,1,93.00307865,Arch
464027ec375b375475999c78c56612506753f77e,5,382,64,318,1,0,1,1,5,43,2,4,1.114672038,699,25,7,89,76,13,5352,3779,1573,53,44,9,1,91.19610128,Arch
ba4e732ba75e12a02d07c09f2662678bdcafbdc2,7,65,17,48,0,0,0,2,28,354,4,5,2.579222994,1297,155,11,140,133,7,7857,7511,346,76,71,5,1,90.08097166,Arch
c77b2591d057fdc1c014a80284024e19254e3606,14,99,113,14,0,1,1,13,42,424,4,12,3.214915074,2388,92,5,184,182,2,12641,12530,111,110,108,2,1,97.9566963,Arch
3fdc9332e58930aa8e4fef0d0f85ffbec78c6e7b,14,452,217,235,0,0,0,15,36,189,3,8,3.407268471,7740,2,2,594,578,16,54372,53429,943,257,243,14,1,90.34657798,Arch
3b2da9f13847475be3dcef13b3d25df8818cecc7,2,30,6,24,0,0,0,5,14,312,1,2,0.943601631,319,35,2,31,29,2,1712,1583,129,16,14,2,1,88.80229696,Arch
051ad0b033993fcc7c68bdc96368fc6f0b822a55,7,136,53,83,0,0,0,14,32,45,3,7,1.625074099,3077,1,0,261,258,3,23735,22652,1083,132,130,2,1,88.55399634,Arch
4b471772aa130dc4bb577edbd42f2a617f205da0,5,81,5,76,1,0,1,4,4,909,1,2,1.153481768,220,50,1,17,12,5,1313,929,384,14,11,3,1,88.46936699,Arch
c9ffdc493eb8d1971b281e3b84275f4ef5905e4b,7,236,7,229,3,0,3,1,42,132,1,6,2.20479734,1400,51,2,151,137,14,10937,9855,1082,69,59,10,1,90.07352941,Arch
575bc6346825796e091a12be5a53b04980f82637,24,1050,532,518,1,0,1,3,103,108,3,15,3.048475502,10437,45,1,1169,1160,9,66623,61274,5349,727,709,18,2,93.37194948,Arch
548000b0d635067acf7574c4cf5122759e79b52b,5,178,25,153,3,0,3,4,43,2,1,4,2.305129413,631,52,2,85,76,9,4757,4209,548,40,34,6,1,89.57335655,Arch
8859b48b2a13494c89603799684f317f8777726a,8,200,3,197,0,0,0,19,26,135,2,4,2.41550918,2964,0,0,288,257,31,21648,19869,1779,110,102,8,1,92.56623604,Arch
83cff3afee15e129034eb51e68a1734c55d85da2,2,113,0,113,1,0,1,4,6,2,1,2,0.762423324,125,53,3,13,5,8,1378,772,606,9,5,4,1,95.02590674,Arch
e8918b6c2c30968caccc4fc3c166082503b4cc9d,3,96,4,92,1,0,1,1,44,7,1,3,1.477157746,649,55,5,84,77,7,4776,4334,442,38,33,5,1,95.00257069,Arch
7446ff95a7b099d8016b7ca48fdeed9b290d710f,70,810,856,46,2,2,4,2,54,258,2,27,5.207319526,14359,95,2,1196,1204,8,94991,96296,1305,738,738,0,1,92.27748691,Arch
799c78e6888ef6a375c6779c3cfe7067756d4be9,172,1612,265,1347,24,0,24,1,1,0,1,46,4.897274169,29589,189,3,2741,2610,131,161094,156653,4441,1509,1385,124,1,87.54933065,Arch
5f570ea151d0212ab1bb2d1f5693035626b76d31,30,1214,818,396,3,0,3,5,107,389,7,22,3.449301806,10452,0,0,1057,1033,24,64186,62954,1232,658,635,23,1,93.23878133,Arch
a1c42fcc0708f1838391e3e5c3cb7541b1fcd78f,2,14,39,25,0,0,0,1,21,37,2,2,0.993570476,982,190,2,118,121,3,4753,4886,133,62,64,2,0,94.76323657,Arch
eaa4c4f2e2ccdb42f62d91c001a0350de183e4dc,19,719,391,328,2,0,2,19,30,148,4,12,3.064441337,7125,55,9,653,626,27,51284,49539,1745,331,308,23,1,92.86940106,Arch
28dafa774ee058a4d00fc15b1d7fffc0c020ec3e,38,1942,150,1792,4,0,4,22,108,224,4,25,4.219847182,17980,52,3,2225,2035,190,118792,106224,12568,1357,1256,101,2,92.24667349,Arch
444ff496a444ff82385421844aef5b4db01d8892,49,7444,55,7389,29,0,29,1,109,20,3,26,4.947544913,10935,30,3,2529,1400,1129,103992,55088,48904,1268,843,425,4,94.55131335,Arch
52205897a7fb199d31f44cf6da1a926ebd960848,33,1226,633,593,1,0,1,15,45,66,3,16,3.021149871,15032,45,2,1380,1340,40,101258,97953,3305,642,608,34,1,97.84067698,Arch
a2c226132fc7a9eb38a0cf946c73b0abe353d380,5,34,4,30,0,0,0,2,113,107,1,4,2.127773932,3751,69,8,459,455,4,17309,17133,176,403,401,2,1,94.37608319,Arch
9e87d164b3f39d795ef70a1f22ba57353d6e198f,33,1226,633,593,1,0,1,15,45,46,3,16,3.021149871,15033,45,9,1380,1340,40,101258,97953,3305,642,608,34,1,97.84067698,Arch
3e97c88c4ff9cbeb312805daf6d52da5f1bcb0bd,5,34,4,30,0,0,0,2,113,97,1,4,2.127773932,3751,69,13,459,455,4,17309,17133,176,403,401,2,1,94.37608319,Arch
0048b78d18499280f09df8866952968e8efdb45b,105,1294,2983,1689,1,4,5,1,111,125,10,57,5.400808159,49464,193,3,4928,5080,152,295905,306202,10297,2448,2532,84,1,95.26297756,Arch
52205897a7fb199d31f44cf6da1a926ebd960848,33,1226,633,593,1,0,1,15,45,66,3,16,3.021149871,15033,45,2,1380,1340,40,101258,97953,3305,642,608,34,1,97.84067698,Arch
d886e9eb8df9d74d2b8a00a98e851704af183364,15,400,748,348,1,1,2,22,65,20,3,11,3.101942518,7458,201,8,646,671,25,50623,53613,2990,307,322,15,0,97.97723364,Arch
569a76a9a5389efb74ec88b81c616f8ead58df5c,1,2,0,2,0,0,0,6,10,110,1,1,0.0,318,209,2,24,24,0,2389,2370,19,21,21,0,0,92.5008259,Arch
6285a239a35c5808ba2eea00193a51564c716ab6,18,204,173,31,0,0,0,2,65,301,3,9,3.177977283,4629,210,3,625,615,10,27466,27008,458,290,288,2,1,95.26523189,Arch
701f8c039d1cd0104cff4d04f60b159c9e38d84e,26,126,87,39,1,0,1,2,10,122,1,20,4.036274178,7511,5,0,630,632,2,42970,42574,396,361,363,2,1,94.58489779,Arch
61030d8e7a5a05e215efed672267ac163b0cbcf6,41,1510,237,1273,12,1,13,2,118,267,3,25,4.336124421,9724,8,0,1298,1191,107,60405,53372,7033,875,799,76,1,93.38842975,Arch
91a5f3db1dd69813e343ff9df0a2c1b26caea8ca,319,2857,8026,5169,8,42,50,0,114,93,12,161,6.938236036,90702,118,0,8199,8631,432,537643,567707,30064,4335,4583,248,1,93.82528919,Arch
891c4151943c07c4837b760f819947b088a7c112,1,2,0,2,0,0,0,6,10,190,1,1,0.0,318,207,1,24,24,0,2389,2370,19,21,21,0,0,92.49817917,Arch
78ec3a8c52e971380be28927aac0d39ca58eeb12,18,204,173,31,0,0,0,2,65,373,3,9,3.177977283,4629,208,2,625,615,10,27466,27008,458,290,288,2,1,95.26382901,Arch
8cb8e04bee544b9fb2360a32979e4d739038d61f,26,126,87,39,1,0,1,2,8,163,1,20,4.036274178,7511,5,0,630,632,2,42970,42574,396,361,363,2,1,94.61493436,Arch
3759a38b99cf9bb7540cd1881879cc0547a25e70,124,5633,1696,3937,36,7,43,1,121,181,8,71,5.877498245,30947,46,0,3441,3132,309,206925,184907,22018,1925,1734,191,1,92.45933522,Arch
6db0720f61e31097a0b07635c4ce9acce581df1d,151,2095,6276,4181,7,36,43,0,117,73,9,93,6.076502119,45869,46,0,4167,4513,346,258605,282872,24267,2207,2413,206,1,92.44464128,Arch
f85cd9b16d2bd0c49fb6a05a4be627dffb4c2065,127,5659,1711,3948,36,7,43,1,122,175,8,74,5.902836108,32606,222,3,3616,3308,308,217624,195536,22088,2018,1827,191,2,92.46987952,Arch
ad27bc352c507fc906495152ccf9d2e6789a9b71,126,1712,5674,3962,7,36,43,0,118,88,8,73,5.901635031,35732,220,14,3219,3530,311,189732,211884,22152,1788,1980,192,2,92.46987952,Arch
f5ab921300654e61a448ac447eb4532a60e49b9c,124,5633,1696,3937,36,7,43,1,123,177,8,71,5.877498245,30949,0,0,3438,3129,309,206833,184815,22018,1927,1736,191,0,92.46987952,Arch
7b98ecfc2a92daf5b04f3823f71fab0ab96e3fac,127,1720,5666,3946,7,36,43,0,119,87,8,74,5.904752065,35501,0,0,3176,3484,308,188098,210183,22085,1759,1951,192,0,92.46987952,Arch
fd8f7c5f6c0bbfbed829f5d1a1d250ca4752d503,124,5633,1696,3937,36,7,43,1,123,177,8,71,5.877498245,30949,86,2,3438,3129,309,206833,184815,22018,1927,1736,191,1,92.46987952,Arch
b3c77338bfe932061ddc1858e19a3ba8651d0d0d,124,1697,5634,3937,7,36,43,0,119,90,8,72,5.877519927,34886,88,7,3129,3438,309,184815,206833,22018,1736,1927,191,1,92.46987952,Arch
5aaac21d1dad8d462f96d47bca7d55494a8a8ae1,152,5730,1790,3940,36,7,43,1,123,222,10,85,6.000027309,36326,0,0,3794,3483,311,242535,220394,22141,2150,1959,191,1,92.36357193,Arch
622d27a099f5dec96f992fd423b666083da4b24a,164,1816,6044,4228,7,38,45,0,119,113,10,90,6.117231007,44010,90,5,3891,4232,341,242574,266297,23723,2103,2317,214,0,92.31722429,Arch
c5c4cfec915fad198ccb57d00bc8d875a78e794b,165,6060,1834,4226,38,7,45,1,123,209,10,90,6.131377919,40017,33,0,4262,3921,341,267847,244133,23714,2321,2107,214,1,92.31722429,Arch
1c43c590aca7ac13f474eb5818b6f3859c5dbf40,1,325,0,325,1,0,1,1,1,0,1,1,0.0,0,34,1,33,0,33,2245,0,2245,11,0,11,1,96.30846126,Arch
26c967bac60de394ca78e79d27647067680ed630,2,312,0,312,2,0,2,1,1,0,1,1,0.692809885,0,35,2,25,0,25,1456,0,1456,17,0,17,1,93.98336578,Arch
47792a318656ecae0203d44f637742a152bbb0e4,30,1930,81,1849,6,0,6,2,64,110,2,14,3.152794275,7095,225,1,879,661,218,51216,40271,10945,387,310,77,1,95.00414785,Arch
c0e15879668537d6de96db2994fc68209ad0baa5,79,2914,2798,116,8,5,13,15,113,255,8,37,5.659606274,16947,2,1,1660,1672,12,110608,109090,1518,825,822,3,1,94.59178858,Arch
126b88b48ddf3af4ad6b48551cab09eea4c800c9,37,918,670,248,2,0,2,15,124,220,8,23,3.823267961,26230,31,0,2167,2154,13,185047,183531,1516,1260,1248,12,1,94.74304805,Arch
9282611baec5069156f627a2c96ee8cdd480bf90,16,2006,10,1996,8,0,8,1,29,75,2,8,2.796707492,3478,10,0,558,312,246,31932,19413,12519,270,164,106,1,96.33442371,Arch
a33bdd32e37a0a7859256f9db32d2bef0a44c1fa,34,690,820,130,1,4,5,5,30,624,4,19,3.909298526,5881,68,2,646,658,12,33183,34444,1261,324,322,2,1,94.78785662,Arch
cdaec5a8da060157eb7426b5b70419c5f8868e04,16,228,5,223,1,0,1,1,129,109,3,11,1.027486938,4727,1,0,574,507,67,25005,20045,4960,445,419,26,1,96.95096827,Arch
e49c2826e415046eceade2d123e213d80c6b108d,5,81,34,47,0,0,0,2,3,57,1,2,2.208702893,1592,243,5,208,204,4,10969,10640,329,81,79,2,1,96.35442618,Arch
0cbe468b6cfb58a57aafff14acec792b233456d6,8,228,5,223,2,0,2,4,130,194,2,6,2.112302892,6309,231,3,673,652,21,39218,37982,1236,476,465,11,1,95.72610986,Arch
6cf5c2447a687003338bb5ce4797ad9ce66aaf7d,7,195,36,159,0,0,0,5,23,316,4,5,2.205818591,2115,6,3,233,214,19,13150,12281,869,143,130,13,1,91.24069059,Arch
8ef49838f494a7d4712e9665d5aded87fa51ad97,7,36,195,159,0,0,0,6,24,114,4,5,2.205818591,2272,234,1,213,232,19,12277,13146,869,129,142,13,1,90.96512708,Arch
94be4a85045e606cb43ab10e035cfa98a6813ea4,4,157,2,155,0,0,0,19,54,174,2,3,1.544172874,1970,238,5,217,209,8,15981,14521,1460,103,100,3,1,97.7321238,Arch
1337565fc619b82b824dba93c1c3814cac5d4335,15,627,209,418,2,0,2,4,69,266,2,7,2.928286927,4597,91,3,525,485,40,34137,30892,3245,265,247,18,1,94.6986787,Arch
60895bbb35b9f945e60e28d6545d8ee66400405f,9,125,16,109,0,0,0,1,19,214,1,6,2.686352523,4325,255,9,563,549,14,26566,25891,675,114,112,2,1,96.84085943,Arch
e16d63b4cf34f589622104dc6fa5f321cc9f3f1e,7,60,266,206,0,2,2,2,2,122,2,7,1.783763104,990,82,6,116,145,29,4298,5277,979,29,38,9,1,96.73644757,Arch
0bd1c533c2aa68f39325d4d7b38b9bc3f197fd6e,5,62,26,36,0,0,0,4,14,423,1,5,2.233900195,709,2,2,58,54,4,5147,4915,232,42,39,3,1,94.60123739,Arch
da71afd53c5e1b2d0cd72d22ddf9278ca2ef664c,17,474,105,369,2,0,2,2,132,295,4,13,3.184557375,5818,17,1,784,752,32,32114,29832,2282,582,564,18,1,93.31887564,Arch
7ae627179e7a70837afd557211f1b3a55a2ec010,920,36541,9538,27003,166,20,186,1,145,169,13,276,8.470134047,180833,0,0,19468,17141,2327,1297286,1149727,147559,10347,9139,1208,1,86.77820678,Arch
16d33ba3cb953435660566ba2ec63a45204a7814,34,2553,127,2426,27,1,28,1,146,20,3,20,4.755484451,5483,16,1,1050,798,252,38712,26659,12053,715,556,159,1,92.63133781,Arch
c9bc03ed8681ab64eea2520f5511464915389c51,27,1957,915,1042,6,1,7,56,147,181,5,17,3.225824728,13729,9,1,1557,1450,107,94614,89282,5332,932,850,82,1,97.63759895,Arch
c18d6153e105ac34fb410c60ce8a153327931782,33,1881,72,1809,13,0,13,1,149,246,3,18,4.568157869,7137,35,0,959,828,131,46201,37266,8935,670,598,72,1,94.00516012,Arch
2fc20c186b77017f7f1c6f6abe8559a9e8cfe578,21,381,222,159,1,1,2,3,150,262,4,8,3.723762912,7692,273,3,947,926,21,45942,45635,307,688,693,5,1,95.33232628,Arch
c95abd3213f4806f535c6d7cb8b346616c3368fb,20,77,600,523,0,2,2,4,151,0,4,8,3.290777457,7851,112,3,865,947,82,42708,45942,3234,662,688,26,2,95.39448849,Arch
3a08bdc3f971b3534e8fb6f34772340cfdf055a9,13,120,40,80,1,0,1,8,154,157,1,5,2.981953838,4111,117,9,518,512,6,20668,20364,304,445,439,6,1,91.65778441,Arch
