CommitID,NMF,TotalAddLines,TotalDeleteLines,LC,FileAdd,FileDelete,NAD,NDVE,NUC,AGE,NMS,NMD,Entropy ,MLMF,EXP,REXP,CommitComplexity,LastCommitComplexity,CFC,CommitTokenCount,LastCommitTokenCount,NCC,CommitMethodNum,LastCommitMethodNum,NMC,NIR,a2a
e191a4b4e2d465018b56ec18b190655d52fd3acb,2,8,4,4,0,0,0,3,16,6,2,2,0.918295834,1194,60,11,189,188,1,5824,5813,11,51,51,0,0,100
4e4bd02fd9f9c7a4c5873f04446e819e4f5353bd,1,15,4,11,0,0,0,6,17,1,1,1,0,824,114,4,144,142,2,4088,4064,24,40,40,0,1,100
1bd0e04983ce3c8b2d503b571d50d7431cb0131a,1,1,1,0,0,0,0,6,18,2,1,1,0,835,61,12,144,144,0,4096,4088,8,40,40,0,0,100
07982526f67964f1b32e315fc5382456fafdd7eb,3,44,10,34,0,0,0,11,91,189,2,3,0.931761578,4359,20,3,795,789,6,26544,26349,195,124,123,1,1,100
35e9c10e53fd9d7fbef554a1c6fedfe84d36c736,2,12,11,1,0,0,0,3,5,715,2,1,0.886540893,609,22,2,121,120,1,3460,3444,16,14,14,0,1,100
7bc2f89e25b656ca9e80d41d6f4cb1531350f502,2,12,3,9,0,0,0,2,92,125,1,2,0.566509507,2524,21,4,436,428,8,15083,14980,103,59,59,0,1,100
23c7b1148533275dffb37853b49a6ebdb8126a7e,1,51,36,15,0,0,0,6,44,18,1,1,0,1309,311,3,332,327,5,7165,7047,118,29,29,0,1,100
8762a8c795d09210fd7293cebf71603bffe644ec,3,338,247,91,0,0,0,3,93,132,1,2,0.659397536,5030,20,2,990,974,16,31611,31346,265,147,145,2,1,100
87fe3446d988b72e24467c427ba31ac9d3174de2,0,0,0,0,0,0,0,0,0,0,0,0,0,0,23,3,0,0,0,0,0,0,0,0,0,1,100
e3d50db85c289f30f71ba3ba27eb23192a554281,1,20,16,4,0,0,0,11,104,54,1,1,0,3787,28,1,696,695,1,25753,25690,63,78,78,0,1,100
3c8b40fcf317235bc5597b4d6ffe535c7a5baa34,4,333,6,327,1,0,1,1,41,182,2,3,1.11721762,1354,119,1,286,266,20,8610,6907,1703,55,51,4,1,97.12155726
8e45cf4808908e866406d35203e49c51f42e362f,0,0,0,0,0,0,0,0,0,0,0,0,0,0,214,5,0,0,0,0,0,0,0,0,0,1,100
2bf60228fe9f2535ddc293c25ee08864871ca23d,0,0,0,0,0,0,0,0,0,0,0,0,0,0,62,10,0,0,0,0,0,0,0,0,0,0,100
f66b885dfb8bb7238f265d85dbb4fb11962119ac,0,0,0,0,0,0,0,0,0,0,0,0,0,0,63,11,0,0,0,0,0,0,0,0,0,0,100
0f0f1d375abf5b3c640c53d75fff38c7405a4e38,0,0,0,0,0,0,0,0,0,0,0,0,0,0,24,4,0,0,0,0,0,0,0,0,0,1,100
3a0b69e38a72827df26719e565b43d5bfc33d7c6,1,26,14,12,0,0,0,3,4,13,1,1,0,758,21,2,150,135,15,4844,4278,566,19,19,0,1,100
a1fcbf71731a10fe94b26fccdffb8d03703bd64f,0,0,0,0,0,0,0,0,0,0,0,0,0,0,64,12,0,0,0,0,0,0,0,0,0,0,100
4c6333f8ffa97be7fea1c67d7b28928624d6e8f9,0,0,0,0,0,0,0,0,0,0,0,0,0,0,65,13,0,0,0,0,0,0,0,0,0,0,100
ad3a3a7829441282beb4dbf92ea50318f0c8b270,2,320,4,316,1,0,1,1,10,190,1,2,0.657139633,299,115,4,84,37,47,2979,1408,1571,24,9,15,1,99.91480298
d7e5146d573ad05662a6bee21dbfbcf807f3501f,0,0,0,0,0,0,0,0,0,0,0,0,0,0,66,13,0,0,0,0,0,0,0,0,0,0,100
47af6cc5406ecaed2aba6345dd61ec6e7456c5b8,0,0,0,0,0,0,0,0,0,0,0,0,0,0,22,2,0,0,0,0,0,0,0,0,0,1,100
6da9fe4618363da23be9a11408cf68325693dfe3,18,335,1159,824,0,2,2,2,103,143,7,13,2.954209548,16442,58,0,2991,3113,122,93829,98472,4643,447,469,22,1,97.08195364
55c55ca7a1aae73c70db7cab5b39dcf72ae3ef4e,18,1164,340,824,2,0,2,2,104,187,7,13,2.962447018,15618,58,0,3113,2991,122,98472,93829,4643,469,447,22,1,97.08195364
ab131efd32f9ba3622aef865d1fd8b0832730dcc,1,8,1,7,0,0,0,6,45,20,1,1,0,1324,312,2,333,332,1,7187,7165,22,29,29,0,1,100
ae53958559129da24915f344f6c3cfa89284faaa,1,3,1,2,0,0,0,3,12,26,1,1,0,374,67,13,47,47,0,1767,1760,7,11,11,0,1,100
cc02a5de76bab4b65e41654a0d8bdb4a174a8252,18,336,1167,831,0,2,2,2,103,131,7,13,2.961677196,16451,60,6,2991,3114,123,93836,98501,4665,447,469,22,1,97.08195364
7af2a1e2bed30fbafd9af461af18710781271bc9,2,8,4,4,0,0,0,3,16,18,2,2,0.918295834,1196,61,7,189,188,1,5831,5820,11,51,51,0,0,100
c7b90aa8db307b9b823eb92dab9d4535133c36b0,1,1,1,0,0,0,0,6,17,0,1,1,0,824,62,8,142,142,0,4072,4064,8,40,40,0,0,100
08cb7d9b1a5155c969a4d0435de5e6445a3a3fef,0,0,0,0,0,0,0,0,0,0,0,0,0,0,63,9,0,0,0,0,0,0,0,0,0,0,100
ce120640e15d0a85ff4ed744ba59c5a6cb72c4e2,0,0,0,0,0,0,0,0,0,0,0,0,0,0,64,10,0,0,0,0,0,0,0,0,0,0,100
1aad349874b3afffb1432736420dd41eddde0c6a,18,1174,346,828,2,0,2,2,104,187,7,13,2.988898689,15624,68,14,3115,2992,123,98482,93855,4627,469,447,22,0,97.08195364
847e0733b97238249808f249f44a4d46ff8dfbeb,0,0,0,0,0,0,0,0,0,0,0,0,0,0,25,4,0,0,0,0,0,0,0,0,0,1,100
62100cdbb3eb5373ddf5d637a502ede20c813a76,1,1,0,1,0,0,0,2,2,45,1,1,0,505,116,3,24,24,0,2494,2477,17,14,14,0,1,100
35c4d34f6ac17d9cfed78e5633c78ec8904cd3af,0,0,0,0,0,0,0,0,0,0,0,0,0,0,69,10,0,0,0,0,0,0,0,0,0,0,100
1b2b32be2e103c845f3183aa66c2aa08db635189,19,341,1170,829,0,2,2,2,103,121,7,14,2.987789013,16958,65,6,3016,3139,123,96332,100976,4644,461,483,22,0,97.08195364
f452c640ce84d2e7709056c20295aaef72a47449,19,1175,346,829,2,0,2,2,104,179,7,14,2.994831711,16129,70,11,3139,3016,123,100976,96332,4644,483,461,22,1,97.08195364
f0024d518afa3ecfbe75873593516396b78bc0a1,16,16,16,0,0,0,0,3,12,376,11,11,4,3613,71,11,496,496,0,18940,18940,0,97,97,0,0,100
60fa8f04caf9e50914568dbbc1b14e61a428c01f,1,31,13,18,0,0,0,2,2,1466,1,1,0,271,72,12,12,12,0,1944,1812,132,4,4,0,0,100
f3d999b4e5731c672a5de0b6e4c90221844f7d53,2,155,0,155,1,0,1,1,19,93,2,2,0.293209343,271,26,4,56,40,16,2033,1313,720,25,19,6,1,99.61726558
cc7277118362a26c5300549fc1c5bf2d22719ca4,0,0,0,0,0,0,0,0,0,0,0,0,0,0,29,1,0,0,0,0,0,0,0,0,0,1,100
2cf47b9fe5228f8f46c63cf0fa370c0fbe5fbd2a,0,0,0,0,0,0,0,0,0,0,0,0,0,0,117,3,0,0,0,0,0,0,0,0,0,1,100
246d53690eec7db1ac45bc3d598ae6c326e7a8f5,1,0,3,3,0,0,0,5,11,58,1,1,0,142,22,2,15,16,1,644,664,20,2,2,0,1,100
d9a661cfefd6b5c13486bc7d16e66e98dcf05bcd,165,0,28801,28801,0,163,163,2,4,838,1,11,6.598767448,28799,73,12,0,4073,4073,0,120126,120126,0,1814,1814,1,90.05211874
cd2e73030f5749330f1b432dd63d3d8dc6d55cbc,2,20,5,15,0,0,0,2,19,357,1,1,0.634309555,437,120,1,82,77,5,2555,2409,146,15,15,0,1,100
5a18b906b701054d8cbb0acbd5d55af27a0573fc,2,7,7,0,0,0,0,2,10,106,1,2,0.591672779,519,23,3,64,63,1,2468,2460,8,28,28,0,1,100
711c69c87d5315d9936b6a46fe390e2672891402,1,16,6,10,0,0,0,7,46,19,1,1,0,1331,118,3,337,333,4,7244,7187,57,29,29,0,1,100
d8e8890ba228a21ea046c70bb4e2ee4c7e6f07b9,10,39,29,10,0,0,0,2,27,298,3,9,2.985849601,4806,121,2,951,946,5,26293,26249,44,184,185,1,1,100
4447aa33c890273201ab34236981c0788f199560,0,0,0,0,0,0,0,0,0,0,0,0,0,0,27,4,0,0,0,0,0,0,0,0,0,1,100
6bdb535df11f31e5701f1b5865e9da72e5cf44a8,5,138,23,115,0,0,0,11,105,267,2,4,1.902337562,5141,122,3,903,883,20,33115,32520,595,154,147,7,1,100
3caa698f3c6957ec5fe65b6e5bb0b59dc757dc34,4,28,17,11,0,0,0,6,17,462,2,4,1.922177901,1403,119,4,188,187,1,6723,6664,59,53,53,0,1,100
a684b48c5a09b2432017249eefad70bc8e36123a,27,382,300,82,0,0,0,5,106,366,3,13,2.781834068,21450,23,2,3848,3817,31,122903,122457,446,711,711,0,1,100
09b52b939bcd957be7e5a6a85a138c0fee29f9df,3,20,6,14,0,0,0,5,7,215,3,3,1.502035276,839,30,2,125,121,4,4123,4059,64,27,27,0,1,100
24a100081eb05276bca7aa07b3a8c2255646c21a,9,115,96,19,0,0,0,1,47,257,7,9,1.887373069,4996,120,5,876,872,4,26089,25958,131,144,144,0,1,100
17e37f0b68a5172c6c4b7c6d7c8a188ebc88f44a,3,9,9,0,0,0,0,3,13,572,1,2,1.530493057,1154,74,8,139,139,0,6511,6514,3,63,63,0,0,100
787457b588a6e4ddac7d5bd31bfe613ede6478d8,4,13,0,13,0,0,0,2,12,834,1,1,1.987773371,1767,121,5,248,248,0,8057,7997,60,51,51,0,1,100
cbee002b8976b1631408ae25d12c4aaf54c01701,0,0,0,0,0,0,0,0,0,0,0,0,0,0,122,6,0,0,0,0,0,0,0,0,0,1,100
a171cdbb47d06057c05cd90a642378af04025fa0,1,5,7,2,0,0,0,6,20,12,1,1,0,837,75,8,144,144,0,4106,4111,5,40,40,0,0,100
6116f91f0edddac4ba6e96f29c23d7a88a106cd1,2,18,273,255,0,1,1,6,11,830,2,2,0.734128043,619,76,7,54,89,35,2105,3414,1309,19,31,12,0,99.9271137
8411c64a6ffefba4332e9f0c74b90d1204fd53c7,1,12,24,12,0,0,0,5,6,5,1,1,0,263,77,8,40,40,0,1500,1553,53,19,19,0,0,100
484abfc4b026f007c2dd0d7aac8faa6ea4bf1f28,1,3,1,2,0,0,0,4,17,24,1,1,0,239,1,0,52,51,1,1343,1327,16,11,11,0,1,100
6f48a62076ba0e5ab738ae3f0fb368b2b81b0529,1,1,2,1,0,0,0,2,4,74,1,1,0,135,78,9,18,18,0,741,746,5,5,5,0,0,100
baac2ba9fcbcdf00b08d69c98fa31f453ababc39,4,160,24,136,0,0,0,4,12,742,3,4,1.71234325,720,313,0,108,90,18,4310,3655,655,30,27,3,1,100
fa59f97bc30584e015b52473d15ade903563b26c,1,11,10,1,0,0,0,2,3,23,1,1,0,353,215,0,46,44,2,1645,1634,11,7,7,0,1,100
578b4ed2f0ce6cf53c7fe571c59a0d2e40525287,8,169,90,79,0,0,0,2,14,190,1,4,2.797387728,2883,123,6,397,395,2,13727,13302,425,96,96,0,1,100
d87ecce141f5f4d36b8490d017ead1c9a4b4aa81,0,0,0,0,0,0,0,0,0,0,0,0,0,0,205,0,0,0,0,0,0,0,0,0,0,1,100
c202a20c1a46aa1c120b654c3e53fbd6bef02606,267,30101,2536,27565,166,3,169,4,103,335,21,68,6.944991812,47373,205,0,11796,7924,3872,370896,257588,113308,3397,1608,1789,1,87.44493392
11e8d07b7a2ec780d59264e52272a42879d0e77d,0,0,0,0,0,0,0,0,0,0,0,0,0,0,213,0,0,0,0,0,0,0,0,0,0,1,100
7993a622e9501521f2dd9d3af19b8704bb499ce1,267,2536,30101,27565,3,166,169,5,106,524,21,68,6.945140434,74938,216,1,7924,11796,3872,257588,370896,113308,1608,3397,1789,1,87.44493392
f0cae730a8cfba87a5396bf8b6914ba132908c02,1,98,33,65,0,0,0,3,7,190,1,1,0,299,24,1,40,39,1,1636,1350,286,24,24,0,1,100
77e2c4429da45c426fd93d68c249ee74b8a77443,0,0,0,0,0,0,0,0,0,0,0,0,0,0,217,2,0,0,0,0,0,0,0,0,0,1,100
a1b2ce54001fc1202bd16f47db0333598f6602c6,1,2,3,1,0,0,0,4,5,749,1,1,0,291,124,6,38,38,0,1142,1155,13,13,13,0,1,100
d6912887437e6d3bdb7fa141801a708629363d06,261,30108,2597,27511,166,3,169,4,103,389,22,63,6.943935639,43808,119,0,11051,7175,3876,350549,237470,113079,3270,1482,1788,1,87.44493392
e8bc76f4d0d74d86ad512be5e2a72383d2c7f6eb,4,28,17,11,0,0,0,6,17,501,2,4,1.922177901,1403,114,0,188,187,1,6723,6664,59,53,53,0,1,100
b7956495617d855660309e4d1cb4081b95d905e2,27,382,300,82,0,0,0,5,104,411,3,13,2.781834068,21340,20,0,3815,3784,31,122176,121730,446,707,707,0,1,100
ce7edb25bd3bf5f1a5be2996ebdb3810ecde5e60,3,20,6,14,0,0,0,5,7,253,3,3,1.502035276,839,28,0,125,121,4,4123,4059,64,27,27,0,1,100
ee47136abe973e8630f970b868ad8b292ca9e443,9,115,96,19,0,0,0,1,44,297,7,9,1.887373069,4952,115,1,863,859,4,25887,25756,131,144,144,0,1,100
cc1bb5a95c36e5d5579742127c13d252b46154a8,233,2060,29694,27634,3,166,169,2,106,580,18,54,6.866343817,57925,125,6,4933,8849,3916,168846,282598,113752,989,2777,1788,1,87.44493392
b0d21cffb94d50e6f5e2ea247a39d13fa33d52e4,1,25,2,23,0,0,0,8,10,150,1,1,0,403,24,1,63,59,4,2340,2227,113,8,8,0,1,99.92706054
a5d2bedb26e210a43c066112c11ccd81d95672be,0,0,0,0,0,0,0,0,0,0,0,0,0,0,28,0,0,0,0,0,0,0,0,0,0,1,100
dcb93b5b9d71a4d08cad1ccce24d0699426b3958,234,29691,2080,27611,166,3,169,2,104,396,18,54,6.870003622,30717,2,0,8908,4996,3912,284825,171186,113639,2785,997,1788,1,87.37607403
428f1207e694e9d2648ddaeddd2b0cea79d765ea,0,0,0,0,0,0,0,0,0,0,0,0,0,0,3,1,0,0,0,0,0,0,0,0,0,1,100
250c50daa59412d7a8b519a3b615f1b00c048589,234,2085,29696,27611,3,166,169,2,106,580,18,54,6.870401954,58328,2,0,4996,8908,3912,171186,284825,113639,997,2785,1788,1,87.37607403
b935426d1856abbe52cfa4a26af9a2110d273ccb,1,20,2,18,0,0,0,5,18,30,1,1,0,241,126,5,54,52,2,1438,1343,95,12,11,1,1,100
3a36875e96aa2f689edd71ab77a8c74a6355493a,16,460,86,374,0,0,0,1,48,402,2,6,3.116895839,5010,123,0,963,889,74,28090,25988,2102,242,215,27,1,100
818e1d354312443fd8e29d49861b91d13e239be2,8,407,102,305,2,0,2,1,34,327,1,3,2.181420076,1097,124,1,194,145,49,6725,5359,1366,81,40,41,1,99.85426281
89136413ee589b9b63a83ea8f61402a533a8f621,1,10,2,8,0,0,0,3,4,224,1,1,0,462,25,1,78,76,2,3032,2999,33,15,15,0,1,100
bf3f095429b0027213c6e10dd6a32d94608623d3,3,8,4,4,0,0,0,1,43,9,2,3,1.251629167,1317,125,2,236,235,1,7217,7192,25,58,58,0,1,100
ac5a03667cf167eb7a1d83d2c9aae8c2ab946494,1,8,8,0,0,0,0,2,3,87,1,1,0,506,127,4,24,24,0,2494,2494,0,14,14,0,1,100
cad64cec34245e3eeff5edff9358aafc98603aab,253,29883,2981,26902,166,5,171,2,104,400,18,59,6.968274782,35317,4,2,9596,5812,3784,304720,194702,110018,2956,1237,1719,1,87.30193662
d4cbf4f68767863c9ef5237e30d091f981baf4b9,1,10,2,8,0,0,0,3,4,226,1,1,0,462,21,1,78,76,2,3032,2999,33,15,15,0,1,100
f734393e68de75dfa37e73ad158aae7e92f04fb2,252,2968,29878,26910,5,166,171,2,106,515,18,58,6.966126165,61757,79,0,5734,9520,3786,191670,301721,110051,1222,2941,1719,0,87.30193662
c9d1546614b1979980a96165e46542f8bb719cbb,0,0,0,0,0,0,0,0,0,0,0,0,0,0,80,1,0,0,0,0,0,0,0,0,0,0,100
480776a9eb2004e3684b1d8f92f29fbeb2815233,16,614,32,582,1,0,1,11,95,84,3,8,1.883926415,7462,314,0,1549,1426,123,44113,41014,3099,295,257,38,1,99.90298326
b56119114cb989c44917dd7fc6d1d8da3b852632,22,26,58,32,0,0,0,10,96,314,9,19,4.301535841,13613,81,2,2388,2394,6,75661,75745,84,449,449,0,1,100
448dd49a62004ad0a3aeb64c5fabef9c1ec4fe1a,22,58,26,32,0,0,0,9,95,234,9,19,4.301535841,13581,81,2,2394,2388,6,75745,75661,84,449,449,0,0,100
b15d6fa8a5a2168ccdc3cf1a5566461508aac711,22,26,58,32,0,0,0,10,96,314,9,19,4.301535841,13613,3,0,2388,2394,6,75661,75745,84,449,449,0,0,100
7729373dea5a560f5cb4b24433d12b25a9dc7519,6,410,3,407,4,0,4,1,4,189,3,3,1.92278344,504,83,4,129,99,30,4323,2499,1824,51,31,20,1,96.07006512
7f9395b357db893c7e2ac7219bc07d02cfbdf67b,8,21,35,14,0,0,0,3,12,594,5,5,2.359217982,2564,84,5,461,463,2,12510,12551,41,120,120,0,1,100
682424276b393c9f6d9fe61f3225f6906b5dce42,1,6,2,4,0,0,0,2,2,1,1,1,0,190,315,1,10,10,0,891,878,13,7,7,0,1,100
ff4e2e7b6847679388a13ddd8396e191e0106f18,13,607,152,455,2,0,2,3,44,136,1,7,2.659643531,4323,316,2,910,834,76,25232,22819,2413,199,182,17,1,95.06457565
9918c8d25c35633c86b2a641a29ff1a83dfe51a0,1,52,55,3,0,0,0,3,33,2,1,1,0,814,317,3,170,168,2,4458,4530,72,36,36,0,1,100
1a2f3f33c938f9f9176208d2278d512fab222afe,20,397,449,52,0,0,0,2,14,1158,5,10,3.036835686,5063,85,6,393,393,0,32064,31935,129,184,184,0,0,98.85815783
00e07f22b592d0d08f706fad0239fd860e8562a7,313,30458,4902,25556,166,12,178,2,104,335,22,85,7.144513154,54237,22,1,12256,8694,3562,401194,298459,102735,3634,1990,1644,1,84.97432463
0bc79e9fb794feb0f7460284c6c355d08dc9de6a,312,4891,30454,25563,12,166,178,3,106,502,22,84,7.142940913,79540,26,1,8659,12222,3563,297210,399980,102770,1971,3615,1644,1,84.97432463
a39c00f952267bacec5388880f33e694bdd467c1,10,39,31,8,0,0,0,2,23,363,4,9,2.236265489,7810,86,7,213,208,5,53824,53870,46,163,163,0,0,97.70780856
c659d9aa711595af9e701210484dc72cd8ff8985,32,693,301,392,1,0,1,11,97,287,2,10,3.973808431,12772,126,1,2570,2478,92,69094,65862,3232,639,614,25,1,99.94936709
89e11bcc2a6782dec11f3f88e459dc6aa8691931,1,9,3,6,0,0,0,3,34,7,1,1,0,811,318,4,176,170,6,4524,4458,66,36,36,0,1,100
2118a71638055f7d44a94cbaed90809c53aead67,2,9,1,8,0,0,0,11,107,53,2,2,0.881290899,3907,127,1,706,705,1,26350,26296,54,80,79,1,1,100
2fb907c802ca64d0117261ef7f47ab2912578d18,0,0,0,0,0,0,0,0,0,0,0,0,0,0,4,1,0,0,0,0,0,0,0,0,0,1,100
40d742fa97f710baf636cc2edfc4aa878f168e18,1,2,2,0,0,0,0,7,23,21,1,1,0,317,87,8,39,39,0,1545,1545,0,11,11,0,0,100
eea868860d283f53d9d24de8909cf5d68b6cf1b7,4,21,9,12,0,0,0,7,48,251,2,3,1.770894436,4057,319,5,911,909,2,20666,20572,94,198,198,0,1,100
2dea1f91c259a52b5f90b23c8469b26ed542d418,332,30693,5544,25149,166,13,179,2,104,285,22,93,7.198531161,65967,311,0,13299,9840,3459,471200,371736,99464,4065,2447,1618,1,84.81240171
3eba2a1edadf7d1c706997401ba46cf13595e82a,332,5543,30692,25149,13,166,179,3,107,516,22,93,7.198652768,91116,29,0,9840,13299,3459,371736,471200,99464,2447,4065,1618,1,84.81240171
048f6a89d05c39ce3c8363dbd542d98124cce69e,0,0,0,0,0,0,0,0,0,0,0,0,0,0,30,1,0,0,0,0,0,0,0,0,0,1,100
064c4f87a69e4f9220ed46d8a8aff13f704664d0,332,30693,5544,25149,166,13,179,2,104,285,22,93,7.198531161,65967,22,0,13299,9840,3459,471200,371736,99464,4065,2447,1618,1,84.81240171
351f870dfad48f72d19e722fdfb098dcea30e503,0,0,0,0,0,0,0,0,0,0,0,0,0,0,23,1,0,0,0,0,0,0,0,0,0,1,100
1115ca8e9bb339b8f8e23909945eb314624e8d4c,332,5544,30697,25153,13,166,179,3,107,516,22,93,7.199448159,91116,88,7,9840,13299,3459,371718,471200,99482,2447,4065,1618,1,84.81240171
bf7188031c715196a3e9a7f3f23c700d2deb427c,332,30693,5544,25149,166,13,179,2,104,285,22,93,7.198531161,65963,66,0,13299,9840,3459,471182,371718,99464,4065,2447,1618,1,84.81240171
68541c92afe3b6500ef28b3a6ee01149a337ad20,332,5543,30692,25149,13,166,179,3,107,516,22,93,7.198652768,91112,27,1,9840,13299,3459,371718,471182,99464,2447,4065,1618,1,84.81240171
6d30412d4cb2215c5a49e4eb21d946f005a64852,332,30693,5544,25149,166,13,179,2,104,285,22,93,7.198531161,65963,23,1,13299,9840,3459,471182,371718,99464,4065,2447,1618,1,84.81240171
ed3f214b2bb44278b27826e7e5de5990df4f62eb,332,5584,30692,25108,13,166,179,3,107,516,22,93,7.200048983,91112,89,3,9844,13299,3455,371947,471182,99235,2448,4065,1617,0,84.81240171
bb420d5c2493e4aa159f3be7b2cbc213bc3c30b3,1,20,0,20,0,0,0,2,7,2,1,1,0,563,90,3,35,33,2,2853,2740,113,16,15,1,0,100
b323f9088ae0b73db492c03aa48bcc178be4e9b1,331,30677,5474,25203,166,13,179,2,105,286,22,93,7.19272753,65751,120,0,13287,9814,3473,470890,371173,99717,4040,2417,1623,1,84.81240171
caba857008b3e0087a276fc2030e13f951cde624,4,333,6,327,1,0,1,1,42,268,2,3,1.11721762,1363,121,1,288,268,20,8672,6969,1703,55,51,4,1,97.18076285
efe49a88baa4ca13ba40299387afc11c769e5131,16,460,86,374,0,0,0,1,48,446,2,6,3.116895839,5019,122,2,965,891,74,28152,26050,2102,242,215,27,1,100
543bfe04ba37bae689e7e5930b1daf3f097dc5e5,3,8,4,4,0,0,0,1,43,0,2,3,1.251629167,1317,123,3,236,235,1,7217,7192,25,58,58,0,1,100
d79f127c2f8331610f5c28cafed43f2eccff6b11,8,407,102,305,2,0,2,1,34,385,1,3,2.181420076,1097,124,4,194,145,49,6725,5359,1366,81,40,41,1,99.87242186
b265605f5ea532e6f46ad9eafc616509834e9d43,16,614,32,582,1,0,1,11,92,83,3,8,1.883926415,7426,312,1,1530,1407,123,43863,40764,3099,294,256,38,1,99.91505628
5fa2e8877f835c7b3e114daded6b56ed1e1361f8,13,607,152,455,2,0,2,3,45,142,1,7,2.659643531,4332,313,2,912,836,76,25295,22882,2413,199,182,17,1,92.13764813
46f95f724e1757af5bba96d50ed06894e4cdd477,1,52,55,3,0,0,0,3,33,0,1,1,0,814,314,3,170,168,2,4458,4530,72,36,36,0,1,100
13e36cf1d32c3cb0cef0903e073d80adbe75c2fb,1,9,3,6,0,0,0,3,34,0,1,1,0,811,315,4,176,170,6,4524,4458,66,36,36,0,1,100
0af4131570f8a1c97a11c0f22ce69d6613442096,317,3292,30564,27272,7,166,173,3,107,518,22,90,7.080886327,89656,91,4,9322,13149,3827,354278,464783,110505,2265,4016,1751,0,79.94512347
5e1a5dc9932e9c25492529f0c6a7f1798c331cc5,1,0,4,4,0,0,0,2,4,45,1,1,0,195,92,5,10,10,0,873,886,13,7,7,0,1,100
1635869172ab15ddda4b770e02b485e597db763b,1,1,0,1,0,0,0,11,108,53,1,1,0,3831,320,0,706,706,0,25994,25985,9,80,80,0,1,100
eed536b1335b324232fce02ae2368d479d75c343,0,0,0,0,0,0,0,0,0,0,0,0,0,0,0,0,0,0,0,0,0,0,0,0,0,1,100
4a332a93ea05cc953ac4a7063f437f2609112a37,317,30560,3285,27275,166,7,173,2,105,343,22,90,7.080777855,62381,0,0,13149,9322,3827,464783,354274,110509,4016,2265,1751,1,79.94512347
868c62b729bb67b8b9db3f2146db1ea442b53ea8,323,4193,30564,26371,13,166,179,3,108,516,22,91,7.127703395,89656,93,4,9385,13149,3764,358571,464783,106212,2294,4016,1722,1,80.35803083
74959da1617f65bdf74048ecd714dc3aa1d384e9,7,572,200,372,3,0,3,2,6,284,1,2,2.503927065,503,321,1,92,50,42,4776,2414,2362,43,20,23,1,93.95402299
f2c3040a0af472cef1a41e13f5b15a34b31b0f04,4,21,66,45,0,0,0,4,47,112,2,3,1.81700402,2695,128,0,540,546,6,14593,14737,144,128,131,3,1,100
5359e376b9c56ca62174722b47ad68cd77b13b73,1,161,165,4,0,0,0,5,10,89,1,1,0,452,94,5,58,58,0,2618,2635,17,7,7,0,0,100
09700f35ad41dbb7c23cedbc8ee68a16d9565de8,620,2830,2830,0,0,0,0,5,109,662,37,149,8.556221563,163695,95,6,23226,23226,0,777806,777806,0,7612,7612,0,0,100
eb21ea6afb9f2ca0e26a769bfc6333ba3cce0e61,119,1500,1500,0,0,0,0,5,50,49,24,66,5.51791261,36128,96,7,5794,5794,0,187810,187810,0,1426,1426,0,0,100
1c441f798e1c5da54f6bb9faf211eadb5f10b6b5,7,5349,0,5349,7,0,7,1,1,0,1,2,2.065662284,0,25,0,417,0,417,39923,0,39923,237,0,237,1,97.75626925
53fb16a60aeb9557d56d76003831e9e442351244,2,1052,0,1052,2,0,2,1,5,773,1,1,0.99948893,0,31,0,49,0,49,8408,0,8408,48,0,48,1,96.89617486
774ecf6588ae92cb1c6edde9d1eaf392d2892811,0,0,0,0,0,0,0,0,0,0,0,0,0,0,206,0,0,0,0,0,0,0,0,0,0,1,100
10f1282e349de976fce8f38ee529e923c2429cee,5,348,89,259,0,0,0,2,31,57,1,4,1.426062419,4737,28,0,642,633,9,30181,27240,2941,151,145,6,1,100
e0d2402468d782553745d2b781cc10de26fcb7d6,1,24,1,23,0,0,0,5,8,44,1,1,0,523,29,1,115,107,8,3198,3049,149,14,13,1,1,100
0a160d601c9004697a49c2f2bbcfc1d4382d1c6a,2,684,0,684,2,0,2,1,1,0,1,1,0.537376085,0,97,0,43,0,43,4183,0,4183,24,0,24,1,99.30184805
1b728ebeab2e90dcb169599ff67dcc7b039fdcf9,845,35234,15502,19732,166,25,191,5,105,148,39,169,7.871696357,184823,29,0,28576,25325,3251,970645,913848,56797,9793,8359,1434,1,87.02724685
26bfd13115db5ce45d192c8291af3363c087950f,7,5355,0,5355,7,0,7,1,1,0,1,2,2.067205919,0,20,0,417,0,417,40014,0,40014,237,0,237,1,96.86282551
4a64c4fa11109d8366185320b5a28f58685328a4,4,407,157,250,0,0,0,6,29,368,1,3,1.427423005,4249,24,0,624,615,9,26226,23398,2828,133,127,6,1,100
1f138601aaf8da82c9ba04f39ff0131d70b33ed8,838,10030,35370,25340,18,166,184,5,109,481,39,169,8.017625536,204805,98,1,24908,28585,3677,873834,973473,99639,8122,9799,1677,0,88.73754828
22259e9d9a3572cf2392996f787a6b3dc8ad0672,5,48,80,32,0,0,0,5,23,87,1,4,2.244440233,2072,0,0,295,300,5,9907,10142,235,87,85,2,1,100
148eb5e64bc3819ae49a2a531d85dc63386f65f0,4,0,6,6,0,0,0,6,18,0,1,3,1.79248125,1179,30,2,147,147,0,5632,5683,51,45,45,0,1,100
d2a0f113223603a5a4e19cf741fc3fc1c8c52170,28,21,374,353,0,2,2,5,37,163,17,25,3.164029657,12081,99,2,1853,1905,52,57975,59960,1985,537,547,10,1,99.91928975
c74dc64b642d7d0762846ed76cad16db3b056fb3,2,89,1,88,0,0,0,2,12,108,1,2,0.783776947,954,128,0,81,76,5,6868,6257,611,57,54,3,1,100
08a17bc5dcccd453dd652fe36b793bd0b9f99f64,1,2,4,2,0,0,0,6,10,78,1,1,0,401,0,0,58,58,0,2037,2053,16,23,23,0,1,100
23609f17a91c788b8016e38e13fa2906cff44e5b,2,8,8,0,0,0,0,4,13,20,1,2,1,260,100,3,31,31,0,1247,1247,0,12,12,0,0,100
ecfa86caa1fea9e58c8d175bb48e667a64077397,842,35714,10059,25655,168,18,186,5,105,149,39,170,8.039985441,179476,116,0,28626,24893,3733,974771,873399,101372,9818,8136,1682,1,88.64699898
d4fd0277a125d9b5c657dd77cff20a58d91dae04,844,10485,35721,25236,20,168,188,5,109,478,39,171,8.048134543,205131,101,4,24916,28626,3710,876054,974771,98717,8148,9818,1670,1,89.43865099
a46ced507d7b47efafcf5bb810b34ef5bbbf0357,4,52,8,44,0,0,0,3,19,68,1,2,1.564292896,1790,32,0,284,279,5,9696,9522,174,58,58,0,1,100
9ad5348947073523b59c92819dcd92510e6df249,1,3,3,0,0,0,0,5,14,86,1,1,0,322,0,0,46,46,0,1695,1695,0,6,6,0,1,100
0999ff6216d531fe1aeac15d4f74c121779b32c9,2,3,3,0,0,0,0,3,14,86,1,2,0.918295834,434,102,4,56,56,0,2194,2194,0,19,19,0,0,100
fb95d3e3fad21a51206d3a3113d703bfe267c808,843,35661,10514,25147,168,20,188,5,105,148,39,171,8.042288869,179143,125,0,28446,24747,3699,970155,871756,98399,9778,8111,1667,1,89.43865099
08a94c741bdfd60c124f824143f476b25bc96167,843,10521,35668,25147,20,168,188,5,109,478,39,171,8.042243379,204290,218,0,24747,28446,3699,871756,970155,98399,8111,9778,1667,1,89.43865099
3b7cf3ae6bec6514d2e38a87a286ec92e3bd3deb,843,35661,10514,25147,168,20,188,5,105,148,39,171,8.042288869,179143,214,0,28446,24747,3699,970155,871756,98399,9778,8111,1667,1,89.43865099
167a382b4d86d4aaee44f1877a6aea36784221ca,0,0,0,0,0,0,0,0,0,0,0,0,0,0,59,0,0,0,0,0,0,0,0,0,0,1,100
01326be73368a0700dce2c13e1850d620112780c,843,10612,35699,25087,20,168,188,5,110,476,39,171,8.051121946,204290,129,0,24764,28446,3682,872161,970155,97994,8115,9778,1663,1,89.43865099
59ba1acf106622a9fad271a7c2197d64a75d4487,1,2,2,0,0,0,0,9,13,105,1,1,0,426,1,1,63,63,0,2338,2338,0,8,8,0,1,100
efbed804f503416cb6a6d051d6283f60758859f9,1,13,13,0,0,0,0,9,14,0,1,1,0,426,103,4,63,63,0,2338,2338,0,8,8,0,0,100
91f270cfd86e2dcc53f29979bd55cad97b87e45a,5,72,5,67,0,0,0,11,111,100,2,4,1.811880333,5055,130,1,921,898,23,32979,32612,367,122,119,3,1,100
8b3f0e60eb9d48ee0a89546b009ee84e7013759e,19,712,548,164,4,0,4,1,52,107,1,10,3.274968964,6274,131,2,1298,1285,13,35197,34379,818,277,265,12,1,96.75990676
3d6476bfb8b391e437a5ba812b0c0a597462fee6,0,0,0,0,0,0,0,0,0,0,0,0,0,0,322,0,0,0,0,0,0,0,0,0,0,1,100
3bbc3702df19ab23e9efab5ca1730e1827a35589,35,1545,122,1423,8,0,8,2,99,170,7,18,3.9329238,13427,132,3,2069,1854,215,88574,80829,7745,558,465,93,0,98.64136295
d6d71f8affdae7e3894c220604414ce53140885d,0,0,0,0,0,0,0,0,0,0,0,0,0,0,323,1,0,0,0,0,0,0,0,0,0,1,100
92d20fe1dd7ef08b3173a506b85f79009913cae9,35,122,1545,1423,0,8,8,3,100,0,7,18,3.9329238,14850,324,2,1854,2069,215,80829,88574,7745,465,558,93,0,98.64136295
85f27292053d2a08c16b61ac40b4088d55da5d85,0,0,0,0,0,0,0,0,0,0,0,0,0,0,2,2,0,0,0,0,0,0,0,0,0,1,100
aa474e74db3354d78b845e2090300ab0f8780ce8,0,0,0,0,0,0,0,0,0,0,0,0,0,0,3,3,0,0,0,0,0,0,0,0,0,1,100
804753ed2cfb15d87d1c46b2d180e03001547f74,1,2,2,0,0,0,0,3,12,4,1,1,0,396,133,4,90,92,2,2207,2217,10,9,9,0,1,100
f4a20e0b9e259a436cb27cb48988076eee4f443a,37,1677,126,1551,8,0,8,3,101,1,9,20,3.907373479,13595,134,5,2117,1870,247,90070,81575,8495,578,477,101,1,98.64136295
ad0fe4b8976aa3fcee85d722bf8fa7bb32d16245,9,188,60,128,0,0,0,4,50,78,1,8,2.217860143,3093,135,6,604,557,47,17216,16335,881,171,160,11,1,100
5fe203f59330f66cd14fa916b9c1a6ebdb9b854d,2,15,17,2,0,0,0,1,20,6,1,2,0.337290067,1250,136,7,235,229,6,7370,7349,21,37,37,0,1,100
3c395a53e3d9dc7a21be08765f4293ed9fdb5133,0,0,0,0,0,0,0,0,0,0,0,0,0,0,31,0,0,0,0,0,0,0,0,0,0,1,100
ebc63ac3ff26f36e577e333f022459bc44c142a0,2,14,12,2,0,0,0,3,17,8,1,2,0.619382195,1187,137,8,274,274,0,6493,6476,17,40,40,0,1,100
4fbab55157102e0eacb8889d23b9a071f9128533,0,0,0,0,0,0,0,0,0,0,0,0,0,0,59,0,0,0,0,0,0,0,0,0,0,1,100
37512c121ac19eb059c512a89c9294bbff824098,864,36328,13151,23177,168,32,200,5,105,145,39,172,8.143105561,184664,60,1,29008,25660,3348,991216,903811,87405,9934,8398,1536,1,87.22702925
f70fdbf7947509c0975bd3c61b96b63f9b5daaa4,864,13220,36354,23134,32,168,200,5,111,465,39,172,8.146083987,207841,0,0,25665,29008,3343,904193,991216,87023,8399,9934,1535,1,87.22702925
bf343a0dd9aaa4859035dfaa61fe0c5b005ff5b2,0,0,0,0,0,0,0,0,0,0,0,0,0,0,32,1,0,0,0,0,0,0,0,0,0,1,100
d61ef2a0438fd69a9595ddd192bf1b9a01c121d1,0,0,0,0,0,0,0,0,0,0,0,0,0,0,31,0,0,0,0,0,0,0,0,0,0,1,100
ae8e485f88700ae1f830ac406322e5d94c750864,0,0,0,0,0,0,0,0,0,0,0,0,0,0,138,9,0,0,0,0,0,0,0,0,0,1,100
2ed2a009beda2e9c2aea01fa16b9404235a90d2e,0,0,0,0,0,0,0,0,0,0,0,0,0,0,129,0,0,0,0,0,0,0,0,0,0,1,100
b4651bc83682758a79659f6ea205b3f5b86408e7,0,0,0,0,0,0,0,0,0,0,0,0,0,0,207,0,0,0,0,0,0,0,0,0,0,1,100
a6e0eb908e932ace080d2b9c9244be9e0727d2ee,1,69,11,58,0,0,0,3,17,41,1,1,0,574,139,2,166,151,15,3324,3045,279,18,17,1,1,100
a15af08cab65ae631b1a853b6de8fa613925b1fa,0,0,0,0,0,0,0,0,0,0,0,0,0,0,33,1,0,0,0,0,0,0,0,0,0,1,100
ccd0badd900f4358b9d1db4c8441a4fbd61c63a0,10,10,4058,4048,0,6,6,11,112,264,2,6,2.462523751,8338,140,2,775,1491,716,28625,50970,22345,95,245,150,1,95.49469965
62160bb81c964fc829b6916f9054faefd1ddfa63,2,2,2,0,0,0,0,4,19,170,1,1,1,683,141,3,159,155,4,3546,3524,22,58,58,0,1,100
ffbb138d1809d5c800a7f916c05ab5cd2a1581a6,867,40382,13258,27124,174,32,206,5,105,141,39,172,8.094152492,182794,126,0,29426,25382,4044,1002387,893298,109089,10028,8344,1684,1,85.17135325
35ff7ee79a5c18f50e62d4f78ff7a5a03598fe05,867,13385,40384,26999,32,174,206,5,112,465,39,172,8.092226791,209918,32,1,25391,29426,4035,893960,1002387,108427,8347,10028,1681,1,85.17135325
de8f444d27eebfa633ad88e14811bfc1e5d39bd7,5,592,0,592,4,0,4,1,3,36,1,2,1.897186323,123,142,3,76,17,59,4164,593,3571,30,4,26,1,99.76392823
d328d023ef69bf0c2952a461c547f2a9ff7fb722,0,0,0,0,0,0,0,0,0,0,0,0,0,0,33,1,0,0,0,0,0,0,0,0,0,1,100
e3a4d80b0adba24aa6eea5556a1928b468aefb8b,3,14,2,12,0,0,0,4,41,32,1,2,1.418564443,1174,143,4,204,205,1,6176,6155,21,81,80,1,1,100
2465befcaf594c91e9c0124209d3137db04fe476,0,0,0,0,0,0,0,0,0,0,0,0,0,0,208,1,0,0,0,0,0,0,0,0,0,1,100
3989b67816807c254edeaccbbd1ba0b3f454fe83,0,0,0,0,0,0,0,0,0,0,0,0,0,0,144,5,0,0,0,0,0,0,0,0,0,1,100
39b23e5a6cd6185c45853e43af72e6eb2f68f5cd,2,22,2,20,0,0,0,4,42,102,2,2,0.870864469,861,145,6,124,116,8,4562,4447,115,50,48,2,1,100
883666c6755d6f291650f17ad81ef2e0c87ad872,0,0,0,0,0,0,0,0,0,0,0,0,0,0,0,0,0,0,0,0,0,0,0,0,0,1,100
10f2befe97f597ebef7cc7ad032e833633905117,3,108,7,101,0,0,0,1,3,189,2,3,1.131406787,584,146,6,111,93,18,3820,3101,719,60,54,6,0,100
d8f4b2eab64c902e9e2018c25ef11f2a88acb2b6,2,21,3,18,0,0,0,7,51,206,2,2,0.41381685,1422,130,0,342,338,4,7670,7581,89,29,29,0,1,100
2fcd7f7cc175c0734443638b99c359e24c0f88ff,872,40387,14119,26268,174,36,210,5,105,141,39,172,8.113190868,183789,127,1,29446,25500,3946,1002909,898976,103933,10036,8389,1647,1,85.07233669
651be2b08ec009f4e7bfc6be6f760db7ab840870,872,14121,40389,26268,36,174,210,5,112,465,39,172,8.113357903,210057,5,0,25500,29446,3946,898976,1002909,103933,8389,10036,1647,0,85.07233669
36da4241c2c81d6b5fe4d06b9312f1e19060f1f2,0,0,0,0,0,0,0,0,0,0,0,0,0,0,34,1,0,0,0,0,0,0,0,0,0,1,100
d3d03a10d6bf30857d50efdc6a6f8cc9fc829397,0,0,0,0,0,0,0,0,0,0,0,0,0,0,35,1,0,0,0,0,0,0,0,0,0,1,100
a51da0013e82dd2e416991704a745fbe5d1ef47f,2,5,5,0,0,0,0,3,7,193,1,1,0.721928095,642,104,0,98,98,0,3186,3186,0,41,41,0,0,100
964253905c0b6d893748180a44d02c13aee851df,1,4,4,0,0,0,0,5,10,228,1,1,0,98,4,0,12,12,0,537,537,0,3,3,0,1,100
fdc3148b9ddab85d489b9bb0b7bbad54b7499790,1,4,4,0,0,0,0,5,11,0,1,1,0,98,5,1,12,12,0,537,537,0,3,3,0,1,100
c0398aaca1c6b00fc82734d896a560066b73a6bc,1,9,7,2,0,0,0,7,52,22,1,1,0,1358,131,1,342,342,0,7335,7324,11,29,29,0,1,100
4148631896dc6576ccc7e9d6eaaeca375c7ce3b8,1,3,2,1,0,0,0,7,53,0,1,1,0,1360,132,2,342,342,0,7338,7335,3,29,29,0,1,100
b995253899ef6e204be70473e6ed94764f25107b,0,0,0,0,0,0,0,0,0,0,0,0,0,0,34,0,0,0,0,0,0,0,0,0,0,1,100
ebcf9dd5e8c35a12b84405067bb7db0c5c3596c6,6,134,27,107,0,0,0,5,45,776,1,2,2.52664453,2817,35,1,573,550,23,18610,17616,994,110,106,4,1,100
200dd5a7336fe84443e7e4a9079cb93fd7393735,875,40424,14264,26160,174,36,210,5,105,141,39,172,8.125562907,184169,117,0,29466,25543,3923,1004167,901231,102936,10048,8405,1643,1,85.07233669
043daf31b3310d7a2f7bab1f81cfbeb99232bb35,1,3,2,1,0,0,0,7,48,0,1,1,0,1322,118,1,332,332,0,7125,7122,3,29,29,0,1,100
83674c7d54d78821edc4a5e72e9ec8dae68fb4ea,875,14355,40425,26070,36,174,210,5,112,467,39,172,8.127238856,210330,147,3,25558,29466,3908,901806,1004170,102364,8407,10048,1641,1,85.07233669
a1dd7be65d9e0ac82b45aa6cb357a657ecab8c4f,1,20,1,19,0,0,0,7,21,112,1,1,0,1027,148,4,179,175,4,6424,6335,89,16,15,1,1,100
7901d43c21d3e392c2f88ed40c22d5c84e227fac,3,56,10,46,0,0,0,1,22,246,1,3,1.571712608,1399,149,5,229,221,8,8741,8482,259,36,34,2,1,100
72ebe7c248a8c2bbc319146885cfb7cc21d92c81,1,1,1,0,0,0,0,4,4,394,1,1,0,212,105,1,27,27,0,1048,1048,0,9,9,0,1,100
32168d60dc3e0a44c9585a67100c9da8cc7b84e0,1,1,1,0,0,0,0,4,5,0,1,1,0,212,106,2,27,27,0,1048,1048,0,9,9,0,1,100
dac747548fccb60fe9ff632e5cf66517414385f2,1,2,2,0,0,0,0,5,6,0,1,1,0,212,6,2,27,27,0,1048,1048,0,9,9,0,0,100
18e248a4c8a52ff61fccc1dede3dac41e2c615e0,0,0,0,0,0,0,0,0,0,0,0,0,0,0,107,3,0,0,0,0,0,0,0,0,0,0,100
5e7b555cd44e48f76c4b9939a3504459b9ab9523,3,43,3,40,0,0,0,5,47,198,2,3,0.997626792,2001,150,6,404,395,9,11649,11373,276,91,89,2,1,100
f2990fe78260b08144a204697770ad374d1a3d6b,876,40426,14373,26053,174,36,210,5,105,138,39,172,8.127427788,184458,119,2,29485,25593,3892,1005126,902775,102351,10057,8418,1639,1,85.07233669
4b9497b62fdd2b7f0bd2c57b0331fe815ae928b8,876,14375,40428,26053,36,174,210,5,112,466,39,172,8.12758693,210511,209,0,25593,29485,3892,902775,1005126,102351,8418,10057,1639,1,85.07233669
11e869f42330a00771ab200ad9e0e176cbd7787a,1,1,1,0,0,0,0,5,9,183,1,1,0,3790,7,3,594,594,0,17542,17542,0,205,205,0,1,100
45f145093338a1604015ec53670de4384722c530,1,1,1,0,0,0,0,7,10,246,1,1,0,225,8,4,42,42,0,945,945,0,10,10,0,1,100
bf649f0978159cfe8021fa2aa35b4a76e9d7d93b,1,1,1,0,0,0,0,3,4,183,1,1,0,190,9,5,28,28,0,729,729,0,9,9,0,1,100
c51d7900c185395c8b4a18220f7aaec66197d21b,1,1,1,0,0,0,0,3,4,183,1,1,0,203,10,6,26,26,0,770,770,0,9,9,0,1,100
1ee7025fa6864089df22ccbabc4d860755623bf8,1,1,1,0,0,0,0,6,8,183,1,1,0,289,11,7,38,38,0,1126,1126,0,13,13,0,1,100
9a9e6e8dc8028c0179f346f05c0ed121b99d72d6,1,1,1,0,0,0,0,4,6,183,1,1,0,139,12,8,18,18,0,504,504,0,7,7,0,1,100
09b57de3b7d3e0365603f4bef8a8655463574913,1,5,2,3,0,0,0,9,21,247,1,1,0,279,0,0,42,42,0,1356,1350,6,20,20,0,1,100
ba5353df997f68ce224a26757a0cc71d5c3bbabc,0,0,0,0,0,0,0,0,0,0,0,0,0,0,96,0,0,0,0,0,0,0,0,0,0,1,100
7676341a08664d7726c6aa31510255e90d56aa35,1,77,0,77,0,0,0,6,29,247,1,1,0,834,36,2,176,151,25,6117,5479,638,18,17,1,1,100
fcb9a9bc9a48aac62b29f8b3cdf26c8326c7a9a7,1,32,27,5,0,0,0,7,23,14,1,1,0,1065,151,4,185,181,4,6545,6521,24,16,16,0,1,100
0ef1622b997861b848c2ab9606932b4316421cbf,0,0,0,0,0,0,0,0,0,0,0,0,0,0,108,4,0,0,0,0,0,0,0,0,0,1,100
510697aef5c782367d918020732b8e307f495909,7,33,10,23,0,0,0,7,32,288,1,6,1.812067905,4346,37,3,507,501,6,24305,24130,175,171,171,0,1,100
263bf4353e6aceceac5d2e522e90eb09392514f1,0,0,0,0,0,0,0,0,0,0,0,0,0,0,210,1,0,0,0,0,0,0,0,0,0,1,100
d6308e68ad66211731f7d3949f5b219d7ba015cc,874,40418,14366,26052,174,36,210,5,105,143,39,172,8.122147521,184363,25,0,29494,25614,3880,1004892,902390,102502,10052,8410,1642,1,85.07233669
c4b0542896714b71bdac0d5e8398354b22e133ed,874,14383,40435,26052,36,174,210,5,112,459,39,172,8.123152044,210415,109,5,25614,29494,3880,902386,1004892,102506,8410,10052,1642,1,85.07233669
2f77beafaa0bffe1e6bfc6e6597f1fff7b569e4d,1,2,2,0,0,0,0,11,33,0,1,1,0,1277,13,9,226,226,0,6842,6842,0,37,37,0,1,100
e1993673264810611bf46914c948c225281ec5c1,0,0,0,0,0,0,0,0,0,0,0,0,0,0,14,10,0,0,0,0,0,0,0,0,0,1,100
937613250e4d4793c3ab89ec82d1b28a0b57451b,1,10,1,9,0,0,0,1,2,173,1,1,0,335,110,6,16,15,1,2347,2281,66,6,6,0,0,100
62689c3c80b7143309fa3de48202060926ac6025,0,0,0,0,0,0,0,0,0,0,0,0,0,0,15,11,0,0,0,0,0,0,0,0,0,1,100
fda9a01d049cd6c4c2b8eb525514293e4b2dc785,1,1,0,1,0,0,0,7,12,255,1,1,0,411,16,12,43,43,0,2349,2345,4,6,6,0,1,100
6ba6af021e44d929fe77ef8fb60f0fe6a1c79b7b,1,1,1,0,0,0,0,3,3,438,1,1,0,223,111,7,25,25,0,806,808,2,14,14,0,0,100
57c88b548d74f775255fe94646f0b78de49b1af7,1,0,1,1,0,0,0,7,19,3,1,1,0,644,112,8,119,119,0,3830,3837,7,19,19,0,0,100
4a565dfbc6661ea74abd70aed4d02e5bbe50bcf6,1,8,1,7,0,0,0,11,34,5,1,1,0,1277,38,4,229,226,3,6907,6842,65,37,37,0,1,100
68898eff03f33e6cf1468c72f32cb4ec2b2d4559,1,1,4,3,0,0,0,7,13,15,1,1,0,412,133,1,43,43,0,2339,2349,10,6,6,0,1,100
1e2e04792975e30d942d208686b0483608639288,1,79,52,27,0,0,0,5,15,185,1,1,0,322,17,11,58,46,12,1859,1695,164,6,6,0,1,100
ed1670212422a7186974ecd8906393195017ce2c,0,0,0,0,0,0,0,0,0,0,0,0,0,0,0,0,0,0,0,0,0,0,0,0,0,1,100
43e2f3d1358490390ed115cdf1f4cc841ad7d5a3,0,0,0,0,0,0,0,0,0,0,0,0,0,0,92,0,0,0,0,0,0,0,0,0,0,0,100
31701840c03d2ecd87c282dae874c55865bcf907,1,4,0,4,0,0,0,8,54,42,1,1,0,1361,1,0,344,342,2,7382,7338,44,29,29,0,1,100
001c91155a9439c26961277e68c355f86f49fec6,2,12,2,10,0,0,0,5,102,480,1,2,0.985228136,3177,211,2,526,522,4,20294,20233,61,84,84,0,1,100
988b2d7aad34fd3445ab4e70ae7460e3f103d6a0,1,1,1,0,0,0,0,4,4,274,1,1,0,39,39,3,2,2,0,81,74,7,1,1,0,1,100
629e2007828db2e594379536802ba8503b179e88,0,0,0,0,0,0,0,0,0,0,0,0,0,0,18,5,0,0,0,0,0,0,0,0,0,1,100
85093b8b4f99775d0ab08428d2184a77ec3da7f8,1,8,3,5,0,0,0,4,10,289,1,1,0,291,0,0,49,48,1,1656,1612,44,7,7,0,1,100
115f9d434894097b295efdf4a73e31ae560de508,876,40491,14464,26027,174,36,210,5,105,139,39,172,8.126804676,185287,21,0,29605,25742,3863,1010657,908392,102265,10093,8450,1643,1,85.07233669
c3a2b50c4d62987b101735087df40f7de97075de,2,12,3,9,0,0,0,2,94,385,1,2,0.566509507,2529,22,1,437,429,8,15106,15003,103,59,59,0,1,100
8992c35df5d1b80c14c3ef1bb111af5c131c6536,3,338,247,91,0,0,0,3,95,313,1,2,0.659397536,5047,26,1,999,983,16,31761,31496,265,147,145,2,1,100
a38480fe35e878b0eb1b505bc978a8bc2432235c,22,26,58,32,0,0,0,10,96,636,9,19,4.301535841,13555,67,0,2383,2389,6,75522,75606,84,449,449,0,1,100
dc873cb29118738cb28981fc79b898e09da1ec56,32,693,301,392,1,0,1,11,97,564,2,10,3.973808431,12818,128,0,2579,2487,92,69334,66103,3231,640,615,25,1,99.95901639
9039504bc68e99dbb4459c4ee6b4bed14078c93f,1,5,71,66,0,0,0,2,3,51,1,1,0,606,30,0,29,31,2,4248,4726,478,29,31,2,1,100
c599bbb4aa1c2948fbef9a1164a5a121de23ad8c,2,21,10,11,0,0,0,11,106,164,2,2,0.458685816,3903,129,1,706,704,2,26306,26233,73,80,79,1,1,100
dd8a58177356408eef4df31b94a35a8c570e5464,1,1,0,1,0,0,0,11,107,0,1,1,0,3830,316,0,706,706,0,25950,25941,9,80,80,0,1,100
76867e570f23bd542d47a8cc0c27a8c51e41e7c9,2,69,2,67,0,0,0,3,4,757,1,2,0.18512476,653,317,1,45,43,2,5299,4806,493,35,33,2,1,100
05e179d442192b6e64d174a6786de0a90716ba8a,864,13640,39968,26328,36,174,210,5,112,455,39,172,8.100317572,209171,40,2,25410,29363,3953,894339,999249,104910,8349,10014,1665,1,86.31450133
31118afd4f0d10ad65faadfce69e0c2755cee030,1,86,49,37,0,0,0,7,14,27,1,1,0,409,19,2,61,43,18,2592,2339,253,6,6,0,1,100
b8dada7b01ab136b1c98ffb872f739eba5bc2f8b,0,0,0,0,0,0,0,0,0,0,0,0,0,0,36,0,0,0,0,0,0,0,0,0,0,1,100
1ff41050015b7be736268f6c84e683121cfffd7b,1,3,1,2,0,0,0,8,55,29,1,1,0,1365,134,1,345,344,1,7398,7382,16,29,29,0,1,100
22029847559b3881cdc3176b15e545e847ef6d7c,1,84,3,81,0,0,0,4,17,114,1,1,0,216,152,0,63,43,20,1448,1017,431,19,11,8,1,100
9dfde6de92799d7d923cf8eb11bbdc8788d6664c,864,40012,13723,26289,174,36,210,5,107,159,39,172,8.102902785,182963,130,2,29383,25449,3934,999680,895039,104641,10022,8357,1665,1,86.31450133
86b606571938658101886c0473701f95da031300,0,0,0,0,0,0,0,0,0,0,0,0,0,0,61,0,0,0,0,0,0,0,0,0,0,1,100
f303c1bd419b457e7fb2190cd8c56c4d54d36d43,866,13729,40018,26289,36,174,210,5,112,454,39,173,8.103721122,209520,33,0,25459,29393,3934,896623,1001264,104641,8367,10032,1665,1,85.98817051
d77f02969c7567fc0fb57163724e18a0262134a6,2,214,83,131,0,0,0,2,19,251,1,2,0.503258335,931,153,1,184,171,13,6502,5760,742,32,26,6,1,100
0dc91ed3b089fdce99d63de4a3cbe71b9203f262,1,68,60,8,0,0,0,9,15,217,1,1,0,426,135,1,68,63,5,2414,2338,76,8,8,0,1,100
5357e9e5eee651cf2b464b421ec5272e959f0c86,1,20,17,3,0,0,0,7,20,74,1,1,0,643,113,0,121,119,2,3878,3830,48,19,19,0,1,100
f895f2a5292a4cd46a5a8f0b69b71682bfe0c1d9,1,3,3,0,0,0,0,2,5,330,1,1,0,229,114,1,28,28,0,882,882,0,13,13,0,1,100
3031af53e6201b0cb94bf970e46baacf3e2451a9,0,0,0,0,0,0,0,0,0,0,0,0,0,0,115,2,0,0,0,0,0,0,0,0,0,0,100
92200a5f1feff2bea850a750b189b6b15b96c2fa,1,18,35,17,0,0,0,9,18,330,1,1,0,455,20,1,62,65,3,2487,2619,132,13,12,1,1,100
37035c36725a04a1f63a776c3037000e803672ca,1,22,23,1,0,0,0,9,19,0,1,1,0,438,116,3,62,62,0,2487,2487,0,13,13,0,0,100
2afe8af3697257485c61426832ad290ff9dcc206,1,4,0,4,0,0,0,8,21,2,1,1,0,646,21,2,121,121,0,3914,3878,36,19,19,0,1,100
da7ae44a644063de12faa7676197b8aa9980a38a,1,0,6,6,0,0,0,8,22,0,1,1,0,650,22,3,118,121,3,3866,3914,48,19,19,0,1,100
688f1c09b918190f427cdcee08af1069605467c8,1,41,47,6,0,0,0,8,23,0,1,1,0,644,117,4,115,118,3,3836,3866,30,19,19,0,0,100
af3b31b5319613c82b12cc7bf411a935c03b8c69,1,292,292,0,0,0,0,13,34,333,1,1,0,955,118,5,207,207,0,4654,4654,0,74,74,0,0,100
8ba81a6e35bb05dae7723138743ccba8c9654048,1,15,11,4,0,0,0,9,20,2,1,1,0,437,23,4,64,62,2,2530,2487,43,13,13,0,1,100
a99e377d39bce90b39b9fd7f2cc1068e1856fd1c,20,673,309,364,1,0,1,6,113,279,7,15,2.139920761,13080,37,1,2197,2106,91,73657,70797,2860,375,366,9,1,96.13485076
7e1c021bd039d450c4bcdf1056273eee46618cf7,0,0,0,0,0,0,0,0,0,0,0,0,0,0,38,2,0,0,0,0,0,0,0,0,0,1,100
2fb94cc54e60e87d190f14f21f0d29f750894adf,8,869,0,869,6,0,6,1,22,77,1,4,2.238931429,1839,26,0,498,384,114,13021,8517,4504,118,77,41,1,98.03087939
2aca79045ea8892c569319ed552bc4157a9e58a9,2,179,3,176,0,0,0,6,12,334,2,2,0.920116457,376,41,1,145,95,50,3601,2108,1493,18,16,2,1,99.97801231
387aaf8a96070629a9e1a3014060731fa343f207,6,69,12,57,0,0,0,3,114,190,1,2,2.490935349,4800,154,2,882,859,23,31516,31050,466,137,133,4,1,100
b2774746c65f037d5bab2e04b6db24122abe9405,2,11,3,8,0,0,0,6,31,334,1,1,0.863120569,1575,155,3,298,295,3,10712,10662,50,100,100,0,1,100
07f0fee7c8cd8355d5c184ae772ac2aa7dd33563,3,347,48,299,2,0,2,1,3,26,1,1,1.227052418,344,119,6,28,16,12,4063,2347,1716,10,6,4,1,99.86821876
18406ea591c17c2e8c6d2e522ea8ac6fe7f6b21a,1,3,3,0,0,0,0,2,6,5,1,1,0,229,120,7,28,28,0,882,882,0,13,13,0,1,100
ae4efea6db2df48fff182284ea65cd1a98ba5b6f,1,270,270,0,0,0,0,10,26,2,1,1,0,781,121,8,126,126,0,4059,4072,13,19,19,0,0,100
814ed7ee81a6f96ce10ee726d4e02838e178412a,1,6,5,1,0,0,0,9,21,2,1,1,0,441,24,5,63,64,1,2538,2530,8,13,13,0,1,100
607c341521a87876cc5efc920f2e97c3a2695f3b,2,3,3,0,0,0,0,11,115,2,1,1,1,4452,156,4,815,815,0,29679,29680,1,112,112,0,1,100
6905ade8edae49e88a3a13cfe3bd53badc765ae9,0,0,0,0,0,0,0,0,0,0,0,0,0,0,25,6,0,0,0,0,0,0,0,0,0,1,100
c008f391bfcd577b24388cf9fb6c2ff021a10238,1,5,6,1,0,0,0,10,22,3,1,1,0,442,60,0,64,63,1,2530,2538,8,13,13,0,0,100
e024d3cd36ecd66264ceaeaf35c7de0748a8d61b,1,11,15,4,0,0,0,10,23,0,1,1,0,441,61,1,62,64,2,2487,2530,43,13,13,0,0,100
1796bc1f1d4ddd577f8ca8a515b16685c64ad955,1,23,22,1,0,0,0,10,24,0,1,1,0,437,62,2,62,62,0,2487,2487,0,13,13,0,0,100
1f855bcf94522f1c492859de92ce0ec7087e88ca,1,35,18,17,0,0,0,10,25,0,1,1,0,438,63,3,65,62,3,2619,2487,132,12,13,1,0,100
6b03a286b188b98928251bce2637ba080f2f9f41,3,19,9,10,0,0,0,1,4,6,1,1,1.497249983,643,122,9,28,28,0,4128,4063,65,10,10,0,0,100
c19ec875742665ab96577f5a27ebac2da036d3bc,0,0,0,0,0,0,0,0,0,0,0,0,0,0,42,1,0,0,0,0,0,0,0,0,0,1,100
823f51fecd63c9d59690de225db224918a3d60d2,2,3,2,1,0,0,0,4,26,174,2,2,0.721928095,716,39,2,121,121,0,3818,3802,16,28,28,0,1,100
1a68c9586dcf74c4c0ed29035678d28a907ce94e,1,5,3,2,0,0,0,1,2,30,1,1,0,90,34,1,6,6,0,410,394,16,6,6,0,1,100
51c340ec1d2cd7b0995215c89c5de1939e0ebe13,1,6,0,6,0,0,0,10,22,96,1,1,0,282,136,1,43,42,1,1392,1356,36,21,20,1,1,100
6f89b16fb53886d0dda9e286b6b21ba4ce493f06,876,41058,16695,24363,174,45,219,5,107,149,39,173,8.143557102,185283,68,0,29416,25790,3626,1001879,909270,92609,10035,8437,1598,0,85.12711864
fe48d911e2a6829a30cdb0ced3d0e52c6865ac0c,876,16688,41052,24364,45,174,219,6,115,449,39,173,8.143664307,209646,43,2,25790,29416,3626,909261,1001879,92618,8437,10035,1598,1,85.12711864
11aa58b634606908c217a23159c8a6d8c7733328,3,149,75,74,0,0,0,11,116,126,1,3,0.738141721,7115,40,3,1329,1306,23,46860,46206,654,161,160,1,1,100
eaef96be8f4ac96522cd25173146e3f3fbfa3b37,2,184,56,128,0,0,0,2,32,162,1,2,0.2108423,2033,157,4,308,306,2,14658,13852,806,114,111,3,1,100
2a3e15e4cfe7ec67d70a2b45e2598bd889bf6ff6,1,2,0,2,0,0,0,4,10,355,1,1,0,119,158,5,21,21,0,591,582,9,5,5,0,1,100
7a1c72262684a862f8df4ba908c5a2a918cb1f53,1,1,1,0,0,0,0,3,13,243,1,1,0,396,159,6,90,90,0,2209,2207,2,9,9,0,1,100
2261a9dca231b4b3009fc96e362ac64f9f09ece3,12,2096,12,2084,5,0,5,1,46,86,2,10,2.198094773,5782,35,1,1244,954,290,44429,33804,10625,357,284,73,1,99.62800875
bb322268a99b18d029030d0a7987f789b5cf8c48,1,54,64,10,0,0,0,11,27,12,1,1,0,456,27,1,64,65,1,2575,2635,60,13,12,1,1,100
d5fee7873a15c914dc705e10dfe5ff03dca91b81,1,5,1,4,0,0,0,11,22,1,1,1,0,1081,36,2,180,179,1,5876,5851,25,36,36,0,1,100
8ae952943926a00b2ce2a33690d553dc47472235,5,420,100,320,1,0,1,1,7,83,2,3,2.043104938,922,28,2,159,117,42,7040,5252,1788,51,36,15,1,99.82555604
1eb8938debd01c5c7aa5faf6c32179a0f2cddea5,2,47,68,21,0,0,0,11,117,6,1,2,0.534339367,6885,41,4,1268,1272,4,45328,45414,86,146,146,0,1,100
28d2ed14d71185103168d407c5c2efb944fb44f0,0,0,0,0,0,0,0,0,0,0,0,0,0,0,6,0,0,0,0,0,0,0,0,0,0,1,100
de68fbdcee485dacbfa9a7f6841388cc475502d1,0,0,0,0,0,0,0,0,0,0,0,0,0,0,137,2,0,0,0,0,0,0,0,0,0,1,100
05248d513f43a164820339b87b82481e871abf56,1,1,1,0,0,0,0,2,5,358,1,1,0,264,138,3,39,39,0,1446,1452,6,13,13,0,1,100
8719e58011e984cc0f421af722723e0a9d986b2e,1,1,1,0,0,0,0,2,4,0,1,1,0,264,7,1,39,39,0,1452,1446,6,13,13,0,1,100
82682d78296f0c9e83491de37ff64f4370c9bf55,1,1,1,0,0,0,0,2,5,358,1,1,0,264,8,2,39,39,0,1446,1452,6,13,13,0,0,100
bedbc4bda97b54113e166307596d8c62ce5d329f,882,41176,19393,21783,174,51,225,5,107,149,39,173,8.147029536,187863,5,0,29416,26143,3273,1001879,923018,78861,10035,8530,1505,1,84.94510135
fb13db8095329f6b0aa9654d8f59e11025e40ba8,882,19387,41170,21783,51,174,225,6,117,448,39,173,8.147183754,209646,37,3,26143,29416,3273,923018,1001879,78861,8530,10035,1505,1,84.94510135
8f9fec37b0cf2c57b01a965453ef3976791b5a96,0,0,0,0,0,0,0,0,0,0,0,0,0,0,1,0,0,0,0,0,0,0,0,0,0,0,100
16f481ba888077acb4daf5705896a8318aa6a24e,19,588,332,256,1,0,1,3,106,201,4,9,3.237600069,14500,160,6,2349,2289,60,91188,89432,1756,448,442,6,1,99.89118607
10d8f6a649f52230c85a7c3e2f3b53623892f814,0,0,0,0,0,0,0,0,0,0,0,0,0,0,0,0,0,0,0,0,0,0,0,0,0,1,100
337eaac075594328cf8c95d0dbb775489c24027e,0,0,0,0,0,0,0,0,0,0,0,0,0,0,219,0,0,0,0,0,0,0,0,0,0,1,100
8f19bc5dddf4ad310c584dc2eebed614bb3e32bc,0,0,0,0,0,0,0,0,0,0,0,0,0,0,64,4,0,0,0,0,0,0,0,0,0,1,100
e64af0f51670b831dbb5d97f231df05269fff7a4,1,2,4,2,0,0,0,7,29,9,1,1,0,1431,161,7,42,43,1,10598,10608,10,42,42,0,1,100
ed6488361660aecbba1d006f26218e5193995f8f,1,8,1,7,0,0,0,6,12,379,1,1,0,451,38,4,80,79,1,2168,2126,42,27,27,0,1,100
7fe9290b174121025960535ebccb2b0d91e1855e,3,151,136,15,0,0,0,11,118,138,2,3,1.233463963,4281,212,0,787,783,4,29297,29125,172,105,105,0,1,100
e3b0ce2d9760f9f85cddaea6adb1db4fb2abdaeb,6,198,203,5,0,0,0,2,107,24,2,5,0.988630487,4118,42,3,728,727,1,25421,25338,83,100,100,0,1,100
4d9eca77698db58097b5266f71535a854d1b9bda,3,3,4,1,0,0,0,13,36,21,1,2,1.556656707,2630,39,5,460,460,0,13508,13513,5,118,118,0,1,100
4603dfa3de3921d1b6c6e1be10dfb82720896de6,3,47,57,10,0,0,0,5,25,216,3,3,1.553137672,1271,139,3,205,199,6,6379,6263,116,53,54,1,1,100
306075df553e295041ef5b6e5b01a8a6799c9654,4,449,11,438,3,0,3,1,5,95,1,2,1.477537266,62,26,0,63,5,58,2579,275,2304,14,4,10,1,99.67490247
9fea06dbb70adc2a0c33d5ab3b019064f571a141,0,0,0,0,0,0,0,0,0,0,0,0,0,0,27,1,0,0,0,0,0,0,0,0,0,1,100
987a8c0366c1c6a881a461127b8ac1bdf6d68724,1,4,3,1,0,0,0,13,37,4,1,1,0,1002,40,6,221,219,2,4898,4899,1,78,78,0,1,100
5c2eee8ab4f64ea5d99c957f50827f3c186a82a1,0,0,0,0,0,0,0,0,0,0,0,0,0,0,123,0,0,0,0,0,0,0,0,0,0,0,100
223a14974c4614ecf0d0d537c62b5b1319d8d7b7,2,18,13,5,0,0,0,1,47,19,2,2,0.554778163,2785,41,6,555,555,0,17373,17338,35,99,99,0,1,100
d55fad42315022931e210176fb339650181339be,1,12,10,2,0,0,0,7,26,12,1,1,0,902,140,3,160,160,0,4556,4546,10,43,43,0,1,100
49af166e2a9427480c62d97d85810fc9119d4d7e,0,0,0,0,0,0,0,0,0,0,0,0,0,0,28,2,0,0,0,0,0,0,0,0,0,1,100
6c9a84244ffbca2645d2ad190862d8287a01233b,0,0,0,0,0,0,0,0,0,0,0,0,0,0,29,3,0,0,0,0,0,0,0,0,0,1,100
c4e078ecb44583303cead25fe85df78ecda6b545,82,77,98,21,0,0,0,3,36,444,15,30,6.329698755,23667,2,1,3278,3278,0,124831,124898,67,852,852,0,0,100
65bc6a51b8ba4c319515281e3b557f7f0b608a31,2,2,2,0,0,0,0,2,6,392,1,2,1,164,124,1,16,16,0,668,664,4,5,5,0,0,100
90619aa108f4bca13f0679a66e3d6aff45ea9215,0,0,0,0,0,0,0,0,0,0,0,0,0,0,125,2,0,0,0,0,0,0,0,0,0,0,100
70fc18099bd54c290aa832e3708c72f5307d7d55,0,0,0,0,0,0,0,0,0,0,0,0,0,0,30,4,0,0,0,0,0,0,0,0,0,1,100
4dc8cc0b763779ee6a0f589285e7dd9d95391038,1,5,0,5,0,0,0,11,28,39,1,1,0,446,31,5,66,64,2,2610,2575,35,13,13,0,1,100
701a368ada9d3fa0ea446fc6c238a1bfcf0ea1f9,1,2,2,0,0,0,0,11,29,0,1,1,0,451,126,3,66,66,0,2610,2610,0,13,13,0,0,100
653d86c48623abc6fb29ae8b3a759039a7f07afc,29,145,240,95,0,0,0,3,25,683,1,1,4.737181448,4110,3,2,475,476,1,22616,23380,764,174,175,1,0,95.77319588
d6d5c2c3127f1d47a99637a95d34edb7559ee160,4,7,9,2,0,0,0,2,13,306,1,3,1.905639062,894,127,4,138,138,0,4674,4678,4,27,27,0,0,100
2135a00370e47d1b46b60d4c39dee82cb1c7fad7,1,1,1,0,0,0,0,1,4,10,1,1,0,809,42,7,120,119,1,4386,4382,4,26,26,0,1,100
8a398878a195b2bf2f260bd4019f544b0d6c30eb,2,18,8,10,0,0,0,11,108,11,2,2,0.619382195,3289,29,2,599,601,2,20598,20537,61,81,81,0,1,100
82189ab24fd6957b5e877a30ddefbfd5c9c1d0b1,0,0,0,0,0,0,0,0,0,0,0,0,0,0,32,6,0,0,0,0,0,0,0,0,0,1,100
65f4de2bd69765f63ad95b82a742b2dbb769b273,0,0,0,0,0,0,0,0,0,0,0,0,0,0,33,7,0,0,0,0,0,0,0,0,0,1,100
1ffe400869788cb83e9f418f303c964dfabf3a55,1,1,1,0,0,0,0,4,22,34,1,1,0,438,128,5,78,78,0,2138,2138,0,17,17,0,0,100
1bcb9ebe55746ae69bd1d099af678a8f24c0c2f2,1,2,1,1,0,0,0,9,25,9,1,1,0,638,34,8,115,115,0,3844,3837,7,19,19,0,1,100
84b28e9a7137db73a029fd9164d5dffb32cb5d3b,2,2,2,0,0,0,0,7,11,235,1,1,1,545,35,9,68,68,0,2491,2473,18,15,15,0,1,100
d7f73fe4243856c60f1260e72c2e1aec1f96f07a,0,0,0,0,0,0,0,0,0,0,0,0,0,0,36,10,0,0,0,0,0,0,0,0,0,1,100
46c446f23eba7b9bb9dd6721c117a96c2ffc64b7,3,29,20,9,0,0,0,3,33,287,1,2,1.529786509,1668,162,2,291,290,1,11249,11169,80,100,100,0,1,100
ca2d2f9d7c338637f81878b902cf8955cb692a9e,1,1,1,0,0,0,0,8,56,104,1,1,0,1367,141,2,345,345,0,7398,7398,0,29,29,0,1,100
1cf39781ba54b78fb4544dfd02536bc300b1b5b3,1,4,5,1,0,0,0,7,20,90,1,1,0,646,142,3,169,165,4,4234,4210,24,23,23,0,1,100
3d158d51adf0deedd023aefdad026855459d8d57,4,1075,9,1066,2,0,2,1,18,232,1,3,0.80017543,873,143,4,264,116,148,9128,4330,4798,60,23,37,1,99.90151664
436b1fa9ed1b5c915129cd83017eef657aff25ac,1,6,6,0,0,0,0,11,119,27,1,1,0,3880,163,3,716,716,0,26699,26691,8,84,84,0,1,100
37a253d4f175d1fa1b8667d3125a7592e7918529,3,44,36,8,0,0,0,2,21,335,1,2,1.336666482,904,164,3,150,147,3,5122,5076,46,23,23,0,1,100
be582b59c2e459cefbe04dc01105c334a7ac216b,1,23,3,20,0,0,0,8,57,0,1,1,0,1367,144,5,349,345,4,7493,7398,95,30,29,1,1,100
bf29570d00db51e9ca6cfc27d7043b3ce10af1d8,1,7,6,1,0,0,0,4,10,242,1,1,0,708,43,5,44,44,0,3515,3515,0,19,19,0,1,100
59c5c9e856ddaf59dee9a2227b438375359ea650,0,0,0,0,0,0,0,0,0,0,0,0,0,0,145,6,0,0,0,0,0,0,0,0,0,1,100
0668f632700bdb35ec6e32a54c7713d7c91a66c4,3,28,44,16,0,0,0,6,109,41,1,2,1.515541327,3887,30,1,683,678,5,22518,22583,65,95,95,0,1,100
a7a631d5d8d102b5ae7eadb24e6781b3809d7d5b,4,172,18,154,0,0,0,8,38,28,4,4,1.539446801,2151,2,0,502,437,65,12845,11523,1322,109,108,1,1,100
da730073faaa0d426b9dded8b3c448cd44536f10,1,34,29,5,0,0,0,1,2,20,1,1,0,914,146,6,127,123,4,4259,4184,75,27,27,0,1,100
4370b6b135ca5288bf25bd6f7a353b9699821099,1,23,21,2,0,0,0,6,11,348,1,1,0,399,165,3,59,58,1,2043,2037,6,23,23,0,1,100
5aceeaf0cf2c3eaf66f5a8b9d2736d24bde62b15,1,0,2,2,0,0,0,1,5,29,1,1,0,809,44,3,120,120,0,4369,4386,17,26,26,0,1,100
509b316ef10e1c5a927b2662e337717ca23bae43,0,0,0,0,0,0,0,0,0,0,0,0,0,0,9,0,0,0,0,0,0,0,0,0,0,1,100
869c723f126b7fa2b7c3aa796d805ec7e494de62,0,0,0,0,0,0,0,0,0,0,0,0,0,0,10,1,0,0,0,0,0,0,0,0,0,1,100
06005ca39b12bde4042804bf538ab855507c983f,1,1,0,1,0,0,0,5,8,41,1,1,0,338,37,9,76,76,0,1811,1807,4,12,12,0,1,100
5eb030ada419c4b1aaff4474ac98b6680667efb0,1,14,1,13,0,0,0,2,2,51,1,1,0,292,129,5,40,38,2,1694,1649,45,6,6,0,1,100
bc8ebde4a61aa1aee31403c0f2d43b2a4c07a8b3,2,80,16,64,0,0,0,5,48,44,1,2,0.14609425,2242,43,0,508,492,16,14716,14175,541,89,89,0,1,100
82509d969cb7c4c8c7092ce84b8f6ee91186af6c,0,0,0,0,0,0,0,0,0,0,0,0,0,0,11,2,0,0,0,0,0,0,0,0,0,1,100
f39e4880082f5579db49b29be735977a341c041b,0,0,0,0,0,0,0,0,0,0,0,0,0,0,12,3,0,0,0,0,0,0,0,0,0,1,100
4a1e4928ac4cdb2c7494d0700efe0e8fbd2980dc,3,29,20,9,0,0,0,3,33,284,1,2,1.529786509,1668,162,2,291,290,1,11249,11169,80,100,100,0,1,100
254ebf1569de4ef4792033d21c321e93592ebd14,1,4,5,1,0,0,0,7,20,88,1,1,0,646,141,2,169,165,4,4234,4210,24,23,23,0,1,100
0981a4628849d4b8f8d5624a10ec74cf013dc188,1,1,1,0,0,0,0,8,56,102,1,1,0,1367,142,3,345,345,0,7398,7398,0,29,29,0,1,100
eb101791586fe974fa41671cd0bb004578368d09,1,1,1,0,0,0,0,5,9,360,1,1,0,546,130,7,115,115,0,3202,3198,4,14,14,0,0,100
5c5b47b6cbbeba92523d4c393519e8ffd688f0e9,0,0,0,0,0,0,0,0,0,0,0,0,0,0,37,11,0,0,0,0,0,0,0,0,0,1,100
9558aa3a2d629f8955b7491f306590c437c1fda8,1,2,1,1,0,0,0,3,4,12,1,1,0,137,38,12,19,19,0,703,693,10,5,5,0,1,100
7802c83cb8eb0c76a5e57bea1d7a2aa213483385,0,0,0,0,0,0,0,0,0,0,0,0,0,0,131,8,0,0,0,0,0,0,0,0,0,0,100
525098460de96ce66877929b5cd0039d3fdc7862,8,34,20,14,0,0,0,2,14,451,1,3,2.42483468,1626,4,3,281,277,4,9737,9656,81,68,66,2,1,100
46c446f23eba7b9bb9dd6721c117a96c2ffc64b7,12,28,42,14,0,0,0,1,55,455,4,7,3.027753518,4336,162,2,921,929,8,25155,25274,119,137,139,2,1,100
691c01f53aacd2ae7da0d51d2c983be739620e96,106,596,649,53,0,0,0,2,56,435,5,35,5.66558873,35300,5,4,6360,6352,8,190423,191357,934,1894,1892,2,1,100
ca2d2f9d7c338637f81878b902cf8955cb692a9e,105,648,595,53,0,0,0,1,52,324,4,34,5.657450553,33880,141,2,6007,6015,8,183959,183025,934,1863,1865,2,1,100
1cf39781ba54b78fb4544dfd02536bc300b1b5b3,1,4,5,1,0,0,0,7,20,90,1,1,0,646,142,3,169,165,4,4234,4210,24,23,23,0,1,100
543b591d58910b12516344c7a4a667dfb4942742,108,1666,652,1014,2,0,2,2,53,438,4,36,4.37173,34160,143,4,6110,5958,152,187919,184079,3840,1902,1863,39,1,99.90151664
3d158d51adf0deedd023aefdad026855459d8d57,104,643,591,52,0,0,0,1,52,324,3,33,5.636374986,33235,143,4,5842,5846,4,179749,178791,958,1840,1842,2,1,100
fbc7f19db32200bc35211cbe6c309e8a3e53fed0,105,597,649,52,0,0,0,2,119,438,3,34,5.660427727,37167,163,3,6562,6558,4,205490,206440,950,1926,1924,2,1,100
436b1fa9ed1b5c915129cd83017eef657aff25ac,104,643,591,52,0,0,0,1,52,324,3,33,5.636374986,33235,163,3,5842,5846,4,179749,178791,958,1840,1842,2,1,100
e4122919c46bd9fec38a76b27c7e0f5fb98a5f5b,107,635,679,44,0,0,0,2,53,443,4,35,5.705536076,34191,164,3,5996,5989,7,183913,184825,912,1865,1863,2,1,100
37a253d4f175d1fa1b8667d3125a7592e7918529,104,643,591,52,0,0,0,1,52,324,3,33,5.636374986,33235,164,3,5842,5846,4,179749,178791,958,1840,1842,2,1,100
239cc55e11b5fc46761d6cde49a5c908938fb111,105,614,646,32,0,0,0,2,57,438,4,34,5.665059588,34654,144,5,6195,6187,8,186284,187147,863,1872,1869,3,1,100
be582b59c2e459cefbe04dc01105c334a7ac216b,104,643,591,52,0,0,0,1,52,324,3,33,5.636374986,33235,144,5,5842,5846,4,179749,178791,958,1840,1842,2,1,100
74905128f0ed9c7dd16c4f9bf353b624a343fc46,105,598,649,51,0,0,0,2,53,440,4,34,5.661213427,33995,43,5,5890,5886,4,182306,183264,958,1861,1859,2,1,100
bf29570d00db51e9ca6cfc27d7043b3ce10af1d8,104,643,591,52,0,0,0,1,52,324,3,33,5.636374986,33235,43,5,5842,5846,4,179749,178791,958,1840,1842,2,1,100
ed152bc6d105d2c4d6e9967e7cc91a9035ffebe1,109,712,910,198,0,0,0,2,54,354,3,34,5.683812647,34232,6,4,5947,5985,38,183125,184623,1498,1888,1886,2,0,100
4e414fd89682e08a20ce83698c830be453bd8483,2,4,4,0,0,0,0,7,25,0,1,2,0.811278124,715,132,9,134,134,0,3586,3581,5,39,39,0,0,100
bc61f4bac1282c6f93157a5a97bc5577ebec4024,0,0,0,0,0,0,0,0,0,0,0,0,0,0,39,13,0,0,0,0,0,0,0,0,0,1,100
63b211ec25f9730ec1523fa4a2282cf05394cbf6,0,0,0,0,0,0,0,0,0,0,0,0,0,0,165,4,0,0,0,0,0,0,0,0,0,0,100
e5ee51dd0b3ebed7fe00570c99e2805d1c92eb0a,0,0,0,0,0,0,0,0,0,0,0,0,0,0,166,5,0,0,0,0,0,0,0,0,0,0,100
24b411016e879349d557be999cec703c92b601bc,0,0,0,0,0,0,0,0,0,0,0,0,0,0,145,6,0,0,0,0,0,0,0,0,0,1,100
59c5c9e856ddaf59dee9a2227b438375359ea650,109,912,714,198,0,0,0,1,52,319,3,34,5.684507625,34034,145,6,5985,5947,38,184623,183130,1493,1886,1888,2,1,100
b012a480a397e9e9360a6649ea1183c509824232,109,714,912,198,0,0,0,2,54,354,3,34,5.684507625,34232,44,6,5947,5985,38,183130,184623,1493,1888,1886,2,0,100
bb680265bdbe58b8e1da50d2bcacb77676e15a51,0,0,0,0,0,0,0,0,0,0,0,0,0,0,30,1,0,0,0,0,0,0,0,0,0,0,100
3802c841a0fb40f59689523c077269cf4638b3a9,0,0,0,0,0,0,0,0,0,0,0,0,0,0,7,5,0,0,0,0,0,0,0,0,0,0,100
2d406044fafb574400bc66d06ee679f6dda5ed23,3,28,44,16,0,0,0,6,109,41,1,2,1.515541327,3887,31,2,683,678,5,22518,22583,65,95,95,0,1,100
0668f632700bdb35ec6e32a54c7713d7c91a66c4,109,912,714,198,0,0,0,1,52,319,3,34,5.684507625,34034,30,1,5985,5947,38,184623,183130,1493,1886,1888,2,1,100
63050d27abed5daaca4ae86043264e4a0e779441,110,748,941,193,0,0,0,2,54,352,4,35,5.702248104,35146,146,7,6074,6108,34,187389,188807,1418,1915,1913,2,1,100
f8ffd36de7d6327fa24f5a119fd5f1bf924032d7,0,0,0,0,0,0,0,0,0,0,0,0,0,0,44,0,0,0,0,0,0,0,0,0,0,0,100
74ec5f38adba600cc79b34880d725e8b0430b31b,4,172,18,154,0,0,0,8,38,25,4,4,1.539446801,2162,2,0,505,440,65,12898,11576,1322,110,109,1,1,100
a7a631d5d8d102b5ae7eadb24e6781b3809d7d5b,110,941,748,193,0,0,0,1,52,315,4,35,5.702248104,35009,2,0,6133,6099,34,189292,187874,1418,1913,1915,2,1,100
3d3ea6f6c7759f47a794d25ef5cde3b9eb8d20d2,111,749,942,193,0,0,0,8,54,350,5,36,5.70870967,35588,40,12,6145,6179,34,189724,191140,1416,1922,1920,2,1,100
4734abe7d81caf6bf2fb6287d1e5e00c50c600f2,0,0,0,0,0,0,0,0,0,0,0,0,0,0,133,9,0,0,0,0,0,0,0,0,0,1,100
983f1bee1121dfe7b3e109761f90c6be351644eb,0,0,0,0,0,0,0,0,0,0,0,0,0,0,8,6,0,0,0,0,0,0,0,0,0,0,100
7c443ded808e46761dc61c7b9f7fb03f58b8e7b1,1,23,21,2,0,0,0,7,12,21,1,1,0,399,167,5,59,58,1,2013,2007,6,23,23,0,1,100
da730073faaa0d426b9dded8b3c448cd44536f10,110,934,738,196,0,0,0,8,52,315,4,35,5.673862241,34478,146,6,6056,6019,37,186956,185471,1485,1893,1895,2,1,100
4370b6b135ca5288bf25bd6f7a353b9699821099,1,23,21,2,0,0,0,6,11,348,1,1,0,399,165,3,59,58,1,2043,2037,6,23,23,0,1,100
5aceeaf0cf2c3eaf66f5a8b9d2736d24bde62b15,1,0,2,2,0,0,0,1,5,29,1,1,0,809,44,3,120,120,0,4369,4386,17,26,26,0,1,100
75ed6057b6ebfed8e3736f32c4318d23affd3d3b,110,715,913,198,0,0,0,8,54,350,4,35,5.691173701,34676,45,4,6019,6057,38,185471,186962,1491,1895,1893,2,1,100
509b316ef10e1c5a927b2662e337717ca23bae43,110,913,715,198,0,0,0,8,52,318,4,35,5.691173701,34478,9,0,6057,6019,38,186962,185471,1491,1893,1895,2,1,100
f143f8173e3562a71433d6562391eef7e0afa73c,110,715,913,198,0,0,0,8,54,350,4,35,5.691173701,34676,9,0,6019,6057,38,185471,186962,1491,1895,1893,2,1,100
869c723f126b7fa2b7c3aa796d805ec7e494de62,110,913,715,198,0,0,0,8,52,318,4,35,5.691173701,34478,10,1,6057,6019,38,186962,185471,1491,1893,1895,2,1,100
06005ca39b12bde4042804bf538ab855507c983f,1,1,0,1,0,0,0,5,8,41,1,1,0,338,37,9,76,76,0,1811,1807,4,12,12,0,1,100
5eb030ada419c4b1aaff4474ac98b6680667efb0,1,14,1,13,0,0,0,2,2,51,1,1,0,292,129,5,40,38,2,1694,1649,45,6,6,0,1,100
b9b4b80895fa181ee206254332de5dbccb96cf2d,111,716,927,211,0,0,0,8,54,348,5,36,5.71418169,34981,41,13,6057,6097,40,187120,188656,1536,1901,1899,2,1,100
c07e8600ae353a156e83d89ebdd1590353bdc47f,1,14,1,13,0,0,0,2,2,51,1,1,0,292,134,10,40,38,2,1694,1649,45,6,6,0,1,100
1df13a47ce8b2df5751bfd4fc7490abb5385c344,2,80,16,64,0,0,0,5,48,44,1,2,0.14609425,2242,43,0,508,492,16,14716,14175,541,89,89,0,1,100
bc8ebde4a61aa1aee31403c0f2d43b2a4c07a8b3,110,913,715,198,0,0,0,8,52,318,4,35,5.691173701,34478,43,0,6057,6019,38,186962,185471,1491,1893,1895,2,1,100
82509d969cb7c4c8c7092ce84b8f6ee91186af6c,0,0,0,0,0,0,0,0,0,0,0,0,0,0,11,2,0,0,0,0,0,0,0,0,0,1,100
73fbf32721067861ca2b4118efc3935e83b79c37,110,715,913,198,0,0,0,8,54,350,4,35,5.691173701,34676,10,1,6019,6057,38,185471,186962,1491,1895,1893,2,1,100
f39e4880082f5579db49b29be735977a341c041b,110,913,715,198,0,0,0,8,52,318,4,35,5.691173701,34478,12,3,6057,6019,38,186962,185471,1491,1893,1895,2,1,100
3f6da35ffb0231da0d94d5f58b8a0159dbb1163a,110,715,913,198,0,0,0,8,54,350,4,35,5.691173701,34676,11,2,6019,6057,38,185471,186962,1491,1895,1893,2,1,100
52ecc0073267d4388968abfe892c163a3537ddd7,1,1,1,0,0,0,0,5,7,23,1,1,0,198,42,10,34,34,0,1304,1304,0,12,12,0,1,100
72f8f093dc5d67ca8d7bf408953f7422de422b48,0,0,0,0,0,0,0,0,0,0,0,0,0,0,43,11,0,0,0,0,0,0,0,0,0,1,100
390b97a5a05f58fac969a6950474652be8577bd0,0,0,0,0,0,0,0,0,0,0,0,0,0,0,135,8,0,0,0,0,0,0,0,0,0,1,100
9aa7262d3fcfb8425823a996eb32cc6fbc062ab5,9,515,33,482,1,0,1,10,120,93,2,8,2.175415525,6838,168,5,1370,1293,77,44977,42279,2698,227,211,16,1,98.07425055
212547978baa0cd526435aca28a51473d9626505,110,914,716,198,0,0,0,8,52,323,4,35,5.692375587,34637,166,4,6081,6043,38,187752,186261,1491,1898,1900,2,1,100
1409c1889747e1e04d47af00a90ce8676e9793bc,110,716,914,198,0,0,0,8,54,348,4,35,5.692375587,34835,44,1,6043,6081,38,186261,187752,1491,1900,1898,2,0,100
1f65120758a10476e2bdbcb580bea5ba7a8a624b,1,4,4,0,0,0,0,6,12,456,1,1,0,658,44,5,118,118,0,3686,3686,0,19,19,0,1,100
fdb098c24ba075727dafbb0f9b91e9a026a00db2,0,0,0,0,0,0,0,0,0,0,0,0,0,0,45,5,0,0,0,0,0,0,0,0,0,1,100
cd4dbcbdea320f7782a9998a039919694fe544d5,1,7,6,1,0,0,0,1,2,11,1,1,0,162,169,2,20,20,0,880,865,15,9,9,0,1,100
6326d01ca0eea73b48e1f008d5557604bdd48b3d,1,4,3,1,0,0,0,8,19,398,1,1,0,317,147,1,41,41,0,1813,1807,6,10,10,0,1,100
a989733e5cf61d69559fd84159a79cfd99ecf4ea,112,924,727,197,0,0,0,8,52,316,5,36,5.730491337,35458,147,1,6219,6181,38,192303,190827,1476,1926,1928,2,1,100
eaba7530f3f5d3f02db20ec0f57fcc529656b3be,113,750,937,187,0,0,0,8,58,348,5,37,5.757102293,37042,170,3,6532,6568,36,198358,199796,1438,1958,1956,2,1,100
85acf2999d1965b4277601e9ec5607b9234e2d7e,112,924,727,197,0,0,0,8,52,316,5,36,5.730491337,35458,167,2,6219,6181,38,192303,190827,1476,1926,1928,2,1,100
674cab34f6a021fdf4cc13dbb4039b8e48838d52,114,733,937,204,0,0,0,8,54,344,5,37,5.765321796,36279,46,6,6286,6325,39,194426,195939,1513,1944,1942,2,1,100
8cb01118573e0778a627e67673c39ddd1b619621,1,1,1,0,0,0,0,6,10,54,1,1,0,546,47,7,116,115,1,3208,3202,6,14,14,0,1,100
59ed6628e2b30e63f037a0dbbc27b8d28f773fc4,29,54,64,10,0,0,0,8,121,189,1,11,4.59961469,25876,9,1,3914,3919,5,163789,163898,109,587,587,0,0,100
731b82244c268f44f320c540bf50cc25cfdda611,141,1002,788,214,0,0,0,8,120,292,5,44,6.030085262,61192,13,4,10096,10053,43,355494,353878,1616,2504,2506,2,1,100
b83fcdbb4144e18e7e17bd84f5a499e81a1fe588,141,788,1002,214,0,0,0,8,121,288,5,44,6.030085262,61406,12,3,10053,10096,43,353878,355494,1616,2506,2504,2,1,100
24f053e2636e45171b98e84080ca2b8c3b7cc9c7,0,0,0,0,0,0,0,0,0,0,0,0,0,0,3,1,0,0,0,0,0,0,0,0,0,1,100
d18af7a942e9cd21b6f93e1ce64a17e416a5d45a,141,1002,788,214,0,0,0,8,120,292,5,44,6.030085262,61192,3,1,10096,10053,43,355494,353878,1616,2504,2506,2,1,100
bbaf1e7df65f5da68468b18bdefd3ebdca34bc7f,1,8,5,3,0,0,0,12,37,69,1,1,0,1323,4,2,236,236,0,7246,7218,28,38,38,0,1,100
748a84cd409b436b12c720a1c67bae62cee6aa4b,141,788,1002,214,0,0,0,8,121,288,5,44,6.030085262,61406,4,2,10053,10096,43,353878,355494,1616,2506,2504,2,1,100
9afb3eca89e12f2c35c465a727ef498223c5ad86,140,996,781,215,0,0,0,8,120,295,5,44,6.011703377,61029,168,3,10076,10033,43,354629,352998,1631,2495,2497,2,1,100
c0c1b155e5edf167b627da9b72d8d3df0ecc13c5,141,797,1005,208,0,0,0,8,122,288,5,44,6.039538881,61580,5,3,10094,10134,40,355161,356726,1565,2511,2509,2,1,100
360cdd683c0c74db58f12fa0fb3f912a8b6c6a98,2,95,92,3,0,0,0,13,49,34,2,2,0.118604153,2559,6,4,542,538,4,16687,16662,25,87,87,0,1,100
1eada5de1520c155bd29a43abe252ba00c2a51ba,142,1088,876,212,0,0,0,8,121,291,6,45,5.9042363,63591,5,3,10614,10575,39,371291,369685,1606,2582,2584,2,1,100
b905523b731f20d3fa70221b4de8894bb7ce8d4c,2,95,92,3,0,0,0,13,49,34,2,2,0.118604153,2559,6,4,542,538,4,16687,16662,25,87,87,0,1,100
6a602cadc520d47ec4342161d4db2a5240e40155,148,814,1043,229,0,0,0,8,123,307,5,46,6.130211947,65376,10,2,10382,10425,43,379183,380993,1810,2636,2634,2,0,94.69426152
ec858915dc5efa8111de0804005776fb56ac4c23,1,5,5,0,0,0,0,12,18,0,1,1,0,343,48,8,61,61,0,2189,2163,26,14,14,0,1,100
b79e1cf8feeb9269304da16ff44d98ad67e2574e,0,0,0,0,0,0,0,0,0,0,0,0,0,0,136,3,0,0,0,0,0,0,0,0,0,0,100
24c83278df4b8c6558fe4373cae7443a74e23a74,9,930,243,687,5,0,5,1,6,29,1,3,2.084646318,513,49,8,216,65,151,6174,2624,3550,59,14,45,1,99.75234389
b51cd90f8da84cb0b753d25fcb420405fe42972c,2,4,4,0,0,0,0,3,13,59,1,1,1,690,137,2,100,100,0,3478,3462,16,34,34,0,1,100
bf1cdd1a3265912df818e351ef198af3cc5c9aae,158,1293,1751,458,0,5,5,8,121,275,6,49,5.536147586,66690,130,0,10551,10659,108,385796,387562,1766,2662,2709,47,1,94.48405253
362a548efbcf3ca4ea9e60878440265f9c4aa305,158,1750,1292,458,5,0,5,8,123,279,6,49,5.541790467,66232,50,8,10659,10551,108,387562,385796,1766,2709,2662,47,1,94.48405253
e2f8b6be57f76661c76737f866dbb36d0392e63a,1,1,1,0,0,0,0,5,16,205,1,1,0,349,51,9,58,58,0,1859,1859,0,6,6,0,1,100
38ddea3913942ff5a64adab39d9d706fa758b9c1,0,0,0,0,0,0,0,0,0,0,0,0,0,0,52,10,0,0,0,0,0,0,0,0,0,0,100
fa98f45ff26bb67d7685b10a0e17496ba37a5f6b,159,1295,1753,458,0,5,5,8,121,275,7,50,5.541524537,67039,7,4,10609,10717,108,387655,389421,1766,2668,2715,47,1,94.48405253
16cc0d30c08dd7ffe17095c451062203f32c26db,0,0,0,0,0,0,0,0,0,0,0,0,0,0,8,5,0,0,0,0,0,0,0,0,0,1,100
f3473d23fc2c87ff03fc5c2c826a26155742e791,159,1751,1293,458,5,0,5,8,123,277,7,50,5.546042887,66581,7,4,10717,10609,108,389421,387655,1766,2715,2668,47,1,94.48405253
759a7b3e61bf281906c6384d47a7f6de25dc791c,0,0,0,0,0,0,0,0,0,0,0,0,0,0,8,5,0,0,0,0,0,0,0,0,0,1,100
6ad60b5d3c29685b2867905cfe8386bc71c00fb7,2,100,2,98,0,0,0,13,50,88,2,2,0.139232999,2483,45,1,558,524,34,16618,15986,632,81,81,0,1,100
ffadac96cd9be789d8cbed04c5e0dccf4f87c384,159,1295,1753,458,0,5,5,8,121,275,7,50,5.541524537,67039,44,0,10609,10717,108,387655,389421,1766,2668,2715,47,1,94.48405253
6854f4d3c7624a340a26e4df194effc7d792dbf1,159,1867,1491,376,5,0,5,8,123,275,7,50,5.470308726,66581,53,9,10692,10609,83,388742,387655,1087,2716,2668,48,1,94.48405253
70ca2df6337b2fb905d1996faabffec06494ff2c,1,1,1,0,0,0,0,5,6,482,1,1,0,127,54,10,14,14,0,501,501,0,3,3,0,1,100
f35c8bd546e6d82c605d9f58caa12d3f0bde9e8a,1,1,0,1,0,0,0,4,9,395,1,1,0,121,148,1,13,13,0,496,487,9,9,9,0,1,100
20315eabbc93d824772981d3cec82f4a4e284b7e,33,68,76,8,0,0,0,6,19,404,12,24,5.010784558,6500,138,2,978,978,0,35257,35327,70,179,179,0,1,100
5ea8062df77769ddb02235c7e8f3b51185143b3d,7,148,486,338,1,0,1,8,39,120,6,6,2.735467088,2710,139,3,417,458,41,11926,13401,1475,113,116,3,1,99.91183213
976142edefb2cc09c6178f36dec909fdeffcbe83,193,2053,2083,30,0,6,6,8,121,272,17,70,5.838366671,74072,148,1,11768,11810,42,427047,426589,458,2913,2958,45,1,94.39339959
7d929b4750f200366ddfc9bf3e620dd8b87b905b,193,2081,2051,30,6,0,6,8,123,295,17,70,5.841556104,74042,46,0,11810,11768,42,426589,427047,458,2958,2913,45,1,94.39339959
4307d3b84e3480cc80663bd2c8f61c83d2ddf42a,193,2053,2083,30,0,6,6,8,121,272,17,70,5.838366671,74072,45,0,11768,11810,42,427047,426589,458,2913,2958,45,1,94.39339959
b2a2516d21095046ad9d1c1748e8ee38985f0e17,194,2090,2058,32,6,0,6,8,123,295,17,70,5.855506164,74247,55,11,11823,11780,43,427603,428064,461,2968,2923,45,1,94.39339959
0492cd578a4c0d9e1b62a94ea6938422c0557120,1,3,8,5,0,0,0,12,38,22,1,1,0,1326,56,12,232,236,4,7203,7246,43,38,38,0,1,100
6d96b21a300ddb03ffc72a74b13d268e7ccf45fb,195,2068,2095,27,0,6,6,8,121,277,17,70,5.863293056,75600,46,1,12016,12055,39,435310,434806,504,2961,3006,45,1,94.39339959
a15a0bd8157fba6b946ea701589f401dcd914475,195,2093,2066,27,6,0,6,8,123,295,17,70,5.866476723,75573,47,1,12055,12016,39,434806,435310,504,3006,2961,45,1,94.39339959
6d862ed4339a4589c4ce1be38a119cd2a49e5a5e,2,15,1,14,0,0,0,1,40,67,1,2,0.69621226,1601,48,2,261,260,1,8913,8822,91,107,107,0,1,100
6ec7d9659d26925795ecb65bd5e3c8a89982116a,195,2068,2095,27,0,6,6,8,121,277,17,70,5.863293056,75603,47,2,12017,12056,39,435324,434820,504,2961,3006,45,1,94.39339959
d5e5ad5f892dea696740bd6834b3c96b213498e1,195,2098,2071,27,6,0,6,8,123,293,17,70,5.873839821,75576,57,13,12056,12017,39,434820,435324,504,3006,2961,45,1,94.39339959
432f9f7ac0b98fb0b1f144f56df4f7a7efcca5f2,0,0,0,0,0,0,0,0,0,0,0,0,0,0,58,14,0,0,0,0,0,0,0,0,0,1,100
a118f7100d33d39c2d0c6a99d50769492af444e9,1,3,2,1,0,0,0,3,22,81,1,1,0,366,140,4,76,76,0,2137,2116,21,10,10,0,1,100
910aff0edf48b595a4e86b31d2edfda621d2f9ff,1,1,1,0,0,0,0,13,51,7,1,1,0,2147,32,0,490,490,0,14204,14204,0,73,73,0,1,100
852e89cda3f54cf322a695cd511b015f31a335c0,196,2075,2103,28,0,6,6,8,121,280,18,71,5.876976272,75970,0,0,12093,12132,39,437440,436957,483,2971,3016,45,1,94.39339959
284ca416a60533139889a0c3f68f20ae12fdd3cc,196,2101,2073,28,6,0,6,8,123,293,18,71,5.880156637,75942,9,6,12132,12093,39,436957,437440,483,3016,2971,45,1,94.39339959
8f825cad14ede10bfd090e53a1d05c39fbabc6b5,196,2075,2103,28,0,6,6,8,121,280,18,71,5.876976272,75970,9,6,12093,12132,39,437440,436957,483,2971,3016,45,1,94.39339959
8da88797371c8316ea7539051176e610cfff5125,198,2158,2079,79,6,0,6,8,123,294,18,73,5.905762861,76538,49,3,12212,12168,44,440398,440604,206,3036,2988,48,1,94.39339959
f81da73092e246531791657a2462033d58f91c03,196,2075,2103,28,0,6,6,8,121,280,18,71,5.876976272,75994,48,3,12097,12136,39,437536,437053,483,2973,3018,45,1,94.39339959
29eda27ef32146bd490d5005633f06bf68ee8d2a,196,2101,2073,28,6,0,6,8,123,293,18,71,5.880156637,75966,59,15,12136,12097,39,437053,437536,483,3018,2973,45,1,94.39339959
a9fb73f420b8a3af9938f8d5f49d43ed4e1d6eb0,0,0,0,0,0,0,0,0,0,0,0,0,0,0,60,16,0,0,0,0,0,0,0,0,0,1,100
7ada8bc2cb547b589067aa4ef7e834cb41a42f30,1,2,3,1,0,0,0,12,39,6,1,1,0,1321,61,17,230,232,2,7184,7203,19,38,38,0,1,100
2d79a01571acd9bdfe50a3f901b6f5ad9b5d35ed,1,2,0,2,0,0,0,5,11,77,1,1,0,709,62,18,44,44,0,3545,3515,30,19,19,0,1,100
4981181a9a9f261d3fb30485aec709a1bccb3292,2,2,2,0,0,0,0,13,124,90,1,1,1,4640,171,2,856,856,0,31124,31124,0,116,116,0,1,100
58018b21b751293d803f7702920b13247b0c09ba,1,11,2,9,0,0,0,5,7,104,1,1,0,96,141,5,10,8,2,438,406,32,2,2,0,1,100
a4f1be829c2eb1eb5bdaaa721ad30ffee7fe6530,1,5,2,3,0,0,0,2,3,101,1,1,0,75,142,6,7,6,1,358,338,20,2,2,0,0,100
c80d81189e5e15d912176ac8430a3b0e9e7bb0a1,0,0,0,0,0,0,0,0,0,0,0,0,0,0,143,7,0,0,0,0,0,0,0,0,0,1,100
e02967f38993dce2d59bc2dc58a4a3227cd89b7b,1,2,3,1,0,0,0,5,16,498,1,1,0,383,0,0,49,49,0,1772,1775,3,11,11,0,0,100
68d48941d36ed7f8f2aa1cf6b30a2881326b3f5c,200,2084,2125,41,0,6,6,8,121,262,18,72,5.906997132,77490,0,0,12262,12302,40,445249,444829,420,3026,3071,45,0,94.39339959
14853bdc61d97fa8d33aa0ab806f8d8abf01bc09,200,2123,2082,41,6,0,6,8,124,290,18,72,5.910172457,77449,63,17,12302,12262,40,444829,445249,420,3071,3026,45,1,94.39339959
0ad9539cfd5b8f8f4a0e9a4a5b30b6d198ca2ae7,0,0,0,0,0,0,0,0,0,0,0,0,0,0,64,18,0,0,0,0,0,0,0,0,0,1,100
85ddb48e2c7a795969e908ebce377ab4666aecce,11,612,535,77,0,0,0,8,125,63,7,11,2.745679574,8502,172,2,1149,1112,37,58128,58062,66,206,200,6,1,96.40227577
5d5a0cd7198ee3590645c193c03708de91899420,0,0,0,0,0,0,0,0,0,0,0,0,0,0,46,1,0,0,0,0,0,0,0,0,0,1,100
01f57d4c469577e31402bf837d1de906c9e07a40,202,2616,2734,118,0,6,6,8,121,260,18,74,5.89896084,78560,45,1,12497,12574,77,451358,451004,354,3067,3118,51,1,95.19077196
e6fd8e4e8e817c897f6ccbb4e666bd40c93d1aec,204,2755,2634,121,6,0,6,8,125,233,19,75,5.927444282,80858,33,1,13105,13027,78,466345,466639,294,3210,3159,51,1,95.19077196
a1c9fee705d668b62f3998aab55e11074a9a1ce8,202,2618,2735,117,0,6,6,8,121,264,18,74,5.897938699,78561,31,0,12497,12574,77,451389,451020,369,3067,3118,51,1,95.19077196
121d1a98129b48a098a1aa5e406337c931663f16,2,2,2,0,0,0,0,12,122,101,1,1,1,4641,169,1,856,856,0,31160,31160,0,116,116,0,1,100
74e86ca146e01415c350940817131dbaeb5a6a02,9,930,243,687,5,0,5,1,6,45,1,3,2.084646318,513,38,0,216,65,151,6174,2624,3550,59,14,45,1,99.72039145
959ba7f068efdf6000e33e4e082a7b8c07f36473,33,67,75,8,0,0,0,6,19,457,12,24,5.002449769,6503,131,1,979,979,0,35273,35343,70,179,179,0,1,100
c9e94357028234db1b1ff9be57ecf13ae29f5d87,11,612,537,75,0,0,0,7,123,106,7,11,2.74569671,8508,170,2,1150,1113,37,58181,58123,58,206,200,6,1,97.47315224
786bb3a22deaab1338f56893841804fc8134da1c,164,1126,1763,637,1,0,1,8,125,272,11,54,5.997449742,71263,65,17,11265,11376,111,407037,410944,3907,2847,2847,0,1,94.17891017
75f8f1d0b280df1a6d7ddbf7430333691a7da976,0,0,0,0,0,0,0,0,0,0,0,0,0,0,0,0,0,0,0,0,0,0,0,0,0,1,100
942f630ba672452c93de684fc156754f7c0fe83f,1,3,0,3,0,0,0,5,54,28,1,1,0,949,173,2,214,213,1,5225,5208,17,35,35,0,1,100
73ceb8b57ac9e788b83985fb176ceccdf3ff110b,164,1763,1126,637,0,1,1,8,123,304,11,54,5.997449742,70629,171,2,11377,11266,111,410961,407054,3907,2847,2847,0,1,94.17891017
1ca8de3f4a322e8bc15cd948d616d015bf63625a,164,1126,1763,637,1,0,1,8,125,272,11,54,5.997449742,71266,144,7,11266,11377,111,407054,410961,3907,2847,2847,0,1,94.17891017
f310aaf6bb7b81825ce2886ba4f16c13a09c603a,1,17,17,0,0,0,0,6,21,507,1,1,0,1218,213,0,189,189,0,3530,3530,0,16,16,0,1,100
a44c04e436caadbe391cad957e9f4d70f66eb51e,164,1763,1126,637,0,1,1,8,123,304,11,54,5.997449742,70629,213,0,11377,11266,111,410961,407054,3907,2847,2847,0,1,94.17891017
d534b16379bcc9b3f48a8c3bf07551ced974909f,165,1145,1780,635,1,0,1,8,126,272,11,54,6.016313208,71544,174,3,11308,11418,110,408566,412452,3886,2864,2864,0,1,94.17891017
61999ef5cf8c83328ba7ad1b5870f84c09670db6,164,1763,1126,637,0,1,1,8,124,304,11,54,5.997449742,70632,172,3,11378,11267,111,410969,407062,3907,2847,2847,0,1,94.17891017
2f8c7f27af7137a36eff68db1c02544916bdc37a,165,1127,1764,637,1,0,1,8,126,272,12,55,6.001560499,71651,66,17,11316,11427,111,408834,412741,3907,2858,2858,0,1,94.17891017
149c51662037b45472281bf166b2cb19a5d1262a,1,1,1,0,0,0,0,6,11,115,1,1,0,111,67,18,10,10,0,512,512,0,2,2,0,1,100
8166d00b12c920bb48896b69b50eceecde1b6975,1,1,1,0,0,0,0,4,5,508,1,1,0,69,68,19,6,6,0,296,296,0,1,1,0,1,100
2d9a322102355f4f998541c2fe9866a85560b2b3,1,9,1,8,0,0,0,9,34,94,1,1,0,391,1,1,66,64,2,2854,2788,66,10,10,0,1,99.95222169
73eed772414e2bf0ae796d0368af20a822916bbd,0,0,0,0,0,0,0,0,0,0,0,0,0,0,2,2,0,0,0,0,0,0,0,0,0,1,100
3632b35d01451d8f6983e46fbbc78ac54d8c0ce4,0,0,0,0,0,0,0,0,0,0,0,0,0,0,3,3,0,0,0,0,0,0,0,0,0,1,100
79230377fd1e27c28e330dfac0f382c1a78b710d,0,0,0,0,0,0,0,0,0,0,0,0,0,0,4,4,0,0,0,0,0,0,0,0,0,1,100
063bf890a46a5a10c84070bae85fe532ef92fd23,0,0,0,0,0,0,0,0,0,0,0,0,0,0,69,14,0,0,0,0,0,0,0,0,0,1,100
683f1e3a6ced7368891ddd58183e3be46f649004,0,0,0,0,0,0,0,0,0,0,0,0,0,0,175,4,0,0,0,0,0,0,0,0,0,1,100
b0e364cde56ccab3daf1fb1c7f0554db181361a6,167,1767,1138,629,0,1,1,8,124,298,12,55,6.013140658,71202,173,4,11443,11334,109,413549,409708,3841,2861,2861,0,1,94.12420974
a2291f0a821e9c51f4fb5779fae1eb5a9b13f733,167,1138,1767,629,1,0,1,8,126,273,12,55,6.013140658,71831,5,5,11334,11443,109,409708,413549,3841,2861,2861,0,1,94.12420974
5d2f72376ffec2572d2114515ffa7d7f1e096a36,0,0,0,0,0,0,0,0,0,0,0,0,0,0,70,13,0,0,0,0,0,0,0,0,0,1,100
acda969b845ed003fed6e40d120074a20a9ec3ac,0,0,0,0,0,0,0,0,0,0,0,0,0,0,50,2,0,0,0,0,0,0,0,0,0,1,100
04be201cc561efccf7b2c37bff1858dddcdcfbc9,167,1767,1138,629,0,1,1,8,124,298,12,55,6.013140658,71202,49,1,11443,11334,109,413549,409708,3841,2861,2861,0,1,94.12420974
37c95f703aa0ae87bb943fc48249b4b302a2cba4,167,1138,1767,629,1,0,1,8,126,273,12,55,6.013140658,71831,0,0,11334,11443,109,409708,413549,3841,2861,2861,0,1,94.12420974
b47e4d43577e260f74dd5b299d7fad2858d9b797,167,1767,1138,629,0,1,1,8,124,298,12,55,6.013140658,71202,0,0,11443,11334,109,413549,409708,3841,2861,2861,0,1,94.12420974
18abc714ba48dde9f11d930a94a1ce59c292d77f,167,1138,1767,629,1,0,1,8,126,273,12,55,6.013140658,71831,6,6,11334,11443,109,409708,413549,3841,2861,2861,0,1,94.12420974
3bfdf4ee93d66e4ac8011e45f7c07f01db3126d3,0,0,0,0,0,0,0,0,0,0,0,0,0,0,7,7,0,0,0,0,0,0,0,0,0,1,100
25435ffa1a439f5db70b1c10e4bc67d19f8a7686,2,8,1,7,0,0,0,5,44,131,1,2,0.764204507,1163,176,4,188,187,1,6447,6424,23,49,48,1,1,100
aeb1ade1c54da6cb95ae1c95068ad37a8bf610cc,167,1767,1138,629,0,1,1,8,124,300,12,55,6.013140658,71209,174,5,11444,11335,109,413572,409731,3841,2862,2862,0,1,94.12420974
5cab3e2be54a2660148c31432ea0a86764020d67,167,1138,2250,1112,1,0,1,8,126,270,12,55,5.736929207,71838,11,0,11233,11444,211,406972,413572,6600,2856,2862,6,0,94.12420974
546fc8718fb91c2b1587dd859ec663971f563b10,0,0,0,0,0,0,0,0,0,0,0,0,0,0,145,0,0,0,0,0,0,0,0,0,0,1,100
84e90c132062baacf4de65a03bdb7372e479a4c1,0,0,0,0,0,0,0,0,0,0,0,0,0,0,47,0,0,0,0,0,0,0,0,0,0,1,100
d60ae8fe4ad36ad4e7340e8781bf0d85e2962f76,167,2250,1138,1112,0,1,1,8,124,300,12,55,5.736929207,70726,46,0,11444,11233,211,413572,406972,6600,2862,2856,6,1,94.12420974
6c0b06252ad670bdbd5ffba93a3b51015308e9ec,2,390,176,214,0,0,0,6,13,111,2,2,0.631937335,1116,32,0,263,198,65,7384,5854,1530,51,46,5,1,100
6cfb01883fb97bd98e5e5b7baacb3cdd85a15b68,167,1183,2299,1116,1,0,1,8,126,270,12,55,5.755942075,72052,34,0,11298,11509,211,408502,415102,6600,2861,2867,6,1,94.12420974
5a39409dc0f07db2fcf9175e10e46ca8e1f92f7d,1,12,26,14,0,0,0,8,12,156,1,1,0,224,12,1,40,42,2,873,943,70,10,10,0,1,100
f2ab4279e68d1fd0b4253a519bd063b4d4e0730f,1,6,0,6,0,0,0,6,18,53,1,1,0,382,1,0,51,49,2,1804,1772,32,11,11,0,1,100
3b964a345be4838dfbfb273f1973e0b129da8ca9,2,94,10,84,0,0,0,13,127,58,2,2,0.078232465,3949,177,2,756,729,27,27394,26755,639,87,86,1,1,100
ceb556ee1c12227d6a50ece1fee7a1c8a6d7dd8f,167,2325,1201,1124,0,1,1,8,125,296,12,55,5.781864537,71012,175,2,11536,11325,211,415741,409103,6638,2868,2862,6,1,94.12420974
ba664e1b310ae65b674ff28e0772d208d3b20464,0,0,0,0,0,0,0,0,0,0,0,0,0,0,1,1,0,0,0,0,0,0,0,0,0,1,100
bdf0b61c0f6e109c2f4e0459676dda71f0265aeb,167,1201,2325,1124,1,0,1,8,127,270,12,55,5.781864537,72136,1,1,11325,11536,211,409103,415741,6638,2862,2868,6,1,94.12420974
f3e8b2fe7bb58f11445b7a7fd902de4331d8e86f,167,2335,1210,1125,0,1,1,8,125,296,12,55,5.783322471,71012,149,0,11537,11325,212,415749,409103,6646,2868,2862,6,1,94.12420974
cdde1b6e86fcdd92c681b66b9ac291384e41bba5,167,1200,2324,1124,1,0,1,8,127,270,12,55,5.781537971,72137,149,0,11326,11537,211,409111,415749,6638,2862,2868,6,1,94.12420974
1d18e76dacc9326419855c7881ef79cf60f19a61,52,342,353,11,0,0,0,3,128,239,1,13,4.666236447,30554,13,2,5420,5420,0,164749,164749,0,1040,1040,0,0,100
8cc43743df75968bf92d52523fd5d4804de98175,0,0,0,0,0,0,0,0,0,0,0,0,0,0,146,1,0,0,0,0,0,0,0,0,0,1,100
a20e7a2f9d5c4ad47030eb07968414fdcadb6c3d,0,0,0,0,0,0,0,0,0,0,0,0,0,0,147,2,0,0,0,0,0,0,0,0,0,1,100
f84ff8e0fd83d6787847a3c5fe16c73d73daa5a8,0,0,0,0,0,0,0,0,0,0,0,0,0,0,71,0,0,0,0,0,0,0,0,0,0,1,100
c89b555919126bb5501bfc1a80cd6813ca41c9d8,0,0,0,0,0,0,0,0,0,0,0,0,0,0,72,1,0,0,0,0,0,0,0,0,0,1,100
6e512b6ab5c7d2008ff8e1abd2ad9f1b8b12e169,1,79,26,53,0,0,0,6,16,585,1,1,0,589,148,3,75,70,5,3504,3323,181,34,29,5,1,100
50668346b7c73c52b7fe87cf9175af512c5b9855,0,0,0,0,0,0,0,0,0,0,0,0,0,0,51,0,0,0,0,0,0,0,0,0,0,1,100
d456ac7f2e168af0f81a0005f66365a8f9215cef,0,0,0,0,0,0,0,0,0,0,0,0,0,0,73,2,0,0,0,0,0,0,0,0,0,1,100
bca550210ce7c863d228e5fe3445cf1ab4da85d1,0,0,0,0,0,0,0,0,0,0,0,0,0,0,74,3,0,0,0,0,0,0,0,0,0,1,100
73c2faa494c0af8e7ff4894b5fbcd1a8e49504d0,0,0,0,0,0,0,0,0,0,0,0,0,0,0,52,1,0,0,0,0,0,0,0,0,0,0,100
88c73dfe682c9b868c6c8c8ecc34082afb5e1e71,1,2,2,0,0,0,0,5,12,32,1,1,0,339,75,4,76,76,0,1797,1797,0,12,12,0,1,100
50fb124e52235fd076b6bf6a68940ac9f5cb0ed5,0,0,0,0,0,0,0,0,0,0,0,0,0,0,8,0,0,0,0,0,0,0,0,0,0,1,100
11282a1eae4612fb0619de7a934c776ba3f54fc8,1,7,5,2,0,0,0,1,3,605,1,1,0,422,149,3,30,30,0,2196,2182,14,10,10,0,1,100
c60de3a6a690999219f22915f542444783d40bc2,0,0,0,0,0,0,0,0,0,0,0,0,0,0,150,4,0,0,0,0,0,0,0,0,0,1,100
a4592939b58c9459ac340f70ab4ea86a0b564388,9,758,120,638,0,0,0,2,12,346,4,4,2.046082526,2763,151,5,186,159,27,19393,15615,3778,90,82,8,1,100
b25026259544d2b210e40d4510a02ba1aaafde2f,1,1,1,0,0,0,0,8,50,202,1,1,0,460,76,5,75,75,0,2530,2530,0,25,25,0,1,100
1bdc28c61b934895afde923895caf000d1b95979,2,27,13,14,0,0,0,4,11,127,1,2,0.934068055,188,77,6,19,18,1,844,705,139,6,5,1,1,99.96815287
dc31b21fcda9ca0a1f39af6b90599bf600a88290,0,0,0,0,0,0,0,0,0,0,0,0,0,0,78,7,0,0,0,0,0,0,0,0,0,1,100
8944052fc67d262be0c2677f7d0988679a683b88,1,2,2,0,0,0,0,12,23,249,1,1,0,1085,79,8,180,180,0,5876,5876,0,36,36,0,0,100
79a8d7c86038f4bd67d7d6078d5b17bebf7ec771,1,964,0,964,1,0,1,1,1,0,1,1,0,0,0,0,55,0,55,8861,0,8861,40,0,40,1,96.73671621
af035198cc7d7a943a6b13e997c0973b482f2019,212,2829,2401,428,0,1,1,8,125,302,16,66,6.170039487,89212,0,0,14016,13838,178,497088,494562,2526,3592,3600,8,1,93.98862713
3362acea8fa966eafa6a61147ed93142475bcb1e,212,2415,2843,428,1,0,1,8,128,233,16,66,6.157308514,89640,152,6,13838,14016,178,494562,497088,2526,3600,3592,8,1,93.98862713
acee1c4f750637e2103f1134427aacbd4f7fd378,1,1,1,0,0,0,0,4,8,611,1,1,0,353,0,0,60,60,0,1475,1475,0,12,12,0,0,100
9911429927df041cd9f193ee7052d2eb8e7e6207,214,2833,2402,431,0,1,1,8,125,297,18,68,6.1742228,90099,50,0,14161,13983,178,501605,499050,2555,3618,3626,8,1,93.98862713
a3d9b0f91d2113a1d1977e6f527d70b76c447f08,214,2434,2865,431,1,0,1,8,129,234,18,68,6.167581968,90530,80,9,13983,14161,178,499050,501605,2555,3626,3618,8,1,93.98862713
9c1ffb10431b89bcbcceeb9d885b8768b346bfe4,2,3,0,3,0,0,0,3,9,372,2,2,0.918295834,662,153,7,101,101,0,3666,3635,31,17,17,0,1,100
9f0cfcfc06e281fc5781e09dea2bcfa9e677333c,0,0,0,0,0,0,0,0,0,0,0,0,0,0,81,10,0,0,0,0,0,0,0,0,0,1,100
770f274d04f1a438b90d3cb6643d587558f6bbf7,0,0,0,0,0,0,0,0,0,0,0,0,0,0,82,11,0,0,0,0,0,0,0,0,0,1,100
2a3ada00603b17093678a78c4106ca91a4b5a2fd,2,3,3,0,0,0,0,7,22,95,2,2,0.918295834,801,154,6,151,150,1,4310,4310,0,35,35,0,1,100
7665dcfd7843e0b999f821fa362de7461aeadf7b,214,2851,2423,428,0,1,1,8,125,295,18,68,6.180962018,90102,132,0,14162,13984,178,501605,499081,2524,3618,3626,8,1,93.98862713
da8ba041b72e0caee90378ddcd08e122b6ce6ecc,5,10,0,10,0,0,0,8,41,94,4,4,2.321928095,2233,51,1,406,406,0,11370,11280,90,107,107,0,1,100
27bd3fe5c5e0c147d386f1c4441253d92f122b30,214,2440,2874,434,1,0,1,8,129,234,18,68,6.169484228,90540,53,2,13984,14162,178,499117,501695,2578,3626,3618,8,1,93.98862713
fd597296756c0680e136439271c05d1ff38d86c9,0,0,0,0,0,0,0,0,0,0,0,0,0,0,9,1,0,0,0,0,0,0,0,0,0,1,100
8751791d8dae25f2dd6f2499e8f766c5763677db,1,0,1,1,0,0,0,2,4,158,1,1,0,694,83,10,153,153,0,4537,4545,8,13,13,0,1,100
c41f19e47d4e35520eae15b181a4d05baed5ad48,1,3,3,0,0,0,0,7,23,1,1,1,0,313,84,11,64,64,0,1946,1946,0,6,6,0,1,100
3bc1229ffd098e28e323eeaed47040277955dccb,1,1,1,0,0,0,0,9,14,143,1,1,0,185,85,12,25,25,0,970,970,0,9,9,0,1,100
9a1d5b49bf4c22b8a7847b4637e86bdbe9de9a0c,4,57,52,5,0,0,0,12,112,128,2,3,1.934768183,3620,14,0,652,650,2,21964,22037,73,94,92,2,1,97.64167547
66b258ae951611a4a2862d8f0547071d8d411146,0,0,0,0,0,0,0,0,0,0,0,0,0,0,35,0,0,0,0,0,0,0,0,0,0,1,100
70dcd590701f581f864ee847f7a28c41620349a8,215,2916,2486,430,0,1,1,8,125,290,19,69,6.220072108,90804,33,0,14315,14139,176,506240,503581,2659,3631,3641,10,1,94.20849421
1bd34894bdae33e159b2de89c503b060ff8351e9,37,278,60,218,0,0,0,6,110,388,12,24,4.651986158,17683,0,0,2658,2636,22,103925,102779,1146,796,779,17,1,100
c6f5f101b75f8ae0386a94ffa36e8b3653649c7a,0,0,0,0,0,0,0,0,0,0,0,0,0,0,10,0,0,0,0,0,0,0,0,0,0,1,100
ac24f705fb7d1902c8f8553ed98b988ac59678ec,217,2511,2943,432,1,0,1,8,129,234,19,69,6.216748841,92362,0,0,14220,14396,176,513198,515865,2667,3706,3696,10,1,94.20849421
37667d7faf87ec0000e5d236a19891046d66f1c1,0,0,0,0,0,0,0,0,0,0,0,0,0,0,10,0,0,0,0,0,0,0,0,0,0,1,100
a02901c6f613a9bc3d10c31869400496c254b01b,1,1,1,0,0,0,0,6,8,130,1,1,0,105,86,13,10,10,0,438,438,0,2,2,0,1,100
4294802af0e9f7fc8252105084200f318d667dd6,3,48,31,17,0,0,0,4,27,247,1,3,0.888907614,649,178,0,139,134,5,3347,3169,178,42,44,2,1,100
faf5bf177f2f145f40f667a598929a6dbd7e81df,3,22,2,20,0,0,0,6,25,387,2,3,0.888686553,3385,179,1,756,752,4,15897,15706,191,272,272,0,1,99.91589571
c7784876173bc9eafd1c47def7f45bad3b5010ac,5,18,17,1,0,0,0,2,33,189,1,4,2.073441492,5195,1,1,559,559,0,35158,35158,0,270,270,0,1,100
1a461ecfb7b4c0e8005d06e8d9d2dfb7c65a1497,220,2962,2567,395,0,1,1,8,125,294,19,69,6.269167891,92472,1,1,14503,14336,167,518529,516231,2298,3728,3736,8,1,94.15847311
c01d01f54622286de7ef17b302ae0a734664a9d1,220,2581,2976,395,1,0,1,8,129,239,19,69,6.257025535,92867,11,1,14336,14503,167,516231,518529,2298,3736,3728,8,1,94.15847311
a7bb8e732b840bbcdcf48c49b21a8e17ea97293c,220,2962,2567,395,0,1,1,8,125,294,19,69,6.269167891,92472,11,1,14503,14336,167,518529,516231,2298,3728,3736,8,1,94.15847311
f1117f5fe6cd2749b913986ea7529f99e9706caa,223,2602,2986,384,1,0,1,8,129,240,21,71,6.276159061,94347,2,2,14591,14756,165,523859,526110,2251,3793,3785,8,1,94.15847311
45f30336fd885a7bda5bb3700821ea237fb13b31,0,0,0,0,0,0,0,0,0,0,0,0,0,0,3,3,0,0,0,0,0,0,0,0,0,1,100
5e858afc6e3e140f9b07eca98787019672c6b137,220,2962,2567,395,0,1,1,8,125,295,19,69,6.269167891,92472,2,2,14503,14336,167,518529,516231,2298,3728,3736,8,1,94.15847311
0a5265a54a0c12aaa5c399a3c3153b5e794783b7,0,0,0,0,0,0,0,0,0,0,0,0,0,0,3,3,0,0,0,0,0,0,0,0,0,1,100
ce7169f8f62fbadba516ea7af89a9ab9f9b5fb76,1,21,13,8,0,0,0,7,11,12,1,1,0,338,34,1,77,76,1,1857,1811,46,12,12,0,1,100
501e05f1a1225dfbcc16bf4d2c0d86e55d4a928e,220,2584,2977,393,1,0,1,8,129,239,19,69,6.258476094,92875,36,1,14337,14504,167,516283,518575,2292,3736,3728,8,1,94.15847311
21066540d388402d12413144e63a2d74becf1fd1,1,1,1,0,0,0,0,8,18,24,1,1,0,488,12,2,87,87,0,2364,2364,0,29,29,0,1,100
4ff214e0bcc43e737783461f99cf63123ea56f63,220,2963,2570,393,0,1,1,8,125,295,19,69,6.270611745,92482,12,2,14504,14337,167,518575,516283,2292,3728,3736,8,1,94.15847311
cd9d1a49105d42eeb3a7aa65205b6f1d3018a180,221,2594,2977,383,1,0,1,8,129,241,19,70,6.266203101,93081,180,2,14377,14539,162,517396,519618,2222,3745,3737,8,1,94.15847311
e51d992a36acc1714081163f893539753cb5dddb,1,2,2,0,0,0,0,2,5,1110,1,1,0,474,87,7,56,56,0,1856,1856,0,32,32,0,1,100
0c7798f336ebb72da32d4ecc8d84c677dbb785ca,221,2958,2573,385,0,1,1,8,125,288,20,71,6.271980282,92965,39,0,14583,14420,163,520457,518238,2219,3759,3767,8,1,94.15847311
c23b3743fa432fb242bd57da7693d88e1f8033bc,221,2590,2972,382,1,0,1,8,129,244,20,71,6.261416124,93350,54,1,14420,14583,163,518257,520457,2200,3767,3759,8,1,94.15847311
2ae1346e36853271c531d753408cfc16ce0dfb53,220,2927,2528,399,0,1,1,8,125,288,20,71,6.249163309,92838,176,0,14562,14394,168,519955,517577,2378,3748,3758,10,1,94.15847311
6fa851ddc6f83bc056829f9b5738726573262028,1,73,0,73,0,0,0,4,9,150,1,1,0,147,35,2,31,21,10,1244,786,458,7,5,2,1,100
93ccc5237384a378416489d68e9e7d4234d07f73,220,2542,2941,399,1,0,1,8,129,242,20,71,6.236860216,93237,37,2,14394,14562,168,517577,519955,2378,3758,3748,10,1,94.15847311
54e0e8d027130224416a235052be9a912a2f85a9,1,3,4,1,0,0,0,2,3,275,1,1,0,819,0,0,122,122,0,4245,4245,0,14,14,0,1,100
43998e11326998dc373d115dcd658ec16a46e7fb,220,2927,2528,399,0,1,1,8,125,288,20,71,6.249163309,92838,0,0,14562,14394,168,519955,517577,2378,3748,3758,10,1,94.15847311
b623fd3aca34a48768bf06d9bda02791a42c14dd,1,1,1,0,0,0,0,11,23,312,1,1,0,288,13,3,43,43,0,1392,1392,0,21,21,0,1,100
ba122d3adc0722e62df8abe61319bea23a784a66,220,2542,2941,399,1,0,1,8,129,243,20,71,6.236860216,93237,13,3,14394,14562,168,517577,519955,2378,3758,3748,10,1,94.15847311
07fc810408d1b5772925357413795dd7d93bdc8e,220,2929,2529,400,0,1,1,8,125,289,20,71,6.24897036,92838,4,4,14562,14394,168,519965,517577,2388,3748,3758,10,1,94.15847311
58116e0118909b7ef495c3721575ba866a919c3a,220,2542,2941,399,1,0,1,8,129,243,20,71,6.236860216,93238,4,4,14394,14562,168,517587,519965,2378,3758,3748,10,1,94.15847311
a5ab9a34d3c8a66d3119f9bd552bd35ce68b03ed,4,5,5,0,0,0,0,2,9,468,2,4,1.921928095,608,38,3,58,58,0,3266,3266,0,37,37,0,1,100
ca69b58ca9b634dcc90b49fe6f4a580df3c49213,220,2927,2528,399,0,1,1,8,125,298,20,71,6.249163309,92839,36,3,14562,14394,168,519965,517587,2378,3748,3758,10,1,94.15847311
02f83498e11754dcbc478ec0946a1ecc582640fe,223,2806,2967,161,2,0,2,8,129,237,20,71,6.270461224,94736,150,0,14797,14930,133,526601,527865,1264,3806,3786,20,1,94.06093328
13f01c82bf50300a48de3a5d0300e29a8bf969cb,0,0,0,0,0,0,0,0,0,0,0,0,0,0,151,1,0,0,0,0,0,0,0,0,0,1,100
2fabba3f6af06b79c012841c886eb639a6307b40,220,2942,2544,398,0,1,1,8,125,298,20,71,6.235520155,92856,150,0,14564,14396,168,520044,517666,2378,3749,3759,10,1,92.65967588
87bc2e786cc2159aae274998c8ae52719b06b798,220,2549,2947,398,1,0,1,8,129,238,20,71,6.231024446,93254,10,1,14396,14564,168,517666,520044,2378,3759,3749,10,1,92.65967588
c213c9587dd6c2c8403eab30470575a7e3bbdb07,2,10,7,3,0,0,0,1,14,6,2,2,0.522559375,1066,152,2,70,70,0,5171,5156,15,29,29,0,1,100
ada188bb60fa358ff7e143ceec74190458580c7d,220,2945,2547,398,0,1,1,8,125,297,20,71,6.232827988,92859,151,1,14564,14396,168,520055,517677,2378,3749,3759,10,1,92.65967588
c324ece1144b90cff6e43bf9e2c40fcb07888e0a,220,2550,2948,398,1,0,1,8,129,238,20,71,6.23012009,93257,0,0,14396,14564,168,517677,520055,2378,3759,3749,10,1,92.65967588
79da7d92721bb48b6fe96444cfb2c801a524a8a7,1,6,1,5,0,0,0,2,4,44,1,1,0,132,155,0,17,16,1,685,658,27,3,3,0,1,100
7019d3c6b5d5abeaee3d823dfa4bc4c3927474ef,0,0,0,0,0,0,0,0,0,0,0,0,0,0,156,1,0,0,0,0,0,0,0,0,0,1,100
db075f111c89ce19e9dbb68886eb6c487ab6bd36,220,2945,2549,396,0,1,1,8,125,298,20,71,6.230416242,92864,52,0,14564,14397,167,520074,517704,2370,3749,3759,10,1,92.65967588
095c358b5aac6178cd60d73a429f2d6f7bd10cdc,220,2552,2948,396,1,0,1,8,129,238,20,71,6.227712533,93260,88,1,14397,14564,167,517704,520074,2370,3759,3749,10,1,92.65967588
9aad8d6e7649fe40909a74af8865fff3e28e3ebc,221,2948,2552,396,0,1,1,8,125,298,20,72,6.232636648,93084,37,3,14595,14428,167,521320,518948,2372,3756,3766,10,1,92.65967588
0ba3e129a068cf68ea8c2a77f003e112d0d54e08,220,2552,2948,396,1,0,1,8,129,238,20,71,6.227712533,93260,39,3,14397,14564,167,517706,520076,2370,3759,3749,10,1,92.65967588
a3a5e2a7bc6209f6e93b66858d1f62a44e119d4e,14,184,615,431,0,0,0,4,32,554,1,3,2.831276368,15156,157,2,672,674,2,108442,112116,3674,490,491,1,1,90.17838835
1327c5530746d10cb2ccf2789ce99000b80c1efd,0,0,0,0,0,0,0,0,0,0,0,0,0,0,158,3,0,0,0,0,0,0,0,0,0,1,100
8e19fc4370f6ff93a5387dd56cd4ed97faae74c6,3,46,2,44,0,0,0,1,6,632,1,1,0.97378373,342,159,4,29,26,3,1821,1570,251,18,17,1,1,100
cfb6a6d701b2922a342bbefb33ee9155619b54f7,0,0,0,0,0,0,0,0,0,0,0,0,0,0,160,5,0,0,0,0,0,0,0,0,0,1,100
4f7519293b506340486e2bbdfa93adfb414da126,0,0,0,0,0,0,0,0,0,0,0,0,0,0,1,1,0,0,0,0,0,0,0,0,0,1,100
6f51d062a6e698d4100e7725c31782b35182c7b4,0,0,0,0,0,0,0,0,0,0,0,0,0,0,11,1,0,0,0,0,0,0,0,0,0,2,100
42e050157b55a9a5bef1f2d913e8c5f0351364ab,0,0,0,0,0,0,0,0,0,0,0,0,0,0,12,2,0,0,0,0,0,0,0,0,0,2,100
95b2912e93a69fac4bc1081b49cf62f46c78d176,1,18,50,32,0,0,0,5,11,50,1,1,0,537,89,2,84,85,1,3044,3044,0,14,14,0,1,100
fa38ed737d8696519d39b0cc53c128141e29edc6,4,98,34,64,0,0,0,13,130,128,2,4,1.797091494,4799,5,1,897,885,12,32236,31633,603,127,126,1,1,100
3999d5b6a2f93ef72bdf1deea45d7abbe4268652,234,3651,2836,815,0,1,1,8,126,303,21,72,6.372254299,103104,5,1,15169,15002,167,598715,592922,5793,4155,4165,10,1,91.51486098
a8b4976ded4c4f980c351dd5c90f990c437107cd,234,2837,3652,815,1,0,1,8,130,247,21,72,6.371301571,103919,13,3,15002,15169,167,592922,598715,5793,4165,4155,10,2,91.51486098
b7c425945bd5323e20ccb690bc7bccb1397727fa,5,49,5,44,0,0,0,9,61,106,2,5,1.497275762,3589,181,1,788,776,12,19262,19013,249,134,132,2,1,100
3afd64e4f4088df4c1f6d6493a9d8506c224900b,233,3648,2834,814,0,1,1,8,126,301,21,72,6.368080207,102704,177,1,15100,14933,167,596786,590997,5789,4140,4150,10,1,89.87256875
55329a3e13580f014e282d319dc3168bb3e55507,233,2835,3649,814,1,0,1,8,130,250,21,72,6.367127689,103518,214,0,14933,15100,167,590997,596786,5789,4150,4140,10,1,89.87256875
4c54b13b78f775b2e2e564f86f63c54c372850cf,233,3648,2834,814,0,1,1,8,126,301,21,72,6.368080207,102704,214,0,15100,14933,167,596786,590997,5789,4140,4150,10,1,89.87256875
fe999c662ff15640502c3378b9ce50be41612dec,233,2835,3649,814,1,0,1,8,130,250,21,72,6.367127689,103518,153,3,14933,15100,167,590997,596786,5789,4150,4140,10,1,89.87256875
b8738de30bc49b64858b2d09e0eb033e04a326a6,233,3648,2834,814,0,1,1,8,126,301,21,72,6.368080207,102704,152,2,15100,14933,167,596786,590997,5789,4140,4150,10,1,89.87256875
e281a2e50d1def8e1773c5463709be03921aa94a,0,0,0,0,0,0,0,0,0,0,0,0,0,0,2,0,0,0,0,0,0,0,0,0,0,1,100
e05276f05a615590f7bb737bd6bcc8e4763822f1,233,2835,3649,814,1,0,1,8,130,250,21,72,6.367127689,103518,2,0,14933,15100,167,590997,596786,5789,4150,4140,10,1,89.87256875
a6daa264b6752ecd64473462799b774f621a2f6f,2,76,11,65,0,0,0,5,45,213,1,2,0.269055303,825,182,1,130,120,10,4490,4165,325,63,60,3,1,100
c6af51547e4e8bc0511b538a3f9af2362978eb86,233,3648,2834,814,0,1,1,8,126,302,21,72,6.368080207,102769,178,2,15110,14943,167,597111,591322,5789,4143,4153,10,1,89.87256875
b451c34d96a37985085c840cef61608fc39ee07b,234,2835,3654,819,1,0,1,8,130,247,21,73,6.371301571,103879,14,4,14992,15159,167,592978,598767,5789,4160,4150,10,1,89.87256875
1056997de83fae36a6b966be8ffe24cd89bcf551,1,6,6,0,0,0,0,9,54,15,1,1,0,501,90,2,84,84,0,2627,2627,0,29,29,0,1,100
a8a0b5533c4ef59638a116fadd9f0f0d68f5ee88,0,0,0,0,0,0,0,0,0,0,0,0,0,0,0,0,0,0,0,0,0,0,0,0,0,1,100
b08baf923d1f24434f79edeccc68de2103340275,0,0,0,0,0,0,0,0,0,0,0,0,0,0,91,3,0,0,0,0,0,0,0,0,0,1,100
39184d44aa26645fd000c7e4620807af6a1f2ee7,2,33,18,15,0,0,0,5,46,4,1,2,0.238684511,890,183,2,130,130,0,4628,4490,138,63,63,0,1,100
cc6ce72e8fdcb7079204ca403334b8c3f7add04d,234,3659,2840,819,0,1,1,8,126,299,21,73,6.373107719,103075,179,2,15159,14992,167,598905,593116,5789,4150,4160,10,1,89.87256875
cbfe184c3b08e2ad4c1090b6a76ca09d92507852,235,2842,3661,819,1,0,1,8,130,245,22,74,6.374229337,104328,15,5,15060,15227,167,595530,601319,5789,4168,4158,10,1,89.87256875
b8bc69a92d577a503ed4c3ba08a3d64c643d98c3,0,0,0,0,0,0,0,0,0,0,0,0,0,0,0,0,0,0,0,0,0,0,0,0,0,1,100
5d5dee08a041e7366ecb9caa0e060ce4a74e0dde,2,74,0,74,1,0,1,1,5,151,1,1,0.103275085,125,161,6,23,17,6,935,608,327,6,4,2,1,99.89493039
d128b5fe159cc52186c790ab08163718cab65b89,1,1,1,0,0,0,0,2,5,72,1,1,0,693,92,4,153,153,0,4532,4537,5,13,13,0,1,100
66adb23ca5e46710d9c7804e54faa0767ae624e3,1,1,1,0,0,0,0,15,131,21,1,1,0,3866,93,5,731,731,0,26689,26689,0,81,81,0,1,100
69204867d4bba0d7094ea5963971baf403af2fe4,3,37,21,16,0,0,0,13,132,14,2,3,1.572704142,4382,6,1,814,811,3,30000,29912,88,98,98,0,1,100
0765c215d6fa1a70734a32e6f37f6fc77dc718d5,237,3660,2916,744,0,2,2,8,127,295,22,74,6.398636541,103716,6,1,15244,15083,161,601945,596478,5467,4162,4174,12,1,89.78999106
e22ee9607206ad387572e3cac0aac32a562c57d5,238,2918,3662,744,2,0,2,8,132,239,23,75,6.399739841,104587,94,6,15100,15261,161,596985,602452,5467,4181,4169,12,1,89.78999106
82f2840f33b563924f9704cdafd9b4c590b332d8,0,0,0,0,0,0,0,0,0,0,0,0,0,0,162,7,0,0,0,0,0,0,0,0,0,1,100
47c8da66fac3a166dacae400acd78d94084fc4c1,1,18,30,12,0,0,0,2,4,101,1,1,0,980,163,8,43,47,4,6047,6149,102,23,24,1,1,100
bae15a962ac87f02c4d982edb2d5bd566dec5b7f,1,6,4,2,0,0,0,5,23,295,1,1,0,472,184,3,116,114,2,2534,2505,29,47,47,0,1,100
7164cfc4c43ee2411b12e3b5d7dc6cfeb388b2ab,238,3676,2920,756,0,2,2,8,127,302,23,75,6.395895624,103833,180,3,15263,15098,165,602481,596912,5569,4169,4180,11,1,89.78999106
e26bcce249ec1852e4b55daf8e9f78f754e30343,238,2929,3685,756,2,0,2,8,132,239,23,75,6.402192051,104589,95,7,15098,15263,165,596912,602481,5569,4180,4169,11,1,89.78999106
dae5808f35332270ee5c4b4e5467d860982b532d,0,0,0,0,0,0,0,0,0,0,0,0,0,0,96,8,0,0,0,0,0,0,0,0,0,1,100
e8abd7f3dc5617536cad4dc736976c70567fb391,1,1,1,0,0,0,0,3,4,295,1,1,0,88,0,0,14,14,0,339,339,0,5,5,0,1,100
4a87c298362da5bf3265103a37bb25eec6166b85,0,0,0,0,0,0,0,0,0,0,0,0,0,0,16,5,0,0,0,0,0,0,0,0,0,1,100
03fa94cb91904d33f1fa925581e5978522da998d,1,1,1,0,0,0,0,6,11,264,1,1,0,567,17,6,97,97,0,2785,2785,0,31,31,0,1,100
fd931f20270d4db8187b885b9e7f95c8261fdd82,2,10,14,4,0,0,0,1,6,104,1,1,0.543564443,644,164,9,29,30,1,4103,4140,37,10,10,0,1,100
69bb80df27bc49e1544a3b3bbe87c3d00cd921da,238,3700,2940,760,0,2,2,8,127,302,23,75,6.406610603,103829,3,1,15263,15097,166,602481,596875,5606,4169,4180,11,1,89.78999106
56e28489607eb7e7da68a76edf98c5f8ca78eb6c,238,2941,3701,760,2,0,2,8,132,234,23,75,6.405679601,104589,3,1,15097,15263,166,596875,602481,5606,4180,4169,11,1,89.78999106
56a93f6e483be0c49e35095f7eb0ea20123628e6,1,4,1,3,0,0,0,13,34,53,1,1,0,432,40,1,77,74,3,2768,2723,45,12,12,0,1,100
a3c8de04f19b984e16cc8a828ac0c3ac99683e00,238,3700,2940,760,0,2,2,8,127,302,23,75,6.406610603,103832,38,1,15266,15100,166,602526,596920,5606,4169,4180,11,1,89.78999106
d7c0b7a43e1fb1caaaa372495ba8b16a27243197,238,2941,3701,760,2,0,2,8,132,234,23,75,6.405679601,104592,18,7,15100,15266,166,596920,602526,5606,4180,4169,11,1,89.78999106
615a70ddbd66d4a2403ef26fa018246b8ac7ddb1,0,0,0,0,0,0,0,0,0,0,0,0,0,0,19,8,0,0,0,0,0,0,0,0,0,2,100
0c7a2d853251b64de019884f5f8aa1cc1acb29e7,1,27,30,3,0,0,0,3,6,14,1,1,0,126,165,4,16,17,1,598,615,17,4,4,0,1,99.86924686
01be3608f37369663e810a84fbb5b131281fad71,0,0,0,0,0,0,0,0,0,0,0,0,0,0,0,0,0,0,0,0,0,0,0,0,0,1,100
ca53a68e4b0c22f17db8faa4313d37fa360d5ee2,238,3729,2966,763,0,2,2,8,127,302,23,75,6.421611903,103829,0,0,15266,15099,167,602526,596903,5623,4169,4180,11,1,89.79955457
7e223f90b319795c23225b447aded71f74546331,238,2967,3730,763,2,0,2,8,132,233,23,75,6.420687621,104592,20,9,15099,15266,167,596903,602526,5623,4180,4169,11,1,89.79955457
75ff18b1265e91890302398286ae9dfa1b2e3148,5,86,309,223,0,0,0,3,33,108,1,3,1.42059712,6633,166,5,305,305,0,50508,52603,2095,259,260,1,1,94.63235294
24d15821c13dd6727417b244c9f25ce8f77fabfb,0,0,0,0,0,0,0,0,0,0,0,0,0,0,167,6,0,0,0,0,0,0,0,0,0,1,100
d7ea2e27a52e531f883be436a290f0de8f15ff4a,0,0,0,0,0,0,0,0,0,0,0,0,0,0,21,8,0,0,0,0,0,0,0,0,0,2,100
734eff61d86243805e578e1fb3a2b7c52cc91acc,0,0,0,0,0,0,0,0,0,0,0,0,0,0,97,7,0,0,0,0,0,0,0,0,0,1,100
f8ed53ef466e3206d743b4b92f48e1889df0cb7b,0,0,0,0,0,0,0,0,0,0,0,0,0,0,22,9,0,0,0,0,0,0,0,0,0,1,100
bf7a8bbde061d4ddcc387fb755443a70e85c4181,2,42,10,32,0,0,0,2,13,131,1,1,0.235193382,349,168,7,61,52,9,2037,1830,207,10,9,1,1,99.72235076
0f0bfc6dcece0c19d353cc54c5d08416afa38493,2,140,3,137,0,0,0,2,3,190,1,1,0.998270812,312,14,0,77,32,45,2444,1430,1014,15,11,4,1,99.86127168
cf01599b8724e080bcb760ef207fcf9fe9943396,240,4046,3092,954,0,2,2,8,127,302,23,75,6.434225236,103911,14,0,15305,15147,158,603913,596402,7511,4177,4188,11,1,93.24181626
dffbad4af43018438faf00b156acf593ab47839c,242,3272,4168,896,3,0,3,8,132,227,23,76,6.44863487,105026,15,0,15170,15323,153,597505,604844,7339,4198,4180,18,1,93.26032013
4e1eb0e98061de204bfdf339f2b593c8b219dfb5,240,4046,3092,954,0,2,2,8,127,302,23,75,6.434225236,103911,4,0,15305,15147,158,603913,596402,7511,4177,4188,11,1,93.3683106
0da1b424f3cf9574e31375251b4c78ee1f0e10a0,241,3232,4049,817,2,0,2,8,132,229,23,75,6.446658081,106314,325,0,15630,15671,41,604670,611780,7110,4221,4209,12,1,93.3683106
eb386c33c5a796a0e535598e5d71afa60fe2aa7f,240,4046,3092,954,0,2,2,8,127,302,23,75,6.434225236,103911,325,0,15305,15147,158,603913,596402,7511,4177,4188,11,1,93.3683106
5cee254303eb379ecc0633943542b0f2f396cd4c,0,0,0,0,0,0,0,0,0,0,0,0,0,0,215,0,0,0,0,0,0,0,0,0,0,1,100
bc4ab70bf4e4c32882392366bc653dde64a253f4,240,3093,4047,954,2,0,2,8,132,229,23,75,6.433380656,104865,215,0,15147,15305,158,596402,603913,7511,4188,4177,11,1,93.3683106
e10bad4da7a73d398a788d0881b4944dadf69b61,1,2,2,0,0,0,0,9,63,8,1,1,0,1586,154,0,483,483,0,8268,8268,0,33,33,0,1,100
f604e53d17607e9bccf3c5819a3291874672cc57,240,4046,3092,954,0,2,2,8,127,302,23,75,6.434225236,103911,153,0,15305,15147,158,603913,596402,7511,4177,4188,11,1,93.3683106
bac22f2216022a4b56b5a90eee0b928bb03d1dc9,241,3095,4047,952,2,0,2,8,132,229,23,75,6.435288028,106451,155,1,15632,15788,156,604676,612181,7505,4221,4210,11,1,93.3683106
d28acf0af1fea237257a46178459a45ffb4814c9,240,4046,3092,954,0,2,2,8,127,302,23,75,6.434225236,103911,154,1,15305,15147,158,603913,596402,7511,4177,4188,11,1,93.3683106
9a943f1bf915247c01c1ac4322e8e56e63386a04,242,3448,4087,639,3,0,3,8,132,230,23,75,6.432427474,104950,185,2,15229,15305,76,598505,604283,5778,4201,4177,24,1,93.30956376
3f07cc36890cdc9c6f0b7c132253fe85409abbd8,2,346,91,255,0,0,0,5,26,213,1,2,0.258018669,3323,186,3,793,732,61,17266,15639,1627,272,266,6,1,100
dae46059b940d258449779d3fbb0963df82936c0,0,0,0,0,0,0,0,0,0,0,0,0,0,0,169,8,0,0,0,0,0,0,0,0,0,1,100
47ce2df14dfcd817606457bd961930785edbc030,242,4185,3801,384,0,3,3,8,127,301,23,75,6.375548578,104566,133,0,15305,15290,15,604283,600132,4151,4177,4207,30,1,93.30956376
098865edd9174ab5bb17bf5c7caa54128fdf04d2,0,0,0,0,0,0,0,0,0,0,0,0,0,0,65,0,0,0,0,0,0,0,0,0,0,1,100
f26bac88fdce0faa0309a7b13e93990af3838a47,247,3861,4252,391,3,0,3,8,132,239,23,75,6.429217976,105293,187,3,15315,15335,20,601602,605728,4126,4224,4194,30,1,93.30956376
2a5b55e1bbae108432c20a5977f8ce4fe757b5a0,5,10,5,5,0,0,0,1,24,5,1,4,2.321928095,353,188,4,27,27,0,1498,1453,45,14,14,0,1,100
2e193e124399cf685c17798b8243e1d62f223315,1,3,0,3,0,0,0,3,6,93,1,1,0,104,156,2,19,18,1,346,334,12,9,9,0,1,100
208acf8eca45152e99da200e21847e01cab59604,0,0,0,0,0,0,0,0,0,0,0,0,0,0,1,1,0,0,0,0,0,0,0,0,0,1,100
c7ad5012be0c6542eae5eff57f29538a0d4498ad,1,75,70,5,0,0,0,7,16,269,1,1,0,446,170,5,65,61,4,2645,2592,53,8,6,2,1,100
16f3dd3c350ac9ea85b157b81ceddfcdb761e128,0,0,0,0,0,0,0,0,0,0,0,0,0,0,65,0,0,0,0,0,0,0,0,0,0,1,100
e1fa93de70bdb61fbcc05bda0d5786b7451c2b8c,23,69,116,47,0,0,0,3,34,348,2,5,3.100686358,18104,171,3,846,846,0,134872,135323,451,614,614,0,1,100
2d8895e6de2b1d04ce57e18c8b21a1fdff3b44b8,0,0,0,0,0,0,0,0,0,0,0,0,0,0,172,4,0,0,0,0,0,0,0,0,0,1,100
fbfa3193d9b267c18e95048d177f8d68f31a61ff,0,0,0,0,0,0,0,0,0,0,0,0,0,0,23,0,0,0,0,0,0,0,0,0,0,1,100
93b489e4c5741ccb27e57361fb17958b5ba5f15a,0,0,0,0,0,0,0,0,0,0,0,0,0,0,173,4,0,0,0,0,0,0,0,0,0,1,100
2814f71fa3fc4d31836ff55eddaff5d49e34494c,1,5,0,5,0,0,0,11,27,426,1,1,0,781,0,0,127,126,1,4103,4059,44,19,19,0,0,100
f2c4f90f07f6cddc008b560aa361b5a0b1e04a00,0,0,0,0,0,0,0,0,0,0,0,0,0,0,98,0,0,0,0,0,0,0,0,0,0,3,100
5e82ed83c4f6f360aefd2818c1485cb7dce2027c,0,0,0,0,0,0,0,0,0,0,0,0,0,0,4,0,0,0,0,0,0,0,0,0,0,1,100
9a99e3f41cc2125295058a8fc32e5b9e53bb48a4,1,36,17,19,0,0,0,7,14,206,1,1,0,485,41,0,91,88,3,2638,2537,101,20,20,0,1,100
2c57feaf8b53f719d889f07a21cbdfafe6608dc4,2,2,3,1,0,0,0,7,17,280,2,2,0.721928095,730,24,1,83,83,0,3806,3826,20,37,37,0,1,97.22468917
08d9c4e332cc54bf900002771b63c480d8e1dcc4,1,21,11,10,0,0,0,9,15,151,1,1,0,185,174,5,27,25,2,1010,970,40,9,9,0,1,100
42657fdb849f9e96e87c3f16f7c06a639600253a,0,0,0,0,0,0,0,0,0,0,0,0,0,0,99,1,0,0,0,0,0,0,0,0,0,1,100
57783900cad2d2a28f47e36ebea3864b8ffe38bd,2,100,47,53,0,0,0,9,28,212,1,2,0.999966618,1719,5,1,386,358,28,11096,10558,538,38,38,0,1,100
a94de11049c498cb93a96f00eae51af817b56d6b,0,0,0,0,0,0,0,0,0,0,0,0,0,0,6,2,0,0,0,0,0,0,0,0,0,1,100
fdd1d294c6b3c0e3cd8dd4219d034ad63210b380,1,0,2,2,0,0,0,8,27,156,1,1,0,315,157,1,39,39,0,1521,1543,22,11,11,0,1,100
7e75e9b1c4a0e6dd64d3ff09da1f713bc43b7e26,0,0,0,0,0,0,0,0,0,0,0,0,0,0,25,2,0,0,0,0,0,0,0,0,0,1,100
f2e36940c11642b7385e4af6d3b736ff952a7245,1,278,0,278,1,0,1,1,1,0,1,1,0,0,175,4,12,0,12,1681,0,1681,5,0,5,1,99.95698925
e07556457c8b159046016c97aedaa4dc4d0c3ef2,0,0,0,0,0,0,0,0,0,0,0,0,0,0,100,2,0,0,0,0,0,0,0,0,0,1,100
dbbc2eab1c5400a20245f04672dc7b9932969d43,2,86,64,22,0,0,0,6,10,631,1,1,0.918295834,129,176,5,10,9,1,725,667,58,8,5,3,1,100
ba29b40946bf98be6a5776e09ecaa056e4754109,1,56,0,56,0,0,0,5,19,62,1,1,0,551,189,0,124,112,12,3757,3441,316,21,20,1,1,98.87267905
84de2f030d92798e6715e180e00785f19d7c09bc,0,0,0,0,0,0,0,0,0,0,0,0,0,0,26,3,0,0,0,0,0,0,0,0,0,2,100
fd9abc800bbac553434b7a2d911a277ed6b70119,1,33,21,12,0,0,0,7,14,323,1,1,0,401,16,0,57,59,2,2269,2021,248,23,23,0,1,100
64a8c9f381ece94f0cbe35f3dbd97e5b56af093d,3,214,6,208,1,0,1,1,16,705,2,2,0.48964153,537,55,0,130,101,29,3637,2540,1097,48,41,7,1,99.52456418
51a96a86e88fb545b392704c4ddffe1e4957ff42,4,37,233,196,0,1,1,0,20,1,2,3,1.090257042,1352,190,1,227,254,27,6372,7394,1022,62,69,7,1,99.52456418
f6ff008a13d2fe25196d8f939369a1273829b927,0,0,0,0,0,0,0,0,0,0,0,0,0,0,27,4,0,0,0,0,0,0,0,0,0,1,100
820c6d251c44899c23e6f189eefeb9a79ca7384f,13,546,70,476,2,0,2,13,114,279,2,6,2.787648424,7889,191,2,1592,1501,91,48037,45419,2618,279,259,20,1,98.92352545
1a24d019e5875e97d13c833991f3c439d65a1dd7,17,303,583,280,1,2,3,13,113,262,2,8,3.157393261,9521,56,1,1755,1819,64,52813,54409,1596,328,341,13,1,98.50446429
a75eed841423addd53f26fcb57f55eca494e04fa,14,577,89,488,2,0,2,13,114,258,2,6,2.962949103,8496,57,2,1718,1625,93,51869,49176,2693,300,280,20,0,99.8424488
e52e2b271399c4d40b23da2a099b0dc16ed840c0,1,7,2,5,0,0,0,1,2,17,1,1,0,278,177,3,12,12,0,1734,1681,53,5,5,0,1,100
11bcd728ef103a1dd34a6d3f2b386bbaaa9ba550,1,26,12,14,0,0,0,6,19,252,1,1,0,388,158,1,57,51,6,1959,1804,155,11,11,0,1,100
84d132fcf8df176e827144b83425fce5f89de312,0,0,0,0,0,0,0,0,0,0,0,0,0,0,48,0,0,0,0,0,0,0,0,0,0,1,100
f6029f1cc926d8f487368216deb9dbebb3074eac,0,0,0,0,0,0,0,0,0,0,0,0,0,0,28,4,0,0,0,0,0,0,0,0,0,1,100
fdb74d51f86cc5e464e1beefd910fa3fc73ec45d,1,50,5,45,0,0,0,7,15,43,1,1,0,504,42,0,104,91,13,2937,2638,299,21,20,1,1,100
b7a1cc05c9607e02ce91079ee0d62c5d547ba069,1,18,12,6,0,0,0,7,16,173,1,1,0,348,178,3,79,77,2,1905,1849,56,12,12,0,1,100
16353c268e9d4c4c5cfd44f12937386165435493,0,0,0,0,0,0,0,0,0,0,0,0,0,0,29,4,0,0,0,0,0,0,0,0,0,2,100
b096802bec6fa59142ae924ed09419be5ad719e5,0,0,0,0,0,0,0,0,0,0,0,0,0,0,101,1,0,0,0,0,0,0,0,0,0,1,100
655ceb219ab044010bd9e764bb17dccc112c65a0,0,0,0,0,0,0,0,0,0,0,0,0,0,0,179,2,0,0,0,0,0,0,0,0,0,1,100
324a8e8728bd8d43c4165c77ed65fe63448533e9,0,0,0,0,0,0,0,0,0,0,0,0,0,0,102,1,0,0,0,0,0,0,0,0,0,0,100
8d32649f935fc0ade400db94c20d909fa1f767e1,2,26,4,22,0,0,0,7,53,223,1,2,0.468995594,3767,216,0,539,533,6,26293,26115,178,117,116,1,1,100
b47fe34779beb4be49015ca2f3dfecae7413135a,2,263,83,180,1,0,1,1,18,39,1,2,0.99302328,642,43,1,90,75,15,4447,3499,948,45,34,11,1,99.68418678
f695b5def99d6614f917b393c3802a721b82b687,0,0,0,0,0,0,0,0,0,0,0,0,0,0,180,2,0,0,0,0,0,0,0,0,0,0,100
eb77374d14120f20c50b8e862fd0e7ad2dd53c01,1,10,1,9,0,0,0,1,3,42,1,1,0,283,181,3,12,12,0,1808,1734,74,5,5,0,0,100
b3e4fdb3aa450cbdb93c0f8246bc09ce6d5f4802,0,0,0,0,0,0,0,0,0,0,0,0,0,0,7,0,0,0,0,0,0,0,0,0,0,1,100
e7c13864fc37f98b0e1fc4f9add2a681c43197f0,1,2,3,1,0,0,0,1,4,0,1,1,0,292,182,4,12,12,0,1783,1808,25,5,5,0,0,100
d2e1d099ebbd16af54144391fbe3803f1f204b79,1,3,2,1,0,0,0,1,5,0,1,1,0,291,183,5,12,12,0,1808,1783,25,5,5,0,0,100
d592d3fa2c2ea9f48f87b94f9ea5287f928df30d,1,1,10,9,0,0,0,1,6,0,1,1,0,292,184,6,12,12,0,1734,1808,74,5,5,0,0,100
caf7e9b86ece776de465a1961f89a918ba4cbef7,1,3,7,4,0,0,0,1,7,0,1,1,0,283,185,7,12,12,0,1686,1734,48,5,5,0,1,100
03df41fb21f8fe95d9ebaa3604408e2f4432e27b,0,0,0,0,0,0,0,0,0,0,0,0,0,0,8,1,0,0,0,0,0,0,0,0,0,1,100
d4f2340a9f68b046f770bd09f74e243ed28ad167,0,0,0,0,0,0,0,0,0,0,0,0,0,0,0,0,0,0,0,0,0,0,0,0,0,1,100
05a1a40175d6458509e715bb19fd219248e965e1,3,45,14,31,1,0,1,1,21,154,1,3,1.260375942,617,1,0,78,77,1,3206,3084,122,25,24,1,1,99.90952273
988f8eafeea04772dfbbe5b5ea838984c2bf522e,0,0,0,0,0,0,0,0,0,0,0,0,0,0,30,1,0,0,0,0,0,0,0,0,0,1,100
a92129807e4a46c6644c1dd6e430fe8b8b4c1739,0,0,0,0,0,0,0,0,0,0,0,0,0,0,31,2,0,0,0,0,0,0,0,0,0,1,100
7b61f159fa8f5c612c65a2b329fd103153cfb0aa,1,2,2,0,0,0,0,9,35,104,1,1,0,1398,186,7,42,42,0,10306,10306,0,42,42,0,1,100
15fd7fa5d1a734246640e1337d2b2b927dccc486,0,0,0,0,0,0,0,0,0,0,0,0,0,0,32,2,0,0,0,0,0,0,0,0,0,2,100
c5332d123411535f3dbfeef7b1872d97cc087bb2,0,0,0,0,0,0,0,0,0,0,0,0,0,0,33,3,0,0,0,0,0,0,0,0,0,1,100
66e1ce2e1eb2bcf894178be5a6b64f60dc8faeed,0,0,0,0,0,0,0,0,0,0,0,0,0,0,34,4,0,0,0,0,0,0,0,0,0,1,100
55e6d4e1398f27d897795a174a332d6e18642b08,1,0,3,3,0,0,0,13,54,26,1,1,0,2170,44,1,495,496,1,14371,14392,21,74,74,0,1,100
5055db1535098f25603cb63fa4bb5aa521d6161a,3,21,9,12,0,0,0,2,58,271,1,3,1.41861967,1609,192,0,382,372,10,8853,8734,119,63,63,0,1,100
88352408b535d82bbef1b1ffc79b16fb57ffb505,0,0,0,0,0,0,0,0,0,0,0,0,0,0,35,5,0,0,0,0,0,0,0,0,0,1,100
96b0c48602d777e7f1aacc6b7253fed874811b1a,17,358,27,331,0,0,0,6,65,365,12,16,3.120457311,8315,193,1,1696,1647,49,49311,47292,2019,322,315,7,1,99.41375423
1685bacf057b773210ae8ca055a6668ea2fa7dd5,1,20,12,8,0,0,0,2,4,298,1,1,0,424,36,4,30,30,0,2349,2196,153,10,10,0,1,100
edd0bd6a69b4919745d79119e943ad4b330941d0,1,100,0,100,0,0,0,10,66,0,1,1,0,1614,37,5,502,488,14,9003,8406,597,37,33,4,0,100
a89ddecf05b9b22c6b5faf2f2f7acd12cbb1f7ca,0,0,0,0,0,0,0,0,0,0,0,0,0,0,17,0,0,0,0,0,0,0,0,0,0,1,100
7d5d00c15d4fdde8d57182dc67ec05b883474191,0,0,0,0,0,0,0,0,0,0,0,0,0,0,45,1,0,0,0,0,0,0,0,0,0,1,100
7c401b3e305c3ec7de47105a2980a9152ae04ce4,6,38,85,47,0,0,0,4,56,126,1,6,1.914532699,2110,194,2,396,405,9,11085,11271,186,104,107,3,1,100
13620b2647899732452ad883a33cd4e98fe70edb,1,15,2,13,0,0,0,7,16,351,1,1,0,839,103,0,179,177,2,5081,5018,63,22,22,0,1,99.46356728
b6c631dbdba2329b760eedeb58c983555648f504,2,24,1,23,0,0,0,7,21,271,2,2,0.795040279,947,2,0,136,132,4,4882,4785,97,25,24,1,1,100
c12cfd97728b1209fa5340a42b9528d008f10db5,1,18,7,11,0,0,0,7,17,521,1,1,0,366,3,1,48,46,2,1767,1717,50,11,11,0,1,100
1befffcc1c18679cdf2c6413496b2078f6d2a838,1,6,3,3,0,0,0,7,18,0,1,1,0,377,159,0,48,48,0,1780,1767,13,11,11,0,1,100
93c900c346cdac33e268c2e76e2f37568cc1c7f3,3,30,32,2,0,0,0,3,36,628,1,2,1.332358738,1733,18,1,302,301,1,11884,11940,56,99,98,1,0,100
c5daf83bc225a6249022e23fd0cbcadeb56a0987,0,0,0,0,0,0,0,0,0,0,0,0,0,0,9,0,0,0,0,0,0,0,0,0,0,1,100
f01bcf3d003500eaa28c1f48b8eac83fb037298a,3,0,3,3,0,0,0,8,14,275,2,3,1.584962501,962,38,3,140,140,0,5084,5105,21,33,33,0,1,100
688807cf74fc434e246a2f7d6c0e71e941178421,1,21,27,6,0,0,0,9,16,168,1,1,0,195,19,2,29,27,2,970,1010,40,11,9,2,0,100
4ce27cffb96e21e2e7ece628b0a303c52746204d,2,2,62,60,0,0,0,7,28,165,2,2,0.625262405,1333,160,1,213,220,7,6310,6652,342,53,54,1,1,100
0736d98e23441a112567b470254cc47bbdf2cb69,1,14,17,3,0,0,0,13,27,267,1,1,0,284,39,1,41,42,1,1342,1351,9,21,21,0,1,100
0878d19e9fc39c13c136411ee4df6c6fa33c7b43,2,50,32,18,0,0,0,6,67,164,1,2,0.499179836,2617,40,2,555,554,1,13507,13428,79,61,60,1,1,100
9f5721bbed8057586e63a5ea5552ddecf5cc67ca,10,716,199,517,0,0,0,13,55,413,2,8,2.608357039,10010,7,0,1577,1435,142,65676,62043,3633,383,373,10,1,99.82234066
71023632235ec0ad1e85962f47153c586983b225,0,0,0,0,0,0,0,0,0,0,0,0,0,0,20,2,0,0,0,0,0,0,0,0,0,0,100
3dc21364c4b50444147aa45bc9bcc4c1325f8f2d,15,49,100,51,0,0,0,7,17,411,1,1,3.702197124,4729,21,3,691,691,0,27520,27769,249,162,162,0,0,99.07874534
f7230f70a4de21c7bac9028a05f9f7472077e809,1,3,2,1,0,0,0,6,16,16,1,1,0,912,187,0,53,53,0,4490,4484,6,24,24,0,1,100
1b4e78b0dcfad74b7fd2baea16364b7daf32159e,1,63,43,20,0,0,0,8,24,63,1,1,0,777,195,0,207,198,9,5303,5080,223,26,26,0,2,100
c8058ad8056c534688551b2e1767611d47d66ab7,1,1,0,1,0,0,0,13,115,163,1,1,0,3201,8,1,592,592,0,19951,19944,7,69,69,0,1,100
f6d4f116c5ecf0a656b1cba3846cfd3cbd9e5393,0,0,0,0,0,0,0,0,0,0,0,0,0,0,10,0,0,0,0,0,0,0,0,0,0,1,100
d4cf1226427e8c49e63a751f4fe8bada565f64d1,2,20,0,20,0,0,0,5,27,820,2,2,1,1630,11,1,326,322,4,7441,7306,135,124,122,2,1,100
ca9f7c1824f3d6bd0e2796b9aed4ec5f66bb3baa,3,65,11,54,0,0,0,1,43,286,1,3,1.448119997,2510,58,0,410,407,3,13878,13502,376,128,127,1,1,100
32999cd07c4dae454e0dde8fc3433c0e822d068d,0,0,0,0,0,0,0,0,0,0,0,0,0,0,41,2,0,0,0,0,0,0,0,0,0,1,100
a9523814cf4b3763a3a8db7d7eb3161e624074c5,0,0,0,0,0,0,0,0,0,0,0,0,0,0,42,3,0,0,0,0,0,0,0,0,0,1,100
b676cd920cc64e6e8d286f231a714a65f93031ef,0,0,0,0,0,0,0,0,0,0,0,0,0,0,43,4,0,0,0,0,0,0,0,0,0,2,100
a16889fbbd189ea6282030b528f8d17fac79144a,0,0,0,0,0,0,0,0,0,0,0,0,0,0,44,5,0,0,0,0,0,0,0,0,0,1,100
02c094393f40b209800f740a1ca8eaa8f7f4e43a,3,37,22,15,0,0,0,9,36,139,2,3,1.349722756,2103,46,0,160,159,1,14227,14105,122,73,73,0,1,100
e0a010f5c859a52be452f92244c67ac045bdfbdf,4,9,8,1,0,0,0,3,56,36,2,3,1.903967813,6167,0,0,953,950,3,39770,39768,2,183,183,0,1,100
5318e2f5f5610c3765df7971a48d5f3692e3286b,2,14,6,8,0,0,0,11,28,114,1,1,1,1625,59,1,251,251,0,8590,8510,80,33,33,0,1,100
5fc9ee1f9a41d2dd73dad1dc9e32fbfaa38872a6,0,0,0,0,0,0,0,0,0,0,0,0,0,0,104,0,0,0,0,0,0,0,0,0,0,2,100
b9cdb0bd540f4e092720026ca92ce934cc13f90d,2,126,57,69,0,0,0,7,29,115,1,2,0.99997846,1401,9,2,292,264,28,9687,9133,554,26,26,0,1,100
053cdd7b7e367aef09ab9d6b862f86fad35de811,1,26,6,20,0,0,0,13,116,20,1,1,0,3202,10,3,604,592,12,20142,19951,191,69,69,0,1,100
18a47ed4b8ea910a2c93c8707a0128f9b2af6ce5,2,36,1,35,0,0,0,11,57,179,1,2,0.303374836,3283,0,0,623,615,8,20935,20708,227,157,155,2,1,100
a43dd80f08857b99464934de9f5262851ab6749f,1,17,14,3,0,0,0,14,28,48,1,1,0,281,105,1,42,41,1,1351,1342,9,21,21,0,1,100
4daf1e9ed9f89f389f8cdb74baa1792f92fc2466,1,1,1,0,0,0,0,8,24,369,1,1,0,313,2,0,64,64,0,1946,1946,0,6,6,0,1,100
83b67df99b87e8fa14564e237623f8749f1fab81,0,0,0,0,0,0,0,0,0,0,0,0,0,0,45,4,0,0,0,0,0,0,0,0,0,1,100
e474c4d7b844c2cb3ac5609b68f56eee43ae4b64,1,1,1,0,0,0,0,6,13,289,1,1,0,217,0,0,37,37,0,1226,1226,0,6,6,0,1,100
c7d1e50b231e10efb543b5ebec578598396b9f68,4,14,15,1,0,0,0,10,27,241,4,4,1.063431858,2291,188,0,460,460,0,10902,10921,19,95,95,0,1,100
a71dab7fdf43cb939221c9aaa0e34a34df153dd6,1,1,1,0,0,0,0,9,37,81,1,1,0,1457,46,5,272,272,0,10201,10197,4,92,92,0,1,100
95615f8eb7c6acd7c92c75527e8255d59143f68e,1,30,0,30,0,0,0,7,17,46,1,1,0,913,0,0,56,53,3,4649,4490,159,25,24,1,1,100
792e40bcdf6b209ed47f0508bd11efc820b0a5b8,0,0,0,0,0,0,0,0,0,0,0,0,0,0,1,0,0,0,0,0,0,0,0,0,0,1,100
a8fea7b6d2d40dc13a8aa4e92852fedc2dde5b40,0,0,0,0,0,0,0,0,0,0,0,0,0,0,189,1,0,0,0,0,0,0,0,0,0,1,100
4075c08b9fd1c6ce6ef4fa2d3a1033e95d9d3d8a,0,0,0,0,0,0,0,0,0,0,0,0,0,0,190,2,0,0,0,0,0,0,0,0,0,0,100
5a736c2aaab7a7498dd143ce5078ba4e605536d9,0,0,0,0,0,0,0,0,0,0,0,0,0,0,191,3,0,0,0,0,0,0,0,0,0,0,100
513477d06d3dc2d4ac38eedfca83f58b6b8f28a7,0,0,0,0,0,0,0,0,0,0,0,0,0,0,1,1,0,0,0,0,0,0,0,0,0,1,100
c24c9bdfd2bc813febf16736877b7f43cd8bfeb5,0,0,0,0,0,0,0,0,0,0,0,0,0,0,47,2,0,0,0,0,0,0,0,0,0,1,100
6890976ee99a2f05fbec214003c67da7b2eb466d,2,7,1,6,0,0,0,4,68,180,1,1,0.954434003,1830,48,3,523,521,2,9398,9369,29,46,46,0,1,100
f4019d11ba20fb6d61171876e4f14ea428028887,4,514,144,370,0,0,0,1,44,44,1,3,1.282928777,3358,60,0,621,537,84,20480,18061,2419,156,147,9,1,100
d0cf2dd5545152701355560d2b2dbba19eec0b3b,1,21,18,3,0,0,0,9,25,38,1,1,0,313,49,4,65,64,1,1967,1946,21,6,6,0,1,100
991481b2795de80c771d7354594b7c59ac5022ce,1,35,27,8,0,0,0,4,43,133,1,1,0,880,196,0,203,200,3,5188,5152,36,41,41,0,1,100
774f55845921c6a60ce5c06ccb19e339a5529d49,0,0,0,0,0,0,0,0,0,0,0,0,0,0,50,4,0,0,0,0,0,0,0,0,0,1,100
b383385fe32e1b7da32bc04ad1d47dd4907a3b38,1,31,1,30,0,0,0,16,133,344,1,1,0,3870,1,0,746,731,15,26923,26708,215,82,81,1,1,100
23046e9e81941060df0faa76984a64832a42f516,38,1333,2016,683,5,9,14,6,134,549,13,24,4.094279804,23566,2,1,3857,3941,84,142193,141510,683,723,770,47,1,97.6195823
de417e1851603e98c2acb0e6a81b0f2524256a06,3,14,11,3,0,0,0,8,24,224,1,1,1.582683189,1347,110,1,299,299,0,8428,8358,70,46,46,0,1,100
a341fa1af3e36c4809d5d834cafb6a3a8168ff4d,0,0,0,0,0,0,0,0,0,0,0,0,0,0,111,2,0,0,0,0,0,0,0,0,0,1,100
ea9d66a249a169e2de8f90e0452a684c2629e762,1,1,5,4,0,0,0,3,4,1130,1,1,0,233,60,2,33,33,0,868,877,9,16,16,0,1,100
e0c1e355a94cdecdf60e6d9eb0c54ff6d3bd412d,5,105,19,86,0,0,0,9,135,390,1,5,1.817867716,10102,16,1,1529,1514,15,68255,67781,474,227,223,4,1,100
7985dd473acb024e8f3c56c12af6608b0cecc3b6,17,1105,704,401,1,0,1,7,136,445,3,11,2.413350084,13830,197,0,2600,2547,53,86006,83991,2015,620,605,15,1,98.56348471
eed9eb2b5cb19756cab3b9085f930634c7d9dcd5,1,20,37,17,0,0,0,7,17,147,1,1,0,549,197,0,102,104,2,2895,2937,42,19,21,2,1,100
ca9b5f51241a802b0d28152779fe22412dd2f774,1,5,7,2,0,0,0,17,60,41,1,1,0,2229,3,2,507,506,1,14825,14824,1,74,74,0,1,100
478f5ffc737b4c238db67e844e88fd73c61dc5da,2,55,0,55,0,0,0,15,120,290,1,2,0.13110653,4855,17,2,975,954,21,31024,30642,382,115,114,1,1,100
2cc88970bea34cdeac92182572a5046f09a70306,1,7,6,1,0,0,0,13,22,442,1,1,0,367,112,2,65,65,0,2374,2361,13,14,14,0,1,100
d9f54d72ca7eec9eeeb4f12f5ebfa71b61b2acc0,3,57,51,6,0,0,0,16,137,239,2,2,1.114269072,4750,198,1,929,931,2,31370,31373,3,107,108,1,1,100
8d39dfe99051968055f0f46a9275f59a276fc84a,0,0,0,0,0,0,0,0,0,0,0,0,0,0,61,1,0,0,0,0,0,0,0,0,0,1,100
a98dc785a61ee9bbb1cdb4f8caac5a87dd163ed1,1,4,1,3,0,0,0,15,121,9,1,1,0,3291,18,2,634,632,2,20718,20690,28,70,70,0,1,100
6014e64a0fcfe957f4a0ee7e52cc29139b63ac92,2,3,30,27,0,0,0,9,18,981,1,2,0.532835063,968,19,3,136,139,3,3722,3837,115,13,13,0,1,100
a2e896da0989c90060e767338165b3ccf27f6c67,12,90,32,58,0,0,0,9,138,393,2,6,3.190338949,14887,199,2,1801,1791,10,103324,102844,480,399,397,2,1,100
c3fbdae9faf4e53816e9cc7b965f8a5aa59cf1e6,1,2,2,0,0,0,0,5,19,501,1,1,0,216,200,3,39,40,1,1102,1113,11,9,9,0,1,100
c61f97a3d22c12c7817b0c441a2ba78b5465b3ee,2,97,42,55,0,0,0,3,18,585,1,1,0.915879063,610,198,1,122,112,10,3337,3083,254,32,29,3,1,100
97280ee10f8cb1c624e348227fc696adffa731ce,0,0,0,0,0,0,0,0,0,0,0,0,0,0,20,4,0,0,0,0,0,0,0,0,0,1,100
33bf690cc7d09aacd10fa9f12ba073e5e6e1e124,1,121,44,77,0,0,0,5,23,350,1,1,0,663,201,4,156,141,15,4218,3795,423,27,25,2,1,100
9e8bfb9c28cc8eee2972e62dd256e8aa9d933c1e,2,6,6,0,0,0,0,2,7,824,2,2,0.918295834,339,199,2,21,21,0,1556,1556,0,12,12,0,1,100
caf373daf8cce06c2fad7f6452756708e178cd38,2,27,1,26,0,0,0,3,19,8,1,1,0.905928216,665,200,3,126,122,4,3439,3337,102,34,32,2,1,100
8d9bd5fbaeb5a555134de50d3bab3ec560267c6f,0,0,0,0,0,0,0,0,0,0,0,0,0,0,62,2,0,0,0,0,0,0,0,0,0,1,100
a4e69aab29a7c2362af26c0c46f8ed63d983370a,0,0,0,0,0,0,0,0,0,0,0,0,0,0,4,1,0,0,0,0,0,0,0,0,0,1,100
847e121f5e210638d292eee0cb9beef34a037927,7,156,74,82,0,0,0,5,23,565,1,5,1.949855586,2985,202,5,442,434,8,18221,17551,670,112,108,4,1,100
ba99369a82914101d0652d68056a0b48eb69eea1,1,3,0,3,0,0,0,7,14,779,1,1,0,149,4,0,9,9,0,716,689,27,2,2,0,1,100
79e91fa5f5175b3ddeab8d901f7e98697c9d639f,1,37,11,26,0,0,0,9,26,138,1,1,0,316,113,1,71,65,6,2173,1967,206,6,6,0,1,100
6e6e42b0bffb67ad5613b99bf8f6dadbfeeca90b,8,880,2,878,7,0,7,1,30,13,3,5,2.604233486,285,114,2,168,42,126,5645,1360,4285,61,21,40,1,97.24076547
7fc74fccc9ab4e1b1f9a369b92e762afe241fcb3,7,26,8,18,0,0,0,5,56,128,1,5,2.380759422,3969,203,6,814,810,4,22517,22417,100,159,156,3,1,100
543b9ff006da4f64b951e2f6c0a6b16d9b703f22,0,0,0,0,0,0,0,0,0,0,0,0,0,0,63,2,0,0,0,0,0,0,0,0,0,1,100
e16fd4c338fc318c26721107107b12f414df79a3,0,0,0,0,0,0,0,0,0,0,0,0,0,0,64,3,0,0,0,0,0,0,0,0,0,1,100
454be055e496921c7384ada2cb1d00120c83bc48,0,0,0,0,0,0,0,0,0,0,0,0,0,0,65,4,0,0,0,0,0,0,0,0,0,1,100
c1b9b90d1ba28b49791dac5877ef8ed643e3fc7b,1,4,4,0,0,0,0,9,27,16,1,1,0,342,115,2,71,71,0,2189,2173,16,6,6,0,1,100
8dc5598c034017a22bacf9e6082aa1f4a7d6cc23,0,0,0,0,0,0,0,0,0,0,0,0,0,0,66,5,0,0,0,0,0,0,0,0,0,1,100
adffc001f44a38965860ce3e720d708ed13f8747,1,40,48,8,0,0,0,3,7,1192,1,1,0,208,204,3,32,31,1,1021,1003,18,6,7,1,1,100
a7163cb91dbf459c4e88025415ebab82a4a10f8b,0,0,0,0,0,0,0,0,0,0,0,0,0,0,5,1,0,0,0,0,0,0,0,0,0,1,100
4c1e80e6bb4262a4e11dbf5dfe9b9aad00fabc14,1,8,7,1,0,0,0,3,3,1202,1,1,0,217,116,3,29,28,1,1153,1141,12,10,10,0,1,100
45f40277c996ea754eb7efb995e73efaec311394,1,2,21,19,0,0,0,7,13,719,1,1,0,464,67,5,56,56,0,2149,2157,8,11,11,0,1,100
a62060fb08ab515c6251372098930dcfcd9bbdba,0,0,0,0,0,0,0,0,0,0,0,0,0,0,117,4,0,0,0,0,0,0,0,0,0,1,100
550cefcb6c7cd9009c123f8052cf6cc45ee6350b,1,2,2,0,0,0,0,7,12,722,1,1,0,492,118,5,70,70,0,2608,2608,0,12,12,0,1,100
29d9322ec4a0e12650d4be1e569a945ddde9dfcd,0,0,0,0,0,0,0,0,0,0,0,0,0,0,4,0,0,0,0,0,0,0,0,0,0,1,100
54c87fec53986dbe6e798aeab8e2a1d628c280b3,0,0,0,0,0,0,0,0,0,0,0,0,0,0,201,0,0,0,0,0,0,0,0,0,0,1,100
44691b556dfe427d0c873c4f6537f55fa207a28c,2,1006,0,1006,2,0,2,1,1,0,1,1,0.441295579,0,119,4,86,0,86,3389,0,3389,80,0,80,2,99.91401548
502f3cea682013f5ca4ea5e702f887aabc60e538,0,0,0,0,0,0,0,0,0,0,0,0,0,0,68,5,0,0,0,0,0,0,0,0,0,1,100
b3dc7bd42f4144be258265d22040cecef0bc2ee3,0,0,0,0,0,0,0,0,0,0,0,0,0,0,202,1,0,0,0,0,0,0,0,0,0,1,100
f8931ff65721a49cfd7998522f75774bb3e861e6,2,4,0,4,0,0,0,8,17,295,2,2,0.811278124,648,5,0,99,99,0,3959,3935,24,20,20,0,1,100
0688f5eb7378a120830571260bf483949ccd4a74,1,1,0,1,0,0,0,3,23,733,1,1,0,367,205,1,77,76,1,2140,2137,3,10,10,0,1,100
2a1406df8125b96b3051616cb61ba01fc96f93c3,8,357,176,181,0,0,0,1,60,333,1,6,1.567969499,3251,206,2,665,634,31,18376,17410,966,157,148,9,1,99.78383052
98cb80e3335e7c9588b9ad5b57667d3421fba4e6,1,57,21,36,0,0,0,4,9,1226,1,1,0,303,207,3,53,47,6,1612,1460,152,15,14,1,1,100
576b62ad0e9ec4ae6de270a4531eb7eb162d6d8e,5,81,142,61,1,0,1,3,6,988,1,1,2.253051836,531,23,0,46,60,14,2250,2837,587,14,16,2,0,99.71782071
58fc47e6247500f8c67c55d933ce99c3c47a97ef,2,8,3,5,0,0,0,5,9,421,2,2,0.994030211,483,13,0,75,73,2,2791,2748,43,23,23,0,1,100
e65235d1cb52267be16d6b033532d88692fde12f,0,0,0,0,0,0,0,0,0,0,0,0,0,0,120,4,0,0,0,0,0,0,0,0,0,1,100
81d1584a2c8337e5fca81bf5cc237c3e66666e4e,1,15,16,1,0,0,0,6,14,75,1,1,0,678,208,3,118,118,0,3392,3392,0,35,35,0,1,100
6f4e28639ad431cc0073e1af4ed591035d92b734,1,2,3,1,0,0,0,17,139,102,1,1,0,4000,5,1,770,770,0,27686,27669,17,85,85,0,1,100
10051777edf21c5ab7914c0670e23040d105dc4c,5,134,91,43,0,0,0,2,17,764,1,3,1.99778077,1700,209,4,303,292,11,8772,8606,166,73,72,1,1,99.65179543
8ab766846538ddcb3dd56dc11c174c6a8e3ad83c,1,3,2,1,0,0,0,14,35,544,1,1,0,435,69,1,77,77,0,2771,2768,3,12,12,0,1,100
41e220381fecb3fcb184b0227152f4e77078ab1c,3,17,57,40,0,0,0,4,13,661,1,3,1.281701324,1638,24,1,195,202,7,9863,10050,187,50,51,1,0,99.95625547
ad2731811d56a2fa357cf06bea5e5c2f1fc1b98d,5,358,29,329,4,0,4,1,2,17,1,2,2.133843761,280,121,2,91,45,46,2877,1634,1243,40,10,30,1,99.84699454
906613684d0662b22448435fe794b08b217d7021,2,30,28,2,0,0,0,3,16,738,2,2,0.66319684,287,122,2,43,42,1,1488,1469,19,10,10,0,1,100
5824fdc819bf41736ec5d2798ffaa7aba24c8cc7,0,0,0,0,0,0,0,0,0,0,0,0,0,0,70,1,0,0,0,0,0,0,0,0,0,1,100
21f8b63f5d0c6e422bc19adb515ba8a542955ab5,0,0,0,0,0,0,0,0,0,0,0,0,0,0,71,2,0,0,0,0,0,0,0,0,0,2,100
b70479c4fe1abadf9d94d07a995e0c988dc5ad1c,0,0,0,0,0,0,0,0,0,0,0,0,0,0,203,0,0,0,0,0,0,0,0,0,0,1,100
1e77fa2a4be3425f97d5711ebb0de5db8258c618,3,199,5,194,1,0,1,1,140,19,2,3,0.722440719,4676,210,2,910,888,22,32018,31078,940,128,120,8,1,99.95633188
4c2bed53607de1fe8d3565f7a79dc807f6a5008a,0,0,0,0,0,0,0,0,0,0,0,0,0,0,123,2,0,0,0,0,0,0,0,0,0,1,100
fb0b6f6abd06ad051d53fe67ed62a2aaedf518ed,0,0,0,0,0,0,0,0,0,0,0,0,0,0,72,3,0,0,0,0,0,0,0,0,0,1,100
879a4dfddca4218148a738ef20001b020f4b9f3e,1,1,1,0,0,0,0,6,8,576,1,1,0,152,73,3,18,18,0,861,861,0,5,5,0,1,100
370cb4fc6c634f5eaccb91727ae8fe1b2b262ea1,3,429,20,409,1,0,1,1,26,302,1,2,1.104464671,888,211,1,257,216,41,8024,5768,2256,53,32,21,1,99.91272093
9260e0de099d1c4c092c276217088b7512db134a,0,0,0,0,0,0,0,0,0,0,0,0,0,0,74,4,0,0,0,0,0,0,0,0,0,1,100
44538159464b1357ed6862c5462ae7a4d48a0b8b,1,5,11,6,0,0,0,3,8,209,1,1,0,694,75,5,151,153,2,4510,4538,28,13,13,0,1,100
650b24e5d38c20c20869c0158ed9f35818e79bd0,1,5,8,3,0,0,0,10,36,675,1,1,0,402,76,6,65,66,1,2897,2893,4,9,10,1,1,100
03b052e2ca543ef4724f7b23807ee9bebf0ff34c,0,0,0,0,0,0,0,0,0,0,0,0,0,0,204,1,0,0,0,0,0,0,0,0,0,1,100
d7557cd01e3a7aacc295c297655753923ac7599a,0,0,0,0,0,0,0,0,0,0,0,0,0,0,205,2,0,0,0,0,0,0,0,0,0,1,100
87428c93c69abf834b9d0814210a9493e5390c1f,0,0,0,0,0,0,0,0,0,0,0,0,0,0,206,3,0,0,0,0,0,0,0,0,0,1,100
291bb3e9c2e67a5bacad40f397382e6b896f96a2,0,0,0,0,0,0,0,0,0,0,0,0,0,0,207,4,0,0,0,0,0,0,0,0,0,1,100
c806d17779144df3d0c60402a03cb167e69c1582,6,622,35,587,4,0,4,1,6,499,2,4,2.101313393,328,2,0,106,48,58,5179,1524,3655,60,23,37,1,99.82585982
9750aa3d96336a352a7219cd9041978532642009,1,48,55,7,0,0,0,6,9,971,1,1,0,240,25,0,37,41,4,1356,1428,72,9,8,1,0,100
2fa6f6ce6255e3a49756a02c65a018b61d1ad9f4,2,8,7,1,0,0,0,2,27,4,1,2,0.566509507,1188,26,1,247,246,1,7466,7441,25,47,47,0,0,100
f79737bb284fd0671a6ad05ccc4c1d16fd4e1603,0,0,0,0,0,0,0,0,0,0,0,0,0,0,21,0,0,0,0,0,0,0,0,0,0,1,100
e2c52d62b100e0ed2b2ce3e47dc8a9ee0aab19d6,0,0,0,0,0,0,0,0,0,0,0,0,0,0,208,5,0,0,0,0,0,0,0,0,0,1,100
c7260c3eeee0b9f33f01a166b1be5ee6540a10d7,6,35,622,587,0,4,4,2,7,0,2,4,2.101313393,915,66,0,48,106,58,1524,5179,3655,23,60,37,1,99.82585982
e8afb9faad81e7042877aa528635848a0043cb0c,21,626,740,114,2,2,4,1,24,713,2,6,3.513702624,3485,212,2,467,485,18,18332,18906,574,133,132,1,1,99.39420164
b8c70c41b9728f9abb22b8cde66cc09ee8dc0845,2,0,455,455,0,2,2,3,5,788,2,2,0.893046568,455,209,6,0,75,75,0,2188,2188,0,24,24,1,99.91405243
d22398bb4e5ef2efe15d9d55e56e08c0bf37a8b6,0,0,0,0,0,0,0,0,0,0,0,0,0,0,210,7,0,0,0,0,0,0,0,0,0,0,100
c4020f89b929f323d133fbe81d2571deca29f934,0,0,0,0,0,0,0,0,0,0,0,0,0,0,27,2,0,0,0,0,0,0,0,0,0,0,100
59b457a451fd0d1b78b658405ad936b5f6f3135a,0,0,0,0,0,0,0,0,0,0,0,0,0,0,211,7,0,0,0,0,0,0,0,0,0,1,100
30b8ddfbdc946c4a3e07da0121c29e0da1db2587,0,0,0,0,0,0,0,0,0,0,0,0,0,0,212,8,0,0,0,0,0,0,0,0,0,1,100
58f513215da421a4015e2d080e88d8fdacad3471,0,0,0,0,0,0,0,0,0,0,0,0,0,0,213,9,0,0,0,0,0,0,0,0,0,1,100
d1ee6a578e4d3268bdb220cdb73f481d7403fbc2,0,0,0,0,0,0,0,0,0,0,0,0,0,0,124,1,0,0,0,0,0,0,0,0,0,1,100
cd67d7295a95049646c44c3bcf1fdd04895eff5d,0,0,0,0,0,0,0,0,0,0,0,0,0,0,77,5,0,0,0,0,0,0,0,0,0,1,100
dec65f164f06c04947c1823f91da7482f9a8067e,2,0,251,251,0,2,2,4,10,1326,1,1,0.550514207,251,213,2,0,40,40,0,1100,1100,0,4,4,1,99.89231101
ca8f0b76404db53a4b0bdb4f697d14e7adeff175,0,0,0,0,0,0,0,0,0,0,0,0,0,0,214,10,0,0,0,0,0,0,0,0,0,1,100
0e5b0775258a251d1846dd9622f234b8b46df742,0,0,0,0,0,0,0,0,0,0,0,0,0,0,215,11,0,0,0,0,0,0,0,0,0,1,100
46164b7514891c67e617ec64bbd770668ef79c89,6,618,35,583,4,0,4,2,8,30,2,4,2.10581345,328,3,1,107,48,59,5128,1524,3604,60,23,37,1,99.82788296
bba925d48e6381b40c34f3364aa34020a984e284,0,0,0,0,0,0,0,0,0,0,0,0,0,0,28,3,0,0,0,0,0,0,0,0,0,2,100
bd3c1bc7b4869957a3e33320831da0f4938daafe,0,0,0,0,0,0,0,0,0,0,0,0,0,0,6,0,0,0,0,0,0,0,0,0,0,1,100
e71b452f68104922c3c49e18ce99b5d86d9f1084,0,0,0,0,0,0,0,0,0,0,0,0,0,0,216,12,0,0,0,0,0,0,0,0,0,1,100
567d2c9149dbb625ba65d2668178210eaf1932a2,1,29,107,78,0,0,0,1,3,254,1,1,0,398,217,13,23,27,4,1984,2579,595,18,20,2,1,100
6841f14d563e00e3f94c4dc979528c885d1f1dfe,1,107,29,78,0,0,0,1,4,0,1,1,0,320,218,14,27,23,4,2579,1984,595,20,18,2,1,100
f1fb6315f0d4cbc1c32b93d7951fb99ea376c73a,0,0,0,0,0,0,0,0,0,0,0,0,0,0,6,0,0,0,0,0,0,0,0,0,0,1,100
52a303218224610d4b7b34f745bacfadaea1420c,1,8,6,2,0,0,0,4,10,1346,1,1,0,463,78,1,78,77,1,2106,2095,11,36,36,0,1,100
3e1168ddb6b322d57d56ebc5c8d87b006df15aa6,1,1,1,0,0,0,0,5,5,845,1,1,0,136,125,1,21,21,0,755,751,4,5,5,0,1,100
4ef52b46b1e6dd7bc1991a05b8256984d30a6c58,0,0,0,0,0,0,0,0,0,0,0,0,0,0,79,2,0,0,0,0,0,0,0,0,0,1,100
a1c14e3507981968e366924667fa47079208dfda,1,33,20,13,0,0,0,7,23,404,1,1,0,411,161,0,60,58,2,2065,2009,56,11,11,0,1,100
12d9e21ac27edb5a23c7505ecb07b47c987bcbdd,0,0,0,0,0,0,0,0,0,0,0,0,0,0,0,0,0,0,0,0,0,0,0,0,0,1,100
252af49103e8a93517b402be31d7c2822204ff73,1,1,8,7,0,0,0,5,6,41,1,1,0,136,214,0,20,21,1,689,755,66,5,5,0,1,100
5da7000f82e8c052aef23bcbdb89dcfc108d6aa3,1,1,1,0,0,0,0,11,23,992,1,1,0,113,6,0,7,7,0,988,988,0,3,3,0,1,100
d02cdaee6069f5ae350115f46543f7c2da00e4f5,1,4,4,0,0,0,0,6,17,586,1,1,0,390,80,0,81,81,0,1936,1944,8,38,38,0,1,100
b35551124f765d3129eca6922102b29ae6c87586,0,0,0,0,0,0,0,0,0,0,0,0,0,0,7,0,0,0,0,0,0,0,0,0,0,1,100
7d39a737c6fc873891930e08b364a0e8944a41c9,0,0,0,0,0,0,0,0,0,0,0,0,0,0,219,0,0,0,0,0,0,0,0,0,0,1,100
8db0cec1b7449529a84d3026411a9116a05c6d8a,0,0,0,0,0,0,0,0,0,0,0,0,0,0,220,1,0,0,0,0,0,0,0,0,0,1,100
8ef10c06114fb46f8cea3b3e8f6b2f852a0fb842,0,0,0,0,0,0,0,0,0,0,0,0,0,0,14,0,0,0,0,0,0,0,0,0,0,0,100
13d1b185f5d59a0ca4d2cf7fe835f840a7001f02,2,17,5,12,0,0,0,17,61,313,1,1,0.902393283,3635,22,0,775,769,6,22757,22663,94,114,113,1,2,100
0d9d8aed2b9e3caddfb077b4a122e09982e1c0e0,1,30,23,7,0,0,0,2,8,341,1,1,0,1001,63,0,168,165,3,5721,5681,40,16,16,0,1,100
1a5eba44657e8b6b85322a26725ba7ad23a294ee,1,0,8,8,0,0,0,7,11,983,1,1,0,546,23,1,114,116,2,3152,3208,56,14,14,0,1,100
a0b11d6217312dcf43effbb91792c3ef370572f4,1,1,1,0,0,0,0,10,38,433,1,1,0,1457,162,0,272,272,0,10211,10201,10,92,92,0,1,100
533f8dae644a833dd2d0df2eb7ea4d2c7f9f92f6,1,1,1,0,0,0,0,10,39,0,1,1,0,1457,163,1,272,272,0,10201,10211,10,92,92,0,1,100
c57afe81289a458a8ba122c0e2f88b8ef88f0f43,1,1,1,0,0,0,0,11,40,0,1,1,0,1457,0,0,272,272,0,10211,10201,10,92,92,0,1,100
7968836177a4ba1ba872fbb16518bed03e805193,21,912,1372,460,0,2,2,17,141,695,4,9,2.432754396,12333,215,0,2382,2507,125,70302,72868,2566,393,406,13,1,99.12393162
ab4793bce7469bcc80e5a99b0f764f1fbf755efc,3,25,2,23,0,0,0,10,62,232,1,3,1.218336824,4202,7,0,616,612,4,28888,28681,207,134,133,1,1,100
e23977ce61ece178d37b97f95d5353fda53ab71b,0,0,0,0,0,0,0,0,0,0,0,0,0,0,8,0,0,0,0,0,0,0,0,0,0,1,100
af6b8c4f3d27b2a5adf37b509c036ab3ba63cb75,1,12,8,4,0,0,0,9,17,521,1,1,0,189,221,0,30,29,1,988,970,18,11,11,0,1,100
9da43c7e07ba5eaba31cfd7a4bf4727f9021395c,2,37,2,35,0,0,0,5,50,16,1,2,0.6789539,1429,216,1,263,254,9,8162,7994,168,66,65,1,1,100
d259ed9da390d09d9a4cb350911d2e2920c6416d,0,0,0,0,0,0,0,0,0,0,0,0,0,0,222,1,0,0,0,0,0,0,0,0,0,1,100
9ea96d9f4913bdf05a5656528de9b8424c9daa79,0,0,0,0,0,0,0,0,0,0,0,0,0,0,223,2,0,0,0,0,0,0,0,0,0,1,100
dab9ed6e0f5d922bbd389358f7eaee66f2aa0fcb,1,1,0,1,0,0,0,1,5,774,1,1,0,272,224,3,12,12,0,1704,1695,9,4,4,0,0,100
75b8a422cfe8ab8f9896720a98ac8bd739c065a1,21,278,289,11,0,0,0,13,70,741,10,18,2.361102473,13549,225,4,2520,2524,4,74623,75231,608,421,421,0,1,100
f5c15d40b57adc68bed84f3dc89af8038c6bff19,2,11,3,8,0,0,0,14,31,313,1,2,0.749595257,925,217,2,163,162,1,5807,5740,67,37,37,0,1,100
2de803d1241244a38d30cdb762df3b2608b045da,3,41,119,78,0,0,0,2,10,741,2,3,0.664933268,667,226,5,54,58,4,3350,3945,595,30,32,2,1,100
adea501cdade780bf78360c65904fa0ce8104acb,0,0,0,0,0,0,0,0,0,0,0,0,0,0,13,0,0,0,0,0,0,0,0,0,0,1,100
886a9c6e196b12bc8cc0ae49a6d8e9bd8c244152,0,0,0,0,0,0,0,0,0,0,0,0,0,0,14,1,0,0,0,0,0,0,0,0,0,1,100
ea30b1355a6184098e803f4cbd59f2e8ec93cb9e,0,0,0,0,0,0,0,0,0,0,0,0,0,0,15,2,0,0,0,0,0,0,0,0,0,1,100
1ab501c3bce92d4f6c9d4a5b9168dd34c0310289,21,740,626,114,2,2,4,2,25,189,2,6,3.513702624,3371,326,0,485,467,18,18906,18332,574,132,133,1,2,99.39965695
740c150b0d1bc716464c2bce1509a3b2c9f8cc07,0,0,0,0,0,0,0,0,0,0,0,0,0,0,24,0,0,0,0,0,0,0,0,0,0,1,100
ef214a010d9a99afb7522e413722f2b788df3664,0,0,0,0,0,0,0,0,0,0,0,0,0,0,25,1,0,0,0,0,0,0,0,0,0,1,100
0c339bdf4577de3ea066ab4ef5e4a18424b875ae,0,0,0,0,0,0,0,0,0,0,0,0,0,0,26,2,0,0,0,0,0,0,0,0,0,1,100
ded33518f3bfb153b10c770ffb82dc835c1fc18b,5,55,50,5,0,0,0,2,58,635,2,5,1.617622786,3413,218,1,516,518,2,22212,22143,69,156,156,0,1,100
3286f6a55eeb6e5c6d5ecc949373d77916d9a278,1,22,10,12,0,0,0,10,28,226,1,1,0,880,219,1,225,223,2,5799,5744,55,29,28,1,1,100
9b1ddbf3ffe2ecbbb0912e533c9c5a321dbd37e9,2,30,5,25,0,0,0,8,13,735,1,2,0.994693795,560,8,0,54,41,13,3570,3294,276,11,11,0,1,100
605691882e08771c96371715f52bc34380dd4d27,0,0,0,0,0,0,0,0,0,0,0,0,0,0,9,0,0,0,0,0,0,0,0,0,0,1,100
6239cb1a96b65f9d3cadbaeebab7e1aecd03343f,0,0,0,0,0,0,0,0,0,0,0,0,0,0,6,0,0,0,0,0,0,0,0,0,0,1,100
7514a9102b6649f0043220e0708a71d1ec6d0c77,0,0,0,0,0,0,0,0,0,0,0,0,0,0,227,0,0,0,0,0,0,0,0,0,0,1,100
04b4e167b14d768a160d4342ed12302f9449994f,0,0,0,0,0,0,0,0,0,0,0,0,0,0,1,0,0,0,0,0,0,0,0,0,0,1,100
625cd35a49c772a7df44ae65ba02b0129e98c9f9,2,22,11,11,0,0,0,8,17,609,2,2,0.684038436,612,27,3,172,169,3,4167,4068,99,20,20,0,1,100
44b3738480032c5304aa3f1c2d75e6808d31cc65,20,1103,18,1085,7,0,7,9,142,472,2,12,3.824293966,16745,15,0,2763,2604,159,108899,104245,4654,633,572,61,1,93.67606915
7954cbbcd90500ec90d425aa20ca7e2fba34d695,0,0,0,0,0,0,0,0,0,0,0,0,0,0,7,1,0,0,0,0,0,0,0,0,0,1,100
3de85629229529ee6dc0d47345708a29c1262dd6,0,0,0,0,0,0,0,0,0,0,0,0,0,0,64,0,0,0,0,0,0,0,0,0,0,1,100
fe9b6bbff97d0eeb2affebd6439e0bcf0df5724e,0,0,0,0,0,0,0,0,0,0,0,0,0,0,65,1,0,0,0,0,0,0,0,0,0,1,100
61d624c2d4cdc4fa4a8f2652f66f53f30e33eb28,2,24,12,12,0,0,0,3,11,583,2,2,0.964078765,964,8,2,166,161,5,4598,4453,145,32,32,0,1,100
fdce224fa1aa63eba2fec2dce52f3d5ac3532df6,9,77,92,15,0,0,0,15,143,405,3,6,2.696162376,13006,29,0,2521,2538,17,83954,84066,112,356,357,1,1,100
81a6d5e433d0f9a6080e7afb0cec541d2b0efdd2,4,67,11,56,0,0,0,2,29,579,1,2,1.298518571,1242,30,1,89,81,8,7804,7383,421,29,26,3,1,100
5439720fd909ec6c78bbc72e7ae743bdcebbd097,5,23,88,65,0,0,0,3,28,209,2,3,1.790434511,1752,220,1,165,175,10,9628,10109,481,41,44,3,1,100
36b1286e88e577a43f6b548dd8e8220b1c6ea890,4,67,11,56,0,0,0,2,29,579,1,2,1.298518571,1242,66,2,89,81,8,7804,7383,421,29,26,3,0,100
024a3e392ba23b6d3a13f64b8159d54d062e4478,3,29,3,26,0,0,0,15,45,254,1,2,0.776973436,3024,67,3,596,589,7,16223,16076,147,126,125,1,1,100
72ed7d398fa3cdb93f8868e553323c27801b2e83,0,0,0,0,0,0,0,0,0,0,0,0,0,0,10,1,0,0,0,0,0,0,0,0,0,1,100
0e1169a5bb3202caec32f23ae83ace2d879caa2c,4,42,9,33,0,0,0,4,64,351,1,4,1.864407565,7300,11,2,826,825,1,52688,52458,230,333,332,1,1,100
58d1fa472bb1d7f6d5c98188f5f5631295825e02,0,0,0,0,0,0,0,0,0,0,0,0,0,0,12,3,0,0,0,0,0,0,0,0,0,1,100
e4828e4eee1fb51b866cc7e8c0f6ddfe46151626,0,0,0,0,0,0,0,0,0,0,0,0,0,0,13,4,0,0,0,0,0,0,0,0,0,1,100
3ddd087a72ac3170ded270afb89bea8a131ad2ff,0,0,0,0,0,0,0,0,0,0,0,0,0,0,14,5,0,0,0,0,0,0,0,0,0,1,100
743e66f88af24501d6d3bb1a4495424946c7098c,0,0,0,0,0,0,0,0,0,0,0,0,0,0,0,0,0,0,0,0,0,0,0,0,0,1,100
3b5686c5acd94fcbef15efe77aa1496892cc3f85,0,0,0,0,0,0,0,0,0,0,0,0,0,0,9,3,0,0,0,0,0,0,0,0,0,1,100
2bd65a0785a66934d2f15e7750bfadd6bd5ceec2,0,0,0,0,0,0,0,0,0,0,0,0,0,0,67,0,0,0,0,0,0,0,0,0,0,1,100
4a99dab9ca2af75f67d8f6e68841060d469b77a3,0,0,0,0,0,0,0,0,0,0,0,0,0,0,164,0,0,0,0,0,0,0,0,0,0,1,100
83321916e246315cdb125f92b7600bff46422f2b,0,0,0,0,0,0,0,0,0,0,0,0,0,0,15,5,0,0,0,0,0,0,0,0,0,1,100
c10533226aa51f61a5916079aad6e4882002e436,0,0,0,0,0,0,0,0,0,0,0,0,0,0,16,6,0,0,0,0,0,0,0,0,0,1,100
bb5706b702be898d8c7b43a374856204b1275344,0,0,0,0,0,0,0,0,0,0,0,0,0,0,28,1,0,0,0,0,0,0,0,0,0,1,100
367a724cf12b6a028efb2ea46124d45f8ff08f6a,0,0,0,0,0,0,0,0,0,0,0,0,0,0,29,2,0,0,0,0,0,0,0,0,0,1,100
79d177be7bc6d511e8902d963802c9550608bebf,0,0,0,0,0,0,0,0,0,0,0,0,0,0,17,7,0,0,0,0,0,0,0,0,0,1,100
3d341a4c2429cae259b831b112c6d65eaa12a2e1,1,8,5,3,0,0,0,13,25,29,1,1,0,421,30,2,81,79,2,3259,3266,7,11,11,0,1,100
c79aad4362b6f806da47462ec84e35108ba8eb1f,3,3,29,26,0,0,0,15,46,24,1,2,0.776973436,3050,68,2,589,596,7,16076,16223,147,125,126,1,1,100
fe9b6bbff97d0eeb2affebd6439e0bcf0df5724e,0,0,0,0,0,0,0,0,0,0,0,0,0,0,65,1,0,0,0,0,0,0,0,0,0,1,100
2626e5ccf03860de96b25b428eb4e64a4447cb8c,23,757,911,154,2,3,5,2,26,100,3,6,3.81789752,3779,220,2,504,522,18,19295,20194,899,147,145,2,1,93.07903152
49b8a7a26653b028b7adaff3809a88f59fee3bf7,9,77,92,15,0,0,0,15,143,396,3,6,2.696162376,13006,29,0,2521,2538,17,83954,84066,112,356,357,1,1,100
9ed210470bbc447d1fbacd9b98421309394061b0,4,282,63,219,1,0,1,2,27,0,1,2,1.347469831,655,221,2,148,116,32,4640,3662,978,30,22,8,1,99.86899563
91a437a29cd58902dc49b422e0421e36c7a07039,2,24,12,12,0,0,0,3,11,582,2,2,0.964078765,964,8,2,166,161,5,4598,4453,145,32,32,0,1,100
61d624c2d4cdc4fa4a8f2652f66f53f30e33eb28,33,1011,1061,50,3,3,6,2,142,260,6,12,4.19180519,16835,8,2,3060,3057,3,104260,104227,33,502,511,9,1,93.10897436
dcba4bc40a795156fbac8b747e339dc34a23bec7,33,1059,1009,50,3,3,6,2,143,180,6,12,4.192435925,16785,126,0,3057,3060,3,104227,104260,33,511,502,9,2,93.10897436
d3fffd00dc2846e381cef4a43a31dbabf8f323bd,4,67,11,56,0,0,0,2,29,570,1,2,1.298518571,1242,30,1,89,81,8,7804,7383,421,29,26,3,1,100
fdce224fa1aa63eba2fec2dce52f3d5ac3532df6,28,930,1051,121,3,3,6,2,28,190,4,8,4.018501726,5142,29,0,603,625,22,27577,28077,500,171,184,13,1,93.10897436
6cc62086795a212516b69fd09a1c2ef7a6761e5d,45,1273,1006,267,3,3,6,2,125,408,8,19,4.448943982,12404,327,0,2034,1975,59,69780,68461,1319,497,479,18,1,93.10897436
9a3d4e306b5e536e294cb20fb67664e2e0b7a7f8,5,590,851,261,0,3,3,4,9,697,1,3,1.825144472,1056,0,0,126,199,73,4299,6069,1770,29,28,1,1,93.94689469
70379200545a8cd859f9f163da4a4327001f84c1,0,0,0,0,0,0,0,0,0,0,0,0,0,0,64,0,0,0,0,0,0,0,0,0,0,1,100
844315cdbc5e4589f5a4f873c33533d8f7bb014e,44,3292,742,2550,9,0,9,2,62,272,3,17,4.3127322,15213,222,3,3325,2818,507,97392,82104,15288,841,707,134,1,92.20661531
19d6ef464a39394869ddf49e49c8e39dce96a8a0,0,0,0,0,0,0,0,0,0,0,0,0,0,0,223,4,0,0,0,0,0,0,0,0,0,1,100
52f5249bbdc7f1bd8c8b3aa91d2040a9f63c47ee,27,1817,119,1698,13,0,13,3,64,259,2,12,4.37396456,12234,65,1,2374,2123,251,73954,67257,6697,576,409,167,1,99.27360775
81a6d5e433d0f9a6080e7afb0cec541d2b0efdd2,109,2290,6488,4198,5,24,29,3,124,250,8,36,5.697934942,41945,30,1,6755,7492,737,206438,227560,21122,1524,1842,318,1,90.25394647
f96a9276f1b3ed920735e550a5c1cfe5cf560fe7,109,6432,2333,4099,21,5,26,3,125,319,8,36,5.698341652,37837,224,5,7489,6755,734,227491,206438,21053,1841,1524,317,1,90.25394647
5439720fd909ec6c78bbc72e7ae743bdcebbd097,113,2301,6555,4254,5,24,29,3,124,244,9,38,5.731966968,43234,220,1,6834,7579,745,213761,235304,21543,1550,1871,321,1,90.25394647
0ae46b7467594bb01038dac0bc240743cfb4f5ef,113,6487,2323,4164,21,5,26,3,125,321,9,38,5.71952207,39070,127,1,7578,6834,744,235295,213761,21534,1870,1550,320,2,90.25394647
4d05b1560b5aab4f0df5d43c6a8f10ed98404da0,0,0,0,0,0,0,0,0,0,0,0,0,0,0,10,1,0,0,0,0,0,0,0,0,0,1,100
fa104ec32a00661ed82bc9675460c41e3647e62b,4,42,9,33,0,0,0,4,65,233,1,4,1.864407565,7272,11,2,828,827,1,52209,51979,230,335,334,1,1,100
4319dea618c97f5f2bc47e6e3152267d6b7c52eb,0,0,0,0,0,0,0,0,0,0,0,0,0,0,228,1,0,0,0,0,0,0,0,0,0,1,100
36b1286e88e577a43f6b548dd8e8220b1c6ea890,111,2299,6530,4231,5,24,29,3,124,244,8,38,5.718393704,45854,66,2,6924,7662,738,237156,258508,21352,1695,2014,319,0,90.25394647
a9fbbcafa75b48ccfac28544c624bdef7b6ae081,112,6491,2324,4167,21,5,26,3,125,314,8,39,5.719587257,42750,66,2,7924,7180,744,263826,242336,21490,2099,1780,319,1,90.25394647
024a3e392ba23b6d3a13f64b8159d54d062e4478,111,2299,6530,4231,5,24,29,3,124,238,8,38,5.718393704,45853,67,3,6924,7662,738,237174,258526,21352,1695,2014,319,1,90.25394647
1d4afbe57a86bf025b00b0e2c93793d355a9096d,111,6473,2321,4152,21,5,26,3,125,316,8,38,5.70660713,41712,225,5,7661,6924,737,258580,237174,21406,2013,1695,318,1,90.25394647
2109fe04db224ae91cd9aa98c66cef0af4116d63,0,0,0,0,0,0,0,0,0,0,0,0,0,0,12,3,0,0,0,0,0,0,0,0,0,1,100
06bf91715310915cc5e124ead572c4ee866b59d3,0,0,0,0,0,0,0,0,0,0,0,0,0,0,13,4,0,0,0,0,0,0,0,0,0,1,100
8f1625c26bc0dcd8970867c25b6be0b5afbbcb0f,0,0,0,0,0,0,0,0,0,0,0,0,0,0,14,5,0,0,0,0,0,0,0,0,0,1,100
72ed7d398fa3cdb93f8868e553323c27801b2e83,111,2299,6541,4242,5,24,29,3,124,238,8,38,5.719128146,45864,10,1,6924,7662,738,237174,258589,21415,1695,2014,319,1,90.25394647
0e1169a5bb3202caec32f23ae83ace2d879caa2c,4,42,9,33,0,0,0,4,64,351,1,4,1.864407565,7300,11,2,826,825,1,52688,52458,230,333,332,1,1,100
58d1fa472bb1d7f6d5c98188f5f5631295825e02,0,0,0,0,0,0,0,0,0,0,0,0,0,0,12,3,0,0,0,0,0,0,0,0,0,1,100
e4828e4eee1fb51b866cc7e8c0f6ddfe46151626,0,0,0,0,0,0,0,0,0,0,0,0,0,0,13,4,0,0,0,0,0,0,0,0,0,1,100
3ddd087a72ac3170ded270afb89bea8a131ad2ff,0,0,0,0,0,0,0,0,0,0,0,0,0,0,14,5,0,0,0,0,0,0,0,0,0,1,100
e1346179aae59ffc3b3319cfa643f39e9aef863b,109,6431,2312,4119,21,5,26,3,125,314,8,36,5.686031238,37837,0,0,7489,6753,736,227653,206477,21176,1841,1524,317,1,90.25394647
743e66f88af24501d6d3bb1a4495424946c7098c,109,2290,6499,4209,5,24,29,3,124,246,8,36,5.698688797,41956,0,0,6753,7490,737,206477,227662,21185,1524,1842,318,1,90.25394647
3b5686c5acd94fcbef15efe77aa1496892cc3f85,0,0,0,0,0,0,0,0,0,0,0,0,0,0,9,3,0,0,0,0,0,0,0,0,0,1,100
809a78b4a9549ac1d28ae600fc23e769c50ede20,109,6431,2312,4119,21,5,26,3,125,314,8,36,5.686031238,37837,9,3,7489,6753,736,227653,206477,21176,1841,1524,317,1,90.25394647
14a0b8ebbe9baf8ad9ea4855187de0ee1e49e708,0,0,0,0,0,0,0,0,0,0,0,0,0,0,67,0,0,0,0,0,0,0,0,0,0,1,100
2bd65a0785a66934d2f15e7750bfadd6bd5ceec2,109,2290,6499,4209,5,24,29,3,124,246,8,36,5.698688797,41956,67,0,6753,7490,737,206477,227662,21185,1524,1842,318,1,90.25394647
c85ef54762b94b77fe7ef7b71a97a7acea7e8b26,109,6431,2312,4119,21,5,26,3,125,314,8,36,5.686031238,37837,15,5,7489,6753,736,227653,206477,21176,1841,1524,317,1,90.25394647
aca4c3b5438e0e52b1e2d24a7e322278d36c7ffc,1,11,10,1,0,0,0,1,2,10,1,1,0,480,226,6,126,126,0,3736,3731,5,11,11,0,1,100
69f4d32da7c1dc2754147cb673aae0eb044e7779,5,96,23,73,0,0,0,15,126,34,2,3,1.748759827,5367,227,7,1050,1036,14,32867,32461,406,143,140,3,1,100
12cfce0010501844baa8bb63c5b6f3138f38d582,0,0,0,0,0,0,0,0,0,0,0,0,0,0,164,0,0,0,0,0,0,0,0,0,0,1,100
4a99dab9ca2af75f67d8f6e68841060d469b77a3,110,2313,6596,4283,5,24,29,3,124,246,8,36,5.719420927,42110,164,0,6753,7504,751,206831,228427,21596,1524,1845,321,1,90.25394647
8888b6285fba7373df8b00a0dd5b0ac0c4b17aea,110,6528,2335,4193,21,5,26,3,126,312,8,36,5.70711442,37917,16,6,7503,6753,750,228418,206831,21587,1844,1524,320,1,90.25394647
83321916e246315cdb125f92b7600bff46422f2b,110,2313,6596,4283,5,24,29,3,124,246,8,36,5.719420927,42110,15,5,6753,7504,751,206831,228427,21596,1524,1845,321,1,90.25394647
c10533226aa51f61a5916079aad6e4882002e436,0,0,0,0,0,0,0,0,0,0,0,0,0,0,16,6,0,0,0,0,0,0,0,0,0,1,100
bb5706b702be898d8c7b43a374856204b1275344,0,0,0,0,0,0,0,0,0,0,0,0,0,0,28,1,0,0,0,0,0,0,0,0,0,1,100
367a724cf12b6a028efb2ea46124d45f8ff08f6a,0,0,0,0,0,0,0,0,0,0,0,0,0,0,29,2,0,0,0,0,0,0,0,0,0,1,100
2b1143abac2a665bbefbbfcd17b57390094a7a2b,118,7431,2336,5095,27,5,32,3,126,289,10,40,5.86311411,38361,128,2,7690,6814,876,235081,209104,25977,1918,1551,367,1,90.9693089
79d177be7bc6d511e8902d963802c9550608bebf,118,2314,7499,5185,5,30,35,3,124,236,10,40,5.874210853,43456,17,7,6814,7691,877,209104,235090,25986,1551,1919,368,1,90.9693089
3d341a4c2429cae259b831b112c6d65eaa12a2e1,1,8,5,3,0,0,0,13,25,29,1,1,0,421,30,2,81,79,2,3259,3266,7,11,11,0,1,100
a7d51d496d860715577d1a77117313748c611397,120,7586,2345,5241,27,5,32,3,126,285,10,40,5.891526203,39226,9,0,7884,6970,914,240426,213554,26872,1980,1605,375,1,90.9693089
94d0566d21a64b795c9a4844354960605bc1f9d9,1,19,3,16,0,0,0,11,26,46,1,1,0,728,228,7,204,200,4,4787,4650,137,24,23,1,1,100
c79aad4362b6f806da47462ec84e35108ba8eb1f,122,2329,7702,5373,5,30,35,3,124,242,10,41,5.924026988,46275,68,2,7426,8352,926,223366,250531,27165,1713,2091,378,1,90.9693089
ad426c24c04e36ff6b7fc286501b4b737b317ad3,121,7631,2345,5286,27,5,32,3,126,282,10,41,5.90816345,40568,28,0,8272,7345,927,247256,220107,27149,2079,1702,377,1,90.9693089
2aaa012dcf74dfd3952aabcc5c58681ab5d77054,3,3,29,26,0,0,0,15,46,24,1,2,0.776973436,3120,67,3,593,600,7,16546,16693,147,125,126,1,1,100
0b47455a2efab020825cbcc09f2474e4be59fe62,1,517,262,255,0,0,0,18,144,44,1,1,0,4080,10,1,825,786,39,29804,28200,1604,90,89,1,1,100
b068bfe56a63d70f47982f6aa60ebc5c42317b73,18,373,87,286,0,0,0,9,145,560,1,7,3.393549695,20273,11,2,3662,3576,86,129583,127283,2300,623,615,8,1,100
df0e650881b48530f9495fdaca28feb6bc54a719,1,2,1,1,0,0,0,18,67,0,1,1,0,2291,12,3,520,520,0,15168,15168,0,77,77,0,1,100
5aa5657d49990b1a620d880e2c64c5125b2f1b4e,0,0,0,0,0,0,0,0,0,0,0,0,0,0,1,1,0,0,0,0,0,0,0,0,0,1,100
cc21ffa63fcb6953f7bf5c59090af98c73517ab3,0,0,0,0,0,0,0,0,0,0,0,0,0,0,229,1,0,0,0,0,0,0,0,0,0,1,100
57222febb111066c0867618b89e36c0d44c653c5,0,0,0,0,0,0,0,0,0,0,0,0,0,0,17,7,0,0,0,0,0,0,0,0,0,1,100
a1929a82446f5aa8ba662649e9ff3af9e61bec4b,4,64,6,58,0,0,0,16,128,300,4,4,1.885103227,6935,229,7,1503,1482,21,42407,41980,427,237,234,3,1,100
54fab186a40a04ba88527a811e378125fbedd98d,3,88,8,80,0,0,0,3,7,54,1,2,1.335137438,388,230,8,43,36,7,2438,1940,498,25,21,4,1,100
a1a989d1751204ff216479f96f730ccc1648d679,2,87,19,68,0,0,0,2,5,56,1,2,0.77170947,388,231,9,51,43,8,3095,2551,544,23,18,5,1,100
f95d9ab6ffbef5fc27ec69d97d30a3ddbda119c9,5,143,79,64,1,0,1,4,44,536,1,2,1.868527435,3000,232,10,420,402,18,19669,18862,807,153,146,7,1,99.95913363
4a96827235d6c910a13ffc2587785c9c997ea58c,0,0,0,0,0,0,0,0,0,0,0,0,0,0,68,1,0,0,0,0,0,0,0,0,0,1,100
c994a111fef904775a51490f20a1cb2b1131b2d9,1,165,0,165,1,0,1,1,1,0,1,1,0,0,29,1,21,0,21,917,0,917,6,0,6,1,96.53299916
5c39c2127894f6921500c97f035ef6d83fbea173,0,0,0,0,0,0,0,0,0,0,0,0,0,0,69,2,0,0,0,0,0,0,0,0,0,1,100
ab2a7df91736451fe0c1d0e43287b740394f169c,0,0,0,0,0,0,0,0,0,0,0,0,0,0,18,6,0,0,0,0,0,0,0,0,0,1,100
83e19b8d38364282826c824f0f683350479e3189,6,11,11,0,0,0,0,13,27,35,2,5,2.424390713,2056,233,8,423,424,1,13689,13680,9,103,103,0,1,100
4970af966b1b29db729002f4e8130595be4c28db,0,0,0,0,0,0,0,0,0,0,0,0,0,0,70,2,0,0,0,0,0,0,0,0,0,1,100
97b927f9371a0eaa1beb21f252c52904798c6f80,3,10,5,5,0,0,0,2,16,1397,1,3,1.521928095,376,30,2,31,30,1,1510,1467,43,10,9,1,1,100
d2073e774f458079d9e92a610fec2ae22d63cf12,0,0,0,0,0,0,0,0,0,0,0,0,0,0,19,3,0,0,0,0,0,0,0,0,0,1,100
2925c07bf59c12be43f4a37b521f5f1b79e1125f,1,11,11,0,0,0,0,7,18,543,1,1,0,852,165,0,179,179,0,5081,5081,0,22,22,0,1,100
44e4269b194a2714e8f01802e1c7d6a6c9d0ae0e,0,0,0,0,0,0,0,0,0,0,0,0,0,0,129,1,0,0,0,0,0,0,0,0,0,1,100
98e6b663156a67ce9ccba4b01a76d24a559eb885,1,1,1,0,0,0,0,10,29,92,1,1,0,892,234,6,226,225,1,5805,5799,6,29,29,0,1,100
5f6e6ce72e16343c47b5294b93e15b81f4ebf475,1,16,3,13,0,0,0,11,27,27,1,1,0,744,235,7,208,204,4,4899,4787,112,25,24,1,1,100
ab0b91fd666feb034a7a3c06d419d915f8c6721d,2,20,21,1,0,0,0,16,129,19,1,2,0.659375881,3842,31,0,744,744,0,24804,24779,25,85,84,1,1,100
ec754db0fe7ac788a9c9a439c5aa2ae66f32e021,1,30,7,23,0,0,0,16,130,2,1,1,0,3419,13,3,669,665,4,21719,21529,190,74,74,0,1,100
59956846bc915a1b051fecc062440af22f6b7d79,1,1,1,0,0,0,0,7,9,66,1,1,0,423,31,3,57,57,0,1017,1017,0,24,24,0,1,100
b2295a5e2e8b4848c60e6ed9929147748f5d44cb,0,0,0,0,0,0,0,0,0,0,0,0,0,0,32,1,0,0,0,0,0,0,0,0,0,1,100
358540dcfbaa78da2cae1c41e81fde983e91e510,1,18,13,5,0,0,0,5,61,57,1,1,0,886,236,8,194,191,3,5418,5355,63,34,34,0,1,100
e6c7afaa851cbcd5abe2f4881a6f9eaea6d2d64f,1,1,1,0,0,0,0,5,11,68,1,1,0,227,32,4,44,44,0,988,988,0,17,17,0,1,100
6da244d6f7f6f43e98e702d83fc3c768b1713f0e,1,17,28,11,0,0,0,11,29,39,1,1,0,1652,33,2,362,372,10,7606,7695,89,62,62,0,1,100
2b5a72ea7ce9ea33dd12a223edc2ce0287f37973,2,629,0,629,2,0,2,1,1,0,1,1,0.600411222,0,130,1,57,0,57,2707,0,2707,44,0,44,2,99.9146029
e80464244db6f5a1acf393862752cb951155524d,0,0,0,0,0,0,0,0,0,0,0,0,0,0,131,2,0,0,0,0,0,0,0,0,0,1,100
b6d45a261810b3ddbf3bca5bb68110a86dd5060c,0,0,0,0,0,0,0,0,0,0,0,0,0,0,132,3,0,0,0,0,0,0,0,0,0,1,100
ceaed3f3dd590078a59ca9007fec3930542b6152,0,0,0,0,0,0,0,0,0,0,0,0,0,0,133,4,0,0,0,0,0,0,0,0,0,1,100
7f61b14810c3d8eb84d0e7ab0695672837130235,20,554,159,395,0,0,0,3,47,206,2,9,3.841535216,7639,68,0,1398,1323,75,41248,39144,2104,422,373,49,1,100
732244640a88b66bc62c0a57d840997d8a70768e,1,5,13,8,0,0,0,6,8,0,1,1,0,124,69,1,12,12,0,463,479,16,3,3,0,1,100
cf69754ad3018bcea1846b1bfb0a05d05b3d557a,21,173,559,386,0,0,0,3,46,163,3,10,3.899778559,8118,134,5,1331,1406,75,39551,41624,2073,379,428,49,1,100
cafe7aee09c1f4a51cdfd107d6701d8853928bae,20,557,170,387,0,0,0,3,47,148,2,9,3.878281683,7639,70,2,1398,1323,75,41232,39144,2088,422,373,49,0,100
d24b04c0da419b481a8a6b62071a8b8854259e2d,1,19,0,19,0,0,0,9,28,1005,1,1,0,642,71,3,118,115,3,3996,3863,133,19,19,0,1,100
57e01bab63a5d4972886954399e8e4fc240d4431,3,156,30,126,1,0,1,9,68,47,1,3,1.022647421,2953,14,1,651,638,13,19737,19164,573,101,96,5,1,97.24732087
27d6453a935e0f1aa36184fc34e05ca7c4045fa7,2,50,32,18,0,0,0,2,8,736,1,2,0.872161788,626,15,2,91,87,4,4068,3922,146,24,20,4,1,100
11a4f40a2a579308e874dca7625e66aa0cf8ed12,1,1,2,1,0,0,0,16,131,24,1,1,0,3442,16,3,669,669,0,21707,21719,12,74,74,0,1,100
5259c1e9da4591a611e67f6cfdae1f5c350c184a,1,19,0,19,0,0,0,9,28,1005,1,1,0,642,72,4,118,115,3,3996,3863,133,19,19,0,0,100
20db6e67bdaf65e1f6012ac798fe6c9d3b1cd110,1,184,55,129,0,0,0,7,12,1267,1,1,0,257,16,0,67,42,25,2433,1531,902,23,19,4,1,100
091ad6f95c98357b4843bfb94e71b58ba5463aff,2,157,4,153,0,0,0,5,10,795,2,2,0.229618382,423,10,0,103,64,39,3594,2277,1317,26,22,4,1,100
122172a0baa4c899a145e119038243da1370788d,1,245,0,245,0,0,0,9,39,114,1,1,0,1425,17,1,49,43,6,12616,10526,2090,49,43,6,1,100
e65a3e81265f46c76611b0c3e7265af932629bb1,7,68,44,24,0,0,0,8,14,450,2,2,2.634778982,1142,11,1,127,128,1,5499,5237,262,38,39,1,1,100
fe854a061e0948f27437fb5d9e6f24f0cac0f372,1,1,1,0,0,0,0,5,62,31,1,1,0,891,237,1,193,194,1,5410,5418,8,34,34,0,1,100
c8f67ce7c9314867b6481ee10e82ed19b15f37e8,1,26,0,26,0,0,0,4,5,1268,1,1,0,138,17,4,22,19,3,853,703,150,6,5,1,1,100
3b510f8c07271e2e51b5a9151a0d26f7084e3792,19,1571,40,1531,4,0,4,5,64,392,1,6,3.00969957,5184,238,2,1251,913,338,35904,27312,8592,349,257,92,1,97.3871734
6cb7e82f4926c407028cd9374001e7059a4c5a43,2,54,26,28,0,0,0,1,7,703,1,1,0.69621226,228,239,3,44,36,8,1184,1008,176,13,11,2,1,99.94312796
50e88f2ee6b0100ddd76d35cb25dfbd73f2767b8,1,1,1,0,0,0,0,15,48,21,1,1,0,1037,33,2,256,256,0,5180,5180,0,85,85,0,1,100
ad0273f135bafa2b429fdb7b878fd227815a0a5e,3,4,2,2,0,0,0,10,30,387,3,3,1.584962501,1548,240,4,361,359,2,9307,9264,43,69,69,0,1,100
343668b42afe7265c08064c7fb0bf40f7184ea1e,2,11,5,6,0,0,0,8,20,815,1,1,0.954434003,1176,0,0,171,167,4,6270,6209,61,28,28,0,1,100
c394fa42c770deb4981e226b8037174f5a9d260a,2,30,8,22,0,0,0,8,18,134,2,2,0.967788463,623,34,1,185,172,13,4396,4167,229,20,20,0,1,100
8ea482af6fc34cad60817bb1f5ffcf383850784c,0,0,0,0,0,0,0,0,0,0,0,0,0,0,20,0,0,0,0,0,0,0,0,0,0,1,100
662878d2dcd1ff67642eeeceb108f38ff23036ee,8,58,68,10,0,0,0,3,65,47,1,3,2.232457043,4127,241,4,873,874,1,23317,23381,64,142,142,0,1,100
58aa1bc298e38df0e10c8e0a79cc63a5fb2a5b33,1,42,27,15,0,0,0,6,10,125,1,1,0,357,2,0,58,53,5,2053,1952,101,13,13,0,1,100
35a33288d566cc8b5ffd6218dd0e7ed13598cc70,0,0,0,0,0,0,0,0,0,0,0,0,0,0,135,1,0,0,0,0,0,0,0,0,0,1,100
b9007bfa646812481199290168557fa96e089a88,0,0,0,0,0,0,0,0,0,0,0,0,0,0,136,1,0,0,0,0,0,0,0,0,0,1,100
499650ce026f8195c2fd6bb3e8743bcf99ae73a1,0,0,0,0,0,0,0,0,0,0,0,0,0,0,21,1,0,0,0,0,0,0,0,0,0,1,100
bc2cd5e00290866eb48f5115edb0e33971e8fca3,6,1474,1144,330,2,0,2,1,19,529,1,1,2.093507122,1634,0,0,325,246,79,11236,9533,1703,90,85,5,1,99.88638515
6101a41063e45e5aa2c77fff34fc699e36c2b3ba,6,15,27,12,0,0,0,13,49,564,2,5,2.320423375,4541,73,0,901,906,5,23651,23708,57,237,239,2,1,100
24579e08490b5caf764608c258c3d1befe513017,8,78,45,33,0,0,0,13,65,108,4,7,2.117089403,7163,242,5,1455,1447,8,41079,40946,133,375,373,2,1,100
cd00c1020af18691c27a156e5180e09b45b6c831,8,44,77,33,0,0,0,13,64,423,4,7,2.138143603,7196,74,1,1447,1455,8,40946,41079,133,373,375,2,1,100
bd40d5028f82eabc01615414f29262af22e89074,8,78,45,33,0,0,0,13,65,108,4,7,2.117089403,7163,22,2,1455,1447,8,41079,40946,133,375,373,2,1,100
d0e5f24b2e412b33442aecce818dea19fdd6761a,0,0,0,0,0,0,0,0,0,0,0,0,0,0,50,0,0,0,0,0,0,0,0,0,0,1,100
a4ad1a0b6599cee1831062d73f8515bcd7e0f721,2,540,147,393,0,0,0,14,49,37,1,2,0.118419205,2437,12,2,636,512,124,15724,12940,2784,133,125,8,1,100
f957fde26c386a6573c8ea1898e90c4a630a03b0,6,15,27,12,0,0,0,14,51,553,2,5,2.320423375,4934,75,2,1025,1030,5,26435,26492,57,245,247,2,0,100
e6f96c09225a2e52353f5a338a9f020cbbdc865f,3,2,6,4,0,0,0,9,46,108,1,2,1.5,3276,18,1,397,397,0,21836,21875,39,86,86,0,1,100
f3f8ee523b5a7f75ae11f3d3da1c9dc6948a5084,0,0,0,0,0,0,0,0,0,0,0,0,0,0,51,1,0,0,0,0,0,0,0,0,0,1,100
00ab2a51ae62fbc0b63c6767835ac6121fd29b79,0,0,0,0,0,0,0,0,0,0,0,0,0,0,76,3,0,0,0,0,0,0,0,0,0,1,100
bf9876c3a4b837cbda02bfdd83a3ef97fca77315,0,0,0,0,0,0,0,0,0,0,0,0,0,0,71,0,0,0,0,0,0,0,0,0,0,1,100
e6ab27ef6cbdea1ea37d52a99ec69eaaf9aa310e,4,30,1,29,0,0,0,1,66,41,1,2,1.669595024,1764,243,2,346,341,5,9544,9416,128,109,105,4,1,100
d8295fe6cf8da0641b3ba851f952290a6686d96e,0,0,0,0,0,0,0,0,0,0,0,0,0,0,77,4,0,0,0,0,0,0,0,0,0,1,100
a6c9065c65e125771cf3b2ffb58599687b7dd387,3,8,3,5,0,0,0,2,66,31,1,1,1.309296668,1274,244,3,280,276,4,7535,7441,94,50,50,0,1,100
d9ace0393d1226c13848f8d17a40bac13a7d6390,9,131,48,83,1,0,1,5,60,655,4,8,2.525388323,3521,245,4,470,460,10,18618,18251,367,134,132,2,1,99.6566851
fbaa4537c6fb75b500c4917c76358cbd0cdf3877,1,19,18,1,0,0,0,2,6,116,1,1,0,127,246,5,14,13,1,624,605,19,4,4,0,1,100
2b9f76e818e404ae824b40479f6c3cb84d870a92,0,0,0,0,0,0,0,0,0,0,0,0,0,0,19,1,0,0,0,0,0,0,0,0,0,1,100
6c6ec75db0c3871ff76fc072e64fbc778d58625c,0,0,0,0,0,0,0,0,0,0,0,0,0,0,23,2,0,0,0,0,0,0,0,0,0,1,100
f076f521655c62b8859de12f57dede1b1fa4aa0a,1,92,1,91,0,0,0,6,10,176,1,1,0,438,3,0,86,73,13,2850,2347,503,17,16,1,1,100
9c7ef90e65bf27e04ae0950e9d78c767d211991f,0,0,0,0,0,0,0,0,0,0,0,0,0,0,247,5,0,0,0,0,0,0,0,0,0,1,100
3edac55fc718baf54edd0148200f461addc60e6e,2,4,4,0,0,0,0,1,4,124,1,2,1,1070,248,6,232,232,0,7394,7382,12,35,35,0,1,100
b66953fd165d0f650141b9d8a68588c5e1689b45,2,55,0,55,0,0,0,5,13,1619,2,1,0.999761525,4282,230,0,700,692,8,20245,20049,196,305,297,8,1,100
38141722ee791f8ae0006247af148ed0bfa7db0c,1,1,1,0,0,0,0,2,13,89,1,1,0,1090,78,3,175,175,0,6233,6233,0,16,16,0,1,100
b087c4ccb804cb84ffc622a07d8ea25e900eb35a,3,19,9,10,0,0,0,14,52,289,1,3,1.094914318,2895,79,4,646,644,2,15979,15924,55,144,143,1,1,100
666f6f6bbc21e66a0d4030031917ae79f29f26b1,0,0,0,0,0,0,0,0,0,0,0,0,0,0,52,1,0,0,0,0,0,0,0,0,0,1,100
f21e2b4cfa61b9e2d4f28e35e0a965b99090bf6e,1,1,3,2,0,0,0,9,17,129,1,1,0,140,13,0,15,15,0,638,651,13,2,2,0,1,100
eed027abd9ee65c21867e1a2b9676f491d0d1800,3,351,1,350,0,0,0,4,30,580,1,3,0.732945248,3152,18,0,482,471,11,22377,20068,2309,166,155,11,1,100
cccb5e1b949e843f6ff756f2019938d65125ea08,2,5,2,3,0,0,0,9,37,197,1,2,0.985228136,1064,20,1,124,123,1,6460,6409,51,33,33,0,1,100
513788f50de261466d98a770204dd6072fa54a27,1,10,6,4,0,0,0,2,5,25,1,1,0,481,14,1,126,126,0,3826,3740,86,11,11,0,1,100
e1912c8dcf1866d552db8e9fcd858f43cb489541,1,5,4,1,0,0,0,2,3,197,1,1,0,293,328,0,44,44,0,1565,1552,13,15,15,0,1,100
5ab18c4ddd5bda99a7f1722728bed41b84de788c,3,3,138,135,0,0,0,4,31,266,1,3,1.506613124,3344,34,0,514,546,32,16436,17278,842,149,161,12,1,100
cfb2cdaded11c9843411936bf0802d8fd2d2e6e9,0,0,0,0,0,0,0,0,0,0,0,0,0,0,15,2,0,0,0,0,0,0,0,0,0,1,100
7a216a80afc9fda0a96cb2d07b839dbaf9355946,1,22,0,22,0,0,0,5,9,98,1,1,0,583,53,1,65,57,8,3200,3050,150,8,8,0,1,100
df4c01307b0542f8c80b6f3b31f34472ff76a307,2,4,7,3,0,0,0,5,7,12,1,2,0.439496987,1816,54,2,115,115,0,14414,14431,17,99,99,0,1,100
626f92a9226ea6938578b7d18c3ee7bd835c958e,7,725,5,720,2,0,2,10,146,122,1,6,1.898620928,12010,21,1,1671,1580,91,87485,82873,4612,273,249,24,1,99.90393852
ab6cb3935ad48948047028750fe8167c66111f87,1,47,47,0,0,0,0,6,11,45,1,1,0,529,4,0,87,86,1,2857,2850,7,17,17,0,1,100
081af481923207ee93a3d4a7cc29901b4c972a44,2,66,6,60,0,0,0,3,29,220,1,1,0.650022422,558,249,0,118,104,14,3350,2986,364,16,16,0,1,100
d1521dcdc33252c79dc89b7d065c2ebdcaa8a9f4,2,6,6,0,0,0,0,9,38,26,1,2,0.650022422,1067,16,3,124,124,0,6462,6460,2,33,33,0,1,100
751b33c3ecbf498f30e7c904f977822136f90fdb,0,0,0,0,0,0,0,0,0,0,0,0,0,0,24,0,0,0,0,0,0,0,0,0,0,1,100
0ff82bcad230ae9e58220c587218972213f593c6,0,0,0,0,0,0,0,0,0,0,0,0,0,0,22,2,0,0,0,0,0,0,0,0,0,1,100
6504a70eeeaefa6a7de18a0eb8f78f62dad76d9f,1,1,1,0,0,0,0,10,72,192,1,1,0,1743,166,0,508,508,0,9125,9125,0,38,38,0,1,100
84513334719958539fbddfbd12e3c95e4804a1fb,72,139,720,581,0,0,0,5,32,1745,1,6,3.338028212,12934,35,1,1631,1808,177,62103,64993,2890,575,617,42,1,97.7
95a8dce283647f91d625a732c36db3c8c7434719,0,0,0,0,0,0,0,0,0,0,0,0,0,0,0,0,0,0,0,0,0,0,0,0,0,1,100
5dced6f6695f51e52f66015252059f59ad643108,0,0,0,0,0,0,0,0,0,0,0,0,0,0,35,0,0,0,0,0,0,0,0,0,0,1,100
b041df1ddade3d3a78fe86513258d617a42e7f10,4,43,0,43,0,0,0,5,13,379,1,3,1.354822045,2016,250,1,293,289,4,13866,13472,394,71,70,1,1,100
009cef8ab75f724eaf0282529e4e1975d65234e6,0,0,0,0,0,0,0,0,0,0,0,0,0,0,25,1,0,0,0,0,0,0,0,0,0,1,100
b619bd596f52570150d766216571956f47100dbb,0,0,0,0,0,0,0,0,0,0,0,0,0,0,80,0,0,0,0,0,0,0,0,0,0,1,100
987abe8064529b08149a03ab22e2dbfbbe1cc0d8,0,0,0,0,0,0,0,0,0,0,0,0,0,0,23,1,0,0,0,0,0,0,0,0,0,1,100
32d73afd6bc5ac5d9b894f3d14f3eaf9b1b4f408,0,0,0,0,0,0,0,0,0,0,0,0,0,0,26,1,0,0,0,0,0,0,0,0,0,1,100
f49820a9b73d80326d7a8f5339c7f7f0bcc40d13,0,0,0,0,0,0,0,0,0,0,0,0,0,0,167,0,0,0,0,0,0,0,0,0,0,1,100
82ef3daa0af15e254509302bb4e6b4efbc67e71c,4,21,20,1,0,0,0,5,14,12,1,3,1.48188057,2059,251,1,298,293,5,13805,13866,61,71,71,0,1,100
6922c03f7085dfd37101536f6283d57fc063f581,0,0,0,0,0,0,0,0,0,0,0,0,0,0,93,0,0,0,0,0,0,0,0,0,0,1,100
ce725f500ffb826f8d121ddef2514f7052013577,3,270,0,270,1,0,1,1,30,190,2,3,0.664108911,652,168,1,106,60,46,5187,3650,1537,28,19,9,1,97.6618705
80c8198337060b89bbcde05331ca65f7e06a0105,2,36,32,4,0,0,0,6,12,587,2,2,0.989992792,347,17,0,53,51,2,1952,1922,30,12,12,0,1,100
06d0813563d118f69ba04a60396016007ac1d77e,1,6,2,4,0,0,0,7,15,197,1,1,0,521,81,1,73,73,0,2862,2826,36,12,12,0,1,100
f54723676d416001b6fb26f5ea281de0b392ec06,1,379,189,190,0,0,0,11,41,82,1,1,0,1681,18,1,59,49,10,14473,12531,1942,59,49,10,1,97.70275669
282c1d55d9c5aab4611c3a859169b594c9180b0f,1,4,4,0,0,0,0,8,12,1257,1,1,0,123,0,0,14,14,0,522,522,0,2,2,0,1,100
4e04da6556c53aeb62af5f480db221933075b4d2,7,2162,3,2159,2,0,2,1,43,1347,1,2,0.751840355,1964,19,0,426,374,52,26908,11782,15126,122,70,52,1,99.72894078
f1a71e0a9381bf53f4f020a92f0315548190bf7f,4,14,15,1,0,0,0,5,42,161,1,3,1.467549308,5994,19,2,333,333,0,44521,44578,57,281,281,0,1,100
6cf1471c240930d33a4d3334a2d011a9dfd22ea8,1,6,2,4,0,0,0,9,15,1400,1,1,0,325,20,3,39,39,0,1573,1514,59,7,7,0,1,100
49f2aa90e99bc7bf38a8411dab06fe9471955966,0,0,0,0,0,0,0,0,0,0,0,0,0,0,231,0,0,0,0,0,0,0,0,0,0,1,100
ee20663d43468fa7fcc00315dfcfa25fa272404a,1,29,5,24,0,0,0,18,147,110,1,1,0,4749,20,1,897,891,6,33215,33056,159,94,94,0,1,100
29fedc53fdc4a9df9f5857e754cf6fdcad488cef,10,895,0,895,10,0,10,1,1,0,1,2,3.219974633,0,24,0,43,0,43,3486,0,3486,43,0,43,1,96.24776653
63d84316028a28a8b6c8c3b65efd104c89bd9925,3,17,16,1,0,0,0,1,7,21,1,1,1.494918848,2183,21,2,55,54,1,15350,15328,22,52,52,0,1,100
2c64ee2c80380b1c5e6f53c92007c04ca6219268,0,0,0,0,0,0,0,0,0,0,0,0,0,0,169,0,0,0,0,0,0,0,0,0,0,1,100
da29d1929a54b2b579a74da32e5ea074d0f8e15d,0,0,0,0,0,0,0,0,0,0,0,0,0,0,22,3,0,0,0,0,0,0,0,0,0,1,100
3c18a99c2ca5b0a5302d0b646438be2990ee6c34,3,157,73,84,0,0,0,5,12,241,2,2,0.696878707,1090,329,0,189,169,20,6049,5577,472,43,39,4,1,100
4209b8d96abf6e827aa320653ba227a6c0c5abdb,0,0,0,0,0,0,0,0,0,0,0,0,0,0,330,1,0,0,0,0,0,0,0,0,0,1,100
f2be7cdd65539c05153202b823af8953032e0649,1,3,2,1,0,0,0,2,6,358,1,1,0,108,252,0,15,15,0,546,551,5,6,6,0,1,100
023d2312d5bab1c3d22a2291409a1a63ef12541d,0,0,0,0,0,0,0,0,0,0,0,0,0,0,72,0,0,0,0,0,0,0,0,0,0,1,100
7597d160f74780c4744b545a1c4782d656db1db8,1,285,0,285,1,0,1,1,1,0,1,1,0,0,21,0,5,0,5,2353,0,2353,5,0,5,1,99.35225757
1732536f1de4ac3f1699f660e089385487004261,0,0,0,0,0,0,0,0,0,0,0,0,0,0,73,1,0,0,0,0,0,0,0,0,0,1,100
fa58e9878c4e1bcfa48d6532dec9d47306c199cc,0,0,0,0,0,0,0,0,0,0,0,0,0,0,82,0,0,0,0,0,0,0,0,0,0,1,100
399cf813cafb09d1ae54cb7cfa61044167f8805c,6,58,33,25,0,0,0,13,174,204,1,4,1.435828981,13636,43,3,2382,2374,8,90802,90591,211,342,342,0,1,99.94711793
06b46597108132316ccfc9bf4af0805454e26aec,0,0,0,0,0,0,0,0,0,0,0,0,0,0,43,3,0,0,0,0,0,0,0,0,0,1,100
147c28c11896edfd8e52ce275b28ede6204ac695,0,0,0,0,0,0,0,0,0,0,0,0,0,0,49,3,0,0,0,0,0,0,0,0,0,1,100
9fec38f6b77648268c5473aada56c2c1a2c7d08a,1,1,1,0,0,0,0,7,18,5,1,1,0,665,50,4,108,108,0,3744,3744,0,22,22,0,1,100
1b93570cdadafb24065340b67fde32fc8ca0cbbf,1,1,1,0,0,0,0,7,17,230,1,1,0,665,49,3,108,108,0,3744,3744,0,22,22,0,1,100
54f4aac6b65d79e1b23f9ff017f076600be64fe1,1,1,1,0,0,0,0,7,18,6,1,1,0,665,50,4,108,108,0,3744,3744,0,22,22,0,1,100
630d4b7cd112094df1ac9fe55261c112094a9d97,0,0,0,0,0,0,0,0,0,0,0,0,0,0,37,1,0,0,0,0,0,0,0,0,0,1,100
716591dec8a80ac50d4fc0ff4a1c3337404e3ec7,0,0,0,0,0,0,0,0,0,0,0,0,0,0,38,2,0,0,0,0,0,0,0,0,0,1,100
77e70cbbc29c23657d41a231927d559cc349aead,0,0,0,0,0,0,0,0,0,0,0,0,0,0,37,1,0,0,0,0,0,0,0,0,0,1,100
2a97668824d6a05f97193f3bf21d1bbe50a48330,0,0,0,0,0,0,0,0,0,0,0,0,0,0,38,2,0,0,0,0,0,0,0,0,0,1,100
27948b8fcceab4d615600d5de41df285027caa4a,0,0,0,0,0,0,0,0,0,0,0,0,0,0,83,1,0,0,0,0,0,0,0,0,0,1,100
8323aaf62b76beb4dfcee1bbaaf1365cf9111b3e,4,97,11,86,0,0,0,14,34,1184,1,3,1.869571004,3253,97,1,700,674,26,19177,18749,428,113,107,6,1,100
0bfe8a0b4c521297a91c4421fbe35f30c52608bc,2,195,143,52,0,0,0,7,35,640,1,1,0.206995532,2339,98,2,468,454,14,13819,13481,338,60,60,0,1,100
e750c52985461649fda5371676d3fe4253d4ea3d,0,0,0,0,0,0,0,0,0,0,0,0,0,0,44,2,0,0,0,0,0,0,0,0,0,1,100
1893a36d64a78e3d18cf74e74bf6a88649d15515,16,242,175,67,1,0,1,3,175,363,2,11,3.055666689,16839,45,3,2781,2776,5,107874,107739,135,458,450,8,1,96.01842711
120ea59cd9db1dc835c06a9834b63862c8e03522,1,27,0,27,0,0,0,3,3,94,1,1,0,286,39,2,68,50,18,2151,1832,319,10,10,0,1,100
12208bd5392d0e93d2d49cf77237498aaaced779,4,110,12,98,0,0,0,19,169,91,3,4,1.41871105,7827,201,0,1716,1692,24,47061,46424,637,242,236,6,0,100
928b3253d7068a67cbe8451a560b1d55b2eae7b0,4,12,110,98,0,0,0,19,170,0,3,4,1.41871105,7925,202,1,1692,1716,24,46424,47061,637,236,242,6,0,100
35bc9c935441b0680fe464c1f3df361c3551a5ca,5,188,17,171,0,0,0,19,171,534,3,5,1.818038734,7920,203,2,1745,1704,41,48072,46893,1179,248,240,8,1,100
11b3f309176002aac571fbb459695f3106b8c04a,1,16,5,11,0,0,0,12,83,1,1,1,0,2550,204,3,694,711,17,14139,14365,226,58,60,2,1,100
527ab5a8da9cdb4158b454dbdc382246974dddae,1,48,12,36,0,0,0,7,13,225,1,1,0,611,99,2,105,95,10,2833,2613,220,20,20,0,1,100
e00e11eb7afb90bfa5d86c55d30efade2a8b99a3,2,8,0,8,0,0,0,6,21,1440,2,2,0.811278124,1251,5,0,124,123,1,6636,6592,44,28,28,0,1,100
17a97fab5c72cc7dff19c2cd688c21b15bd3a71b,2,6,9,3,0,0,0,19,176,22,1,2,0.721928095,9214,46,2,1858,1858,0,61182,61204,22,207,207,0,1,100
719dd4bf6a6b91ed00294f61a4854fac8e2acda8,1,77,1,76,0,0,0,2,9,12,1,1,0,166,205,4,35,29,6,1480,1011,469,12,6,6,1,100
c3cfb4da74b3a1edb11901f2e59a9fdbf5b7bcbc,1,6,0,6,0,0,0,12,84,12,1,1,0,2561,206,5,694,694,0,14161,14139,22,58,58,0,1,100
bb7dee1d51ec702065abff5ecd01a0a02a3dbb08,0,0,0,0,0,0,0,0,0,0,0,0,0,0,6,1,0,0,0,0,0,0,0,0,0,2,100
65020a7bf1cf3b38b9ed3e558c88c7c3574ebb79,7,81,56,25,1,0,1,14,177,24,2,5,1.985340579,12064,51,0,1926,1928,2,81664,81669,5,263,263,0,1,99.922899
f04b3e4e6629dd468765633d8e5f2dcb5008ef6a,2,76,19,57,0,0,0,4,36,1333,1,2,0.084262429,988,3,0,247,228,19,6614,6288,326,34,33,1,1,100
3246f85e8d08b53426e17a30527e24917aea2cec,0,0,0,0,0,0,0,0,0,0,0,0,0,0,7,2,0,0,0,0,0,0,0,0,0,1,100
d8a056e163011602e5722bb1a0293e0151047b1c,1,11,1,10,0,0,0,3,11,953,1,1,0,348,207,6,89,86,3,2106,2052,54,15,15,0,1,100
ba2d55068a0c4e19b29616c1265575da674a5170,1,44,114,70,0,0,0,14,36,56,1,1,0,1865,100,1,377,395,18,10476,10978,502,48,48,0,1,100
b2cebfd75f7c813651a37db76dc85a67e5e5536e,9,70,59,11,0,0,0,19,174,346,2,5,2.718961992,8697,309,0,1860,1852,8,53575,53436,139,280,279,1,1,100
59b33c505a4393bd014f5c24639dac578f921d68,1,6,2,4,0,0,0,12,85,26,1,1,0,2567,208,7,696,694,2,14199,14161,38,58,58,0,1,100
f57022645db36054d2c63f1af503b82363999b47,2,3,7,4,0,0,0,12,86,212,1,1,0.721928095,2850,209,4,753,754,1,15703,15733,30,70,70,0,1,100
f8e89b63f9fde52c54c181b27b353fe93da4751c,2,1,3,2,0,0,0,6,22,62,2,2,1,1259,8,0,124,124,0,6614,6636,22,28,28,0,1,100
96560fd86543ffd2fe97531eb862b3c66cf0736a,1,16,16,0,0,0,0,9,27,230,1,1,0,426,0,0,61,61,0,2064,2064,0,11,11,0,1,100
3c788da0080c680c4c0a4220c23970979908277e,1,41,4,37,0,0,0,6,12,994,1,1,0,446,52,0,91,83,8,3195,2943,252,22,21,1,1,100
27c36c1daedd28ef20872cb786afca177c0a6e23,9,211,145,66,0,0,0,12,87,280,2,5,1.959830171,8334,310,1,1939,1924,15,47235,46994,241,323,324,1,1,99.96921182
0e8831d5da5daba52c67cac24b314cc982d288c6,0,0,0,0,0,0,0,0,0,0,0,0,0,0,40,0,0,0,0,0,0,0,0,0,0,1,100
084c5993d469faade6d67d0e202e9a212fbcf2ff,1,11,2,9,0,0,0,7,17,236,1,1,0,490,9,0,81,81,0,2850,2740,110,16,16,0,1,100
35bf9fc966d9993607eb23a98a98610e8765bee4,3,80,8,72,1,0,1,9,28,731,2,2,0.985514869,496,210,2,79,71,8,2633,2250,383,18,15,3,1,99.75505205
11c9556c40964cc697e5995e966c9b482482ee48,1,2,3,1,0,0,0,1,2,2,1,1,0,68,211,3,7,8,1,315,326,11,3,3,0,1,100
c46de425783ce0ce2c4ce0a7d4dae58807c626ef,0,0,0,0,0,0,0,0,0,0,0,0,0,0,41,1,0,0,0,0,0,0,0,0,0,1,100
a94f6e0d1f39ea51743ea54849313d198237e70f,5,405,20,385,0,0,0,16,41,924,4,5,1.939415416,1505,47,0,323,243,80,10442,7971,2471,84,71,13,1,99.95426132
67e3ceaf5d7ab6bdd8d7a9550dd2bf9bef13cfc3,1,1,1,0,0,0,0,6,78,61,1,1,0,1260,311,1,295,294,1,7723,7716,7,46,46,0,1,100
988f31ce174ca1df3b5949cc8e952af5ff10a00f,0,0,0,0,0,0,0,0,0,0,0,0,0,0,42,2,0,0,0,0,0,0,0,0,0,1,100
06f329d5fc1e911bde012725f91a4bc46ff802d3,2,0,4,4,0,0,0,8,18,2036,2,2,0.811278124,652,53,1,99,99,0,3935,3959,24,20,20,0,1,100
d17fa2c7230260cc3d4ddbef3fc6ab8bddb4154a,1,14,11,3,0,0,0,1,2,152,1,1,0,191,101,0,24,22,2,1113,1069,44,3,3,0,1,100
8fe1ce872ab13c4543f6eb70cfe01bcdc36ff8f3,4,35,4,31,0,0,0,7,49,220,4,4,1.6336208,3400,0,0,688,683,5,21451,21260,191,188,184,4,1,100
2b988a83638d36528a4690705435023bc1f9fcef,4,37,24,13,0,0,0,5,36,279,2,4,1.371248547,2832,312,2,518,518,0,15306,15143,163,187,187,0,1,100
8ed1b3385abfdb1e725f10d131bee7d339bb8fd4,4,304,15,289,0,0,0,7,29,918,3,3,1.400049122,904,102,1,179,129,50,6015,4321,1694,51,37,14,1,99.75520196
0baf6a4c9bc0a35c0d635fa6001c1a0842b20423,1,20,13,7,0,0,0,16,37,88,1,1,0,851,4,0,244,240,4,5564,5504,60,27,27,0,0,100
5523d16cb1e4612a98af0d5a93842edbb011853a,1,1,2,1,0,0,0,9,19,324,1,1,0,415,48,1,57,57,0,2249,2259,10,24,24,0,1,100
f9926cd6d4113e00e508496665cc36d092168323,0,0,0,0,0,0,0,0,0,0,0,0,0,0,43,3,0,0,0,0,0,0,0,0,0,1,100
46670b24d6a30f9ac7bffd5b1d3c9f1a671b3538,0,0,0,0,0,0,0,0,0,0,0,0,0,0,49,2,0,0,0,0,0,0,0,0,0,1,100
c66a77ac18cfa9cd1f59c81ece4235aa84e9d248,0,0,0,0,0,0,0,0,0,0,0,0,0,0,1,0,0,0,0,0,0,0,0,0,0,1,100
f30fa46d4046a69451ffd6a2b77a0d9a333cdfad,4,43,13,30,0,0,0,3,88,244,2,4,1.346305788,4077,103,2,1015,1006,9,23585,23337,248,100,100,0,1,100
2a6dd3d078c52cc1314af581f7b8e6c8cdab933a,0,0,0,0,0,0,0,0,0,0,0,0,0,0,50,3,0,0,0,0,0,0,0,0,0,1,100
c5bf2f6364a97539451656d28fd36e35d8e2736d,5,141,63,78,0,0,0,20,178,182,2,4,1.236433715,11515,0,0,2326,2316,10,76966,76241,725,289,287,2,1,100
4624da1f47242715865a5197ecd1f0d5adb62617,4,463,213,250,0,0,0,6,41,533,3,3,1.90549289,2049,5,1,394,346,48,13843,12607,1236,79,70,9,0,99.93857494
c31d4e45281d18b2f18be315d58dc21ea02c7c47,36,2221,530,1691,4,0,4,2,179,873,3,17,4.011051757,26441,313,2,5271,4914,357,169207,159276,9931,1087,1014,73,1,99.80067464
b69227eb2f6b8aacb539a6454c714923257de059,27,1526,140,1386,4,0,4,4,180,237,3,12,3.97126575,19738,212,0,4062,3816,246,129665,121877,7788,736,674,62,1,99.86238532
02640d3cf520ee5a0dae13dd46b91ff266359e77,7,2182,801,1381,3,0,3,1,21,411,1,1,2.482488866,1531,0,0,425,233,192,15954,8793,7161,99,65,34,1,99.81696156
e5b7838f490d6d526974bf2c6cd24917d2209693,0,0,0,0,0,0,0,0,0,0,0,0,0,0,84,0,0,0,0,0,0,0,0,0,0,1,100
d484e2bad26cc024e36908691138f8c4ac133f47,9,327,328,1,0,0,0,3,35,77,2,6,1.83785734,3024,314,3,478,525,47,16369,16627,258,171,171,0,1,100
68fa17a19a1032c3b3f2bff0df2f4c922b243595,7,124,43,81,0,0,0,3,181,47,2,5,2.263307549,10274,213,1,2123,2100,23,66257,65738,519,270,266,4,1,100
9a62c142ac7dbd7d3412076c26787c2d2e9ec1c6,1,2,2,0,0,0,0,5,9,1701,1,1,0,116,27,0,25,23,2,555,543,12,4,4,0,1,100
52936a50cfde9959825cd57d62593873941dc9b4,1,2,2,0,0,0,0,6,79,46,1,1,0,1260,315,2,295,295,0,7723,7723,0,46,46,0,1,100
13341c7c22ca78eff2d1eb49bb5b56e8cb68f8d3,10,124,85,39,0,0,0,22,182,92,2,4,2.469495814,11657,316,3,2378,2368,10,72460,72167,293,433,431,2,1,100
334e22ed1e507ca6477129cc8cccd8789d8f75b2,1,3,0,3,0,0,0,20,178,28,1,1,0,4209,54,0,869,869,0,27060,27046,14,100,100,0,1,100
0011a441d0151c9eeec78ab1e5b9e3e3262129b8,1,2,1,1,0,0,0,15,50,53,1,1,0,1633,0,0,304,304,0,11100,11078,22,93,93,0,1,100
0d5fa49f90881fb27b464c25ec28535da036adcd,0,0,0,0,0,0,0,0,0,0,0,0,0,0,20,0,0,0,0,0,0,0,0,0,0,1,100
49d092acfd4c4aea86d9ddb64995e61c61828442,0,0,0,0,0,0,0,0,0,0,0,0,0,0,85,1,0,0,0,0,0,0,0,0,0,1,100
3145c50365e91a741b1dfaa994afdb964d36799b,0,0,0,0,0,0,0,0,0,0,0,0,0,0,5,0,0,0,0,0,0,0,0,0,0,1,100
41b459b0642cbce5fc63d1b0db04d4e06738cef9,0,0,0,0,0,0,0,0,0,0,0,0,0,0,6,1,0,0,0,0,0,0,0,0,0,1,100
d12f94f681c8406e16d5c0591019dae7ce2d3541,0,0,0,0,0,0,0,0,0,0,0,0,0,0,7,2,0,0,0,0,0,0,0,0,0,1,100
fb97a18b5f409dc7beb9c0ed5ec43c9daad89f41,2,2,2,0,0,0,0,5,91,18,1,2,1,2493,317,4,542,540,2,14446,14424,22,76,76,0,1,100
b58257d23a904f5b046b0777a0497ceb7ea093d4,4,64,3,61,0,0,0,5,17,1111,1,3,1.652055967,3349,104,0,170,163,7,18484,18138,346,44,43,1,1,100
72be01bb789e369158d73a841800b22f71a5c85a,1,6,9,3,0,0,0,9,25,25,1,1,0,686,318,4,82,82,0,3500,3516,16,51,51,0,1,100
3eef84032aa7b2a55fa0ae5383739b2336d5de6c,9,261,71,190,0,0,0,4,183,138,2,6,2.438103856,10712,214,2,2152,2118,34,71016,69864,1152,276,269,7,1,98.19277108
a0b7d9a57c79d48a0fbf21e37ae09c74d6fa11e6,4,478,573,95,1,0,1,1,37,80,2,3,1.780530284,3729,6,0,727,745,18,21064,21863,799,123,120,3,1,99.92171599
085f2c1fc2937695ed0ea9d35dce86b1f152c423,1,2,0,2,0,0,0,15,25,241,1,1,0,366,215,3,64,64,0,2350,2336,14,14,14,0,1,100
3f551593f14be940a8179e547b222e3a5134c252,1,1,0,1,0,0,0,2,4,23,1,1,0,161,216,4,22,22,0,851,844,7,8,8,0,1,100
4f4e50ff3c21002225f5abd24203e03bd10671c8,1,0,1,1,0,0,0,2,5,0,1,1,0,162,217,5,22,22,0,844,851,7,8,8,0,1,100
e3c642e415f1d805236422b0c0f888cb61ce3362,1,4,4,0,0,0,0,2,6,0,1,1,0,161,218,6,22,22,0,837,844,7,8,8,0,1,100
3f468bab324b78de86e1efa38bb823c685c2b077,3,271,0,271,3,0,3,1,1,0,2,3,1.490502441,0,28,1,21,0,21,1367,0,1367,9,0,9,1,99.89057371
965368da8d56af436af12d5901fb83647ad65725,1,8,1,7,0,0,0,1,2,51,1,1,0,352,219,6,64,65,1,1928,1888,40,8,8,0,1,100
50d8f2fa8ce564cea522c95b97a17421edb7fcd9,2,57,19,38,0,0,0,10,22,50,1,1,0.175565026,1758,0,0,275,270,5,10337,10045,292,71,71,0,1,100
74839e3ed04125b312c09543953b100fb103a8bb,8,86,60,26,0,0,0,3,57,756,1,6,2.576232149,4529,319,4,1001,995,6,26035,25754,281,209,209,0,1,100
722a660b214aa9301c18b7f123f2ad689cdccf94,7,329,0,329,1,0,1,3,20,241,2,6,1.448109181,2630,220,6,520,476,44,17291,15362,1929,104,92,12,1,99.0234971
f11d297ad74407e51707ba890b4f07db8ddb3be4,3,52,0,52,0,0,0,3,7,235,1,2,1.457265914,522,55,1,90,81,9,3024,2783,241,33,28,5,1,100
c267ee7ef05078eea77770f7a4701d3189d05ca1,1,19,1,18,0,0,0,4,8,0,1,1,0,356,56,2,62,58,4,2123,2031,92,22,21,1,1,100
28c1fe70c9ae30adc60968681dbb6f85e9981ee5,2,17,19,2,0,0,0,5,12,287,1,2,0.183122068,588,7,1,85,90,5,3553,3638,85,14,14,0,1,100
bbc5650d71e69c8d852d0bb804faddc8ce078da6,0,0,0,0,0,0,0,0,0,0,0,0,0,0,221,7,0,0,0,0,0,0,0,0,0,1,100
1f5619d156680fc1942a8822841d56168867664a,14,360,23,337,2,0,2,4,180,89,3,7,2.523636375,15858,320,5,2443,2405,38,109105,107435,1670,509,489,20,1,99.89563143
c600fcbfbde71cbf242b0f68910f5d6c2ae9cb9a,0,0,0,0,0,0,0,0,0,0,0,0,0,0,44,0,0,0,0,0,0,0,0,0,0,1,100
522d1ccd2a05921d7563b921e617c50fee30c40d,4,23,0,23,0,0,0,7,181,60,1,2,1.444747003,8263,321,5,1662,1658,4,50017,49894,123,225,224,1,1,100
79b0c121a607ba8653f7983ed52ddbe986533fd4,2,12,9,3,0,0,0,2,30,1234,1,1,0.702466551,659,322,3,120,120,0,3626,3590,36,25,25,0,1,100
c76f8eecf181f813774d8e7a6546f1666287eefe,5,24,1,23,0,0,0,12,184,135,2,4,2.092238192,7458,0,0,1464,1460,4,49104,48998,106,194,191,3,1,100
b348291eaeeefc3723bb5507d3770b463544c24a,8,65,42,23,0,0,0,2,7,880,1,2,2.515490983,1040,1,1,163,156,7,5809,5732,77,47,40,7,1,100
1a6b97e2c948347383ae2c279721e1c3ea7eaff5,1,76,35,41,0,0,0,2,2,740,1,1,0,152,1,0,27,17,10,969,742,227,5,4,1,0,100
f937360f06535afccac39da7e1212820f17cbda6,1,8,1,7,0,0,0,8,18,124,1,1,0,383,222,1,71,70,1,2125,2094,31,19,19,0,1,100
e5afd844a3020c6c9872481c6dd76a3489dd5c19,9,569,337,232,0,0,0,2,9,2471,1,2,1.279270254,1986,29,0,210,184,26,12819,10925,1894,110,103,7,1,100
d3ae6231664ea445192c84036ed77a635496f331,1,3,0,3,0,0,0,3,14,3035,1,1,0,67,223,1,8,7,1,286,263,23,2,2,0,1,100
5ccf414965bff9f79e51738d0bf4ba09880693eb,10,711,146,565,2,0,2,3,10,1491,2,3,2.710153023,1749,30,1,223,170,53,12854,9459,3395,102,79,23,1,99.83613884
7638d8b9af163484ff1718880356a23328c4904d,4,84,34,50,0,0,0,2,3,1912,2,2,1.213579815,389,8,0,41,23,18,2260,1894,366,10,10,0,1,100
72bccb365ef3b473444c10c1c6f802100ed5c242,30,534,28,506,0,0,0,14,185,1512,2,14,4.35626574,23340,0,0,3953,3883,70,139967,137665,2302,996,968,28,1,100
cd1e9b71a523e12e612e608a3dff15ecd773f652,77,798,766,32,3,2,5,2,186,531,19,44,5.235768025,41855,332,0,8221,8211,10,243481,244055,574,1607,1599,8,1,96.14342629
3105b94c03ac2176955dedb2d4ac78ebb4665cf6,13,40,54,14,0,0,0,21,184,94,7,11,2.050069344,9356,333,1,1744,1745,1,57401,57509,108,311,312,1,1,96.78626084
d37a6b5a0fd909fe4cbe650a7bdfae401247849c,2,38,11,27,0,0,0,7,49,709,1,2,0.642064289,1658,57,0,303,300,3,9361,9202,159,47,46,1,1,100
bc74cb2467229bb8b1cf89f593547eec00a6480d,3,30,18,12,0,0,0,6,17,680,1,3,1.158222676,1360,105,0,187,181,6,7767,7705,62,36,36,0,1,100
22168d1b0bdf51e1317447cafddeb0f60af10810,0,0,0,0,0,0,0,0,0,0,0,0,0,0,1,1,0,0,0,0,0,0,0,0,0,1,100
618ebd3a9ce93bf348ff48b7c9a687c274d9556c,3,86,73,13,0,0,0,21,187,5,1,2,0.585923894,11075,323,0,2266,2257,9,70545,70424,121,269,267,2,1,100
0a7f809880c38190596945e0c30ac713bf0deeb2,39,2393,2567,174,5,0,5,14,188,188,6,19,3.087041117,27602,324,1,5086,5170,84,169124,170370,1246,969,967,2,1,97.46793818
51349e296be6cf83da1f775138b51b175f1f47e7,0,0,0,0,0,0,0,0,0,0,0,0,0,0,45,0,0,0,0,0,0,0,0,0,0,1,100
23d2b935c87a7cb3bf30e562660f897d9afc2fc2,0,0,0,0,0,0,0,0,0,0,0,0,0,0,46,1,0,0,0,0,0,0,0,0,0,1,100
3fca183e7bd2212489513ced5fa550fe7259e140,15,489,409,80,0,0,0,14,187,0,2,9,2.990789882,11835,334,2,2078,2071,7,76158,76023,135,423,423,0,1,97.66927526
a6f6f1f8cbd5c7d8b12631c2c8bdf1acb6c32555,0,0,0,0,0,0,0,0,0,0,0,0,0,0,86,0,0,0,0,0,0,0,0,0,0,1,100
54fa50a3a4a170071ec7ca92ea0d25ad1e497c53,1,15,16,1,0,0,0,16,38,138,1,1,0,1657,2,0,358,357,1,9535,9508,27,43,43,0,1,100
afb1f208557dbe308d0e2c5fdbe833fcbffb6111,5,107,124,17,0,0,0,4,61,154,1,4,1.900175762,5303,325,2,1133,1142,9,31156,31275,119,208,209,1,1,100
0298b7ed15c2a864cdd97a81a3983cba0358b07b,8,272,264,8,0,0,0,1,95,3,1,4,2.163925799,6993,326,3,1394,1393,1,40748,40563,185,284,283,1,1,98.0675456
6cd9e7b9efe7a799ce4d5c3faa6d1d9491dcf1c1,32,640,641,1,0,0,0,2,96,22,4,15,3.889553155,12896,335,2,2268,2269,1,72514,72664,150,553,548,5,1,97.17455365
7ea6c1f0cf8d1034b05132154bd8198cd9b67039,0,0,0,0,0,0,0,0,0,0,0,0,0,0,47,2,0,0,0,0,0,0,0,0,0,1,100
25a8c43b92806042f3a9b6823be24006129bfcd3,1,2,2,0,0,0,0,2,3,4,1,1,0,262,327,4,39,40,1,1589,1593,4,7,7,0,1,100
50de18f19f14e793e454a598d4569bd598a2cb0f,1,1,1,0,0,0,0,1,3,13,1,1,0,274,336,2,53,53,0,1282,1282,0,16,16,0,1,100
2c29f0623c3571fdfad5ddd918e87d8a2c7cd3a2,4,15,13,2,0,0,0,21,188,33,1,3,1.877387064,4781,328,4,956,954,2,30205,30185,20,118,118,0,1,100
8ac5fdd407ecfe69dadad466a78eb283c847c7a1,3,36,7,29,0,0,0,12,91,53,2,2,1.448090918,4103,224,0,1055,1048,7,23527,23391,136,117,116,1,1,100
b581a4b478d6263eea6176fb5c7a51b875821681,1,9,5,4,0,0,0,11,78,21,1,1,0,738,337,3,141,140,1,3835,3819,16,48,48,0,1,100
fa0dff146399b97554d4e745e6e2dcbd7510d988,5,356,66,290,2,0,2,1,92,4,2,3,1.86822772,4818,329,5,1166,1131,35,29163,27543,1620,165,153,12,1,97.94905723
3cba16886cd78a35c61f02ebd1ed4bc8a3767d47,1,3,1,2,0,0,0,11,79,1,1,1,0,742,225,1,142,141,1,3843,3835,8,48,48,0,1,100
7c815e8ad71c3168b60195c7b18fdbaa0d4e4e92,1,2,2,0,0,0,0,1,2,0,1,1,0,168,330,6,19,19,0,987,986,1,6,6,0,1,100
f028a213463d5ebd5b150c78fc43931fa8e49c92,20,68,27,41,0,0,0,6,189,195,2,9,3.582852046,17987,338,3,3583,3575,8,108198,107963,235,615,611,4,1,98.60701409
1368600bc10ed31adbdf6e64530590ed1ad4c9f9,3,98,33,65,0,0,0,2,81,64,2,3,1.581398849,1166,331,6,246,222,24,6790,6350,440,59,58,1,1,99.96718083
f6685bd4af4dd9ef87c10c294709e3a1b37d4f50,5,17,17,0,0,0,0,2,97,324,1,4,1.780446315,3061,332,7,667,666,1,17489,17485,4,105,105,0,1,100
962538b34ef0ad24f74cad029b74b0b2f5b53e9f,0,0,0,0,0,0,0,0,0,0,0,0,0,0,167,0,0,0,0,0,0,0,0,0,0,1,100
665ef47e0fdd018a6da8173d2fa88ce4104105d3,0,0,0,0,0,0,0,0,0,0,0,0,0,0,168,1,0,0,0,0,0,0,0,0,0,1,100
5a201d6caf435bde87731db1ac9da602e871b7b2,2,227,18,209,0,0,0,12,93,19,1,1,0.37873934,2921,226,2,794,769,25,17486,15987,1499,81,73,8,1,100
733c28e640c035526a7656091752b58f2846b506,1,1,1,0,0,0,0,4,5,3104,1,1,0,80,9,0,13,12,1,350,336,14,8,8,0,1,100
8121961018350014860e29951cbd5b106e8b7923,5,46,14,32,0,0,0,22,190,110,1,3,1.892762369,11713,2,0,2368,2363,5,74451,74190,261,300,299,1,1,100
ba52fa43f245236de94bc36c49f2cd7c5e655f9a,0,0,0,0,0,0,0,0,0,0,0,0,0,0,48,0,0,0,0,0,0,0,0,0,0,1,100
446fb478ee49779271557cca1076db2a777bfaa8,1,0,2,2,0,0,0,9,20,960,1,1,0,411,0,0,74,74,0,2575,2591,16,13,13,0,1,100
7bc6266e4d2c30e01fdaedc4b2c5e1d09ed7b79b,8,115,5,110,0,0,0,22,191,472,3,7,2.256137719,11593,51,0,2298,2265,33,74033,73065,968,346,337,9,1,100
6396e3a473fe8b2bc7282b402575299d9c09d8df,1,5,1,4,0,0,0,23,192,6,1,1,0,4284,3,0,887,886,1,27517,27501,16,100,100,0,1,100
d6e0e9af2446d023e68df1e21221d8bf1190615d,3,86,28,58,0,0,0,15,43,66,2,2,0.8708069,2045,58,0,404,403,1,10863,10633,230,64,60,4,1,96.24012638
af9e3feaa43b6376101e28efc4926a3188d78653,1,1,1,0,0,0,0,5,15,3530,1,1,0,364,1,0,61,61,0,1532,1532,0,11,11,0,1,100
2c21aadea26e5942117858167e94b31d1adf1b5d,1,25,1,24,0,0,0,16,42,278,1,1,0,613,52,1,119,110,9,4109,3913,196,18,18,0,1,100
66ff8bd23a4f7713a6f935c62f398ef54e84da70,1,9,1,8,0,0,0,15,44,11,1,1,0,1512,59,1,335,334,1,7286,7236,50,53,53,0,1,100
1c488dc64acfa850da2426c3ed5ffc03397f224c,1,46,1,45,0,0,0,25,192,27,1,1,0,5356,4,1,1073,1063,10,36610,36340,270,123,121,2,1,100
e6b1a137cf157e7f9a73a760b8ee036d9cf269f5,0,0,0,0,0,0,0,0,0,0,0,0,0,0,60,2,0,0,0,0,0,0,0,0,0,1,100
9728fbf7362920ce2c7d8099491c27917c5501da,1,1,1,0,0,0,0,3,3,124,1,1,0,163,53,2,19,19,0,1128,1128,0,4,4,0,1,100
079967c59f281cf0e7178613a38a4db952e16816,3,30,13,17,0,0,0,16,39,189,2,3,1.564549689,3260,61,0,696,689,7,18509,18317,192,93,93,0,1,100
b24b99b8853b70444fae795ce2a7366b6642eada,3,19,20,1,0,0,0,11,31,122,2,3,1.22800053,1501,54,0,257,257,0,8375,8360,15,76,76,0,1,100
9108bffe69dff0e2e1896f85f1f48ab882b3ce49,0,0,0,0,0,0,0,0,0,0,0,0,0,0,55,1,0,0,0,0,0,0,0,0,0,1,100
e06abc00667b3935ad86a146be73853fed807eda,0,0,0,0,0,0,0,0,0,0,0,0,0,0,339,0,0,0,0,0,0,0,0,0,0,1,100
d991dbb4e3aa7eee6b0cb0d1ba87c8632fba6912,1,1,0,1,0,0,0,23,193,74,1,1,0,4288,2,0,887,887,0,27526,27517,9,100,100,0,1,100
eb5aac4babb95a9c06a27d6f6b089aa474eaa2b0,0,0,0,0,0,0,0,0,0,0,0,0,0,0,2,0,0,0,0,0,0,0,0,0,0,1,100
797725221637736ae5a9836ff994477a8c5b8fd8,0,0,0,0,0,0,0,0,0,0,0,0,0,0,333,0,0,0,0,0,0,0,0,0,0,1,100
b26e07e44537c5ee90a8a5c58d1235284478398d,1,3,0,3,0,0,0,2,3,831,1,1,0,171,2,0,1,1,0,318,312,6,1,1,0,1,100
7cfef395c5c1cd8d0cdbf135d0360daff49e8d4c,0,0,0,0,0,0,0,0,0,0,0,0,0,0,0,0,0,0,0,0,0,0,0,0,0,1,100
3e5ccd6c7892636a30ab3b1e96d79109b7915268,0,0,0,0,0,0,0,0,0,0,0,0,0,0,1,1,0,0,0,0,0,0,0,0,0,1,100
281d93f83ec3de932e0fbfdcde4ada2b09145d08,0,0,0,0,0,0,0,0,0,0,0,0,0,0,2,2,0,0,0,0,0,0,0,0,0,0,100
8e79c971d8cc139f2c719fbc2c5aaa0cc8b7bf72,0,0,0,0,0,0,0,0,0,0,0,0,0,0,56,2,0,0,0,0,0,0,0,0,0,0,100
580f0aed6a0032c13643b517b8eef795fa2ccf72,0,0,0,0,0,0,0,0,0,0,0,0,0,0,3,3,0,0,0,0,0,0,0,0,0,1,100
ed3a3c62fb5941ad9c11b4c800a26b9d10e49493,1,5,0,5,0,0,0,20,41,119,1,1,0,331,3,1,51,49,2,1668,1638,30,28,28,0,1,100
d62bedef4232e846cb24d8a1629fb7b242d4575e,3,35,25,10,0,0,0,23,194,83,1,2,1.570950594,7112,3,1,1485,1479,6,42992,42927,65,185,185,0,1,100
375e736dedd5c766d747e9c68934ef7c3ab2a398,0,0,0,0,0,0,0,0,0,0,0,0,0,0,334,1,0,0,0,0,0,0,0,0,0,0,100
ef1e02dc9421e3d56c9ead3d8711d5de6d2ee496,2,443,11,432,1,0,1,1,34,309,2,2,0.198572181,349,3,1,99,47,52,4689,1873,2816,23,11,12,1,99.90871748
b87dab05c1ef268cdc038668e91c0203fe9bc40d,1,22,13,9,0,0,0,1,2,10,1,1,0,440,4,2,57,54,3,2913,2855,58,12,12,0,1,100
27bd9d884f48f3b51b1357de0f9783a82ccaf858,1,100,46,54,0,0,0,5,8,228,1,1,0,640,5,0,82,54,28,5184,4918,266,20,20,0,1,100
41797b2443ffd1f957620931c5ffb145f56cfc8d,1,1,1,0,0,0,0,9,11,552,1,1,0,232,4,4,37,37,0,1289,1288,1,17,17,0,1,100
0a39904ac134736d1eeeb03ae83069c9896c8f97,7,78,10,68,1,0,1,18,54,662,4,7,2.616277246,4160,57,2,944,937,7,22375,22073,302,200,198,2,1,99.9240237
3a4bb32abe0a24628f1c16f1eedf792b37906372,1,5,8,3,0,0,0,17,46,20,1,1,0,1538,0,0,340,340,0,7362,7379,17,54,54,0,1,100
f4ba50fcdd26198eeebe3daef79d61061ccdba57,0,0,0,0,0,0,0,0,0,0,0,0,0,0,58,2,0,0,0,0,0,0,0,0,0,1,100
2258ab08caab0439712bf9bdafeeb9db57a23bfd,5,31,68,37,0,0,0,2,12,2290,1,2,2.084061024,1272,0,0,74,77,3,7382,7700,318,26,25,1,1,99.98481166
cc9220deabbad0d59e2f4e02bdbd7c36301d9d6f,0,0,0,0,0,0,0,0,0,0,0,0,0,0,59,3,0,0,0,0,0,0,0,0,0,1,100
84453294076e1bfe4739a0008543a8402292014b,2,9,3,6,0,0,0,10,84,987,1,2,0.650022422,2920,49,0,683,681,2,20010,19958,52,90,90,0,1,100
6cd9c1416d1540a6ae36640153e7c3f7c01c9e5f,0,0,0,0,0,0,0,0,0,0,0,0,0,0,50,1,0,0,0,0,0,0,0,0,0,1,100
fc3d9d9daa061f2e4ac6388b15b7504887aa2232,7,125,13,112,0,0,0,7,24,763,2,4,2.460060794,2334,5,0,299,285,14,11217,10804,413,178,168,10,1,99.92387333
09707c368eb35bdac91b25dc6ab33cc210ed2e59,0,0,0,0,0,0,0,0,0,0,0,0,0,0,51,2,0,0,0,0,0,0,0,0,0,1,100
75bd661410ad6e4463e7aad68622cf4ca7aac5a0,13,270,9,261,0,0,0,7,19,1590,13,13,3.539272295,2593,1,0,442,398,44,16716,14559,2157,107,102,5,1,99.47089947
a743cbef24303dce2b7674a348b67c3530318dc6,0,0,0,0,0,0,0,0,0,0,0,0,0,0,5,0,0,0,0,0,0,0,0,0,0,1,100
b4c32849245b40d100a583b0b214a69f9b678a44,9,13,29,16,0,0,0,15,44,1102,1,3,2.49849323,4238,0,0,210,210,0,23879,24047,168,132,132,0,1,100
1518e7124447264e6f2adabb9a267deeb7840030,1,2,2,0,0,0,0,2,6,179,1,1,0,282,335,0,46,46,0,1719,1712,7,7,7,0,1,100
23b30beed5b7501627c3288275a9cde73048b449,0,0,0,0,0,0,0,0,0,0,0,0,0,0,60,1,0,0,0,0,0,0,0,0,0,1,100
0b23df7801062cc7836f2e162e1775101898add4,2,52,1,51,1,0,1,1,42,31,2,2,0.612196127,336,0,0,54,51,3,1823,1668,155,31,28,3,1,99.55136833
65b4cec2b68e2e1aa260bfe115d77a60c6d41f20,0,0,0,0,0,0,0,0,0,0,0,0,0,0,1,0,0,0,0,0,0,0,0,0,0,2,100
1eec98e4739e47f139776c1ec0ccee57ecb7dd73,7,536,17,519,3,0,3,11,55,420,4,5,2.542445904,2300,0,0,552,483,69,14128,11418,2710,159,141,18,1,99.85083532
1718a56d20ea98e128f2152c5370183c946ab155,0,0,0,0,0,0,0,0,0,0,0,0,0,0,0,0,0,0,0,0,0,0,0,0,0,1,100
e9959c0c0b41684eace583cb3a68afa5ee97d7c5,1,3,11,8,0,0,0,11,82,197,1,1,0,752,336,1,141,143,2,3849,3889,40,49,49,0,1,100
a5a7ee0511607b9d194cb935b2ece49a9d3da917,0,0,0,0,0,0,0,0,0,0,0,0,0,0,6,1,0,0,0,0,0,0,0,0,0,1,100
dc6381372bc49bfdfe8586f24102b7d3c376ca58,26,1172,104,1068,5,0,5,3,193,751,3,13,4.010752607,19526,106,0,4029,3830,199,124274,117977,6297,793,711,82,1,99.68763945
eedb5f3f36fcb504f5cc0f0cb8b70299d8773046,1,1,1,0,0,0,0,13,19,198,1,1,0,335,1,1,59,59,0,1737,1737,0,26,26,0,1,100
f909896df1310cf198509e5eac474402c9473b47,2,14,0,14,0,0,0,8,20,171,1,2,0.591672779,1176,340,0,198,192,6,6852,6684,168,38,38,0,1,100
07a70be8cf19157efc0c875a6ddf63ab514ce88a,4,0,38,38,0,0,0,20,57,292,1,3,1.823829808,3875,2,0,732,738,6,20609,20789,180,172,174,2,1,100
3171f5b38908e18d7ac40d27a1737e3d41370d9a,1,21,32,11,0,0,0,7,9,2077,1,1,0,116,3,1,11,12,1,431,463,32,3,3,0,1,100
44a84058c9f59c7207283269bc212e722e9330aa,0,0,0,0,0,0,0,0,0,0,0,0,0,0,52,0,0,0,0,0,0,0,0,0,0,1,100
54083d6bdd7711588e88ff806eab92af3ea05568,3,20,10,10,0,0,0,14,86,39,1,2,1.456564762,4304,61,0,806,804,2,27440,27421,19,182,180,2,2,100
51c584682279c799fdc6cad93042e6b7cf461673,4,128,52,76,0,0,0,6,12,843,1,2,1.671174255,596,2,1,81,69,12,3786,3106,680,21,18,3,1,99.97029115
575f7093f353a1ec813e344060b5cb2f5adbf392,4,52,128,76,0,0,0,7,13,4,1,2,1.671174255,672,62,1,69,81,12,3106,3786,680,18,21,3,1,99.97029115
f37f5407eee8d2627a4306a25938b151f8e2ba31,9,29,13,16,0,0,0,15,45,48,1,3,2.49849323,4218,63,2,210,210,0,23999,23831,168,132,132,0,1,100
3a7f5d7031d415869cfce682c240a9d9b20bbf4d,0,0,0,0,0,0,0,0,0,0,0,0,0,0,64,3,0,0,0,0,0,0,0,0,0,1,100
f849208240ca6bb44a3c85bc0008eb112099507b,1,457,0,457,1,0,1,1,1,0,1,1,0,0,65,4,74,0,74,2896,0,2896,27,0,27,1,99.89611161
fec8ed65861997e6141c302be3cbab0861fec072,0,0,0,0,0,0,0,0,0,0,0,0,0,0,7,0,0,0,0,0,0,0,0,0,0,1,100
0586ed0b97ceecd5d7523377ee92b24093520c73,2,5,5,0,0,0,0,8,21,48,1,2,0.721928095,1190,341,0,198,198,0,6852,6852,0,38,38,0,1,100
48076d2055ccdc9dbf7cfb46a368c1e0b7d20e6f,4,42,11,31,0,0,0,8,87,55,2,4,1.741416106,2961,107,0,658,653,5,19334,19130,204,115,113,2,1,100
767d9e760b762362fab7e73c8b325b6f24d7a17e,4,11,42,31,0,0,0,8,88,0,2,4,1.741416106,2992,108,1,653,658,5,19130,19334,204,113,115,2,1,100
2ec95d58a9e6b674b7d374f6b1a7a98eeb76195e,11,1204,20,1184,5,0,5,1,46,209,2,4,2.488202218,2081,109,2,531,329,202,18482,12021,6461,132,82,50,1,99.64633068
417a84cacfb74de041aa6e9a4ce20eb078b39816,0,0,0,0,0,0,0,0,0,0,0,0,0,0,56,0,0,0,0,0,0,0,0,0,0,1,100
6d6682cbf12c04f76545b9e2451c6ba3de06ac74,14,1670,0,1670,13,0,13,1,43,8,2,9,3.449287866,342,0,0,216,52,164,10800,1710,9090,85,29,56,1,99.7080292
6d8f9179d60f7d5f70852e13779fb096adfcf714,4,42,11,31,0,0,0,8,89,24,2,4,1.617019467,2961,110,3,658,653,5,19383,19130,253,115,113,2,1,21.71761281
10f4cff27b703ffbb18e77ac9bd08d4b61e63813,7,81,32,49,0,0,0,6,26,332,2,4,2.076351539,3166,1,0,491,488,3,18630,18306,324,117,117,0,1,21.71761281
d157019bf84cea2208001468e2d1affc8c025b3d,1,4,0,4,0,0,0,4,11,2243,1,1,0,264,342,1,59,57,2,1181,1156,25,22,20,2,1,100
6b2fba5f83288e3f6d8e532748064d52b115ff9e,1,4,6,2,0,0,0,2,2,341,1,1,0,1094,0,0,221,221,0,5931,5931,0,53,53,0,1,100
3b49c2f9fb77d76154911b7dd61f2382d0b56bfb,1,353,0,353,1,0,1,1,1,0,1,1,0,0,66,0,41,0,41,2264,0,2264,13,0,13,2,99.81121115
3c37e7aea13539f086766a78e2afa3859f9edde4,3,21,8,13,0,0,0,9,18,347,1,2,1.439868363,1343,111,4,207,202,5,6875,6775,100,42,42,0,1,100
896f348636f7df8e64f789a8f24569720afb654b,2,59,9,50,0,0,0,10,23,638,1,2,0.26086291,802,53,0,127,118,9,4465,4164,301,22,21,1,1,100
f6ae204704c5e717aaf7d06e05af5534a2ce503a,0,0,0,0,0,0,0,0,0,0,0,0,0,0,54,1,0,0,0,0,0,0,0,0,0,1,100
0f507a9270a9bdf4b55ff821dd77d39ba65d2138,1,3,1,2,0,0,0,3,3,1556,1,1,0,263,6,0,45,45,0,1653,1639,14,9,9,0,1,100
6b5df44448c4524e6881ed3682c4b1ffa2163b28,5,275,1,274,1,0,1,1,53,1840,2,3,0.711959957,1771,0,0,359,314,45,12984,11555,1429,108,98,10,1,99.97103129
2459a50bb50424b4e9fb1000b1ad6cd683efd58d,0,0,0,0,0,0,0,0,0,0,0,0,0,0,0,0,0,0,0,0,0,0,0,0,0,1,100
bf2206f36343bd0f8562f3a38819217ce0ecffe5,2,51,22,29,0,0,0,4,14,87,1,2,0.996613283,543,0,0,90,86,4,3140,3001,139,32,30,2,1,100
daeda7ab8aefcfdbe5869ff7c5852fe1ee351635,4,99,14,85,0,0,0,8,98,292,1,3,1.548002321,2582,343,1,461,439,22,15061,14367,694,127,122,5,1,94.3255814
eafe72eb10fc165e865f3a8a43663e457e1ab96e,1,11,0,11,0,0,0,2,7,2169,1,1,0,153,337,0,25,21,4,770,674,96,3,3,0,1,100
91885108cda7d247247aa6917d056e121271d8a1,1,2,3,1,0,0,0,5,9,910,1,1,0,289,112,1,40,41,1,1411,1422,11,12,12,0,1,100
d65abd8c4f7a5297f376c167f5f31b57e68bf601,1,14,4,10,0,0,0,24,195,234,1,1,0,4297,2,0,899,893,6,27687,27606,81,100,100,0,1,100
7b66386ebbd81337888cbc3b5b0fc65c2a8aa4a1,2,42,87,45,0,0,0,12,32,168,2,2,0.987436027,796,8,0,109,117,8,4237,4443,206,21,30,9,1,100
f0797138f6bdf9432400d1c2743b5ea7351a0c8d,3,308,0,308,2,0,2,1,10,768,1,2,1.04485093,125,344,1,49,17,32,2422,600,1822,18,4,14,1,99.95156447
8b963d304c77f7daf86131a514f1744a44b485b1,6,203,134,69,0,0,0,8,99,128,1,4,1.965693421,3823,345,2,743,706,37,22113,21575,538,196,185,11,1,99.86414362
ffb4ce24a10414fa20bf4b686a7b37291ac1db09,2,94,112,18,0,0,0,25,194,174,2,2,0.189990756,5889,346,3,1154,1165,11,39452,39801,349,145,147,2,1,100
d7bd3336d59a83027a4488ca783dd1ce09c2224d,1,1,1,0,0,0,0,22,44,64,1,1,0,350,57,0,53,53,0,1752,1752,0,30,30,0,1,100
cf775085d6eb850f65ac2de2707d75e36862c1ba,0,0,0,0,0,0,0,0,0,0,0,0,0,0,3,1,0,0,0,0,0,0,0,0,0,1,100
6827eb7351708c22d45481fda8cfa61467f60741,5,375,162,213,0,0,0,7,41,262,1,2,2.222731344,5588,113,1,1151,1053,98,33047,31965,1082,131,133,2,1,100
d51ec831affbfb1e29215d77a2204423ab77e6d9,0,0,0,0,0,0,0,0,0,0,0,0,0,0,114,2,0,0,0,0,0,0,0,0,0,1,100
bb05c645fccb45dcadeaf557fa7dd174413d7af3,2,44,27,17,0,0,0,1,2,8,1,2,0.998711751,306,347,4,32,32,0,1928,1809,119,16,14,2,1,100
7581772df51b7846215bb6f03b929127e423debb,1,0,1,1,0,0,0,1,3,0,1,1,0,159,348,5,18,18,0,880,888,8,3,3,0,1,100
0a998ed76fab3c7898a5d36b0a560f9723c19a75,0,0,0,0,0,0,0,0,0,0,0,0,0,0,338,1,0,0,0,0,0,0,0,0,0,1,100
03fab86922c1cefbee52b6ab343bf471b71b6a98,0,0,0,0,0,0,0,0,0,0,0,0,0,0,339,2,0,0,0,0,0,0,0,0,0,1,100
5b23eff7d1ce5b4cbd0fa1b7ad4709f7e48cd10f,2,20,6,14,0,0,0,7,196,429,1,1,0.619382195,5346,4,2,1112,1107,5,34671,34553,118,124,124,0,1,100
99c15149dc250d56e5145996bc944f0b32e6ac56,2,16,9,7,0,0,0,7,15,58,1,2,0.970950594,1695,1,0,319,317,2,10347,10298,49,56,55,1,1,94.14577259
7dac4e178b94c949da7c727fb2e749b50d933bb5,0,0,0,0,0,0,0,0,0,0,0,0,0,0,55,0,0,0,0,0,0,0,0,0,0,1,100
40d935cd635ea23596590f444c3c6ce71474bbb9,1,2,2,0,0,0,0,11,17,224,1,1,0,379,2,1,96,96,0,2958,2958,0,9,9,0,1,100
4e3500192f88cf6c232d729797d08f475aaef44e,0,0,0,0,0,0,0,0,0,0,0,0,0,0,56,1,0,0,0,0,0,0,0,0,0,1,100
6b393ddbab3cc3cd8981f77849c915c01cacea24,0,0,0,0,0,0,0,0,0,0,0,0,0,0,58,1,0,0,0,0,0,0,0,0,0,1,100
0e2f4ba26d83866adb3e924a4e45fbabe0777e27,1,3,0,3,0,0,0,7,15,460,1,1,0,688,5,3,83,83,0,3902,3872,30,9,9,0,1,100
a9028bb31d143ce527d89413a8d13f6fe56f2bbf,1,4,3,1,0,0,0,4,17,26,1,1,0,1234,39,0,219,219,0,7204,7196,8,16,16,0,1,100
41f64240fe999028e27c9306ca75ec44c142bf74,1,93,0,93,1,0,1,1,1,0,1,1,0,0,115,2,9,0,9,444,0,444,5,0,5,2,99.97098927
75823ca43035be58ff6d9c4545034b954f595c87,0,0,0,0,0,0,0,0,0,0,0,0,0,0,116,3,0,0,0,0,0,0,0,0,0,1,100
7bf61cc5835a61c552b709ac3c200f9a69f61a66,1,0,4,4,0,0,0,1,2,0,1,1,0,93,117,4,9,9,0,408,444,36,5,5,0,1,100
6d93ba7158dbc366457613f29b71b25ee6790484,1,4,2,2,0,0,0,3,5,1839,1,1,0,203,3,2,32,31,1,935,925,10,5,5,0,1,100
53890aa7a3c6b6fb6476874c703e12030a4e7033,0,0,0,0,0,0,0,0,0,0,0,0,0,0,118,5,0,0,0,0,0,0,0,0,0,1,100
b8a3e18e3824ac372ceecef1b2de404105a9722b,0,0,0,0,0,0,0,0,0,0,0,0,0,0,119,6,0,0,0,0,0,0,0,0,0,1,100
b8789eef138f869763d09a442edd515dc2592585,2,91,3,88,0,0,0,5,9,618,2,2,0.997059057,479,340,2,103,85,18,2610,2174,436,20,19,1,1,100
a15e49fb53b9a0ea7ae273a26e412e4b065765a1,5,1228,547,681,2,0,2,1,2,609,2,2,1.593028878,887,8,0,209,167,42,8488,5131,3357,124,76,48,1,99.75315812
9e1268863d82d5c63a899375d5aa06fdec6a7d53,1,227,21,206,0,0,0,2,3,104,1,1,0,213,6,2,52,24,28,2109,1128,981,12,2,10,1,100
6decd3a0ba8bff83dff0863a9694afdf47a63cd9,0,0,0,0,0,0,0,0,0,0,0,0,0,0,40,1,0,0,0,0,0,0,0,0,0,1,100
fc7873ed00177ac98b6eca6381997cf2af6fcb69,1,4,2,2,0,0,0,17,43,376,1,1,0,637,9,0,120,119,1,4131,4109,22,18,18,0,1,100
b7a2902939f0d5ae64ead9fde539e76a766238a2,2,88,33,55,0,0,0,7,197,28,1,1,0.988885904,5360,341,2,1120,1112,8,34973,34671,302,125,124,1,1,99.95638901
21a4c0dd2feba0b958fbc1a6d8b8009ccbbb818d,1,13,0,13,0,0,0,2,2,989,1,1,0,67,4,3,4,4,0,524,373,151,3,3,0,1,100
fcfe7a54257912f6bcf38d8ba9510f8eb04e1d53,0,0,0,0,0,0,0,0,0,0,0,0,0,0,7,3,0,0,0,0,0,0,0,0,0,1,100
2b5fc4796f6ab1dafaf682a8fb6f647812261d5a,1,4,8,4,0,0,0,11,34,147,1,1,0,828,120,5,147,148,1,4963,4968,5,29,29,0,1,100
0ac7c0c438e85f3b0b83b28efc99ce8221d21d1e,0,0,0,0,0,0,0,0,0,0,0,0,0,0,41,2,0,0,0,0,0,0,0,0,0,1,100
91a00f42062bfe01600fd477a4d57d5b1a6b8b06,2,203,1,202,1,0,1,1,7,1636,2,2,0.079490442,102,342,2,32,11,21,1389,456,933,15,6,9,1,97.18309859
f117b1c245d2f388d262425276e5e9f81f0c9248,1,25,14,11,0,0,0,8,20,1702,1,1,0,380,10,1,49,48,1,1823,1778,45,12,11,1,1,100
586c8562043def73ef371e2661c3fccf55a6c6ef,1,11,7,4,0,0,0,2,3,888,1,1,0,500,6,0,64,62,2,2787,2751,36,16,16,0,1,100
845700e977d5560186557105ae7bb5c4c5793d92,1,3,2,1,0,0,0,26,195,90,1,1,0,5405,8,2,1077,1077,0,36674,36660,14,123,123,0,1,100
c5fb46ebde5d2d257f79ca3b33aff01b286b1664,4,31,8,23,0,0,0,5,54,351,1,2,1.476542775,2811,1,0,376,369,7,18383,18252,131,124,123,1,1,100
b374845664bd0e48d2b6debb52097e221c3eac20,0,0,0,0,0,0,0,0,0,0,0,0,0,0,121,0,0,0,0,0,0,0,0,0,0,1,100
0db8b4f3f5997fee2f05b35a2488a08873657bcb,0,0,0,0,0,0,0,0,0,0,0,0,0,0,122,1,0,0,0,0,0,0,0,0,0,1,100
c2155dfad98323df02b05c5852b1a3c3a05aa313,2,8,1,7,0,0,0,8,100,108,1,2,0.764204507,1927,349,0,355,354,1,11542,11515,27,86,85,1,1,100
86ea0b4ee722cd9c6c1fdc77b91102f15afda7e4,1,0,29,29,0,0,0,3,4,31,1,1,0,504,37,0,60,64,4,2599,2787,188,14,16,2,1,100
f4ac66d5f2f0014a8b1f6ab043cc1372a55ab6fd,3,189,71,118,0,0,0,5,21,564,1,3,0.757665761,948,7,0,87,83,4,6835,6024,811,25,24,1,1,100
acd7516eea2e11921a42478b717d58f2bead54e8,2,86,17,69,0,0,0,16,196,132,1,2,0.984646827,7912,5,0,1130,1126,4,55846,55395,451,173,172,1,1,100
454537a95494477312b592256cd38878d004a167,4,331,32,299,1,0,1,1,3,54,3,3,1.5932369,1456,9,0,235,199,36,9745,8087,1658,134,115,19,1,99.96690933
6effe9615cbf47aa4aadc4cb7874fd87ff5c1bad,3,34,2,32,0,0,0,8,85,87,1,3,1.539117355,2122,350,1,370,364,6,12127,11809,318,128,126,2,1,100
9256a436b392e11907d1b1570d69e106c8e5dd7f,1,4,4,0,0,0,0,1,1,0,1,1,0,178,42,0,19,19,0,859,859,0,7,7,0,2,99.90077724
45efc9a622a10d963d1b5d406bd9e49fdb6d6589,1,3,1,2,0,0,0,2,3,182,1,1,0,1092,343,0,222,221,1,5939,5931,8,53,53,0,1,100
d488d570d6b94a8987431d4424727c6a91d640b7,20,196,53,143,0,0,0,3,94,753,7,12,2.352087869,10691,43,1,2142,2112,30,63711,62840,871,513,507,6,1,100
e78498a4c1d767134b4abf4aeeeedc2d8bc69a9f,4,205,280,75,1,0,1,3,44,1027,1,1,1.470261792,1174,44,2,156,184,28,6402,6907,505,32,35,3,1,99.96696399
813b67197ae6e58c21a9e72c7f034779c3efed79,1,2,0,2,0,0,0,1,2,12,1,1,0,178,45,3,19,19,0,870,859,11,7,7,0,1,100
cf1e3ef8dcd5a4adc046a3895f49c9deb3069015,12,1339,149,1190,6,0,6,1,47,478,3,8,2.895789281,4036,0,0,953,787,166,29648,22479,7169,150,114,36,1,97.93648235
a72b5eddecfd61099791eae615716cce430b348a,0,0,0,0,0,0,0,0,0,0,0,0,0,0,46,4,0,0,0,0,0,0,0,0,0,1,100
54e54886329f9e46845f11cde066c842525d2e88,0,0,0,0,0,0,0,0,0,0,0,0,0,0,9,0,0,0,0,0,0,0,0,0,0,1,100
d5e3dc8c722e7ec4f035139c7c20e706aa82b146,0,0,0,0,0,0,0,0,0,0,0,0,0,0,47,5,0,0,0,0,0,0,0,0,0,1,100
3a4a313e5ed97c7d36340ef59b6a4038e7bae89f,2,82,22,60,0,0,0,17,197,36,1,2,0.078232465,7981,11,0,1146,1130,16,56215,55846,369,175,173,2,1,100
d8e9c489d4bff72cb80661a268b35d5a01688586,2,432,262,170,1,0,1,1,2,121,1,1,0.961311725,505,123,0,127,96,31,3605,2557,1048,21,18,3,1,99.96849401
d722786c8914e762ab1334d245855e0e440af5fe,0,0,0,0,0,0,0,0,0,0,0,0,0,0,38,0,0,0,0,0,0,0,0,0,0,1,100
d4d19bb056f1c2d32eda250f8a990bcf3c2d57df,0,0,0,0,0,0,0,0,0,0,0,0,0,0,39,1,0,0,0,0,0,0,0,0,0,1,100
8050020935618488ba1406f7568c2f1f654029ec,10,171,103,68,0,0,0,3,101,284,2,6,2.783998229,7244,344,1,1533,1520,13,41921,41429,492,317,316,1,1,100
5dc750994aa0164d519aab709dd28789164b756b,11,73,49,24,0,0,0,2,4,904,4,9,3.015818046,1925,48,6,279,273,6,10884,10888,4,72,66,6,1,100
5d1f87cd92eeed7cc7deb3fd0f7e688ef71e9250,1,223,31,192,0,0,0,8,16,221,1,1,0,366,10,1,69,42,27,3251,2306,945,16,6,10,1,100
f45054d1b933b5e65cb19ace014d3b2cb0d78132,4,295,1,294,0,0,0,7,21,521,1,3,1.399301494,1133,0,0,221,147,74,6947,4617,2330,81,69,12,1,99.95274846
cd2165f4b81eff0f29edf30fe73c31d24d9f1d78,1,11,3,8,0,0,0,3,3,30,1,1,0,100,8,0,17,14,3,555,519,36,4,4,0,1,100
6ae055f68adc4f63a36459b27084cc3ab0a8f53e,2,297,0,297,1,0,1,1,2,21,1,1,0.428211973,96,49,3,62,16,46,2295,413,1882,16,7,9,1,99.90569003
05f465ea950530a30e8c8491276d83324a7aa652,0,0,0,0,0,0,0,0,0,0,0,0,0,0,10,0,0,0,0,0,0,0,0,0,0,1,100
7b0fe697daf162cf326c9d19fed547337da2513a,1,0,1,1,0,0,0,11,22,18,1,1,0,548,50,4,106,106,0,3705,3714,9,18,18,0,1,100
23bef42d73b9b98c77d0e34794b11742c85571c0,2,0,74,74,0,0,0,3,3,376,2,2,0.99947302,214,7,0,12,24,12,591,1155,564,4,6,2,1,100
8087992d110c7beab059e002e8e8f57485ad544f,4,8,7,1,0,0,0,2,43,24,2,3,1.604935595,2316,345,1,460,460,0,13092,13081,11,75,75,0,1,100
f246f4397f2a2c8bfa596a2b0dada0874c77e6aa,17,817,822,5,0,0,0,3,19,3912,2,6,3.843669251,1863,51,5,195,195,0,8303,8303,0,61,61,0,1,100
297e8b909a405b7448c699d535299aaf7a2c4d93,1,1,0,1,0,0,0,11,20,0,1,1,0,729,0,0,121,121,0,5041,5037,4,20,20,0,1,100
734485dd2149db628b3353279a9f16b45de91956,1,8,0,8,0,0,0,18,45,54,1,1,0,527,6,0,87,87,0,3565,3483,82,12,12,0,1,100
12019572d2a7f77e221ccdb28cec2e58fd776141,0,0,0,0,0,0,0,0,0,0,0,0,0,0,52,4,0,0,0,0,0,0,0,0,0,1,100
63df056c754a2889ee4c6fc17d22529ca0cb7f6d,1,24,8,16,0,0,0,18,46,5,1,1,0,535,53,5,91,87,4,3688,3565,123,12,12,0,1,99.93718593
691a55cd38ef216258aec370859d5b2d823320da,7,431,362,69,0,0,0,24,198,163,2,4,1.422880393,7312,346,1,1524,1503,21,45436,44897,539,244,240,4,1,100
473d2c99ccee166efa6788a0767d44cb38e336cf,1,1,1,0,0,0,0,1,4,207,1,1,0,158,351,0,18,18,0,888,880,8,3,3,0,1,100
d6c53d9cdef75c00c28cea487c70b3fceb63e672,3,15,11,4,0,0,0,6,88,224,2,3,1.238901257,2313,347,2,465,464,1,12547,12521,26,125,125,0,1,100
bcdb1eda7f0d774952facd84da77b69fca149ff1,3,69,28,41,0,0,0,5,36,1134,2,3,1.293947727,1508,352,1,280,278,2,7642,7478,164,106,104,2,1,100
a14b6d6aa57d6bc0026713e73750df716c65aa8f,1,6,120,114,0,0,0,24,199,28,1,1,0,4335,11,0,876,903,27,27113,27901,788,98,101,3,1,100
641ef11a2e45887d689c986b2584fd3ba4c9fcc5,1,1,0,1,0,0,0,8,17,74,1,1,0,558,12,1,69,69,0,3258,3251,7,16,16,0,1,100
e3e0e0d76774996223a4e1207b1fcae984bf9acb,3,15,3,12,0,0,0,23,45,300,1,3,1.122113677,1786,12,0,331,328,3,10684,10616,68,76,75,1,1,100
e3ff179223f87b8fe3c66b08d6c48eda3f0e6f7b,1,4,0,4,0,0,0,2,5,26,1,1,0,158,13,1,20,18,2,923,888,35,3,3,0,1,100
8ed113f424d0054b364cc6bd5874225d6f2011ba,0,0,0,0,0,0,0,0,0,0,0,0,0,0,57,0,0,0,0,0,0,0,0,0,0,1,100
81dd0f650eb179d29b9d62a6e435fef00e944e40,1,5,1,4,0,0,0,4,5,87,1,1,0,146,54,0,21,20,1,723,680,43,7,7,0,1,100
225d00761850301a9f9a346e01808717eb110178,1,5,10,5,0,0,0,28,198,99,1,1,0,5477,348,1,1094,1095,1,37010,37047,37,125,125,0,1,100
de88e7973763b816655f99f917c4f28fe0ced40c,0,0,0,0,0,0,0,0,0,0,0,0,0,0,8,0,0,0,0,0,0,0,0,0,0,1,100
23b49c581dedea32bf8a03b503f9337530427521,0,0,0,0,0,0,0,0,0,0,0,0,0,0,7,0,0,0,0,0,0,0,0,0,0,1,100
57e97631bcaf9100e88c4c9e9d091404d93a4c72,0,0,0,0,0,0,0,0,0,0,0,0,0,0,55,1,0,0,0,0,0,0,0,0,0,1,100
197b27683b5271836a8add2d783ee2889b47d153,0,0,0,0,0,0,0,0,0,0,0,0,0,0,0,0,0,0,0,0,0,0,0,0,0,1,100
a15ec3c1028b01b292e257a1a50d83fcd8d91149,2,52,4,48,0,0,0,16,49,1028,1,1,0.67694187,2895,1,0,545,537,8,14275,14099,176,61,61,0,1,100
8391df288a002cd5b0995998df36511d185867e2,1,2,2,0,0,0,0,14,95,131,1,1,0,2917,5,0,746,746,0,16281,16281,0,71,71,0,1,100
0fa35a1d00de7899effa5a589713baf947cabd2b,2,18,0,18,0,0,0,2,5,139,2,1,0.99107606,1382,1,1,206,203,3,7650,7546,104,121,119,2,1,100
e79967389edf007ce181553e5ade8d5912c3a8f4,2,0,18,18,0,0,0,3,6,0,2,1,0.99107606,1400,56,2,203,206,3,7546,7650,104,119,121,2,1,100
4160ebfc7cb1db642e8ba7fdbaa72142978e764b,1,6,2,4,0,0,0,3,3,105,1,1,0,125,2,2,19,18,1,762,725,37,2,2,0,1,100
400beaa7604e4c83d051dc6e83b8bc109e5d8c53,3,69,3,66,0,0,0,25,200,131,1,2,1.003198401,5467,2,1,1043,1027,16,34290,33901,389,167,165,2,1,100
a4cf0b7c26723db0429f5ef8ac39b64bf1a8762c,4,917,0,917,4,0,4,1,1,0,2,3,1.567820743,0,0,0,100,0,100,6048,0,6048,71,0,71,1,99.78025428
88403100b3c56d0cf41cfb8ac47a0315ab830cad,0,0,0,0,0,0,0,0,0,0,0,0,0,0,0,0,0,0,0,0,0,0,0,0,0,1,100
64a1d8e2db5201bf7de2f3ea5b6b22b5f2869ec5,0,0,0,0,0,0,0,0,0,0,0,0,0,0,124,0,0,0,0,0,0,0,0,0,0,1,100
95a1aa57a96b392227a4f0aa4e7ecc396dca2261,0,0,0,0,0,0,0,0,0,0,0,0,0,0,2,2,0,0,0,0,0,0,0,0,0,1,100
68627f54b681894622808e3cc4f12a6d7a539dd2,2,28,3,25,0,0,0,6,199,40,1,2,0.962900415,5921,349,1,1192,1190,2,39670,39482,188,145,145,0,1,100
8e45df1f117c8a65e05be5218a111078efd6234a,7,498,64,434,4,0,4,2,3,48,4,5,2.638969584,651,0,0,138,83,55,6813,4105,2708,38,21,17,1,99.74953037
708085410ff2bbbde5f9343c31cd0a1b45f5efa8,1,1,1,0,0,0,0,10,103,69,1,1,0,915,13,0,223,223,0,5639,5639,0,36,36,0,1,100
bc94870c3ee448b3d71d709cccfcf6ccfcae3ad4,0,0,0,0,0,0,0,0,0,0,0,0,0,0,58,1,0,0,0,0,0,0,0,0,0,1,100
f2ca558474e4639d6aa0e1f6a4715fb7f606b3b4,3,48,10,38,0,0,0,2,48,125,1,1,1.073551999,2514,14,1,468,461,7,12993,12738,255,83,82,1,1,100
87cc02b103c15297e8b8ddb12a8997517a27fc1c,0,0,0,0,0,0,0,0,0,0,0,0,0,0,59,2,0,0,0,0,0,0,0,0,0,1,100
807cb949dbc46699ba6694d9404158dd61ecc019,0,0,0,0,0,0,0,0,0,0,0,0,0,0,14,1,0,0,0,0,0,0,0,0,0,1,100
c66c8384757be11335d62f72e63b8da5a5f58234,0,0,0,0,0,0,0,0,0,0,0,0,0,0,60,3,0,0,0,0,0,0,0,0,0,1,100
a0ec633e77db702d4fbc9fd97eee44c8467eb035,1,1,19,18,0,0,0,9,24,132,1,1,0,571,57,3,79,82,3,2810,2904,94,13,13,0,1,100
23fc9bf3bec073fb92f506d4bddc08427961cd89,3,11,10,1,0,0,0,3,4,3,3,3,1.312744353,780,58,4,107,108,1,5160,5178,18,24,24,0,1,100
8626832e6648535c34fa6915f8272c4d671f05ed,1,18,2,16,0,0,0,25,201,22,1,1,0,4268,350,2,889,888,1,27471,27397,74,99,99,0,1,100
4a1c375088ad351ea5b1f727bcbb225ec044c344,1,1,1,0,0,0,0,10,104,13,1,1,0,915,351,2,224,223,1,5657,5639,18,36,36,0,1,100
7f32d49b5c015e3a85b276e1242277be37b1192d,0,0,0,0,0,0,0,0,0,0,0,0,0,0,10,0,0,0,0,0,0,0,0,0,0,1,100
850e31e31087fad03ba519d1246d2f0bd70cb669,0,0,0,0,0,0,0,0,0,0,0,0,0,0,9,0,0,0,0,0,0,0,0,0,0,1,100
11a1cf1c6b35868dc17c3217fa4ec9791dd30886,3,327,0,327,2,0,2,1,11,101,1,2,1.024698308,127,125,1,63,17,46,2743,613,2130,19,4,15,1,99.92196036
b34bc70edcab38e902df6380f8e2fc8de1464e30,0,0,0,0,0,0,0,0,0,0,0,0,0,0,9,0,0,0,0,0,0,0,0,0,0,1,100
9cb4f16eaf834a4f8916d43d9f0f8ddd9f781f20,0,0,0,0,0,0,0,0,0,0,0,0,0,0,352,3,0,0,0,0,0,0,0,0,0,1,100
0fa3ef5497bc563e0ff80e9696fdb1bc309d7fe1,3,17,15,2,0,0,0,4,5,24,3,3,0.868392729,781,3,2,115,107,8,5220,5160,60,24,24,0,1,100
f5f0dcafc03d7910d0517845bd7ca43253d07557,2,161,11,150,1,0,1,18,56,86,1,1,0.761862446,1658,15,1,332,308,24,12361,11240,1121,99,94,5,1,99.96885705
1628fa74843950119f6bdb8e2cb5a9301c1b2056,2,23,1,22,0,0,0,25,202,371,1,2,0.41381685,4537,15,2,945,940,5,28876,28743,133,119,118,1,1,100
0ecdb149010a2c75265826bd523b480b20976adb,0,0,0,0,0,0,0,0,0,0,0,0,0,0,10,1,0,0,0,0,0,0,0,0,0,1,100
ec584951a53cb2af558b6ebad9d6612faf070916,3,14,14,0,0,0,0,2,89,301,2,3,0.946372936,1254,353,4,247,249,2,7032,7055,23,62,62,0,1,100
ad06828d2d0b31731e02247a29bba65b9c9f2cef,1,194,0,194,0,0,0,3,4,53,1,1,0,129,4,1,59,19,40,2280,762,1518,2,2,0,1,100
4b77aaf68a9c0c3d1b555708b418f915afdffc7a,0,0,0,0,0,0,0,0,0,0,0,0,0,0,16,2,0,0,0,0,0,0,0,0,0,1,100
78eb798a4a00e289d7e62951b00a4c297b5b3d83,1,11,6,5,0,0,0,25,203,9,1,1,0,4284,16,1,891,889,2,27538,27483,55,99,99,0,1,100
20561472eba2fc484f33801c5c07fdc9b8edd9d9,2,70,2,68,1,0,1,4,6,37,1,1,0.249882293,150,59,0,29,21,8,1045,723,322,10,7,3,1,95.73554665
694967aff3d09fcb8c27d1733322e92d44209c99,1,19,5,14,0,0,0,11,26,596,1,1,0,614,21,0,98,93,5,3642,3541,101,41,41,0,1,100
b51c110115f6f1872b362884697f0fc15b73e346,2,185,27,158,1,0,1,1,2,30,1,1,0.989122892,530,3,0,105,77,28,4740,3945,795,68,59,9,0,99.94705493
b91d21d194a64fb29d45058cf8bf8a0a289263a9,1,73,9,64,0,0,0,11,35,276,1,1,0,824,126,1,155,147,8,5366,4963,403,30,29,1,1,100
e3938e97159d1c5fc7bfff10cafbc95e3c3a8396,0,0,0,0,0,0,0,0,0,0,0,0,0,0,60,1,0,0,0,0,0,0,0,0,0,1,100
8f0c6a56773e71d52c96fe998d8bd06e6efbc5c9,1,6,0,6,0,0,0,12,36,3,1,1,0,888,61,2,157,155,2,5432,5366,66,30,30,0,2,100
9683eacca70780ab1d73d74d319dc28c08b0059e,0,0,0,0,0,0,0,0,0,0,0,0,0,0,61,0,0,0,0,0,0,0,0,0,0,1,100
b6b53a9c1851825e19d70e92a1d5e63e86163f31,0,0,0,0,0,0,0,0,0,0,0,0,0,0,0,0,0,0,0,0,0,0,0,0,0,1,100
e47c0a78aef9d4ccbc0db6945cb1e84340e54f96,1,3,1,2,0,0,0,2,2,1337,1,1,0,556,6,0,105,104,1,3324,3309,15,17,17,0,1,100
f51d386f700cc24d562190c95dfb6f2598d5e6d1,1,7,0,7,0,0,0,2,2,1341,1,1,0,86,7,1,12,10,2,469,406,63,2,2,0,1,100
90877c6d3364cacb13b1ef29541da6505d13cc2a,2,83,67,16,0,0,0,5,85,644,1,1,0.881290899,1637,354,0,381,386,5,10008,9896,112,58,56,2,1,100
d62368a45e8ed435e308c3ca9e79cdfde1a57a2c,0,0,0,0,0,0,0,0,0,0,0,0,0,0,62,1,0,0,0,0,0,0,0,0,0,1,100
321e6b412f45bd3c348732fcf5bb1cbbc22f7892,0,0,0,0,0,0,0,0,0,0,0,0,0,0,353,0,0,0,0,0,0,0,0,0,0,1,100
087aef3b31ef6a16d42806b0b06ebaca1c4dc7a2,0,0,0,0,0,0,0,0,0,0,0,0,0,0,1,1,0,0,0,0,0,0,0,0,0,1,100
25224db4ec5d49867da53269b62f5f7412dfd122,0,0,0,0,0,0,0,0,0,0,0,0,0,0,2,2,0,0,0,0,0,0,0,0,0,1,100
d2eaba6739895fff34b6d6e492b66d27756a39b7,2,18,0,18,0,0,0,10,44,568,1,2,0.309543429,1211,17,0,216,213,3,7918,7808,110,24,24,0,1,100
39bb22ec0dac0a9a7b13389c89df1616a3ba23e7,11,307,25,282,2,0,2,3,90,770,1,7,2.594890796,3949,355,1,778,729,49,24200,22677,1523,178,166,12,1,97.98566987
4b491edcb60b74717972f753ef4f9db0d14ee9f9,0,0,0,0,0,0,0,0,0,0,0,0,0,0,63,1,0,0,0,0,0,0,0,0,0,1,100
4df84df925854b6034eaa6c582914662d0863b0e,0,0,0,0,0,0,0,0,0,0,0,0,0,0,64,2,0,0,0,0,0,0,0,0,0,1,100
801e9b0f1b965c55156bbd08c945f3e9fe338df0,0,0,0,0,0,0,0,0,0,0,0,0,0,0,11,0,0,0,0,0,0,0,0,0,0,1,100
67457efd63a833a2dc8ac4e59172652a9a8e5841,1,3,5,2,0,0,0,1,3,59,1,1,0,569,4,0,83,84,1,4224,4232,8,61,61,0,1,100
68450ad64917fa4bd6846257cee73c59151e2fe3,0,0,0,0,0,0,0,0,0,0,0,0,0,0,354,1,0,0,0,0,0,0,0,0,0,1,100
a74bbb71252ec472b7939ec6c7a2745aac6b543f,0,0,0,0,0,0,0,0,0,0,0,0,0,0,355,2,0,0,0,0,0,0,0,0,0,1,100
5ea01053ee5a962bd4750905c63eb053e4434181,0,0,0,0,0,0,0,0,0,0,0,0,0,0,356,3,0,0,0,0,0,0,0,0,0,1,100
b1988a39266d8be1ea1ebabb630630d1740fd73f,0,0,0,0,0,0,0,0,0,0,0,0,0,0,357,4,0,0,0,0,0,0,0,0,0,1,100
8d5e9df079bff4ad5a05d32bcccadc74ed07ed6a,0,0,0,0,0,0,0,0,0,0,0,0,0,0,358,5,0,0,0,0,0,0,0,0,0,1,100
fc95accb67c1a7e0acf49b5b847fc0a69346c7c4,0,0,0,0,0,0,0,0,0,0,0,0,0,0,359,6,0,0,0,0,0,0,0,0,0,1,100
668417c91438cbf85788644694e78a66f45efe44,0,0,0,0,0,0,0,0,0,0,0,0,0,0,360,7,0,0,0,0,0,0,0,0,0,1,100
baa023635a3a0e9e7ba26ed1914150ebcf6149b8,0,0,0,0,0,0,0,0,0,0,0,0,0,0,361,8,0,0,0,0,0,0,0,0,0,1,100
fab37f89e62c1f7e19a44d0e9889925bc2efcf26,0,0,0,0,0,0,0,0,0,0,0,0,0,0,362,8,0,0,0,0,0,0,0,0,0,1,100
68ec93a3b8974d2c8e63e9afdf45f4e153ac0bfb,0,0,0,0,0,0,0,0,0,0,0,0,0,0,363,9,0,0,0,0,0,0,0,0,0,1,100
ab86a4c6e06fa3048072cff6664e8cffbb8c667b,0,0,0,0,0,0,0,0,0,0,0,0,0,0,3,0,0,0,0,0,0,0,0,0,0,1,100
84e0bbd28ff000a3d018f9a939dc41c7991e3aac,1,23,21,2,0,0,0,13,39,863,1,1,0,989,17,0,253,252,1,6436,6428,8,32,32,0,1,100
5a16f9afffc0ba5cc3f9e16e23af8e67090112d4,0,0,0,0,0,0,0,0,0,0,0,0,0,0,364,10,0,0,0,0,0,0,0,0,0,1,100
e3e872a9da7ffdd2ac7cc0630f11133464b52e55,0,0,0,0,0,0,0,0,0,0,0,0,0,0,365,11,0,0,0,0,0,0,0,0,0,1,100
a53a891114feb310483d8797a3c49ca68d840d5c,0,0,0,0,0,0,0,0,0,0,0,0,0,0,366,12,0,0,0,0,0,0,0,0,0,1,100
5e3655ef3bf904bb9da34c79d7f93341c167c1c4,0,0,0,0,0,0,0,0,0,0,0,0,0,0,367,13,0,0,0,0,0,0,0,0,0,1,100
c5e613c7fca7d489ef74b1973611e10deb4f1aa7,1,7,1,6,0,0,0,14,96,166,1,1,0,2917,368,14,747,746,1,16290,16281,9,71,71,0,1,100
2178ebd53c22d879e66f2f11d7d06cc41f73c9b6,0,0,0,0,0,0,0,0,0,0,0,0,0,0,369,15,0,0,0,0,0,0,0,0,0,1,100
5ec9fbd0b78595084dc847f7fdc9da0506f6c482,0,0,0,0,0,0,0,0,0,0,0,0,0,0,12,0,0,0,0,0,0,0,0,0,0,1,100
ba696a959d24b0ee7da49ec0cfba05b57259a6ce,0,0,0,0,0,0,0,0,0,0,0,0,0,0,370,11,0,0,0,0,0,0,0,0,0,1,100
faae58f507fde28cfb45d76665571417a85870d2,5,275,112,163,0,0,0,1,90,305,2,5,1.724154058,5298,127,0,1081,1040,41,33789,32610,1179,229,216,13,1,99.8894875
32ee9faa51a0933ffb5d80f52535654f63941a3d,1,0,3,3,0,0,0,8,21,0,1,1,0,1300,128,1,286,286,0,7569,7594,25,37,37,0,1,100
03d4b3e1a053f0a79899051e1064213d2b66286a,4,321,2,319,1,0,1,1,22,413,3,3,1.153624844,1424,11,0,268,228,40,9378,7684,1694,62,49,13,1,95.2128402
53938ba0da2c4028cef9b3202c883d377f9ced6f,3,343,0,343,1,0,1,1,3,572,2,3,0.250934936,333,129,2,108,42,66,3917,1922,1995,19,8,11,2,99.97180716
2c163cd7351578e52b4c0cca4384023016b7a81c,0,0,0,0,0,0,0,0,0,0,0,0,0,0,130,3,0,0,0,0,0,0,0,0,0,1,100
c5c140d391c1bb8d683856e872b66f5fac5faf66,0,0,0,0,0,0,0,0,0,0,0,0,0,0,65,0,0,0,0,0,0,0,0,0,0,1,100
241b55993bbc884ea1451f31e3b4b40061f1a473,3,13,5,8,0,0,0,9,105,251,1,2,1.541982284,2066,371,8,375,373,2,12319,12276,43,90,89,1,1,100
bbb68a1b43c2f29c7389211e462959faab7d7988,0,0,0,0,0,0,0,0,0,0,0,0,0,0,13,1,0,0,0,0,0,0,0,0,0,1,100
7d3e3f83539e3ad2e9a5b968ceada4fe5e9b3356,1,12,0,12,0,0,0,8,8,660,1,1,0,203,14,2,34,32,2,1349,1246,103,6,6,0,1,100
05a6974bf5be84cb5338e97769d0756a08ee1090,0,0,0,0,0,0,0,0,0,0,0,0,0,0,1,0,0,0,0,0,0,0,0,0,0,1,100
01185485308296b1efe0bb413be4afaf0149be7a,1,13,13,0,0,0,0,21,91,33,1,1,0,2657,131,4,614,615,1,17689,17711,22,89,89,0,1,100
2644fa26f375dbd0f719971a62d9d2ad31bfe4a9,2,60,0,60,0,0,0,19,36,1366,2,2,0.122291597,1430,66,1,270,259,11,8595,8310,285,43,42,1,1,100
c570ffb0b9fcd2f577ae332e4c826ed94adf8497,0,0,0,0,0,0,0,0,0,0,0,0,0,0,67,2,0,0,0,0,0,0,0,0,0,1,100
bf7f3b26895845f3726a1bc8e0f5f2db5a9544a3,0,0,0,0,0,0,0,0,0,0,0,0,0,0,68,3,0,0,0,0,0,0,0,0,0,1,100
c00fc52f4779206309ee9b6e9cd464fbf0829c6c,1,11,6,5,0,0,0,8,23,41,1,1,0,687,12,1,113,112,1,3952,3915,37,22,22,0,1,100
a73ced56850d6858abe4dcc3d63c3c211b9203b1,13,1384,4,1380,8,0,8,1,200,151,2,5,3.18793466,7491,356,0,1669,1462,207,50412,44068,6344,355,246,109,1,96.39905549
312eeb4d816683e22844b4c59c3e7b9784a7ff3b,0,0,0,0,0,0,0,0,0,0,0,0,0,0,69,4,0,0,0,0,0,0,0,0,0,1,100
72200f343f60254b75daf3d4f3eac0be804a6a64,3,91,36,55,1,0,1,1,5,1885,1,1,1.546050812,250,15,2,30,27,3,1542,1293,249,16,15,1,1,99.96901147
cfae5c3cfba22d7a7baf68570c32ad65f8755609,1,1,1,0,0,0,0,1,2,41,1,1,0,331,132,3,64,64,0,1923,1923,0,11,11,0,1,100
e9d8c1c0b6a77a06183c423ee6cb77ab4ba000ec,1,1,1,0,0,0,0,2,5,291,1,1,0,1096,357,1,223,223,0,5951,5950,1,53,53,0,1,100
779ec1563b9da167fbd0b745fcaa8c545b3a64fe,0,0,0,0,0,0,0,0,0,0,0,0,0,0,372,0,0,0,0,0,0,0,0,0,0,1,100
119bd2cc530b4c82470b0f53e604b3986af397fe,1,5,5,0,0,0,0,15,97,109,1,1,0,2923,18,0,747,747,0,16290,16290,0,71,71,0,1,100
6fe1da81f1745536f1d4d755b2a7b975c7e74e98,0,0,0,0,0,0,0,0,0,0,0,0,0,0,40,0,0,0,0,0,0,0,0,0,0,1,100
f55d064f31329cba6bdceac1bd29d7a7de76b4b3,1,2,2,0,0,0,0,2,3,407,1,1,0,180,1,0,19,19,0,870,870,0,7,7,0,1,100
03d1c665bc9a239f4e5980542d2a4b3334ed2724,1,7,0,7,0,0,0,3,3,380,1,1,0,283,41,1,46,45,1,1710,1651,59,4,4,0,1,100
14ded0f6d2625d8a4eb497693d6fda62134dc40f,0,0,0,0,0,0,0,0,0,0,0,0,0,0,42,2,0,0,0,0,0,0,0,0,0,1,100
cf8548e153973ef94723d1959abc27671bd81e15,1,60,42,18,0,0,0,28,201,51,1,1,0,5493,10,0,1102,1098,4,37185,37155,30,126,126,0,1,100
888f50e1c785baec74a428847bd91b8353e3ffcc,0,0,0,0,0,0,0,0,0,0,0,0,0,0,70,0,0,0,0,0,0,0,0,0,0,1,100
64d87c1a7eef6b30227478b340980889e07e2816,4,1,295,294,0,0,0,8,23,371,1,3,1.399301494,1426,4,0,147,221,74,4617,6938,2321,69,81,12,2,99.93807091
645ad2f6b4a79c62a5ff5694cbc6b7bb198570fc,1,71,27,44,0,0,0,1,3,53,1,1,0,85,358,1,26,11,15,676,445,231,7,6,1,1,100
49b10e35eb9ed461c507696de687e88b713f4bea,1,1,1,0,0,0,0,2,3,532,1,1,0,89,19,1,9,9,0,412,408,4,5,5,0,1,100
5499dd5f6d41c875c51350d6aac5071a14e985fa,0,0,0,0,0,0,0,0,0,0,0,0,0,0,5,1,0,0,0,0,0,0,0,0,0,1,100
4c1ee073f58b598f121d22edb8a6acb034dd0cfa,1,4,5,1,0,0,0,5,33,374,1,1,0,499,359,1,90,90,0,2517,2532,15,17,17,0,1,100
6ca25d5a5b19bdc136a61a145f01120ef0f4d437,3,19,18,1,0,0,0,17,202,170,1,3,0.801619295,8340,360,2,1192,1194,2,57884,57888,4,189,189,0,1,100
9be6a7d01f8d6a83e740ac27225eda1fff83501a,36,2375,5415,3040,1,7,8,1,92,1670,3,13,3.220754893,14271,133,0,2048,2581,533,64679,79775,15096,550,655,105,1,98.13307803
25cd75ad107714ec27e2cb5f64d0a9cc3556519d,1,13,6,7,0,0,0,5,11,0,1,1,0,232,134,1,28,27,1,1389,1363,26,8,8,0,1,100
cacdab9b5ddd5a5fcd60d5ab873ad400f95c46bd,0,0,0,0,0,0,0,0,0,0,0,0,0,0,71,0,0,0,0,0,0,0,0,0,0,1,100
ca303c62100bbe800f5a8cc2d67588c8f4aaa549,0,0,0,0,0,0,0,0,0,0,0,0,0,0,72,1,0,0,0,0,0,0,0,0,0,1,100
2b98b58c606f8e9b3ac159739f1cf2261cfc1691,0,0,0,0,0,0,0,0,0,0,0,0,0,0,73,2,0,0,0,0,0,0,0,0,0,1,100
7a9ff9a29ab464e7057453f55581beb4faac1952,4,98,4,94,0,0,0,15,32,777,1,4,1.47741817,1999,74,3,372,351,21,12965,12308,657,70,67,3,1,100
0e9f58feb50b6a60f28c2d6c49245834771da4fa,0,0,0,0,0,0,0,0,0,0,0,0,0,0,1,0,0,0,0,0,0,0,0,0,0,1,100
6ac69435ac0da964d2911e53af112cbf21907608,1,57,36,21,0,0,0,16,43,58,1,1,0,1486,135,0,318,315,3,8908,8813,95,38,38,0,1,100
67a64a4a2c5c859613759ae77b8ff0094207e0f3,0,0,0,0,0,0,0,0,0,0,0,0,0,0,75,0,0,0,0,0,0,0,0,0,0,1,100
51da2b38337fb849694a2cfb95ca3cf5c8752a0f,0,0,0,0,0,0,0,0,0,0,0,0,0,0,76,1,0,0,0,0,0,0,0,0,0,1,100
5ef30420430c195597ea3b47f4027c5b60002b94,0,0,0,0,0,0,0,0,0,0,0,0,0,0,11,0,0,0,0,0,0,0,0,0,0,1,100
a9e637cf8289e8de5f440b5e7a526aafd573aa0a,3,155,28,127,0,0,0,25,204,254,1,3,0.135735044,10078,18,0,2084,2049,35,67058,66131,927,249,245,4,1,100
20038898779b8c509930181d9e0b6c69e65b6501,3,103,25,78,1,0,1,1,8,120,2,3,1.480222807,394,361,0,65,57,8,2556,2174,382,35,28,7,1,99.95060915
01f3408810de54c62ba8ac87f6ba2d58bb159743,1,99,18,81,0,0,0,16,98,116,1,1,0,2923,0,0,758,747,11,16577,16290,287,73,71,2,1,100
60e453f754cca269455608be41e253d322b4d528,1,160,0,160,1,0,1,1,1,0,1,1,0,0,13,0,19,0,19,785,0,785,7,0,7,1,94.49434946
6dcf2a8c587d6ec3f55b6a3506d1eaaad30bed48,1,8,8,0,0,0,0,1,1,0,1,1,0,160,14,1,19,19,0,785,785,0,7,7,0,1,99.94821336
dfe6bb643d3b27dcf6ceba1b30d2c2186c6772d5,1,3,1,2,0,0,0,7,86,301,1,1,0,1325,362,1,304,304,0,8135,8114,21,48,48,0,1,100
d5511352c63466a603a7090b7ee1b54b0a17060f,2,29,18,11,0,0,0,10,20,1894,2,2,0.973385435,656,6,0,192,188,4,4586,4477,109,20,20,0,1,100
2bacdc639c87773daf53f872137c2ebaee2c03cf,0,0,0,0,0,0,0,0,0,0,0,0,0,0,4,0,0,0,0,0,0,0,0,0,0,1,100
b7e26a6633746e54343c0714341c3d159502967a,3,14,3,11,0,0,0,4,65,634,1,2,1.332820405,2842,363,2,639,637,2,16427,16361,66,130,128,2,1,100
af384899abda5888414700beff26fc67a518b7e3,6,106,14,92,0,0,0,25,205,431,2,4,1.687017657,7582,364,3,1631,1616,15,47994,47283,711,230,227,3,1,99.9611399
5db01e9f38fbc561ab333a64ea289dd2de2c4e03,0,0,0,0,0,0,0,0,0,0,0,0,0,0,365,3,0,0,0,0,0,0,0,0,0,1,100
acb1193bfc383e37d59d0cbcaa9f7cb848dbd351,1,2,1,1,0,0,0,13,40,288,1,1,0,991,20,0,253,253,0,6441,6436,5,32,32,0,1,100
75578f0333cc8e1999704e3948715dba41309eb2,15,858,24,834,2,0,2,25,206,391,2,10,2.442057126,14288,21,1,3115,2937,178,86905,82238,4667,723,669,54,1,98.21722436
2fa64a613a7c907dd3b38c4f6e1f051fb8f52a51,4,180,12,168,0,0,0,4,41,1405,2,4,1.094084711,1558,22,2,326,306,20,10525,9476,1049,76,69,7,1,100
3f21afc42225a902bf13111b883e68d3c0e6a767,2,146,38,108,0,0,0,3,13,2508,1,1,0.946058435,238,23,3,45,27,18,1838,1041,797,10,7,3,1,100
68e4ee217d461d52a3e1f9ad0ed919219203076c,2,21,3,18,0,0,0,12,27,1553,1,2,0.994984828,774,24,4,113,109,4,4330,4235,95,29,29,0,1,100
94e347647b87096cb3ce8e7ed51f9cd27b795388,0,0,0,0,0,0,0,0,0,0,0,0,0,0,7,1,0,0,0,0,0,0,0,0,0,1,100
0b9694d5e7382fac95df12a30be598bd7dd4168a,2,135,3,132,1,0,1,1,4,126,2,2,0.473572925,143,136,0,34,18,16,1580,847,733,11,5,6,1,94.13138232
be62fcda9ae7728f4b3e9463cab94e52116722bb,1,1,1,0,0,0,0,1,2,2,1,1,0,405,25,5,96,96,0,2396,2398,2,24,24,0,1,100
be601220666a1694a293f25b39db729fa1d69358,9,65,136,71,0,1,1,3,57,1451,7,8,2.090707677,7518,373,0,996,1006,10,41018,41238,220,346,347,1,1,99.93312155
bf342aa72d1caedc8ebea58676597d002f161dbb,4,38,28,10,0,0,0,2,58,1587,3,4,1.570784788,3602,366,4,702,700,2,22498,22456,42,155,155,0,1,100
dda1e61f0040788fd713f23f05970efba50d95c7,2,122,79,43,0,0,0,13,42,4,2,2,0.080463137,1516,374,1,378,369,9,9851,9657,194,66,63,3,1,100
910b2cc8170240ddd3c533661dbaee8bcd0a8893,0,0,0,0,0,0,0,0,0,0,0,0,0,0,375,2,0,0,0,0,0,0,0,0,0,1,100
e0c36f801636b83dd35ae05c22217a1b004ad33f,0,0,0,0,0,0,0,0,0,0,0,0,0,0,376,3,0,0,0,0,0,0,0,0,0,1,100
45b476a813af2d3a918404709f7f644f0df0bd8d,1,96,73,23,0,0,0,16,99,65,1,1,0,3004,26,6,763,758,5,16784,16577,207,74,73,1,1,100
c778e92fb885207038edeb5df367c6d89c225167,0,0,0,0,0,0,0,0,0,0,0,0,0,0,377,4,0,0,0,0,0,0,0,0,0,1,100
5b8197c2ae63ec5d3428afa00829567943072b96,2,12,0,12,0,0,0,8,26,751,1,2,0.41381685,910,12,0,104,102,2,2964,2916,48,66,64,2,1,100
a2a772459bee8844bc545b9f93d258a2a3228a52,3,18,12,6,0,0,0,8,47,832,1,3,1.241946032,2086,13,1,186,185,1,16267,16221,46,74,74,0,1,100
bfae8135693345d9328bf683c02f94f306881df3,1,13,4,9,0,0,0,6,10,1293,1,1,0,116,19,0,25,25,0,620,555,65,4,4,0,1,100
1a9973fdb6d01654c449f554fe9cbe2c57e9b1bc,1,46,84,38,0,0,0,25,207,16,1,1,0,4434,20,1,920,929,9,28354,28601,247,101,103,2,1,100
0fb54a3d82b07fd3ba0988c682d8a1c88179a774,0,0,0,0,0,0,0,0,0,0,0,0,0,0,8,2,0,0,0,0,0,0,0,0,0,1,100
11130b093a3f3c732f4fe1744fa4c0e1de23d049,3,23,12,11,0,0,0,10,82,84,1,2,1.263481591,3720,367,4,741,738,3,21650,21605,45,176,175,1,1,100
d30c478fd9b17a2528faaef0a42d13c718c1d955,0,0,0,0,0,0,0,0,0,0,0,0,0,0,21,2,0,0,0,0,0,0,0,0,0,1,100
042512e4d1b304ec4da423434a4ba6143a174ed5,1,5,2,3,0,0,0,4,7,465,1,1,0,842,0,0,150,150,0,5246,5229,17,72,72,0,1,100
9376ec750ba63022e735f5dd216b3d7423344d81,3,100,0,100,0,0,0,4,6,1421,3,3,1.580557588,272,1,1,54,36,18,2103,1347,756,13,10,3,1,100
8a7a47a63ed5b0c0b8070ebc63a1dd447abc8be4,1,2,2,0,0,0,0,4,8,0,1,1,0,845,2,2,150,150,0,5246,5246,0,72,72,0,1,100
7be006f96b9c7e5e3c8a2658e79314b63a8df9f2,3,19,0,19,0,0,0,12,47,781,3,3,1.581030963,1357,3,3,217,217,0,7847,7722,125,34,34,0,1,100
194ed82d8adff0c7d2f8c6faa701f55f9f602e6e,4,47,27,20,0,0,0,2,13,944,1,1,1.885480388,1047,1,0,50,50,0,6668,6471,197,21,21,0,1,100
c2ef613a78b8b4478adcdcd8dd344da362532cdb,0,0,0,0,0,0,0,0,0,0,0,0,0,0,14,2,0,0,0,0,0,0,0,0,0,1,100
a9d578e1de1a5e0b21fa6a0f547386b222e545e3,3,27,9,18,0,0,0,13,48,0,3,3,1.584962501,1376,9,2,223,217,6,7964,7847,117,34,34,0,1,100
37a8128b8feb3bbcbdecae9cb12b96ff10e4d638,3,21,13,8,0,0,0,7,21,2413,1,3,1.429753806,1208,8,0,215,214,1,7523,7437,86,43,42,1,1,100
bdc35608991d465c29035b8a86e92def2186bc4b,1,48,0,48,0,0,0,17,100,8,1,1,0,3027,4,4,769,763,6,17114,16784,330,75,74,1,1,100
039c4b45430e5160ed4d2938ccfc63025ba1a86e,8,327,191,136,0,0,0,2,68,283,1,5,2.598175472,6249,368,5,1316,1270,46,37766,36368,1398,266,258,8,1,100
63434dd53cb7aed13b9cb7fbf0c83ca2ff3ae0e2,26,599,204,395,1,0,1,14,59,1728,8,17,3.588632805,10663,2,0,2093,2012,81,63049,60189,2860,406,390,16,1,94.62784179
ec8189ab42a9b922a56f6f3d280d7856a7393870,4,289,93,196,1,0,1,8,208,1221,2,4,1.241632441,4688,15,3,956,932,24,30817,29981,836,118,105,13,1,99.51845907
0b4eb4e75e42db7f861863d6a3f59a9e1e0dd4b2,0,0,0,0,0,0,0,0,0,0,0,0,0,0,2,0,0,0,0,0,0,0,0,0,0,1,100
630b2ddf345e5581d2c9e465db7797f2be79a81b,0,0,0,0,0,0,0,0,0,0,0,0,0,0,378,5,0,0,0,0,0,0,0,0,0,1,100
26127d6bf438e1c506c2ec398f2d6eb96b6f84ee,1,2,2,0,0,0,0,3,6,33,1,1,0,138,137,1,6,6,0,807,807,0,6,6,0,1,100
9db488807ae8731106c8d15ce9203df0fe8579c7,1,49,32,17,0,0,0,18,59,36,1,1,0,1779,27,2,339,333,6,12456,12313,143,102,100,2,1,100
2826e12e10061f4551b588be7d0fa79476766210,3,41,15,26,0,0,0,17,93,133,2,3,1.413799565,4735,138,1,1053,1046,7,30782,30557,225,142,142,0,1,100
f1d5bf18e6490d7b81d3550c61b08318a71691ec,0,0,0,0,0,0,0,0,0,0,0,0,0,0,10,0,0,0,0,0,0,0,0,0,0,1,100
44335cc5566bff27233286c0be7a7d2bb65396c9,0,0,0,0,0,0,0,0,0,0,0,0,0,0,11,1,0,0,0,0,0,0,0,0,0,1,100
f277f4f1dcc91bdd0487fdce046bb5d08fee34b5,8,196,76,120,0,0,0,25,209,384,2,5,2.437325398,8624,369,0,1871,1843,28,53881,52878,1003,281,277,4,1,100
7c0cc2835cead1b90107df114dd35bd7bb172e15,0,0,0,0,0,0,0,0,0,0,0,0,0,0,379,1,0,0,0,0,0,0,0,0,0,1,100
1a8df23a22af40d25a33cf42cfbcdf9de6035c2b,0,0,0,0,0,0,0,0,0,0,0,0,0,0,380,2,0,0,0,0,0,0,0,0,0,1,100
a302d8c515b89122827cb78095dd8ff408528a83,0,0,0,0,0,0,0,0,0,0,0,0,0,0,370,1,0,0,0,0,0,0,0,0,0,1,100
d894ad84d620a8b8da19c4ed2f9c25485fe8496b,8,668,68,600,4,0,4,10,28,761,2,4,2.600508707,1489,28,0,277,219,58,10549,8493,2056,58,40,18,1,99.85399328
38dbf7cceae8bc43aee53be4cc10d04a2821dda4,4,52,2,50,0,0,0,18,60,1117,2,3,0.905508323,3638,29,1,628,617,11,21844,21530,314,169,166,3,1,100
1a0fb59ce12064b60d98e234103aa8308639995f,1,58,29,29,0,0,0,3,9,42,1,1,0,545,371,1,119,109,10,3694,3469,225,23,23,0,1,100
09911ad82c0a136db10d4430b4a5bb3c82fb62cc,12,726,194,532,1,0,1,3,94,185,3,9,2.153171231,9332,139,0,1971,1852,119,58782,55675,3107,430,407,23,1,99.91245988
7e987c2865c501f77bb349c3eb8d5dc2b37a057a,2,5,4,1,0,0,0,14,210,643,1,2,0.99107606,6640,372,1,995,995,0,46185,46216,31,167,167,0,1,100
85b54777d5432a1781f86fb6037bc1dfe703dfb4,1,0,4,4,0,0,0,14,63,0,1,1,0,2163,373,2,64,64,0,17338,17361,23,64,64,0,0,100
1c855b31895eaf6301c6bf237b23f88b04ad2ac7,0,0,0,0,0,0,0,0,0,0,0,0,0,0,3,0,0,0,0,0,0,0,0,0,0,1,100
304a5a118fb5351dd0baa4c69f325fc4a674b3d3,0,0,0,0,0,0,0,0,0,0,0,0,0,0,381,0,0,0,0,0,0,0,0,0,0,1,100
0b36db3c7e53c8e11593901859001d7d856ba188,12,668,227,441,1,0,1,3,107,709,2,6,2.346394725,8993,374,3,2001,1932,69,55699,52875,2824,431,414,17,1,99.97081144
2d2aaa10493338d9912690238b8965e5ced0e1b2,0,0,0,0,0,0,0,0,0,0,0,0,0,0,4,1,0,0,0,0,0,0,0,0,0,1,100
8b8f2b9d88977c5194cfd7026896b250133dec2e,0,0,0,0,0,0,0,0,0,0,0,0,0,0,5,2,0,0,0,0,0,0,0,0,0,1,100
7cdbe14bc065df408130a0b117a37943a1055648,4,607,21,586,1,0,1,1,93,171,1,4,0.53094034,2309,375,1,542,484,58,16409,12610,3799,126,116,10,1,90.92903024
88c3915e51ff4b30a0d96a1855668cbcaeb45d38,1,53,4,49,0,0,0,18,61,64,1,1,0,1840,30,0,356,347,9,13027,12712,315,107,105,2,1,100
8a542c14a4991d06b61a514233726c81d62662b6,1,143,0,143,1,0,1,1,1,0,1,1,0,0,376,1,18,0,18,830,0,830,6,0,6,1,99.96618194
52a0f3ddaee7bd8f7b7d6d6dd355a60c082a8e0b,3,6,6,0,0,0,0,14,50,1683,3,3,1.459147917,1125,140,0,161,161,0,6640,6640,0,29,29,0,1,100
036fe4df863f6becc6e404b2a20b6d5136025eea,1,2,2,0,0,0,0,7,14,174,1,1,0,268,0,0,57,57,0,1221,1221,0,17,17,0,1,100
345296fa876c2dc120c9d806bbb5cad815c6b1e0,1,1,1,0,0,0,0,23,51,20,1,1,0,567,9,0,93,93,0,3848,3846,2,12,12,0,1,100
0c72d21ca917327ce25ef4bfb54ff0316de643d0,1,120,91,29,0,0,0,2,3,1143,1,1,0,449,16,0,64,57,7,3079,2913,166,12,12,0,1,100
580b99f911c93092967ed8bff1bf0ce88ff067f0,1,0,3,3,0,0,0,12,28,640,1,1,0,706,12,0,86,86,0,3619,3634,15,52,52,0,1,100
11a7bf8f37af1d7501df4492de95f7c9d796ab07,1,2,2,0,0,0,0,2,7,33,1,1,0,185,141,1,25,25,0,934,934,0,10,10,0,1,100
adb0735e336e99c2a6d1a20fcd4a8892f9e4a4a7,2,79,3,76,0,0,0,21,61,98,1,2,0.226410948,2259,142,2,494,477,17,12979,12453,526,114,113,1,1,100
26e38207b6a2993745229610b8e3a48adf1f3b48,2,49,28,21,0,0,0,28,204,168,2,2,0.237508144,5716,377,0,1165,1160,5,38514,38420,94,129,129,0,1,100
b9aed233726ed75cf2b7b2dabe36b9244d71f529,0,0,0,0,0,0,0,0,0,0,0,0,0,0,77,0,0,0,0,0,0,0,0,0,0,1,100
a1c40ba7f2a7ed554ee6fdb49569a114b9bdb491,5,99,42,57,0,0,0,2,91,968,1,4,1.479011044,2430,378,1,541,539,2,14921,14313,608,117,117,0,1,98.74246339
847c2809b3a8b731316112edcff76e1befd8223b,3,427,319,108,0,0,0,14,95,772,1,3,0.091383677,8022,143,1,1036,1015,21,63008,62486,522,330,329,1,1,100
f371e186087e049f039d7549aed4ee0ba69fb146,1,7,4,3,0,0,0,2,4,403,1,1,0,89,31,0,10,9,1,434,412,22,5,5,0,1,100
1fbd0a31527d87a5d2d0bb239ac4ca9be3a58b57,11,617,0,617,1,0,1,1,24,2175,1,2,1.054725322,852,22,0,201,124,77,7319,3593,3726,76,48,28,1,96.55113829
ede568667973c96b1be5dcba8117c18725a98f58,1,1,0,1,0,0,0,10,19,1022,1,1,0,170,6,0,16,16,0,859,850,9,3,3,0,1,100
06dfdcd7f7baec8df32452b1edeb4ef7770ba0ca,0,0,0,0,0,0,0,0,0,0,0,0,0,0,32,1,0,0,0,0,0,0,0,0,0,1,100
f5cc6680ce595ec7566210024bdafbca9461e966,0,0,0,0,0,0,0,0,0,0,0,0,0,0,5,0,0,0,0,0,0,0,0,0,0,1,100
b077acb99a8543f1f040857bb0fa47cfa3972eaf,15,1,1544,1543,0,7,7,6,84,2947,3,8,2.653695599,7336,382,0,576,803,227,37403,44153,6750,313,419,106,1,99.75259772
c20d0e0a65aed8f7fbd8020acfe1612c9b7887f8,15,1095,540,555,1,0,1,15,205,564,3,8,2.825509908,17640,379,1,3121,3000,121,125739,122719,3020,583,564,19,1,99.83501072
cc21e670f32d5033d8b0be938466d5bb813964cb,0,0,0,0,0,0,0,0,0,0,0,0,0,0,383,1,0,0,0,0,0,0,0,0,0,1,100
f04a7f24945c15909b3eea2ee82decf6b1f4a598,7,1107,151,956,5,0,5,1,17,605,1,2,2.42265106,552,16,0,220,104,116,6650,2800,3850,42,16,26,1,99.75369458
da4500ee114513f87698fa7be88da4f5b70c0ab2,0,0,0,0,0,0,0,0,0,0,0,0,0,0,78,0,0,0,0,0,0,0,0,0,0,1,100
18dca4e396d710a7b8cf4c657cdffa50ef513395,0,0,0,0,0,0,0,0,0,0,0,0,0,0,13,0,0,0,0,0,0,0,0,0,0,1,100
438d91ba87b798aad28b9bda8f6a316407b16f8e,0,0,0,0,0,0,0,0,0,0,0,0,0,0,14,1,0,0,0,0,0,0,0,0,0,1,100
30836f8def9a7cf8eeac1e0cf13634edf3a243ea,1,17,11,6,0,0,0,2,3,40,1,1,0,45,380,1,0,0,0,160,160,0,0,0,0,1,100
ed9a6beda01f9edf6e41f7439c6d3a676cec8574,0,0,0,0,0,0,0,0,0,0,0,0,0,0,384,1,0,0,0,0,0,0,0,0,0,1,100
74f5a5e237639c8e542a6336bfe2ce7e1690aa27,0,0,0,0,0,0,0,0,0,0,0,0,0,0,79,1,0,0,0,0,0,0,0,0,0,1,100
7bfb57a3dc7fa48935c8a252b01b427481307ce2,1,3,1,2,0,0,0,2,10,155,1,1,0,1213,381,1,254,253,1,6676,6666,10,59,59,0,1,100
1fd1c1e126dbad83d9d6fdb581e4e52777be39c2,1,36,2,34,0,0,0,12,41,104,1,1,0,1062,144,0,196,188,8,6673,6447,226,13,13,0,1,100
bb797b97710bbcff6fa15701fa99bc1b6fa460ab,0,0,0,0,0,0,0,0,0,0,0,0,0,0,80,2,0,0,0,0,0,0,0,0,0,1,100
aca977f8359d6208ef4e52c3ba598045737ca01a,1,4,2,2,0,0,0,12,42,2,1,1,0,1096,145,1,196,196,0,6703,6673,30,13,13,0,1,100
1ca3846f592013bab38f1fcbdab2edb6d8b5bf5c,8,343,358,15,0,0,0,14,211,148,2,6,2.236687752,16256,382,2,2957,2959,2,106882,107080,198,517,518,1,1,99.58506224
b31f38b74876f8463f9da89b6991610e6b5bf5c3,3,21,141,120,0,1,1,1,4,713,2,2,1.018811611,879,6,0,84,106,22,5246,5716,470,61,69,8,1,99.93267127
ba6b92dd765528bd1b1e1264b45f27ffc0bb8e15,0,0,0,0,0,0,0,0,0,0,0,0,0,0,10,0,0,0,0,0,0,0,0,0,0,1,100
50992b38e6c5025b58d5cb75c79117660d65d209,4,65,12,53,0,0,0,17,96,231,2,4,1.621521726,6630,146,2,1520,1507,13,41514,41172,342,261,259,2,1,100
c32688c2c89d5ea646b6e112932978d19edca8d7,1,19,0,19,0,0,0,4,15,3,1,1,0,917,383,3,207,201,6,5778,5635,143,41,41,0,0,100
2c8321353265fa55287051a56c80fd15a6e939ad,1,1,0,1,0,0,0,12,95,3,1,1,0,910,384,4,182,182,0,4886,4875,11,55,55,0,1,100
1825aa2306eb024ee20f9e1fe737699862217409,1,14,3,11,0,0,0,3,3,2125,1,1,0,307,385,5,41,41,0,2079,1955,124,10,10,0,1,100
ca4590019b187d5a54938e672f3e456630c063c1,0,0,0,0,0,0,0,0,0,0,0,0,0,0,7,1,0,0,0,0,0,0,0,0,0,1,100
4341dd420c9ad0becd1a77ee2551b99322186b3d,0,0,0,0,0,0,0,0,0,0,0,0,0,0,17,0,0,0,0,0,0,0,0,0,0,1,100
0c6752205d849fad674e5f907679a3eaa98433f5,1,11,1,10,0,0,0,8,21,997,1,1,0,391,33,0,50,49,1,1866,1823,43,12,12,0,1,100
e57cbf095add61bb7dffd401a8bec92d0ced55df,0,0,0,0,0,0,0,0,0,0,0,0,0,0,11,1,0,0,0,0,0,0,0,0,0,1,100
147168e46aa2a149b63c7cf63f757feff679d9d2,0,0,0,0,0,0,0,0,0,0,0,0,0,0,15,0,0,0,0,0,0,0,0,0,0,1,100
4a92117d0e40a6b386996d0addd0d8b3b23bed7b,2,26,4,22,0,0,0,5,26,90,1,2,0.353359335,1644,386,4,364,358,6,9417,9226,191,76,76,0,1,100
ac6d8bf3ae4bc0a2c66660cb75a7c15014cf6f8c,0,0,0,0,0,0,0,0,0,0,0,0,0,0,1,0,0,0,0,0,0,0,0,0,0,1,100
57b6f98a1457ebef45dedfb9aa5bde9f09638c4b,16,2608,271,2337,8,0,8,1,31,1481,1,4,2.875078746,3578,34,1,907,546,361,27875,16738,11137,263,159,104,1,99.68072593
686d6144eefe5470232a9704729d5fbef299f7dd,0,0,0,0,0,0,0,0,0,0,0,0,0,0,81,0,0,0,0,0,0,0,0,0,0,1,100
90a6037d5611bb6ee725febd78e4de3ffe5971cf,0,0,0,0,0,0,0,0,0,0,0,0,0,0,82,1,0,0,0,0,0,0,0,0,0,1,100
01efbd0b41750266fe6804d4e0ba21e81f3cd9a3,0,0,0,0,0,0,0,0,0,0,0,0,0,0,83,2,0,0,0,0,0,0,0,0,0,1,100
3da2dee2d98c21f67565dcd01fa2a899aee9cc5b,0,0,0,0,0,0,0,0,0,0,0,0,0,0,8,1,0,0,0,0,0,0,0,0,0,1,100
ff0682b35dd6008627c87695b19d607e57548f62,3,352,0,352,2,0,2,1,207,23,1,2,1.116581013,5755,23,0,1203,1153,50,40641,38769,1872,144,131,13,1,99.81568365
9b6fad5787a37829dbd4f25c29040663127ee452,0,0,0,0,0,0,0,0,0,0,0,0,0,0,12,0,0,0,0,0,0,0,0,0,0,1,100
24094cecc5054c8fd898ec870a060538e147816b,0,0,0,0,0,0,0,0,0,0,0,0,0,0,84,3,0,0,0,0,0,0,0,0,0,1,100
17173e575e2721946fc82accbee6829251afb341,0,0,0,0,0,0,0,0,0,0,0,0,0,0,85,3,0,0,0,0,0,0,0,0,0,1,100
668ca16b1455d379e834ca0d1102f48a8ec7e68e,1,6,2,4,0,0,0,24,52,230,1,1,0,567,5,0,93,93,0,3890,3848,42,12,12,0,1,100
6c89ae8213e49d8dd039b769e8d3b374acf0c3fe,0,0,0,0,0,0,0,0,0,0,0,0,0,0,13,1,0,0,0,0,0,0,0,0,0,1,100
ab5aab216e3cf7477a2151c24a1f29e9991aa548,1,2,2,0,0,0,0,7,10,1332,1,1,0,143,2,0,23,23,0,764,764,0,5,5,0,1,100
4e45ed274114a7b3c693373102d1fed623539f13,1,9,5,4,0,0,0,5,6,1014,1,1,0,416,3,0,50,49,1,2354,2325,29,10,10,0,1,100
9696e41c16015c5044329088e74fa810700e8388,2,49,13,36,0,0,0,6,20,1014,1,2,0.345117315,577,387,0,126,113,13,3164,2955,209,58,56,2,1,100
be025adeb10170218a9bd520be86a13c6e4f72b8,1,5,18,13,0,0,0,12,35,1400,1,1,0,341,35,0,44,45,1,1741,1834,93,11,11,0,1,100
eef8f45205847cf4aeb39336563e8f54e5230c29,0,0,0,0,0,0,0,0,0,0,0,0,0,0,388,1,0,0,0,0,0,0,0,0,0,1,100
4f1785a79aabb6314f6e241ecc8f76c7f4eda0e4,1,25,7,18,0,0,0,17,101,422,1,1,0,3075,36,1,775,769,6,17235,17114,121,76,75,1,1,100
a871937e6fd6eb26c343a9fda590190b89fea277,0,0,0,0,0,0,0,0,0,0,0,0,0,0,37,2,0,0,0,0,0,0,0,0,0,1,100
1eb702ab45f43636a45961135286214b41bbcd17,6,121,118,3,0,0,0,1,208,786,2,6,2.240476632,8268,389,2,1721,1724,3,53718,53684,34,239,241,2,1,100
62a0719da3a05ce1c3325d97439d03b4d391c2d0,0,0,0,0,0,0,0,0,0,0,0,0,0,0,86,2,0,0,0,0,0,0,0,0,0,1,100
77091940b1b032ec11ff6d3707959621cb6f33f5,0,0,0,0,0,0,0,0,0,0,0,0,0,0,87,3,0,0,0,0,0,0,0,0,0,1,100
360379d3ef89570abbad6f066b775214767daefb,2,1,40,39,0,0,0,12,37,598,2,2,0.281193796,1426,147,0,232,239,7,8430,8641,211,45,46,1,1,100
e219c2511c131a78a04b11e534240b031d72e862,0,0,0,0,0,0,0,0,0,0,0,0,0,0,14,1,0,0,0,0,0,0,0,0,0,1,100
72a58ea04248c44d6ffc1337e61bdefc31992de1,0,0,0,0,0,0,0,0,0,0,0,0,0,0,15,2,0,0,0,0,0,0,0,0,0,1,100
f84adce7c6988419ac1d9d59b6f347ea09636dc2,6,130,60,70,0,0,0,3,63,315,2,5,1.646668933,3628,148,1,792,783,9,20357,19960,397,210,205,5,2,99.89949749
65c778c62b36ea736bd9f95af14f0e6183f91524,5,15,18,3,0,0,0,1,96,59,2,5,1.872627741,3044,390,3,671,669,2,17729,17695,34,134,134,0,1,100
a8ecae82e5d15ce1d40eb4d5b9d01b0c55cb958e,2,3,3,0,0,0,0,1,49,0,1,2,0.918295834,2035,149,2,408,408,0,12269,12269,0,55,55,0,1,100
933479e31a76c457db00cedf3758670b84c99387,7,97,12,85,0,0,0,12,97,899,1,4,2.088110018,8886,385,0,1946,1925,21,46275,45672,603,603,599,4,1,99.96651599
62c9aeca807bd056c69a4b902db32a962c13590a,0,0,0,0,0,0,0,0,0,0,0,0,0,0,16,2,0,0,0,0,0,0,0,0,0,3,100
c50fe0310c54fc7e264834e2600c26c798ee0da8,1,1,1,0,0,0,0,4,4,139,1,1,0,318,17,3,41,41,0,2082,2079,3,10,10,0,1,100
900a027f32410a0282ec705aeddf4de66705e462,2,16,12,4,0,0,0,6,209,1714,1,2,1,6286,16,0,1229,1229,0,42563,42535,28,139,139,0,1,100
51c7bff02399b0d4a6c80314705403ad97d412c8,0,0,0,0,0,0,0,0,0,0,0,0,0,0,6,0,0,0,0,0,0,0,0,0,0,1,100
a82c5c7ce1c45b0f069dce45cf0e40539aa96db6,3,24,0,24,0,0,0,1,43,276,1,2,1.143155878,1576,150,3,238,231,7,9497,9309,188,39,38,1,1,100
89cd470154abc6221ac95cff41d0970d07b0b61f,2,50,58,8,0,0,0,3,210,588,1,2,0.764204507,5977,391,1,1182,1186,4,39768,39804,36,136,136,0,1,100
7a2e6d92a0aa7344509b1b4aed9846ac9118c472,3,103,175,72,0,0,0,25,212,666,1,2,1.541960008,5339,392,2,1031,1020,11,33222,33400,178,129,129,0,1,100
57d7455c69051e7f29ac8702ea0ac47dbd0b18c0,4,11,5,6,0,0,0,9,211,841,2,4,1.805036533,7235,3,0,1352,1350,2,48930,48852,78,189,189,0,1,100
de3474c9b4ee8ab790ab3ad2a782baf5163fdd95,0,0,0,0,0,0,0,0,0,0,0,0,0,0,88,0,0,0,0,0,0,0,0,0,0,1,100
050cec06a7699c463eceda508afa02695781a45a,0,0,0,0,0,0,0,0,0,0,0,0,0,0,18,4,0,0,0,0,0,0,0,0,0,1,100
642721fe1ee5cfe1064c1ed94a25c1ccf9ca1148,2,195,43,152,0,0,0,4,15,3000,1,1,0.458248908,383,19,3,93,61,32,3146,2035,1111,15,10,5,1,99.93303198
e01d39c954fa196c321f7f91ef15a518b34bde49,2,91,38,53,0,0,0,1,5,172,2,2,0.518569732,759,9,0,94,84,10,5643,5246,397,64,61,3,1,100
7d2afd7d17d768601e9f9e860ed10ab49e6c9c9a,1,1,3,2,0,0,0,13,43,501,1,1,0,1154,38,0,280,282,2,7446,7455,9,42,42,0,1,100
b60a6e291e960ea915155b414fa3c43378386720,0,0,0,0,0,0,0,0,0,0,0,0,0,0,386,0,0,0,0,0,0,0,0,0,0,1,100
039940365d9f319a6ca0df05b72fc566a09d895d,2,22,4,18,0,0,0,25,213,32,2,2,0.619382195,5279,393,2,1096,1093,3,33014,32935,79,160,160,0,1,100
a1f06916e3fb295dfdeba0fe082afc9174ece512,1,2,1,1,0,0,0,11,22,489,1,1,0,418,4,0,148,146,2,3074,3056,18,11,11,0,1,100
fc942a2c014e108ddc0e5265a1ae9f0162738da5,1,20,5,15,0,0,0,1,2,1755,1,1,0,168,394,3,18,18,0,698,632,66,11,11,0,1,100
c33d74a80dd2e75296458e40e28fe32d98e8e520,6,524,95,429,0,0,0,5,109,723,1,4,1.849370612,5341,387,1,1319,1208,111,33252,30436,2816,315,279,36,1,100
7691bce9f37c4c0197468f7e236bd3ef9a54b7b0,7,144,4,140,0,0,0,17,50,1770,3,3,2.795687763,2578,151,1,534,508,26,14370,13698,672,179,155,24,0,100
8c385c8176022e5f448224361cb9fbda60238a4a,1,7,2,5,0,0,0,4,6,0,1,1,0,544,388,2,125,125,0,3496,3469,27,49,49,0,1,100
2ac6feb14c7866537b2a936d326c08d3f37e0311,2,13,12,1,0,0,0,17,97,95,2,2,0.634309555,5022,152,2,1145,1141,4,32630,32599,31,147,147,0,1,100
e05098fc9bb2a54b8713e5e4d9fc9e9c6bcb3655,7,53,23,30,0,0,0,9,110,796,3,6,2.354985382,5018,39,1,989,983,6,29474,29304,170,222,218,4,1,99.94976557
c336699753729af5d850776763013956bfa740b4,2,53,4,49,1,0,1,1,7,30,1,2,0.669996032,201,0,0,32,31,1,1114,927,187,6,5,1,1,98.37465112
5bb31423f68768d0e4a3ab7260432048076cc72b,1,2,0,2,0,0,0,7,20,438,1,1,0,611,153,2,98,98,0,3368,3350,18,13,13,0,1,100
11b0d3a8c857eed0b31bae389d360cfe0dad630a,0,0,0,0,0,0,0,0,0,0,0,0,0,0,389,2,0,0,0,0,0,0,0,0,0,1,100
18018d23c2681b04bdfe5da97a367247718d66d5,1,18,0,18,0,0,0,4,6,1840,1,1,0,227,17,0,67,61,6,1200,1108,92,24,22,2,1,100
d8db40445dc3a1920468f0dc6231ca6f9deb4407,0,0,0,0,0,0,0,0,0,0,0,0,0,0,89,0,0,0,0,0,0,0,0,0,0,1,100
68d5f57273ee05b05dceca33397fe8ac2b7337fc,0,0,0,0,0,0,0,0,0,0,0,0,0,0,90,1,0,0,0,0,0,0,0,0,0,1,100
4a87e3203ad18155e82b172e9754aa0fdc3554e7,8,363,198,165,0,0,0,2,31,2353,2,7,1.935699736,2767,395,0,538,500,38,15292,14261,1031,105,101,4,1,95.98662207
4b85ec8246f4b8d330960a26eda51ecb77468f1f,0,0,0,0,0,0,0,0,0,0,0,0,0,0,62,0,0,0,0,0,0,0,0,0,0,1,100
0184d93d3a0185dc589a5ed1226f418305371fb3,3,332,23,309,1,0,1,1,24,550,2,3,0.628697111,1248,15,0,253,206,47,8972,7258,1714,54,40,14,1,92.32778322
accecd25a3587bf3c6c513029f183d2632348e9b,1,1,1,0,0,0,0,22,98,56,1,1,0,3159,24,0,739,738,1,21355,21345,10,99,99,0,1,100
b06f86997e95cdaa29d3f74bc40a3f689d6cb0e7,1,1,1,0,0,0,0,4,8,37,1,1,0,348,0,0,80,80,0,1891,1891,0,26,26,0,1,100
0baae220f646f35a73e00da94f47fbb57d616a9d,0,0,0,0,0,0,0,0,0,0,0,0,0,0,396,1,0,0,0,0,0,0,0,0,0,1,100
0d848289b497ba0fd470a3214feb71c215ce8361,2,2,2,0,0,0,0,7,21,276,1,1,1,928,154,0,144,144,0,5167,5167,0,25,25,0,0,100
c455ffa79ecb5c6d73d068890a3457b084afc85a,1,89,59,30,0,0,0,6,7,173,1,1,0,420,17,0,53,50,3,2455,2354,101,10,10,0,1,100
21b7ce54991594162c1868eb994640dfbde5593b,3,28,34,6,0,0,0,3,5,1782,1,2,0.409633444,664,20,0,57,57,0,3300,3374,74,35,35,0,1,100
9651c029e95bf09bb7054308fee1abb1a236d49f,0,0,0,0,0,0,0,0,0,0,0,0,0,0,91,0,0,0,0,0,0,0,0,0,0,1,100
c8c582d53efcbffa65f11a101ae328ae0e83f105,0,0,0,0,0,0,0,0,0,0,0,0,0,0,155,0,0,0,0,0,0,0,0,0,0,1,100
3b6583a2beb96c40c647f415bff01d97f0923bec,8,343,138,205,0,0,0,9,111,748,2,5,1.827340673,6121,40,0,1475,1418,57,35288,34231,1057,248,233,15,1,99.50930626
04a7140ac86ed52a5b3c9463db8e0891d8638253,0,0,0,0,0,0,0,0,0,0,0,0,0,0,63,0,0,0,0,0,0,0,0,0,0,1,100
596c30c74692ab528dc18038c609ef98d0d0e0cf,0,0,0,0,0,0,0,0,0,0,0,0,0,0,64,1,0,0,0,0,0,0,0,0,0,1,100
a1191d7292fa44e05a9c6e09f513ccf881760a8f,2,13,4,9,0,0,0,4,45,124,1,2,0.672294817,1506,397,0,306,304,2,9404,9342,62,61,61,0,1,100
5cc2a352778c324ea6f35090078111b511fdb510,1,67,34,33,0,0,0,30,212,174,1,1,0,5770,65,2,1156,1152,4,39131,38871,260,131,131,0,1,100
ca1f9469b4341db94ec214ac02715ec86798f2f3,6,118,31,87,1,0,1,3,52,2295,2,5,1.756592631,2970,66,3,499,472,27,16257,15798,459,116,110,6,1,99.96622763
1a0782272852e23e5aa4d9f87a65d69e9fc50eeb,0,0,0,0,0,0,0,0,0,0,0,0,0,0,92,0,0,0,0,0,0,0,0,0,0,1,100
6bf1ff25e6964d34d7bfdf0224e96624d7dbfc14,0,0,0,0,0,0,0,0,0,0,0,0,0,0,93,1,0,0,0,0,0,0,0,0,0,1,100
c050902d401ea6c44bfbce7c1363ced56c3ec5d2,4,27,20,7,0,0,0,9,53,1690,1,3,1.631047299,4079,67,4,464,463,1,29459,29293,166,130,130,0,1,100
7eef860348d8cc5d1a7d1ff2e1e915a04d571a02,0,0,0,0,0,0,0,0,0,0,0,0,0,0,41,1,0,0,0,0,0,0,0,0,0,1,100
77a99893cfae4c330734740a95e4cc25f05ca667,7,72,17,55,1,0,1,1,24,1531,1,3,1.992061607,2036,21,0,294,295,1,11229,11012,217,95,93,2,0,99.81459633
8cf1668c165c9a981d47597a4cfc693169debf18,2,59,15,44,0,0,0,8,93,991,1,1,0.639457132,1519,398,1,351,344,7,9475,9183,292,67,67,0,1,95.34007195
0f60a401ce36737da905f77b8d98fc4851b69aee,5,91,71,20,0,0,0,5,112,342,1,4,1.770489918,3442,399,2,799,795,4,20913,20705,208,167,164,3,1,100
0c0271651b553409a604cf773dd3b29f0c07bd5d,5,270,28,242,0,0,0,4,21,741,1,4,1.974737083,1022,390,0,180,159,21,6970,5131,1839,63,58,5,1,100
f7d334589494e32f75f07beb8c7222164967b5a2,1,13,3,10,0,0,0,24,53,269,1,1,0,571,7,0,96,93,3,3966,3890,76,12,12,0,1,100
f5b3f1e1871c9ad53db3491f16288c0810c0ab75,0,0,0,0,0,0,0,0,0,0,0,0,0,0,42,2,0,0,0,0,0,0,0,0,0,1,100
6406df1c6151aaedeba870e31f50c7100a24d5e0,1,1,1,0,0,0,0,24,54,18,1,1,0,581,8,1,96,96,0,3962,3966,4,12,12,0,1,100
a395c181a10fe660121d486c87c830697278c2b2,1,3,3,0,0,0,0,17,103,46,1,1,0,3140,68,3,792,792,0,17398,17398,0,77,77,0,1,100
637c2d9c32e3d8fd2d0a09ef6512eda811198f32,1,12,1,11,0,0,0,9,9,960,1,1,0,215,22,1,35,34,1,1456,1349,107,6,6,0,1,100
a1ec8ebe898af4990c2f4dd24bc08923c0c168d7,1,22,24,2,0,0,0,8,14,827,1,1,0,1305,25,0,250,256,6,8031,8106,75,32,32,0,1,100
77163ee10568a15621ca1efd2291741f1f9e9dc2,1,81,35,46,0,0,0,7,15,1626,1,1,0,232,18,0,37,33,4,1624,1358,266,8,7,1,1,100
e5598f6ea881825fcde046e4002d46f6e2d06007,0,0,0,0,0,0,0,0,0,0,0,0,0,0,19,1,0,0,0,0,0,0,0,0,0,1,100
f6c61852c6fb87528b2ca3627d2969cb26cfd4e1,3,28,1,27,0,0,0,13,99,338,1,3,1.217016339,4995,18,0,991,987,4,32410,32230,180,211,209,2,1,100
5b186d543a3c671bfdc792135266184ab5c585d9,4,152,0,152,0,0,0,6,213,203,1,2,0.913370756,9567,26,1,2036,1994,42,64880,63809,1071,267,263,4,1,100
5a07338439dc9a1de10a3066ebe17aed7de2239c,2,3,1,2,0,0,0,8,95,42,1,1,1,1508,400,0,343,343,0,9193,9185,8,66,66,0,1,100
df73558c0f7000a942b08e6e2fee056b16c8846f,1,1,0,1,0,0,0,11,23,47,1,1,0,358,20,2,65,65,0,1756,1747,9,43,43,0,1,100
0e18a748c63e1a5a84338422be672e112228a4d8,0,0,0,0,0,0,0,0,0,0,0,0,0,0,27,2,0,0,0,0,0,0,0,0,0,1,100
31976fdeda190bcd1c3608a6989d35e4173834ca,0,0,0,0,0,0,0,0,0,0,0,0,0,0,23,1,0,0,0,0,0,0,0,0,0,0,100
aca73deb28b567ce7ea6d4f508e7ab6ab813c0fd,1,2,0,2,0,0,0,17,104,45,1,1,0,3140,43,0,794,792,2,17404,17398,6,77,77,0,1,100
c8742481f7ce581b3050b2dfb0b02cdca662da3e,1,13,6,7,0,0,0,17,105,1,1,1,0,3142,44,1,797,794,3,17427,17404,23,77,77,0,1,100
1bbff57fed892c9907268fd2dceb00ea4803d7fd,2,107,1,106,0,0,0,17,106,917,1,1,0.780584932,3469,45,2,887,866,21,19821,19215,606,95,91,4,1,100
368b9811356382741e52d3081f07a2dfeef7907e,0,0,0,0,0,0,0,0,0,0,0,0,0,0,0,0,0,0,0,0,0,0,0,0,0,1,100
10f51810b37062b3a2dc7c90e92dd6a25b8d88d1,1,1,0,1,0,0,0,11,24,32,1,1,0,359,21,1,65,65,0,1765,1756,9,43,43,0,1,100
7dc0950191203253d8a598283a15b91ab2c4660a,0,0,0,0,0,0,0,0,0,0,0,0,0,0,94,0,0,0,0,0,0,0,0,0,0,1,100
30730b1f691ba5ff7ebcddab78102c18b4deb734,0,0,0,0,0,0,0,0,0,0,0,0,0,0,19,0,0,0,0,0,0,0,0,0,0,1,100
9c69c0b25812ef977bb5d351ed312437ca3e53cd,6,94,45,49,0,0,0,15,214,350,2,6,2.076667606,7174,401,0,1430,1420,10,47591,47314,277,170,169,1,1,100
bc42f47d65090cef2ab69af51d3dff511ea30565,2,70,14,56,0,0,0,16,101,279,1,2,0.791858353,6734,24,1,884,875,9,55560,54943,617,237,234,3,1,99.25373134
8c56ed3f753cbd7a948b994485d4c27b5215bfda,0,0,0,0,0,0,0,0,0,0,0,0,0,0,22,2,0,0,0,0,0,0,0,0,0,1,100
1ea8274b80482d9d21037fd87f2af7f7a708f998,17,175,14,161,0,0,0,18,102,913,3,7,3.653956485,11209,0,0,2052,2036,16,62213,61676,537,541,525,16,0,100
f29d37e7440b78ebbf13b5df9e69e64ce2d460a1,14,1397,409,988,0,0,0,12,101,1032,2,5,1.50085774,5923,46,3,1287,1081,206,39488,33489,5999,302,258,44,1,100
9360cf02a02bea2fc8a17d9decb3afb3b808d13b,2,58,29,29,0,0,0,5,103,374,1,2,0.608400215,3459,156,0,784,781,3,23450,23242,208,111,111,0,1,100
ecb7a83e23a8a1f60e6241679354a4da874a53ab,0,0,0,0,0,0,0,0,0,0,0,0,0,0,23,2,0,0,0,0,0,0,0,0,0,1,100
86a87b9e6c61eaf803f3527ba3a6ab4af11b696c,2,15,1,14,0,0,0,2,215,1049,1,2,0.337290067,6153,69,0,1234,1231,3,41107,41037,70,160,158,2,1,100
7dfff5935f2ec98881a6441eda756bc4723e4400,0,0,0,0,0,0,0,0,0,0,0,0,0,0,70,1,0,0,0,0,0,0,0,0,0,1,100
9d012fa1c2a9eb1dfa5ac24f160e34d07edc6053,1,37,13,24,0,0,0,30,216,2,1,1,0,5953,25,1,1203,1196,7,40395,40177,218,135,135,0,1,100
79f21e1de687e5bbf7b24f2695033c7f0825775f,0,0,0,0,0,0,0,0,0,0,0,0,0,0,95,1,0,0,0,0,0,0,0,0,0,1,100
a1f1fc8fb2438a50ad0d16224adc9c921a6057de,0,0,0,0,0,0,0,0,0,0,0,0,0,0,71,2,0,0,0,0,0,0,0,0,0,1,100
fd90d0d4d37b2a2ca4c82b641929153a4dfb31dd,6,158,93,65,0,0,0,7,24,2048,1,5,1.981804653,2278,157,1,305,292,13,11585,11062,523,80,78,2,1,99.94570136
6bf45ebc0c86ceb599f8d3db130a0e833aa88700,0,0,0,0,0,0,0,0,0,0,0,0,0,0,24,2,0,0,0,0,0,0,0,0,0,1,100
91cf22c81bfece412462b641600de12a8e849b30,1,1,1,0,0,0,0,11,40,298,1,1,0,1706,0,0,358,358,0,7974,7974,0,141,141,0,1,100
9a65430647be51aa52f3a61fcf3cb505bfb747c0,1,13,0,13,0,0,0,14,46,152,1,1,0,1162,0,0,284,282,2,7550,7498,52,43,42,1,1,100
670567dae68e158f865eef841d8de167e0bbfa63,1,11,3,8,0,0,0,9,96,90,1,1,0,1308,1,1,305,304,1,8129,8080,49,47,47,0,1,100
218c06ff54f389a2ee57d80e156ecbf7364a51ec,9,324,63,261,0,0,0,5,113,268,1,5,2.306806049,5125,402,0,1181,1133,48,32187,30232,1955,231,221,10,1,94.29908161
f636ad05ba32cc3f11d924330376a0a5a4c88323,0,0,0,0,0,0,0,0,0,0,0,0,0,0,25,2,0,0,0,0,0,0,0,0,0,1,100
1bf7a8c76a2d6d4616307052733f42ac65b8ea47,2,44,4,40,0,0,0,11,114,12,1,2,0.738284866,3027,391,0,684,680,4,16274,16030,244,195,190,5,1,100
d9baa1ee110c9240f0dd2728c7016e2ba1cce02f,0,0,0,0,0,0,0,0,0,0,0,0,0,0,26,0,0,0,0,0,0,0,0,0,0,1,100
a3a553d753af2eff846f1f6fd23eb4f6352cbd75,1,22,4,18,0,0,0,17,107,80,1,1,0,3230,47,0,816,815,1,17925,17850,75,81,80,1,1,100
7fb90c3941dbb5c381d9be967888b681c6b04fcb,1,2,0,2,0,0,0,12,103,14,1,1,0,1180,403,1,250,249,1,6462,6449,13,69,68,1,1,100
8a39d80347bb6119d9568a34d00113e4b83a7d46,1,47,28,19,0,0,0,7,8,234,1,1,0,450,27,1,58,53,5,2595,2455,140,12,10,2,1,100
698c415f4780e676c51745205396d43c50dc6001,0,0,0,0,0,0,0,0,0,0,0,0,0,0,20,0,0,0,0,0,0,0,0,0,0,1,100
1f689f798539331debde4453cba8487b9b90c85f,3,76,6,70,0,0,0,3,214,3571,1,3,1.529516548,4693,28,2,936,929,7,30006,29437,569,123,120,3,1,100
407db230e3e56e51abe447a2c85fd30db5bc92a3,0,0,0,0,0,0,0,0,0,0,0,0,0,0,48,1,0,0,0,0,0,0,0,0,0,1,100
5fa4c941705e62ccef33bb89514838b72fadf6d0,1,38,2,36,0,0,0,17,108,10,1,1,0,3248,49,2,845,816,29,18055,17925,130,82,81,1,1,100
b1dcfb42f942273de17bba58ab4c94cd3990b4f2,2,21,21,0,0,0,0,12,104,170,1,2,0.591672779,1731,404,2,378,375,3,10002,9958,44,118,118,0,1,100
8bd0e9d0cbfedeb795b95a8e71e500fdb7a7d44e,2,3,3,0,0,0,0,2,10,80,2,2,0.918295834,424,72,0,90,89,1,2433,2425,8,8,8,0,1,100
93bb7d6cbbffece234da682f4a2a8e0c570d217c,3,12,0,12,0,0,0,6,34,755,1,3,1.554585169,635,73,1,47,45,2,4396,4279,117,16,16,0,1,100
7f9a46a22ff404214e03e767dd199d8c10ea7449,1,110,3,107,0,0,0,17,109,16,1,1,0,3284,50,3,871,845,26,18686,18055,631,88,82,6,1,100
37730726038082a074f3a2621185c560515d929b,1,0,1,1,0,0,0,30,217,70,1,1,0,5977,405,2,1203,1203,0,40383,40395,12,135,135,0,1,100
0324e50c4833555fed6dbdb6166c12bf8ffb18c8,3,28,20,8,0,0,0,3,98,618,2,2,1.143155878,2444,406,3,544,541,3,15257,15218,39,82,82,0,1,100
afb4d982cdcf4203db046f556a829ded75151c5c,0,0,0,0,0,0,0,0,0,0,0,0,0,0,96,0,0,0,0,0,0,0,0,0,0,1,100
ef68653da007a18966fda92a5300bc2823f0643c,4,499,404,95,0,0,0,14,218,400,1,4,1.029792195,15038,26,1,2233,2216,17,105282,104808,474,366,351,15,1,100
259f50847f0e8720184362ad25604fe9fe301fd6,3,126,10,116,0,0,0,3,29,2166,1,2,0.691454664,773,392,1,197,163,34,4823,4093,730,83,67,16,1,100
814a9216ce2ea2ef93b4e5548df26ddbeb2ecf92,2,11,9,2,0,0,0,4,7,1464,2,2,0.721928095,331,0,0,31,33,2,1793,1776,17,11,11,0,1,100
86714159195f917d3ee03f72c22ad7e4fc59b731,1,5,3,2,0,0,0,11,115,48,1,1,0,1351,393,1,324,324,0,8261,8252,9,52,52,0,1,100
ac250e096f5b6e9945e52fb490eb5ff36c747172,1,3,2,1,0,0,0,17,110,23,1,1,0,3391,51,3,871,871,0,18688,18686,2,88,88,0,1,100
58d88dd0e446a343af68e417b2918b5b883d1d4a,4,60,18,42,0,0,0,6,32,2829,1,3,1.874359837,2310,394,2,139,132,7,15824,15457,367,64,62,2,1,100
663b5ed98f32939a9474e9c1f8c07538cb95e2e6,0,0,0,0,0,0,0,0,0,0,0,0,0,0,395,3,0,0,0,0,0,0,0,0,0,1,100
7680080524d358c9692c775354c6a161c6bc2bdd,0,0,0,0,0,0,0,0,0,0,0,0,0,0,52,2,0,0,0,0,0,0,0,0,0,0,100
bfe15fe21d00b75d4f508a15b9bf6bd9efbb267d,0,0,0,0,0,0,0,0,0,0,0,0,0,0,21,0,0,0,0,0,0,0,0,0,0,1,100
32715f961ffbf780b7d1ce99aaf0045b3fed3dcb,0,0,0,0,0,0,0,0,0,0,0,0,0,0,1,1,0,0,0,0,0,0,0,0,0,1,100
e6ece6a46679da4ea37b6f114b7323c7efd04149,1,1,0,1,0,0,0,17,111,9,1,1,0,3392,53,3,872,871,1,18691,18688,3,88,88,0,1,100
f47acb52681c0d8378b15637299f8baf51d0d226,1,4,4,0,0,0,0,12,23,391,1,1,0,419,10,0,148,148,0,3081,3074,7,11,11,0,1,100
08bbf835729f3788ea33d2f5e2e6915ed0314d69,1,4,4,0,0,0,0,11,22,489,1,1,0,419,54,4,148,148,0,3074,3081,7,11,11,0,1,100
e5998fd3249e0eb1661d2b21fe53f4002e07fe95,0,0,0,0,0,0,0,0,0,0,0,0,0,0,55,5,0,0,0,0,0,0,0,0,0,1,100
20234c14c0a106559528fbf864eae51686ec6ddf,1,4,4,0,0,0,0,12,23,391,1,1,0,419,11,1,148,148,0,3081,3074,7,11,11,0,0,100
e192fd1eeeb43ddf9bb3e027e52bac146ddfcb94,0,0,0,0,0,0,0,0,0,0,0,0,0,0,97,1,0,0,0,0,0,0,0,0,0,1,100
f5924b3476ba3fed6f128e6257ebab9bea5cd769,4,63,9,54,0,0,0,25,216,357,1,2,1.331966065,5266,407,0,1080,1068,12,33824,33455,369,131,128,3,1,99.95012469
c1c22d94065e96705f696075d10f6ec41e282a05,1,2,0,2,0,0,0,9,99,56,1,1,0,1423,408,1,323,323,0,9038,9030,8,49,49,0,1,100
8fbee8b6d081cd603c704cf977fa79504686ee18,2,1,252,251,0,0,0,17,112,109,1,1,0.46522548,3738,56,3,867,944,77,19290,20662,1372,92,103,11,2,100
c3cc47da40f0f7504a3ed6ba7ecc363bc3afb248,1,55,0,55,0,0,0,17,113,2,1,1,0,3167,57,1,812,798,14,17868,17502,366,81,78,3,1,100
d73ea981673bc5f5b20d191022695094ec3f47b2,0,0,0,0,0,0,0,0,0,0,0,0,0,0,396,0,0,0,0,0,0,0,0,0,0,1,100
07bac5789bbf7103941cf8f9355f9e9502a5e17f,2,8,14,6,0,0,0,2,16,367,1,2,0.439496987,1179,409,2,276,277,1,7172,7194,22,44,44,0,1,100
919ce3cfa66541f594b8a86a8ad8ba70b3825671,1,1,0,1,0,0,0,2,9,103,1,1,0,184,74,0,21,21,0,1047,1036,11,5,5,0,1,100
dd297ce9aa6cb1784fb4a6cc79bd9377b7c12da6,0,0,0,0,0,0,0,0,0,0,0,0,0,0,58,2,0,0,0,0,0,0,0,0,0,1,100
ed0fe3a19bf531316d2b128afd6e4ae8c87328d2,1,10,6,4,0,0,0,3,39,2,1,1,0,627,398,1,148,144,4,3805,3820,15,26,25,1,1,100
183b5c2b9c5bea22d81a2142ef9fa6759dff6ead,1,6,2,4,0,0,0,5,5,1332,1,1,0,100,5,0,9,9,0,471,445,26,7,7,0,1,100
76bd108a7a8815b14f87eb038aeceb4b99f03329,0,0,0,0,0,0,0,0,0,0,0,0,0,0,59,0,0,0,0,0,0,0,0,0,0,1,100
ac27d800e1494ee045cc374252799d50fdfbc060,0,0,0,0,0,0,0,0,0,0,0,0,0,0,60,1,0,0,0,0,0,0,0,0,0,1,100
911bdc88c86e316a04e8ae7719fc5a967425648e,11,1085,681,404,3,1,4,1,105,925,1,5,2.186847738,2548,399,0,461,547,86,16629,16581,48,141,171,30,1,91.10816191
52a855892fab138652255b9f492c06725c82d7be,9,356,40,316,2,0,2,1,11,445,1,6,2.396551171,1581,400,1,211,189,22,11461,9463,1998,74,69,5,1,92.69027882
35c8bc3923ad9961d9d5809f1269b586368b2330,0,0,0,0,0,0,0,0,0,0,0,0,0,0,61,0,0,0,0,0,0,0,0,0,0,1,100
acde646a57070584ef23b6320f0512d6d91504fd,0,0,0,0,0,0,0,0,0,0,0,0,0,0,401,2,0,0,0,0,0,0,0,0,0,2,100
71218abafbc774ae5d6770e05f2a70435b17ac8e,0,0,0,0,0,0,0,0,0,0,0,0,0,0,402,3,0,0,0,0,0,0,0,0,0,1,100
70403cfde9c24c65254129603a9f656c59116fa7,5,205,111,94,0,0,0,3,64,822,3,4,1.889899612,4542,403,4,910,889,21,27407,27078,329,222,215,7,1,100
4f87679c4390787889f959f8fa5c3086d1af7511,0,0,0,0,0,0,0,0,0,0,0,0,0,0,404,5,0,0,0,0,0,0,0,0,0,1,100
491fd60b49b1716ef7780f8ddb7ceb0d59af1a43,0,0,0,0,0,0,0,0,0,0,0,0,0,0,29,0,0,0,0,0,0,0,0,0,0,1,100
6116b415009edf0a48df9f59b66bf85f64caea23,1,1,1,0,0,0,0,2,2,2718,1,1,0,304,0,0,40,40,0,1107,1107,0,28,28,0,1,100
64882134083c87790eb94b4f5504eeb10c70f82c,11,185,86,99,0,0,0,10,85,799,1,4,2.970211567,5295,405,4,1049,1031,18,30116,29207,909,351,345,6,1,99.83377199
2fac8c94813b672390516fe86d9174d5d16299a0,0,0,0,0,0,0,0,0,0,0,0,0,0,0,98,0,0,0,0,0,0,0,0,0,0,1,100
8eb8a1bae8ee57055f66e0344a24aca1750f95d9,1,1,0,1,0,0,0,11,20,944,1,1,0,171,99,1,16,16,0,868,859,9,3,3,0,1,100
9cbf1bbf1cf2ceb42c7c641366d12f261c045aca,0,0,0,0,0,0,0,0,0,0,0,0,0,0,406,3,0,0,0,0,0,0,0,0,0,1,100
1803188a72788870f5d8b3dbf2766a60e9d5dd5b,6,412,44,368,2,0,2,2,25,1974,1,1,1.909007996,2008,30,1,359,295,64,13605,11193,2412,95,77,18,1,99.79261717
8f916359da958b57b90721096facd65c1817bdec,0,0,0,0,0,0,0,0,0,0,0,0,0,0,0,0,0,0,0,0,0,0,0,0,0,1,100
cec500b00e6c979196b6a1ed59df5817dc25e204,439,1524,1426,98,0,0,0,15,219,2327,42,129,8.669652233,162634,407,1,27874,27884,10,917137,918892,1755,6006,6006,0,1,100
0aabd6b3bfcd54ee573d389a7403223e29b33f01,2,291,55,236,0,0,0,1,5,48,1,2,0.318663083,921,408,2,182,142,40,7042,5772,1270,78,53,25,1,100
54d491cdee6f2704b7862e45c03317fc8536bf68,0,0,0,0,0,0,0,0,0,0,0,0,0,0,31,1,0,0,0,0,0,0,0,0,0,1,100
28032bf3b29ca48187352a1ae774a51d8505ce7d,0,0,0,0,0,0,0,0,0,0,0,0,0,0,75,0,0,0,0,0,0,0,0,0,0,1,100
0198a1ccf45efb50e8d5c5a5f71034a9e2d93929,0,0,0,0,0,0,0,0,0,0,0,0,0,0,76,1,0,0,0,0,0,0,0,0,0,1,100
8285b13e48058de93a0c245c9e1962b5cae0beff,2,63,23,40,0,0,0,3,115,22,1,1,0.159350063,3390,409,3,864,831,33,19434,18841,593,91,87,4,1,100
a435f34005c0f8d4beea6d122e5118f847df61b2,0,0,0,0,0,0,0,0,0,0,0,0,0,0,77,2,0,0,0,0,0,0,0,0,0,1,100
45d9eef8cc9c441959da55d9809d58bcb2e594fb,5,212,19,193,2,0,2,1,8,43,1,4,2.139229072,1254,410,1,195,182,13,8477,7546,931,84,78,6,1,99.91735537
ed85f602cb663dcebb1a4bd4b17a0501be7ecf76,16,151,126,25,0,0,0,4,14,729,15,16,1.820740571,5580,411,2,832,830,2,23813,23689,124,285,285,0,1,100
5e24f09f1a54ac5e07079758d3fc45a4bf16677d,1,5,1,4,0,0,0,13,30,57,1,1,0,766,78,3,127,125,2,4447,4422,25,49,48,1,1,100
c9a495c754da74e656cbedd824b2c8ade9da4d07,0,0,0,0,0,0,0,0,0,0,0,0,0,0,1,0,0,0,0,0,0,0,0,0,0,1,100
6cca6db3d11601e04faaeee95d796e2ca2d59570,12,1012,25,987,1,0,1,17,107,209,3,7,2.628586915,7456,412,2,1453,1297,156,49021,42859,6162,415,379,36,1,99.64329812
70c614b1ab936e3f8d17d749b7ea78be499e58e4,2,10,5,5,0,0,0,10,101,92,1,2,0.996791632,2554,413,3,480,480,0,15559,15575,16,109,108,1,1,100
b3bac410c3cfec4900cc89e0f58137f4cb1c6a8d,0,0,0,0,0,0,0,0,0,0,0,0,0,0,12,0,0,0,0,0,0,0,0,0,0,1,100
e1534fd6577e73eee052ab715ad506c6de8f0b86,1,17,0,17,0,0,0,7,30,80,1,1,0,320,62,0,75,69,6,1921,1780,141,14,14,0,1,100
bfde444184cd1a2eb968222181607dbc7b7a48a2,1,1,1,0,0,0,0,18,116,62,1,1,0,3262,47,0,845,845,0,18450,18451,1,85,85,0,1,100
55c04f2f47bf749ede969804b34a3837f8520937,7,287,134,153,1,0,1,1,27,595,1,1,2.113751037,2745,0,0,413,403,10,15989,15241,748,107,98,9,1,99.75339088
2a1fbbf154e00a34976832d45c507ccc0111c35a,2,8,7,1,0,0,0,4,25,90,1,1,0.566509507,1063,48,1,188,188,0,6087,6079,8,51,51,0,1,100
7f81994d9bcfd29f07a18ab3554204dff5cbe4b6,0,0,0,0,0,0,0,0,0,0,0,0,0,0,0,0,0,0,0,0,0,0,0,0,0,1,100
1a375c422c108921ea01c6f011c7dde8f8cfa862,2,47,44,3,0,0,0,13,28,58,1,1,0.985228136,825,32,0,136,139,3,4709,4671,38,28,27,1,1,100
d6205c5593743a6f14ed64c62142a30ca16ea912,0,0,0,0,0,0,0,0,0,0,0,0,0,0,33,1,0,0,0,0,0,0,0,0,0,1,100
fb764e6910830f138ab1513b65f7689599ff0307,2,13,12,1,0,0,0,15,48,104,2,2,0.970950594,1484,6,0,348,346,2,9298,9256,42,57,57,0,1,95.55302166
b0e7ded902b68bc1210098edcd8c367f230290f7,0,0,0,0,0,0,0,0,0,0,0,0,0,0,43,0,0,0,0,0,0,0,0,0,0,1,100
7680d0f63ce838742ef51ab54720c0f7636d6734,0,0,0,0,0,0,0,0,0,0,0,0,0,0,2,0,0,0,0,0,0,0,0,0,0,1,100
db99f639017bc9bbd71a7c5772adc1545ca83ec0,2,22,3,19,0,0,0,2,56,1016,1,1,0.998845536,692,1,1,119,116,3,4589,4454,135,22,21,1,1,100
62e9a12c44741474696614421b9137e8e468d234,3,33,8,25,0,0,0,2,6,3201,1,1,1.574008923,310,414,0,14,15,1,2382,2164,218,10,10,0,1,100
2db9fe2ed461ba55b9be6948dd17b27cf5956b88,1,19,26,7,0,0,0,3,9,140,1,1,0,332,415,1,58,58,0,1530,1524,6,9,9,0,1,100
828bced055304aeeec2b035cd127edcadbb08278,1,23,1,22,0,0,0,8,13,143,1,1,0,299,1,0,32,29,3,1644,1571,73,18,17,1,1,100
ca9881f4889f7ffd5a5d101bf15c5ea48af84eb8,1,1,2,1,0,0,0,12,38,72,1,1,0,1200,63,0,214,214,0,6968,6981,13,37,37,0,1,100
f8be6c040bf6951708ec58232891334d177fc677,2,78,5,73,0,0,0,2,3,144,1,1,0.163860513,526,64,1,90,79,11,2877,2554,323,26,23,3,1,100
626b8222c058fa381b943c16262da8e87ff50098,0,0,0,0,0,0,0,0,0,0,0,0,0,0,416,2,0,0,0,0,0,0,0,0,0,1,100
b97f0c373d0e3cf00fbd0c75cf6bc313f4fb8b39,0,0,0,0,0,0,0,0,0,0,0,0,0,0,0,0,0,0,0,0,0,0,0,0,0,1,100
9c7d7767760213ac42285bf6bc8369be44c47a25,0,0,0,0,0,0,0,0,0,0,0,0,0,0,1,1,0,0,0,0,0,0,0,0,0,1,100
85a79f621b58a149eb4f72f16cea990ed17b11a1,0,0,0,0,0,0,0,0,0,0,0,0,0,0,2,2,0,0,0,0,0,0,0,0,0,1,100
1793c76b8f4085bad17be416cd6dae7cad27a0e1,0,0,0,0,0,0,0,0,0,0,0,0,0,0,3,3,0,0,0,0,0,0,0,0,0,1,100
8069bd2b8dbe1f08909d73f6ae35d8fc7d86a5e7,0,0,0,0,0,0,0,0,0,0,0,0,0,0,4,4,0,0,0,0,0,0,0,0,0,1,100
48b8883f82d34cf952384a6e9df86c0cbb6873c8,0,0,0,0,0,0,0,0,0,0,0,0,0,0,5,5,0,0,0,0,0,0,0,0,0,1,100
cb7f09834e6646a4e8fe878775e598d077071958,4,71,2,69,0,0,0,6,32,1184,1,4,1.921461215,1393,2,1,240,231,9,8441,8038,403,49,46,3,1,100
39ea1534a98c51ba8b88e7313b7b3d851298b3e6,1,0,1,1,0,0,0,12,21,0,1,1,0,562,0,0,87,87,0,3250,3261,11,20,20,0,1,100
9ae72563d717ecdfe736918a4f255c7c68155901,2,10,3,7,0,0,0,2,5,2277,1,1,0.995727452,100,417,1,6,5,1,509,470,39,4,3,1,1,100
55496d57776ed0417d66733780371ac29c26b67c,1,20,0,20,0,0,0,16,23,186,1,1,0,361,9,0,46,41,5,1949,1777,172,7,7,0,1,100
bbd8427e4d16334ef605b918781aad64f466744f,0,0,0,0,0,0,0,0,0,0,0,0,0,0,6,6,0,0,0,0,0,0,0,0,0,1,100
7a40478526f982c51e6264ee1db8171dcb006cb9,3,11,5,6,0,0,0,10,33,70,1,3,1.366314657,944,44,0,161,160,1,5478,5415,63,26,26,0,1,100
7fdd9060b0c15dfbcd709b34729a265fc7a0cd44,4,13,31,18,0,0,0,16,105,308,1,4,1.659588,7352,45,1,982,987,5,58404,58473,69,261,261,0,1,100
73918f78fa7724ba988903026bd552d5836b4d68,2,4,4,0,0,0,0,4,39,3005,1,2,0.811278124,3769,46,2,154,154,0,34691,34691,0,154,154,0,1,100
79f4efc4396abb09befff5639281a6f757723a18,1,7,1,6,0,0,0,2,7,4304,1,1,0,56,418,1,5,6,1,318,273,45,3,3,0,1,100
767e1dac62a74ebd44663ff1166c55f1cfabfa45,0,0,0,0,0,0,0,0,0,0,0,0,0,0,419,2,0,0,0,0,0,0,0,0,0,1,100
d43969e99733ec078c63101e1d7a542e6669f05e,2,3,22,19,0,0,0,2,57,98,1,1,0.998845536,711,79,0,116,119,3,4454,4589,135,21,22,1,1,100
3dcccf22049f3442915c7cb6f9d1f2d3304637a4,1,3,1,2,0,0,0,6,6,228,1,1,0,270,0,0,41,41,0,1118,1102,16,19,19,0,1,100
86f24aa3b8b4795fa2b59f3d980b25e1398bd318,0,0,0,0,0,0,0,0,0,0,0,0,0,0,80,1,0,0,0,0,0,0,0,0,0,1,100
6f2fabf2bfaa24292ab98deaa2298e35fbad27b9,4,101,0,101,0,0,0,25,220,474,1,3,1.525773198,11408,81,2,2288,2263,25,74553,73839,714,331,325,6,1,100
3c693dadd5428b8b9d637ce0818c39ab173468b8,1,28,17,11,0,0,0,25,219,0,1,1,0,4416,27,0,918,915,3,28498,28472,26,104,104,0,1,100
869ec42f3718fcb4a7f8c463cbbb884f7216e9d9,7,150,6,144,0,0,0,14,27,2728,1,2,2.382065637,1197,22,0,198,172,26,8113,6941,1172,56,48,8,1,92.9794965
b2ae8ad83bd1946f44cf64b0b80b9fa2993f6ea6,1,10,1,9,0,0,0,8,16,228,1,1,0,1303,420,2,253,250,3,8093,8023,70,32,32,0,1,100
b7eb7c124ebe49b8b6678b7a3b55ae6215835ef1,1,1,1,0,0,0,0,14,28,0,1,1,0,443,158,0,80,80,0,2838,2838,0,15,15,0,1,100
ab932157a0b15cd5c873a6e09a9fbe973f571935,0,0,0,0,0,0,0,0,0,0,0,0,0,0,34,0,0,0,0,0,0,0,0,0,0,1,100
0f58f9bb8396a3f618ae791bca9f68cf7fd57334,0,0,0,0,0,0,0,0,0,0,0,0,0,0,28,0,0,0,0,0,0,0,0,0,0,1,100
6b0fcd2bd2428d259445405fa47eedd2a228099c,1,2,1,1,0,0,0,3,3,228,1,1,0,144,35,1,18,18,0,837,835,2,6,6,0,1,100
f428f7e6ebdcd1ac61cbf1521b75b856b6799abf,8,158,33,125,1,0,1,2,76,544,2,3,2.665127745,4556,410,0,982,959,23,27080,26338,742,197,192,5,1,99.91924319
d2aa5bd8e12f8e8dbb350c7480be4aecbe47cb73,7,135,4,131,0,0,0,5,33,804,3,5,2.032311884,2262,411,1,404,384,20,13067,12234,833,94,92,2,1,100
d2931d324639f0bb4d327e5889f600f3da99e2db,1,2,2,0,0,0,0,3,5,0,1,1,0,120,412,2,18,18,0,644,648,4,4,4,0,1,100
2ac244986941aa32c8e4c594dec3225b0907992b,4,41,21,20,0,0,0,25,221,0,1,3,1.749613442,11520,82,3,2293,2291,2,74741,74579,162,331,331,0,1,100
e6de6fc759cf1a4e573e9af47cf86004f5200dc2,3,43,2,41,0,0,0,5,31,1214,2,2,1.48654941,803,65,0,183,175,8,4418,4119,299,47,46,1,1,100
4bf527fac1dbaaf6dc2d25f0102add7a8eb652ce,1,138,0,138,1,0,1,1,1,0,1,1,0,0,13,0,28,0,28,823,0,823,6,0,6,1,99.97694259
34277d811269105f7306ac581be4a773db280c4f,1,13,3,10,0,0,0,1,6,962,1,1,0,597,14,1,92,90,2,4576,4478,98,65,63,2,1,100
d2b347309be9f462adaf3d2a4ae692d0e4f86dd5,1,27,22,5,0,0,0,6,24,228,1,1,0,459,413,3,85,86,1,2352,2341,11,15,15,0,1,100
b8b0c9cf6c0dfe2a17b1d4dd0b4ae63a86135ff5,1,3,5,2,0,0,0,6,25,0,1,1,0,464,414,4,85,85,0,2350,2352,2,15,15,0,1,100
717ea1a5813ddb82163fc5b414f055c627908f72,0,0,0,0,0,0,0,0,0,0,0,0,0,0,83,4,0,0,0,0,0,0,0,0,0,1,100
284e6e29bae07f88bb47554a01e37f0b9b4d2032,2,128,0,128,1,0,1,1,27,0,1,2,0.473929123,310,29,1,78,64,14,2141,1592,549,28,22,6,1,99.80335454
62b29e5a84b27ce31f1f45333352df737c8b7840,8,95,46,49,0,0,0,18,222,1452,2,6,2.659567807,12445,415,5,1805,1802,3,86441,86036,405,337,337,0,1,99.11326555
2cb3b83f54d5482906046043ef0486cd823b3cc1,1,0,7,7,0,0,0,9,14,1446,1,1,0,586,1,0,133,135,2,3561,3613,52,14,14,0,1,100
f8f26ce64569a57913ebedb04e6d96d02306fe96,2,35,15,20,0,0,0,19,117,71,1,1,0.970950594,3618,23,1,929,924,5,20716,20490,226,101,100,1,1,100
3812635dcaa71b78c01ed6a627326c2fb54594de,1,3,1,2,0,0,0,30,223,0,1,1,0,6085,36,2,1224,1224,0,40906,40881,25,151,151,0,1,100
0d61ff0994e6d64337f6ccc4a4956abcd552c89c,1,39,24,15,0,0,0,7,17,662,1,1,0,729,159,1,96,92,4,4298,4181,117,10,9,1,1,100
15bdc2fe16ed03dbdf326409a163808ebbdbdb06,1,13,12,1,0,0,0,10,14,228,1,1,0,217,160,2,30,28,2,1151,1138,13,9,9,0,1,100
6b12de58dcbbb53a6f2b8f4e9dbba13c2e35db93,0,0,0,0,0,0,0,0,0,0,0,0,0,0,84,5,0,0,0,0,0,0,0,0,0,1,100
780e10a23602d519a9b5933065ebc97a3605b90f,4,212,3,209,1,0,1,1,224,0,1,3,1.153197414,6525,30,2,1330,1302,28,44147,43047,1100,186,179,7,1,99.90368408
e876338e048db4a45b1fe933c2c961bd0851fb47,2,208,46,162,0,0,0,3,15,114,2,2,0.116849761,985,416,6,227,196,31,7355,5855,1500,46,40,6,1,100
7a4310e25e1214b077d4482f07577f8d4c76fdf2,10,397,23,374,2,0,2,4,32,1781,2,5,3.09111907,2580,28,1,320,283,37,18053,15703,2350,151,132,19,1,92.37528728
dbb58d489c6860fc2aebefaa6b8b8cb4e3dd68cc,2,89,48,41,0,0,0,2,15,1394,1,1,0.498372856,234,417,7,40,32,8,1333,1156,177,9,6,3,1,100
9f7d05e82936c384a0f7a09abfece7512099641c,3,263,0,263,2,0,2,1,29,76,2,3,0.942275249,555,0,0,98,81,17,4038,2876,1162,25,14,11,1,99.92294652
d92dd86c5575a23aa77467a178064e6f33caad77,0,0,0,0,0,0,0,0,0,0,0,0,0,0,47,3,0,0,0,0,0,0,0,0,0,1,100
3d35e303ff400d18e651ddd72af2b6c11eaf0a4e,2,37,27,10,0,0,0,20,118,734,2,2,0.200622324,3351,0,0,846,845,1,19029,18919,110,86,85,1,1,100
e66025c1ab5c4f4148943ba31648b982fec07257,1,3,4,1,0,0,0,20,119,0,1,1,0,3270,66,1,846,846,0,18598,18619,21,86,86,0,1,100
24986f105534fd6fe07e4ba688df666d595430bd,1,2,2,0,0,0,0,9,16,0,1,1,0,248,31,3,43,42,1,1306,1299,7,14,14,0,1,100
73394a7b681abae0e3cf3a72445d7165da23b774,0,0,0,0,0,0,0,0,0,0,0,0,0,0,48,4,0,0,0,0,0,0,0,0,0,1,100
676831d4a39c8c0f416e73edb51987e59ee2d096,1,10,2,8,0,0,0,11,18,228,1,1,0,395,0,0,49,47,2,1939,1886,53,12,12,0,1,100
146a9de187ee960e7fd8f4686716bcda182b7652,0,0,0,0,0,0,0,0,0,0,0,0,0,0,418,8,0,0,0,0,0,0,0,0,0,1,100
59b19919fd68fbb76318a18efbab7c0b85074f42,0,0,0,0,0,0,0,0,0,0,0,0,0,0,49,5,0,0,0,0,0,0,0,0,0,1,100
3d406400b050ae10f5016ee2e9d280caecffe24e,1,3,2,1,0,0,0,4,10,228,1,1,0,216,419,9,37,37,0,1027,1027,0,5,5,0,1,100
c5a085bb0cda44e2a2d0cded7974278916d2b5e9,1,3,2,1,0,0,0,4,11,0,1,1,0,217,420,10,37,37,0,1027,1027,0,5,5,0,1,100
1eeb40a7102a717257f045bf81483552bf6d7720,2,1088,10,1078,0,0,0,16,106,32,1,2,0.062208298,6800,85,6,911,887,24,65664,55651,10013,261,237,24,1,89.75664069
073544441eabc461897e3242b9c274fe9cbf69ff,2,359,8,351,0,0,0,9,56,508,1,2,0.18039692,3338,86,7,350,339,11,28611,25021,3590,102,92,10,1,100
9f9831d2f2ed079a31b13c6b9997c3195a011ab9,0,0,0,0,0,0,0,0,0,0,0,0,0,0,50,6,0,0,0,0,0,0,0,0,0,1,100
db457c02eb96245ba338f9d2ec4940f8714ec63c,3,16,43,27,0,0,0,14,77,152,2,3,0.767347287,2776,0,0,581,593,12,16841,16961,120,85,85,0,1,100
3730f1ba2de312972300a7377b792313bbc5fea5,1,6,2,4,0,0,0,3,16,228,1,1,0,322,421,11,58,56,2,1771,1751,20,8,8,0,1,100
84f9fb8fc5c50159906faac121164ad1b4442063,3,57,2,55,0,0,0,10,221,1469,1,3,1.260375942,4882,37,3,963,951,12,32072,31414,658,116,115,1,1,100
d411e8027679529888de2211059f42cd28ef4718,13,759,133,626,3,0,3,10,50,275,2,7,2.693608708,5483,87,8,1176,1070,106,33898,30198,3700,191,180,11,1,99.81916817
9bb528ed5af88e79fab53e2717b0923a499dc3ed,1,5,1,4,0,0,0,8,9,624,1,1,0,469,0,0,59,58,1,2626,2595,31,12,12,0,1,100
b7f85a4fca7c2d729b1a1d43a27d6e2ab9bb1da7,5,448,481,33,0,0,0,2,44,964,1,3,1.246869351,2404,422,12,442,436,6,14116,14307,191,46,57,11,1,100
ac6fddf342cf5c3e393124d024106aa4fc5bb32c,2,6,30,24,0,0,0,3,23,0,1,1,1,922,423,13,138,144,6,5162,5300,138,17,17,0,1,100
c370022bf1f803198e574a2bef23a27ad3fd0c6b,0,0,0,0,0,0,0,0,0,0,0,0,0,0,15,2,0,0,0,0,0,0,0,0,0,1,100
9cc9d9233b4e8a3f268871e0a172c1f0dc4ca565,2,47,86,39,0,1,1,3,225,114,1,2,0.999632954,6157,424,14,1232,1230,2,41065,41222,157,154,152,2,1,99.96712689
84be12cf576e6bf69857df5b5a47447ae80c691a,0,0,0,0,0,0,0,0,0,0,0,0,0,0,88,9,0,0,0,0,0,0,0,0,0,1,100
4cb374c27d3d7be1607acd86a0f3e06101ca081a,3,142,111,31,0,0,0,2,107,537,2,3,0.902675221,7945,89,10,922,919,3,65792,65874,82,272,269,3,1,100
d96c22ad7b0122ad1c22b5e9af01628662b3b36a,1,3,0,3,0,0,0,2,4,0,1,1,0,227,425,15,36,36,0,1245,1224,21,3,3,0,1,100
dc2adcab1a0012524086bccecf1691a12f821127,0,0,0,0,0,0,0,0,0,0,0,0,0,0,90,11,0,0,0,0,0,0,0,0,0,1,100
ffe96d88762d0f07a6356e4e937c371f52cee821,1,24,0,24,0,0,0,6,7,228,1,1,0,80,38,4,9,5,4,497,327,170,5,4,1,1,99.73800557
6e509e758c78b33daaecd1fcb726b00de4389e6c,14,364,178,186,2,0,2,2,108,795,1,8,3.335994295,11493,24,2,1379,1360,19,85165,84543,622,511,492,19,1,99.93481095
d4b86478f0b33e66e51a71cc03f83298f689c0b0,0,0,0,0,0,0,0,0,0,0,0,0,0,0,7,1,0,0,0,0,0,0,0,0,0,1,100
ae73baac78593cc0b665f279460e1f091a3a5273,0,0,0,0,0,0,0,0,0,0,0,0,0,0,91,12,0,0,0,0,0,0,0,0,0,1,100
14f2929aa52f6f45b9e90e7027615f353f38a224,1,11,8,3,0,0,0,4,16,0,1,1,0,899,32,4,186,185,1,6076,6056,20,32,32,0,1,100
5d3b618157ecb09da22e2e5d2de1dc520ee9d193,1,110,63,47,0,0,0,20,54,228,1,1,0,1869,16,3,419,406,13,11574,11322,252,48,48,0,1,100
4a33bbdfc8ca4fc39807483ddc852dc50115bb35,6,208,31,177,0,0,0,20,109,1013,3,6,1.964100151,11275,161,3,1706,1660,46,85376,84218,1158,438,430,8,1,100
753764665d910d9fefdd0c414d550dfa0c3db330,0,0,0,0,0,0,0,0,0,0,0,0,0,0,92,13,0,0,0,0,0,0,0,0,0,1,100
1cb1af1104becbc47e7ef9132fcaf0d7ae94a546,0,0,0,0,0,0,0,0,0,0,0,0,0,0,51,7,0,0,0,0,0,0,0,0,0,1,100
70d985bb227f8af3d46841956e00307047562699,1,15,5,10,0,0,0,4,7,177,1,1,0,235,162,4,34,32,2,973,912,61,11,11,0,1,100
7ba1078e524e267a995b7ed03b801c9a4fd7c62e,1,1,1,0,0,0,0,7,78,0,1,1,0,1557,0,0,375,375,0,9659,9659,0,68,68,0,1,100
39f990eb1363a905172f3521825d8bae2c2e6164,4,20,12,8,0,0,0,2,14,2041,1,1,2,1169,0,0,57,57,0,7470,7338,132,23,23,0,1,100
2daa8e506c9adc814c5479ddbd95fc819a2276d2,11,12,12,0,0,0,0,9,17,83,5,9,3.418295834,3142,93,14,518,518,0,18052,18062,10,99,99,0,1,100
9fc4b0cec14a0c3781144f845b5451326fd72c78,3,418,88,330,0,0,0,1,67,326,1,3,1.001099255,2789,163,5,579,526,53,17621,15696,1925,145,134,11,1,100
2d82431d7c96416e5aae645c1558535209027a2d,2,132,86,46,0,0,0,5,110,336,1,2,0.768783375,3535,164,6,808,799,9,24104,23687,417,116,114,2,1,100
bb61d13e92d9b334a8be0bbefbd4abe52c5f942c,1,2,8,6,0,0,0,20,51,0,1,1,0,1550,426,16,342,342,0,7410,7449,39,55,55,0,1,100
9cca00996059c12cd91a7b6d260b74a1dbff8169,1,471,0,471,1,0,1,1,1,0,1,1,0,0,39,5,79,0,79,3418,0,3418,15,0,15,1,99.96743732
1baeb502c4d1284b17874544a13174fe6bb0c3cd,6,712,171,541,2,0,2,7,39,551,1,3,1.96932678,1549,40,6,408,266,142,12305,9253,3052,61,51,10,1,98.49451808
08f1bbdac0d085d599f9c53a48f10ca12b5f5452,1,28,2,26,0,0,0,14,25,228,1,1,0,420,10,0,157,148,9,3314,3086,228,11,11,0,1,100
32fd08cbef82f675018d4864475c6bbc2e7c5a4e,0,0,0,0,0,0,0,0,0,0,0,0,0,0,29,2,0,0,0,0,0,0,0,0,0,1,100
1a25bbe5bf4492d45697723b7700abdff4788c5c,7,107,15,92,0,0,0,3,4,2660,1,1,2.806117548,775,0,0,131,124,7,4296,3918,378,44,44,0,1,100
dc1d3396c18dff3c1380ec1e5ce81220a9518aab,0,0,0,0,0,0,0,0,0,0,0,0,0,0,94,15,0,0,0,0,0,0,0,0,0,1,100
cf1699f01c4f13b6bfeaf3136cc34342975636de,0,0,0,0,0,0,0,0,0,0,0,0,0,0,3,0,0,0,0,0,0,0,0,0,0,1,100
7fc670bdfad96c04268d24abdd7cf6d065d65819,1,8,6,2,0,0,0,2,2,2,1,1,0,138,2,0,28,28,0,857,823,34,6,6,0,1,100
88a375f3cb5ef4cc110494cd2582cb2f760e3a9d,4,11,29,18,0,0,0,18,222,4,1,2,1.773719189,8629,4,1,1654,1660,6,54248,54326,78,259,259,0,1,100
d9d080dea207319147190f2a8875effca95d4d73,0,0,0,0,0,0,0,0,0,0,0,0,0,0,0,0,0,0,0,0,0,0,0,0,0,1,100
de268eaa39cc3770ef5f6603fba8c47212df9823,0,0,0,0,0,0,0,0,0,0,0,0,0,0,8,1,0,0,0,0,0,0,0,0,0,1,100
3bcfe85a5dbcfa7825fc500ac3b5e945a9c44ef1,0,0,0,0,0,0,0,0,0,0,0,0,0,0,41,7,0,0,0,0,0,0,0,0,0,1,100
361f179249679bb7a78d2ca10aa5bccca79088ee,0,0,0,0,0,0,0,0,0,0,0,0,0,0,95,16,0,0,0,0,0,0,0,0,0,1,100
c6d8de7bf6e74ea425f2fbb125a254828c9283cb,3,30,16,14,0,0,0,12,108,973,1,3,1.210322672,2572,427,17,546,540,6,14174,14097,77,141,139,2,1,100
bcd501a8d88135e1917019463a47d2349e16a166,2,64,3,61,0,0,0,11,25,1469,1,1,0.839530498,1231,11,1,239,211,28,6503,6018,485,40,38,2,1,100
f06a557da0ef160eb26069dfbb349c1049278000,0,0,0,0,0,0,0,0,0,0,0,0,0,0,42,8,0,0,0,0,0,0,0,0,0,1,100
da426dc8da469585f1c8f05d5d70189ebc7e6592,2,22,3,19,0,0,0,2,58,22,1,1,0.998845536,692,2,0,119,116,3,4589,4454,135,22,21,1,1,100
88fa08cf93ffbacf79ded8ca5452f0365a06bafa,3,74,5,69,0,0,0,9,57,249,1,3,1.03792972,4124,52,5,424,412,12,30228,29806,422,136,131,5,1,100
6edcaab9d642c9500b39fb8940eb286988737a02,0,0,0,0,0,0,0,0,0,0,0,0,0,0,9,2,0,0,0,0,0,0,0,0,0,1,100
889dcec9693aa4fc03cbe317dd817e3550bdc7d5,0,0,0,0,0,0,0,0,0,0,0,0,0,0,10,3,0,0,0,0,0,0,0,0,0,1,100
55886d610926f1a5f7ac89d34da146089383707a,0,0,0,0,0,0,0,0,0,0,0,0,0,0,12,2,0,0,0,0,0,0,0,0,0,1,100
7a8af6cf0b5ffa9f126f68c7d58feb09e8da734e,1,1,1,0,0,0,0,6,20,257,1,1,0,420,96,17,90,89,1,2376,2367,9,17,17,0,1,100
34de432a4715b8a15bdbd2b3cd7c439953fb161e,3,14,14,0,0,0,0,3,5,258,1,2,1.577406283,861,1,0,151,151,0,4977,4977,0,22,22,0,0,100
cca2e0c43b3dd6b97fc3a8e4819135b99a29266e,3,5,74,69,0,0,0,9,58,12,1,3,1.03792972,4193,97,18,412,424,12,29806,30228,422,131,136,5,1,100
efcab63007ee92503d888caacbe49722e50d0cc8,0,0,0,0,0,0,0,0,0,0,0,0,0,0,43,2,0,0,0,0,0,0,0,0,0,1,100
9ab1a79002ff0a6abe6ea5ec871a1c40a73b949d,0,0,0,0,0,0,0,0,0,0,0,0,0,0,44,3,0,0,0,0,0,0,0,0,0,1,100
8c86743ef79fe06e49c8aafd0ed4acff02959742,4,329,0,329,1,0,1,14,33,274,4,4,1.401554124,1616,421,0,234,194,40,11751,9864,1887,150,122,28,1,99.96710526
184f5c2c6e0d27f9faa6a51a2e4e77817622bc38,2,3,3,0,0,0,0,4,16,162,2,2,0.918295834,875,98,3,165,164,1,4748,4729,19,12,12,0,1,100
764da30b74791bb1c679688934253c1f86cfbf21,0,0,0,0,0,0,0,0,0,0,0,0,0,0,7,0,0,0,0,0,0,0,0,0,0,1,100
13fd68222e9dd072c33f9bf36e8bff4dda928da1,3,74,5,69,0,0,0,9,59,9,1,3,1.03792972,4124,53,1,424,412,12,30228,29806,422,136,131,5,1,100
6f42259dde3137a8b68873123971b4f1af26117a,9,27,22,5,0,0,0,10,223,104,1,4,2.69548697,14287,5,0,2830,2830,0,87337,87292,45,475,475,0,1,100
e6dc5b505f063d2e6b877c92340e9302142f4a61,0,0,0,0,0,0,0,0,0,0,0,0,0,0,11,0,0,0,0,0,0,0,0,0,0,1,100
f7bdb442803355739c3dd5fcc3a79235d122a8f8,1,45,1,44,0,0,0,2,2,72,1,1,0,471,1,0,90,79,11,3716,3418,298,16,15,1,1,100
249177c15ea1aa7a0d19171695b4d386c96693cb,3,97,0,97,1,0,1,1,60,31,1,3,0.59112957,1682,2,1,327,315,12,9821,9397,424,59,53,6,1,100
4c5ae661f13c5524497614282a5f72e7f7ef8137,1,2,0,2,0,0,0,8,19,310,1,1,0,466,0,0,77,77,0,2808,2784,24,22,22,0,1,100
9f2c94f97a01a90ecfd97e08dced7565cca97392,5,134,134,0,0,0,0,18,49,831,1,1,1.544521602,3040,422,0,340,340,0,17435,17435,0,153,153,0,1,100
153dad299556785e7e8799de50f0887042dcb2e4,3,63,0,63,0,0,0,2,109,261,1,2,0.618132801,1379,423,1,295,279,16,7903,7502,401,79,77,2,1,100
67584c17cee063a91ee5d4cba009c8f8463f7f99,1,0,1,1,0,0,0,2,3,21,1,1,0,515,3,2,90,90,0,3709,3716,7,16,16,0,1,100
e64833bbd87298e55cf24bf43989eadb08741abf,13,2913,1,2912,11,0,11,1,47,30,4,6,2.784501622,921,0,0,578,161,417,21049,5140,15909,228,48,180,1,98.60253494
a3a8f3e64893b538627b912d7e8b52bf4a6fcd1c,1,1,1,0,0,0,0,14,34,136,1,1,0,696,54,0,130,128,2,4232,4220,12,19,19,0,1,100
9f121a7917128c3e96dcb98c03e6578ef7aa18bd,0,0,0,0,0,0,0,0,0,0,0,0,0,0,99,0,0,0,0,0,0,0,0,0,0,1,100
c4923f885a8c1a03d7ef81ecd989463593d71851,13,1,2913,2912,0,11,11,2,48,0,4,6,2.784501622,3833,67,0,161,578,417,5140,21049,15909,48,228,180,1,98.60253494
9a2b9a0b8db215a8a149372ae9334dc09284a62d,1,21,8,13,0,0,0,20,120,105,1,1,0,3269,424,2,846,846,0,18659,18598,61,86,86,0,1,100
4a2347e5205cf69b6cfbc9885e3fed63899e8ef5,3,94,12,82,0,0,0,1,10,235,1,3,1.156429434,1379,425,3,205,194,11,8748,8267,481,92,86,6,1,100
ce32230744590110fe2eda4d1ddbdb86265f8767,0,0,0,0,0,0,0,0,0,0,0,0,0,0,100,1,0,0,0,0,0,0,0,0,0,1,100
3391876d426dce64cc687e139b7def28f6b2b12b,0,0,0,0,0,0,0,0,0,0,0,0,0,0,13,0,0,0,0,0,0,0,0,0,0,2,100
a04a89b46f3b91e7bfffbac23597bcbc640ef20b,13,2913,1,2912,11,0,11,2,49,13,4,6,2.784501622,921,1,1,578,161,417,21049,5140,15909,228,48,180,1,98.60253494
0e5da90690a06ab924b38a37d05aa808ef10792e,0,0,0,0,0,0,0,0,0,0,0,0,0,0,68,1,0,0,0,0,0,0,0,0,0,1,100
a6005001713eb287c7a84507adcd5f9933dc4e7d,0,0,0,0,0,0,0,0,0,0,0,0,0,0,2,2,0,0,0,0,0,0,0,0,0,1,100
8ed0d334ae1fd5ee05b96564499ef407da940244,0,0,0,0,0,0,0,0,0,0,0,0,0,0,3,3,0,0,0,0,0,0,0,0,0,1,100
3bb5c083856f09de16dabd3e2ee5de29e746f420,1,10,2,8,0,0,0,11,117,355,1,1,0,1353,426,4,326,324,2,8289,8253,36,52,52,0,1,100
57a01c74e1d7c58377eb28c5ccea17f5e06490fe,2,16,2,14,0,0,0,2,16,244,2,2,0.764204507,442,428,0,107,103,4,2523,2439,84,9,9,0,1,100
38f7cc98dd80bd6a585297a13232313f4cc43e1d,0,0,0,0,0,0,0,0,0,0,0,0,0,0,69,2,0,0,0,0,0,0,0,0,0,2,100
ddca805447a628aca27d024da1dbdfe6d48d42d4,5,143,6,137,1,0,1,1,110,118,2,4,1.859434034,3329,427,3,756,729,27,20244,19467,777,164,157,7,1,99.91975606
14c64913a85eca154b2f3051cee999b06e475ef2,0,0,0,0,0,0,0,0,0,0,0,0,0,0,4,3,0,0,0,0,0,0,0,0,0,1,100
ff744a2879af79068e059e6ab2c2bcc6f00195ff,0,0,0,0,0,0,0,0,0,0,0,0,0,0,3,0,0,0,0,0,0,0,0,0,0,0,100
e194002e3f235802a3a512fa75854ed19e4e4266,2,35,24,11,0,0,0,6,11,352,2,2,0.728656167,472,429,0,88,83,5,2218,2108,110,18,18,0,1,100
9f2672ccc99271d36a03d0815ff8e864a18b0ef5,0,0,0,0,0,0,0,0,0,0,0,0,0,0,3,0,0,0,0,0,0,0,0,0,0,1,100
23b2f53af7ed35170919546b692ed7c257cfe23e,1,13,61,48,0,0,0,8,18,212,1,1,0,744,4,1,82,96,14,3905,4298,393,10,10,0,1,100
03338d66847a0ec73ab8b08687c485e17d079e73,3,36,0,36,0,0,0,1,11,87,1,3,1.251629167,1461,428,0,208,205,3,9021,8748,273,95,92,3,1,100
4ac29d0485cdab15652157f4a0409c7bee9b35e6,0,0,0,0,0,0,0,0,0,0,0,0,0,0,70,0,0,0,0,0,0,0,0,0,0,1,100
ce3339c8ab653d99382caba9b2e5f306a7118561,0,0,0,0,0,0,0,0,0,0,0,0,0,0,5,2,0,0,0,0,0,0,0,0,0,1,100
