CommitID,NMF,TotalAddLines,TotalDeleteLines,LC,FileAdd,FileDelete,NAD,NDVE,NUC,AGE,NMS,NMD,Entropy ,MLMF,EXP,REXP,CommitComplexity,LastCommitComplexity,CFC,CommitTokenCount,LastCommitTokenCount,NCC,CommitMethodNum,LastCommitMethodNum,NMC,NIR,a2a,Tag
e2c52d62b100e0ed2b2ce3e47dc8a9ee0aab19d6,0,0,0,0,0,0,0,0,0,0,0,0,0.0,0,208,5,0,0,0,0,0,0,0,0,0,1,100.0,NoArch
68d5f57273ee05b05dceca33397fe8ac2b7337fc,0,0,0,0,0,0,0,0,0,0,0,0,0.0,0,90,1,0,0,0,0,0,0,0,0,0,1,100.0,NoArch
fe854a061e0948f27437fb5d9e6f24f0cac0f372,1,1,1,0,0,0,0,5,62,31,1,1,0.0,891,237,1,193,194,1,5410,5418,8,34,34,0,1,100.0,NoArch
ab0b91fd666feb034a7a3c06d419d915f8c6721d,2,20,21,1,0,0,0,16,129,19,1,2,0.659375881,3842,31,0,744,744,0,24804,24779,25,85,84,1,1,100.0,NoArch
13620b2647899732452ad883a33cd4e98fe70edb,1,15,2,13,0,0,0,7,16,351,1,1,0.0,839,103,0,179,177,2,5081,5018,63,22,22,0,1,99.46356728,NoArch
1796bc1f1d4ddd577f8ca8a515b16685c64ad955,1,23,22,1,0,0,0,10,24,0,1,1,0.0,437,62,2,62,62,0,2487,2487,0,13,13,0,0,100.0,NoArch
f5b3f1e1871c9ad53db3491f16288c0810c0ab75,0,0,0,0,0,0,0,0,0,0,0,0,0.0,0,42,2,0,0,0,0,0,0,0,0,0,1,100.0,NoArch
11b3f309176002aac571fbb459695f3106b8c04a,1,16,5,11,0,0,0,12,83,1,1,1,0.0,2550,204,3,694,711,17,14139,14365,226,58,60,2,1,100.0,NoArch
85a79f621b58a149eb4f72f16cea990ed17b11a1,0,0,0,0,0,0,0,0,0,0,0,0,0.0,0,2,2,0,0,0,0,0,0,0,0,0,1,100.0,NoArch
a8fea7b6d2d40dc13a8aa4e92852fedc2dde5b40,0,0,0,0,0,0,0,0,0,0,0,0,0.0,0,189,1,0,0,0,0,0,0,0,0,0,1,100.0,NoArch
36b1286e88e577a43f6b548dd8e8220b1c6ea890,4,67,11,56,0,0,0,2,29,579,1,2,1.298518571,1242,66,2,89,81,8,7804,7383,421,29,26,3,0,100.0,NoArch
bb05c645fccb45dcadeaf557fa7dd174413d7af3,2,44,27,17,0,0,0,1,2,8,1,2,0.998711751,306,347,4,32,32,0,1928,1809,119,16,14,2,1,100.0,NoArch
d5e3dc8c722e7ec4f035139c7c20e706aa82b146,0,0,0,0,0,0,0,0,0,0,0,0,0.0,0,47,5,0,0,0,0,0,0,0,0,0,1,100.0,NoArch
a6daa264b6752ecd64473462799b774f621a2f6f,2,76,11,65,0,0,0,5,45,213,1,2,0.269055303,825,182,1,130,120,10,4490,4165,325,63,60,3,1,100.0,NoArch
5ea8062df77769ddb02235c7e8f3b51185143b3d,7,148,486,338,1,0,1,8,39,120,6,6,2.735467088,2710,139,3,417,458,41,11926,13401,1475,113,116,3,1,99.91183213,NoArch
d02cdaee6069f5ae350115f46543f7c2da00e4f5,1,4,4,0,0,0,0,6,17,586,1,1,0.0,390,80,0,81,81,0,1936,1944,8,38,38,0,1,100.0,NoArch
0736d98e23441a112567b470254cc47bbdf2cb69,1,14,17,3,0,0,0,13,27,267,1,1,0.0,284,39,1,41,42,1,1342,1351,9,21,21,0,1,100.0,NoArch
adb0735e336e99c2a6d1a20fcd4a8892f9e4a4a7,2,79,3,76,0,0,0,21,61,98,1,2,0.226410948,2259,142,2,494,477,17,12979,12453,526,114,113,1,1,100.0,NoArch
e3ff179223f87b8fe3c66b08d6c48eda3f0e6f7b,1,4,0,4,0,0,0,2,5,26,1,1,0.0,158,13,1,20,18,2,923,888,35,3,3,0,1,100.0,NoArch
e47c0a78aef9d4ccbc0db6945cb1e84340e54f96,1,3,1,2,0,0,0,2,2,1337,1,1,0.0,556,6,0,105,104,1,3324,3309,15,17,17,0,1,100.0,NoArch
86a87b9e6c61eaf803f3527ba3a6ab4af11b696c,2,15,1,14,0,0,0,2,215,1049,1,2,0.337290067,6153,69,0,1234,1231,3,41107,41037,70,160,158,2,1,100.0,NoArch
f0797138f6bdf9432400d1c2743b5ea7351a0c8d,3,308,0,308,2,0,2,1,10,768,1,2,1.04485093,125,344,1,49,17,32,2422,600,1822,18,4,14,1,99.95156447,NoArch
0878d19e9fc39c13c136411ee4df6c6fa33c7b43,2,50,32,18,0,0,0,6,67,164,1,2,0.499179836,2617,40,2,555,554,1,13507,13428,79,61,60,1,1,100.0,NoArch
f1a71e0a9381bf53f4f020a92f0315548190bf7f,4,14,15,1,0,0,0,5,42,161,1,3,1.467549308,5994,19,2,333,333,0,44521,44578,57,281,281,0,1,100.0,NoArch
23c7b1148533275dffb37853b49a6ebdb8126a7e,1,51,36,15,0,0,0,6,44,18,1,1,0.0,1309,311,3,332,327,5,7165,7047,118,29,29,0,1,100.0,NoArch
bcd501a8d88135e1917019463a47d2349e16a166,2,64,3,61,0,0,0,11,25,1469,1,1,0.839530498,1231,11,1,239,211,28,6503,6018,485,40,38,2,1,100.0,NoArch
6f48a62076ba0e5ab738ae3f0fb368b2b81b0529,1,1,2,1,0,0,0,2,4,74,1,1,0.0,135,78,9,18,18,0,741,746,5,5,5,0,0,100.0,NoArch
0c72d21ca917327ce25ef4bfb54ff0316de643d0,1,120,91,29,0,0,0,2,3,1143,1,1,0.0,449,16,0,64,57,7,3079,2913,166,12,12,0,1,100.0,NoArch
2118a71638055f7d44a94cbaed90809c53aead67,2,9,1,8,0,0,0,11,107,53,2,2,0.881290899,3907,127,1,706,705,1,26350,26296,54,80,79,1,1,100.0,NoArch
a3a553d753af2eff846f1f6fd23eb4f6352cbd75,1,22,4,18,0,0,0,17,107,80,1,1,0.0,3230,47,0,816,815,1,17925,17850,75,81,80,1,1,100.0,NoArch
eea868860d283f53d9d24de8909cf5d68b6cf1b7,4,21,9,12,0,0,0,7,48,251,2,3,1.770894436,4057,319,5,911,909,2,20666,20572,94,198,198,0,1,100.0,NoArch
146a9de187ee960e7fd8f4686716bcda182b7652,0,0,0,0,0,0,0,0,0,0,0,0,0.0,0,418,8,0,0,0,0,0,0,0,0,0,1,100.0,NoArch
e00e11eb7afb90bfa5d86c55d30efade2a8b99a3,2,8,0,8,0,0,0,6,21,1440,2,2,0.811278124,1251,5,0,124,123,1,6636,6592,44,28,28,0,1,100.0,NoArch
ce120640e15d0a85ff4ed744ba59c5a6cb72c4e2,0,0,0,0,0,0,0,0,0,0,0,0,0.0,0,64,10,0,0,0,0,0,0,0,0,0,0,100.0,NoArch
d3ae6231664ea445192c84036ed77a635496f331,1,3,0,3,0,0,0,3,14,3035,1,1,0.0,67,223,1,8,7,1,286,263,23,2,2,0,1,100.0,NoArch
d17fa2c7230260cc3d4ddbef3fc6ab8bddb4154a,1,14,11,3,0,0,0,1,2,152,1,1,0.0,191,101,0,24,22,2,1113,1069,44,3,3,0,1,100.0,NoArch
7dac4e178b94c949da7c727fb2e749b50d933bb5,0,0,0,0,0,0,0,0,0,0,0,0,0.0,0,55,0,0,0,0,0,0,0,0,0,0,1,100.0,NoArch
883666c6755d6f291650f17ad81ef2e0c87ad872,0,0,0,0,0,0,0,0,0,0,0,0,0.0,0,0,0,0,0,0,0,0,0,0,0,0,1,100.0,NoArch
50fb124e52235fd076b6bf6a68940ac9f5cb0ed5,0,0,0,0,0,0,0,0,0,0,0,0,0.0,0,8,0,0,0,0,0,0,0,0,0,0,1,100.0,NoArch
71023632235ec0ad1e85962f47153c586983b225,0,0,0,0,0,0,0,0,0,0,0,0,0.0,0,20,2,0,0,0,0,0,0,0,0,0,0,100.0,NoArch
3bb5c083856f09de16dabd3e2ee5de29e746f420,1,10,2,8,0,0,0,11,117,355,1,1,0.0,1353,426,4,326,324,2,8289,8253,36,52,52,0,1,100.0,NoArch
f9926cd6d4113e00e508496665cc36d092168323,0,0,0,0,0,0,0,0,0,0,0,0,0.0,0,43,3,0,0,0,0,0,0,0,0,0,1,100.0,NoArch
a6f6f1f8cbd5c7d8b12631c2c8bdf1acb6c32555,0,0,0,0,0,0,0,0,0,0,0,0,0.0,0,86,0,0,0,0,0,0,0,0,0,0,1,100.0,NoArch
03fa94cb91904d33f1fa925581e5978522da998d,1,1,1,0,0,0,0,6,11,264,1,1,0.0,567,17,6,97,97,0,2785,2785,0,31,31,0,1,100.0,NoArch
f01bcf3d003500eaa28c1f48b8eac83fb037298a,3,0,3,3,0,0,0,8,14,275,2,3,1.584962501,962,38,3,140,140,0,5084,5105,21,33,33,0,1,100.0,NoArch
afb1f208557dbe308d0e2c5fdbe833fcbffb6111,5,107,124,17,0,0,0,4,61,154,1,4,1.900175762,5303,325,2,1133,1142,9,31156,31275,119,208,209,1,1,100.0,NoArch
9651c029e95bf09bb7054308fee1abb1a236d49f,0,0,0,0,0,0,0,0,0,0,0,0,0.0,0,91,0,0,0,0,0,0,0,0,0,0,1,100.0,NoArch
a6c9065c65e125771cf3b2ffb58599687b7dd387,3,8,3,5,0,0,0,2,66,31,1,1,1.309296668,1274,244,3,280,276,4,7535,7441,94,50,50,0,1,100.0,NoArch
845700e977d5560186557105ae7bb5c4c5793d92,1,3,2,1,0,0,0,26,195,90,1,1,0.0,5405,8,2,1077,1077,0,36674,36660,14,123,123,0,1,100.0,NoArch
0a160d601c9004697a49c2f2bbcfc1d4382d1c6a,2,684,0,684,2,0,2,1,1,0,1,1,0.537376085,0,97,0,43,0,43,4183,0,4183,24,0,24,1,99.30184805,NoArch
a38480fe35e878b0eb1b505bc978a8bc2432235c,22,26,58,32,0,0,0,10,96,636,9,19,4.301535841,13555,67,0,2383,2389,6,75522,75606,84,449,449,0,1,100.0,NoArch
0f0f1d375abf5b3c640c53d75fff38c7405a4e38,0,0,0,0,0,0,0,0,0,0,0,0,0.0,0,24,4,0,0,0,0,0,0,0,0,0,1,100.0,NoArch
1a68c9586dcf74c4c0ed29035678d28a907ce94e,1,5,3,2,0,0,0,1,2,30,1,1,0.0,90,34,1,6,6,0,410,394,16,6,6,0,1,100.0,NoArch
73394a7b681abae0e3cf3a72445d7165da23b774,0,0,0,0,0,0,0,0,0,0,0,0,0.0,0,48,4,0,0,0,0,0,0,0,0,0,1,100.0,NoArch
fd931f20270d4db8187b885b9e7f95c8261fdd82,2,10,14,4,0,0,0,1,6,104,1,1,0.543564443,644,164,9,29,30,1,4103,4140,37,10,10,0,1,100.0,NoArch
bb420d5c2493e4aa159f3be7b2cbc213bc3c30b3,1,20,0,20,0,0,0,2,7,2,1,1,0.0,563,90,3,35,33,2,2853,2740,113,16,15,1,0,100.0,NoArch
24d15821c13dd6727417b244c9f25ce8f77fabfb,0,0,0,0,0,0,0,0,0,0,0,0,0.0,0,167,6,0,0,0,0,0,0,0,0,0,1,100.0,NoArch
16f481ba888077acb4daf5705896a8318aa6a24e,19,588,332,256,1,0,1,3,106,201,4,9,3.237600069,14500,160,6,2349,2289,60,91188,89432,1756,448,442,6,1,99.89118607,NoArch
44691b556dfe427d0c873c4f6537f55fa207a28c,2,1006,0,1006,2,0,2,1,1,0,1,1,0.441295579,0,119,4,86,0,86,3389,0,3389,80,0,80,2,99.91401548,NoArch
d5511352c63466a603a7090b7ee1b54b0a17060f,2,29,18,11,0,0,0,10,20,1894,2,2,0.973385435,656,6,0,192,188,4,4586,4477,109,20,20,0,1,100.0,NoArch
95a8dce283647f91d625a732c36db3c8c7434719,0,0,0,0,0,0,0,0,0,0,0,0,0.0,0,0,0,0,0,0,0,0,0,0,0,0,1,100.0,NoArch
24986f105534fd6fe07e4ba688df666d595430bd,1,2,2,0,0,0,0,9,16,0,1,1,0.0,248,31,3,43,42,1,1306,1299,7,14,14,0,1,100.0,NoArch
c5bf2f6364a97539451656d28fd36e35d8e2736d,5,141,63,78,0,0,0,20,178,182,2,4,1.236433715,11515,0,0,2326,2316,10,76966,76241,725,289,287,2,1,100.0,NoArch
c66c8384757be11335d62f72e63b8da5a5f58234,0,0,0,0,0,0,0,0,0,0,0,0,0.0,0,60,3,0,0,0,0,0,0,0,0,0,1,100.0,NoArch
c3a2b50c4d62987b101735087df40f7de97075de,2,12,3,9,0,0,0,2,94,385,1,2,0.566509507,2529,22,1,437,429,8,15106,15003,103,59,59,0,1,100.0,NoArch
ab5aab216e3cf7477a2151c24a1f29e9991aa548,1,2,2,0,0,0,0,7,10,1332,1,1,0.0,143,2,0,23,23,0,764,764,0,5,5,0,1,100.0,NoArch
26127d6bf438e1c506c2ec398f2d6eb96b6f84ee,1,2,2,0,0,0,0,3,6,33,1,1,0.0,138,137,1,6,6,0,807,807,0,6,6,0,1,100.0,NoArch
b995253899ef6e204be70473e6ed94764f25107b,0,0,0,0,0,0,0,0,0,0,0,0,0.0,0,34,0,0,0,0,0,0,0,0,0,0,1,100.0,NoArch
3171f5b38908e18d7ac40d27a1737e3d41370d9a,1,21,32,11,0,0,0,7,9,2077,1,1,0.0,116,3,1,11,12,1,431,463,32,3,3,0,1,100.0,NoArch
b69227eb2f6b8aacb539a6454c714923257de059,27,1526,140,1386,4,0,4,4,180,237,3,12,3.97126575,19738,212,0,4062,3816,246,129665,121877,7788,736,674,62,1,99.86238532,NoArch
fc95accb67c1a7e0acf49b5b847fc0a69346c7c4,0,0,0,0,0,0,0,0,0,0,0,0,0.0,0,359,6,0,0,0,0,0,0,0,0,0,1,100.0,NoArch
ed3a3c62fb5941ad9c11b4c800a26b9d10e49493,1,5,0,5,0,0,0,20,41,119,1,1,0.0,331,3,1,51,49,2,1668,1638,30,28,28,0,1,100.0,NoArch
087aef3b31ef6a16d42806b0b06ebaca1c4dc7a2,0,0,0,0,0,0,0,0,0,0,0,0,0.0,0,1,1,0,0,0,0,0,0,0,0,0,1,100.0,NoArch
da8ba041b72e0caee90378ddcd08e122b6ce6ecc,5,10,0,10,0,0,0,8,41,94,4,4,2.321928095,2233,51,1,406,406,0,11370,11280,90,107,107,0,1,100.0,NoArch
28c1fe70c9ae30adc60968681dbb6f85e9981ee5,2,17,19,2,0,0,0,5,12,287,1,2,0.183122068,588,7,1,85,90,5,3553,3638,85,14,14,0,1,100.0,NoArch
4a92117d0e40a6b386996d0addd0d8b3b23bed7b,2,26,4,22,0,0,0,5,26,90,1,2,0.353359335,1644,386,4,364,358,6,9417,9226,191,76,76,0,1,100.0,NoArch
11a7bf8f37af1d7501df4492de95f7c9d796ab07,1,2,2,0,0,0,0,2,7,33,1,1,0.0,185,141,1,25,25,0,934,934,0,10,10,0,1,100.0,NoArch
9ad5348947073523b59c92819dcd92510e6df249,1,3,3,0,0,0,0,5,14,86,1,1,0.0,322,0,0,46,46,0,1695,1695,0,6,6,0,1,100.0,NoArch
676831d4a39c8c0f416e73edb51987e59ee2d096,1,10,2,8,0,0,0,11,18,228,1,1,0.0,395,0,0,49,47,2,1939,1886,53,12,12,0,1,100.0,NoArch
20315eabbc93d824772981d3cec82f4a4e284b7e,33,68,76,8,0,0,0,6,19,404,12,24,5.010784558,6500,138,2,978,978,0,35257,35327,70,179,179,0,1,100.0,NoArch
8c86743ef79fe06e49c8aafd0ed4acff02959742,4,329,0,329,1,0,1,14,33,274,4,4,1.401554124,1616,421,0,234,194,40,11751,9864,1887,150,122,28,1,99.96710526,NoArch
d2a0f113223603a5a4e19cf741fc3fc1c8c52170,28,21,374,353,0,2,2,5,37,163,17,25,3.164029657,12081,99,2,1853,1905,52,57975,59960,1985,537,547,10,1,99.91928975,NoArch
9f5721bbed8057586e63a5ea5552ddecf5cc67ca,10,716,199,517,0,0,0,13,55,413,2,8,2.608357039,10010,7,0,1577,1435,142,65676,62043,3633,383,373,10,1,99.82234066,NoArch
375e736dedd5c766d747e9c68934ef7c3ab2a398,0,0,0,0,0,0,0,0,0,0,0,0,0.0,0,334,1,0,0,0,0,0,0,0,0,0,0,100.0,NoArch
9db488807ae8731106c8d15ce9203df0fe8579c7,1,49,32,17,0,0,0,18,59,36,1,1,0.0,1779,27,2,339,333,6,12456,12313,143,102,100,2,1,100.0,NoArch
89e11bcc2a6782dec11f3f88e459dc6aa8691931,1,9,3,6,0,0,0,3,34,7,1,1,0.0,811,318,4,176,170,6,4524,4458,66,36,36,0,1,100.0,NoArch
23b49c581dedea32bf8a03b503f9337530427521,0,0,0,0,0,0,0,0,0,0,0,0,0.0,0,7,0,0,0,0,0,0,0,0,0,0,1,100.0,NoArch
12d9e21ac27edb5a23c7505ecb07b47c987bcbdd,0,0,0,0,0,0,0,0,0,0,0,0,0.0,0,0,0,0,0,0,0,0,0,0,0,0,1,100.0,NoArch
c31d4e45281d18b2f18be315d58dc21ea02c7c47,36,2221,530,1691,4,0,4,2,179,873,3,17,4.011051757,26441,313,2,5271,4914,357,169207,159276,9931,1087,1014,73,1,99.80067464,NoArch
3bfdf4ee93d66e4ac8011e45f7c07f01db3126d3,0,0,0,0,0,0,0,0,0,0,0,0,0.0,0,7,7,0,0,0,0,0,0,0,0,0,1,100.0,NoArch
a98dc785a61ee9bbb1cdb4f8caac5a87dd163ed1,1,4,1,3,0,0,0,15,121,9,1,1,0.0,3291,18,2,634,632,2,20718,20690,28,70,70,0,1,100.0,NoArch
63b211ec25f9730ec1523fa4a2282cf05394cbf6,0,0,0,0,0,0,0,0,0,0,0,0,0.0,0,165,4,0,0,0,0,0,0,0,0,0,0,100.0,NoArch
d8e8890ba228a21ea046c70bb4e2ee4c7e6f07b9,10,39,29,10,0,0,0,2,27,298,3,9,2.985849601,4806,121,2,951,946,5,26293,26249,44,184,185,1,1,100.0,NoArch
042512e4d1b304ec4da423434a4ba6143a174ed5,1,5,2,3,0,0,0,4,7,465,1,1,0.0,842,0,0,150,150,0,5246,5229,17,72,72,0,1,100.0,NoArch
edd0bd6a69b4919745d79119e943ad4b330941d0,1,100,0,100,0,0,0,10,66,0,1,1,0.0,1614,37,5,502,488,14,9003,8406,597,37,33,4,0,100.0,NoArch
f6685bd4af4dd9ef87c10c294709e3a1b37d4f50,5,17,17,0,0,0,0,2,97,324,1,4,1.780446315,3061,332,7,667,666,1,17489,17485,4,105,105,0,1,100.0,NoArch
09700f35ad41dbb7c23cedbc8ee68a16d9565de8,620,2830,2830,0,0,0,0,5,109,662,37,149,8.556221563,163695,95,6,23226,23226,0,777806,777806,0,7612,7612,0,0,100.0,NoArch
0baf6a4c9bc0a35c0d635fa6001c1a0842b20423,1,20,13,7,0,0,0,16,37,88,1,1,0.0,851,4,0,244,240,4,5564,5504,60,27,27,0,0,100.0,NoArch
717ea1a5813ddb82163fc5b414f055c627908f72,0,0,0,0,0,0,0,0,0,0,0,0,0.0,0,83,4,0,0,0,0,0,0,0,0,0,1,100.0,NoArch
e0c1e355a94cdecdf60e6d9eb0c54ff6d3bd412d,5,105,19,86,0,0,0,9,135,390,1,5,1.817867716,10102,16,1,1529,1514,15,68255,67781,474,227,223,4,1,100.0,NoArch
da730073faaa0d426b9dded8b3c448cd44536f10,110,934,738,196,0,0,0,8,52,315,4,35,5.673862241,34478,146,6,6056,6019,37,186956,185471,1485,1893,1895,2,1,100.0,NoArch
f246f4397f2a2c8bfa596a2b0dada0874c77e6aa,17,817,822,5,0,0,0,3,19,3912,2,6,3.843669251,1863,51,5,195,195,0,8303,8303,0,61,61,0,1,100.0,NoArch
d8e9c489d4bff72cb80661a268b35d5a01688586,2,432,262,170,1,0,1,1,2,121,1,1,0.961311725,505,123,0,127,96,31,3605,2557,1048,21,18,3,1,99.96849401,NoArch
88c73dfe682c9b868c6c8c8ecc34082afb5e1e71,1,2,2,0,0,0,0,5,12,32,1,1,0.0,339,75,4,76,76,0,1797,1797,0,12,12,0,1,100.0,NoArch
8fbee8b6d081cd603c704cf977fa79504686ee18,2,1,252,251,0,0,0,17,112,109,1,1,0.46522548,3738,56,3,867,944,77,19290,20662,1372,92,103,11,2,100.0,NoArch
d6d5c2c3127f1d47a99637a95d34edb7559ee160,4,7,9,2,0,0,0,2,13,306,1,3,1.905639062,894,127,4,138,138,0,4674,4678,4,27,27,0,0,100.0,NoArch
35bf9fc966d9993607eb23a98a98610e8765bee4,3,80,8,72,1,0,1,9,28,731,2,2,0.985514869,496,210,2,79,71,8,2633,2250,383,18,15,3,1,99.75505205,NoArch
fd90d0d4d37b2a2ca4c82b641929153a4dfb31dd,6,158,93,65,0,0,0,7,24,2048,1,5,1.981804653,2278,157,1,305,292,13,11585,11062,523,80,78,2,1,99.94570136,NoArch
b51cd90f8da84cb0b753d25fcb420405fe42972c,2,4,4,0,0,0,0,3,13,59,1,1,1.0,690,137,2,100,100,0,3478,3462,16,34,34,0,1,100.0,NoArch
30730b1f691ba5ff7ebcddab78102c18b4deb734,0,0,0,0,0,0,0,0,0,0,0,0,0.0,0,19,0,0,0,0,0,0,0,0,0,0,1,100.0,NoArch
21b7ce54991594162c1868eb994640dfbde5593b,3,28,34,6,0,0,0,3,5,1782,1,2,0.409633444,664,20,0,57,57,0,3300,3374,74,35,35,0,1,100.0,NoArch
6edcaab9d642c9500b39fb8940eb286988737a02,0,0,0,0,0,0,0,0,0,0,0,0,0.0,0,9,2,0,0,0,0,0,0,0,0,0,1,100.0,NoArch
b60a6e291e960ea915155b414fa3c43378386720,0,0,0,0,0,0,0,0,0,0,0,0,0.0,0,386,0,0,0,0,0,0,0,0,0,0,1,100.0,NoArch
5a736c2aaab7a7498dd143ce5078ba4e605536d9,0,0,0,0,0,0,0,0,0,0,0,0,0.0,0,191,3,0,0,0,0,0,0,0,0,0,0,100.0,NoArch
4daf1e9ed9f89f389f8cdb74baa1792f92fc2466,1,1,1,0,0,0,0,8,24,369,1,1,0.0,313,2,0,64,64,0,1946,1946,0,6,6,0,1,100.0,NoArch
4ac29d0485cdab15652157f4a0409c7bee9b35e6,0,0,0,0,0,0,0,0,0,0,0,0,0.0,0,70,0,0,0,0,0,0,0,0,0,0,1,100.0,NoArch
23609f17a91c788b8016e38e13fa2906cff44e5b,2,8,8,0,0,0,0,4,13,20,1,2,1.0,260,100,3,31,31,0,1247,1247,0,12,12,0,0,100.0,NoArch
cd00c1020af18691c27a156e5180e09b45b6c831,8,44,77,33,0,0,0,13,64,423,4,7,2.138143603,7196,74,1,1447,1455,8,40946,41079,133,373,375,2,1,100.0,NoArch
1825aa2306eb024ee20f9e1fe737699862217409,1,14,3,11,0,0,0,3,3,2125,1,1,0.0,307,385,5,41,41,0,2079,1955,124,10,10,0,1,100.0,NoArch
e219c2511c131a78a04b11e534240b031d72e862,0,0,0,0,0,0,0,0,0,0,0,0,0.0,0,14,1,0,0,0,0,0,0,0,0,0,1,100.0,NoArch
be601220666a1694a293f25b39db729fa1d69358,9,65,136,71,0,1,1,3,57,1451,7,8,2.090707677,7518,373,0,996,1006,10,41018,41238,220,346,347,1,1,99.93312155,NoArch
e6f96c09225a2e52353f5a338a9f020cbbdc865f,3,2,6,4,0,0,0,9,46,108,1,2,1.5,3276,18,1,397,397,0,21836,21875,39,86,86,0,1,100.0,NoArch
62c9aeca807bd056c69a4b902db32a962c13590a,0,0,0,0,0,0,0,0,0,0,0,0,0.0,0,16,2,0,0,0,0,0,0,0,0,0,3,100.0,NoArch
ddca805447a628aca27d024da1dbdfe6d48d42d4,5,143,6,137,1,0,1,1,110,118,2,4,1.859434034,3329,427,3,756,729,27,20244,19467,777,164,157,7,1,99.91975606,NoArch
2b9f76e818e404ae824b40479f6c3cb84d870a92,0,0,0,0,0,0,0,0,0,0,0,0,0.0,0,19,1,0,0,0,0,0,0,0,0,0,1,100.0,NoArch
a871937e6fd6eb26c343a9fda590190b89fea277,0,0,0,0,0,0,0,0,0,0,0,0,0.0,0,37,2,0,0,0,0,0,0,0,0,0,1,100.0,NoArch
34277d811269105f7306ac581be4a773db280c4f,1,13,3,10,0,0,0,1,6,962,1,1,0.0,597,14,1,92,90,2,4576,4478,98,65,63,2,1,100.0,NoArch
7c0cc2835cead1b90107df114dd35bd7bb172e15,0,0,0,0,0,0,0,0,0,0,0,0,0.0,0,379,1,0,0,0,0,0,0,0,0,0,1,100.0,NoArch
686d6144eefe5470232a9704729d5fbef299f7dd,0,0,0,0,0,0,0,0,0,0,0,0,0.0,0,81,0,0,0,0,0,0,0,0,0,0,1,100.0,NoArch
d8e9c489d4bff72cb80661a268b35d5a01688586,2,432,262,170,1,0,1,1,2,121,1,1,0.961311725,505,123,0,127,96,31,3605,2557,1048,21,18,3,1,99.96849401,NoArch
79e91fa5f5175b3ddeab8d901f7e98697c9d639f,1,37,11,26,0,0,0,9,26,138,1,1,0.0,316,113,1,71,65,6,2173,1967,206,6,6,0,1,100.0,NoArch
ac6d8bf3ae4bc0a2c66660cb75a7c15014cf6f8c,0,0,0,0,0,0,0,0,0,0,0,0,0.0,0,1,0,0,0,0,0,0,0,0,0,0,1,100.0,NoArch
67584c17cee063a91ee5d4cba009c8f8463f7f99,1,0,1,1,0,0,0,2,3,21,1,1,0.0,515,3,2,90,90,0,3709,3716,7,16,16,0,1,100.0,NoArch
ae73baac78593cc0b665f279460e1f091a3a5273,0,0,0,0,0,0,0,0,0,0,0,0,0.0,0,91,12,0,0,0,0,0,0,0,0,0,1,100.0,NoArch
ba5353df997f68ce224a26757a0cc71d5c3bbabc,0,0,0,0,0,0,0,0,0,0,0,0,0.0,0,96,0,0,0,0,0,0,0,0,0,0,1,100.0,NoArch
6504a70eeeaefa6a7de18a0eb8f78f62dad76d9f,1,1,1,0,0,0,0,10,72,192,1,1,0.0,1743,166,0,508,508,0,9125,9125,0,38,38,0,1,100.0,NoArch
988f31ce174ca1df3b5949cc8e952af5ff10a00f,0,0,0,0,0,0,0,0,0,0,0,0,0.0,0,42,2,0,0,0,0,0,0,0,0,0,1,100.0,NoArch
148eb5e64bc3819ae49a2a531d85dc63386f65f0,4,0,6,6,0,0,0,6,18,0,1,3,1.79248125,1179,30,2,147,147,0,5632,5683,51,45,45,0,1,100.0,NoArch
13fd68222e9dd072c33f9bf36e8bff4dda928da1,3,74,5,69,0,0,0,9,59,9,1,3,1.03792972,4124,53,1,424,412,12,30228,29806,422,136,131,5,1,100.0,NoArch
886a9c6e196b12bc8cc0ae49a6d8e9bd8c244152,0,0,0,0,0,0,0,0,0,0,0,0,0.0,0,14,1,0,0,0,0,0,0,0,0,0,1,100.0,NoArch
304a5a118fb5351dd0baa4c69f325fc4a674b3d3,0,0,0,0,0,0,0,0,0,0,0,0,0.0,0,381,0,0,0,0,0,0,0,0,0,0,1,100.0,NoArch
d592d3fa2c2ea9f48f87b94f9ea5287f928df30d,1,1,10,9,0,0,0,1,6,0,1,1,0.0,292,184,6,12,12,0,1734,1808,74,5,5,0,0,100.0,NoArch
a15af08cab65ae631b1a853b6de8fa613925b1fa,0,0,0,0,0,0,0,0,0,0,0,0,0.0,0,33,1,0,0,0,0,0,0,0,0,0,1,100.0,NoArch
cc21e670f32d5033d8b0be938466d5bb813964cb,0,0,0,0,0,0,0,0,0,0,0,0,0.0,0,383,1,0,0,0,0,0,0,0,0,0,1,100.0,NoArch
5ab18c4ddd5bda99a7f1722728bed41b84de788c,3,3,138,135,0,0,0,4,31,266,1,3,1.506613124,3344,34,0,514,546,32,16436,17278,842,149,161,12,1,100.0,NoArch
17e37f0b68a5172c6c4b7c6d7c8a188ebc88f44a,3,9,9,0,0,0,0,3,13,572,1,2,1.530493057,1154,74,8,139,139,0,6511,6514,3,63,63,0,0,100.0,NoArch
cd67d7295a95049646c44c3bcf1fdd04895eff5d,0,0,0,0,0,0,0,0,0,0,0,0,0.0,0,77,5,0,0,0,0,0,0,0,0,0,1,100.0,NoArch
740c150b0d1bc716464c2bce1509a3b2c9f8cc07,0,0,0,0,0,0,0,0,0,0,0,0,0.0,0,24,0,0,0,0,0,0,0,0,0,0,1,100.0,NoArch
f909896df1310cf198509e5eac474402c9473b47,2,14,0,14,0,0,0,8,20,171,1,2,0.591672779,1176,340,0,198,192,6,6852,6684,168,38,38,0,1,100.0,NoArch
6116b415009edf0a48df9f59b66bf85f64caea23,1,1,1,0,0,0,0,2,2,2718,1,1,0.0,304,0,0,40,40,0,1107,1107,0,28,28,0,1,100.0,NoArch
641ef11a2e45887d689c986b2584fd3ba4c9fcc5,1,1,0,1,0,0,0,8,17,74,1,1,0.0,558,12,1,69,69,0,3258,3251,7,16,16,0,1,100.0,NoArch
98cb80e3335e7c9588b9ad5b57667d3421fba4e6,1,57,21,36,0,0,0,4,9,1226,1,1,0.0,303,207,3,53,47,6,1612,1460,152,15,14,1,1,100.0,NoArch
d4b86478f0b33e66e51a71cc03f83298f689c0b0,0,0,0,0,0,0,0,0,0,0,0,0,0.0,0,7,1,0,0,0,0,0,0,0,0,0,1,100.0,NoArch
546fc8718fb91c2b1587dd859ec663971f563b10,0,0,0,0,0,0,0,0,0,0,0,0,0.0,0,145,0,0,0,0,0,0,0,0,0,0,1,100.0,NoArch
ebcf9dd5e8c35a12b84405067bb7db0c5c3596c6,6,134,27,107,0,0,0,5,45,776,1,2,2.52664453,2817,35,1,573,550,23,18610,17616,994,110,106,4,1,100.0,NoArch
eb101791586fe974fa41671cd0bb004578368d09,1,1,1,0,0,0,0,5,9,360,1,1,0.0,546,130,7,115,115,0,3202,3198,4,14,14,0,0,100.0,NoArch
f6ff008a13d2fe25196d8f939369a1273829b927,0,0,0,0,0,0,0,0,0,0,0,0,0.0,0,27,4,0,0,0,0,0,0,0,0,0,1,100.0,NoArch
59ed6628e2b30e63f037a0dbbc27b8d28f773fc4,29,54,64,10,0,0,0,8,121,189,1,11,4.59961469,25876,9,1,3914,3919,5,163789,163898,109,587,587,0,0,100.0,NoArch
16353c268e9d4c4c5cfd44f12937386165435493,0,0,0,0,0,0,0,0,0,0,0,0,0.0,0,29,4,0,0,0,0,0,0,0,0,0,2,100.0,NoArch
45f145093338a1604015ec53670de4384722c530,1,1,1,0,0,0,0,7,10,246,1,1,0.0,225,8,4,42,42,0,945,945,0,10,10,0,1,100.0,NoArch
4daf1e9ed9f89f389f8cdb74baa1792f92fc2466,1,1,1,0,0,0,0,8,24,369,1,1,0.0,313,2,0,64,64,0,1946,1946,0,6,6,0,1,100.0,NoArch
147c28c11896edfd8e52ce275b28ede6204ac695,0,0,0,0,0,0,0,0,0,0,0,0,0.0,0,49,3,0,0,0,0,0,0,0,0,0,1,100.0,NoArch
ab131efd32f9ba3622aef865d1fd8b0832730dcc,1,8,1,7,0,0,0,6,45,20,1,1,0.0,1324,312,2,333,332,1,7187,7165,22,29,29,0,1,100.0,NoArch
de268eaa39cc3770ef5f6603fba8c47212df9823,0,0,0,0,0,0,0,0,0,0,0,0,0.0,0,8,1,0,0,0,0,0,0,0,0,0,1,100.0,NoArch
8d39dfe99051968055f0f46a9275f59a276fc84a,0,0,0,0,0,0,0,0,0,0,0,0,0.0,0,61,1,0,0,0,0,0,0,0,0,0,1,100.0,NoArch
f37f5407eee8d2627a4306a25938b151f8e2ba31,9,29,13,16,0,0,0,15,45,48,1,3,2.49849323,4218,63,2,210,210,0,23999,23831,168,132,132,0,1,100.0,NoArch
f937360f06535afccac39da7e1212820f17cbda6,1,8,1,7,0,0,0,8,18,124,1,1,0.0,383,222,1,71,70,1,2125,2094,31,19,19,0,1,100.0,NoArch
da426dc8da469585f1c8f05d5d70189ebc7e6592,2,22,3,19,0,0,0,2,58,22,1,1,0.998845536,692,2,0,119,116,3,4589,4454,135,22,21,1,1,100.0,NoArch
39b23e5a6cd6185c45853e43af72e6eb2f68f5cd,2,22,2,20,0,0,0,4,42,102,2,2,0.870864469,861,145,6,124,116,8,4562,4447,115,50,48,2,1,100.0,NoArch
183b5c2b9c5bea22d81a2142ef9fa6759dff6ead,1,6,2,4,0,0,0,5,5,1332,1,1,0.0,100,5,0,9,9,0,471,445,26,7,7,0,1,100.0,NoArch
e0d2402468d782553745d2b781cc10de26fcb7d6,1,24,1,23,0,0,0,5,8,44,1,1,0.0,523,29,1,115,107,8,3198,3049,149,14,13,1,1,100.0,NoArch
d92dd86c5575a23aa77467a178064e6f33caad77,0,0,0,0,0,0,0,0,0,0,0,0,0.0,0,47,3,0,0,0,0,0,0,0,0,0,1,100.0,NoArch
a9523814cf4b3763a3a8db7d7eb3161e624074c5,0,0,0,0,0,0,0,0,0,0,0,0,0.0,0,42,3,0,0,0,0,0,0,0,0,0,1,100.0,NoArch
4a99dab9ca2af75f67d8f6e68841060d469b77a3,0,0,0,0,0,0,0,0,0,0,0,0,0.0,0,164,0,0,0,0,0,0,0,0,0,0,1,100.0,NoArch
042512e4d1b304ec4da423434a4ba6143a174ed5,1,5,2,3,0,0,0,4,7,465,1,1,0.0,842,0,0,150,150,0,5246,5229,17,72,72,0,1,100.0,NoArch
d6c53d9cdef75c00c28cea487c70b3fceb63e672,3,15,11,4,0,0,0,6,88,224,2,3,1.238901257,2313,347,2,465,464,1,12547,12521,26,125,125,0,1,100.0,NoArch
787457b588a6e4ddac7d5bd31bfe613ede6478d8,4,13,0,13,0,0,0,2,12,834,1,1,1.987773371,1767,121,5,248,248,0,8057,7997,60,51,51,0,1,100.0,NoArch
869c723f126b7fa2b7c3aa796d805ec7e494de62,110,913,715,198,0,0,0,8,52,318,4,35,5.691173701,34478,10,1,6057,6019,38,186962,185471,1491,1893,1895,2,1,100.0,NoArch
2fac8c94813b672390516fe86d9174d5d16299a0,0,0,0,0,0,0,0,0,0,0,0,0,0.0,0,98,0,0,0,0,0,0,0,0,0,0,1,100.0,NoArch
79230377fd1e27c28e330dfac0f382c1a78b710d,0,0,0,0,0,0,0,0,0,0,0,0,0.0,0,4,4,0,0,0,0,0,0,0,0,0,1,100.0,NoArch
f2e36940c11642b7385e4af6d3b736ff952a7245,1,278,0,278,1,0,1,1,1,0,1,1,0.0,0,175,4,12,0,12,1681,0,1681,5,0,5,1,99.95698925,NoArch
72be01bb789e369158d73a841800b22f71a5c85a,1,6,9,3,0,0,0,9,25,25,1,1,0.0,686,318,4,82,82,0,3500,3516,16,51,51,0,1,100.0,NoArch
16cc0d30c08dd7ffe17095c451062203f32c26db,0,0,0,0,0,0,0,0,0,0,0,0,0.0,0,8,5,0,0,0,0,0,0,0,0,0,1,100.0,NoArch
e6c7afaa851cbcd5abe2f4881a6f9eaea6d2d64f,1,1,1,0,0,0,0,5,11,68,1,1,0.0,227,32,4,44,44,0,988,988,0,17,17,0,1,100.0,NoArch
58aa1bc298e38df0e10c8e0a79cc63a5fb2a5b33,1,42,27,15,0,0,0,6,10,125,1,1,0.0,357,2,0,58,53,5,2053,1952,101,13,13,0,1,100.0,NoArch
7c401b3e305c3ec7de47105a2980a9152ae04ce4,6,38,85,47,0,0,0,4,56,126,1,6,1.914532699,2110,194,2,396,405,9,11085,11271,186,104,107,3,1,100.0,NoArch
a14b6d6aa57d6bc0026713e73750df716c65aa8f,1,6,120,114,0,0,0,24,199,28,1,1,0.0,4335,11,0,876,903,27,27113,27901,788,98,101,3,1,100.0,NoArch
0a39904ac134736d1eeeb03ae83069c9896c8f97,7,78,10,68,1,0,1,18,54,662,4,7,2.616277246,4160,57,2,944,937,7,22375,22073,302,200,198,2,1,99.9240237,NoArch
7691bce9f37c4c0197468f7e236bd3ef9a54b7b0,7,144,4,140,0,0,0,17,50,1770,3,3,2.795687763,2578,151,1,534,508,26,14370,13698,672,179,155,24,0,100.0,NoArch
f7bdb442803355739c3dd5fcc3a79235d122a8f8,1,45,1,44,0,0,0,2,2,72,1,1,0.0,471,1,0,90,79,11,3716,3418,298,16,15,1,1,100.0,NoArch
a9e637cf8289e8de5f440b5e7a526aafd573aa0a,3,155,28,127,0,0,0,25,204,254,1,3,0.135735044,10078,18,0,2084,2049,35,67058,66131,927,249,245,4,1,100.0,NoArch
77e2c4429da45c426fd93d68c249ee74b8a77443,0,0,0,0,0,0,0,0,0,0,0,0,0.0,0,217,2,0,0,0,0,0,0,0,0,0,1,100.0,NoArch
e474c4d7b844c2cb3ac5609b68f56eee43ae4b64,1,1,1,0,0,0,0,6,13,289,1,1,0.0,217,0,0,37,37,0,1226,1226,0,6,6,0,1,100.0,NoArch
ba5353df997f68ce224a26757a0cc71d5c3bbabc,0,0,0,0,0,0,0,0,0,0,0,0,0.0,0,96,0,0,0,0,0,0,0,0,0,0,1,100.0,NoArch
df0e650881b48530f9495fdaca28feb6bc54a719,1,2,1,1,0,0,0,18,67,0,1,1,0.0,2291,12,3,520,520,0,15168,15168,0,77,77,0,1,100.0,NoArch
9a65430647be51aa52f3a61fcf3cb505bfb747c0,1,13,0,13,0,0,0,14,46,152,1,1,0.0,1162,0,0,284,282,2,7550,7498,52,43,42,1,1,100.0,NoArch
3ddd087a72ac3170ded270afb89bea8a131ad2ff,0,0,0,0,0,0,0,0,0,0,0,0,0.0,0,14,5,0,0,0,0,0,0,0,0,0,1,100.0,NoArch
84f9fb8fc5c50159906faac121164ad1b4442063,3,57,2,55,0,0,0,10,221,1469,1,3,1.260375942,4882,37,3,963,951,12,32072,31414,658,116,115,1,1,100.0,NoArch
90a6037d5611bb6ee725febd78e4de3ffe5971cf,0,0,0,0,0,0,0,0,0,0,0,0,0.0,0,82,1,0,0,0,0,0,0,0,0,0,1,100.0,NoArch
75b8a422cfe8ab8f9896720a98ac8bd739c065a1,21,278,289,11,0,0,0,13,70,741,10,18,2.361102473,13549,225,4,2520,2524,4,74623,75231,608,421,421,0,1,100.0,NoArch
358540dcfbaa78da2cae1c41e81fde983e91e510,1,18,13,5,0,0,0,5,61,57,1,1,0.0,886,236,8,194,191,3,5418,5355,63,34,34,0,1,100.0,NoArch
ae8e485f88700ae1f830ac406322e5d94c750864,0,0,0,0,0,0,0,0,0,0,0,0,0.0,0,138,9,0,0,0,0,0,0,0,0,0,1,100.0,NoArch
533f8dae644a833dd2d0df2eb7ea4d2c7f9f92f6,1,1,1,0,0,0,0,10,39,0,1,1,0.0,1457,163,1,272,272,0,10201,10211,10,92,92,0,1,100.0,NoArch
5a39409dc0f07db2fcf9175e10e46ca8e1f92f7d,1,12,26,14,0,0,0,8,12,156,1,1,0.0,224,12,1,40,42,2,873,943,70,10,10,0,1,100.0,NoArch
cca2e0c43b3dd6b97fc3a8e4819135b99a29266e,3,5,74,69,0,0,0,9,58,12,1,3,1.03792972,4193,97,18,412,424,12,29806,30228,422,131,136,5,1,100.0,NoArch
77e70cbbc29c23657d41a231927d559cc349aead,0,0,0,0,0,0,0,0,0,0,0,0,0.0,0,37,1,0,0,0,0,0,0,0,0,0,1,100.0,NoArch
6ba6af021e44d929fe77ef8fb60f0fe6a1c79b7b,1,1,1,0,0,0,0,3,3,438,1,1,0.0,223,111,7,25,25,0,806,808,2,14,14,0,0,100.0,NoArch
f957fde26c386a6573c8ea1898e90c4a630a03b0,6,15,27,12,0,0,0,14,51,553,2,5,2.320423375,4934,75,2,1025,1030,5,26435,26492,57,245,247,2,0,100.0,NoArch
acde646a57070584ef23b6320f0512d6d91504fd,0,0,0,0,0,0,0,0,0,0,0,0,0.0,0,401,2,0,0,0,0,0,0,0,0,0,2,100.0,NoArch
32ee9faa51a0933ffb5d80f52535654f63941a3d,1,0,3,3,0,0,0,8,21,0,1,1,0.0,1300,128,1,286,286,0,7569,7594,25,37,37,0,1,100.0,NoArch
5e24f09f1a54ac5e07079758d3fc45a4bf16677d,1,5,1,4,0,0,0,13,30,57,1,1,0.0,766,78,3,127,125,2,4447,4422,25,49,48,1,1,100.0,NoArch
eed536b1335b324232fce02ae2368d479d75c343,0,0,0,0,0,0,0,0,0,0,0,0,0.0,0,0,0,0,0,0,0,0,0,0,0,0,1,100.0,NoArch
787457b588a6e4ddac7d5bd31bfe613ede6478d8,4,13,0,13,0,0,0,2,12,834,1,1,1.987773371,1767,121,5,248,248,0,8057,7997,60,51,51,0,1,100.0,NoArch
a9e637cf8289e8de5f440b5e7a526aafd573aa0a,3,155,28,127,0,0,0,25,204,254,1,3,0.135735044,10078,18,0,2084,2049,35,67058,66131,927,249,245,4,1,100.0,NoArch
d7bd3336d59a83027a4488ca783dd1ce09c2224d,1,1,1,0,0,0,0,22,44,64,1,1,0.0,350,57,0,53,53,0,1752,1752,0,30,30,0,1,100.0,NoArch
84b28e9a7137db73a029fd9164d5dffb32cb5d3b,2,2,2,0,0,0,0,7,11,235,1,1,1.0,545,35,9,68,68,0,2491,2473,18,15,15,0,1,100.0,NoArch
3b5686c5acd94fcbef15efe77aa1496892cc3f85,0,0,0,0,0,0,0,0,0,0,0,0,0.0,0,9,3,0,0,0,0,0,0,0,0,0,1,100.0,NoArch
baa023635a3a0e9e7ba26ed1914150ebcf6149b8,0,0,0,0,0,0,0,0,0,0,0,0,0.0,0,361,8,0,0,0,0,0,0,0,0,0,1,100.0,NoArch
121d1a98129b48a098a1aa5e406337c931663f16,2,2,2,0,0,0,0,12,122,101,1,1,1.0,4641,169,1,856,856,0,31160,31160,0,116,116,0,1,100.0,NoArch
fdd1d294c6b3c0e3cd8dd4219d034ad63210b380,1,0,2,2,0,0,0,8,27,156,1,1,0.0,315,157,1,39,39,0,1521,1543,22,11,11,0,1,100.0,NoArch
acde646a57070584ef23b6320f0512d6d91504fd,0,0,0,0,0,0,0,0,0,0,0,0,0.0,0,401,2,0,0,0,0,0,0,0,0,0,2,100.0,NoArch
b623fd3aca34a48768bf06d9bda02791a42c14dd,1,1,1,0,0,0,0,11,23,312,1,1,0.0,288,13,3,43,43,0,1392,1392,0,21,21,0,1,100.0,NoArch
ed6488361660aecbba1d006f26218e5193995f8f,1,8,1,7,0,0,0,6,12,379,1,1,0.0,451,38,4,80,79,1,2168,2126,42,27,27,0,1,100.0,NoArch
d37a6b5a0fd909fe4cbe650a7bdfae401247849c,2,38,11,27,0,0,0,7,49,709,1,2,0.642064289,1658,57,0,303,300,3,9361,9202,159,47,46,1,1,100.0,NoArch
1ee7025fa6864089df22ccbabc4d860755623bf8,1,1,1,0,0,0,0,6,8,183,1,1,0.0,289,11,7,38,38,0,1126,1126,0,13,13,0,1,100.0,NoArch
d8295fe6cf8da0641b3ba851f952290a6686d96e,0,0,0,0,0,0,0,0,0,0,0,0,0.0,0,77,4,0,0,0,0,0,0,0,0,0,1,100.0,NoArch
fe9b6bbff97d0eeb2affebd6439e0bcf0df5724e,0,0,0,0,0,0,0,0,0,0,0,0,0.0,0,65,1,0,0,0,0,0,0,0,0,0,1,100.0,NoArch
dab9ed6e0f5d922bbd389358f7eaee66f2aa0fcb,1,1,0,1,0,0,0,1,5,774,1,1,0.0,272,224,3,12,12,0,1704,1695,9,4,4,0,0,100.0,NoArch
1a25bbe5bf4492d45697723b7700abdff4788c5c,7,107,15,92,0,0,0,3,4,2660,1,1,2.806117548,775,0,0,131,124,7,4296,3918,378,44,44,0,1,100.0,NoArch
ea9d66a249a169e2de8f90e0452a684c2629e762,1,1,5,4,0,0,0,3,4,1130,1,1,0.0,233,60,2,33,33,0,868,877,9,16,16,0,1,100.0,NoArch
15bdc2fe16ed03dbdf326409a163808ebbdbdb06,1,13,12,1,0,0,0,10,14,228,1,1,0.0,217,160,2,30,28,2,1151,1138,13,9,9,0,1,100.0,NoArch
0c339bdf4577de3ea066ab4ef5e4a18424b875ae,0,0,0,0,0,0,0,0,0,0,0,0,0.0,0,26,2,0,0,0,0,0,0,0,0,0,1,100.0,NoArch
b8bc69a92d577a503ed4c3ba08a3d64c643d98c3,0,0,0,0,0,0,0,0,0,0,0,0,0.0,0,0,0,0,0,0,0,0,0,0,0,0,1,100.0,NoArch
1d18e76dacc9326419855c7881ef79cf60f19a61,52,342,353,11,0,0,0,3,128,239,1,13,4.666236447,30554,13,2,5420,5420,0,164749,164749,0,1040,1040,0,0,100.0,NoArch
8ba81a6e35bb05dae7723138743ccba8c9654048,1,15,11,4,0,0,0,9,20,2,1,1,0.0,437,23,4,64,62,2,2530,2487,43,13,13,0,1,100.0,NoArch
6cd9c1416d1540a6ae36640153e7c3f7c01c9e5f,0,0,0,0,0,0,0,0,0,0,0,0,0.0,0,50,1,0,0,0,0,0,0,0,0,0,1,100.0,NoArch
ca8f0b76404db53a4b0bdb4f697d14e7adeff175,0,0,0,0,0,0,0,0,0,0,0,0,0.0,0,214,10,0,0,0,0,0,0,0,0,0,1,100.0,NoArch
f7230f70a4de21c7bac9028a05f9f7472077e809,1,3,2,1,0,0,0,6,16,16,1,1,0.0,912,187,0,53,53,0,4490,4484,6,24,24,0,1,100.0,NoArch
4b77aaf68a9c0c3d1b555708b418f915afdffc7a,0,0,0,0,0,0,0,0,0,0,0,0,0.0,0,16,2,0,0,0,0,0,0,0,0,0,1,100.0,NoArch
2d9a322102355f4f998541c2fe9866a85560b2b3,1,9,1,8,0,0,0,9,34,94,1,1,0.0,391,1,1,66,64,2,2854,2788,66,10,10,0,1,99.95222169,NoArch
19d6ef464a39394869ddf49e49c8e39dce96a8a0,0,0,0,0,0,0,0,0,0,0,0,0,0.0,0,223,4,0,0,0,0,0,0,0,0,0,1,100.0,NoArch
e64833bbd87298e55cf24bf43989eadb08741abf,13,2913,1,2912,11,0,11,1,47,30,4,6,2.784501622,921,0,0,578,161,417,21049,5140,15909,228,48,180,1,98.60253494,NoArch
797725221637736ae5a9836ff994477a8c5b8fd8,0,0,0,0,0,0,0,0,0,0,0,0,0.0,0,333,0,0,0,0,0,0,0,0,0,0,1,100.0,NoArch
2644fa26f375dbd0f719971a62d9d2ad31bfe4a9,2,60,0,60,0,0,0,19,36,1366,2,2,0.122291597,1430,66,1,270,259,11,8595,8310,285,43,42,1,1,100.0,NoArch
1bdc28c61b934895afde923895caf000d1b95979,2,27,13,14,0,0,0,4,11,127,1,2,0.934068055,188,77,6,19,18,1,844,705,139,6,5,1,1,99.96815287,NoArch
9a62c142ac7dbd7d3412076c26787c2d2e9ec1c6,1,2,2,0,0,0,0,5,9,1701,1,1,0.0,116,27,0,25,23,2,555,543,12,4,4,0,1,100.0,NoArch
96560fd86543ffd2fe97531eb862b3c66cf0736a,1,16,16,0,0,0,0,9,27,230,1,1,0.0,426,0,0,61,61,0,2064,2064,0,11,11,0,1,100.0,NoArch
93b489e4c5741ccb27e57361fb17958b5ba5f15a,0,0,0,0,0,0,0,0,0,0,0,0,0.0,0,173,4,0,0,0,0,0,0,0,0,0,1,100.0,NoArch
1f5619d156680fc1942a8822841d56168867664a,14,360,23,337,2,0,2,4,180,89,3,7,2.523636375,15858,320,5,2443,2405,38,109105,107435,1670,509,489,20,1,99.89563143,NoArch
2c8321353265fa55287051a56c80fd15a6e939ad,1,1,0,1,0,0,0,12,95,3,1,1,0.0,910,384,4,182,182,0,4886,4875,11,55,55,0,1,100.0,NoArch
3d158d51adf0deedd023aefdad026855459d8d57,4,1075,9,1066,2,0,2,1,18,232,1,3,0.80017543,873,143,4,264,116,148,9128,4330,4798,60,23,37,1,99.90151664,NoArch
f5924b3476ba3fed6f128e6257ebab9bea5cd769,4,63,9,54,0,0,0,25,216,357,1,2,1.331966065,5266,407,0,1080,1068,12,33824,33455,369,131,128,3,1,99.95012469,NoArch
c0398aaca1c6b00fc82734d896a560066b73a6bc,1,9,7,2,0,0,0,7,52,22,1,1,0.0,1358,131,1,342,342,0,7335,7324,11,29,29,0,1,100.0,NoArch
1a0fb59ce12064b60d98e234103aa8308639995f,1,58,29,29,0,0,0,3,9,42,1,1,0.0,545,371,1,119,109,10,3694,3469,225,23,23,0,1,100.0,NoArch
5cee254303eb379ecc0633943542b0f2f396cd4c,0,0,0,0,0,0,0,0,0,0,0,0,0.0,0,215,0,0,0,0,0,0,0,0,0,0,1,100.0,NoArch
3391876d426dce64cc687e139b7def28f6b2b12b,0,0,0,0,0,0,0,0,0,0,0,0,0.0,0,13,0,0,0,0,0,0,0,0,0,0,2,100.0,NoArch
596c30c74692ab528dc18038c609ef98d0d0e0cf,0,0,0,0,0,0,0,0,0,0,0,0,0.0,0,64,1,0,0,0,0,0,0,0,0,0,1,100.0,NoArch
54e0e8d027130224416a235052be9a912a2f85a9,1,3,4,1,0,0,0,2,3,275,1,1,0.0,819,0,0,122,122,0,4245,4245,0,14,14,0,1,100.0,NoArch
0981a4628849d4b8f8d5624a10ec74cf013dc188,1,1,1,0,0,0,0,8,56,102,1,1,0.0,1367,142,3,345,345,0,7398,7398,0,29,29,0,1,100.0,NoArch
e6de6fc759cf1a4e573e9af47cf86004f5200dc2,3,43,2,41,0,0,0,5,31,1214,2,2,1.48654941,803,65,0,183,175,8,4418,4119,299,47,46,1,1,100.0,NoArch
2d406044fafb574400bc66d06ee679f6dda5ed23,3,28,44,16,0,0,0,6,109,41,1,2,1.515541327,3887,31,2,683,678,5,22518,22583,65,95,95,0,1,100.0,NoArch
f8ed53ef466e3206d743b4b92f48e1889df0cb7b,0,0,0,0,0,0,0,0,0,0,0,0,0.0,0,22,9,0,0,0,0,0,0,0,0,0,1,100.0,NoArch
959ba7f068efdf6000e33e4e082a7b8c07f36473,33,67,75,8,0,0,0,6,19,457,12,24,5.002449769,6503,131,1,979,979,0,35273,35343,70,179,179,0,1,100.0,NoArch
9ad5348947073523b59c92819dcd92510e6df249,1,3,3,0,0,0,0,5,14,86,1,1,0.0,322,0,0,46,46,0,1695,1695,0,6,6,0,1,100.0,NoArch
a51da0013e82dd2e416991704a745fbe5d1ef47f,2,5,5,0,0,0,0,3,7,193,1,1,0.721928095,642,104,0,98,98,0,3186,3186,0,41,41,0,0,100.0,NoArch
3c8b40fcf317235bc5597b4d6ffe535c7a5baa34,4,333,6,327,1,0,1,1,41,182,2,3,1.11721762,1354,119,1,286,266,20,8610,6907,1703,55,51,4,1,97.12155726,Arch
6da9fe4618363da23be9a11408cf68325693dfe3,18,335,1159,824,0,2,2,2,103,143,7,13,2.954209548,16442,58,0,2991,3113,122,93829,98472,4643,447,469,22,1,97.08195364,Arch
55c55ca7a1aae73c70db7cab5b39dcf72ae3ef4e,18,1164,340,824,2,0,2,2,104,187,7,13,2.962447018,15618,58,0,3113,2991,122,98472,93829,4643,469,447,22,1,97.08195364,Arch
cc02a5de76bab4b65e41654a0d8bdb4a174a8252,18,336,1167,831,0,2,2,2,103,131,7,13,2.961677196,16451,60,6,2991,3114,123,93836,98501,4665,447,469,22,1,97.08195364,Arch
1aad349874b3afffb1432736420dd41eddde0c6a,18,1174,346,828,2,0,2,2,104,187,7,13,2.988898689,15624,68,14,3115,2992,123,98482,93855,4627,469,447,22,0,97.08195364,Arch
1b2b32be2e103c845f3183aa66c2aa08db635189,19,341,1170,829,0,2,2,2,103,121,7,14,2.987789013,16958,65,6,3016,3139,123,96332,100976,4644,461,483,22,0,97.08195364,Arch
f452c640ce84d2e7709056c20295aaef72a47449,19,1175,346,829,2,0,2,2,104,179,7,14,2.994831711,16129,70,11,3139,3016,123,100976,96332,4644,483,461,22,1,97.08195364,Arch
d9a661cfefd6b5c13486bc7d16e66e98dcf05bcd,165,0,28801,28801,0,163,163,2,4,838,1,11,6.598767448,28799,73,12,0,4073,4073,0,120126,120126,0,1814,1814,1,90.05211874,Arch
c202a20c1a46aa1c120b654c3e53fbd6bef02606,267,30101,2536,27565,166,3,169,4,103,335,21,68,6.944991812,47373,205,0,11796,7924,3872,370896,257588,113308,3397,1608,1789,1,87.44493392,Arch
7993a622e9501521f2dd9d3af19b8704bb499ce1,267,2536,30101,27565,3,166,169,5,106,524,21,68,6.945140434,74938,216,1,7924,11796,3872,257588,370896,113308,1608,3397,1789,1,87.44493392,Arch
d6912887437e6d3bdb7fa141801a708629363d06,261,30108,2597,27511,166,3,169,4,103,389,22,63,6.943935639,43808,119,0,11051,7175,3876,350549,237470,113079,3270,1482,1788,1,87.44493392,Arch
cc1bb5a95c36e5d5579742127c13d252b46154a8,233,2060,29694,27634,3,166,169,2,106,580,18,54,6.866343817,57925,125,6,4933,8849,3916,168846,282598,113752,989,2777,1788,1,87.44493392,Arch
dcb93b5b9d71a4d08cad1ccce24d0699426b3958,234,29691,2080,27611,166,3,169,2,104,396,18,54,6.870003622,30717,2,0,8908,4996,3912,284825,171186,113639,2785,997,1788,1,87.37607403,Arch
250c50daa59412d7a8b519a3b615f1b00c048589,234,2085,29696,27611,3,166,169,2,106,580,18,54,6.870401954,58328,2,0,4996,8908,3912,171186,284825,113639,997,2785,1788,1,87.37607403,Arch
cad64cec34245e3eeff5edff9358aafc98603aab,253,29883,2981,26902,166,5,171,2,104,400,18,59,6.968274782,35317,4,2,9596,5812,3784,304720,194702,110018,2956,1237,1719,1,87.30193662,Arch
f734393e68de75dfa37e73ad158aae7e92f04fb2,252,2968,29878,26910,5,166,171,2,106,515,18,58,6.966126165,61757,79,0,5734,9520,3786,191670,301721,110051,1222,2941,1719,0,87.30193662,Arch
7729373dea5a560f5cb4b24433d12b25a9dc7519,6,410,3,407,4,0,4,1,4,189,3,3,1.92278344,504,83,4,129,99,30,4323,2499,1824,51,31,20,1,96.07006512,Arch
ff4e2e7b6847679388a13ddd8396e191e0106f18,13,607,152,455,2,0,2,3,44,136,1,7,2.659643531,4323,316,2,910,834,76,25232,22819,2413,199,182,17,1,95.06457565,Arch
00e07f22b592d0d08f706fad0239fd860e8562a7,313,30458,4902,25556,166,12,178,2,104,335,22,85,7.144513154,54237,22,1,12256,8694,3562,401194,298459,102735,3634,1990,1644,1,84.97432463,Arch
0bc79e9fb794feb0f7460284c6c355d08dc9de6a,312,4891,30454,25563,12,166,178,3,106,502,22,84,7.142940913,79540,26,1,8659,12222,3563,297210,399980,102770,1971,3615,1644,1,84.97432463,Arch
a39c00f952267bacec5388880f33e694bdd467c1,10,39,31,8,0,0,0,2,23,363,4,9,2.236265489,7810,86,7,213,208,5,53824,53870,46,163,163,0,0,97.70780856,Arch
2dea1f91c259a52b5f90b23c8469b26ed542d418,332,30693,5544,25149,166,13,179,2,104,285,22,93,7.198531161,65967,311,0,13299,9840,3459,471200,371736,99464,4065,2447,1618,1,84.81240171,Arch
3eba2a1edadf7d1c706997401ba46cf13595e82a,332,5543,30692,25149,13,166,179,3,107,516,22,93,7.198652768,91116,29,0,9840,13299,3459,371736,471200,99464,2447,4065,1618,1,84.81240171,Arch
064c4f87a69e4f9220ed46d8a8aff13f704664d0,332,30693,5544,25149,166,13,179,2,104,285,22,93,7.198531161,65967,22,0,13299,9840,3459,471200,371736,99464,4065,2447,1618,1,84.81240171,Arch
1115ca8e9bb339b8f8e23909945eb314624e8d4c,332,5544,30697,25153,13,166,179,3,107,516,22,93,7.199448159,91116,88,7,9840,13299,3459,371718,471200,99482,2447,4065,1618,1,84.81240171,Arch
bf7188031c715196a3e9a7f3f23c700d2deb427c,332,30693,5544,25149,166,13,179,2,104,285,22,93,7.198531161,65963,66,0,13299,9840,3459,471182,371718,99464,4065,2447,1618,1,84.81240171,Arch
68541c92afe3b6500ef28b3a6ee01149a337ad20,332,5543,30692,25149,13,166,179,3,107,516,22,93,7.198652768,91112,27,1,9840,13299,3459,371718,471182,99464,2447,4065,1618,1,84.81240171,Arch
6d30412d4cb2215c5a49e4eb21d946f005a64852,332,30693,5544,25149,166,13,179,2,104,285,22,93,7.198531161,65963,23,1,13299,9840,3459,471182,371718,99464,4065,2447,1618,1,84.81240171,Arch
ed3f214b2bb44278b27826e7e5de5990df4f62eb,332,5584,30692,25108,13,166,179,3,107,516,22,93,7.200048983,91112,89,3,9844,13299,3455,371947,471182,99235,2448,4065,1617,0,84.81240171,Arch
b323f9088ae0b73db492c03aa48bcc178be4e9b1,331,30677,5474,25203,166,13,179,2,105,286,22,93,7.19272753,65751,120,0,13287,9814,3473,470890,371173,99717,4040,2417,1623,1,84.81240171,Arch
caba857008b3e0087a276fc2030e13f951cde624,4,333,6,327,1,0,1,1,42,268,2,3,1.11721762,1363,121,1,288,268,20,8672,6969,1703,55,51,4,1,97.18076285,Arch
5fa2e8877f835c7b3e114daded6b56ed1e1361f8,13,607,152,455,2,0,2,3,45,142,1,7,2.659643531,4332,313,2,912,836,76,25295,22882,2413,199,182,17,1,92.13764813,Arch
0af4131570f8a1c97a11c0f22ce69d6613442096,317,3292,30564,27272,7,166,173,3,107,518,22,90,7.080886327,89656,91,4,9322,13149,3827,354278,464783,110505,2265,4016,1751,0,79.94512347,Arch
4a332a93ea05cc953ac4a7063f437f2609112a37,317,30560,3285,27275,166,7,173,2,105,343,22,90,7.080777855,62381,0,0,13149,9322,3827,464783,354274,110509,4016,2265,1751,1,79.94512347,Arch
868c62b729bb67b8b9db3f2146db1ea442b53ea8,323,4193,30564,26371,13,166,179,3,108,516,22,91,7.127703395,89656,93,4,9385,13149,3764,358571,464783,106212,2294,4016,1722,1,80.35803083,Arch
74959da1617f65bdf74048ecd714dc3aa1d384e9,7,572,200,372,3,0,3,2,6,284,1,2,2.503927065,503,321,1,92,50,42,4776,2414,2362,43,20,23,1,93.95402299,Arch
1c441f798e1c5da54f6bb9faf211eadb5f10b6b5,7,5349,0,5349,7,0,7,1,1,0,1,2,2.065662284,0,25,0,417,0,417,39923,0,39923,237,0,237,1,97.75626925,Arch
53fb16a60aeb9557d56d76003831e9e442351244,2,1052,0,1052,2,0,2,1,5,773,1,1,0.99948893,0,31,0,49,0,49,8408,0,8408,48,0,48,1,96.89617486,Arch
1b728ebeab2e90dcb169599ff67dcc7b039fdcf9,845,35234,15502,19732,166,25,191,5,105,148,39,169,7.871696357,184823,29,0,28576,25325,3251,970645,913848,56797,9793,8359,1434,1,87.02724685,Arch
26bfd13115db5ce45d192c8291af3363c087950f,7,5355,0,5355,7,0,7,1,1,0,1,2,2.067205919,0,20,0,417,0,417,40014,0,40014,237,0,237,1,96.86282551,Arch
1f138601aaf8da82c9ba04f39ff0131d70b33ed8,838,10030,35370,25340,18,166,184,5,109,481,39,169,8.017625536,204805,98,1,24908,28585,3677,873834,973473,99639,8122,9799,1677,0,88.73754828,Arch
ecfa86caa1fea9e58c8d175bb48e667a64077397,842,35714,10059,25655,168,18,186,5,105,149,39,170,8.039985441,179476,116,0,28626,24893,3733,974771,873399,101372,9818,8136,1682,1,88.64699898,Arch
d4fd0277a125d9b5c657dd77cff20a58d91dae04,844,10485,35721,25236,20,168,188,5,109,478,39,171,8.048134543,205131,101,4,24916,28626,3710,876054,974771,98717,8148,9818,1670,1,89.43865099,Arch
fb95d3e3fad21a51206d3a3113d703bfe267c808,843,35661,10514,25147,168,20,188,5,105,148,39,171,8.042288869,179143,125,0,28446,24747,3699,970155,871756,98399,9778,8111,1667,1,89.43865099,Arch
08a94c741bdfd60c124f824143f476b25bc96167,843,10521,35668,25147,20,168,188,5,109,478,39,171,8.042243379,204290,218,0,24747,28446,3699,871756,970155,98399,8111,9778,1667,1,89.43865099,Arch
3b7cf3ae6bec6514d2e38a87a286ec92e3bd3deb,843,35661,10514,25147,168,20,188,5,105,148,39,171,8.042288869,179143,214,0,28446,24747,3699,970155,871756,98399,9778,8111,1667,1,89.43865099,Arch
01326be73368a0700dce2c13e1850d620112780c,843,10612,35699,25087,20,168,188,5,110,476,39,171,8.051121946,204290,129,0,24764,28446,3682,872161,970155,97994,8115,9778,1663,1,89.43865099,Arch
8b3f0e60eb9d48ee0a89546b009ee84e7013759e,19,712,548,164,4,0,4,1,52,107,1,10,3.274968964,6274,131,2,1298,1285,13,35197,34379,818,277,265,12,1,96.75990676,Arch
37512c121ac19eb059c512a89c9294bbff824098,864,36328,13151,23177,168,32,200,5,105,145,39,172,8.143105561,184664,60,1,29008,25660,3348,991216,903811,87405,9934,8398,1536,1,87.22702925,Arch
f70fdbf7947509c0975bd3c61b96b63f9b5daaa4,864,13220,36354,23134,32,168,200,5,111,465,39,172,8.146083987,207841,0,0,25665,29008,3343,904193,991216,87023,8399,9934,1535,1,87.22702925,Arch
ccd0badd900f4358b9d1db4c8441a4fbd61c63a0,10,10,4058,4048,0,6,6,11,112,264,2,6,2.462523751,8338,140,2,775,1491,716,28625,50970,22345,95,245,150,1,95.49469965,Arch
ffbb138d1809d5c800a7f916c05ab5cd2a1581a6,867,40382,13258,27124,174,32,206,5,105,141,39,172,8.094152492,182794,126,0,29426,25382,4044,1002387,893298,109089,10028,8344,1684,1,85.17135325,Arch
35ff7ee79a5c18f50e62d4f78ff7a5a03598fe05,867,13385,40384,26999,32,174,206,5,112,465,39,172,8.092226791,209918,32,1,25391,29426,4035,893960,1002387,108427,8347,10028,1681,1,85.17135325,Arch
2fcd7f7cc175c0734443638b99c359e24c0f88ff,872,40387,14119,26268,174,36,210,5,105,141,39,172,8.113190868,183789,127,1,29446,25500,3946,1002909,898976,103933,10036,8389,1647,1,85.07233669,Arch
651be2b08ec009f4e7bfc6be6f760db7ab840870,872,14121,40389,26268,36,174,210,5,112,465,39,172,8.113357903,210057,5,0,25500,29446,3946,898976,1002909,103933,8389,10036,1647,0,85.07233669,Arch
200dd5a7336fe84443e7e4a9079cb93fd7393735,875,40424,14264,26160,174,36,210,5,105,141,39,172,8.125562907,184169,117,0,29466,25543,3923,1004167,901231,102936,10048,8405,1643,1,85.07233669,Arch
83674c7d54d78821edc4a5e72e9ec8dae68fb4ea,875,14355,40425,26070,36,174,210,5,112,467,39,172,8.127238856,210330,147,3,25558,29466,3908,901806,1004170,102364,8407,10048,1641,1,85.07233669,Arch
f2990fe78260b08144a204697770ad374d1a3d6b,876,40426,14373,26053,174,36,210,5,105,138,39,172,8.127427788,184458,119,2,29485,25593,3892,1005126,902775,102351,10057,8418,1639,1,85.07233669,Arch
4b9497b62fdd2b7f0bd2c57b0331fe815ae928b8,876,14375,40428,26053,36,174,210,5,112,466,39,172,8.12758693,210511,209,0,25593,29485,3892,902775,1005126,102351,8418,10057,1639,1,85.07233669,Arch
d6308e68ad66211731f7d3949f5b219d7ba015cc,874,40418,14366,26052,174,36,210,5,105,143,39,172,8.122147521,184363,25,0,29494,25614,3880,1004892,902390,102502,10052,8410,1642,1,85.07233669,Arch
c4b0542896714b71bdac0d5e8398354b22e133ed,874,14383,40435,26052,36,174,210,5,112,459,39,172,8.123152044,210415,109,5,25614,29494,3880,902386,1004892,102506,8410,10052,1642,1,85.07233669,Arch
115f9d434894097b295efdf4a73e31ae560de508,876,40491,14464,26027,174,36,210,5,105,139,39,172,8.126804676,185287,21,0,29605,25742,3863,1010657,908392,102265,10093,8450,1643,1,85.07233669,Arch
05e179d442192b6e64d174a6786de0a90716ba8a,864,13640,39968,26328,36,174,210,5,112,455,39,172,8.100317572,209171,40,2,25410,29363,3953,894339,999249,104910,8349,10014,1665,1,86.31450133,Arch
9dfde6de92799d7d923cf8eb11bbdc8788d6664c,864,40012,13723,26289,174,36,210,5,107,159,39,172,8.102902785,182963,130,2,29383,25449,3934,999680,895039,104641,10022,8357,1665,1,86.31450133,Arch
f303c1bd419b457e7fb2190cd8c56c4d54d36d43,866,13729,40018,26289,36,174,210,5,112,454,39,173,8.103721122,209520,33,0,25459,29393,3934,896623,1001264,104641,8367,10032,1665,1,85.98817051,Arch
a99e377d39bce90b39b9fd7f2cc1068e1856fd1c,20,673,309,364,1,0,1,6,113,279,7,15,2.139920761,13080,37,1,2197,2106,91,73657,70797,2860,375,366,9,1,96.13485076,Arch
6f89b16fb53886d0dda9e286b6b21ba4ce493f06,876,41058,16695,24363,174,45,219,5,107,149,39,173,8.143557102,185283,68,0,29416,25790,3626,1001879,909270,92609,10035,8437,1598,0,85.12711864,Arch
fe48d911e2a6829a30cdb0ced3d0e52c6865ac0c,876,16688,41052,24364,45,174,219,6,115,449,39,173,8.143664307,209646,43,2,25790,29416,3626,909261,1001879,92618,8437,10035,1598,1,85.12711864,Arch
bedbc4bda97b54113e166307596d8c62ce5d329f,882,41176,19393,21783,174,51,225,5,107,149,39,173,8.147029536,187863,5,0,29416,26143,3273,1001879,923018,78861,10035,8530,1505,1,84.94510135,Arch
fb13db8095329f6b0aa9654d8f59e11025e40ba8,882,19387,41170,21783,51,174,225,6,117,448,39,173,8.147183754,209646,37,3,26143,29416,3273,923018,1001879,78861,8530,10035,1505,1,84.94510135,Arch
653d86c48623abc6fb29ae8b3a759039a7f07afc,29,145,240,95,0,0,0,3,25,683,1,1,4.737181448,4110,3,2,475,476,1,22616,23380,764,174,175,1,0,95.77319588,Arch
6a602cadc520d47ec4342161d4db2a5240e40155,148,814,1043,229,0,0,0,8,123,307,5,46,6.130211947,65376,10,2,10382,10425,43,379183,380993,1810,2636,2634,2,0,94.69426152,Arch
bf1cdd1a3265912df818e351ef198af3cc5c9aae,158,1293,1751,458,0,5,5,8,121,275,6,49,5.536147586,66690,130,0,10551,10659,108,385796,387562,1766,2662,2709,47,1,94.48405253,Arch
362a548efbcf3ca4ea9e60878440265f9c4aa305,158,1750,1292,458,5,0,5,8,123,279,6,49,5.541790467,66232,50,8,10659,10551,108,387562,385796,1766,2709,2662,47,1,94.48405253,Arch
fa98f45ff26bb67d7685b10a0e17496ba37a5f6b,159,1295,1753,458,0,5,5,8,121,275,7,50,5.541524537,67039,7,4,10609,10717,108,387655,389421,1766,2668,2715,47,1,94.48405253,Arch
f3473d23fc2c87ff03fc5c2c826a26155742e791,159,1751,1293,458,5,0,5,8,123,277,7,50,5.546042887,66581,7,4,10717,10609,108,389421,387655,1766,2715,2668,47,1,94.48405253,Arch
ffadac96cd9be789d8cbed04c5e0dccf4f87c384,159,1295,1753,458,0,5,5,8,121,275,7,50,5.541524537,67039,44,0,10609,10717,108,387655,389421,1766,2668,2715,47,1,94.48405253,Arch
6854f4d3c7624a340a26e4df194effc7d792dbf1,159,1867,1491,376,5,0,5,8,123,275,7,50,5.470308726,66581,53,9,10692,10609,83,388742,387655,1087,2716,2668,48,1,94.48405253,Arch
976142edefb2cc09c6178f36dec909fdeffcbe83,193,2053,2083,30,0,6,6,8,121,272,17,70,5.838366671,74072,148,1,11768,11810,42,427047,426589,458,2913,2958,45,1,94.39339959,Arch
7d929b4750f200366ddfc9bf3e620dd8b87b905b,193,2081,2051,30,6,0,6,8,123,295,17,70,5.841556104,74042,46,0,11810,11768,42,426589,427047,458,2958,2913,45,1,94.39339959,Arch
4307d3b84e3480cc80663bd2c8f61c83d2ddf42a,193,2053,2083,30,0,6,6,8,121,272,17,70,5.838366671,74072,45,0,11768,11810,42,427047,426589,458,2913,2958,45,1,94.39339959,Arch
b2a2516d21095046ad9d1c1748e8ee38985f0e17,194,2090,2058,32,6,0,6,8,123,295,17,70,5.855506164,74247,55,11,11823,11780,43,427603,428064,461,2968,2923,45,1,94.39339959,Arch
6d96b21a300ddb03ffc72a74b13d268e7ccf45fb,195,2068,2095,27,0,6,6,8,121,277,17,70,5.863293056,75600,46,1,12016,12055,39,435310,434806,504,2961,3006,45,1,94.39339959,Arch
a15a0bd8157fba6b946ea701589f401dcd914475,195,2093,2066,27,6,0,6,8,123,295,17,70,5.866476723,75573,47,1,12055,12016,39,434806,435310,504,3006,2961,45,1,94.39339959,Arch
6ec7d9659d26925795ecb65bd5e3c8a89982116a,195,2068,2095,27,0,6,6,8,121,277,17,70,5.863293056,75603,47,2,12017,12056,39,435324,434820,504,2961,3006,45,1,94.39339959,Arch
d5e5ad5f892dea696740bd6834b3c96b213498e1,195,2098,2071,27,6,0,6,8,123,293,17,70,5.873839821,75576,57,13,12056,12017,39,434820,435324,504,3006,2961,45,1,94.39339959,Arch
852e89cda3f54cf322a695cd511b015f31a335c0,196,2075,2103,28,0,6,6,8,121,280,18,71,5.876976272,75970,0,0,12093,12132,39,437440,436957,483,2971,3016,45,1,94.39339959,Arch
284ca416a60533139889a0c3f68f20ae12fdd3cc,196,2101,2073,28,6,0,6,8,123,293,18,71,5.880156637,75942,9,6,12132,12093,39,436957,437440,483,3016,2971,45,1,94.39339959,Arch
8f825cad14ede10bfd090e53a1d05c39fbabc6b5,196,2075,2103,28,0,6,6,8,121,280,18,71,5.876976272,75970,9,6,12093,12132,39,437440,436957,483,2971,3016,45,1,94.39339959,Arch
8da88797371c8316ea7539051176e610cfff5125,198,2158,2079,79,6,0,6,8,123,294,18,73,5.905762861,76538,49,3,12212,12168,44,440398,440604,206,3036,2988,48,1,94.39339959,Arch
f81da73092e246531791657a2462033d58f91c03,196,2075,2103,28,0,6,6,8,121,280,18,71,5.876976272,75994,48,3,12097,12136,39,437536,437053,483,2973,3018,45,1,94.39339959,Arch
29eda27ef32146bd490d5005633f06bf68ee8d2a,196,2101,2073,28,6,0,6,8,123,293,18,71,5.880156637,75966,59,15,12136,12097,39,437053,437536,483,3018,2973,45,1,94.39339959,Arch
68d48941d36ed7f8f2aa1cf6b30a2881326b3f5c,200,2084,2125,41,0,6,6,8,121,262,18,72,5.906997132,77490,0,0,12262,12302,40,445249,444829,420,3026,3071,45,0,94.39339959,Arch
14853bdc61d97fa8d33aa0ab806f8d8abf01bc09,200,2123,2082,41,6,0,6,8,124,290,18,72,5.910172457,77449,63,17,12302,12262,40,444829,445249,420,3071,3026,45,1,94.39339959,Arch
85ddb48e2c7a795969e908ebce377ab4666aecce,11,612,535,77,0,0,0,8,125,63,7,11,2.745679574,8502,172,2,1149,1112,37,58128,58062,66,206,200,6,1,96.40227577,Arch
01f57d4c469577e31402bf837d1de906c9e07a40,202,2616,2734,118,0,6,6,8,121,260,18,74,5.89896084,78560,45,1,12497,12574,77,451358,451004,354,3067,3118,51,1,95.19077196,Arch
e6fd8e4e8e817c897f6ccbb4e666bd40c93d1aec,204,2755,2634,121,6,0,6,8,125,233,19,75,5.927444282,80858,33,1,13105,13027,78,466345,466639,294,3210,3159,51,1,95.19077196,Arch
a1c9fee705d668b62f3998aab55e11074a9a1ce8,202,2618,2735,117,0,6,6,8,121,264,18,74,5.897938699,78561,31,0,12497,12574,77,451389,451020,369,3067,3118,51,1,95.19077196,Arch
c9e94357028234db1b1ff9be57ecf13ae29f5d87,11,612,537,75,0,0,0,7,123,106,7,11,2.74569671,8508,170,2,1150,1113,37,58181,58123,58,206,200,6,1,97.47315224,Arch
786bb3a22deaab1338f56893841804fc8134da1c,164,1126,1763,637,1,0,1,8,125,272,11,54,5.997449742,71263,65,17,11265,11376,111,407037,410944,3907,2847,2847,0,1,94.17891017,Arch
73ceb8b57ac9e788b83985fb176ceccdf3ff110b,164,1763,1126,637,0,1,1,8,123,304,11,54,5.997449742,70629,171,2,11377,11266,111,410961,407054,3907,2847,2847,0,1,94.17891017,Arch
1ca8de3f4a322e8bc15cd948d616d015bf63625a,164,1126,1763,637,1,0,1,8,125,272,11,54,5.997449742,71266,144,7,11266,11377,111,407054,410961,3907,2847,2847,0,1,94.17891017,Arch
a44c04e436caadbe391cad957e9f4d70f66eb51e,164,1763,1126,637,0,1,1,8,123,304,11,54,5.997449742,70629,213,0,11377,11266,111,410961,407054,3907,2847,2847,0,1,94.17891017,Arch
d534b16379bcc9b3f48a8c3bf07551ced974909f,165,1145,1780,635,1,0,1,8,126,272,11,54,6.016313208,71544,174,3,11308,11418,110,408566,412452,3886,2864,2864,0,1,94.17891017,Arch
61999ef5cf8c83328ba7ad1b5870f84c09670db6,164,1763,1126,637,0,1,1,8,124,304,11,54,5.997449742,70632,172,3,11378,11267,111,410969,407062,3907,2847,2847,0,1,94.17891017,Arch
2f8c7f27af7137a36eff68db1c02544916bdc37a,165,1127,1764,637,1,0,1,8,126,272,12,55,6.001560499,71651,66,17,11316,11427,111,408834,412741,3907,2858,2858,0,1,94.17891017,Arch
b0e364cde56ccab3daf1fb1c7f0554db181361a6,167,1767,1138,629,0,1,1,8,124,298,12,55,6.013140658,71202,173,4,11443,11334,109,413549,409708,3841,2861,2861,0,1,94.12420974,Arch
a2291f0a821e9c51f4fb5779fae1eb5a9b13f733,167,1138,1767,629,1,0,1,8,126,273,12,55,6.013140658,71831,5,5,11334,11443,109,409708,413549,3841,2861,2861,0,1,94.12420974,Arch
04be201cc561efccf7b2c37bff1858dddcdcfbc9,167,1767,1138,629,0,1,1,8,124,298,12,55,6.013140658,71202,49,1,11443,11334,109,413549,409708,3841,2861,2861,0,1,94.12420974,Arch
37c95f703aa0ae87bb943fc48249b4b302a2cba4,167,1138,1767,629,1,0,1,8,126,273,12,55,6.013140658,71831,0,0,11334,11443,109,409708,413549,3841,2861,2861,0,1,94.12420974,Arch
b47e4d43577e260f74dd5b299d7fad2858d9b797,167,1767,1138,629,0,1,1,8,124,298,12,55,6.013140658,71202,0,0,11443,11334,109,413549,409708,3841,2861,2861,0,1,94.12420974,Arch
18abc714ba48dde9f11d930a94a1ce59c292d77f,167,1138,1767,629,1,0,1,8,126,273,12,55,6.013140658,71831,6,6,11334,11443,109,409708,413549,3841,2861,2861,0,1,94.12420974,Arch
aeb1ade1c54da6cb95ae1c95068ad37a8bf610cc,167,1767,1138,629,0,1,1,8,124,300,12,55,6.013140658,71209,174,5,11444,11335,109,413572,409731,3841,2862,2862,0,1,94.12420974,Arch
5cab3e2be54a2660148c31432ea0a86764020d67,167,1138,2250,1112,1,0,1,8,126,270,12,55,5.736929207,71838,11,0,11233,11444,211,406972,413572,6600,2856,2862,6,0,94.12420974,Arch
d60ae8fe4ad36ad4e7340e8781bf0d85e2962f76,167,2250,1138,1112,0,1,1,8,124,300,12,55,5.736929207,70726,46,0,11444,11233,211,413572,406972,6600,2862,2856,6,1,94.12420974,Arch
6cfb01883fb97bd98e5e5b7baacb3cdd85a15b68,167,1183,2299,1116,1,0,1,8,126,270,12,55,5.755942075,72052,34,0,11298,11509,211,408502,415102,6600,2861,2867,6,1,94.12420974,Arch
ceb556ee1c12227d6a50ece1fee7a1c8a6d7dd8f,167,2325,1201,1124,0,1,1,8,125,296,12,55,5.781864537,71012,175,2,11536,11325,211,415741,409103,6638,2868,2862,6,1,94.12420974,Arch
bdf0b61c0f6e109c2f4e0459676dda71f0265aeb,167,1201,2325,1124,1,0,1,8,127,270,12,55,5.781864537,72136,1,1,11325,11536,211,409103,415741,6638,2862,2868,6,1,94.12420974,Arch
f3e8b2fe7bb58f11445b7a7fd902de4331d8e86f,167,2335,1210,1125,0,1,1,8,125,296,12,55,5.783322471,71012,149,0,11537,11325,212,415749,409103,6646,2868,2862,6,1,94.12420974,Arch
cdde1b6e86fcdd92c681b66b9ac291384e41bba5,167,1200,2324,1124,1,0,1,8,127,270,12,55,5.781537971,72137,149,0,11326,11537,211,409111,415749,6638,2862,2868,6,1,94.12420974,Arch
79a8d7c86038f4bd67d7d6078d5b17bebf7ec771,1,964,0,964,1,0,1,1,1,0,1,1,0.0,0,0,0,55,0,55,8861,0,8861,40,0,40,1,96.73671621,Arch
af035198cc7d7a943a6b13e997c0973b482f2019,212,2829,2401,428,0,1,1,8,125,302,16,66,6.170039487,89212,0,0,14016,13838,178,497088,494562,2526,3592,3600,8,1,93.98862713,Arch
3362acea8fa966eafa6a61147ed93142475bcb1e,212,2415,2843,428,1,0,1,8,128,233,16,66,6.157308514,89640,152,6,13838,14016,178,494562,497088,2526,3600,3592,8,1,93.98862713,Arch
9911429927df041cd9f193ee7052d2eb8e7e6207,214,2833,2402,431,0,1,1,8,125,297,18,68,6.1742228,90099,50,0,14161,13983,178,501605,499050,2555,3618,3626,8,1,93.98862713,Arch
a3d9b0f91d2113a1d1977e6f527d70b76c447f08,214,2434,2865,431,1,0,1,8,129,234,18,68,6.167581968,90530,80,9,13983,14161,178,499050,501605,2555,3626,3618,8,1,93.98862713,Arch
7665dcfd7843e0b999f821fa362de7461aeadf7b,214,2851,2423,428,0,1,1,8,125,295,18,68,6.180962018,90102,132,0,14162,13984,178,501605,499081,2524,3618,3626,8,1,93.98862713,Arch
27bd3fe5c5e0c147d386f1c4441253d92f122b30,214,2440,2874,434,1,0,1,8,129,234,18,68,6.169484228,90540,53,2,13984,14162,178,499117,501695,2578,3626,3618,8,1,93.98862713,Arch
9a1d5b49bf4c22b8a7847b4637e86bdbe9de9a0c,4,57,52,5,0,0,0,12,112,128,2,3,1.934768183,3620,14,0,652,650,2,21964,22037,73,94,92,2,1,97.64167547,Arch
70dcd590701f581f864ee847f7a28c41620349a8,215,2916,2486,430,0,1,1,8,125,290,19,69,6.220072108,90804,33,0,14315,14139,176,506240,503581,2659,3631,3641,10,1,94.20849421,Arch
ac24f705fb7d1902c8f8553ed98b988ac59678ec,217,2511,2943,432,1,0,1,8,129,234,19,69,6.216748841,92362,0,0,14220,14396,176,513198,515865,2667,3706,3696,10,1,94.20849421,Arch
1a461ecfb7b4c0e8005d06e8d9d2dfb7c65a1497,220,2962,2567,395,0,1,1,8,125,294,19,69,6.269167891,92472,1,1,14503,14336,167,518529,516231,2298,3728,3736,8,1,94.15847311,Arch
c01d01f54622286de7ef17b302ae0a734664a9d1,220,2581,2976,395,1,0,1,8,129,239,19,69,6.257025535,92867,11,1,14336,14503,167,516231,518529,2298,3736,3728,8,1,94.15847311,Arch
a7bb8e732b840bbcdcf48c49b21a8e17ea97293c,220,2962,2567,395,0,1,1,8,125,294,19,69,6.269167891,92472,11,1,14503,14336,167,518529,516231,2298,3728,3736,8,1,94.15847311,Arch
f1117f5fe6cd2749b913986ea7529f99e9706caa,223,2602,2986,384,1,0,1,8,129,240,21,71,6.276159061,94347,2,2,14591,14756,165,523859,526110,2251,3793,3785,8,1,94.15847311,Arch
5e858afc6e3e140f9b07eca98787019672c6b137,220,2962,2567,395,0,1,1,8,125,295,19,69,6.269167891,92472,2,2,14503,14336,167,518529,516231,2298,3728,3736,8,1,94.15847311,Arch
501e05f1a1225dfbcc16bf4d2c0d86e55d4a928e,220,2584,2977,393,1,0,1,8,129,239,19,69,6.258476094,92875,36,1,14337,14504,167,516283,518575,2292,3736,3728,8,1,94.15847311,Arch
4ff214e0bcc43e737783461f99cf63123ea56f63,220,2963,2570,393,0,1,1,8,125,295,19,69,6.270611745,92482,12,2,14504,14337,167,518575,516283,2292,3728,3736,8,1,94.15847311,Arch
cd9d1a49105d42eeb3a7aa65205b6f1d3018a180,221,2594,2977,383,1,0,1,8,129,241,19,70,6.266203101,93081,180,2,14377,14539,162,517396,519618,2222,3745,3737,8,1,94.15847311,Arch
0c7798f336ebb72da32d4ecc8d84c677dbb785ca,221,2958,2573,385,0,1,1,8,125,288,20,71,6.271980282,92965,39,0,14583,14420,163,520457,518238,2219,3759,3767,8,1,94.15847311,Arch
c23b3743fa432fb242bd57da7693d88e1f8033bc,221,2590,2972,382,1,0,1,8,129,244,20,71,6.261416124,93350,54,1,14420,14583,163,518257,520457,2200,3767,3759,8,1,94.15847311,Arch
2ae1346e36853271c531d753408cfc16ce0dfb53,220,2927,2528,399,0,1,1,8,125,288,20,71,6.249163309,92838,176,0,14562,14394,168,519955,517577,2378,3748,3758,10,1,94.15847311,Arch
93ccc5237384a378416489d68e9e7d4234d07f73,220,2542,2941,399,1,0,1,8,129,242,20,71,6.236860216,93237,37,2,14394,14562,168,517577,519955,2378,3758,3748,10,1,94.15847311,Arch
43998e11326998dc373d115dcd658ec16a46e7fb,220,2927,2528,399,0,1,1,8,125,288,20,71,6.249163309,92838,0,0,14562,14394,168,519955,517577,2378,3748,3758,10,1,94.15847311,Arch
ba122d3adc0722e62df8abe61319bea23a784a66,220,2542,2941,399,1,0,1,8,129,243,20,71,6.236860216,93237,13,3,14394,14562,168,517577,519955,2378,3758,3748,10,1,94.15847311,Arch
07fc810408d1b5772925357413795dd7d93bdc8e,220,2929,2529,400,0,1,1,8,125,289,20,71,6.24897036,92838,4,4,14562,14394,168,519965,517577,2388,3748,3758,10,1,94.15847311,Arch
58116e0118909b7ef495c3721575ba866a919c3a,220,2542,2941,399,1,0,1,8,129,243,20,71,6.236860216,93238,4,4,14394,14562,168,517587,519965,2378,3758,3748,10,1,94.15847311,Arch
ca69b58ca9b634dcc90b49fe6f4a580df3c49213,220,2927,2528,399,0,1,1,8,125,298,20,71,6.249163309,92839,36,3,14562,14394,168,519965,517587,2378,3748,3758,10,1,94.15847311,Arch
02f83498e11754dcbc478ec0946a1ecc582640fe,223,2806,2967,161,2,0,2,8,129,237,20,71,6.270461224,94736,150,0,14797,14930,133,526601,527865,1264,3806,3786,20,1,94.06093328,Arch
2fabba3f6af06b79c012841c886eb639a6307b40,220,2942,2544,398,0,1,1,8,125,298,20,71,6.235520155,92856,150,0,14564,14396,168,520044,517666,2378,3749,3759,10,1,92.65967588,Arch
87bc2e786cc2159aae274998c8ae52719b06b798,220,2549,2947,398,1,0,1,8,129,238,20,71,6.231024446,93254,10,1,14396,14564,168,517666,520044,2378,3759,3749,10,1,92.65967588,Arch
ada188bb60fa358ff7e143ceec74190458580c7d,220,2945,2547,398,0,1,1,8,125,297,20,71,6.232827988,92859,151,1,14564,14396,168,520055,517677,2378,3749,3759,10,1,92.65967588,Arch
c324ece1144b90cff6e43bf9e2c40fcb07888e0a,220,2550,2948,398,1,0,1,8,129,238,20,71,6.23012009,93257,0,0,14396,14564,168,517677,520055,2378,3759,3749,10,1,92.65967588,Arch
db075f111c89ce19e9dbb68886eb6c487ab6bd36,220,2945,2549,396,0,1,1,8,125,298,20,71,6.230416242,92864,52,0,14564,14397,167,520074,517704,2370,3749,3759,10,1,92.65967588,Arch
095c358b5aac6178cd60d73a429f2d6f7bd10cdc,220,2552,2948,396,1,0,1,8,129,238,20,71,6.227712533,93260,88,1,14397,14564,167,517704,520074,2370,3759,3749,10,1,92.65967588,Arch
9aad8d6e7649fe40909a74af8865fff3e28e3ebc,221,2948,2552,396,0,1,1,8,125,298,20,72,6.232636648,93084,37,3,14595,14428,167,521320,518948,2372,3756,3766,10,1,92.65967588,Arch
0ba3e129a068cf68ea8c2a77f003e112d0d54e08,220,2552,2948,396,1,0,1,8,129,238,20,71,6.227712533,93260,39,3,14397,14564,167,517706,520076,2370,3759,3749,10,1,92.65967588,Arch
a3a5e2a7bc6209f6e93b66858d1f62a44e119d4e,14,184,615,431,0,0,0,4,32,554,1,3,2.831276368,15156,157,2,672,674,2,108442,112116,3674,490,491,1,1,90.17838835,Arch
3999d5b6a2f93ef72bdf1deea45d7abbe4268652,234,3651,2836,815,0,1,1,8,126,303,21,72,6.372254299,103104,5,1,15169,15002,167,598715,592922,5793,4155,4165,10,1,91.51486098,Arch
a8b4976ded4c4f980c351dd5c90f990c437107cd,234,2837,3652,815,1,0,1,8,130,247,21,72,6.371301571,103919,13,3,15002,15169,167,592922,598715,5793,4165,4155,10,2,91.51486098,Arch
3afd64e4f4088df4c1f6d6493a9d8506c224900b,233,3648,2834,814,0,1,1,8,126,301,21,72,6.368080207,102704,177,1,15100,14933,167,596786,590997,5789,4140,4150,10,1,89.87256875,Arch
55329a3e13580f014e282d319dc3168bb3e55507,233,2835,3649,814,1,0,1,8,130,250,21,72,6.367127689,103518,214,0,14933,15100,167,590997,596786,5789,4150,4140,10,1,89.87256875,Arch
4c54b13b78f775b2e2e564f86f63c54c372850cf,233,3648,2834,814,0,1,1,8,126,301,21,72,6.368080207,102704,214,0,15100,14933,167,596786,590997,5789,4140,4150,10,1,89.87256875,Arch
fe999c662ff15640502c3378b9ce50be41612dec,233,2835,3649,814,1,0,1,8,130,250,21,72,6.367127689,103518,153,3,14933,15100,167,590997,596786,5789,4150,4140,10,1,89.87256875,Arch
b8738de30bc49b64858b2d09e0eb033e04a326a6,233,3648,2834,814,0,1,1,8,126,301,21,72,6.368080207,102704,152,2,15100,14933,167,596786,590997,5789,4140,4150,10,1,89.87256875,Arch
e05276f05a615590f7bb737bd6bcc8e4763822f1,233,2835,3649,814,1,0,1,8,130,250,21,72,6.367127689,103518,2,0,14933,15100,167,590997,596786,5789,4150,4140,10,1,89.87256875,Arch
c6af51547e4e8bc0511b538a3f9af2362978eb86,233,3648,2834,814,0,1,1,8,126,302,21,72,6.368080207,102769,178,2,15110,14943,167,597111,591322,5789,4143,4153,10,1,89.87256875,Arch
b451c34d96a37985085c840cef61608fc39ee07b,234,2835,3654,819,1,0,1,8,130,247,21,73,6.371301571,103879,14,4,14992,15159,167,592978,598767,5789,4160,4150,10,1,89.87256875,Arch
cc6ce72e8fdcb7079204ca403334b8c3f7add04d,234,3659,2840,819,0,1,1,8,126,299,21,73,6.373107719,103075,179,2,15159,14992,167,598905,593116,5789,4150,4160,10,1,89.87256875,Arch
cbfe184c3b08e2ad4c1090b6a76ca09d92507852,235,2842,3661,819,1,0,1,8,130,245,22,74,6.374229337,104328,15,5,15060,15227,167,595530,601319,5789,4168,4158,10,1,89.87256875,Arch
0765c215d6fa1a70734a32e6f37f6fc77dc718d5,237,3660,2916,744,0,2,2,8,127,295,22,74,6.398636541,103716,6,1,15244,15083,161,601945,596478,5467,4162,4174,12,1,89.78999106,Arch
e22ee9607206ad387572e3cac0aac32a562c57d5,238,2918,3662,744,2,0,2,8,132,239,23,75,6.399739841,104587,94,6,15100,15261,161,596985,602452,5467,4181,4169,12,1,89.78999106,Arch
7164cfc4c43ee2411b12e3b5d7dc6cfeb388b2ab,238,3676,2920,756,0,2,2,8,127,302,23,75,6.395895624,103833,180,3,15263,15098,165,602481,596912,5569,4169,4180,11,1,89.78999106,Arch
e26bcce249ec1852e4b55daf8e9f78f754e30343,238,2929,3685,756,2,0,2,8,132,239,23,75,6.402192051,104589,95,7,15098,15263,165,596912,602481,5569,4180,4169,11,1,89.78999106,Arch
69bb80df27bc49e1544a3b3bbe87c3d00cd921da,238,3700,2940,760,0,2,2,8,127,302,23,75,6.406610603,103829,3,1,15263,15097,166,602481,596875,5606,4169,4180,11,1,89.78999106,Arch
56e28489607eb7e7da68a76edf98c5f8ca78eb6c,238,2941,3701,760,2,0,2,8,132,234,23,75,6.405679601,104589,3,1,15097,15263,166,596875,602481,5606,4180,4169,11,1,89.78999106,Arch
a3c8de04f19b984e16cc8a828ac0c3ac99683e00,238,3700,2940,760,0,2,2,8,127,302,23,75,6.406610603,103832,38,1,15266,15100,166,602526,596920,5606,4169,4180,11,1,89.78999106,Arch
d7c0b7a43e1fb1caaaa372495ba8b16a27243197,238,2941,3701,760,2,0,2,8,132,234,23,75,6.405679601,104592,18,7,15100,15266,166,596920,602526,5606,4180,4169,11,1,89.78999106,Arch
ca53a68e4b0c22f17db8faa4313d37fa360d5ee2,238,3729,2966,763,0,2,2,8,127,302,23,75,6.421611903,103829,0,0,15266,15099,167,602526,596903,5623,4169,4180,11,1,89.79955457,Arch
7e223f90b319795c23225b447aded71f74546331,238,2967,3730,763,2,0,2,8,132,233,23,75,6.420687621,104592,20,9,15099,15266,167,596903,602526,5623,4180,4169,11,1,89.79955457,Arch
75ff18b1265e91890302398286ae9dfa1b2e3148,5,86,309,223,0,0,0,3,33,108,1,3,1.42059712,6633,166,5,305,305,0,50508,52603,2095,259,260,1,1,94.63235294,Arch
cf01599b8724e080bcb760ef207fcf9fe9943396,240,4046,3092,954,0,2,2,8,127,302,23,75,6.434225236,103911,14,0,15305,15147,158,603913,596402,7511,4177,4188,11,1,93.24181626,Arch
dffbad4af43018438faf00b156acf593ab47839c,242,3272,4168,896,3,0,3,8,132,227,23,76,6.44863487,105026,15,0,15170,15323,153,597505,604844,7339,4198,4180,18,1,93.26032013,Arch
4e1eb0e98061de204bfdf339f2b593c8b219dfb5,240,4046,3092,954,0,2,2,8,127,302,23,75,6.434225236,103911,4,0,15305,15147,158,603913,596402,7511,4177,4188,11,1,93.3683106,Arch
0da1b424f3cf9574e31375251b4c78ee1f0e10a0,241,3232,4049,817,2,0,2,8,132,229,23,75,6.446658081,106314,325,0,15630,15671,41,604670,611780,7110,4221,4209,12,1,93.3683106,Arch
eb386c33c5a796a0e535598e5d71afa60fe2aa7f,240,4046,3092,954,0,2,2,8,127,302,23,75,6.434225236,103911,325,0,15305,15147,158,603913,596402,7511,4177,4188,11,1,93.3683106,Arch
bc4ab70bf4e4c32882392366bc653dde64a253f4,240,3093,4047,954,2,0,2,8,132,229,23,75,6.433380656,104865,215,0,15147,15305,158,596402,603913,7511,4188,4177,11,1,93.3683106,Arch
f604e53d17607e9bccf3c5819a3291874672cc57,240,4046,3092,954,0,2,2,8,127,302,23,75,6.434225236,103911,153,0,15305,15147,158,603913,596402,7511,4177,4188,11,1,93.3683106,Arch
bac22f2216022a4b56b5a90eee0b928bb03d1dc9,241,3095,4047,952,2,0,2,8,132,229,23,75,6.435288028,106451,155,1,15632,15788,156,604676,612181,7505,4221,4210,11,1,93.3683106,Arch
d28acf0af1fea237257a46178459a45ffb4814c9,240,4046,3092,954,0,2,2,8,127,302,23,75,6.434225236,103911,154,1,15305,15147,158,603913,596402,7511,4177,4188,11,1,93.3683106,Arch
9a943f1bf915247c01c1ac4322e8e56e63386a04,242,3448,4087,639,3,0,3,8,132,230,23,75,6.432427474,104950,185,2,15229,15305,76,598505,604283,5778,4201,4177,24,1,93.30956376,Arch
47ce2df14dfcd817606457bd961930785edbc030,242,4185,3801,384,0,3,3,8,127,301,23,75,6.375548578,104566,133,0,15305,15290,15,604283,600132,4151,4177,4207,30,1,93.30956376,Arch
f26bac88fdce0faa0309a7b13e93990af3838a47,247,3861,4252,391,3,0,3,8,132,239,23,75,6.429217976,105293,187,3,15315,15335,20,601602,605728,4126,4224,4194,30,1,93.30956376,Arch
2c57feaf8b53f719d889f07a21cbdfafe6608dc4,2,2,3,1,0,0,0,7,17,280,2,2,0.721928095,730,24,1,83,83,0,3806,3826,20,37,37,0,1,97.22468917,Arch
23046e9e81941060df0faa76984a64832a42f516,38,1333,2016,683,5,9,14,6,134,549,13,24,4.094279804,23566,2,1,3857,3941,84,142193,141510,683,723,770,47,1,97.6195823,Arch
6e6e42b0bffb67ad5613b99bf8f6dadbfeeca90b,8,880,2,878,7,0,7,1,30,13,3,5,2.604233486,285,114,2,168,42,126,5645,1360,4285,61,21,40,1,97.24076547,Arch
44b3738480032c5304aa3f1c2d75e6808d31cc65,20,1103,18,1085,7,0,7,9,142,472,2,12,3.824293966,16745,15,0,2763,2604,159,108899,104245,4654,633,572,61,1,93.67606915,Arch
2626e5ccf03860de96b25b428eb4e64a4447cb8c,23,757,911,154,2,3,5,2,26,100,3,6,3.81789752,3779,220,2,504,522,18,19295,20194,899,147,145,2,1,93.07903152,Arch
61d624c2d4cdc4fa4a8f2652f66f53f30e33eb28,33,1011,1061,50,3,3,6,2,142,260,6,12,4.19180519,16835,8,2,3060,3057,3,104260,104227,33,502,511,9,1,93.10897436,Arch
dcba4bc40a795156fbac8b747e339dc34a23bec7,33,1059,1009,50,3,3,6,2,143,180,6,12,4.192435925,16785,126,0,3057,3060,3,104227,104260,33,511,502,9,2,93.10897436,Arch
fdce224fa1aa63eba2fec2dce52f3d5ac3532df6,28,930,1051,121,3,3,6,2,28,190,4,8,4.018501726,5142,29,0,603,625,22,27577,28077,500,171,184,13,1,93.10897436,Arch
6cc62086795a212516b69fd09a1c2ef7a6761e5d,45,1273,1006,267,3,3,6,2,125,408,8,19,4.448943982,12404,327,0,2034,1975,59,69780,68461,1319,497,479,18,1,93.10897436,Arch
9a3d4e306b5e536e294cb20fb67664e2e0b7a7f8,5,590,851,261,0,3,3,4,9,697,1,3,1.825144472,1056,0,0,126,199,73,4299,6069,1770,29,28,1,1,93.94689469,Arch
844315cdbc5e4589f5a4f873c33533d8f7bb014e,44,3292,742,2550,9,0,9,2,62,272,3,17,4.3127322,15213,222,3,3325,2818,507,97392,82104,15288,841,707,134,1,92.20661531,Arch
81a6d5e433d0f9a6080e7afb0cec541d2b0efdd2,109,2290,6488,4198,5,24,29,3,124,250,8,36,5.697934942,41945,30,1,6755,7492,737,206438,227560,21122,1524,1842,318,1,90.25394647,Arch
f96a9276f1b3ed920735e550a5c1cfe5cf560fe7,109,6432,2333,4099,21,5,26,3,125,319,8,36,5.698341652,37837,224,5,7489,6755,734,227491,206438,21053,1841,1524,317,1,90.25394647,Arch
5439720fd909ec6c78bbc72e7ae743bdcebbd097,113,2301,6555,4254,5,24,29,3,124,244,9,38,5.731966968,43234,220,1,6834,7579,745,213761,235304,21543,1550,1871,321,1,90.25394647,Arch
0ae46b7467594bb01038dac0bc240743cfb4f5ef,113,6487,2323,4164,21,5,26,3,125,321,9,38,5.71952207,39070,127,1,7578,6834,744,235295,213761,21534,1870,1550,320,2,90.25394647,Arch
36b1286e88e577a43f6b548dd8e8220b1c6ea890,111,2299,6530,4231,5,24,29,3,124,244,8,38,5.718393704,45854,66,2,6924,7662,738,237156,258508,21352,1695,2014,319,0,90.25394647,Arch
a9fbbcafa75b48ccfac28544c624bdef7b6ae081,112,6491,2324,4167,21,5,26,3,125,314,8,39,5.719587257,42750,66,2,7924,7180,744,263826,242336,21490,2099,1780,319,1,90.25394647,Arch
024a3e392ba23b6d3a13f64b8159d54d062e4478,111,2299,6530,4231,5,24,29,3,124,238,8,38,5.718393704,45853,67,3,6924,7662,738,237174,258526,21352,1695,2014,319,1,90.25394647,Arch
1d4afbe57a86bf025b00b0e2c93793d355a9096d,111,6473,2321,4152,21,5,26,3,125,316,8,38,5.70660713,41712,225,5,7661,6924,737,258580,237174,21406,2013,1695,318,1,90.25394647,Arch
72ed7d398fa3cdb93f8868e553323c27801b2e83,111,2299,6541,4242,5,24,29,3,124,238,8,38,5.719128146,45864,10,1,6924,7662,738,237174,258589,21415,1695,2014,319,1,90.25394647,Arch
e1346179aae59ffc3b3319cfa643f39e9aef863b,109,6431,2312,4119,21,5,26,3,125,314,8,36,5.686031238,37837,0,0,7489,6753,736,227653,206477,21176,1841,1524,317,1,90.25394647,Arch
743e66f88af24501d6d3bb1a4495424946c7098c,109,2290,6499,4209,5,24,29,3,124,246,8,36,5.698688797,41956,0,0,6753,7490,737,206477,227662,21185,1524,1842,318,1,90.25394647,Arch
809a78b4a9549ac1d28ae600fc23e769c50ede20,109,6431,2312,4119,21,5,26,3,125,314,8,36,5.686031238,37837,9,3,7489,6753,736,227653,206477,21176,1841,1524,317,1,90.25394647,Arch
2bd65a0785a66934d2f15e7750bfadd6bd5ceec2,109,2290,6499,4209,5,24,29,3,124,246,8,36,5.698688797,41956,67,0,6753,7490,737,206477,227662,21185,1524,1842,318,1,90.25394647,Arch
c85ef54762b94b77fe7ef7b71a97a7acea7e8b26,109,6431,2312,4119,21,5,26,3,125,314,8,36,5.686031238,37837,15,5,7489,6753,736,227653,206477,21176,1841,1524,317,1,90.25394647,Arch
4a99dab9ca2af75f67d8f6e68841060d469b77a3,110,2313,6596,4283,5,24,29,3,124,246,8,36,5.719420927,42110,164,0,6753,7504,751,206831,228427,21596,1524,1845,321,1,90.25394647,Arch
8888b6285fba7373df8b00a0dd5b0ac0c4b17aea,110,6528,2335,4193,21,5,26,3,126,312,8,36,5.70711442,37917,16,6,7503,6753,750,228418,206831,21587,1844,1524,320,1,90.25394647,Arch
83321916e246315cdb125f92b7600bff46422f2b,110,2313,6596,4283,5,24,29,3,124,246,8,36,5.719420927,42110,15,5,6753,7504,751,206831,228427,21596,1524,1845,321,1,90.25394647,Arch
2b1143abac2a665bbefbbfcd17b57390094a7a2b,118,7431,2336,5095,27,5,32,3,126,289,10,40,5.86311411,38361,128,2,7690,6814,876,235081,209104,25977,1918,1551,367,1,90.9693089,Arch
79d177be7bc6d511e8902d963802c9550608bebf,118,2314,7499,5185,5,30,35,3,124,236,10,40,5.874210853,43456,17,7,6814,7691,877,209104,235090,25986,1551,1919,368,1,90.9693089,Arch
a7d51d496d860715577d1a77117313748c611397,120,7586,2345,5241,27,5,32,3,126,285,10,40,5.891526203,39226,9,0,7884,6970,914,240426,213554,26872,1980,1605,375,1,90.9693089,Arch
c79aad4362b6f806da47462ec84e35108ba8eb1f,122,2329,7702,5373,5,30,35,3,124,242,10,41,5.924026988,46275,68,2,7426,8352,926,223366,250531,27165,1713,2091,378,1,90.9693089,Arch
ad426c24c04e36ff6b7fc286501b4b737b317ad3,121,7631,2345,5286,27,5,32,3,126,282,10,41,5.90816345,40568,28,0,8272,7345,927,247256,220107,27149,2079,1702,377,1,90.9693089,Arch
c994a111fef904775a51490f20a1cb2b1131b2d9,1,165,0,165,1,0,1,1,1,0,1,1,0.0,0,29,1,21,0,21,917,0,917,6,0,6,1,96.53299916,Arch
57e01bab63a5d4972886954399e8e4fc240d4431,3,156,30,126,1,0,1,9,68,47,1,3,1.022647421,2953,14,1,651,638,13,19737,19164,573,101,96,5,1,97.24732087,Arch
3b510f8c07271e2e51b5a9151a0d26f7084e3792,19,1571,40,1531,4,0,4,5,64,392,1,6,3.00969957,5184,238,2,1251,913,338,35904,27312,8592,349,257,92,1,97.3871734,Arch
84513334719958539fbddfbd12e3c95e4804a1fb,72,139,720,581,0,0,0,5,32,1745,1,6,3.338028212,12934,35,1,1631,1808,177,62103,64993,2890,575,617,42,1,97.7,Arch
ce725f500ffb826f8d121ddef2514f7052013577,3,270,0,270,1,0,1,1,30,190,2,3,0.664108911,652,168,1,106,60,46,5187,3650,1537,28,19,9,1,97.6618705,Arch
f54723676d416001b6fb26f5ea281de0b392ec06,1,379,189,190,0,0,0,11,41,82,1,1,0.0,1681,18,1,59,49,10,14473,12531,1942,59,49,10,1,97.70275669,Arch
29fedc53fdc4a9df9f5857e754cf6fdcad488cef,10,895,0,895,10,0,10,1,1,0,1,2,3.219974633,0,24,0,43,0,43,3486,0,3486,43,0,43,1,96.24776653,Arch
1893a36d64a78e3d18cf74e74bf6a88649d15515,16,242,175,67,1,0,1,3,175,363,2,11,3.055666689,16839,45,3,2781,2776,5,107874,107739,135,458,450,8,1,96.01842711,Arch
cd1e9b71a523e12e612e608a3dff15ecd773f652,77,798,766,32,3,2,5,2,186,531,19,44,5.235768025,41855,332,0,8221,8211,10,243481,244055,574,1607,1599,8,1,96.14342629,Arch
3105b94c03ac2176955dedb2d4ac78ebb4665cf6,13,40,54,14,0,0,0,21,184,94,7,11,2.050069344,9356,333,1,1744,1745,1,57401,57509,108,311,312,1,1,96.78626084,Arch
0a7f809880c38190596945e0c30ac713bf0deeb2,39,2393,2567,174,5,0,5,14,188,188,6,19,3.087041117,27602,324,1,5086,5170,84,169124,170370,1246,969,967,2,1,97.46793818,Arch
3fca183e7bd2212489513ced5fa550fe7259e140,15,489,409,80,0,0,0,14,187,0,2,9,2.990789882,11835,334,2,2078,2071,7,76158,76023,135,423,423,0,1,97.66927526,Arch
6cd9e7b9efe7a799ce4d5c3faa6d1d9491dcf1c1,32,640,641,1,0,0,0,2,96,22,4,15,3.889553155,12896,335,2,2268,2269,1,72514,72664,150,553,548,5,1,97.17455365,Arch
fa0dff146399b97554d4e745e6e2dcbd7510d988,5,356,66,290,2,0,2,1,92,4,2,3,1.86822772,4818,329,5,1166,1131,35,29163,27543,1620,165,153,12,1,97.94905723,Arch
d6e0e9af2446d023e68df1e21221d8bf1190615d,3,86,28,58,0,0,0,15,43,66,2,2,0.8708069,2045,58,0,404,403,1,10863,10633,230,64,60,4,1,96.24012638,Arch
6d8f9179d60f7d5f70852e13779fb096adfcf714,4,42,11,31,0,0,0,8,89,24,2,4,1.617019467,2961,110,3,658,653,5,19383,19130,253,115,113,2,1,21.71761281,Arch
10f4cff27b703ffbb18e77ac9bd08d4b61e63813,7,81,32,49,0,0,0,6,26,332,2,4,2.076351539,3166,1,0,491,488,3,18630,18306,324,117,117,0,1,21.71761281,Arch
daeda7ab8aefcfdbe5869ff7c5852fe1ee351635,4,99,14,85,0,0,0,8,98,292,1,3,1.548002321,2582,343,1,461,439,22,15061,14367,694,127,122,5,1,94.3255814,Arch
99c15149dc250d56e5145996bc944f0b32e6ac56,2,16,9,7,0,0,0,7,15,58,1,2,0.970950594,1695,1,0,319,317,2,10347,10298,49,56,55,1,1,94.14577259,Arch
91a00f42062bfe01600fd477a4d57d5b1a6b8b06,2,203,1,202,1,0,1,1,7,1636,2,2,0.079490442,102,342,2,32,11,21,1389,456,933,15,6,9,1,97.18309859,Arch
cf1e3ef8dcd5a4adc046a3895f49c9deb3069015,12,1339,149,1190,6,0,6,1,47,478,3,8,2.895789281,4036,0,0,953,787,166,29648,22479,7169,150,114,36,1,97.93648235,Arch
20561472eba2fc484f33801c5c07fdc9b8edd9d9,2,70,2,68,1,0,1,4,6,37,1,1,0.249882293,150,59,0,29,21,8,1045,723,322,10,7,3,1,95.73554665,Arch
39bb22ec0dac0a9a7b13389c89df1616a3ba23e7,11,307,25,282,2,0,2,3,90,770,1,7,2.594890796,3949,355,1,778,729,49,24200,22677,1523,178,166,12,1,97.98566987,Arch
03d4b3e1a053f0a79899051e1064213d2b66286a,4,321,2,319,1,0,1,1,22,413,3,3,1.153624844,1424,11,0,268,228,40,9378,7684,1694,62,49,13,1,95.2128402,Arch
a73ced56850d6858abe4dcc3d63c3c211b9203b1,13,1384,4,1380,8,0,8,1,200,151,2,5,3.18793466,7491,356,0,1669,1462,207,50412,44068,6344,355,246,109,1,96.39905549,Arch
60e453f754cca269455608be41e253d322b4d528,1,160,0,160,1,0,1,1,1,0,1,1,0.0,0,13,0,19,0,19,785,0,785,7,0,7,1,94.49434946,Arch
0b9694d5e7382fac95df12a30be598bd7dd4168a,2,135,3,132,1,0,1,1,4,126,2,2,0.473572925,143,136,0,34,18,16,1580,847,733,11,5,6,1,94.13138232,Arch
63434dd53cb7aed13b9cb7fbf0c83ca2ff3ae0e2,26,599,204,395,1,0,1,14,59,1728,8,17,3.588632805,10663,2,0,2093,2012,81,63049,60189,2860,406,390,16,1,94.62784179,Arch
7cdbe14bc065df408130a0b117a37943a1055648,4,607,21,586,1,0,1,1,93,171,1,4,0.53094034,2309,375,1,542,484,58,16409,12610,3799,126,116,10,1,90.92903024,Arch
1fbd0a31527d87a5d2d0bb239ac4ca9be3a58b57,11,617,0,617,1,0,1,1,24,2175,1,2,1.054725322,852,22,0,201,124,77,7319,3593,3726,76,48,28,1,96.55113829,Arch
4a87e3203ad18155e82b172e9754aa0fdc3554e7,8,363,198,165,0,0,0,2,31,2353,2,7,1.935699736,2767,395,0,538,500,38,15292,14261,1031,105,101,4,1,95.98662207,Arch
0184d93d3a0185dc589a5ed1226f418305371fb3,3,332,23,309,1,0,1,1,24,550,2,3,0.628697111,1248,15,0,253,206,47,8972,7258,1714,54,40,14,1,92.32778322,Arch
8cf1668c165c9a981d47597a4cfc693169debf18,2,59,15,44,0,0,0,8,93,991,1,1,0.639457132,1519,398,1,351,344,7,9475,9183,292,67,67,0,1,95.34007195,Arch
218c06ff54f389a2ee57d80e156ecbf7364a51ec,9,324,63,261,0,0,0,5,113,268,1,5,2.306806049,5125,402,0,1181,1133,48,32187,30232,1955,231,221,10,1,94.29908161,Arch
911bdc88c86e316a04e8ae7719fc5a967425648e,11,1085,681,404,3,1,4,1,105,925,1,5,2.186847738,2548,399,0,461,547,86,16629,16581,48,141,171,30,1,91.10816191,Arch
52a855892fab138652255b9f492c06725c82d7be,9,356,40,316,2,0,2,1,11,445,1,6,2.396551171,1581,400,1,211,189,22,11461,9463,1998,74,69,5,1,92.69027882,Arch
fb764e6910830f138ab1513b65f7689599ff0307,2,13,12,1,0,0,0,15,48,104,2,2,0.970950594,1484,6,0,348,346,2,9298,9256,42,57,57,0,1,95.55302166,Arch
869ec42f3718fcb4a7f8c463cbbb884f7216e9d9,7,150,6,144,0,0,0,14,27,2728,1,2,2.382065637,1197,22,0,198,172,26,8113,6941,1172,56,48,8,1,92.9794965,Arch
7a4310e25e1214b077d4482f07577f8d4c76fdf2,10,397,23,374,2,0,2,4,32,1781,2,5,3.09111907,2580,28,1,320,283,37,18053,15703,2350,151,132,19,1,92.37528728,Arch
1eeb40a7102a717257f045bf81483552bf6d7720,2,1088,10,1078,0,0,0,16,106,32,1,2,0.062208298,6800,85,6,911,887,24,65664,55651,10013,261,237,24,1,89.75664069,Arch
