CommitID,NMF,TotalAddLines,TotalDeleteLines,LC,FileAdd,FileDelete,NAD,NDVE,NUC,AGE,NMS,NMD,Entropy ,MLMF,EXP,REXP,CommitComplexity,LastCommitComplexity,CFC,CommitTokenCount,LastCommitTokenCount,NCC,CommitMethodNum,LastCommitMethodNum,NFC,NIR,a2a,Tag
f84e41611c1c25f5fc33d96570d1fb629858118b,1,2,2,0,0,0,0,1,2,20,1,1,0.0,180,381,19,10,10,0,790,790,0,10,10,0,0,100.0,NoArch
4a01e40cb40f82b10f794ea5466f751eedf7f7f9,2,6,3,3,0,0,0,2,13,53,1,2,0.764204507,905,26,15,160,160,0,5830,5817,13,46,46,0,0,100.0,NoArch
4834cf15ecd9a8584e37f5c8d0c257e64b05250d,1,0,27,27,0,1,1,2,2,451,1,1,0.0,27,1163,1,0,1,1,0,40,40,0,1,1,1,99.9903035,NoArch
a620b403f4df4e5c8392b2b827942f0c11db35ef,1,1,1,0,0,0,0,2,2,1204,1,1,0.0,75,247,20,9,9,0,327,327,0,3,3,0,0,100.0,NoArch
06949a507495e6b2e5761a11b10b8aab89a00b1b,2,87,16,71,0,0,0,1,5,10,1,2,0.994485462,1484,756,4,200,189,11,6626,6277,349,91,87,4,1,100.0,NoArch
563cc1bc6a79a76270d83bd34d52672131f36835,0,0,0,0,0,0,0,0,0,0,0,0,0.0,0,1403,1,0,0,0,0,0,0,0,0,0,0,100.0,NoArch
4bba15a7638824d1e16ad3304bfd7d48b8f02518,2,84,11,73,0,0,0,9,85,223,1,2,0.887629706,2890,346,11,258,255,3,19100,18516,584,115,114,1,1,100.0,NoArch
aa1aa58caa992ac48cc1896042a95f8ebd10e693,18,379,374,5,0,0,0,2,7,528,1,11,2.071355301,3406,783,6,271,271,0,17678,17150,528,128,128,0,0,100.0,NoArch
6c859676b3995334e96c16c47653ec72fa70f729,4,55,21,34,0,0,0,11,37,50,2,3,1.708112513,3687,14,12,507,507,0,22508,22275,233,145,145,0,1,99.98194837,NoArch
ede5e3f23ed0aeb2fd6b7a6a5fc47b1cb86a0bbc,1,4,2,2,0,0,0,2,2,26,1,1,0.0,219,186,11,7,7,0,289,275,14,7,7,0,0,100.0,NoArch
e3626e19bccfedb6d147d23c071ef3b30fb2329c,5,22,31,9,0,0,0,5,21,45,3,4,1.89156618,1414,1074,4,162,161,1,7709,7798,89,67,67,0,1,100.0,NoArch
a5bb9bd1d792b1676884f31e5254d9e1c4fbb27c,1,6,0,6,0,0,0,1,2,2,1,1,0.0,139,981,5,11,11,0,746,701,45,6,6,0,1,100.0,NoArch
2241f2064f65b742bc0b4e91eb6d6f09e4212261,1,1,1,0,0,0,0,2,2,546,1,1,0.0,83,332,38,10,10,0,279,279,0,9,9,0,0,100.0,NoArch
0ee6047d012249eb5896fad101f20cec21d1dbd0,1,4,5,1,0,0,0,2,3,33,1,1,0.0,313,141,3,60,60,0,838,849,11,22,22,0,0,100.0,NoArch
60832c0b2d58c0977c2ba90afdb5d7fb40a9350d,0,0,0,0,0,0,0,0,0,0,0,0,0.0,0,407,12,0,0,0,0,0,0,0,0,0,0,100.0,NoArch
b0e35706522f491bfccf56bed14195278607b97f,2,43,14,29,0,0,0,1,77,11,1,2,0.366578013,1368,258,9,232,232,0,8105,7833,272,66,66,0,1,100.0,NoArch
82942f9e318f87b5658b330a007f19aa886fe1cd,0,0,0,0,0,0,0,0,0,0,0,0,0.0,0,536,37,0,0,0,0,0,0,0,0,0,0,100.0,NoArch
2b0a194416b12550903fcee1cf8531edc8be8307,3,21,13,8,0,0,0,2,13,803,1,2,1.495824229,611,262,13,71,71,0,2927,2870,57,25,25,0,0,100.0,NoArch
67f887da88dc62accb41598bd9f9fa9f3267ec00,0,0,0,0,0,0,0,0,0,0,0,0,0.0,0,110,16,0,0,0,0,0,0,0,0,0,1,100.0,NoArch
3adffc18e1d747a710eee5a0e648e74c2fc8bdc8,0,0,0,0,0,0,0,0,0,0,0,0,0.0,0,128,10,0,0,0,0,0,0,0,0,0,1,100.0,NoArch
b92a315599d53b07e2ed4eff1c6f0345f048c0a8,7,672,0,672,7,0,7,1,1,0,1,2,2.649456225,0,1177,3,77,0,77,3304,0,3304,34,0,34,1,99.75863821,NoArch
6c1676b59fcd7d46ed4ea9c5c1d6ef77f9bbd779,13,148,71,77,0,0,0,1,245,293,1,12,2.650457097,14767,30,27,2472,2462,10,69035,68712,323,1010,1005,5,1,99.9854827,NoArch
2e0f676c9bd59c4ac078fcbe2d8bfab850ce1fc2,1,1,1,0,0,0,0,4,51,243,1,1,0.0,1921,288,21,214,214,0,6290,6292,2,123,123,0,0,100.0,NoArch
0051c4ea6f579cab730d89364d0a53b043a90995,1,6,1,5,0,0,0,13,240,12,1,1,0.0,2791,987,10,509,508,1,12227,12193,34,245,245,0,1,100.0,NoArch
c4b11a639615d3192ab242bf76d7146383751396,1,7,6,1,0,0,0,5,10,0,1,1,0.0,324,66,1,59,59,0,1593,1593,0,29,29,0,0,100.0,NoArch
67fd739b3a846b411f0e296cb80d7ee81b4a83a5,6,0,356,356,0,6,6,3,7,115,1,1,2.575256544,356,372,56,0,22,22,0,1173,1173,0,22,22,0,99.87176958,NoArch
01e2aec7b59cf5def1c69a6c2208c7648b6956d2,2,61,0,61,1,0,1,1,15,950,1,2,0.208180946,136,158,0,26,23,3,885,663,222,21,18,3,1,99.98213329,NoArch
1e5dac11fad48f4d909dbe85d2f7c91be4989e6f,6,128,39,89,2,0,2,3,13,257,1,2,2.37972341,465,811,17,43,41,2,2456,2306,150,32,29,3,1,99.97101869,NoArch
82ce164d7a95111d976dec747331c8f7e2536537,1,1,2,1,0,0,0,4,8,15,1,1,0.0,89,426,30,7,8,1,342,348,6,6,6,0,0,100.0,NoArch
16c1627ca0324b255b1dcd28105984d1f7faeabb,4,32,2,30,0,0,0,6,10,482,1,2,1.851226816,1884,0,0,322,316,6,8674,8549,125,196,193,3,1,100.0,NoArch
219c5d32cd75bdae8b86e960d121e553042d3e9a,1,75,0,75,1,0,1,1,1,0,1,1,0.0,0,647,13,5,0,5,325,0,325,4,0,4,0,99.97978471,NoArch
6778a49eecb2efe2af4fb6bb2a0d7c82f9861248,4,262,9,253,1,0,1,1,126,160,1,4,0.433153102,3138,848,11,556,539,17,16565,15032,1533,203,193,10,1,99.98971617,NoArch
1214c40ff0209b880f6ca058c3fc9ec406baa4e4,0,0,0,0,0,0,0,0,0,0,0,0,0.0,0,484,30,0,0,0,0,0,0,0,0,0,0,100.0,NoArch
da4302921e300f660568fcc1788eaafad07824f5,1,3,3,0,0,0,0,1,3,641,1,1,0.0,200,568,28,7,7,0,907,907,0,4,4,0,0,100.0,NoArch
393a861e89e08d767d40cd7740f274fa85020167,1,16,2,14,0,0,0,2,22,41,1,1,0.0,300,514,26,61,57,4,1404,1321,83,24,24,0,1,100.0,NoArch
cf0570f75e2f9e94f1d52a99706ed1b51a793f8e,0,0,0,0,0,0,0,0,0,0,0,0,0.0,0,431,22,0,0,0,0,0,0,0,0,0,0,100.0,NoArch
7e28d2a948404df1d73be55a0fa4db81760fb402,1,2,2,0,0,0,0,1,2,824,1,1,0.0,199,826,8,15,15,0,985,987,2,4,4,0,1,100.0,NoArch
47abda2a7d26629ef8428000c664af6f9487bc4c,1,15,18,3,0,0,0,2,4,34,1,1,0.0,214,500,16,19,20,1,1058,1097,39,4,4,0,0,99.95390112,NoArch
85df0e62d7208435531fd117c9b5b07a2377054e,1,1,2,1,0,0,0,5,23,0,1,1,0.0,686,1,1,32,32,0,2910,2915,5,23,23,0,0,100.0,NoArch
dc4ceb47e8cf3bad78abfcf1b9b8cbb9f265d390,6,199,70,129,1,0,1,2,10,12,1,2,1.217835811,1519,1218,5,185,159,26,7252,6633,619,71,57,14,0,99.98621704,NoArch
1462fd234c98037992cdb78b77e9ddde808efa83,1,15,0,15,0,0,0,12,215,80,1,1,0.0,2473,703,5,451,451,0,10754,10754,0,229,229,0,1,100.0,NoArch
760c62934d2ff5fe92e399cf7f980d8de4e191d4,2,113,3,110,1,0,1,1,14,441,1,2,0.362051252,76,881,20,17,9,8,938,316,622,11,7,4,1,99.98265896,NoArch
1bdcb4f96ffa7b08532f0ef76425416d9363c118,0,0,0,0,0,0,0,0,0,0,0,0,0.0,0,684,11,0,0,0,0,0,0,0,0,0,1,100.0,NoArch
df72ec507943951ff41fed156b9d6d8de8f507d0,0,0,0,0,0,0,0,0,0,0,0,0,0.0,0,583,43,0,0,0,0,0,0,0,0,0,0,100.0,NoArch
7b16aec2c0edec1bff95245900e702811aa3a718,2,9,3,6,0,0,0,3,14,1165,2,2,0.979868757,319,132,8,43,42,1,1191,1174,17,18,18,0,1,100.0,NoArch
9308db8b75a747646f02f0ff8dad0ea65d16aabe,2,82,78,4,0,0,0,3,6,35,1,1,0.543564443,643,38,10,21,21,0,3565,3524,41,18,18,0,0,100.0,NoArch
30f41b9811cb883bd2b251a216eb59f3431caf9d,1,3,3,0,0,0,0,2,2,113,1,1,0.0,581,933,4,82,82,0,3842,3837,5,42,42,0,1,100.0,NoArch
129f879607e02f54834911d5b31a5cffb9f4b2b3,1,81,33,48,0,0,0,2,4,91,1,1,0.0,243,457,5,43,35,8,1703,1423,280,19,18,1,0,100.0,NoArch
31ecfae93453e5a35d72322bf2e2bb5adcdeac5e,1,9,1,8,0,0,0,6,80,0,1,1,0.0,863,988,26,176,174,2,4086,4058,28,56,56,0,1,100.0,NoArch
4a01e40cb40f82b10f794ea5466f751eedf7f7f9,2,6,3,3,0,0,0,2,13,53,1,2,0.764204507,905,26,15,160,160,0,5830,5817,13,46,46,0,0,100.0,NoArch
3c1b477523365dac6eca3b284f46df80d05b23de,2,33,2,31,0,0,0,7,26,6,2,2,0.863120569,534,338,10,60,58,2,2847,2616,231,22,21,1,1,100.0,NoArch
b6e3ca74ba68c6a9879076ecb5be468e881897cd,1,6,5,1,0,0,0,6,7,2062,1,1,0.0,115,556,17,10,10,0,548,557,9,6,6,0,0,100.0,NoArch
39e63c0051c1e296927c0f64c69b80dad15fc028,5,171,18,153,1,0,1,1,24,641,1,5,1.324552215,1237,248,11,218,213,5,6986,6127,859,89,86,3,0,99.91580365,NoArch
8d560fe39a453fdf0701917fd6fdd04e0160ce59,0,0,0,0,0,0,0,0,0,0,0,0,0.0,0,129,1,0,0,0,0,0,0,0,0,0,1,100.0,NoArch
f5d8a05ed7957f42c3a734891bc7f36f60891889,1,40,24,16,0,0,0,2,2,333,1,1,0.0,288,601,44,28,27,1,2070,1938,132,10,10,0,1,100.0,NoArch
610d5272ec7b948afa4bbfaa2b011b8a2aa74ee6,1,1,2,1,0,0,0,3,15,354,1,1,0.0,331,55,9,47,47,0,2215,2215,0,30,30,0,1,100.0,NoArch
ff5e7e76264af13db020e627bdf81e23e9b4fbea,1,0,58,58,0,0,0,5,108,2,1,1,0.0,2887,302,10,484,491,7,16412,16872,460,182,182,0,1,100.0,NoArch
b1d7a78c0a1ed6212b9cec274992f37d91b03d94,3,23,46,23,0,0,0,4,47,25,1,1,0.701626777,3487,469,10,492,493,1,19757,19878,121,229,229,0,0,100.0,NoArch
f79f7ad426146983f21f0b42e6661816c6f33e97,1,32,1,31,0,0,0,3,18,182,1,1,0.0,553,1073,3,53,48,5,3822,3588,234,23,21,2,0,100.0,NoArch
38e5c0829a3c8051841be416ec432dadae0dcf4a,1,0,1,1,0,0,0,10,144,41,1,1,0.0,2610,784,2,353,353,0,9314,9323,9,189,189,0,1,100.0,NoArch
fc0b3599731442be6256c0bc9e2925151fd5cfac,1,2,1,1,0,0,0,6,18,326,1,1,0.0,134,783,1,13,13,0,712,700,12,10,10,0,0,100.0,NoArch
1e5dac11fad48f4d909dbe85d2f7c91be4989e6f,6,128,39,89,2,0,2,3,13,257,1,2,2.37972341,465,811,17,43,41,2,2456,2306,150,32,29,3,1,99.97101869,NoArch
3813947879fc0eb4fdd59a0bfb83915722103c96,2,118,3,115,0,0,0,7,235,148,1,2,0.318855419,3289,359,9,470,461,9,19548,18790,758,144,141,3,1,100.0,NoArch
5ad120242694a0db524863aab3e03ab34be9c390,0,0,0,0,0,0,0,0,0,0,0,0,0.0,0,538,39,0,0,0,0,0,0,0,0,0,1,100.0,NoArch
c1acb4030d12e6d653bc5bca385532fc00dc3ed9,1,1,1,0,0,0,0,1,2,18,1,1,0.0,131,489,12,11,11,0,610,610,0,8,8,0,0,100.0,NoArch
34af42f4440979a9dee85908718857120236b495,1,70,3,67,0,0,0,5,107,34,1,1,0.0,2820,301,9,491,482,9,16872,16380,492,182,182,0,1,100.0,NoArch
3845c7caa744dca4d9144f1c55842efa0bf437a4,3,44,3,41,0,0,0,3,11,136,1,2,0.75390776,1212,777,32,157,153,4,7571,7287,284,59,58,1,1,100.0,NoArch
144be7c2774dd67524684711d1824bb4790d1568,1,43,10,33,0,0,0,3,4,14,1,1,0.0,625,603,31,86,84,2,2080,1929,151,79,79,0,1,100.0,NoArch
4e2acd4a77a39ed74dfb692c2978248fba3a4946,3,40,9,31,0,0,0,4,54,9,1,1,1.516472194,4487,331,37,464,459,5,13147,13060,87,287,283,4,0,100.0,NoArch
a265a2687859b940f8a7684d7e63f93a6da13b4f,0,0,0,0,0,0,0,0,0,0,0,0,0.0,0,177,21,0,0,0,0,0,0,0,0,0,0,100.0,NoArch
a7533ba92285a2910dfe8faad7d1492cf9ff7ab3,7,33,17,16,0,0,0,3,10,379,2,4,2.051346433,3666,940,1,422,417,5,19367,19273,94,194,193,1,1,100.0,NoArch
6e5f231a8a1f133cd71063be040d2db1810e40aa,2,103,0,103,2,0,2,1,1,0,2,2,0.815102505,0,782,29,6,0,6,443,0,443,3,0,3,1,99.8985401,NoArch
dc35766d0e321f5df912bc05de039bc62fb8b492,0,0,0,0,0,0,0,0,0,0,0,0,0.0,0,760,4,0,0,0,0,0,0,0,0,0,1,100.0,NoArch
6ee4c66fc353f45ab254e6da2b91c2c1ad86312a,0,0,0,0,0,0,0,0,0,0,0,0,0.0,0,778,30,0,0,0,0,0,0,0,0,0,0,100.0,NoArch
e771b88479c70cd24ea489ef325b59da108572cd,2,56,2,54,0,0,0,1,114,221,1,2,0.216396932,2942,447,5,340,337,3,11851,11523,328,185,184,1,1,100.0,NoArch
d8440f8610f56d79555c43a40c16948fb56df1d9,1,1,1,0,0,0,0,1,5,921,1,1,0.0,282,1177,0,48,47,1,1176,1170,6,13,13,0,0,100.0,NoArch
330c9a896d175ccb2bb41f2a9ce569851026ac9c,4,18,8,10,0,0,0,1,13,186,1,3,1.709778149,383,579,6,26,24,2,1896,1845,51,17,16,1,1,100.0,NoArch
d112ad5af754a07130890b240182e10578494a78,2,259,3,256,1,0,1,1,31,25,1,2,0.177653494,311,297,5,93,68,25,2720,1340,1380,35,27,8,1,99.95913363,NoArch
6725350e0907dc10604960cb1b423f3042c06ec8,0,0,0,0,0,0,0,0,0,0,0,0,0.0,0,147,10,0,0,0,0,0,0,0,0,0,1,100.0,NoArch
6f7e3fc1d5be96ff0ba57b1f0fd45f2289242c37,3,16,3,13,0,0,0,2,51,192,1,2,1.432983121,3515,490,13,538,534,4,19962,19880,82,242,241,1,0,100.0,NoArch
a1d5ff03169024fe486b96378f5e8409b6a98fd9,1,12,7,5,0,0,0,11,229,15,1,1,0.0,2135,243,14,380,379,1,10969,10955,14,105,105,0,1,100.0,NoArch
e80e052c278df2b3657bdcfc01b2df4d8a01ccfb,1,1,1,0,0,0,0,2,4,58,1,1,0.0,57,674,29,1,1,0,146,159,13,1,1,0,0,100.0,NoArch
73d5b6feea246c20f26b949aa3d34974095752ee,0,0,0,0,0,0,0,0,0,0,0,0,0.0,0,133,21,0,0,0,0,0,0,0,0,0,0,100.0,NoArch
68bcac109a2caf4855656ac0c94924d5c44f704a,5,5,5,0,0,0,0,3,72,167,2,5,2.321928095,2244,600,14,380,380,0,11270,11205,65,179,179,0,1,100.0,NoArch
d84e8e182644b71564b79d13ac095b95ec41037b,3,11,5,6,0,0,0,2,7,28,1,1,1.298794941,319,1102,16,24,23,1,1745,1679,66,17,16,1,0,100.0,NoArch
2f47288da270b2db68915ec8caac632236bc6802,1,11,9,2,0,0,0,1,3,473,1,1,0.0,158,581,8,24,24,0,963,957,6,9,9,0,1,100.0,NoArch
663b8a24f9d2553450515c56cf4ff52c6b9a5b10,0,0,0,0,0,0,0,0,0,0,0,0,0.0,0,87,16,0,0,0,0,0,0,0,0,0,0,100.0,NoArch
9e32de2812abb58772b752140d07d0a1513f0a48,5,80,0,80,0,0,0,1,5,227,2,4,2.321928095,391,434,14,25,25,0,2273,2273,0,10,10,0,0,100.0,NoArch
4a23f0d1c1ab0a772239b329a0092308ea9d367b,1,2,2,0,0,0,0,3,7,0,1,1,0.0,236,458,8,35,35,0,908,908,0,22,22,0,1,100.0,NoArch
d6bd98f4c7d7889cc61477ea4ea5f648082e7f32,1,37,0,37,0,0,0,2,3,1172,1,1,0.0,69,413,8,5,4,1,523,281,242,4,3,1,0,99.99149081,NoArch
ff7bee0e49928c7d6d770167f6c78fef9a4ad14f,1,4,4,0,0,0,0,5,35,65,1,1,0.0,795,146,3,132,132,0,4317,4317,0,54,54,0,0,100.0,NoArch
3c4848b8a5582ae510d60da7b786eee7200b456e,4,22,2,20,0,0,0,4,238,1067,3,3,1.528368899,3412,775,11,562,556,6,14666,14513,153,278,277,1,1,99.98235398,NoArch
cbf2adb343f6624a539bc12101a37e4f800cedde,1,19,1,18,0,0,0,1,4,13,1,1,0.0,77,1280,10,18,13,5,453,316,137,14,13,1,0,100.0,NoArch
2a682e2fb2b0f4fc212e89dc13d08a61c3cc1aea,1,9,2,7,0,0,0,4,26,129,1,1,0.0,883,251,32,150,149,1,4502,4466,36,56,56,0,1,100.0,NoArch
488bd9c14d8e403232abfcda86eb6c1db11f3d4a,0,0,0,0,0,0,0,0,0,0,0,0,0.0,0,138,1,0,0,0,0,0,0,0,0,0,1,100.0,NoArch
33cdefaf2ef7d9f5292a95612b404c3712be7262,5,70,44,26,0,0,0,1,114,506,1,4,1.602506541,1504,942,7,248,247,1,7920,7719,201,116,114,2,1,99.98832185,NoArch
37423d661c440fa5fe3420e9b0c0bf8c5d5d67ae,3,158,131,27,0,0,0,1,29,194,2,2,0.297728922,1485,1307,4,263,256,7,8684,8507,177,79,76,3,0,100.0,NoArch
5d697cff3b0f98a2d4d4f7176508bbbc77305d5d,3,33,16,17,0,0,0,4,65,535,2,3,1.109726445,2943,396,5,514,511,3,14280,14120,160,193,193,0,1,100.0,NoArch
bbc337fc9d8acbef5f254c3c3c9aa1d68c2a274c,0,0,0,0,0,0,0,0,0,0,0,0,0.0,0,11,1,0,0,0,0,0,0,0,0,0,1,100.0,NoArch
e8b12e4eaf7bbd9b7efa2087ae241728e6eeebb8,1,1,0,1,0,0,0,5,61,1,1,1,0.0,2067,379,59,229,229,0,6820,6816,4,137,137,0,0,100.0,NoArch
35f15ac8a18c766a011c6e47d37eb9d61a35a906,3,10,11,1,0,0,0,6,22,810,1,1,1.35666952,409,34,31,53,52,1,1500,1531,31,32,31,1,1,100.0,NoArch
2b6f36dbfd3bc2bd4f9e155d6528ac7346e95c6d,2,166,4,162,1,0,1,1,28,1,1,2,0.273769169,113,373,7,31,11,20,1213,475,738,19,8,11,1,99.9890122,NoArch
044b11918ad4aef40142f7f716e4fa4de618d0f0,1,3,3,0,0,0,0,2,3,793,1,1,0.0,211,970,7,10,10,0,864,851,13,6,6,0,1,100.0,NoArch
d1292441a2687eca271b305c0f5db4a402cf1e3e,0,0,0,0,0,0,0,0,0,0,0,0,0.0,0,1066,8,0,0,0,0,0,0,0,0,0,0,100.0,NoArch
94b404d0aba15b6963e66f18ae31393cb64bfe79,10,150,15,135,0,0,0,2,11,485,4,6,2.312073171,2959,1,1,426,416,10,14690,13920,770,226,222,4,1,100.0,NoArch
7a1d626a00c9c4d642bf278322807d6ad84af172,0,0,0,0,0,0,0,0,0,0,0,0,0.0,0,618,2,0,0,0,0,0,0,0,0,0,0,100.0,NoArch
29856516098ba3edc0d1cd5d68bc70beeae1e73d,1,2,2,0,0,0,0,1,3,3,1,1,0.0,152,494,6,11,11,0,836,836,0,4,4,0,1,100.0,NoArch
78a785eeccf270bae1e7733f6f85ce02b39581d0,0,0,0,0,0,0,0,0,0,0,0,0,0.0,0,27,16,0,0,0,0,0,0,0,0,0,1,100.0,NoArch
0d25d4e211c500e213477bad97b3d1e093a887ba,1,13,13,0,0,0,0,2,6,154,1,1,0.0,364,675,30,18,18,0,1946,2063,117,9,9,0,0,100.0,NoArch
c785ff773864e35de773b90ea0252514bb6b1f5b,0,0,0,0,0,0,0,0,0,0,0,0,0.0,0,771,12,0,0,0,0,0,0,0,0,0,0,100.0,NoArch
70b02fde333959b4c7ad91e15ddbca144061e2d2,2,46,3,43,0,0,0,2,17,1453,2,2,0.246022578,1545,160,8,335,332,3,7447,7233,214,97,96,1,1,100.0,NoArch
b93cd9ec13c1d804aafbacdcc3d548eda55bc61a,1,30,1,29,0,0,0,3,4,289,1,1,0.0,84,175,2,7,4,3,237,149,88,5,3,2,0,100.0,NoArch
27ded73ca6380e3e9d8bc2e39a86ca5f906ed62f,1,18,18,0,0,0,0,4,19,125,1,1,0.0,1068,229,10,163,163,0,5225,5243,18,72,72,0,0,100.0,NoArch
7d54de6504327ac06c2ffde6fd4ba7aa887a1837,1,5,7,2,0,0,0,2,3,98,1,1,0.0,96,673,28,10,10,0,314,369,55,6,6,0,0,100.0,NoArch
807e020373fe2733d5f822b399c969860ee97b9d,0,0,0,0,0,0,0,0,0,0,0,0,0.0,0,547,7,0,0,0,0,0,0,0,0,0,0,100.0,NoArch
38e5c0829a3c8051841be416ec432dadae0dcf4a,1,0,1,1,0,0,0,10,144,41,1,1,0.0,2610,784,2,353,353,0,9314,9323,9,189,189,0,1,100.0,NoArch
1d7b69d55c644dabfb605e3cd84bcaeab1b93902,0,0,0,0,0,0,0,0,0,0,0,0,0.0,0,1128,4,0,0,0,0,0,0,0,0,0,1,100.0,NoArch
a9eeb03520f074d5013239b8d8708a05ba31e176,0,0,0,0,0,0,0,0,0,0,0,0,0.0,0,485,18,0,0,0,0,0,0,0,0,0,0,100.0,NoArch
1e7881f5cabc1bf7e850026277040f1e641a8e8b,1,9,18,9,0,0,0,7,93,92,1,1,0.0,612,964,3,96,98,2,3170,3245,75,29,29,0,1,100.0,NoArch
88d56499d96678ed2bef14c956c342b1534ccd12,2,10,4,6,0,0,0,4,50,0,1,1,0.863120569,2609,718,4,307,305,2,8765,8731,34,188,188,0,0,100.0,NoArch
e07809dec603832a45d5d3377b4578caee27ed49,1,2,1,1,0,0,0,10,54,147,1,1,0.0,3409,82,9,585,585,0,20093,20086,7,214,214,0,0,100.0,NoArch
a8d3908586f058c2eadca1eb687907594ceb2df0,2,12,10,2,0,0,0,5,39,300,1,1,0.439496987,740,226,13,124,124,0,3111,3105,6,65,65,0,0,100.0,NoArch
f7a30b80fc9ff0c6b29ceb000e0c1a11cd0b64c0,2,50,22,28,0,0,0,1,53,0,1,2,0.979868757,1256,778,17,185,184,1,6496,6418,78,70,69,1,0,100.0,NoArch
7db8987ca6fdb3ce4f65d30a4178c0ccc483b525,0,0,0,0,0,0,0,0,0,0,0,0,0.0,0,1389,12,0,0,0,0,0,0,0,0,0,0,100.0,NoArch
bc8441bebc92483c2b1ea7298022a4bccb1403bf,2,85,145,60,0,0,0,3,46,547,1,1,0.072016472,523,910,8,80,88,8,1851,2022,171,44,45,1,1,99.97591087,NoArch
2df306cc7ad07b78a3ff9f2db1599a6f9297bf99,1,8,2,6,0,0,0,3,5,3,1,1,0.0,230,156,5,25,23,2,1015,965,50,3,3,0,1,100.0,NoArch
06949a507495e6b2e5761a11b10b8aab89a00b1b,2,87,16,71,0,0,0,1,5,10,1,2,0.994485462,1484,756,4,200,189,11,6626,6277,349,91,87,4,1,100.0,NoArch
050de10d41953f26721562f4d1972c371b9c4d8e,1,63,0,63,1,0,1,1,1,0,1,1,0.0,0,635,19,3,0,3,247,0,247,2,0,2,0,99.97870528,NoArch
07ade0db8f478b37c2950555364ddf9efba86d2c,0,0,0,0,0,0,0,0,0,0,0,0,0.0,0,111,16,0,0,0,0,0,0,0,0,0,1,100.0,NoArch
bb0aed04254c2d18915e6023e53cdbd0d2125507,1,2,2,0,0,0,0,1,3,51,1,1,0.0,83,336,15,11,11,0,639,629,10,2,2,0,0,100.0,NoArch
b437c2c52bf9bde3f2f079f907dd38fa1732c571,0,0,0,0,0,0,0,0,0,0,0,0,0.0,0,105,31,0,0,0,0,0,0,0,0,0,1,100.0,NoArch
a38a7c00933b001578a5fe54c8d91746088b5f47,6,143,8,135,2,0,2,3,10,381,2,3,2.154091788,1022,0,0,161,147,14,6005,5368,637,70,62,8,1,99.95072678,NoArch
4dc1ddcd21e59de465d063a6a780dc2c241cd262,1,3,2,1,0,0,0,4,15,120,1,1,0.0,280,37,0,21,21,0,1573,1556,17,11,11,0,0,100.0,NoArch
604ec7cc9f1e1dd40be0aac1a59e5892d1b49249,1,1,1,0,0,0,0,1,3,0,1,1,0.0,30,505,22,1,1,0,72,72,0,1,1,0,1,100.0,NoArch
60a526c36b5a3842c1f7eac1a8ffda5cd315c904,1,17,13,4,0,0,0,2,5,4,1,1,0.0,175,326,32,14,14,0,1000,945,55,6,6,0,0,100.0,NoArch
a806882adbf865012c615b5ded10f76820024a27,0,0,0,0,0,0,0,0,0,0,0,0,0.0,0,572,6,0,0,0,0,0,0,0,0,0,1,100.0,NoArch
bc45bf806569fbcc21a4765b69f46a463dd8b2bf,6,199,31,168,1,0,1,1,15,68,3,5,1.841851579,3052,1069,11,500,481,19,17277,16110,1167,241,232,9,1,99.93600293,NoArch
b47da808d7bf1ef479e482ed0c1db1c701386626,2,112,29,83,0,0,0,4,44,6,1,1,0.995605261,2825,1098,13,413,413,0,16519,15890,629,195,195,0,0,100.0,NoArch
f5dcc9dfbf6635ec70916376afcb7640396def4a,13,221,66,155,0,0,0,7,227,657,1,3,3.262429974,5779,267,17,869,848,21,28639,27857,782,424,415,9,1,100.0,NoArch
3b19c71935e6bb54da61c95470815ed65c61f77d,1,2,2,0,0,0,0,4,7,3708,1,1,0.0,84,900,7,5,5,0,398,398,0,5,5,0,1,100.0,NoArch
8a01c5d16a051541df404683e6d8ae71bc6240be,10,160,113,47,0,0,0,1,141,479,1,8,2.880801396,5925,31,28,1126,1122,4,27702,27555,147,421,420,1,1,99.98548832,NoArch
b5af41810baac0318d884161d1aa838e0e87b996,0,0,0,0,0,0,0,0,0,0,0,0,0.0,0,30,19,0,0,0,0,0,0,0,0,0,0,100.0,NoArch
f129a0be891bb9926fe949cca154c5dce60ad157,1,0,3,3,0,0,0,1,2,0,1,1,0.0,248,1036,8,22,22,0,1419,1445,26,13,13,0,1,100.0,NoArch
93a379fe3cc9dddd08a945c575cfe705216be55d,5,44,49,5,0,0,0,9,80,353,1,2,0.595091826,3341,909,7,345,344,1,20636,20472,164,179,180,1,1,100.0,NoArch
450b509d58e0cdab12c10edd692ba7a79ea7cca2,0,0,0,0,0,0,0,0,0,0,0,0,0.0,0,1294,2,0,0,0,0,0,0,0,0,0,0,100.0,NoArch
81ce0d1b4fff94fc024503524349901c82319b0c,1,30,16,14,0,0,0,2,6,303,1,1,0.0,149,716,2,25,23,2,641,591,50,11,11,0,0,100.0,NoArch
7695676339af398d2b3f46b9f518d70903b1a027,2,51,23,28,0,0,0,2,45,57,1,2,0.303374836,698,739,0,116,109,7,3261,3165,96,42,42,0,0,100.0,NoArch
edc159901843a88cf6761f25b85c1ee81bacfc46,3,72,24,48,0,0,0,2,2,86,1,2,1.190821416,292,7,7,23,22,1,2005,1571,434,13,12,1,1,99.98088563,NoArch
452ceae26e4ebe2982bf2a8d6f09918d5ca8bc58,1,1,1,0,0,0,0,10,181,109,1,1,0.0,2307,1089,14,422,422,0,10206,10200,6,208,208,0,0,100.0,NoArch
6ce8c3bf87cc2343609dfc9f7c71eadaa45488a9,2,391,48,343,1,0,1,1,58,4,1,2,0.736269273,1059,793,0,184,171,13,6880,5236,1644,70,61,9,1,99.94935854,NoArch
0552c2bf0d0f8aa2a62befa72f638d92e7698266,1,25,6,19,0,0,0,6,58,45,1,1,0.0,1500,26,2,243,239,4,6332,6242,90,127,126,1,1,100.0,NoArch
f25d3044e02c68b9075454131f1635ea5c6c3fae,4,68,0,68,0,0,0,2,4,1415,1,2,2.0,811,31,20,62,62,0,4468,4468,0,27,27,0,0,100.0,NoArch
bb51af38e1ed608b2151152da47c50d6ea788a6b,0,0,0,0,0,0,0,0,0,0,0,0,0.0,0,741,5,0,0,0,0,0,0,0,0,0,0,100.0,NoArch
e771b88479c70cd24ea489ef325b59da108572cd,2,56,2,54,0,0,0,1,114,221,1,2,0.216396932,2942,447,5,340,337,3,11851,11523,328,185,184,1,1,100.0,NoArch
a33f73e2026de6060199ab091b9b7ff369c50eb6,1,0,1,1,0,0,0,9,155,0,1,1,0.0,1979,969,8,350,350,0,8587,8600,13,192,192,0,0,100.0,NoArch
14180c5cb337452f4d630a5ad3d4c5a5dcfaff70,1,2,2,0,0,0,0,2,6,614,1,1,0.0,138,447,12,30,29,1,556,552,4,12,12,0,0,100.0,NoArch
a7891c3dca7b598b4664574bc88e0802e16df6ef,3,32,15,17,0,0,0,2,3,24,1,2,0.945086191,259,604,12,30,29,1,930,821,109,29,28,1,1,99.95607292,NoArch
7606053815c5944ad0299587e85ded5f4067d7a0,1,95,0,95,1,0,1,1,1,0,1,1,0.0,0,131,1,7,0,7,658,0,658,3,0,3,1,99.9769213,NoArch
e413e8711b00fdc8ed1c5f29d4dfa5b79e60cde3,0,0,0,0,0,0,0,0,0,0,0,0,0.0,0,88,1,0,0,0,0,0,0,0,0,0,1,100.0,NoArch
a24560c607ea758e803e76cd4f22e5129e1b517b,0,0,0,0,0,0,0,0,0,0,0,0,0.0,0,149,12,0,0,0,0,0,0,0,0,0,1,100.0,NoArch
bb4a2f73f4db9316593ca4e0e23d69b776513bad,10,546,54,492,2,0,2,4,98,279,2,4,1.869855282,6121,890,7,1026,951,75,32896,30430,2466,462,435,27,0,99.89019245,NoArch
5f7c6b73ba6862345f8ae9d19e0706dc66155650,0,0,0,0,0,0,0,0,0,0,0,0,0.0,0,552,66,0,0,0,0,0,0,0,0,0,1,100.0,NoArch
8938d14d434447193b02ba635606aa0fb7a80353,0,0,0,0,0,0,0,0,0,0,0,0,0.0,0,16,6,0,0,0,0,0,0,0,0,0,0,100.0,NoArch
0c2b35d6edee46a649e2387aae85d898b3c23c6c,1,1,0,1,0,0,0,3,9,497,1,1,0.0,110,856,8,4,4,0,578,571,7,3,3,0,0,100.0,NoArch
5d0182266fd9f27beca26a436a05a48b6835441a,1,3,1,2,0,0,0,7,20,228,1,1,0.0,509,371,15,27,27,0,2960,2960,0,12,12,0,0,100.0,NoArch
d338d8a0d63af8b8c0ac153f0346ea5c2f24f4e1,1,4,0,4,0,0,0,3,35,17,1,1,0.0,1109,767,32,174,173,1,7218,7203,15,40,40,0,1,100.0,NoArch
c866f88d232deeeae3756ae08c69db190212729a,1,142,43,99,0,0,0,3,18,1299,1,1,0.0,347,959,13,112,86,26,2631,2017,614,56,30,26,0,100.0,NoArch
be0311bea07610f017ba7ea9653aca4f3fb1bc0f,1,54,0,54,0,0,0,2,2,740,1,1,0.0,284,149,3,26,21,5,1705,1394,311,12,9,3,0,99.98194511,NoArch
f6041bb83946e1b418046d72216914bc3f73cb9e,0,0,0,0,0,0,0,0,0,0,0,0,0.0,0,482,21,0,0,0,0,0,0,0,0,0,1,100.0,NoArch
55ae21c3811bdeb5bd53c51af75ff8226d63a886,1,1,1,0,0,0,0,1,3,38,1,1,0.0,147,663,6,13,13,0,843,841,2,8,8,0,0,100.0,NoArch
d49ff795fad70048b44656305cf47a93e48bfc8a,0,0,0,0,0,0,0,0,0,0,0,0,0.0,0,68,3,0,0,0,0,0,0,0,0,0,0,100.0,NoArch
d7e65a3c1962cf29292c38f9e43b6c6b0399e17d,1,11,2,9,0,0,0,6,69,607,1,1,0.0,1374,185,33,221,219,2,8639,8581,58,50,50,0,1,100.0,NoArch
238761262881afcf034a9f649625908cbad8b42b,2,27,22,5,0,0,0,3,61,76,1,1,0.963335546,2060,20,13,194,194,0,5390,5390,0,109,110,1,1,99.81609598,NoArch
401895a521656e9ed8bf2a6ce3c79f0d37c63204,0,0,0,0,0,0,0,0,0,0,0,0,0.0,0,524,14,0,0,0,0,0,0,0,0,0,1,100.0,NoArch
a7f916446484bc03a8c95c30b4453436a1be3696,1,3,1,2,0,0,0,2,9,173,1,1,0.0,156,472,12,16,15,1,682,674,8,6,6,0,1,100.0,NoArch
306041d47c167baf121e82382d0e7b5a86ee7f64,0,0,0,0,0,0,0,0,0,0,0,0,0.0,0,26,0,0,0,0,0,0,0,0,0,0,0,100.0,NoArch
5cf33b52c158e5d9f1f7b9a07abacf99f98efee9,4,38,64,26,0,0,0,3,40,114,1,3,1.297434666,1136,853,12,206,206,0,5768,5874,106,73,74,1,1,99.99413834,NoArch
ba2d0c6fa69790481619df1b5d761b40fa48d098,1,4,5,1,0,0,0,1,4,0,1,1,0.0,2081,1290,14,195,195,0,5850,5859,9,104,104,0,0,100.0,NoArch
31d327726aceea1ed0b7b90609ddf5aa799befce,6,80,46,34,0,0,0,1,8,46,1,2,2.178023235,1106,339,44,170,171,1,5850,5929,79,86,82,4,0,100.0,NoArch
80fd502dcd9e9b8bb1b5462b6894e9b7e4878352,1,11,16,5,0,0,0,2,9,17,1,1,0.0,119,344,14,8,8,0,509,517,8,5,5,0,1,100.0,NoArch
870401217a35f3eba495eac167ab0199ab41cec7,3,159,52,107,0,0,0,3,8,50,1,1,1.564413234,621,17,0,122,102,20,3166,2676,490,83,72,11,1,99.98814885,NoArch
d57343cdb55b6f3b951e43ffe768305477a32344,1,3,2,1,0,0,0,4,28,5,1,1,0.0,1153,708,26,199,199,0,6274,6269,5,78,78,0,1,100.0,NoArch
1623820bf1ae10e56f147a9dd039f01249412116,1,0,1,1,0,0,0,3,15,98,1,1,0.0,198,411,17,40,40,0,811,817,6,17,17,0,0,100.0,NoArch
d21b32e7487aaac374dd065eed633d914ce8086b,1,1,0,1,0,0,0,5,9,6,1,1,0.0,2851,536,18,504,504,0,12622,12615,7,243,243,0,0,100.0,NoArch
8f8aa0f5e25070fe27b3aa583c60530286211c25,1,7,12,5,0,0,0,2,4,0,1,1,0.0,256,13,13,38,38,0,963,989,26,13,13,0,1,100.0,NoArch
53bf323e7447bc817372b4117bcf0152f0fb4e0a,1,26,5,21,0,0,0,4,30,1,1,1,0.0,1815,686,9,149,148,1,4290,4261,29,91,90,1,0,100.0,NoArch
d1aeb04fc6950cf9041e420a2142b69e26e84138,2,155,3,152,1,0,1,3,4,638,2,2,0.31526534,100,751,2,25,12,13,1154,400,754,14,6,8,1,99.98835585,NoArch
69e5439718e655ba4171e14f9cda94e7beb5d2d1,0,0,0,0,0,0,0,0,0,0,0,0,0.0,0,719,33,0,0,0,0,0,0,0,0,0,0,100.0,NoArch
06dae40d94618d4fedcc6fd262eeb1b3a57ccda2,0,0,0,0,0,0,0,0,0,0,0,0,0.0,0,929,3,0,0,0,0,0,0,0,0,0,1,100.0,NoArch
8938d14d434447193b02ba635606aa0fb7a80353,0,0,0,0,0,0,0,0,0,0,0,0,0.0,0,16,6,0,0,0,0,0,0,0,0,0,0,100.0,NoArch
3cd8da80a687676167681f8e424e9648db79eb66,1,53,67,14,0,0,0,6,14,12,1,1,0.0,2854,566,26,505,505,0,12517,12578,61,243,243,0,1,100.0,NoArch
9a6074387637d18154dffb3017f7bf396aa7b237,1,75,0,75,0,0,0,4,24,33,1,1,0.0,695,110,20,51,47,4,4646,4248,398,34,33,1,1,100.0,NoArch
f3d84aeb1ad5140952441a0d345d21686982e240,1,15,14,1,0,0,0,3,3,1487,1,1,0.0,180,354,14,16,16,0,1047,1038,9,7,7,0,0,99.99412801,NoArch
6b7055afc8e544c673ebdb9f819f4b8ca5105bf0,1,1,2,1,0,0,0,3,26,113,1,1,0.0,286,475,4,50,50,0,1125,1147,22,27,27,0,0,100.0,NoArch
e423bc58a03f3f02212f1696f96b8fb3e5929468,1,13,1,12,0,0,0,2,12,56,1,1,0.0,133,507,22,22,19,3,661,598,63,10,8,2,1,100.0,NoArch
e2e71eb3ca95d25549b1ae6b86f6bd95b2a7e4c6,1,552,803,251,0,0,0,3,3,185,1,1,0.0,985,353,13,75,75,0,3261,3266,5,33,33,0,0,100.0,NoArch
6bec2aabb5f85450fc2ae9ff2d350af138434759,1,2,3,1,0,0,0,2,2,1046,1,1,0.0,202,986,9,12,12,0,1180,1180,0,7,7,0,0,100.0,NoArch
3a59e68649ae5e36012eae1c7be2714e7fb6b656,1,2,0,2,0,0,0,3,5,2,1,1,0.0,222,19,0,34,34,0,1140,1114,26,8,8,0,0,100.0,NoArch
456005bf1312eb40e747572b5b371c48a1c74aba,1,6,5,1,0,0,0,3,11,1087,1,1,0.0,121,255,20,18,18,0,314,312,2,6,6,0,0,100.0,NoArch
127a36a02bc3cb5c8d2d5bb9a7cc92f47b644641,2,41,0,41,0,0,0,1,2,0,1,2,0.901170196,211,100,10,42,36,6,1178,944,234,29,23,6,0,100.0,NoArch
fccb3cc2b075eff4b540f26adaf4f86c28579846,1,16,1,15,0,0,0,1,2,87,1,1,0.0,222,797,20,32,30,2,997,921,76,14,12,2,1,100.0,NoArch
1623820bf1ae10e56f147a9dd039f01249412116,1,0,1,1,0,0,0,3,15,98,1,1,0.0,198,411,17,40,40,0,811,817,6,17,17,0,0,100.0,NoArch
14e636b74811136d7ded0cae16d74ed19058456a,2,147,7,140,1,0,1,1,117,5,1,2,0.66974162,1317,391,10,319,300,19,6923,6244,679,95,86,9,1,99.98795616,NoArch
419ed2ee91432459d58ece793b3287a97c98db8b,1,23,20,3,0,0,0,6,42,0,1,1,0.0,941,658,1,147,146,1,3704,3773,69,45,45,0,1,100.0,NoArch
119f3e959f0329b8912af5afcf68930af107444c,1,3,4,1,0,0,0,3,3,1218,1,1,0.0,64,169,17,8,8,0,136,136,0,8,8,0,0,100.0,NoArch
3c1b477523365dac6eca3b284f46df80d05b23de,2,33,2,31,0,0,0,7,26,6,2,2,0.863120569,534,338,10,60,58,2,2847,2616,231,22,21,1,1,100.0,NoArch
33bb129bee18e374d6cfd97a19432146e7072117,1,65,0,65,1,0,1,1,1,0,1,1,0.0,0,709,7,2,0,2,256,0,256,2,0,2,0,99.98841788,NoArch
d4d3915d9161e483aff6b59b6a1d0d93617b02a6,1,18,11,7,0,0,0,5,49,10,1,1,0.0,530,718,15,91,89,2,3667,3621,46,34,33,1,0,100.0,NoArch
8db5d9599d55b89b22f145c41150a094c457dd64,0,0,0,0,0,0,0,0,0,0,0,0,0.0,0,783,30,0,0,0,0,0,0,0,0,0,0,100.0,NoArch
537e598a841fb89ddb06cea50749473a09ac511a,1,7,11,4,0,0,0,2,11,1,1,1,0.0,95,1277,7,4,5,1,573,579,6,2,2,0,0,100.0,NoArch
62890b3fbb6a84297c349ce2e683bfb030500139,2,11,4,7,0,0,0,2,29,36,1,2,0.721928095,584,871,12,97,97,0,2541,2452,89,60,60,0,0,100.0,NoArch
d56ebd842dbf3d192ab7dd0d58685d02c916d3ed,1,10,13,3,0,0,0,5,60,2,1,1,0.0,1067,802,9,171,170,1,5239,5247,8,60,60,0,1,100.0,NoArch
1963ea400641edeed6c73783afecac4552b2dcab,3,333,0,333,3,0,3,1,1,0,1,1,0.495331033,0,53,0,34,0,34,1620,0,1620,11,0,11,0,99.92062592,NoArch
dba11a1579ab1f3c2453372de673f6d1884c3851,0,0,0,0,0,0,0,0,0,0,0,0,0.0,0,25,14,0,0,0,0,0,0,0,0,0,0,100.0,NoArch
0729dd88d650bd87e89ff08318770de8f61c1665,0,0,0,0,0,0,0,0,0,0,0,0,0.0,0,1263,44,0,0,0,0,0,0,0,0,0,0,100.0,NoArch
8029b8d5572c48c81fa7ae1efc31434aad9bbcd5,1,133,11,122,0,0,0,1,3,9,1,1,0.0,192,606,14,49,27,22,1712,847,865,42,22,20,0,99.94509718,NoArch
72bf2f85cc084e771bc3b120754518e614258bea,1,3,2,1,0,0,0,2,11,9,1,1,0.0,262,630,15,29,29,0,1917,1911,6,7,7,0,0,100.0,NoArch
4298a41af826537880fa3c46824945baa5c09c8c,1,1,1,0,0,0,0,3,17,125,1,1,0.0,426,715,15,25,25,0,2562,2556,6,11,11,0,0,100.0,NoArch
d7e65a3c1962cf29292c38f9e43b6c6b0399e17d,1,11,2,9,0,0,0,6,69,607,1,1,0.0,1374,185,33,221,219,2,8639,8581,58,50,50,0,1,100.0,NoArch
987769a62b0ad48118e1bb0ed0da277d37ba41c2,3,109,10,99,1,0,1,9,33,293,2,2,0.871064931,514,161,24,69,60,9,2834,2408,426,25,18,7,1,99.97112497,NoArch
78c002f5686b5ab724f0943b199b4f9ebc45ea66,4,14,24,10,0,0,0,3,51,34,1,4,0.943188418,2048,13,6,335,336,1,10511,10547,36,160,161,1,1,100.0,NoArch
3967b81cc7f506efee255288fdd4e2cc17078e31,0,0,0,0,0,0,0,0,0,0,0,0,0.0,0,33,7,0,0,0,0,0,0,0,0,0,0,100.0,NoArch
7f346a8b7978c535e9b1d96d9913f2ac4a655f1c,2,14,6,8,0,0,0,1,2,17,2,2,0.468995594,569,492,32,46,45,1,2499,2476,23,13,13,0,1,100.0,NoArch
aeffe6eeccda21a03c09e2f15ac4bf13016e4fd9,1,1,0,1,0,0,0,2,6,2,1,1,0.0,86,837,5,3,3,0,531,531,0,2,2,0,0,100.0,NoArch
393a861e89e08d767d40cd7740f274fa85020167,1,16,2,14,0,0,0,2,22,41,1,1,0.0,300,514,26,61,57,4,1404,1321,83,24,24,0,1,100.0,NoArch
d7a14830c756f1f2e387b7247901db0725ac5f28,1,2,4,2,0,0,0,2,6,670,1,1,0.0,156,367,51,9,9,0,721,726,5,8,8,0,0,100.0,NoArch
91bcbda6e06a7d88ed21a701f145c74d7127cb05,2,59,5,54,0,0,0,3,24,70,1,2,0.661976064,765,7,0,104,102,2,4238,3834,404,55,54,1,1,99.9744898,NoArch
0f9a34799630911b0d7906e166291ff5af0d852c,4,145,27,118,1,0,1,1,8,345,1,3,1.832313178,277,26,2,31,25,6,1991,1272,719,22,19,3,1,99.98961686,NoArch
a80a1857d0ca86b3253f92c05134c31e8bb1e913,3,17,1,16,0,0,0,5,26,51,1,1,1.251629167,1870,22,12,331,327,4,10156,10099,57,101,98,3,1,100.0,NoArch
38f24afbd569b7747c01a5bd415cc276d8069885,0,0,0,0,0,0,0,0,0,0,0,0,0.0,0,125,3,0,0,0,0,0,0,0,0,0,1,100.0,NoArch
feef358a16f25918823623e0c253c8686d399dee,0,0,0,0,0,0,0,0,0,0,0,0,0.0,0,674,13,0,0,0,0,0,0,0,0,0,0,100.0,NoArch
791d78bc64def507b84ec4f0b12512182c53ee1d,1,11,1,10,0,0,0,2,6,540,1,1,0.0,79,424,28,6,5,1,168,147,21,6,5,1,0,100.0,NoArch
41424a41b9f3597e012e4ee2fe97f3755d8960b0,0,0,0,0,0,0,0,0,0,0,0,0,0.0,0,597,12,0,0,0,0,0,0,0,0,0,0,100.0,NoArch
914e177239f012a3794caaf6ee15f4b9764bfce8,1,3,3,0,0,0,0,2,20,0,1,1,0.0,1161,1267,39,147,147,0,5833,5832,1,37,37,0,0,100.0,NoArch
41c2a9c4698e98667d86b5ccb43d76b7b492d2d3,1,109,0,109,1,0,1,1,1,0,1,1,0.0,0,416,9,5,0,5,574,0,574,2,0,2,0,99.98298452,NoArch
62609f099a3df38aa499bc78598e03a95d3df8bd,1,4,3,1,0,0,0,4,68,56,1,1,0.0,2364,653,10,376,376,0,13717,13705,12,160,160,0,1,100.0,NoArch
4751a9c38cb13599110104f481301a2f07a62b1c,1,33,10,23,0,0,0,2,4,112,1,1,0.0,2333,634,32,126,126,0,15137,14947,190,91,91,0,1,100.0,NoArch
fee7f6a7101711e94328467bff2c9612844b7c87,4,42,18,24,0,0,0,7,40,407,1,4,0.927352815,1856,109,4,120,118,2,11218,11133,85,82,82,0,1,100.0,NoArch
d2610faff4f76f979808b53eb2a2861085508ad1,2,14,15,1,0,0,0,2,8,10,1,2,0.999142104,1010,293,12,127,126,1,6328,6330,2,65,65,0,1,100.0,NoArch
edd8166cb1a4f8fb90b0efdc97358c348fbecbf2,2,80,68,12,0,0,0,7,10,38,1,1,0.980947013,424,926,2,67,63,4,1920,1844,76,34,34,0,1,100.0,NoArch
503d3c3fd132dbd09357c8aa847cf803025df082,0,0,0,0,0,0,0,0,0,0,0,0,0.0,0,871,10,0,0,0,0,0,0,0,0,0,1,100.0,NoArch
3a26442d9268ba526032de64ad36c790c4c0ac40,1,1,1,0,0,0,0,2,4,882,1,1,0.0,210,877,18,20,20,0,1168,1168,0,12,12,0,0,100.0,NoArch
2751497e386f0ca406131c623995fa6293be4218,0,0,0,0,0,0,0,0,0,0,0,0,0.0,0,1270,33,0,0,0,0,0,0,0,0,0,1,100.0,NoArch
70b02fde333959b4c7ad91e15ddbca144061e2d2,2,46,3,43,0,0,0,2,17,1453,2,2,0.246022578,1545,160,8,335,332,3,7447,7233,214,97,96,1,1,100.0,NoArch
fcb5d9ed5f7aaf049d32311161038b1db435d972,10,1962,0,1962,10,0,10,1,1,0,1,1,2.889738995,0,525,39,390,0,390,10639,0,10639,97,0,97,0,99.7312813,NoArch
9c92f186a5f7a12a28e75160c5758431e5f7f045,0,0,0,0,0,0,0,0,0,0,0,0,0.0,0,582,20,0,0,0,0,0,0,0,0,0,0,100.0,NoArch
2d5a0990746f11c052746b5e3fbb50186877e20a,0,0,0,0,0,0,0,0,0,0,0,0,0.0,0,834,8,0,0,0,0,0,0,0,0,0,0,100.0,NoArch
08bd791c5dce3711e36b3485d507578d2acc3a45,1,5,3,2,0,0,0,2,2,198,1,1,0.0,69,54,8,3,3,0,321,309,12,3,3,0,0,100.0,NoArch
970a97ac5fd2f489b0f6ba743612406d66f53f2a,1,23,22,1,0,0,0,3,5,138,1,1,0.0,157,182,19,10,10,0,874,863,11,6,6,0,0,100.0,NoArch
0ee0cb9a2206758c8878b9a947e0e30b79cf0c65,2,244,2,242,1,0,1,1,123,40,1,2,0.486780482,718,1139,8,146,123,23,4806,3765,1041,40,34,6,1,99.97670491,NoArch
6ed942a3eec957658074741ed6ab74cb62d9a795,1,4,4,0,0,0,0,6,95,51,1,1,0.0,1133,618,5,232,232,0,5407,5401,6,74,74,0,1,100.0,NoArch
1fd01f0888072b0da9e8d9761385145a0f97a8ec,0,0,0,0,0,0,0,0,0,0,0,0,0.0,0,490,29,0,0,0,0,0,0,0,0,0,0,100.0,NoArch
a55aae00e73aad844bbacd2afdd03c1459179882,0,0,0,0,0,0,0,0,0,0,0,0,0.0,0,615,21,0,0,0,0,0,0,0,0,0,0,100.0,NoArch
1408e7f63bb08add9ad2dde64e4bb629de9019ee,3,115,16,99,0,0,0,5,14,1055,2,3,1.002204569,2882,1164,0,263,255,8,10100,9630,470,130,129,1,1,100.0,NoArch
8245f68d7963266723fc6b596c12af6876832e7b,0,0,0,0,0,0,0,0,0,0,0,0,0.0,0,67,0,0,0,0,0,0,0,0,0,0,0,100.0,NoArch
739a13dc2b471bcf523bb889d8cbdbe75b05d613,1,9,7,2,0,0,0,2,6,1217,1,1,0.0,251,313,14,23,23,0,1579,1579,0,12,12,0,0,100.0,NoArch
5b1c26c4ded06df1879d26a260780100b23217c9,0,0,0,0,0,0,0,0,0,0,0,0,0.0,0,484,17,0,0,0,0,0,0,0,0,0,0,100.0,NoArch
9e6eb830b35b12fe6c2b15db8ec951d43a006124,0,0,0,0,0,0,0,0,0,0,0,0,0.0,0,703,17,0,0,0,0,0,0,0,0,0,0,100.0,NoArch
f76e23ce2f2da73496f2a6f4f654ac0e768bb8ab,0,0,0,0,0,0,0,0,0,0,0,0,0.0,0,553,46,0,0,0,0,0,0,0,0,0,0,100.0,NoArch
8f43810679ad9a1d3ab4a28397ad0229fc8ffe31,0,0,0,0,0,0,0,0,0,0,0,0,0.0,0,165,13,0,0,0,0,0,0,0,0,0,1,100.0,NoArch
fa5a18b28089ee00a5444d08eae2cacfe9dc5c45,0,0,0,0,0,0,0,0,0,0,0,0,0.0,0,295,3,0,0,0,0,0,0,0,0,0,1,100.0,NoArch
cb32fd2aa440da740ba5b062e12209ef15111b9a,2,2,1,1,0,0,0,2,5,828,1,1,0.918295834,414,408,14,63,63,0,1757,1748,9,35,35,0,1,100.0,NoArch
fd46439e7e7aeeb4bde35fb942cb7882edfab548,1,15,5,10,0,0,0,1,2,11,1,1,0.0,102,872,10,13,11,2,534,454,80,6,5,1,1,100.0,NoArch
e6bfc94fe2826e75898747c655cc52b0bfd02cfb,1,14,3,11,0,0,0,4,8,6,1,1,0.0,155,1259,40,18,17,1,940,858,82,9,8,1,0,100.0,NoArch
35707b3c565716541dcd0b1b41c3f3a515a03cfb,1,1,1,0,0,0,0,2,5,243,1,1,0.0,63,28,0,4,4,0,282,282,0,3,3,0,1,100.0,NoArch
44488a5bc3d872d39e847776cd955b7f374189b8,4,237,4,233,1,0,1,1,130,157,1,3,0.287136314,4108,870,13,600,573,27,16596,15180,1416,340,330,10,1,99.97685319,NoArch
fc519e186a4d30265e74f24e8a31669e8fc8e32d,10,182,5,177,0,0,0,2,5,124,5,7,3.218929837,570,1114,27,57,57,0,3174,3008,166,43,43,0,0,100.0,NoArch
c441e3a66caede2236ce5936d329dd7772e470e4,1,7,11,4,0,0,0,2,12,172,1,1,0.0,91,1309,6,3,4,1,567,573,6,2,2,0,0,100.0,NoArch
40465998ee66c025e726f5ce7ac8ecc3fac480ed,5,39,25,14,0,0,0,2,76,30,2,3,1.760043758,4207,96,7,522,527,5,15229,15129,100,206,210,4,0,100.0,NoArch
8302262e2e932d4b698faf9477b80e754a771f3a,0,0,0,0,0,0,0,0,0,0,0,0,0.0,0,790,3,0,0,0,0,0,0,0,0,0,1,100.0,NoArch
c46003fd3b48d6644c46495a63b77c7b4d62a30b,3,103,98,5,0,0,0,2,12,176,1,1,1.168448181,612,303,13,110,102,8,2642,2571,71,57,56,1,0,100.0,NoArch
365960e40c0615ae6d033a11362988e28da3021c,0,0,0,0,0,0,0,0,0,0,0,0,0.0,0,552,45,0,0,0,0,0,0,0,0,0,0,100.0,NoArch
734f697b0e4d40545f633baf0b18922fd81ded61,0,0,0,0,0,0,0,0,0,0,0,0,0.0,0,15,5,0,0,0,0,0,0,0,0,0,0,100.0,NoArch
6c82480a108a0776632d44b5fa9a1d2e1d8a8501,1,100,0,100,1,0,1,1,1,0,1,1,0.0,0,183,19,7,0,7,494,0,494,3,0,3,1,99.98812634,NoArch
e5b45f6b4b60e72841166200245899b1a588691d,2,12,6,6,0,0,0,5,55,10,1,1,0.764204507,2682,47,3,316,314,2,8882,8848,34,196,196,0,1,100.0,NoArch
934eaf992311793f35fc0e442ffda810d724fff8,1,1,1,0,0,0,0,3,7,706,1,1,0.0,223,299,7,21,21,0,936,928,8,12,12,0,0,100.0,NoArch
37423d661c440fa5fe3420e9b0c0bf8c5d5d67ae,3,158,131,27,0,0,0,1,29,194,2,2,0.297728922,1485,1307,4,263,256,7,8684,8507,177,79,76,3,0,100.0,NoArch
ba519d8bd3e1f17d5885a48da0b58999eebd2e12,1,1,1,0,0,0,0,6,66,8,1,1,0.0,1356,146,7,217,217,0,8516,8518,2,50,50,0,1,100.0,NoArch
45116abe3a930dc9f2f599a653d21227b836b1ec,0,0,0,0,0,0,0,0,0,0,0,0,0.0,0,9,2,0,0,0,0,0,0,0,0,0,0,100.0,NoArch
76efc33cdbfb58f74ca05561341dc48dc633f74b,2,12,4,8,0,0,0,1,3,146,1,1,0.337290067,237,662,17,30,30,0,1282,1249,33,13,13,0,1,100.0,NoArch
24b42fcd8236f0fc62f69d3a34ee9eb86287b620,0,0,0,0,0,0,0,0,0,0,0,0,0.0,0,431,11,0,0,0,0,0,0,0,0,0,1,100.0,NoArch
aa5a625a61dde0c0bd705047a7a19274a8581f35,0,0,0,0,0,0,0,0,0,0,0,0,0.0,0,422,5,0,0,0,0,0,0,0,0,0,0,100.0,NoArch
fc4f01cf5d1a7714f60b70dba6dcd0ae8c26cb46,1,1,1,0,0,0,0,7,144,3,1,1,0.0,811,954,9,151,151,0,3902,3903,1,38,38,0,1,100.0,NoArch
6086520836c0e19ec362096ec08d497daba4cf62,4,92,11,81,1,0,1,1,3,6,1,2,1.199158555,173,108,13,30,21,9,950,506,444,23,21,2,0,99.91918725,NoArch
0e87c01f226e09ba3b404faf95bc97250c3316cd,1,1,1,0,0,0,0,2,7,61,1,1,0.0,161,808,15,19,19,0,711,711,0,13,13,0,0,100.0,NoArch
883eed0e385e9695a3746f1dede0a15c9fc24427,4,180,156,24,0,0,0,3,19,118,1,1,1.725308671,1649,52,6,113,111,2,9254,9025,229,54,52,2,0,100.0,NoArch
9797077d6a7780f464878e6709391677deca4d9a,1,26,0,26,0,0,0,5,14,1126,1,1,0.0,370,938,2,57,56,1,2090,1851,239,12,12,0,1,100.0,NoArch
e2bd38c7a2e3b78b2ff0c770864ce04e2a6d5ff1,9,0,17,17,0,0,0,1,4,0,2,3,0.0,1364,600,8,140,140,0,6333,6538,205,89,89,0,1,99.01308494,NoArch
5c405cbfd8a9dce299c66a46ffbca1b00ba51f66,0,0,0,0,0,0,0,0,0,0,0,0,0.0,0,270,18,0,0,0,0,0,0,0,0,0,1,100.0,NoArch
d458a7943c5052a876319697242370b0b24936ed,1,3,1,2,0,0,0,2,2,542,1,1,0.0,105,0,0,13,12,1,441,420,21,5,5,0,0,100.0,NoArch
38e5c0829a3c8051841be416ec432dadae0dcf4a,1,0,1,1,0,0,0,10,144,41,1,1,0.0,2610,784,2,353,353,0,9314,9323,9,189,189,0,1,100.0,NoArch
8c5aadf6a064f67e3e3de1540822d65225691930,0,0,0,0,0,0,0,0,0,0,0,0,0.0,0,642,15,0,0,0,0,0,0,0,0,0,0,100.0,NoArch
bc281a209e81be06e9bebe6c34bd0bbf0e9938f6,1,5,3,2,0,0,0,2,3,2,1,1,0.0,103,416,22,12,10,2,386,374,12,4,4,0,0,100.0,NoArch
b743552137969cc827e73221be0ab17a8112c47e,6,68,8,60,0,0,0,4,47,2,1,3,2.014493034,3602,49,5,608,592,16,17285,16981,304,274,271,3,2,100.0,NoArch
bb4a2f73f4db9316593ca4e0e23d69b776513bad,10,546,54,492,2,0,2,4,98,279,2,4,1.869855282,6121,890,7,1026,951,75,32896,30430,2466,462,435,27,0,99.89019245,NoArch
040cbc02481d70aac66749e487731def27d5b562,0,0,0,0,0,0,0,0,0,0,0,0,0.0,0,178,22,0,0,0,0,0,0,0,0,0,0,100.0,NoArch
5207f02e6a2f96113183dc2da58a819d8ff0ac3e,1,9,6,3,0,0,0,4,16,0,1,1,0.0,164,465,19,17,17,0,914,908,6,7,7,0,0,100.0,NoArch
7dde85b821034c804dd287e9f61f7249ab6bac81,2,8,1,7,0,0,0,3,15,178,1,1,0.764204507,791,36,6,142,141,1,2606,2569,37,107,106,1,1,100.0,NoArch
67887b419970df6fccdf3633bf77a14613aa8542,0,0,0,0,0,0,0,0,0,0,0,0,0.0,0,437,17,0,0,0,0,0,0,0,0,0,0,100.0,NoArch
2193ef144ba4559ced7015e4ecb777ae68c92a48,3,200,10,190,1,0,1,1,2,1540,2,2,0.632007819,571,180,28,143,123,20,4076,3282,794,43,30,13,1,99.98967902,NoArch
c9e75006df5e669e122424a0e40c5f3af85be9ec,2,14,3,11,0,0,0,1,2,0,1,1,0.873981048,238,736,43,45,45,0,835,733,102,32,32,0,0,100.0,NoArch
c6b98adac458a263dc8a714944cc2dfe25d637d2,0,0,0,0,0,0,0,0,0,0,0,0,0.0,0,495,34,0,0,0,0,0,0,0,0,0,0,100.0,NoArch
f8f24e830772375fd7b9c8bbdcbdb7ce966a6c9c,10,252,31,221,1,0,1,2,48,412,2,4,2.176447071,1771,452,15,277,257,20,10300,9277,1023,124,108,16,2,98.37579618,NoArch
5d4d7487e4100db4ad4b9af1fe2cb61a5c05cb3b,1,26,2,24,0,0,0,2,3,0,1,1,0.0,255,600,43,44,39,5,1696,1558,138,39,34,5,0,100.0,NoArch
e7137b7eaeb94fc2356e59957b0c5a7dfd4580dd,3,25,25,0,0,0,0,1,3,0,1,3,0.639556365,851,1206,5,80,77,3,3353,3272,81,26,26,0,0,100.0,NoArch
c5344c9179e9cf91d6d3e0454410fb36a1e63a65,0,0,0,0,0,0,0,0,0,0,0,0,0.0,0,1388,11,0,0,0,0,0,0,0,0,0,0,100.0,NoArch
4648dbee41a84420418d68526d30051d2e461d22,1,22,42,20,0,0,0,3,5,93,1,1,0.0,310,236,14,14,16,2,1174,1207,33,8,9,1,0,100.0,NoArch
69f56058f258b1036972dfdf51bfa5c48d0d826e,4,202,19,183,1,0,1,3,111,28,2,3,1.419955572,1672,694,14,299,275,24,9979,8924,1055,120,108,12,1,99.93182945,NoArch
582f3401fa82a2907f555a33da1462c134eb3c02,1,1,1,0,0,0,0,2,26,230,1,1,0.0,764,868,16,104,104,0,4330,4330,0,34,34,0,0,100.0,NoArch
bd8d07d948d38f9954555137d0beba8bb144518b,1,0,85,85,0,1,1,1,8,9,1,1,0.0,85,526,39,0,3,3,0,399,399,0,1,1,0,99.97271487,NoArch
98803a594920ae0d94ea70f3f2cf756b787e7317,0,0,0,0,0,0,0,0,0,0,0,0,0.0,0,184,36,0,0,0,0,0,0,0,0,0,1,100.0,NoArch
65e40d03dab60518072515670a87b4d2471badaf,2,7,1,6,0,0,0,1,7,328,1,2,0.811278124,299,485,23,36,35,1,1423,1394,29,26,26,0,1,100.0,NoArch
fc68c3a6e5e3cefaa220d9e1be4004f8726a0ab3,0,0,0,0,0,0,0,0,0,0,0,0,0.0,0,21,1,0,0,0,0,0,0,0,0,0,0,100.0,NoArch
f76e23ce2f2da73496f2a6f4f654ac0e768bb8ab,0,0,0,0,0,0,0,0,0,0,0,0,0.0,0,553,46,0,0,0,0,0,0,0,0,0,0,100.0,NoArch
7167041ee66b3bfb2c052f6717277e85ebae92dc,2,51,33,18,0,0,0,3,7,1048,1,1,0.771311106,681,30,0,77,75,2,1967,1919,48,64,63,1,1,100.0,NoArch
16c1627ca0324b255b1dcd28105984d1f7faeabb,4,32,2,30,0,0,0,6,10,482,1,2,1.851226816,1884,0,0,322,316,6,8674,8549,125,196,193,3,1,100.0,NoArch
4c1a6b4c2b933809ab0cbc4876d6fa3b368f9e1f,0,0,0,0,0,0,0,0,0,0,0,0,0.0,0,28,0,0,0,0,0,0,0,0,0,0,0,100.0,NoArch
a49e75ada09cdfb5def1890113201be2752ff962,0,0,0,0,0,0,0,0,0,0,0,0,0.0,0,444,8,0,0,0,0,0,0,0,0,0,0,100.0,NoArch
4bd8a8bf852507b1d5d03eba0c20aa28a7e69f8b,2,80,1,79,1,0,1,1,48,0,1,2,0.635489638,1267,528,41,207,198,9,5705,5397,308,113,105,8,1,99.97271487,NoArch
f5b69f8783be5d1bebd0336a78b6af3fae9e9583,0,0,0,0,0,0,0,0,0,0,0,0,0.0,0,934,11,0,0,0,0,0,0,0,0,0,1,100.0,NoArch
24984276fc172447d1f5e924f9801db063fd6917,0,0,0,0,0,0,0,0,0,0,0,0,0.0,0,729,45,0,0,0,0,0,0,0,0,0,0,100.0,NoArch
3f8cb551224d9759569d2d2954e2c49dee5146e9,0,0,0,0,0,0,0,0,0,0,0,0,0.0,0,10,3,0,0,0,0,0,0,0,0,0,0,100.0,NoArch
61fcd4cfd1a843d7ff5fd23d60351d7fd1c46c2b,4,118,12,106,0,0,0,1,3,0,1,1,1.328148737,518,83,12,89,72,17,2888,2265,623,57,49,8,0,100.0,NoArch
9989f3a183e37a762dc0e742801c908c254faedf,0,0,0,0,0,0,0,0,0,0,0,0,0.0,0,10,0,0,0,0,0,0,0,0,0,0,1,100.0,NoArch
c9c1f587ad19f1c38a0c46cd5f5ef4d199ba5f41,2,2,2,0,0,0,0,2,2,2172,1,1,1.0,341,242,17,26,26,0,1914,1912,2,18,18,0,0,100.0,NoArch
67fd739b3a846b411f0e296cb80d7ee81b4a83a5,6,0,356,356,0,6,6,3,7,115,1,1,2.575256544,356,372,56,0,22,22,0,1173,1173,0,22,22,0,99.87176958,NoArch
ada47fbc50e8a324538517ba262490499cd05530,3,32,18,14,0,0,0,3,60,114,1,3,0.639556365,1723,872,13,284,280,4,8381,8335,46,119,119,0,0,100.0,NoArch
1e3f4f192b6240271112e2d8dc46413925b46364,1,26,22,4,0,0,0,2,2,2057,1,1,0.0,76,153,1,3,3,0,346,316,30,1,1,0,0,100.0,NoArch
1eaa3b91686c72eb5ce0fb7c5bc11789237971fa,0,0,0,0,0,0,0,0,0,0,0,0,0.0,0,695,9,0,0,0,0,0,0,0,0,0,0,100.0,NoArch
2bbc65ba9addca0327c886e62247c9a0c4aa91d4,0,0,0,0,0,0,0,0,0,0,0,0,0.0,0,81,55,0,0,0,0,0,0,0,0,0,1,100.0,NoArch
68c8c643f269ea113259b60c735a5b195f89fdec,5,97,112,15,0,0,0,2,18,136,1,2,1.568784335,853,560,69,110,111,1,3231,3191,40,68,69,1,0,100.0,NoArch
85df0e62d7208435531fd117c9b5b07a2377054e,1,1,2,1,0,0,0,5,23,0,1,1,0.0,686,1,1,32,32,0,2910,2915,5,23,23,0,0,100.0,NoArch
5a58837f8e629c3cc190fb76c34b9659309260f3,1,1,4,3,0,0,0,2,3,209,1,1,0.0,60,641,14,1,1,0,159,180,21,1,1,0,0,100.0,NoArch
5a0fd5d08671e1ab4886f27fc404b387a375a32b,1,4,1,3,0,0,0,3,5,32,1,1,0.0,201,1067,9,19,19,0,1070,1061,9,12,12,0,0,100.0,NoArch
27cbf7b691e8028e9f0927c1f68b754e342976c2,1,22,1,21,0,0,0,4,29,102,1,1,0.0,702,25,4,106,103,3,3700,3616,84,46,45,1,1,100.0,NoArch
abfe038ddfd6d6c4f7c41e106dabc815041b04c5,0,0,0,0,0,0,0,0,0,0,0,0,0.0,0,90,15,0,0,0,0,0,0,0,0,0,0,100.0,NoArch
21edf2b5bb4e5a6b05429161eb5110ba33449c15,4,68,4,64,1,0,1,1,2,0,2,3,1.196187375,267,18,10,27,25,2,1118,808,310,25,23,2,1,99.96360801,NoArch
b38ec0ad034d1ac156c214462cf21d62135924b1,1,7,3,4,0,0,0,2,5,6,1,1,0.0,147,399,5,17,16,1,647,640,7,11,10,1,0,100.0,NoArch
4f0810acbf2509f142de1e12ef5ce4ea3ac8b602,1,2,1,1,0,0,0,1,2,5,1,1,0.0,145,480,26,4,4,0,568,554,14,3,3,0,1,100.0,NoArch
1b6f8e26cfce46cb5d6641720dbcf8a05e399ec9,1,1,1,0,0,0,0,3,32,279,1,1,0.0,793,1153,17,110,110,0,4637,4637,0,34,34,0,1,100.0,NoArch
39e63c0051c1e296927c0f64c69b80dad15fc028,5,171,18,153,1,0,1,1,24,641,1,5,1.324552215,1237,248,11,218,213,5,6986,6127,859,89,86,3,0,99.91580365,NoArch
2a58f4c3a2a0a27ac51b25273239008e05126607,5,61,6,55,0,0,0,5,101,683,1,2,1.990360597,3653,72,1,453,443,10,13093,12854,239,283,273,10,1,99.90969975,NoArch
349d0f219fbe1b120a17e862abea8a6749d8ee39,1,2,2,0,0,0,0,1,7,269,1,1,0.0,405,683,38,65,65,0,2022,2022,0,26,26,0,0,100.0,NoArch
1797ce98e3a4aa397e05811c207d763806c032be,3,6,6,0,0,0,0,2,6,22,1,2,1.459147917,2838,913,1,498,498,0,12112,12112,0,244,244,0,0,100.0,NoArch
081b823c2da319ad327fd1018555b09136bb404f,2,0,229,229,0,2,2,1,5,1609,1,1,0.87752217,229,890,19,0,26,26,0,1109,1109,0,11,11,1,99.9756454,NoArch
b19f17c96b3636369e394738b72638c9fa1da831,9,40,31,9,0,0,0,2,8,445,1,7,2.662260879,1857,786,9,136,136,0,8687,8611,76,80,80,0,0,100.0,NoArch
d183e3a7c155bae7f38927989e3768c4ed6fdfcd,1,2,2,0,0,0,0,2,3,18,1,1,0.0,1727,142,12,292,292,0,9409,9405,4,106,106,0,0,100.0,NoArch
9f548bb74aa9da57c0226e4eaa381f1efeff8a9e,4,25,34,9,0,0,0,1,104,8,1,2,1.784549136,5881,148,13,696,697,1,20382,20458,76,333,335,2,1,100.0,NoArch
ad585dc4b0381441f1addabc8f2b4a2673d81dfe,3,889,98,791,1,0,1,1,48,4,1,2,0.946999821,465,254,19,160,80,80,5504,1851,3653,85,44,41,1,99.98193424,NoArch
75c659f122bc60a4e21da1f3bf3eadd227c49cbe,0,0,0,0,0,0,0,0,0,0,0,0,0.0,0,171,34,0,0,0,0,0,0,0,0,0,1,100.0,NoArch
5a80d5a6c06bc980df6c59eae56577c0caab36a6,0,0,0,0,0,0,0,0,0,0,0,0,0.0,0,957,11,0,0,0,0,0,0,0,0,0,0,100.0,NoArch
a218949c58e9957722f684854e6fa17f0736e337,0,0,0,0,0,0,0,0,0,0,0,0,0.0,0,648,9,0,0,0,0,0,0,0,0,0,0,100.0,NoArch
648826b6d29a3be4b6653aa9c026e9131663154e,3,4,67,63,0,1,1,1,6,52,2,2,0.620611413,237,624,13,17,24,7,736,975,239,8,10,2,1,99.91568297,NoArch
ba05c2106c4bea4dbcc338f543bbf05c96f90f99,0,0,0,0,0,0,0,0,0,0,0,0,0.0,0,183,27,0,0,0,0,0,0,0,0,0,0,100.0,NoArch
5414e76a85ecd978a2130485065f8f6e304cdfbf,1,1,1,0,0,0,0,2,6,1934,1,1,0.0,112,166,8,12,12,0,381,380,1,11,11,0,0,100.0,NoArch
b50ede668d067e09e51e340df4b7e12c12f8c807,1,13,2,11,0,0,0,4,11,386,1,1,0.0,117,440,17,18,16,2,372,348,24,5,4,1,1,100.0,NoArch
ddb15afe058dd1560ef56e76936db5fe58365dd9,1,10,2,8,0,0,0,1,3,51,1,1,0.0,360,215,6,34,34,0,1939,1895,44,14,14,0,0,100.0,NoArch
838e9a42b418ca723e815a122497fa7fce597c3c,3,3,0,3,0,0,0,2,17,21,1,3,1.584962501,1062,832,4,164,164,0,5097,5067,30,88,88,0,0,100.0,NoArch
9d671b70aa73067d07e2c20edc2128ae7448dc0e,16,188,2,186,1,0,1,3,29,27,1,4,3.090772396,4339,565,34,644,620,24,19993,19182,811,410,392,18,1,99.93170332,NoArch
dc25f2a8f9d4e54c2349946b1337eb4b72890e07,2,60,5,55,0,0,0,1,24,2,2,2,0.444126045,1350,257,27,220,215,5,7757,7321,436,118,117,1,1,100.0,NoArch
08bb172f3c6fc39e5164b5ee8f875a809faa126b,3,205,15,190,1,0,1,1,3,964,2,2,1.18393418,187,120,1,40,21,19,1901,655,1246,20,13,7,1,99.95941764,NoArch
8ad375ff605c358b4313e5f0eef98568c8f1b941,1,13,11,2,0,0,0,2,5,189,1,1,0.0,545,364,48,86,86,0,2850,2845,5,35,35,0,0,100.0,NoArch
e01a937d29a999eea332d96038552a5cf2130e2e,1,32,0,32,0,0,0,2,3,8,1,1,0.0,162,910,4,30,24,6,915,721,194,17,14,3,0,100.0,NoArch
148455413e4c1ede80cdc92c8c445fc1bfa57457,1,11,0,11,0,0,0,1,2,50,1,1,0.0,250,296,4,25,25,0,1444,1366,78,8,8,0,0,100.0,NoArch
b675bb045c7f9f7f7370b325ab2d5953619d1d47,0,0,0,0,0,0,0,0,0,0,0,0,0.0,0,115,4,0,0,0,0,0,0,0,0,0,0,100.0,NoArch
dee9e932660d57147ada730afa31813b0d660373,1,46,55,9,0,0,0,1,2,21,1,1,0.0,273,1231,17,20,20,0,1558,1622,64,10,8,2,0,100.0,NoArch
ff64b14bc78466df96d16b1d04e862a7ddef3204,1,68,58,10,0,0,0,6,63,8,1,1,0.0,1328,47,1,215,212,3,8388,8348,40,50,49,1,1,100.0,NoArch
1f00a395f895751cc8d50eccd335b004c0f77012,4,301,48,253,1,0,1,1,17,574,2,3,1.397843586,1071,21,6,101,82,19,5250,4372,878,69,52,17,1,99.9387523,NoArch
1c0d2eb88672a318b62b7dfd7007cade0d03ba80,0,0,0,0,0,0,0,0,0,0,0,0,0.0,0,530,44,0,0,0,0,0,0,0,0,0,0,100.0,NoArch
0d9b41325673ce4b7b40fc76bec1415c98bef894,1,1,4,3,0,0,0,6,85,3,1,1,0.0,1668,358,42,266,266,0,6918,6959,41,138,138,0,0,100.0,NoArch
19cb932816a09b05d5da73da7fbc39e0dec0e522,2,37,5,32,0,0,0,1,111,9,1,2,0.918295834,1476,728,6,313,310,3,7194,7045,149,99,98,1,1,100.0,NoArch
77f9b872944543fda7c7805fad6a1140aa95f40d,1,24,0,24,0,0,0,1,2,102,1,1,0.0,88,210,8,9,8,1,550,521,29,4,3,1,0,100.0,NoArch
5094609ec519ffaa3e63e05a9ab9e668506c39bf,0,0,0,0,0,0,0,0,0,0,0,0,0.0,0,817,11,0,0,0,0,0,0,0,0,0,0,100.0,NoArch
52f48db0d919c95d7419642d2ae2c97b496b2355,3,49,5,44,1,0,1,1,15,1454,1,3,0.854491888,270,138,9,44,41,3,1217,988,229,20,17,3,1,99.94948219,NoArch
4318eba4a34ad64b1dad549ba94dadd155149b4a,2,1,3,2,0,0,0,5,22,164,1,2,0.811278124,554,405,4,97,97,0,3021,3021,0,41,41,0,1,100.0,NoArch
8be1b5eb5a5f7ddde45656a7e156e8a9ec03b8af,0,0,0,0,0,0,0,0,0,0,0,0,0.0,0,691,9,0,0,0,0,0,0,0,0,0,0,100.0,NoArch
6bb1cf9d989d03dd3b6bf9433f5b81e371056ea3,0,0,0,0,0,0,0,0,0,0,0,0,0.0,0,510,6,0,0,0,0,0,0,0,0,0,0,100.0,NoArch
81c167b205f98f4a866b8293bb494bae777457f3,3,83,54,29,0,0,0,1,2,45,1,1,1.43374317,1448,512,7,132,132,0,10274,10087,187,50,50,0,1,100.0,NoArch
886381edaa0073c2e7fa9ab91f7a41f3a24e91d3,0,0,0,0,0,0,0,0,0,0,0,0,0.0,0,660,19,0,0,0,0,0,0,0,0,0,0,100.0,NoArch
f90c62c64042a6cbf83845ff84932a7d4fdc9e54,1,1,1,0,0,0,0,3,10,432,1,1,0.0,155,809,16,12,12,0,515,513,2,11,11,0,0,100.0,NoArch
6b9662440eedabc6bd749742276570af3d9b8798,1,1,2,1,0,0,0,2,3,75,1,1,0.0,77,25,9,2,2,0,414,433,19,2,2,0,1,100.0,NoArch
331712964fbaf5d04495f03cb4f10cd47e941500,1,9,2,7,0,0,0,2,5,14,1,1,0.0,46,14,12,2,2,0,174,181,7,1,1,0,1,100.0,NoArch
cfdd68c79983eff4ed2b1a8850bb536cf08cefc9,1,509,0,509,1,0,1,1,1,0,1,1,0.0,0,670,12,48,0,48,1618,0,1618,19,0,19,1,99.98993153,NoArch
cf3d419528e5596c1226b5ca11ed37e8039bc006,16,701,72,629,2,0,2,1,81,465,4,7,3.115654941,9072,198,9,1346,1280,66,51932,48700,3232,681,643,38,1,99.74786385,NoArch
0fd46ce6212408191db456865724fac38a8037b2,2,69,1,68,0,0,0,1,4,246,1,2,0.997643296,757,454,3,112,100,12,4478,3976,502,50,49,1,1,100.0,NoArch
882c5539d1b5cdfe64b4f4c5048e7c377e331846,1,6,0,6,0,0,0,9,75,134,1,1,0.0,1921,888,8,105,105,0,12442,12381,61,81,81,0,0,100.0,NoArch
721169a21db22cacafb7c42950103b2dd787e910,1,3,3,0,0,0,0,21,93,111,1,1,0.0,3309,396,3,594,595,1,14269,14274,5,292,292,0,1,100.0,NoArch
99682093d9cd63fb1613eb6b94a7f4bfe547a10a,2,9,6,3,0,0,0,2,4,193,2,2,0.918295834,233,1077,7,31,30,1,1143,1121,22,16,16,0,1,100.0,NoArch
3e1550143941eb07865990d4d28c9eb67d91c18d,3,58,7,51,1,0,1,1,94,1,1,2,1.013628577,1360,549,14,248,244,4,8070,7914,156,67,63,4,1,99.97975196,NoArch
73433372e9bacff78406c64b644c9b1202a0a2c0,4,193,6,187,1,0,1,1,194,518,2,3,0.769037268,3222,470,11,446,431,15,18619,17762,857,155,148,7,1,99.98756992,NoArch
e7784672ac222a4cf1e27d33c3420a9f62278710,9,224,232,8,0,0,0,2,23,679,1,3,1.908257481,1136,193,22,134,133,1,5058,5169,111,76,77,1,1,100.0,NoArch
978f59e62829c4583e8798c93345446f3ffecfdf,0,0,0,0,0,0,0,0,0,0,0,0,0.0,0,578,38,0,0,0,0,0,0,0,0,0,0,100.0,NoArch
f830e07b669c914342125dd5973754ec4c822939,1,245,0,245,1,0,1,1,1,0,1,1,0.0,0,1144,8,27,0,27,1056,0,1056,13,0,13,0,99.92270697,NoArch
3be01132280a2f4c5d2436941ded3089a541358b,0,0,0,0,0,0,0,0,0,0,0,0,0.0,0,221,3,0,0,0,0,0,0,0,0,0,0,100.0,NoArch
e35519f3a116231e3e88452e2c0752609c3cf931,2,29,2,27,0,0,0,4,65,266,1,2,0.345117315,1226,633,18,181,179,2,5414,5184,230,124,123,1,1,99.81226851,NoArch
7d704bc3db375bca1f1a9a7b14735af4691bb553,0,0,0,0,0,0,0,0,0,0,0,0,0.0,0,514,32,0,0,0,0,0,0,0,0,0,0,100.0,NoArch
44a7ffa94677b5791aee4979844cd4dceb681f7e,0,0,0,0,0,0,0,0,0,0,0,0,0.0,0,849,6,0,0,0,0,0,0,0,0,0,1,100.0,NoArch
82004d852356601a779e5a923691899e96079988,0,0,0,0,0,0,0,0,0,0,0,0,0.0,0,494,33,0,0,0,0,0,0,0,0,0,0,100.0,NoArch
ccae55e3676870910df36c86e32a1cf41beebd01,1,18,1,17,0,0,0,2,3,2034,1,1,0.0,135,45,2,9,8,1,872,756,116,7,6,1,0,100.0,NoArch
6bb1cf9d989d03dd3b6bf9433f5b81e371056ea3,0,0,0,0,0,0,0,0,0,0,0,0,0.0,0,510,6,0,0,0,0,0,0,0,0,0,0,100.0,NoArch
a72f26f0df75749a6655a86f72b46a056964fcfd,2,5,1,4,0,0,0,5,151,247,1,2,0.918295834,3799,211,18,458,457,1,18742,18715,27,253,252,1,1,99.98286204,NoArch
9a432f22f9e80c93eb905e90ef67331aed01b6c7,2,290,238,52,0,0,0,2,18,1120,1,2,0.064254625,527,78,5,56,49,7,2581,2289,292,27,26,1,1,100.0,NoArch
89e8767973e84828d1c5513884b0b8eeaa895aa4,1,3,6,3,0,0,0,2,2,54,1,1,0.0,131,124,4,12,13,1,621,635,14,10,10,0,0,100.0,NoArch
ac77a047c0e22177fd6f69ed3e16cd64b0ca37f7,1,0,4,4,0,0,0,4,15,0,1,1,0.0,268,386,14,36,36,0,1377,1385,8,18,18,0,1,100.0,NoArch
96d92110a388905b33e48e9cbd6353e798a84a61,0,0,0,0,0,0,0,0,0,0,0,0,0.0,0,574,13,0,0,0,0,0,0,0,0,0,0,100.0,NoArch
29453d67935b4eff368c7ad87ab7d30aaed11cb8,0,0,0,0,0,0,0,0,0,0,0,0,0.0,0,1,1,0,0,0,0,0,0,0,0,0,0,100.0,NoArch
aa8bc42fd4cde2756ff00bd5152089d7813deea7,1,0,4,4,0,0,0,3,7,0,1,1,0.0,208,699,1,13,13,0,1176,1212,36,7,7,0,1,100.0,NoArch
5b5133c28b98b3715fe955bd18d9481035a3f42c,0,0,0,0,0,0,0,0,0,0,0,0,0.0,0,37,25,0,0,0,0,0,0,0,0,0,0,100.0,NoArch
f09000d1e61a0131ee20df22b7b2ac6d297ebd07,2,3,0,3,0,0,0,1,4,514,2,2,0.918295834,176,409,8,6,6,0,925,907,18,4,4,0,1,100.0,NoArch
43da1ca798cf694d654cdf410c6a40bebd4dc255,0,0,0,0,0,0,0,0,0,0,0,0,0.0,0,571,31,0,0,0,0,0,0,0,0,0,0,100.0,NoArch
2fc2c285164b51d9fb756b074cd59343f42e34a1,1,3,2,1,0,0,0,2,4,441,1,1,0.0,221,134,21,34,34,0,1114,1114,0,8,8,0,0,100.0,NoArch
4d1a176784e1c5fd3f5302fb9371a42947e4c736,1,8,9,1,0,0,0,3,32,344,1,1,0.0,255,394,0,46,46,0,1406,1409,3,20,20,0,0,100.0,NoArch
ab28b31451f750fa6701dac83ae1e8387003a7e8,3,48,6,42,0,0,0,1,2,264,2,2,1.567711658,196,435,15,12,12,0,1092,1138,46,7,7,0,0,100.0,NoArch
3221b16221ceb7d3d28c4efff4482105e829b4eb,1,63,28,35,0,0,0,9,124,18,1,1,0.0,1268,263,17,261,260,1,7843,7457,386,71,71,0,1,100.0,NoArch
d31324c8b0cbbf12b8645a8155fcfa80e7039544,32,542,72,470,0,0,0,2,5,1022,3,14,4.977158236,7296,1137,1,956,956,0,30612,30612,0,331,331,0,0,100.0,NoArch
0b8b230983989079bf30e67a48b54e71f99ad077,1,15,5,10,0,0,0,3,3,597,1,1,0.0,118,772,35,19,18,1,587,572,15,9,9,0,1,100.0,NoArch
815b789eebfcaf14667a0f93c0c6af2a8cba565c,0,0,0,0,0,0,0,0,0,0,0,0,0.0,0,42,11,0,0,0,0,0,0,0,0,0,1,100.0,NoArch
36265ea80286fcd0bcad2ff5081a3e7e71fe63db,1,43,0,43,0,0,0,3,8,77,1,1,0.0,287,701,15,52,44,8,1692,1427,265,11,10,1,0,100.0,NoArch
9827427f465881826d617c9e0692001650d1f176,0,0,0,0,0,0,0,0,0,0,0,0,0.0,0,480,13,0,0,0,0,0,0,0,0,0,0,100.0,NoArch
238761262881afcf034a9f649625908cbad8b42b,2,27,22,5,0,0,0,3,61,76,1,1,0.963335546,2060,20,13,194,194,0,5390,5390,0,109,110,1,1,99.81609598,NoArch
4c4f86a0d8523eb9fca630b181ce2b90e28940a6,3,57,12,45,0,0,0,2,24,239,1,1,0.930586005,2688,451,24,290,281,9,8129,7972,157,139,133,6,1,100.0,NoArch
83760fdcd028d468410b410bd3270b1b95a7327a,2,222,0,222,2,0,2,1,1,0,1,1,0.918295834,0,1198,0,27,0,27,1103,0,1103,20,0,20,1,99.96988677,NoArch
6b643dc2c3d932ddd7f5d90e0ce522201ae57b8e,2,18,9,9,0,0,0,2,73,10,1,2,0.918295834,2523,674,14,390,389,1,14542,14473,69,165,165,0,1,100.0,NoArch
8e33f646c63e32f95dc8063f7fdab6a8a1e9a1e6,0,0,0,0,0,0,0,0,0,0,0,0,0.0,0,840,12,0,0,0,0,0,0,0,0,0,0,100.0,NoArch
fcb5d9ed5f7aaf049d32311161038b1db435d972,10,1962,0,1962,10,0,10,1,1,0,1,1,2.889738995,0,525,39,390,0,390,10639,0,10639,97,0,97,0,99.7312813,NoArch
5f7c6b73ba6862345f8ae9d19e0706dc66155650,0,0,0,0,0,0,0,0,0,0,0,0,0.0,0,552,66,0,0,0,0,0,0,0,0,0,1,100.0,NoArch
8905b967bbe68797e8201ad8f5be27760c4172c5,0,0,0,0,0,0,0,0,0,0,0,0,0.0,0,495,11,0,0,0,0,0,0,0,0,0,0,100.0,NoArch
cdf35dfe12a7b4295b33a3703d917b12b460576b,3,52,0,52,0,0,0,2,23,13,1,2,1.464274509,1426,502,23,236,226,10,7264,7064,200,116,106,10,0,100.0,NoArch
a80acbb1ad4e26987a7ff82c587e4bb6a81d15f2,17,516,519,3,0,0,0,6,134,1159,1,1,2.000458081,4145,434,13,627,617,10,18947,19029,82,274,274,0,0,100.0,NoArch
7230da33c6e35133ef2c8c78fbe7151159bb6be5,1,1,1,0,0,0,0,2,4,0,1,1,0.0,154,784,7,19,19,0,732,731,1,5,5,0,0,100.0,NoArch
4f3f52392d3ee4053b75b8e41b577fb224f924d6,7,474,50,424,2,0,2,1,16,54,1,2,1.785412958,1089,715,29,223,174,49,7322,5644,1678,105,82,23,0,99.78559717,NoArch
a19bfd4c9a969d41faacb858be855d9fda338bba,5,100,41,59,0,0,0,2,29,26,1,2,1.50935113,1507,603,11,232,221,11,6315,6092,223,93,93,0,1,100.0,NoArch
f28ac6d5e42c8425dfe7725ac366fc2f60c612c8,1,1,1,0,0,0,0,4,14,549,1,1,0.0,245,163,26,25,25,0,1383,1383,0,18,18,0,0,100.0,NoArch
80242339ec4cae44be57fa863392ff0959f2b734,0,0,0,0,0,0,0,0,0,0,0,0,0.0,0,416,8,0,0,0,0,0,0,0,0,0,1,100.0,NoArch
636e37b376c084de86032ac919ce38380138d485,0,0,0,0,0,0,0,0,0,0,0,0,0.0,0,694,8,0,0,0,0,0,0,0,0,0,0,100.0,NoArch
8c5aadf6a064f67e3e3de1540822d65225691930,0,0,0,0,0,0,0,0,0,0,0,0,0.0,0,642,15,0,0,0,0,0,0,0,0,0,0,100.0,NoArch
8c5c33bfc2e581edcba0c164fb0cb7f892e65b3f,2,6,215,209,0,0,0,2,25,45,1,1,0.07442579,1285,1281,8,162,162,0,6453,6450,3,38,39,1,0,100.0,NoArch
c9414c4a6d0fbfa5c6668f2efdae54ec5bd6c2a7,2,73,28,45,1,0,1,4,13,103,1,1,0.864983275,73,869,12,4,3,1,268,182,86,3,2,1,1,99.98263487,NoArch
8bae15a2a29450aef9b8a46f4a3427c8b41c415b,2,0,0,0,0,0,0,1,1,0,1,1,0.0,78,1237,23,2,2,0,236,236,0,2,2,0,0,99.93701779,NoArch
ca067a6bbb91bbe1d8e3878b1ececd0449ae85b4,14,296,35,261,2,0,2,1,33,192,1,7,2.753562864,5805,456,24,852,836,16,25953,24452,1501,441,431,10,1,99.95337995,NoArch
dee584b99e25dff2eb855b517a7318d6f85c8249,3,197,2,195,1,0,1,5,45,592,1,2,0.300322862,515,423,12,80,63,17,3210,2305,905,36,25,11,0,99.98202086,NoArch
d403f107224244abbe53e8e9cb90959ae402885a,1,8,0,8,0,0,0,13,223,0,1,1,0.0,2555,238,10,465,464,1,11146,11092,54,230,230,0,1,99.98190373,NoArch
9c2f043a6536e72313c5c35abe226ed219ae5c73,0,0,0,0,0,0,0,0,0,0,0,0,0.0,0,397,3,0,0,0,0,0,0,0,0,0,0,100.0,NoArch
a3b0e8ad7f9f6f7aba848cdce13acff32fd936e8,3,124,243,119,0,2,2,1,4,110,2,1,1.287906617,328,6,1,54,73,19,868,1213,345,7,12,5,1,99.95058068,NoArch
ed58e9a05d86b913dd4bd9c4b1800a1da89983e3,3,104,79,25,0,0,0,5,236,518,2,3,0.17360681,3082,773,10,536,530,6,13095,13001,94,259,255,4,1,100.0,NoArch
d649a9184b44236e055f024be947e67cb455e10b,0,0,0,0,0,0,0,0,0,0,0,0,0.0,0,445,25,0,0,0,0,0,0,0,0,0,0,100.0,NoArch
8ae10b93958fa38e8e56e83e076936c0a010c8e3,1,1,1,0,0,0,0,3,6,0,1,1,0.0,542,164,12,58,58,0,1467,1463,4,32,32,0,1,100.0,NoArch
401895a521656e9ed8bf2a6ce3c79f0d37c63204,0,0,0,0,0,0,0,0,0,0,0,0,0.0,0,524,14,0,0,0,0,0,0,0,0,0,1,100.0,NoArch
171e3223c19b17658633a53732a93519e015f94b,4,20,10,10,0,0,0,2,18,36,1,2,1.425605199,471,562,41,61,59,2,1977,1909,68,27,27,0,1,100.0,NoArch
59b38fcc43766717a923d23c410e349b32a4c9ea,2,121,7,114,1,0,1,1,138,83,1,2,0.543564443,2550,348,13,349,344,5,9626,9123,503,186,182,4,1,99.97058304,NoArch
b489fc6f751638a0ec9af4194f1722ac8d8a2a0d,0,0,0,0,0,0,0,0,0,0,0,0,0.0,0,519,12,0,0,0,0,0,0,0,0,0,1,100.0,NoArch
6b2786a191378f835f042e3402d631f5c2b6393d,1,5,1,4,0,0,0,3,6,0,1,1,0.0,2366,638,33,125,125,0,15236,15190,46,91,91,0,0,100.0,NoArch
2ebba60265a46ba495a5598abe4330e3c255e830,1,1,1,0,0,0,0,2,2,254,1,1,0.0,48,1099,13,2,2,0,204,204,0,1,1,0,0,100.0,NoArch
dcbb19509435703ebb16e1da65a8029206fbbe66,1,12,0,12,0,0,0,2,3,50,1,1,0.0,743,1279,9,146,142,4,4190,4122,68,68,68,0,1,100.0,NoArch
62a6e358c84230548d3e847432a06df230ca251b,0,0,0,0,0,0,0,0,0,0,0,0,0.0,0,985,8,0,0,0,0,0,0,0,0,0,0,100.0,NoArch
fbb0a43218866944b87cfa72687cdc16cbb2d4c2,0,0,0,0,0,0,0,0,0,0,0,0,0.0,0,481,27,0,0,0,0,0,0,0,0,0,0,100.0,NoArch
32acb34018346cc69ba384d9031dc0e83228eb1a,1,146,0,146,1,0,1,1,1,0,1,1,0.0,0,219,12,10,0,10,796,0,796,8,0,8,1,99.96575929,NoArch
f42c91f43db0f2a59d0bd7e924adc4ac9d042d03,4,66,26,40,0,0,0,3,61,345,1,2,1.568416778,1651,1081,10,265,260,5,6613,6506,107,124,122,2,1,100.0,NoArch
15f85cd768f2bc1ca21a5a283dba672beb1d1256,1,2,6,4,0,0,0,5,20,0,1,1,0.0,362,753,4,37,38,1,1807,1823,16,19,19,0,1,100.0,NoArch
534a44fbd6b703e31448f89c3feddf3a7f4e3a6f,1,1,1,0,0,0,0,5,93,8,1,1,0.0,2691,194,22,448,448,0,15723,15723,0,166,166,0,1,100.0,NoArch
ac4beb12f94b63d3a83fdf678e0a618542016ee3,0,0,0,0,0,0,0,0,0,0,0,0,0.0,0,82,3,0,0,0,0,0,0,0,0,0,1,100.0,NoArch
bf62dc88c1da23827c21a0c3ef8f21afe27cb866,2,123,9,114,1,0,1,1,19,751,1,2,0.684038436,180,386,21,38,32,6,1671,1088,583,25,20,5,1,99.45225054,NoArch
fd84b78d5bd9d5132f7179f67adf2802f6dbf21b,1,5,5,0,0,0,0,6,72,16,1,1,0.0,731,9,2,152,152,0,3882,3882,0,70,70,0,0,100.0,NoArch
6a794d8a60b704e5dd250e4086ee09950f8367ff,2,22,22,0,0,0,0,1,4,21,1,2,0.773226674,366,103,13,79,79,0,2478,2478,0,10,10,0,0,100.0,NoArch
efed771196cf281e38223cd88398ba4389a0505e,0,0,0,0,0,0,0,0,0,0,0,0,0.0,0,196,23,0,0,0,0,0,0,0,0,0,0,100.0,NoArch
a08a4a84c768c3afaa8578d744386c9baf9dfc80,1,3,0,3,0,0,0,3,8,669,1,1,0.0,148,718,36,11,11,0,502,489,13,10,10,0,0,98.40231711,NoArch
8d42a5af7f1c1102b4486918e1f5c1a4ac8d6883,2,3,1,2,0,0,0,3,8,149,1,2,1.0,276,613,16,25,25,0,814,802,12,11,11,0,0,100.0,NoArch
e23519b06aab590df6398ce378ce2864f863f4d7,0,0,0,0,0,0,0,0,0,0,0,0,0.0,0,58,10,0,0,0,0,0,0,0,0,0,0,100.0,NoArch
b7921117cf49f2e50cc3465dc0e3ff38fa5f1ea2,0,0,0,0,0,0,0,0,0,0,0,0,0.0,0,38,26,0,0,0,0,0,0,0,0,0,0,100.0,NoArch
fa37910edde3e99eae267b78ed97131bd5319178,4,20,19,1,0,0,0,1,8,0,1,2,1.591000576,784,84,13,142,142,0,4018,4000,18,58,58,0,0,100.0,NoArch
2de531cb5209e0aa8ce46f18379619352583f6ba,2,2,2,0,0,0,0,4,147,99,2,2,1.0,2290,66,14,405,404,1,9918,9912,6,221,221,0,1,100.0,NoArch
33d70700561fcc9dcb7cc0d7b5b13c7174bf5c93,1,14,5,9,0,0,0,1,6,0,1,1,0.0,169,82,11,33,32,1,744,719,25,24,24,0,0,100.0,NoArch
fba8e25563a1d3368025891ffe2df46ea0767a0e,1,1,1,0,0,0,0,5,48,1,1,1,0.0,1248,19,12,194,193,1,7959,7953,6,45,45,0,1,100.0,NoArch
803c42d4da1a610bfb4c10c9fe0fc81c40dcc829,4,64,0,64,0,0,0,1,9,0,1,2,2.0,89,1236,22,0,0,0,310,310,0,0,0,0,0,100.0,NoArch
1a24160641c2197b3e29a3f4851ca6c01aeace25,2,244,11,233,1,0,1,1,36,0,2,2,0.450066658,1707,143,18,340,312,28,11158,9788,1370,96,84,12,0,99.98968966,NoArch
5ca9763343e4f692d53429b27813e45b7653d532,1,9,6,3,0,0,0,6,50,0,1,1,0.0,548,642,8,100,99,1,2371,2359,12,52,52,0,1,100.0,NoArch
67fd739b3a846b411f0e296cb80d7ee81b4a83a5,6,0,356,356,0,6,6,3,7,115,1,1,2.575256544,356,372,56,0,22,22,0,1173,1173,0,22,22,0,99.87176958,NoArch
6d9e5b59518ec6f8ad3e577f2a2e300087d25a43,2,4,3,1,0,0,0,1,6,7,1,2,0.985228136,350,116,20,46,46,0,2070,2047,23,14,14,0,0,100.0,NoArch
00282727b838988daa3328595d3f9058d86fdf6d,1,13,11,2,0,0,0,2,7,204,1,1,0.0,327,615,18,72,71,1,2118,2104,14,10,9,1,0,100.0,NoArch
dffe336851234a3389b983effe79bad287d6d1d5,0,0,0,0,0,0,0,0,0,0,0,0,0.0,0,137,2,0,0,0,0,0,0,0,0,0,0,100.0,NoArch
1dde38ee901c36ebeb147985d52421a92c2fbf9c,1,0,71,71,0,1,1,1,2,0,1,1,0.0,71,643,1,0,1,1,0,323,323,0,1,1,0,99.9739922,NoArch
692411e989e2e39182ead57f4e0c935cfafdcb3a,1,7,7,0,0,0,0,7,19,1087,1,1,0.0,244,451,14,31,31,0,586,586,0,31,31,0,0,100.0,NoArch
358b522b8d016eecbd1208a77a6c0309167636ec,1,2,0,2,0,0,0,5,19,205,1,1,0.0,708,334,13,55,55,0,3215,3203,12,33,33,0,0,100.0,NoArch
12dba4d65c6981324df39bc1b454927a197ec896,2,7,7,0,0,0,0,5,55,246,1,1,0.985228136,1644,785,1,275,268,7,8080,8025,55,97,97,0,0,100.0,NoArch
8a5387f6adde99cf80796629395925bae2b9c9bc,1,2,1,1,0,0,0,4,19,317,1,1,0.0,407,805,21,66,66,0,1408,1394,14,34,34,0,0,100.0,NoArch
f90e6b9b6dc0f1596ddabe01fa03d70b99a8ed06,1,5,7,2,0,0,0,3,4,1426,1,1,0.0,156,360,10,10,10,0,790,790,0,4,4,0,1,100.0,NoArch
f3d633c2a9b4d95b9b23141c0e08ecf0605d0fba,1,103,0,103,1,0,1,1,1,0,1,1,0.0,0,491,13,10,0,10,449,0,449,5,0,5,0,99.96440437,NoArch
4e1ec02590b821defbe3288dfc3551a4c2b18e08,1,3,0,3,0,0,0,2,7,97,1,1,0.0,505,614,17,41,40,1,1093,1078,15,27,27,0,0,100.0,NoArch
d12c087a54a72225f09e38857f1a7d0022c80f7c,1,7,1,6,0,0,0,4,7,234,1,1,0.0,50,233,18,5,4,1,190,168,22,5,4,1,0,100.0,NoArch
c94279e12eb3303d9989b66478cf3880ac2ac838,1,2,3,1,0,0,0,5,27,38,1,1,0.0,1756,223,14,98,98,0,9952,9961,9,62,62,0,0,100.0,NoArch
21fe8cac7d05247c381fc351596c3a56b89a03cd,8,112,120,8,0,0,0,2,7,414,2,2,1.7020821,3621,8,3,529,522,7,18736,19004,268,295,294,1,0,99.95919319,NoArch
479acad417aa06a28d90abc0baf6a32f203d4f43,1,3,0,3,0,0,0,4,35,776,1,1,0.0,454,58,12,79,79,0,3278,3258,20,30,30,0,1,99.97337061,NoArch
e947927511796484e2ae0a066df7fa7b4800a578,5,75,56,19,0,0,0,2,36,1195,2,3,1.236335693,3243,41,1,522,516,6,16395,16306,89,198,194,4,1,100.0,NoArch
561cda1e45da7739dd2b566de5ce1e04907cab2a,2,16,8,8,0,0,0,2,8,326,1,1,0.738284866,1132,267,15,168,166,2,5627,5606,21,69,67,2,0,100.0,NoArch
58be7125d48efdba29f05debe77ee59e0c64eef1,1,14,5,9,0,0,0,2,2,2308,1,1,0.0,259,181,29,28,25,3,1317,1278,39,17,17,0,0,100.0,NoArch
f5dff68d73b5d03dd2192a0626d88fa77fb1d5c1,1,17,17,0,0,0,0,2,2,79,1,1,0.0,148,513,8,12,12,0,365,342,23,11,11,0,1,100.0,NoArch
da66c468477da6475841975c35b7a85fa39f22f0,1,103,0,103,1,0,1,1,1,0,1,1,0.0,0,12,0,5,0,5,310,0,310,5,0,5,1,99.99031758,NoArch
59b38fcc43766717a923d23c410e349b32a4c9ea,2,121,7,114,1,0,1,1,138,83,1,2,0.543564443,2550,348,13,349,344,5,9626,9123,503,186,182,4,1,99.97058304,NoArch
d9efb590f8dc42ec7e04f2f637b159fadd576964,0,0,0,0,0,0,0,0,0,0,0,0,0.0,0,39,28,0,0,0,0,0,0,0,0,0,0,100.0,NoArch
8311938134414c9394fea9fd8bc34f724931fd1a,2,121,1,120,0,0,0,3,23,233,1,2,0.46377735,1045,858,2,84,77,7,6555,5816,739,41,38,3,1,100.0,NoArch
61877f3477448b5cdda9c094de6f54a3d37037fe,0,0,0,0,0,0,0,0,0,0,0,0,0.0,0,1178,4,0,0,0,0,0,0,0,0,0,1,100.0,NoArch
9e3e5ad4ccd5f9e818162c693f79eb45d6fba8da,1,6,5,1,0,0,0,1,2,503,1,1,0.0,158,116,18,16,16,0,876,851,25,9,9,0,1,100.0,NoArch
3ab3f04f941d4b83d95031f1f5335d0529b6b9cc,1,20,12,8,0,0,0,3,6,1302,1,1,0.0,142,161,9,15,14,1,735,672,63,7,6,1,1,100.0,NoArch
c856f30bc556ccdf5c1f05a0244743eca8100c3e,2,146,14,132,1,0,1,1,134,9,1,2,0.881290899,1453,220,4,285,272,13,8482,7915,567,103,100,3,1,99.98843931,NoArch
2e890c6224fb1735e758ee2e9321b9b6ea828c4d,0,0,0,0,0,0,0,0,0,0,0,0,0.0,0,224,6,0,0,0,0,0,0,0,0,0,0,100.0,NoArch
4dda0d83536040814f3aa8b3aea99e2e4d3006af,1,7,3,4,0,0,0,2,8,344,1,1,0.0,149,107,17,17,16,1,893,867,26,7,7,0,0,100.0,NoArch
e332143fd839832b93a4d412a06e08792410a83d,1,1,1,0,0,0,0,1,6,0,1,1,0.0,164,62,20,22,22,0,732,734,2,13,13,0,0,100.0,NoArch
2672065943f9119df9422ef5b3eea0d177a2e82f,0,0,0,0,0,0,0,0,0,0,0,0,0.0,0,636,20,0,0,0,0,0,0,0,0,0,1,100.0,NoArch
129f879607e02f54834911d5b31a5cffb9f4b2b3,1,81,33,48,0,0,0,2,4,91,1,1,0.0,243,457,5,43,35,8,1703,1423,280,19,18,1,0,100.0,NoArch
fb5a97276bc1d88c93f32d4e44aec5abaedcec64,1,3,2,1,0,0,0,2,2,128,1,1,0.0,166,852,5,28,28,0,800,793,7,13,13,0,0,100.0,NoArch
541d9fe3f3566bf2379c03727d442a23af095dcc,2,0,278,278,0,2,2,2,4,54,2,1,0.998169816,278,71,0,0,26,26,0,1242,1242,0,5,5,1,99.94514536,NoArch
54a152039391c15f13507f23630169b2784b8fa3,1,196,0,196,1,0,1,1,1,0,1,1,0.0,0,471,11,17,0,17,950,0,950,5,0,5,1,99.91284861,NoArch
7947655e5f7b2142de869b95a02900826298855a,1,2,3,1,0,0,0,3,8,24,1,1,0.0,375,452,17,37,38,1,1342,1349,7,25,25,0,0,96.35968487,Arch
a522d3abf739bcf2f544f378b3f6e4d440ef0eaa,5,1604,0,1604,5,0,5,1,1,0,1,1,2.021111751,0,453,18,222,0,222,8241,0,8241,97,0,97,0,94.78862005,Arch
8c9bd680da5d74d51c0fc66df3dcc04c56162b79,37,232,2468,2236,0,8,8,4,20,23,3,16,3.894159163,11201,454,0,1168,1493,325,43030,53942,10912,532,666,134,0,96.77704752,Arch
da46dac7bce6d813a1570670b798bd8d66291fdd,1,2,3,1,0,0,0,3,8,77,1,1,0.0,375,458,4,37,38,1,1342,1349,7,25,25,0,0,96.35968487,Arch
b8facc37b4ecb58fed3da08b5ba507222d977b68,36,2771,209,2562,11,0,11,5,12,66,4,13,4.047584416,6660,43,2,1159,786,373,44695,32241,12454,524,376,148,0,94.37458637,Arch
17741208271801d810afb865736ff4907768f474,57,206,5341,5135,0,30,30,0,11,12,4,18,4.960824772,12235,463,9,834,1520,686,34171,56658,22487,397,720,323,1,93.96315171,Arch
2b0279a9af096cd2d2e655ce95308a3212f0dbdc,56,5415,228,5187,30,0,30,1,12,41,4,17,4.974795447,6706,427,18,1478,789,689,55124,32392,22732,700,377,323,1,94.08486384,Arch
a0397468fae85c038e8a20458501e71c9439c59b,3,121,78,43,1,0,1,2,12,68,1,2,1.551772098,571,429,20,94,92,2,2536,2478,58,60,60,0,0,96.24642517,Arch
6cb4828e51d6ea1829171b3539cc1ece615bc492,63,309,5718,5409,0,32,32,0,11,17,5,23,5.143253089,13384,464,10,964,1688,724,37772,61559,23787,468,818,350,1,93.58616101,Arch
c085df44f8b0663a7ee59737e31b2cc49e533882,64,5745,314,5431,32,0,32,1,29,54,5,24,5.16270166,9791,436,24,1895,1171,724,67757,43970,23787,934,584,350,0,93.58616101,Arch
dfd0436c1f3f9490de961f3ad2638ad9a6c1b0a9,64,310,5741,5431,0,32,32,0,29,18,5,24,5.160207269,15203,465,11,1169,1893,724,43939,67726,23787,582,932,350,1,93.58616101,Arch
51daeeeeda587e7aaf0d7d15e99aa2f724dd0b5f,66,5789,316,5473,33,0,33,1,30,54,5,24,5.190979693,9971,466,6,1918,1192,726,68649,44805,23844,942,590,352,0,93.49474524,Arch
bf310ef475f17b25cb0a191f634b1a3b32ac1177,3,185,0,185,3,0,3,1,1,0,1,3,1.468484311,0,437,25,20,0,20,566,0,566,15,0,15,0,96.26179531,Arch
73c4d4d7c2a13e3d154c103f4bebc2f4d6dcd539,69,313,5994,5681,0,36,36,0,29,17,5,27,5.276307873,15652,466,12,1192,1942,750,44805,69356,24551,590,957,367,1,93.76047441,Arch
2054392af21a510ad0eda28f361e511432b16b88,76,7116,317,6799,43,0,43,1,30,46,5,29,5.499620611,9971,17,1,2068,1192,876,73703,44805,28898,1036,590,446,0,93.55544121,Arch
3756ee2d3a1409e3b2345a2c603377893da77576,76,313,7106,6793,0,43,43,0,29,16,5,29,5.497462836,16764,404,1,1192,2066,874,44805,73658,28853,590,1036,446,1,93.55544121,Arch
a1ba6e0325f5af18f958104b603779635e9064ed,77,7226,317,6909,44,0,44,1,30,44,5,30,5.529516553,9971,63,21,2073,1192,881,74028,44805,29223,1038,590,448,0,93.5313786,Arch
10302dd92e1820d794ad9a364739c815f3127637,78,315,7224,6909,0,44,44,0,29,17,5,30,5.530353596,17371,467,13,1263,2144,881,46770,75993,29223,643,1091,448,1,93.5313786,Arch
54515313716733ae95d17044d2cc26456c3bcc6b,78,7228,319,6909,44,0,44,1,31,42,5,30,5.532299858,10462,444,30,2144,1263,881,75993,46770,29223,1091,643,448,0,93.5313786,Arch
4624a3a3cb4ee00f601dc8c7129aa84bf9a369b2,77,313,7222,6909,0,44,44,0,30,15,5,30,5.527567115,16880,405,2,1192,2073,881,44805,74028,29223,590,1038,448,0,93.5313786,Arch
fcc9ae70b15082ee67815a58feb3b1c36db454cf,77,7226,317,6909,44,0,44,1,31,44,5,30,5.529516553,9971,445,31,2073,1192,881,74028,44805,29223,1038,590,448,0,93.5313786,Arch
568bdc4bd47113100a702bd0b013cd06bb1f3819,81,313,7859,7546,0,48,48,0,30,15,5,31,5.61546551,17517,469,12,1192,2154,962,44805,77876,33071,590,1075,485,1,93.41817714,Arch
7dafbb582fbba60c1797cf15af298c7ab6cc8913,82,7864,318,7546,48,0,48,1,31,38,5,32,5.619203982,10840,473,12,2295,1333,962,82173,49102,33071,1133,648,485,1,93.41817714,Arch
142f2ea67068d8e45ff6b1fa041565801b5bc5e8,81,313,7859,7546,0,48,48,0,30,15,5,31,5.61546551,17517,470,13,1192,2154,962,44805,77876,33071,590,1075,485,1,93.41817714,Arch
e264e6f9d1e8e5bcea7d1e30df8793731c608451,84,7863,321,7542,48,0,48,1,31,43,5,33,5.62466839,10798,474,13,2297,1335,962,81760,48733,33027,1136,651,485,1,93.41817714,Arch
396c25dc16c45e16c14cb509cf57fd2b90a2e1a8,88,359,7951,7592,0,48,48,0,30,14,5,33,5.656902261,19353,65,0,1389,2356,967,52928,86169,33241,678,1167,489,1,93.41817714,Arch
789d2da20c0d304a68017c389d99f5ff191ac50c,88,7955,363,7592,48,0,48,1,31,46,5,33,5.658681449,11761,93,22,2356,1389,967,86169,52928,33241,1167,678,489,1,93.41817714,Arch
1e47d1ba034d7910a62346e1858a0e6339a2fbb4,89,359,8134,7775,0,49,49,0,30,13,5,34,5.681841764,19536,471,8,1389,2371,982,52928,86817,33889,678,1171,493,1,93.39416527,Arch
6355225b133d3eded826077b6071931615612e24,89,8153,363,7790,49,0,49,1,31,45,5,34,5.682204147,11761,95,20,2374,1389,985,86905,52928,33977,1172,678,494,0,93.39416527,Arch
e437092be2bcb2baf80c01054fa5358a371eaff5,89,359,8149,7790,0,49,49,0,30,13,5,34,5.680456555,19551,472,9,1389,2374,985,52928,86905,33977,678,1172,494,1,93.39416527,Arch
75270affd846c5ef6ae0c0a81ba4af1d5cd71ac8,90,8173,380,7793,49,0,49,1,31,47,5,35,5.69782144,12098,480,19,2408,1423,985,88960,54982,33978,1187,693,494,1,93.43862352,Arch
784d69ff806ff30d205322d537507d63eb3e028e,89,359,8149,7790,0,49,49,0,30,13,5,34,5.680456555,19551,473,10,1389,2374,985,52928,86905,33977,678,1172,494,1,93.43862352,Arch
dee685f73c67a87b731135146daddedb9cc47cee,89,8196,363,7833,49,0,49,1,31,45,5,34,5.695216206,11761,481,20,2375,1389,986,87127,52928,34199,1173,678,495,1,93.43862352,Arch
c971df54774e26d56fdbaecf1651b4dfd9d681f0,89,359,8192,7833,0,49,49,0,30,13,5,34,5.693482774,19594,474,11,1389,2375,986,52928,87127,34199,678,1173,495,1,93.43862352,Arch
944f9d60d71f3a7c1531b7a0d41ff9e17dc344bf,91,8274,370,7904,49,0,49,1,31,46,5,35,5.724968237,12004,483,22,2407,1410,997,88499,53914,34585,1191,694,497,1,93.37442219,Arch
b3748b4fd8acd595c6bd59c68e82b0b3bf863ca3,10,12,840,828,0,7,7,1,6,213,3,4,2.722284443,893,484,23,9,105,96,287,4312,4025,4,52,48,1,96.22025198,Arch
586d9ef320194e6a2e886a1776f745bbcee62e03,155,1278,9030,7752,9,67,76,0,30,18,8,59,6.320269319,31759,19,0,3076,4066,990,101039,136135,35096,1579,2075,496,0,93.29844269,Arch
a6f93512b426f121f67c5758cd99a454f777fe22,155,9034,1282,7752,67,9,76,1,33,78,8,59,6.32143043,24007,104,14,4066,3076,990,136135,101039,35096,2075,1579,496,0,93.29844269,Arch
f7f2a22712103aaf601b05de0bc160eb2534d2c0,159,1282,9414,8132,9,70,79,0,30,17,9,60,6.375368981,32515,476,0,3127,4180,1053,103078,140287,37209,1611,2128,517,1,93.22379315,Arch
f5ffb392437d7f04979f4ed2ce75a907380b6eb9,160,9423,1289,8134,70,9,79,1,33,72,9,61,6.3805588,24785,487,3,4245,3191,1054,142309,105090,37219,2154,1637,517,1,93.22379315,Arch
1ca2d6f57a3135cb154dca1c513c07114697c687,159,1282,9414,8132,9,70,79,0,30,17,9,60,6.375368981,32515,477,1,3127,4180,1053,103078,140287,37209,1611,2128,517,1,93.22379315,Arch
9c135637f90e0a6dc78201db9e79fb370e334344,160,9427,1305,8122,70,9,79,1,33,72,9,60,6.386055795,24514,488,4,4194,3143,1051,140844,103686,37158,2138,1621,517,0,93.22379315,Arch
5143a2ad0556adf20357191631e0c20699c5a7d4,163,1309,9512,8203,9,71,80,0,30,17,9,60,6.412697036,33384,478,2,3267,4335,1068,106562,144127,37565,1681,2202,521,1,93.20005094,Arch
6a9d59658be8f383bd8a0614517882fb61a0405a,163,9548,1313,8235,71,9,80,1,33,75,9,60,6.417008352,25181,113,17,4335,3267,1068,144127,106562,37565,2202,1681,521,0,93.20005094,Arch
dc98d967b59397aa1e977e4006c78fda4297a367,8,1306,0,1306,8,0,8,1,1,0,1,1,2.296031424,0,510,25,169,0,169,6512,0,6512,77,0,77,0,96.54979276,Arch
4213222264ca82d9f6e71711c3c1b14426daaf54,184,1468,11036,9568,9,77,86,0,30,9,9,66,6.551436907,37262,479,3,3568,4817,1249,119271,163506,44235,1837,2434,597,1,91.81077075,Arch
530884a2d99104a864531b27132e2a0ae825f996,186,11115,1470,9645,79,9,88,1,33,69,9,66,6.572155883,27694,512,27,4823,3568,1255,163672,119271,44401,2437,1837,600,1,93.09407287,Arch
81b9a08d55564795cfc05fc8b7ce2cc74e3623fe,186,1468,11114,9646,9,79,88,0,30,9,9,66,6.571314647,37340,480,4,3568,4823,1255,119271,163683,44412,1837,2437,600,1,93.09407287,Arch
0d9c764bf5411770a4b63a3c29f9788f457f403f,186,11123,1470,9653,79,9,88,1,33,69,9,66,6.571412813,27694,115,19,4826,3568,1258,163708,119271,44437,2437,1837,600,0,93.09407287,Arch
0d7597d4c93ff75846c8dce68905bb219c85bd56,196,4562,11132,6570,16,79,95,0,30,8,10,70,6.421228796,37834,481,5,4451,4884,433,135137,165572,30435,2021,2462,441,0,92.82988004,Arch
c250fa5f6c7d43dbfe04773fc03d5018b8b857fd,196,11135,4565,6570,79,16,95,1,34,84,10,70,6.42212179,31264,132,2,4884,4451,433,165578,135137,30441,2462,2021,441,1,92.82988004,Arch
1f6aa57df62ae72d75a44ad61d859d499f6ca196,28,2,1880,1878,0,22,22,2,19,280,1,3,4.209446996,3601,517,31,160,361,201,8648,17777,9129,59,151,92,0,96.08931656,Arch
a4070b6315982322c5961771f50928960f38af20,196,4657,11419,6762,17,80,97,0,30,15,10,69,6.437556575,38018,482,6,4471,4909,438,134906,165520,30614,2037,2482,445,1,93.61979167,Arch
80c76a8882dbc4d0fdc037bc3ef375ffebca5c3d,11,1497,0,1497,11,0,11,1,7,0,1,1,2.732083585,0,483,7,175,0,175,7012,0,7012,80,0,80,1,97.91549296,Arch
4493e89ed71634a5e115b7097d477fa46c475eac,180,9805,4451,5354,69,16,85,1,36,91,10,68,6.262678076,30326,519,33,4639,4373,266,154783,130449,24334,2350,1980,370,0,93.38701162,Arch
371e892e2c733e06718a5c10d1c26a9b4abfeb0f,183,4455,9883,5428,16,70,86,0,40,14,10,69,6.2862525,37026,486,10,4562,4834,272,136009,160479,24470,2080,2455,375,0,93.32365747,Arch
104305bac0b2f7f5d75631938eb0287f9f96bbde,184,9890,4461,5429,70,16,86,1,41,93,10,69,6.289685932,31642,521,35,4838,4566,272,160561,136088,24473,2459,2084,375,0,93.32365747,Arch
1b0a344feac82eccd163a21633146db2a794021c,183,4455,9883,5428,16,70,86,0,40,14,10,69,6.2862525,37026,487,11,4562,4834,272,136009,160479,24470,2080,2455,375,0,93.32365747,Arch
5b26cd83c91b34e9eeddd50b21d8803e89eb5918,184,9910,4463,5447,70,16,86,1,41,94,11,70,6.295280671,31711,522,36,4849,4570,279,161111,136457,24654,2457,2082,375,0,93.32365747,Arch
27b58d6f61379bc69d0f984cf01d5ce886aea1f4,208,4942,12941,7999,16,81,97,0,40,12,14,75,6.531219527,42449,488,12,5039,5727,688,150003,186011,36008,2401,2882,481,1,93.02815049,Arch
16d403f5354ff7428e54f78ea0fbd360b54259b1,207,12943,4938,8005,81,16,97,1,41,88,14,74,6.528953782,33575,535,49,5586,4896,690,181714,145631,36083,2824,2343,481,1,93.02815049,Arch
251b25de928a7cc7dc93629a658bc380e47c4e17,209,5132,12939,7807,17,81,98,0,40,13,14,75,6.548004618,41781,489,13,4968,5623,655,147684,182700,35016,2356,2831,475,1,93.00460224,Arch
d320676ae1d031f61f7ee099b5aedf844a874296,207,12943,4938,8005,81,16,97,1,41,88,14,74,6.528953782,33575,536,50,5586,4896,690,181714,145631,36083,2824,2343,481,1,93.03364879,Arch
a677c21240ac154a9fdd4cb1aca9001a5cb16472,54,6012,0,6012,54,0,54,1,1,0,1,3,5.378188196,0,477,17,431,0,431,25471,0,25471,266,0,266,0,94.59210678,Arch
288f8767c3c22b5c30ade4f844d23f498824c415,49,0,5308,5308,0,41,41,2,5,389,1,1,5.266338173,5300,480,20,0,390,390,0,21967,21967,0,243,243,1,96.83013033,Arch
fe3785c9baf467c8b74f17e20769cfef30795f41,264,5149,14167,9018,19,89,108,0,40,23,14,75,6.659830533,48005,490,14,5299,6090,791,167714,210455,42741,2592,3119,527,0,89.46047679,Arch
2fe01ce355cfa527f24e9c787b9a2fcc8697713b,261,13966,4942,9024,86,16,102,1,41,47,13,75,6.598884435,38987,537,51,6071,5299,772,209771,167714,42057,3104,2592,512,0,89.46047679,Arch
23e80fdbc14cac424109cef69ef823c444157a9c,264,5070,14051,8981,16,86,102,0,40,26,14,75,6.628096206,48447,491,15,5358,6123,765,169894,211693,41799,2622,3128,506,2,89.46047679,Arch
ff30070bea5bdeb12deaf3d59cf639087033c8b8,261,13966,4942,9024,86,16,102,1,41,47,13,75,6.598884435,38987,538,52,6071,5299,772,209771,167714,42057,3104,2592,512,2,89.46047679,Arch
eafa72d7cb39e80b5ef3e5cebb5b031da9aded84,264,5020,13976,8956,16,86,102,0,40,27,14,76,6.616082343,48811,492,16,5400,6164,764,171886,213717,41831,2651,3159,508,1,89.46047679,Arch
cf5ee40d6397ad5e6106e74612620c797561cbd9,261,13966,4942,9024,86,16,102,1,41,47,13,75,6.598884435,38987,539,53,6071,5299,772,209771,167714,42057,3104,2592,512,1,89.46047679,Arch
43cba856e40ed9ccfb2c0dc988a825ec6b242b2f,262,4965,13964,8999,16,86,102,0,40,24,14,75,6.604423764,48082,493,17,5313,6081,768,168146,210041,41895,2602,3111,509,1,89.44528112,Arch
87666fa1948d22b89fd8cf547d5b4ef86044b9d7,261,13966,4942,9024,86,16,102,1,41,47,13,75,6.598884435,38987,540,54,6071,5299,772,209771,167714,42057,3104,2592,512,1,89.44528112,Arch
c69b9becc78ba1a859566e2762fe87aa0528740d,262,4943,13965,9022,16,86,102,0,40,25,14,75,6.600538235,48222,494,18,5336,6108,772,169049,211096,42047,2601,3113,512,0,89.44528112,Arch
40958b688fc5fc028fcbd4eef9aa0301d9374414,261,13966,4942,9024,86,16,102,1,41,47,13,75,6.598884435,38989,541,55,6071,5299,772,209781,167724,42057,3104,2592,512,0,89.44528112,Arch
fd6ae201af136082394dc55332ae874d6132374e,262,4939,13963,9024,16,86,102,0,40,25,14,75,6.59885036,48107,495,19,5309,6081,772,168053,210110,42057,2598,3110,512,0,89.44528112,Arch
d6c75ee25ec7c9cf3955d1610208d70445fdf619,261,13966,4942,9024,86,16,102,1,41,47,13,75,6.598884435,38989,542,56,6071,5299,772,209781,167724,42057,3104,2592,512,0,89.44528112,Arch
4b3b6186a46dd69ff85e4d5fa99d4b11128a5782,262,5074,13964,8890,16,86,102,0,40,26,14,76,6.612115454,48099,496,20,5335,6085,750,168571,210100,41529,2617,3116,499,1,89.44528112,Arch
1250a6d023092e739700ca8260ecfdc3c6a20cc6,261,13966,4942,9024,86,16,102,1,41,47,13,75,6.598884435,38989,543,57,6071,5299,772,209781,167724,42057,3104,2592,512,1,89.44528112,Arch
8432e7a790523d8a37e612e37398562d4f36369a,262,4942,13962,9020,16,86,102,0,40,25,14,76,6.599490455,48105,497,21,5311,6082,771,168174,210218,42044,2596,3108,512,1,89.44528112,Arch
75fde7165e9541da926ecc9763c905b9783f4c82,261,13966,4942,9024,86,16,102,1,41,47,13,75,6.598884435,38989,544,58,6071,5299,772,209781,167724,42057,3104,2592,512,1,89.44528112,Arch
f4de30d2d979dff284844c325fa612e10a5d79dc,264,5190,14187,8997,16,86,102,0,40,26,14,76,6.625474471,49222,498,22,5494,6262,768,173697,215563,41866,2665,3181,516,2,89.44528112,Arch
ad2546fa8d3982f6671e8022e05e3fb21f32227c,261,13966,4942,9024,86,16,102,1,41,47,13,75,6.598884435,38989,545,59,6071,5299,772,209781,167724,42057,3104,2592,512,2,89.44528112,Arch
79527ce44bb1248e8352bc09179f960d0cb87047,261,4938,13962,9024,16,86,102,0,40,24,14,75,6.597998507,48013,499,23,5299,6071,772,167724,209781,42057,2592,3104,512,0,89.44528112,Arch
6722a0327ea311f7710273371056f66a6bc8e204,261,13966,4942,9024,86,16,102,1,41,47,13,75,6.598884435,38989,548,62,6071,5299,772,209781,167724,42057,3104,2592,512,0,89.44528112,Arch
ca60ebbf73e551f8d4d45405593609f9934f5ce0,265,4943,14041,9098,16,86,102,0,40,24,14,75,6.61221726,48430,500,24,5314,6098,784,168465,210937,42472,2608,3124,516,1,89.3753136,Arch
afba7231914cd9cac32be3e7a870f0871d73c57f,265,14045,4947,9098,86,16,102,1,41,46,13,75,6.613095975,39332,550,64,6098,5314,784,210937,168465,42472,3124,2608,516,1,89.3753136,Arch
91e6c64f1e9f70ac4033d800110e1ddd6e53ae42,265,4943,14041,9098,16,86,102,0,40,24,14,75,6.61221726,48430,501,25,5314,6098,784,168465,210937,42472,2608,3124,516,1,89.3753136,Arch
f2f428101bd3f35c30c2433f38eeaeba6dc4bf64,265,14045,4947,9098,86,16,102,1,41,46,13,75,6.613095975,39333,553,67,6098,5314,784,210946,168474,42472,3124,2608,516,0,89.3753136,Arch
f3e1ea888820fed858c1682282fe68a49b048fe2,265,4943,14041,9098,16,86,102,0,40,24,14,75,6.61221726,48431,503,27,5314,6098,784,168474,210946,42472,2608,3124,516,1,89.3753136,Arch
f2d90cd97cc457d63b066ed53a231ccccd5ab449,265,14045,4947,9098,86,16,102,1,41,46,13,75,6.613095975,39333,555,69,6098,5314,784,210946,168474,42472,3124,2608,516,1,89.3753136,Arch
a2630500ba05f19ecefc227e6470105c90deb148,279,5541,14328,8787,20,89,109,0,40,24,14,79,6.716019426,50205,504,16,5643,6394,751,176964,218318,41354,2778,3275,497,0,89.31077694,Arch
2fc3e8ee7f672cf75e8a028bd72780d923287ab4,277,14332,5146,9186,89,18,107,1,42,48,14,78,6.694946922,41019,563,28,6392,5600,792,218111,175419,42692,3273,2754,519,0,89.13458913,Arch
c59908b429998374b15822cb32e6cd3809a77f9c,277,5136,14315,9179,18,89,107,0,40,24,14,78,6.68995983,50210,506,18,5601,6395,794,175275,218339,43064,2754,3276,522,1,89.13458913,Arch
1bcd631bf913558d6213ce1e66946444a88a7a16,277,14319,5140,9179,89,18,107,1,42,48,14,78,6.690799906,41031,565,30,6393,5603,790,218132,175482,42650,3274,2756,518,0,89.13458913,Arch
ac6e8fc52245e65f12b4e8cfc26563ede76200d8,285,5616,15315,9699,19,92,111,0,40,23,14,80,6.805367909,52166,406,0,5828,6749,921,182327,228349,46022,2848,3420,572,0,89.0313779,Arch
a0e3831ab8228c273a570bf2af14f9ab90ec88dd,285,15316,5617,9699,92,19,111,1,42,40,14,80,6.80604513,42467,14,0,6701,5878,823,226696,184073,42623,3400,2869,531,0,89.0313779,Arch
90d0c4b38b715e5fca91126e8fc673e7e9c67bf2,6,368,60,308,3,0,3,2,43,84,1,2,2.41449923,2000,509,28,368,325,43,9265,8231,1034,214,191,23,1,95.74984821,Arch
b5f54e500b638804e174fa2cfc873507042eb36a,300,5705,16028,10323,19,99,118,0,40,24,14,82,6.895913642,54210,508,7,6008,7002,994,187820,235848,48028,2971,3591,620,1,89.19395466,Arch
95fec7d0db7381fa0f06b736f746d5d0e13267f5,295,15971,5694,10277,98,19,117,1,45,41,14,79,6.881898375,42981,15,1,6844,5949,895,230319,185759,44560,3530,2953,577,1,89.40005042,Arch
643a1cad0b33e6b1a2fc5ba2cf4ccd158146647a,295,5693,15970,10277,19,98,117,0,40,24,14,79,6.881215257,53258,508,7,5899,6892,993,184013,231972,47959,2932,3550,618,0,89.40005042,Arch
8176dca67fe93c4b0fcb09fa333270a249ae18d7,295,15971,5694,10277,98,19,117,1,45,41,14,79,6.881898375,42981,570,18,6844,5949,895,230319,185759,44560,3530,2953,577,1,89.40005042,Arch
3372966d2001eff5cf846fa8062d2456956a1b97,298,5705,15971,10266,19,98,117,0,40,26,14,80,6.884616636,54254,512,8,6067,7058,991,188970,236880,47910,3015,3633,618,1,89.40005042,Arch
f2a80acac5f0f8b38e7abbc7f197c44d8fd34f7c,298,15972,5706,10266,98,19,117,1,45,40,14,80,6.885302843,43988,20,1,7010,6117,893,235227,190716,44511,3613,3036,577,0,89.40005042,Arch
da67a386967bd03bd21af1e3dff3b89f72fc8cc9,17,737,68,669,11,1,12,1,46,19,1,5,3.656383975,2620,521,34,486,420,66,15208,13059,2149,273,217,56,0,95.24793388,Arch
4ae7e1cedefd7effd84d78a2ae978a6b8d97db3d,5,192,8,184,2,0,2,1,4,55,1,3,1.612554048,280,525,38,43,26,17,1481,809,672,33,20,13,0,96.38721047,Arch
7eff7f008cca5796d86c362ffb1cd53d0fb61e78,317,5848,17243,11395,20,113,133,0,40,23,14,82,7.039752424,56395,509,5,6182,7298,1116,193919,245888,51969,3092,3810,718,1,90.18567639,Arch
57b494132549ebef6877bf47da3c3d5d776286e0,1577,30436,17578,12858,159,66,225,1,50,0,20,224,9.316854933,187645,573,13,22259,21628,631,799277,772561,26716,12643,12205,438,0,90.18567639,Arch
a23f329fb78613bc67d7c6660c818e3018e3ec6c,1670,20458,31384,10926,76,159,235,0,40,0,21,236,9.453918471,209458,513,9,22420,23885,1465,792455,864960,72505,12618,13590,972,0,89.90478857,Arch
c36ea1aa9b11ab1cf8763ba6744b79df1cae6460,1670,31397,20460,10937,159,76,235,1,50,0,21,236,9.45441397,198532,531,43,23117,23166,49,832069,825174,6895,13242,12943,299,1,89.90478857,Arch
d44765df12783f96c663192d5803ff03ade0b1ce,1671,20636,31573,10937,77,160,237,0,40,0,21,236,9.455196304,209469,514,10,22420,23913,1493,792455,865978,73523,12618,13607,989,0,89.86278353,Arch
cb77064b88d3ce3558ac6bd91ee7cc8b5abd3a7c,324,17061,7780,9281,114,31,145,1,50,10,13,81,7.101728724,46404,534,37,7069,6786,283,238980,213257,25723,3720,3218,502,1,89.86278353,Arch
b7446c45b1dfae15c4ae3522e91971726aa84efb,1671,20833,32228,11395,77,160,237,0,40,0,21,236,9.451573824,209517,511,7,22418,23927,1509,792406,866183,73777,12618,13614,996,0,89.86278353,Arch
4c1cc956cc72b600a5fc4764b343d23183e45bd0,1671,32214,20835,11379,160,77,237,1,50,0,21,236,9.451737004,198122,579,17,23126,23192,66,832230,826107,6123,13248,12960,288,0,89.86278353,Arch
cc004efa3e65f75af5c24224258179de25764ab4,333,7790,17096,9306,31,114,145,0,41,109,13,83,7.113604397,57654,518,14,6650,7804,1154,207362,261228,53866,3260,4042,782,0,89.86278353,Arch
f998bc73981050d1cc69364df5e337ad7dd91bb8,333,17098,7792,9306,114,31,145,1,50,10,13,83,7.114168974,48348,580,18,7356,7068,288,247137,221313,25824,3890,3383,507,0,89.86278353,Arch
75e0c114786dfdcb2d017827d02ae5391e107c49,333,7790,17096,9306,31,114,145,0,41,109,13,83,7.113604397,57654,519,15,6650,7804,1154,207362,261228,53866,3260,4042,782,0,89.86278353,Arch
902a8ea864d4a8bda65d7ea76f12411f3104202d,339,17184,7798,9386,114,31,145,1,50,10,13,84,7.132105517,49378,138,5,7492,7192,300,250935,224875,26060,3966,3451,515,0,89.86278353,Arch
353ba22e31af4b3d7e46811b9a3143a9efb12dde,345,7814,17363,9549,32,116,148,0,41,107,12,87,7.165187978,59755,520,8,6842,8034,1192,215159,270626,55467,3372,4172,800,0,89.78306508,Arch
cc5f94d4ed4898bce6020c1ed7b53705f04da337,345,17365,7816,9549,116,32,148,1,51,10,12,87,7.165753477,50206,585,15,7571,7268,303,255903,229558,26345,4018,3497,521,0,89.78306508,Arch
b7e322d832b13b66463e2682fbab7f5be9dfcd0c,1673,20857,32479,11622,78,162,240,0,40,0,20,238,9.464053359,209744,512,4,22418,23962,1544,792406,867759,75353,12618,13631,1013,0,89.78306508,Arch
cab35d7553a284a52dca655241196c6f84c4e5df,1673,32485,20859,11626,162,78,240,1,51,0,20,238,9.464134214,198122,555,34,23150,23200,50,833225,826555,6670,13264,12962,302,0,89.78306508,Arch
dd55c215aaaf1e3a55b6576e5dc720c714045446,53,0,0,0,0,0,0,1,1,0,1,15,0.0,6060,567,36,764,764,0,28490,28490,0,381,381,0,0,97.19039825,Arch
1ff804699006659048cf78625e1780a9f898bda1,59,59,0,59,59,0,59,1,1,0,1,1,5.882643049,0,587,14,120,0,120,8648,0,8648,113,0,113,0,92.10205078,Arch
c26d8a9d0d58beac27d2e7033a6c65ef452e8a98,62,772,1,771,61,0,61,1,10,0,1,2,1.426128325,118,588,13,572,16,556,32912,379,32533,472,15,457,0,96.03971318,Arch
1c0e39f7c942cae683225138e85eae7e34cb3a4b,490,7892,19334,11442,32,243,275,1,41,49,12,93,7.298393955,65367,521,3,7302,9300,1998,230915,331947,101032,3607,5066,1459,0,84.70632155,Arch
492952b4bb25451fd85b294e504dd1d85212af3b,490,19325,7883,11442,243,32,275,3,51,7,12,93,7.298683378,53925,571,36,8835,7728,1107,317182,245314,71868,4910,3732,1178,0,84.70632155,Arch
e427cc99a68852a1b24fb05c16363369336aeaa6,490,7892,19334,11442,32,243,275,1,41,49,12,93,7.298393955,65367,522,4,7302,9300,1998,230921,331947,101026,3607,5066,1459,1,84.70632155,Arch
7d4cddd4524508f760177901904e881b07b52177,491,19435,7944,11491,243,32,275,3,51,7,12,94,7.303824866,54554,0,0,8927,7815,1112,321341,249223,72118,4934,3754,1180,0,84.70632155,Arch
935859a63d5fefbd7e49daa111c232c9980eb1aa,498,8137,19860,11723,32,244,276,1,41,48,12,95,7.335215667,67381,523,3,7532,9568,2036,239769,341521,101752,3722,5200,1478,1,84.9011095,Arch
07c1e65c225415b09302a058dcade55c3adcab36,498,19851,8128,11723,244,32,276,3,52,7,12,95,7.335494876,55658,594,9,9102,7958,1144,326759,254168,72591,5043,3847,1196,1,84.9011095,Arch
7b8c1b10be1fc1dfe3a8e924f1cd8b9fca0f4bfc,498,8137,19860,11723,32,244,276,1,41,48,12,95,7.335215667,67381,524,4,7532,9568,2036,239769,341521,101752,3722,5200,1478,1,84.9011095,Arch
6a12e9cdebfcfbd4bc3aab767e56e4bc9cc60cb4,499,19912,8136,11776,244,32,276,3,52,7,12,95,7.341253696,55983,595,9,9156,8002,1154,328006,255225,72781,5090,3888,1202,1,84.9011095,Arch
e8c8abcd5bd1d8fe28a6afd84e818ba0bda062c1,4,209,57,152,1,0,1,1,23,42,1,3,1.208311272,808,594,23,136,128,8,5098,4375,723,74,69,5,1,95.46029192,Arch
bfaff9b37c815c32ec18911bf038d03724c753d4,34,1202,341,861,7,0,7,2,30,63,1,7,4.037714998,6039,149,2,964,845,119,31697,28283,3414,485,420,65,1,94.84320557,Arch
88acb0ede755808266ee9748fcf3d04ee6415e3d,80,1217,291,926,11,0,11,2,22,58,4,32,4.866633259,17255,599,7,2419,2305,114,84241,79651,4590,1155,1062,93,1,97.035486,Arch
cde8b34227709d91a6d0006ce70e56b555d2a46c,611,10207,25371,15164,36,276,312,0,41,32,13,110,7.743597313,85928,526,3,9394,11986,2592,304934,426007,121073,4632,6475,1843,1,83.34166458,Arch
802296d5d90da499ed7d442f62f0c4d2da9c12bc,612,25435,10180,15255,277,36,313,1,55,0,13,110,7.749781668,70764,610,18,11425,9922,1503,406463,324629,81834,6257,4821,1436,0,83.32083958,Arch
de62efbc78bb235e0fe436ebbb2a14d4dd190ddd,652,13723,29071,15348,63,297,360,0,41,0,13,114,7.91975477,87414,527,1,9587,12839,3252,309890,449483,139593,4746,6930,2184,0,82.0375,Arch
2bdded210e2ceb0da5c16fd5cbc99fa35ed9f972,652,29040,13692,15348,304,63,367,1,56,0,13,114,7.919341965,72073,612,16,11625,10675,950,412475,344581,67894,6377,5236,1141,0,82.0375,Arch
861a08912b7ee525496978c0119cd0f84bc7bed6,652,13723,29071,15348,63,304,367,0,41,0,13,114,7.91975477,87421,528,2,9587,12839,3252,309890,449483,139593,4746,6930,2184,1,82.0375,Arch
5b530832748c8ffe49e40cde535e8faf9a2b2380,652,29048,13701,15347,304,63,367,1,56,0,13,114,7.920521412,72123,614,18,11634,10684,950,412787,344893,67894,6380,5239,1141,1,82.0375,Arch
a02fd05f57fafe250c49b032039add7673d9c11d,650,13732,29073,15341,63,304,367,0,41,0,13,114,7.920354668,87269,530,4,9573,12825,3252,309424,448989,139565,4736,6920,2184,1,82.0375,Arch
13277055fb57b9312831598777d52b01bd6d8348,919,27986,48184,20198,297,262,559,2,56,0,15,176,8.793307947,105445,615,18,11359,14150,2791,403833,471972,68139,6220,7338,1118,0,72.58997883,Arch
125fbfed53eab5cb7b60a632a40af54a7467bd33,945,51408,28071,23337,372,297,669,1,41,0,16,187,8.854865003,85382,531,5,13403,12559,844,451033,440010,11023,7004,6780,224,0,71.52006832,Arch
72cc9e9aa0e7d943ecf651ced3db1596c1fbdf7a,945,28040,51377,23337,297,372,669,1,56,0,16,187,8.854675254,108719,619,22,11371,14477,3106,404107,484898,80791,6225,7499,1274,0,71.52006832,Arch
4eef609524f4831de2d294a50f534d112875c556,25,1035,106,929,3,0,3,1,32,67,1,10,3.939808254,5474,156,8,856,716,140,30129,25676,4453,434,361,73,1,92.48415334,Arch
beb72f6403711596a287b0756c9a76a10d80c6d3,960,51532,29327,22205,372,300,672,1,41,0,16,188,8.887576531,88540,14,0,13644,12982,662,460989,455644,5345,7143,7006,137,1,72.09584471,Arch
295850da01be27b59f90674527af28c5a6dbbab1,962,29101,51817,22716,300,374,674,1,56,0,16,188,8.891612686,111053,620,22,11752,14775,3023,418516,496409,77893,6437,7666,1229,0,72.02606456,Arch
220ad62a5057fec622eb073fb97e0c2a76b2e586,9,360,52,308,2,0,2,4,34,0,1,4,2.398736681,2352,621,23,473,416,57,13014,11459,1555,217,189,28,1,93.8049076,Arch
c9b89056f771d351f0a3a4cfbe8976011290e63f,2,132,17,115,1,0,1,1,57,15,1,2,0.999707555,1461,23,1,243,231,12,6540,6106,434,130,123,7,1,93.78872601,Arch
1a88ac6ac383eccf8a026368c894f8f21646cd3c,29,2990,0,2990,29,0,29,1,1,0,2,9,4.678417525,0,623,12,333,0,333,9916,0,9916,228,0,228,1,92.60869565,Arch
0d3ff77e264ed9b9a45c879e337807d01036c2fb,991,51529,32311,19218,373,330,703,1,41,0,17,190,8.95895956,91838,15,1,13687,13343,344,462399,466974,4575,7142,7233,91,1,70.84572886,Arch
2e7aa919e8a2fef10ec47cf606adbb3a5fd44d1f,991,32293,51511,19218,330,373,703,1,57,0,17,190,8.958501755,111056,597,0,12142,14783,2641,430675,496998,66323,6670,7648,978,0,70.84572886,Arch
c6475bf5dcf5342ec7ad54838de9ad08f5253bfd,991,51533,32403,19130,373,330,703,1,41,0,17,190,8.960998885,91926,533,1,13687,13358,329,462399,467383,4984,7142,7237,95,1,72.31309991,Arch
ef5fd15b8470c91470c63917b570c4ef6ae7671e,991,32385,51515,19130,330,373,703,1,57,0,17,190,8.96054177,111056,627,7,12157,14783,2626,431084,496998,65914,6674,7648,974,1,72.31309991,Arch
9388d7c96c2cdd8fcba77394dc0570b3a6e4a470,994,51607,32563,19044,373,330,703,1,41,0,17,190,8.965931929,92249,407,0,13716,13401,315,463288,468674,5386,7164,7267,103,0,72.31309991,Arch
3df5af05ecd7bbcb60cc2ea55d8cdd7113fb485b,994,32545,51589,19044,330,373,703,1,57,0,17,190,8.965476477,111293,628,8,12193,14819,2626,432103,498161,66058,6700,7674,974,0,72.31309991,Arch
83c8c1bd5962ca9b5b561ce0215730d5e33cabf8,963,43264,32563,10701,342,330,672,1,41,0,16,181,8.933765206,92249,534,2,13032,13406,374,428592,468826,40234,6838,7272,434,0,72.94021517,Arch
d90b781b00b52cd7e840fb8dd596044998281dc0,967,33012,43419,10407,334,342,676,1,57,0,16,182,8.941325003,103131,143,1,12260,14149,1889,433793,463998,30205,6743,7358,615,1,72.8781284,Arch
cd4e31881a7fce0a216a3fdae0ed53d4cd97b226,967,43437,33030,10407,342,334,676,1,41,0,16,182,8.941772501,92724,409,2,13046,13474,428,429000,470645,41645,6848,7316,468,0,72.8781284,Arch
2b11b8c36d29bc5f444b081fdf54e3974c5468a1,969,33150,43557,10407,336,344,680,1,57,0,16,182,8.95036576,103131,25,3,12260,14166,1906,433793,464649,30856,6743,7364,621,1,72.76931447,Arch
5de5a0647916578f49f582c39380d093bcbba13f,971,43584,33230,10354,344,336,680,1,41,0,16,182,8.953786167,93144,542,5,13086,13533,447,431095,473556,42461,6876,7351,475,0,72.76931447,Arch
77f1ed2207804238cd01e0b47dc1e11b42d7a5e6,971,41168,43566,2398,336,344,680,1,57,0,16,182,9.105959765,103498,629,9,12302,14206,1904,436053,466744,30691,6772,7392,620,0,72.76931447,Arch
766bf5021551ed4e7f66b4e95e494b9dc26a6136,979,43593,47354,3761,344,344,688,1,41,0,16,182,9.218926618,107259,16,1,13086,13785,699,431095,490400,59305,6876,7445,569,1,72.61129207,Arch
3c441d03aed96f092ec686e2666f2d264d0af51e,979,47402,43575,3827,344,344,688,1,57,0,16,182,9.21928267,103498,144,1,12635,14091,1456,454321,463013,8692,6884,7374,490,1,72.61129207,Arch
039c2310c41349aa7ef82364c6f2621dde50d133,978,43623,47462,3839,344,344,688,1,41,0,16,181,9.220220795,107115,66,0,13052,13755,703,429981,489775,59794,6868,7438,570,1,72.61129207,Arch
e8bae06604e3d1dee6007b9a23b5476fcdcde5d0,977,47659,43608,4051,345,344,689,1,58,0,15,179,9.221584992,102866,79,0,12577,14006,1429,452740,460355,7615,6861,7342,481,1,72.59158752,Arch
8f0490178bf96f8ed921f8ea09b2fcdfbe0021d4,935,39293,47673,8380,302,345,647,2,41,0,13,163,9.146834203,106917,538,5,12581,13727,1146,412127,489190,77063,6631,7422,791,0,73.56985699,Arch
fa4279c43341154ba1bf632190291df0e1f6e0e1,935,47659,39279,8380,345,302,647,3,58,0,13,163,9.146272213,98537,635,13,12577,13583,1006,452740,444016,8724,6861,7124,263,1,73.56985699,Arch
17946e532570199820b019b947c9110cc28155a0,28,1611,869,742,0,0,0,2,15,85,1,10,3.540479311,6631,157,0,997,895,102,30104,27207,2897,498,445,53,1,95.20999177,Arch
6e8044251947ebb95ad504646144c85228d9711b,7,355,0,355,7,0,7,1,1,0,1,3,2.769262325,0,158,1,12,0,12,648,0,648,12,0,12,1,94.95212038,Arch
a20de10f4aa89969900417cb4fc671f81aad8dd1,1,37,31,6,0,0,0,4,29,22,1,1,0.0,469,168,11,73,71,2,3354,3295,59,33,33,0,0,15.39237951,Arch
19812e7e290d09e56b888ae60f4eff6873134256,28,499,120,379,6,0,6,1,61,51,1,6,4.15338791,7078,170,13,1120,1096,24,32294,31258,1036,675,652,23,0,22.28696286,Arch
9ca56a0049e2009f1725aaf0e7afdf6e4d21d6ee,40,191,162,29,0,0,0,3,45,159,2,21,4.880158901,9992,645,10,1317,1318,1,40129,40275,146,680,680,0,1,94.0635349,Arch
7416155e42d81d71c6c72566c997eda0e3108785,1,110,0,110,1,0,1,1,1,0,1,1,0.0,0,172,15,5,0,5,552,0,552,3,0,3,0,94.43867544,Arch
51135a727ae439104ec69a3b3de5ad062cfd68d4,982,40556,51876,11320,302,367,669,2,41,0,13,168,9.203478115,114278,17,0,13075,14246,1171,430282,511390,81108,6877,7750,873,1,74.35158501,Arch
f2dbca05d7f32401446888b794504cce69a5bfac,982,51882,40562,11320,367,302,669,3,61,0,13,168,9.20305017,102958,147,2,13376,13883,507,481754,456523,25231,7293,7294,1,0,74.35158501,Arch
7da6f3a9745f147a89c2f00b963fe212e656f90a,982,40560,51911,11351,302,367,669,2,41,0,13,168,9.203634508,114309,410,0,13075,14246,1171,430282,511390,81108,6877,7750,873,0,74.35158501,Arch
d287bb1d498bb2e8aabc350bffd3f6d9fd5b78b3,985,51986,40571,11415,368,302,670,3,62,0,13,169,9.206107099,103284,619,3,13421,13921,500,483157,457695,25462,7327,7321,6,1,74.33295753,Arch
55867a9a3a93ed6ae000d124b7c8412f0bf88d9d,985,40565,51980,11415,302,368,670,2,41,0,13,169,9.206535644,114699,540,0,13113,14291,1178,431454,512793,81339,6904,7784,880,0,74.33295753,Arch
8cf0a390c5e2fc99f30f63f52d9be4e93f8b05da,985,51986,40571,11415,368,302,670,3,62,0,13,169,9.206107099,103284,650,11,13421,13921,500,483157,457695,25462,7327,7321,6,0,74.33295753,Arch
0cc41ce86ce31e64b7729fff90276dd27f24a89d,985,40565,51980,11415,302,368,670,2,41,0,13,169,9.206535644,114699,541,1,13113,14291,1178,431454,512793,81339,6904,7784,880,0,74.33295753,Arch
4e98feca9209559ccb8105b9bdc4dd2878a972b4,985,52064,40568,11496,368,302,670,3,62,0,13,169,9.205294288,103284,173,16,13432,13921,489,483483,457695,25788,7332,7321,11,0,74.33295753,Arch
ef8320b2e96fff367380ed20f0a616cd809b58b4,990,40566,52683,12117,302,372,674,2,41,0,13,169,9.215273933,116006,542,2,13220,14504,1284,433928,517602,83674,6934,7873,939,0,74.27427427,Arch
c3f41326ef161ac322444558c750decaf296db78,990,52688,40571,12117,372,302,674,3,62,0,13,169,9.214883557,103889,656,15,13634,14028,394,487986,460169,27817,7416,7351,65,0,74.27427427,Arch
c0454ac32545dc637cb63f70065aecd3cb52871d,991,40580,52759,12179,302,372,674,2,41,0,14,170,9.217416898,116294,543,3,13254,14548,1294,435075,519036,83961,6942,7883,941,0,74.27427427,Arch
29459ed41474b5447214696146508c7f75244293,992,52766,40585,12181,372,302,674,3,62,0,14,170,9.217192558,104385,16,0,13728,14112,384,490431,462327,28104,7464,7397,67,0,74.27427427,Arch
6429b1d01b370dbf8485b010ca4a49b25505b8b2,992,40597,52783,12186,302,372,674,2,41,0,14,170,9.216774738,116571,544,4,13304,14599,1295,436086,520061,83975,6980,7922,942,0,74.27427427,Arch
e73f5aabf61468d431d4ac18c1840c90d85820ff,940,52879,35541,17338,372,250,622,3,63,0,11,160,9.116709838,99241,622,6,13730,13622,108,490459,444465,45994,7466,7095,371,0,75.09559011,Arch
b2efb2458b726e3854bb5c67a941a89186d641c9,949,35572,53056,17484,250,375,625,2,41,0,11,160,9.125415563,118155,552,12,12948,14749,1801,424522,527001,102479,6751,8011,1260,0,74.98090145,Arch
a191115187a07585d30222bddf4a14c86fa24dea,949,53061,35577,17484,375,250,625,3,63,0,11,160,9.124990211,100671,666,21,13878,13768,110,497292,451163,46129,7553,7180,373,0,74.98090145,Arch
cb9e5013764d56b202e6bfe0e4e42dcfc9d52a30,971,36349,55857,19508,252,389,641,2,41,0,13,166,9.162399698,121388,560,14,13135,15165,2030,430251,542330,112079,6804,8194,1390,0,74.69625589,Arch
d9ad0437ffb16da04cc215e852816cfdf511f9da,971,55860,36352,19508,389,252,641,3,63,0,13,166,9.161893816,101880,633,17,14277,13975,302,511704,457990,53714,7728,7243,485,0,74.69625589,Arch
49e10d36fc5a3317ee6a3e7a42787c913da5234d,5,259,1,258,3,0,3,1,64,61,1,3,1.607753548,1719,634,18,321,288,33,8367,7401,966,165,143,22,0,97.84451188,Arch
330e73140a1188424d64f031434c825fa8f2ea64,2,552,0,552,2,0,2,1,1,0,1,1,0.994984828,0,179,4,100,0,100,2642,0,2642,49,0,49,0,97.06615315,Arch
ae687a1182452d6939b48ae34e79b16745ddd9cd,6,11,553,542,0,2,2,2,3,56,1,2,1.249157999,858,182,7,17,116,99,1150,3768,2618,14,62,48,0,97.04349796,Arch
da7478d9d534eefd979404417d0dbb9e7fd84a36,3,788,889,101,0,1,1,4,37,23,1,2,1.124423391,1315,687,21,191,201,10,5981,6346,365,83,92,9,0,95.19129519,Arch
1f5f98d1892a0f56882eb5c2678db676bc7c2fd2,1051,37860,58527,20667,253,397,650,2,41,0,13,169,9.214434274,132138,0,0,13758,15903,2145,464212,581577,117365,7319,8752,1433,0,72.79307408,Arch
6b29b8b3ddceae67ece519579da672e15f580c7b,37,981,897,84,4,3,7,0,37,139,3,21,3.744070083,7570,707,21,1039,1016,23,32331,32551,220,472,449,23,0,97.95221843,Arch
ba476b36f05a9f2fdd7fe39c513d2ddbe43967a5,36,806,978,172,2,4,6,1,38,129,3,20,3.646455618,7654,712,26,1006,1039,33,32338,32331,7,443,472,29,0,97.95221843,Arch
af416908d42ceb0f334e816d2c20d4d2f6f025f1,36,981,809,172,4,2,6,0,37,145,3,20,3.641821318,7482,708,22,1039,1006,33,32331,32338,7,472,443,29,0,97.95221843,Arch
9260e941f951462c1234795f7e7a75650b7fb871,37,851,985,134,2,4,6,1,38,121,4,21,3.729087019,8259,644,6,1082,1111,29,36520,36269,251,471,499,28,0,97.89971121,Arch
fc6ab9c6877c83d5dbcf95c5da4cf04e50f389bb,4,153,71,82,0,0,0,2,7,192,1,3,1.821216483,1417,196,18,241,225,16,6465,6067,398,111,108,3,0,94.01399326,Arch
415b561cf26fea311870d352c14f236c21fe44ea,59,1155,2076,921,4,10,14,1,48,110,5,29,4.808258632,16733,152,1,2013,2096,83,63028,67330,4302,984,1012,28,1,93.62763916,Arch
a58d36b9b3665b3493fd252e28996c849174fd95,62,2430,1163,1267,11,4,15,1,49,89,5,30,4.841122061,16841,716,30,2295,2190,105,72992,66992,6000,1136,1098,38,1,93.60368428,Arch
f08fccc5cbc440f6ecacfc39117421bf8fb700c1,62,1164,2431,1267,4,11,15,1,48,113,5,30,4.840424566,18114,153,2,2192,2297,105,67042,73042,6000,1098,1136,38,1,93.60368428,Arch
849d2f330ea978f959b6632523db10126457fb6f,65,2635,1175,1460,14,4,18,1,49,79,5,30,4.9316937,16847,717,31,2310,2192,118,73795,67042,6753,1144,1098,46,0,93.46405229,Arch
629bc81fb2ab21f8ee4bd879b53e3dda0e459226,25,975,524,451,2,0,2,2,17,81,1,8,4.065016246,5901,199,11,842,781,61,29626,28584,1042,472,415,57,0,93.89907105,Arch
e8e8b43b76acb0f6bd7992834b452e5493b44b51,366,2127,4201,2074,4,18,22,1,65,112,13,103,6.440021255,72035,709,23,8589,8787,198,298261,304378,6117,4540,4659,119,1,96.9044586,Arch
e0fdce4f01acb4e7e669bb7a228d25f9cf59a8de,366,4308,2186,2122,18,4,22,1,66,0,13,103,6.485866596,69961,720,34,8793,8589,204,304571,298261,6310,4660,4540,120,0,96.9044586,Arch
45b71de844bb59891edfebaa39192b8c5e8994cb,370,2259,4544,2285,4,20,24,1,65,112,13,103,6.555843218,72692,31,1,8622,8837,215,300199,307159,6960,4563,4692,129,1,96.77624873,Arch
b02ca01826b297f833258968aefe004938bdd40e,371,4572,2260,2312,20,4,24,1,66,0,13,104,6.568340732,70496,35,5,8849,8631,218,307605,300513,7092,4703,4572,131,1,96.77624873,Arch
ea3456e791d047e551aaa30f1b5995c0b845b29b,371,2266,4548,2282,4,20,24,1,65,111,13,104,6.558835763,72808,32,2,8635,8849,214,300664,307605,6941,4574,4703,129,1,96.77624873,Arch
5367f1ecb078074ac02e673a8a911d8aed6ed3ec,375,4616,2431,2185,20,4,24,1,66,0,13,104,6.602970377,71487,202,14,9020,8810,210,310690,303987,6703,4794,4669,125,0,92.90998767,Arch
2e44c7e98c0339f7a140f936ab2f699e0432559a,376,2445,4630,2185,4,20,24,1,65,108,13,104,6.603821477,73821,33,3,8836,9046,210,304470,311173,6703,4688,4813,125,1,92.90998767,Arch
ea66d50338aa912063e815e32f988509e1c4ba5d,376,4618,2432,2186,20,4,24,1,66,0,13,104,6.604768617,71636,730,43,9046,8836,210,311188,304470,6718,4813,4688,125,0,92.90998767,Arch
f4a7b26f2826a26fb6db20f6c7e1bd4b41fb89ec,382,2444,5628,3184,4,26,30,1,65,107,13,107,6.635047156,74819,710,23,8836,9199,363,304479,316335,11856,4688,4903,215,1,92.75255322,Arch
878b9645ce9b0538816c0dca715843c87496f4ec,385,6350,3135,3215,28,4,32,1,66,0,13,107,6.467029579,71700,203,15,9207,8842,365,316988,304597,12391,4912,4694,218,0,92.60992733,Arch
2eba7ef00af114e53745917f2bd5802c0480823f,385,3147,6362,3215,4,28,32,1,66,105,13,107,6.472378359,74926,34,4,8843,9208,365,304638,317029,12391,4694,4912,218,1,92.60992733,Arch
e78a6f7ee952ebd32f03f22eb8109c712860b7bb,385,6358,3138,3220,28,4,32,1,67,0,13,107,6.470366883,71711,204,15,9209,8843,366,317056,304638,12418,4912,4694,218,0,92.60992733,Arch
e00678027f52d17cc2670e5a965f52a39049d631,10,125,37,88,2,0,2,1,37,63,1,3,2.491984781,1720,207,18,256,255,1,7436,7170,266,124,122,2,0,93.81418388,Arch
3bf0245e763d74b5489ba0f872b09303fef8c7d7,25,446,214,232,3,0,3,1,38,30,1,11,3.130368442,6500,209,20,932,901,31,34264,33126,1138,433,418,15,5,94.12722264,Arch
9eb343b322a25c0e1acf337d99e26b956901f4df,444,3803,10680,6877,5,55,60,1,66,92,14,113,6.978690748,83065,642,0,9383,10218,835,323724,352320,28596,5022,5469,447,0,92.82608696,Arch
5c587a2f1319474aed07671faa5801cfc271edbb,444,10668,3793,6875,55,5,60,1,67,0,14,113,6.976301925,76198,213,17,10213,9387,826,351918,324166,27752,5465,5025,440,0,92.82608696,Arch
4597dddf79cf250c5b29e2d59cb4f7457bc62ea1,13,182,70,112,1,0,1,1,68,8,1,8,3.257732743,5040,215,18,776,762,14,23765,23220,545,398,390,8,0,96.5210356,Arch
5bb32abe03bfe22a4179cae02b023afc5fcdc75e,446,3856,10917,7061,5,56,61,1,66,93,14,113,6.998509983,83349,711,2,9395,10261,866,324074,353636,29562,5032,5490,458,1,92.9200248,Arch
415d46cf466067411d3a52a1ca8206fb456470ed,447,10960,3846,7114,56,5,61,1,69,0,14,113,7.004841245,76380,216,19,10279,9410,869,353697,324721,28976,5500,5044,456,0,92.9200248,Arch
fc9ebeb00552019dc5dc928982ad1aa4f1c178d7,448,3918,11139,7221,5,56,61,1,66,93,14,113,7.03045437,83753,645,3,9430,10328,898,324905,355185,30280,5056,5531,475,0,92.90762554,Arch
0a361e504ac78d7b79ae9232844e59be787ce09c,448,11119,3898,7221,56,5,61,1,70,0,14,113,7.033184843,76532,738,1,10322,9433,889,354744,325278,29466,5526,5059,467,0,92.90762554,Arch
08a32a93b9e168a8cd912cd1aaa1474b9adde49f,449,4023,11342,7319,5,57,62,1,66,90,14,113,7.048688727,83851,17,0,9430,10339,909,324890,355489,30599,5056,5534,478,0,92.12607862,Arch
958c41a12b64d9107f4514092c61cb31ed4013eb,449,11327,4003,7324,57,5,62,1,70,0,14,113,7.052889676,76532,220,2,10334,9433,901,355096,325263,29833,5529,5059,470,0,92.12607862,Arch
213ffce94def0a858a4513f31058cf8b0374537f,450,4028,11352,7324,5,57,62,1,66,90,14,114,7.053478083,83966,154,0,9443,10353,910,325299,355926,30627,5065,5543,478,1,92.12607862,Arch
2b903d446ad57e0ab84cee7556a9a68542d72d29,449,11327,4003,7324,57,5,62,1,70,0,14,113,7.052889676,76532,158,1,10334,9433,901,355096,325263,29833,5529,5059,470,1,92.12607862,Arch
9a14a4bbf87a3f8c3d26523260e17c3f13447462,449,4023,11347,7324,5,57,62,1,66,90,14,113,7.050240876,83856,18,1,9430,10340,910,324890,355537,30647,5056,5534,478,1,92.12607862,Arch
2550bc44b7718a7bfdb8844d3e928a58368a271d,449,11327,4003,7324,57,5,62,1,70,0,14,113,7.052889676,76532,19,1,10334,9433,901,355096,325263,29833,5529,5059,470,1,92.12607862,Arch
b1c94aa00b883f505018928dd4bcb50b45948692,2,130,88,42,1,0,1,1,12,46,1,1,0.975576108,189,231,12,35,28,7,1318,1119,199,20,14,6,0,94.98013723,Arch
481fc1ee3a408117526a90922d9b839a363a2c24,18,2419,13,2406,12,0,12,2,18,6,1,5,3.194120856,1485,744,5,516,239,277,18733,7552,11181,260,115,145,0,94.28884559,Arch
75b1c94ddcb535779340538945d9b0032a84d151,11,237,143,94,0,0,0,1,7,86,1,5,2.614760415,2554,745,6,362,344,18,12849,12558,291,172,170,2,0,95.89406921,Arch
e30a9dddde94245184c891b5febf08eba6610eef,12,981,19,962,8,0,8,1,5,10,2,4,3.01503534,1358,752,13,299,207,92,12049,7381,4668,156,98,58,0,95.17892072,Arch
f19a3a66d62acd7765c744b02e82c4ecebf1ea78,1,28,24,4,0,0,0,3,13,164,1,1,0.0,253,265,37,51,51,0,1145,1138,7,26,27,1,0,97.85202864,Arch
0aac7f5d5c4ecf014a2d944663d71f707f5c132d,5,64,8,56,0,0,0,5,28,307,1,4,1.76214721,1348,660,1,117,110,7,5682,5491,191,71,67,4,1,96.02686066,Arch
f0d9464da03efd554371bac2c9c7d528ea616a8f,7,62,454,392,1,2,3,2,16,141,1,5,2.018203789,2422,277,11,282,350,68,9054,10971,1917,127,155,28,0,95.21601686,Arch
0c0be94a312fd432f3076fbe8ab91a2080e65043,27,434,240,194,3,0,3,1,74,142,1,5,3.607895617,7184,278,12,1129,1116,13,31934,31230,704,641,638,3,0,94.60891243,Arch
b54ff7acff55ec6ec3bceaad29d00944b5d42d48,1,62,0,62,1,0,1,1,1,0,1,1,0.0,0,279,13,2,0,2,302,0,302,2,0,2,0,94.37698927,Arch
89d39bbf271eefd25d02be5d1d4785d74a9b4ee9,521,8153,19114,10961,13,100,113,1,66,72,14,120,7.425974274,92634,713,0,9990,11395,1405,345969,396465,50496,5460,6171,711,1,88.85249879,Arch
be35271fdc0f73e0fc53f62fbc31bee311b96f04,519,19029,8000,11029,99,12,111,1,74,1,14,120,7.409317156,81550,755,0,11300,10068,1232,392213,349380,42833,6122,5500,622,1,88.86732961,Arch
80aba76121355cb88e5bddabcd0be6153a177469,520,8030,19115,11085,12,100,112,1,66,72,14,120,7.41778609,92635,0,0,9984,11395,1411,345473,396472,50999,5455,6171,716,0,88.86732961,Arch
a01a002069de21b7899f11af33fcd05cc1c4b0f8,519,19029,8000,11029,99,12,111,1,74,1,14,120,7.409317156,81550,280,14,11300,10068,1232,392213,349380,42833,6122,5500,622,0,88.86732961,Arch
93c67fe701cd4fb7f3ad88e87c707dd81ba10d88,18,2977,112,2865,12,0,12,1,22,90,1,8,3.466904737,1541,281,15,670,208,462,19547,6940,12607,350,101,249,0,97.35962927,Arch
6e7e3abf5da3f59b5a365f71a3c92516db4844c6,11,86,126,40,0,1,1,2,19,71,1,5,2.17055059,2140,290,20,329,327,2,11200,11246,46,160,160,0,0,94.72799209,Arch
a32448486756bc4f71646eff9ddc4dcee8d6fc6d,13,1879,19,1860,5,0,5,2,11,9,1,6,2.374965375,2192,293,15,579,316,263,18799,9559,9240,298,177,121,0,93.87931034,Arch
5b7d073b4ef2bd5303f0bffc818387df185b230e,567,8615,25181,16566,12,123,135,1,66,75,14,127,7.611498445,100433,714,0,10269,12518,2249,353780,430077,76297,5643,6802,1159,0,87.58677491,Arch
7b317ba7adca4499c7813a760a4a4eb92cf66899,567,25084,8641,16443,120,12,132,1,76,18,14,127,7.606355948,84011,299,9,12427,10361,2066,426073,357892,68181,6753,5692,1061,0,87.58677491,Arch
b006e61e4f515c304aca5deaf4d2180f83adc864,3,51,3,48,1,0,1,3,38,75,1,2,1.019966037,964,681,15,179,176,3,5110,5026,84,89,87,2,0,94.82468915,Arch
f92e5b587a71ddebbbc1213ab487df0e6316e25c,1,124,0,124,1,0,1,1,1,0,1,1,0.0,0,313,23,6,0,6,529,0,529,2,0,2,0,95.89788078,Arch
f7e9206ae55068b9c6cc5928741f849f3df19fbf,1,17,1,16,0,0,0,3,10,295,1,1,0.0,346,316,22,53,52,1,2124,1995,129,33,32,1,0,95.5861244,Arch
8cf4795b94da83e09b94612c654315956c862677,121,1310,128,1182,112,0,112,2,28,26,2,8,3.360835549,5613,684,8,1422,730,692,60991,19984,41007,889,312,577,1,90.58524173,Arch
f3b154992184daf3160d943bd10a21c391493b0a,705,10168,27733,17565,20,248,268,1,66,0,14,132,7.766547963,106456,715,1,10995,13998,3003,374912,493474,118562,5935,7700,1765,0,84.16592892,Arch
e04bd6f0e12496b861faad85a9e0e4de990948a0,9,233,110,123,0,0,0,2,51,271,1,4,2.333260752,8533,719,5,980,967,13,34644,34540,104,512,507,5,0,95.43191436,Arch
26198c209486e8ad1956c1a8b0a38d1633e360f3,709,28040,10755,17285,248,20,268,1,77,0,14,132,7.788156331,89647,759,2,13860,11237,2623,488356,383677,104679,7624,6048,1576,1,85.3388998,Arch
05a8cba7d06d4c2c0843238edae54af0b483b52a,20,387,76,311,3,0,3,1,52,146,1,6,3.742181035,8847,685,9,1113,1079,34,31532,30596,936,567,536,31,1,94.36654982,Arch
810a54fea89c18919a82835b538700154e439ba2,723,10817,28507,17690,20,252,272,1,66,0,14,135,7.825877991,109207,646,0,11314,14306,2992,384375,503254,118879,6096,7883,1787,1,86.0097172,Arch
c3fd0a65b1fd1b056c4a91fad4d59e1df48e745a,723,28515,10826,17689,252,20,272,1,78,0,14,135,7.824638824,91518,694,16,14132,11468,2664,496603,390716,105887,7790,6179,1611,1,86.0097172,Arch
669415cfa209d0b304379aa5e1b614b486955312,723,10816,28505,17689,20,252,272,1,66,0,14,135,7.825604718,109207,648,2,11314,14306,2992,384381,503254,118873,6096,7883,1787,1,86.0097172,Arch
63b2d6837d7e29250b537b892c95610a0756fa9c,725,28537,10826,17711,252,20,272,1,78,0,14,135,7.827454669,91802,695,17,14171,11502,2669,497804,391825,105979,7815,6200,1615,1,86.0097172,Arch
df4309b45db630a669694e4237a4a3fd7d2322dd,723,10816,28505,17689,20,252,272,1,66,0,14,135,7.825604718,109207,649,3,11314,14306,2992,384381,503254,118873,6096,7883,1787,1,86.0097172,Arch
611ecd2a0126ffc2e450eb6b28e94ea1bbfe98fd,722,28492,10825,17667,251,20,271,1,78,0,14,135,7.821865337,91518,696,18,14132,11468,2664,496579,390716,105863,7790,6179,1611,0,86.01589667,Arch
429c24b146f5a900a707f9557078ef326e1f50be,727,10923,28544,17621,21,252,273,1,66,0,14,135,7.835284434,109422,732,18,11327,14321,2994,385429,504087,118658,6105,7895,1790,1,86.03871929,Arch
274f677ecb8de58404d85a79b8e7c3812fa9572d,726,28553,10833,17720,252,20,272,1,79,0,14,135,7.828375388,91702,760,3,14146,11478,2668,497389,391329,106060,7801,6187,1614,1,86.09181141,Arch
179cfd833d7a2b394de18fb893e0c12c5cfefbdd,727,10825,28546,17721,20,252,272,1,66,0,14,136,7.830195564,109554,650,4,11335,14332,2997,385582,504682,119100,6111,7902,1791,0,86.09181141,Arch
9ba5e1921cba0888218948b4f3eca9297c1d0bd2,727,28555,10835,17720,252,20,272,1,79,0,14,136,7.829106242,91833,321,27,14158,11489,2669,497986,391917,106069,7809,6194,1615,0,85.33134773,Arch
db811a5016f453c911bb2ec3be6e7c3cb3e5c855,727,10863,28750,17887,20,252,272,1,66,0,14,136,7.831164852,109720,651,5,11335,14373,3038,385582,505399,119817,6111,7921,1810,0,85.33134773,Arch
44bafc3e0340c60d78d533959aebc79e409f3ff1,727,28798,10890,17908,252,20,272,1,81,0,14,136,7.831350894,91833,698,20,14202,11489,2713,498738,391917,106821,7828,6194,1634,0,85.3189377,Arch
b47be19b5fb3b4828795b1041b23f85dc236a4e1,727,10900,28808,17908,20,252,272,1,66,0,14,136,7.832859836,109741,653,7,11335,14377,3042,385582,505436,119854,6111,7922,1811,0,85.3189377,Arch
eb19487b669838127429e5e1e0c50fe1391b20af,727,28798,10890,17908,252,20,272,1,81,0,14,136,7.831350894,91835,0,0,14203,11490,2713,498759,391938,106821,7828,6194,1634,0,85.3189377,Arch
b53e51061c67b8bc2549691e40767c428f13fff8,727,10900,28808,17908,20,252,272,1,66,0,14,136,7.832859836,109743,654,8,11336,14378,3042,385603,505457,119854,6111,7922,1811,0,85.3189377,Arch
ad8c06116b3555404d935113be78ce108e02df23,727,28798,10890,17908,252,20,272,1,81,0,14,136,7.831350894,91835,703,25,14203,11490,2713,498759,391938,106821,7828,6194,1634,0,85.3189377,Arch
8780dba3f4fff19ee86e36957092e01777930316,727,10900,28808,17908,20,252,272,1,66,0,14,136,7.832859836,109743,655,9,11336,14378,3042,385603,505457,119854,6111,7922,1811,0,85.3189377,Arch
167f99a3a1f17a83aec2ff4e31a5a096bcb72909,728,29075,11010,18065,253,21,274,1,81,0,14,136,7.846933547,91835,328,34,14233,11501,2732,499591,392191,107400,7839,6203,1636,1,85.84528568,Arch
49abc1b954e754e804f2366713ae995f3346c01b,729,11025,29135,18110,21,253,274,1,66,0,14,136,7.848708041,110028,656,10,11346,14441,3095,385882,506997,121115,6120,7959,1839,0,85.84528568,Arch
4089d75fb74d7dbbb49434063a2e1be558442a7f,731,29126,11018,18108,253,21,274,1,82,0,14,136,7.848313173,92363,333,39,14280,11539,2741,502306,394771,107535,7870,6228,1642,0,85.84528568,Arch
84eb9f8b6975ccdf1fe7aa7c666fcc59ceb91ac7,26,416,130,286,2,0,2,2,40,252,1,11,3.697463546,8223,340,43,1190,1160,30,37096,36028,1068,734,712,22,0,95.73396382,Arch
759fd2829ce147105c45962cb9d9d56bf5ff51c8,26,661,4033,3372,1,11,12,2,22,153,1,8,3.633486219,7411,350,49,642,1109,467,19128,36571,17443,332,538,206,0,94.0222606,Arch
985b4ce0df17acf06c8046b6e2ecb80f88c31713,29,415,197,218,1,3,4,1,84,155,1,7,2.687669005,4266,351,50,531,517,14,19542,18334,1208,300,293,7,0,96.36864068,Arch
2f1e430c26094e33573f20d761576d1316533767,752,12200,27839,15639,28,250,278,1,66,0,14,136,7.909914333,111298,733,18,11751,14457,2706,403445,507986,104541,6388,8072,1684,0,87.14898596,Arch
05de2b1f475ec37820ed7064119655b0f5c248f9,749,27835,12151,15684,250,28,278,1,84,0,14,136,7.901452334,95336,761,2,14272,11836,2436,502644,406610,96034,7938,6437,1501,0,87.1634803,Arch
0b9c3da7a4bf4da32b1fe4eb6775e3631fbaf510,757,12264,28521,16257,28,253,281,1,66,0,14,136,7.944322134,113305,659,13,12021,14737,2716,409177,514434,105257,6523,8210,1687,1,87.07509496,Arch
f7db42a8353b95279bedab6b3b9ba12f0569b24a,758,28538,12272,16266,253,28,281,1,84,0,14,136,7.942947922,97155,763,4,14607,12167,2440,510177,413723,96454,8128,6625,1503,1,87.07509496,Arch
dfdbfd0c1cb949b75275a6b3f718bdce27dd833f,760,12274,28559,16285,28,253,281,1,66,0,14,136,7.949324931,113634,734,19,12040,14758,2718,410163,515570,105407,6540,8229,1689,1,87.08483491,Arch
ec14f6569d7c9b0dcffbb799a7fa19aafa25a210,765,28677,12274,16403,256,28,284,1,85,0,14,136,7.954759819,97549,764,5,14648,12187,2461,512751,415275,97476,8167,6643,1524,0,86.23131393,Arch
1a3f54c93f54f946342cc307848bb29722bfe8ae,5,265,20,245,1,0,1,1,58,7,1,5,1.344023176,3926,765,6,561,541,20,17400,16117,1283,259,249,10,0,96.32613909,Arch
0ffac9b22bf4e856191b36d4b5d29b8145614ce9,766,12279,28869,16590,28,255,283,1,66,0,14,136,7.959460668,114270,735,20,12069,14834,2765,411321,518611,107290,6567,8292,1725,0,87.41898982,Arch
ebfe94e07771af083c583147671d6eb3e57a404a,766,28879,12281,16598,255,28,283,1,85,0,14,136,7.957689456,97680,766,7,14687,12200,2487,514167,415620,98547,8193,6654,1539,0,87.41898982,Arch
cb9118e80ad729ce1e635cdd33172d4770eb9867,772,12349,28985,16636,28,255,283,1,66,0,14,137,7.971272991,115678,737,22,12136,14908,2772,417796,525441,107645,6611,8340,1729,0,87.29691419,Arch
e39a679d2ff30935261307f0baccb0daf7ae0a8d,772,28999,12357,16642,255,28,283,1,85,0,14,137,7.971069751,99042,721,39,14762,12267,2495,520962,422095,98867,8242,6698,1544,0,87.29691419,Arch
5ef2a30e91353d1064f67c609ca820d54dc144b8,772,12526,39976,27450,31,253,284,1,66,0,14,137,8.420082518,126646,660,14,12148,14940,2792,418258,526145,107887,6623,8358,1735,0,87.26315789,Arch
cb3becf3c4db10c952d14fda83de55bb30cac878,772,39980,12528,27452,253,31,284,1,85,0,14,137,8.418546197,99196,727,44,14788,12286,2502,521249,423051,98198,8253,6717,1536,0,87.26315789,Arch
4741136695f6871fa035c44c65a59e0d1ffe829f,8,62,1,61,0,0,0,2,44,19,1,3,2.673408889,3268,383,61,573,563,10,15902,15608,294,385,379,6,0,96.09388533,Arch
ae73f860b99f30256a3f2b30d4e5bfdb0beec74e,25,616,502,114,2,0,2,3,35,246,1,8,3.106963639,5288,384,62,739,737,2,25194,24486,708,334,335,1,1,96.09614729,Arch
04c5a67344d0e8c7dab5c3ad95c44f279fe7ffc0,803,13361,41979,28618,33,260,293,1,66,0,14,138,8.455976355,130379,661,8,12458,15361,2903,427857,541743,113886,6789,8596,1807,1,86.96543944,Arch
4443d32e5d48bc8dbc4c1763697b9f96dd6c5200,804,41999,13374,28625,260,33,293,2,86,0,14,138,8.456110658,102103,745,46,15268,12662,2606,538398,434322,104076,8505,6903,1602,0,86.96543944,Arch
64669eda8b6483c97163fdbbdb48f6ff0461bfb3,811,13563,42619,29056,33,264,297,1,66,0,14,138,8.481231539,131319,738,0,12530,15461,2931,429961,545643,115682,6810,8627,1817,0,86.87365509,Arch
d301cea84c9c34d7b5769d5d6ff29e9dec33fc10,811,42624,13568,29056,264,33,297,2,91,0,14,138,8.478899216,102263,782,2,15308,12670,2638,540692,434826,105866,8522,6906,1616,0,86.87365509,Arch
538b23bdeb938eaa3a31c09e3f88c778f3512807,811,13557,42613,29056,33,264,297,1,66,0,14,138,8.480323206,131319,9,0,12530,15461,2931,429961,545647,115686,6810,8627,1817,1,86.87365509,Arch
98376dd3be560278aaa3af502bac89bc45ff28c2,811,42624,13568,29056,264,33,297,2,91,0,14,138,8.478899216,102263,9,0,15308,12670,2638,540692,434826,105866,8522,6906,1616,1,86.87365509,Arch
5dde5562a9115dae3700255f9a8f4c021bca7ebf,811,13567,42617,29050,33,264,297,1,66,0,14,138,8.480114664,131319,739,1,12531,15461,2930,429995,545647,115652,6810,8627,1817,0,86.87365509,Arch
e6d20f3932b556377218ac2e353a2cc99d26d1ea,816,43035,13628,29407,267,33,300,2,91,0,15,138,8.49371753,102549,761,1,15376,12691,2685,543686,436177,107509,8557,6922,1635,1,86.8202765,Arch
16f7f2f9a242b33e16204e9782bbe0dc2794e2ee,816,13617,43029,29412,33,267,300,1,66,0,15,138,8.495489437,131961,155,0,12551,15529,2978,431312,548687,117375,6826,8662,1836,0,86.82162605,Arch
2b0bd44cbbd5b917098c05d114c258238374e63c,816,43040,13628,29412,267,33,300,2,91,0,15,138,8.494076246,102549,764,3,15376,12691,2685,543732,436177,107555,8557,6922,1635,0,86.82162605,Arch
fb72e6cc7281aab7c54a3e143249671020d712a8,816,13613,43027,29414,33,267,300,1,66,0,15,138,8.495030807,131961,663,0,12550,15529,2979,431303,548687,117384,6826,8662,1836,1,86.82162605,Arch
9f7fff73652871d2db2f3c263177a11f0315e6d0,816,43038,13624,29414,267,33,300,2,91,0,15,138,8.493617585,102548,783,0,15377,12691,2686,543741,436177,107564,8557,6922,1635,1,86.82162605,Arch
148a2a0437c22c57e1c4074b0ebcebb6b39d8424,816,13613,43028,29415,33,267,300,1,66,0,15,138,8.495102261,131963,664,1,12551,15530,2979,431312,548696,117384,6826,8662,1836,1,86.82162605,Arch
6641ef3ae7e76d672700f6fc7e862b3fa8e12713,816,43039,13624,29415,267,33,300,2,91,0,15,138,8.493689047,102548,767,2,15377,12691,2686,543741,436177,107564,8557,6922,1635,0,86.82162605,Arch
87f75b2de77aa57c4e708cee181725ade8227ca4,7,384,143,241,2,1,3,6,15,278,2,2,2.200438137,891,776,8,176,147,29,4878,3874,1004,89,79,10,1,95.93213984,Arch
7fe3d964feb0eb7b30598fb00b6d9d857de5acdb,823,13690,43492,29802,33,269,302,1,66,1,15,139,8.512784998,133530,742,0,12706,15729,3023,436038,554927,118889,6882,8738,1856,1,86.53909601,Arch
415f35b2081321db85bcc9f2d382c74887b9aa06,823,43502,13700,29802,269,33,302,2,91,2,15,139,8.511257039,103728,784,0,15576,12846,2730,549972,440903,109069,8633,6978,1655,0,86.53909601,Arch
dc8cd476694af283e8fd0e80234b2c324cac4f22,823,13745,43572,29827,33,269,302,1,66,1,15,138,8.514688162,133592,156,0,12727,15758,3031,436646,555569,118923,6884,8739,1855,0,86.53909601,Arch
8f8ff58f8ce0b3b117ac9dbf68aac1811b36e605,823,43583,13756,29827,269,33,302,2,91,3,15,138,8.51328972,103765,790,6,15605,12867,2738,550614,441511,109103,8634,6980,1654,0,86.53909601,Arch
4161819944641cebd15b015c3a06aaa55aded4a8,835,13982,44021,30039,33,271,304,1,66,1,15,139,8.544325712,135563,157,1,12874,15924,3050,444640,564834,120194,6964,8824,1860,1,86.42369522,Arch
4474eb8a1b3e376af5ad14a5a69e7bcc97480f23,835,44029,13993,30036,271,33,304,2,91,9,15,139,8.542839363,105524,165,1,15771,13014,2757,559879,449505,110374,8719,7060,1659,1,86.42369522,Arch
e5a41a148acdaa3fdc535667ed88b25b18e56997,841,14136,44168,30032,33,271,304,1,66,2,15,139,8.55576108,135985,158,2,12917,15967,3050,445940,566134,120194,6994,8854,1860,1,86.44160985,Arch
8f764144143ab687c5958d930ff14e9e89574a93,841,44181,14149,30032,271,33,304,2,91,12,15,139,8.554683809,105953,51,0,15814,13057,2757,561179,450805,110374,8749,7090,1659,1,86.44160985,Arch
6fcaaaed925448d7df49e874a9daa89fd93e3443,841,14136,44168,30032,33,271,304,1,66,2,15,139,8.55576108,135985,35,0,12917,15967,3050,445940,566134,120194,6994,8854,1860,1,86.44160985,Arch
78761dde4e1f462c08cb228e71b4854624796eb7,841,44181,14149,30032,271,33,304,2,91,12,15,139,8.554683809,105953,791,14,15814,13057,2757,561179,450805,110374,8749,7090,1659,0,86.44160985,Arch
a9223e42ebc04d420b2e62e9e57450408ee9f513,849,14390,44413,30023,35,272,307,1,66,2,15,139,8.574331874,136980,160,4,13058,16120,3062,450233,570867,120634,7062,8925,1863,1,86.34714741,Arch
0ef421d14ab9b43dbcfc8d10588d55b33ca4b038,846,44288,14265,30023,271,34,305,2,91,13,15,139,8.562130404,106792,168,4,15943,13188,2755,564977,454695,110282,8813,7156,1657,0,86.38012532,Arch
ec6e6a55a7477dc67d7dc4cd42f9caa64f8de654,12,497,93,404,2,0,2,3,94,260,1,3,3.257749758,3447,792,0,571,511,60,16625,15084,1541,289,242,47,1,95.67241852,Arch
eb9f1d02c727c7ce5cb5980a7370ab591b82c37a,902,14381,45292,30911,34,274,308,1,66,2,15,145,8.644666549,148525,36,0,14424,17626,3202,502422,627078,124656,7679,9619,1940,1,86.50501838,Arch
56be6b93d3ef52270e5ea4e889dc506188f430d5,903,45314,14394,30920,274,34,308,2,94,47,15,145,8.644556436,117702,807,13,17483,14577,2906,622531,507811,114720,9516,7780,1736,0,86.50501838,Arch
08b638da13f8efafd53bbd6c2570663ead88373e,903,14325,45237,30912,34,274,308,1,66,2,15,145,8.644502104,148622,37,1,14435,17638,3203,502873,627578,124705,7683,9623,1940,1,86.50501838,Arch
dd1d6601492e3d16a22e7de3d3762f0663dc83e3,907,45735,14342,31393,277,34,311,2,94,48,15,145,8.656902564,117822,421,26,17552,14586,2966,624599,508203,116396,9547,7788,1759,0,86.45347105,Arch
bb4a890b7a80c42709ee86983a972437cc7574d4,908,14326,45719,31393,34,277,311,1,66,3,15,145,8.658245169,149460,38,2,14482,17745,3263,504278,630683,126405,7709,9672,1963,1,86.45347105,Arch
7029d9b058282cd114afcf52fede7b7dd168f434,907,45735,14342,31393,277,34,311,2,94,48,15,145,8.656902564,117822,52,0,17552,14586,2966,624599,508203,116396,9547,7788,1759,1,86.45347105,Arch
2438ada6ade5b314016255b32fcb27f8004afbc4,4,329,122,207,2,0,2,1,2,126,1,2,1.886936867,364,438,4,68,46,22,2626,1634,992,41,24,17,0,96.90471918,Arch
993f78caac9dfb63ab2e89e1eab51ad9195eb243,2,120,116,4,0,0,0,2,16,62,1,2,0.656540281,954,439,5,155,155,0,5272,5053,219,72,70,2,0,96.96724989,Arch
9b5acf4fa166467b5846a810aca4ad0c976ccaf5,930,15260,48255,32995,34,289,323,1,66,3,15,147,8.707281202,152208,39,0,14612,18057,3445,507349,640838,133489,7796,9875,2079,1,86.10917074,Arch
8f6fac7f1b8d90c2b979a989a667823df2afafd5,929,48259,15292,32967,289,34,323,2,97,55,15,147,8.706185223,119033,795,2,17874,14725,3149,634999,511487,123512,9755,7879,1876,1,86.10917074,Arch
97a591f08f01666f4e9e3fa132d74ff86abe2faa,1,9,14,5,0,0,0,4,47,12,1,1,0.0,678,797,4,135,135,0,3497,3534,37,71,71,0,1,95.43502614,Arch
3b73e602335bfa26dfe164ceb10f300f10e1134b,3,18,12,6,0,0,0,2,31,40,1,3,1.241946032,959,804,11,152,152,0,5248,5200,48,72,73,1,1,94.86006172,Arch
35ba427ec963c8b29401599e67c4042894a8ae69,2,274,229,45,0,0,0,5,44,13,1,2,0.259173896,2123,449,14,384,367,17,11989,11571,418,135,133,2,1,97.05570854,Arch
230a86c4897e10fbc5e7384b064cc526395d47e5,1406,21014,23257,2243,0,0,0,1,101,0,1,120,8.058156963,184356,814,13,18864,18864,0,715347,716613,1266,11439,11439,0,0,95.27949055,Arch
74a7a8bbfc8012bf0842b1eec891a8545f9944cb,724,3525,4208,683,0,0,0,1,102,13,1,106,8.806480101,108360,817,16,11337,11336,1,433675,433457,218,6484,6483,1,0,93.01081389,Arch
625cd7cdb6e503eceb70cb4f8266775c36aa448a,3,12,7,5,0,0,0,2,6,24,1,1,1.557431962,676,466,6,103,102,1,3733,3701,32,60,59,1,0,94.67005076,Arch
6d8e2c5b3a4054f537308a5be9eac9254a57a17a,77,1321,757,564,6,1,7,2,104,0,1,29,4.660277867,21958,467,7,3062,3006,56,102147,99937,2210,1616,1572,44,0,97.46152309,Arch
960f4a7706ca4fdae9a51df5578089e8cba0f891,1892,57087,91749,34662,36,321,357,1,66,0,16,185,9.844158206,243630,41,0,22637,26512,3875,833738,983955,150217,12990,15352,2362,1,84.73917869,Arch
d97054b1c236b152cf3503b2e0eb61b9dd6b3a72,1892,92141,57479,34662,321,36,357,2,105,0,16,185,9.837074538,208968,54,1,26443,22709,3734,981525,836225,145300,15294,13049,2245,1,84.73917869,Arch
197845c0466575c9018bfac1b86e4d5c8b4d38f2,1901,57209,92569,35360,38,328,366,1,66,0,16,185,9.855107203,244514,743,0,22659,26668,4009,834501,988331,153830,13001,15436,2435,0,84.61964345,Arch
0d0dd4587dea3e49d5976ddecf34c81c256e5ea2,1901,92962,57602,35360,328,38,366,2,106,0,16,185,9.848101197,209154,472,4,26561,22768,3793,984930,837975,146955,15355,13083,2272,0,84.61964345,Arch
5f968392593ca773a949c1bbdf1537cb0a3af5c0,13,1086,0,1086,13,0,13,1,1,0,1,2,3.524834825,0,836,8,77,0,77,4741,0,4741,58,0,58,0,93.50850077,Arch
16556f17aaf2b98e7d364627cefae35d91e26671,1909,57393,93241,35848,40,336,376,1,66,0,16,186,9.86253107,245002,744,0,22659,26715,4056,834503,991896,157393,13001,15470,2469,0,81.96202532,Arch
3d024d6b4f6f72b5d731d3242699d5325160ca43,1909,93623,57768,35855,336,40,376,2,108,0,16,186,9.856021626,209154,847,6,26598,22774,3824,988081,838286,149795,15386,13086,2300,0,81.96202532,Arch
f06585433b693562f83cbad3a4cb286dc1ea9718,1920,57468,95050,37582,40,347,387,1,66,0,16,189,9.875694351,246733,42,0,22659,26902,4243,834479,998885,164406,13001,15577,2576,1,81.6260745,Arch
2cb21198141c8980a0d84b697809053a6ad36f35,1920,95505,57851,37654,347,40,387,2,110,0,16,189,9.868148545,209151,515,23,26796,22774,4022,995491,838262,157229,15496,13086,2410,1,81.6260745,Arch
fe8bc3317c5362c1634253f13659f6a500cbf796,1,121,101,20,0,0,0,3,27,93,1,1,0.0,285,854,2,53,50,3,1257,1125,132,25,27,2,0,94.44260668,Arch
a08344e04d8e10763d355974f53c7a0a12a2b8e7,1924,57622,96969,39347,40,351,391,1,66,0,16,189,9.872302025,248497,0,0,22659,27173,4514,834462,1007018,172556,13001,15708,2707,1,84.18041064,Arch
7bd2cbc9af33c4a60035d27cac5f451a4b8ee109,63,5016,546,4470,22,1,23,3,134,301,5,27,4.024080588,12387,39,10,2475,1912,563,76213,55647,20566,1121,881,240,0,95.54047504,Arch
456a2ba5cf570b4b6d61893c54bbb1b58b677405,83,16176,0,16176,83,0,83,1,1,0,1,16,5.674999312,0,1102,1,2085,0,2085,74527,0,74527,1011,0,1011,0,95.19619501,Arch
d7f34d9a6f544549cbfa3b86fc9400a2f6d18223,7,378,19,359,1,0,1,1,135,302,1,5,1.043365269,2245,73,4,396,378,18,12710,11047,1663,150,142,8,1,96.20499029,Arch
301203e6254aae3f792ddd4bc0ffea904fab61f5,122,12087,16,12071,110,0,110,4,83,69,1,8,6.611554675,4462,74,1,1352,654,698,64531,21577,42954,847,278,569,1,94.87235277,Arch
63e3f41af28db87f80bc68823d8a9b2e469ab408,22,536,242,294,2,0,2,1,136,721,1,12,3.221822179,6751,931,2,978,952,26,31981,30628,1353,449,444,5,1,95.93812116,Arch
f62737be7caa75e179dee1f6b081632668dd06af,32,64,3748,3684,0,21,21,1,3,77,2,12,4.044093685,6154,1108,0,285,743,458,13688,31203,17515,153,347,194,0,94.44804894,Arch
3b08860f10a12b8753e24756cf66f4a8d66b270e,128,12147,53,12094,110,0,110,2,140,55,1,9,6.651915216,11736,93,5,2224,1530,694,91017,47766,43251,1282,709,573,1,91.40651225,Arch
675afd696210db795532a09747244c56e2f0909f,1,161,0,161,1,0,1,1,1,0,1,1,0.0,0,97,8,15,0,15,846,0,846,7,0,7,0,94.93421053,Arch
b514d3fb4b71621ea0cbc180ba0e64534d0d4621,11,863,165,698,6,0,6,1,20,653,1,2,3.125670973,819,71,4,174,121,53,6168,3862,2306,94,59,35,1,97.88494078,Arch
d185430ffeadeea3a188019184e5c80b3b2a8bf4,7,250,58,192,1,0,1,2,72,626,1,4,2.532911225,1918,82,4,337,321,16,10741,9812,929,128,110,18,1,97.42830424,Arch
a49ba6c040f3ac07694cf7d8eb54a5c914c28494,5,158,60,98,2,1,3,4,18,723,1,3,1.787181231,409,92,10,61,54,7,1985,1739,246,26,24,2,1,94.54005935,Arch
36eaff08aefe22ebee8db212ea6ff001f9c6dd93,607,3046,53675,50629,7,343,350,0,144,40,15,116,8.412619602,124706,1,0,9875,14476,4601,335757,550373,214616,4875,7604,2729,1,88.20487963,Arch
d20da4460d914ff771a2de1e2e76a2182088c512,607,53697,3053,50644,343,7,350,1,151,248,15,116,8.412248764,74077,118,6,14466,9880,4586,550002,335955,214047,7599,4879,2720,0,88.20487963,Arch
d2dbe18cfbb36b6df142bb94c0c80396571084fc,607,3054,53801,50747,6,344,350,0,144,39,15,116,8.414467274,124800,2,1,9874,14483,4609,335706,550781,215075,4874,7608,2734,1,88.18159787,Arch
b97dbff52ac698284cb1a232b8a94b711717522c,608,53831,3059,50772,344,6,350,1,151,251,15,116,8.416335748,74140,198,13,14483,9886,4597,550808,336225,214583,7608,4882,2726,1,88.18159787,Arch
0101b8879ce30e3007ba8b86b2e52bbd514ec4ad,14,0,2035,2035,0,14,14,2,12,1655,1,3,3.585319061,2035,1151,15,0,260,260,0,10263,10263,0,161,161,1,94.63134042,Arch
d9145485593e8cc23327a7ad0c6692b4ca4369ce,299,22007,1090,20917,156,0,156,3,178,373,10,75,7.471739385,48546,390,1,8829,7090,1739,317394,228738,88656,4654,3526,1128,1,92.41226952,Arch
9822d58d04abe22f059b85b418478a4f80592322,3,107,1,106,1,0,1,3,27,281,1,2,1.246162111,455,396,6,89,80,9,3138,2593,545,30,25,5,1,97.81669677,Arch
c22ea7fab0f3b08fb515146a144047e730f33afc,1,31,10,21,0,0,0,2,2,3,1,1,0.0,39,37,0,8,2,6,242,90,152,2,2,0,0,97.82489203,Arch
05f82a9b6d74f4bc88517a78b934b781a2baa706,9,291,85,206,0,0,0,1,124,811,1,5,1.621807921,3337,398,3,565,543,22,19877,18632,1245,178,165,13,1,95.45667082,Arch
789789f06b8af1c1a9abd1631dcb8ebfafb0bceb,5,282,6,276,1,0,1,1,23,909,1,4,1.324336092,526,333,12,85,59,26,3819,2227,1592,49,33,16,1,97.1571769,Arch
f206410b3da9e690b815ee88090644f9b66510e7,2,142,0,142,2,0,2,1,1,0,1,2,0.967559482,0,405,6,4,0,4,579,0,579,3,0,3,1,96.30008525,Arch
c3a64a8eb30cf9368dba12ce3d02c72d39a9641c,2,77,13,64,1,0,1,1,12,596,1,1,0.595761097,144,420,11,6,4,2,758,531,227,6,4,2,0,96.24737579,Arch
a34c80858e17ad8e2b627b33836514ad651a8c6f,1,106,0,106,1,0,1,1,1,0,1,1,0.0,0,356,11,6,0,6,540,0,540,3,0,3,1,96.09450763,Arch
3af93f18984053f67ea929a24ef4acb61dad3a51,4,39,140,101,0,0,0,1,4,505,1,2,1.176922104,493,357,12,31,32,1,2008,2611,603,12,13,1,1,96.09519612,Arch
eb6fec879fc14a7fb9b45610eeeae3ab254713bf,5,180,99,81,2,1,3,3,6,111,2,3,1.949890631,388,360,15,46,44,2,2377,1730,647,14,14,0,1,97.2255288,Arch
8b6a0c7237a61353b9947c43e7a52e8d82955738,1,136,0,136,1,0,1,1,1,0,1,1,0.0,0,361,16,26,0,26,623,0,623,10,0,10,1,86.1754733,Arch
1a5ad284ed67d1742237c337072635f29aae5f9c,43,524,232,292,0,0,0,2,184,713,1,16,4.805879615,24057,1068,4,3668,3619,49,108842,107106,1736,1900,1871,29,2,96.26646754,Arch
c14dc3a06fb4b25db3e69f232ea565a4ff161824,8,538,125,413,2,0,2,1,117,675,1,1,2.017530639,5306,1083,12,832,779,53,21495,20298,1197,397,372,25,1,97.25654822,Arch
00879cf6836ee20da9796d5475593889f370d661,34,637,273,364,4,0,4,1,186,976,1,9,4.005561786,10152,1085,14,1752,1706,46,43990,42217,1773,873,836,37,1,97.31257064,Arch
9807ee3253200e8ed25407d95bf06ec13ee7be8a,6,604,21,583,1,0,1,8,55,979,1,2,1.745718784,1852,14,0,174,142,32,14754,10650,4104,97,78,19,1,96.50402893,Arch
a6a6a708ff26c8ddba966107d2add4186e173ba4,36,994,259,735,1,0,1,1,96,536,1,22,3.493459741,16295,463,9,2508,2429,79,84006,80325,3681,1228,1178,50,1,96.23550288,Arch
f206a1bd11dfe8265faacfdbbb74113894069d28,9,536,372,164,1,0,1,1,49,588,1,8,1.354799351,4140,480,11,536,520,16,24306,23478,828,238,228,10,1,96.03535853,Arch
9ecc679b3864dc37b3ec6be104ce2634d0ca033f,5,121,19,102,1,0,1,2,13,900,1,4,2.046916615,384,481,12,37,31,6,2230,1730,500,25,19,6,1,93.70187191,Arch
6b4509cdea61f78c2ecc013929c8c54da0f38341,9,680,32,648,6,0,6,1,97,56,1,4,2.866045154,2901,484,13,579,513,66,19340,16158,3182,209,165,44,1,94.43498358,Arch
7a7b380def879593935759308fa5bd3978fdb01a,3,27,56,29,0,0,0,2,12,658,1,2,1.22716963,635,629,14,51,56,5,3273,3419,146,30,32,2,0,95.6570784,Arch
a6c51a45322dd59973cc7743aed7790258aac209,4,151,28,123,1,0,1,1,74,7,1,2,1.525117251,4118,677,16,632,622,10,22948,22369,579,318,313,5,1,96.28458936,Arch
6595dc4a62d53744a4ba3fa5ff3841280ecbd1ab,3,139,8,131,1,0,1,1,44,22,1,2,0.55558131,515,31,3,92,85,7,2411,1985,426,48,45,3,1,94.94328277,Arch
56f8e368d5c3002695d896b9556fbfd9b2744749,2,201,9,192,1,0,1,1,21,14,1,2,0.438057285,171,36,8,45,29,16,1699,753,946,21,11,10,1,92.89389515,Arch
f38908eb52380688aff3c73406d9ac1b32ce28bb,4,208,11,197,1,0,1,2,198,32,1,4,1.664015856,3240,686,11,583,565,18,16197,15133,1064,310,298,12,1,92.89040239,Arch
93e2bd355b6320b1a105620617d1e4260721d3ca,7,66,21,45,0,0,0,3,68,36,1,4,1.855131139,1158,690,13,181,172,9,5077,4836,241,78,74,4,1,94.3097272,Arch
008b3e551c1d8763cbfaa5e18cf7cb6dc1932366,3,243,1,242,2,0,2,1,23,67,1,3,1.060340507,461,582,9,141,114,27,4040,2718,1322,82,58,24,1,95.41234595,Arch
e10f75c33d57041083c95d08dd16635eeafe4ba9,122,969,46,923,110,0,110,1,140,25,1,9,2.657881189,6979,709,12,1786,1103,683,76355,33303,43052,1032,466,566,1,88.89081656,Arch
88c10842dff97f7a8e599cae09a993ea91a4a34b,9,229,12,217,2,0,2,1,55,77,1,4,2.992857857,2802,711,13,380,354,26,16529,15317,1212,199,185,14,1,96.98104555,Arch
c42d8de03489baa6d6d5a3c6af42324bf4e0f37b,3,11,10,1,0,0,0,5,202,35,1,3,0.892942742,4288,714,15,753,753,0,19941,19927,14,369,369,0,1,95.39017776,Arch
cd2c5dd3d040b039cc611773dcf0f063e01df68a,2873,399761,0,399761,2873,0,2873,1,1,0,1,235,10.85032037,0,725,22,42679,0,42679,1733430,0,1733430,24018,0,24018,0,58.63857884,Arch
063285ca8e142480b435c2c294f5163d1afddd5a,2873,0,399761,399761,0,2873,2873,1,2,0,1,235,10.85032037,399761,726,23,0,42679,42679,0,1733430,1733430,0,24018,24018,0,58.63857884,Arch
f33f32e892e8b40e0cd4888aadef9b3035265611,700,27417,6923,20494,317,5,322,1,224,164,14,109,7.807564383,104153,173,17,17297,13891,3406,680281,491772,188509,8909,6810,2099,1,84.89157712,Arch
0b6bf7ec1ba9df68ae6492408d482c984849c31c,5,804,23,781,2,0,2,1,129,7,1,3,1.534038752,4947,206,23,764,707,57,22950,18815,4135,375,349,26,1,97.92956126,Arch
89f22dacac4d786c04d4b0fe3ab7b6ae6d3b3557,8,182,275,93,0,0,0,4,99,81,2,4,2.068565716,6205,892,8,983,989,6,34387,34714,327,439,434,5,1,96.03263762,Arch
32d3fd51b4aa8ce4290cf2389d1bdb2ca34d8d3f,6,98,72,26,0,1,1,2,64,19,1,2,2.186599243,1518,969,6,203,194,9,8841,8695,146,77,67,10,1,96.7416602,Arch
0b01996efb0e1866415a8bee694daafd684b6ca8,4,28,26,2,0,0,0,5,131,700,1,3,1.877722275,1810,27,24,338,337,1,9799,9784,15,123,122,1,1,97.05409748,Arch
1802116df8831a86ab538e94310921cc9bc1cef1,9,233,117,116,1,1,2,3,32,820,1,2,2.425037829,946,69,43,156,132,24,5684,5124,560,57,55,2,1,96.74021802,Arch
8dc1c1240b6a7afd1c2d14e4b4a7b067081e9787,3,318,33,285,1,0,1,1,78,362,1,2,0.921154304,701,428,9,146,125,21,5747,4230,1517,53,42,11,1,90.03548196,Arch
c43b5e5ef45c631c30947f01df013910a43b71cf,3347,457503,0,457503,3345,0,3345,1,1,0,1,250,10.96343435,78,813,7,49621,2,49619,2112602,236,2112366,27849,2,27847,0,61.85824896,Arch
3576fbe97a8eacb6d9ab8a31b84d7369ff1f4c48,3347,0,457503,457503,0,3345,3345,0,1,0,2,250,10.96343435,457581,816,10,2,49621,49619,236,2112602,2112366,2,27849,27847,0,61.85824896,Arch
c43b5e5ef45c631c30947f01df013910a43b71cf,3347,457581,0,457581,3347,0,3347,1,1,0,1,250,10.96411445,0,813,7,49621,0,49621,2112602,0,2112602,27849,0,27849,0,61.86807514,Arch
0b0ed9f84da0c9de632fcf2706629d1f5ebf0e63,3348,37,457509,457472,0,3345,3345,0,5,0,3,251,10.96379678,457735,826,20,15,49631,49616,1219,2113392,2112173,8,27853,27845,0,61.8453469,Arch
1005fc50628d18a2536cec3ebad337d62d0035b8,9,62,50,12,1,0,1,3,118,1397,1,3,2.405084508,2548,1022,10,419,423,4,14608,14585,23,177,178,1,1,91.31428571,Arch
cdd5150340e69a27402fdf73d1726299b0b30854,22,2297,0,2297,22,0,22,1,1,0,1,2,3.641228485,0,1204,3,166,0,166,7635,0,7635,86,0,86,0,97.39429918,Arch
b24dfb908b902caca1aa350b815a0e1ceb1922f1,4,230,17,213,1,0,1,4,13,354,2,3,0.580087047,2119,1026,14,333,313,20,11455,10309,1146,143,128,15,1,97.70687936,Arch
0fffe2172005f337412d5ec172cd92822395e239,12,173,121,52,0,0,0,3,46,1685,3,10,2.945604196,1660,446,9,189,182,7,6461,6331,130,117,110,7,1,92.35441977,Arch
e6285b74267903476b90e1fc826fd8ac8788f698,4,213,40,173,2,0,2,1,5,5,1,3,1.783080349,211,455,15,38,21,17,1829,998,831,23,8,15,1,90.39452977,Arch
cfe5e98da30193c70befcba461213edfa8f0f71a,10,2656,0,2656,9,0,9,1,14,130,1,3,2.878436992,162,1220,7,280,24,256,9100,653,8447,120,7,113,1,93.82589111,Arch
539781ceef979a0eda08b452de7a1b3c626c7e6d,1,0,98,98,0,1,1,4,10,136,1,1,0.0,98,468,22,0,10,10,0,377,377,0,4,4,1,95.65024658,Arch
1aab71b2a7f6402b8b8749cfe8a5806f99f546cd,91,319,1472,1153,0,10,10,1,252,407,1,22,4.832328768,29479,1233,19,4043,4217,174,148159,152407,4248,1908,1985,77,0,88.38032787,Arch
9a8f6e415db43a4e43ad42a87b3617b3641aa07d,1013,259,304,45,186,0,186,3,254,46,8,67,5.281725562,135773,1238,24,15904,15897,7,625158,626235,1077,9710,9705,5,0,73.87761042,Arch
58aca869816e893e7a2f34f0708c1d7fcbdca0f5,396,3,82,79,0,1,1,2,33,59,3,42,2.500086592,65889,1239,25,9008,9011,3,274908,275380,472,4665,4666,1,0,84.65708522,Arch
c5cf03806d646045e01f6cd382504fa73dedfeee,243,3,882,879,0,7,7,1,15,65,7,24,2.317816216,54014,1240,26,7460,7566,106,248493,251718,3225,3759,3824,65,0,88.79129828,Arch
9c39f4e40a2f4ef842e8b5e570232358e752361d,376,0,0,0,61,0,61,1,1,0,1,1,0.0,46361,1242,28,3444,3444,0,211064,211064,0,2814,2814,0,0,90.03813155,Arch
9a1ad8c8b32a90ec45bb4ade507bc0168550e259,53,0,61,61,0,1,1,2,5,108,3,18,0.0,5654,1252,34,597,605,8,24661,24928,267,362,364,2,0,94.13115478,Arch
6010bd3d979bb1547cb066491e91bc89b45391c2,10,0,0,0,0,0,0,1,1,0,1,4,0.0,2297,496,30,211,211,0,14660,14660,0,89,89,0,0,97.09260437,Arch
54a11b96dec51ec0a2c6bca9f5b76b4baa2755f4,16,0,0,0,0,0,0,1,1,0,1,5,0.0,2521,497,31,286,286,0,13314,13314,0,149,149,0,0,96.19821709,Arch
3016b392493a8eb55e57ce9e730c1b3de4caf36e,16,118,1056,938,0,11,11,2,24,100,1,4,3.478016114,2669,1276,6,207,342,135,8294,13002,4708,69,116,47,0,97.20884713,Arch
a1a973ca340a408dad358ab250c24d0a73736f12,2,122,3,119,1,0,1,2,3,0,2,2,0.242292189,468,527,17,93,85,8,3086,2513,573,50,44,6,1,95.09540068,Arch
69d825830811e0088bfe61f57794defa2331e0d7,2,1,3,2,0,0,0,2,13,96,1,1,0.811278124,3010,1070,1,529,530,1,13204,13214,10,253,253,0,0,96.03040154,Arch
63a660ac04affba1d6f48da21b5de80b63a31a0a,9,368,144,224,1,0,1,3,15,41,1,3,2.348504031,5095,573,33,926,896,30,25639,24711,928,478,450,28,1,96.02301151,Arch
7d7d6fa08a9831d81b18a9818dc4bb0d962336ac,10,30,30,0,0,0,0,7,51,0,2,4,2.64860373,6577,1079,9,1007,1007,0,34039,34039,0,516,516,0,0,95.85267256,Arch
6e363216693a83225df878dc6b38027759b6101b,5,0,488,488,0,4,4,5,8,1411,1,2,2.011396037,487,584,44,0,41,41,0,2225,2225,0,25,25,1,95.8741643,Arch
ef24cc9a045da960161fd0ee9f6839b2164e9333,1264,0,346,346,138,4,142,1,7,6,2,71,1.90452176,149384,616,22,11902,11939,37,723683,724734,1051,6886,6909,23,1,70.25072088,Arch
7e87cf26851c149c84d1fe8ef633f371aa167ffd,3,75,20,55,0,0,0,2,4,90,2,2,0.485162354,875,1096,13,118,111,7,5074,4647,427,43,43,0,1,91.43572427,Arch
5219fa1a177aba188a48c0d2447dbad17ead9e1e,19,357,383,26,0,0,0,1,2,19,1,1,3.155935822,3812,643,38,337,338,1,18015,18046,31,150,151,1,0,92.93050414,Arch
fec73ddbc1376f3bc5b323829d0d407142cfad9c,1,6,5,1,0,0,0,1,3,45,1,1,0.0,36,1391,8,1,1,0,120,75,45,1,1,0,0,97.70180833,Arch
8f4ebbb40eec530669fed031a3fc397b490caac6,8,882,0,882,7,0,7,1,2,109,1,4,2.580026723,104,1175,1,124,12,112,4375,341,4034,79,7,72,1,92.18026797,Arch
56070afa01fe1720f1790699a9810e1d28b2d414,3,241,39,202,1,0,1,1,2,6,1,2,1.578712463,332,1179,5,63,56,7,1749,1338,411,43,41,2,0,92.20484799,Arch
0d98623b7b2d768e4374aead79e652856d6cbe5e,1,168,0,168,1,0,1,1,1,0,1,1,0.0,0,1180,6,25,0,25,589,0,589,16,0,16,1,97.20240749,Arch
f71e2fe21a93552bf762f63fc0dc6605499143f8,9,102,9,93,0,0,0,2,19,235,1,4,2.714498736,5562,1181,7,811,801,10,27414,27042,372,340,330,10,1,97.20860263,Arch
634a81898c4db442222ba58ec3ef779f2868dfd4,11,309,45,264,0,0,0,2,32,383,4,7,1.847224843,4464,0,0,750,702,48,23064,21334,1730,329,315,14,1,97.13492504,Arch
e1bbde7302d7d169bec978633d2dd85eba2e19cc,95,589,963,374,0,0,0,4,46,418,2,21,5.319156335,34187,15,15,5402,5554,152,162437,164494,2057,2370,2370,0,1,97.78847325,Arch
f88f2803ac0a2a984137caa86ca9ef2b1199fbe9,3,99,195,96,0,1,1,1,2,0,1,2,1.422293092,656,17,9,96,112,16,3124,3297,173,29,50,21,1,97.90729195,Arch
2ecf41d02f8f858ef1af91fc06e9c276bd667753,55,6807,1,6806,41,0,41,1,1,0,1,29,5.077864445,2116,28,20,984,281,703,38105,9801,28304,236,114,122,0,95.38976566,Arch
9494fe85966f4dc0993b7f9fd521f35a89b28f7a,229,1801,11837,10036,2,71,73,0,55,196,18,64,6.694178335,69071,48,19,7994,8978,984,288145,335606,47461,3654,4187,533,0,89.17444607,Arch
1999ddfd01a4ea12fbe73c2e2f93488590da23f7,229,11846,1806,10040,73,2,75,1,61,352,18,64,6.693486344,59037,231,8,8955,8026,929,334000,290032,43968,4174,3676,498,1,89.17444607,Arch
c5c1495330dbad20c2f25e4b44f017005fb97a42,2,100,0,100,1,0,1,1,11,169,2,2,0.286396957,822,123,3,148,140,8,4751,4274,477,44,38,6,1,92.61711361,Arch
bcb60a482cdc1cd2d2de9b4dba6a38ef831b2fa4,4,215,63,152,1,0,1,11,33,82,2,4,1.773866429,3080,2,0,427,412,15,19645,18807,838,121,111,10,1,94.34275145,Arch
a581d010aa96a5e98e107435a242fc55679042a9,5,145,19,126,0,0,0,11,34,25,2,4,1.312104198,4113,3,1,597,588,9,25480,24524,956,206,202,4,1,94.89879564,Arch
fc244f48e48596c668a7d9dc3b84c26e60693823,45,5559,958,4601,17,0,17,1,43,847,4,12,4.428951054,12039,168,16,2245,1789,456,78356,58500,19856,1185,942,243,1,91.72454226,Arch
07bfc1ef0e5887e7d4ec7c1e8768d2e0cca4e254,1,125,9,116,0,0,0,2,2,1182,1,1,0.0,47,172,20,17,6,11,434,182,252,6,1,5,1,88.7328231,Arch
b41f92127c30f0d185a8c0dde03788b32b270b5e,4,28,16,12,0,0,0,3,8,958,3,4,1.47312829,2021,138,13,289,285,4,10237,10123,114,99,97,2,1,96.61835749,Arch
e3d218a97ab3f502366b7cc1fc62fc212a5591c5,2,185,9,176,1,0,1,1,5,358,2,2,0.334767613,954,186,34,127,118,9,3752,2863,889,49,42,7,1,96.61851257,Arch
3424e04fad09ef69eaa72715669ebba40bb45019,45,937,5538,4601,0,17,17,2,44,0,4,12,4.439722706,16657,50,7,1791,2247,456,58534,78390,19856,944,1187,243,1,97.04549574,Arch
0d815642c1c441b3bbca69c4987430a14e28c441,406,25621,5199,20422,104,3,107,5,95,557,22,102,7.349989447,92899,22,6,14311,12156,2155,554733,455505,99228,7045,5882,1163,0,88.17769025,Arch
a2c5c22ec5e5f30816f0cf3d0f1d192267f7e25e,2,39,1,38,0,0,0,2,23,146,2,2,0.286396957,2182,245,20,331,330,1,11246,10991,255,129,128,1,1,92.21411192,Arch
a49d46e3ca689af6f2cb721c457be97d654b2492,6,242,53,189,0,0,0,1,6,372,2,4,1.90955772,891,26,8,94,79,15,5056,4186,870,61,51,10,1,93.51333553,Arch
c6542a921b7b9fd09ca965761cfb90f2cffca930,3,16,12,4,0,0,0,9,48,1,2,2,1.027058267,3778,5,1,636,633,3,22069,22043,26,246,246,0,1,93.51394572,Arch
95a9a8035145bea04126e924a38ba133a2d6f7e4,199,1869,8711,6842,3,57,60,0,63,380,16,62,6.743390292,54085,496,2,6585,7158,573,230823,259747,28924,2977,3329,352,1,87.8368131,Arch
e8a0d042d8897cffd904697ac8febae7824ddc18,203,8724,1876,6848,57,3,60,1,64,626,16,63,6.751030492,47601,504,3,7169,6596,573,261903,232968,28935,3340,2988,352,0,87.85580666,Arch
796397a7e9f2098968fb8889af082f98664fbe24,210,1889,9033,7144,3,59,62,0,63,386,16,65,6.794958796,56598,497,2,6788,7393,605,243762,274308,30546,3056,3419,363,1,87.85183688,Arch
e100638244c4ca5eb2a1f16bcdc671c9859c2694,210,9031,1892,7139,59,3,62,1,64,630,16,65,6.792986502,49454,160,3,7391,6788,603,274273,243762,30511,3418,3056,362,1,87.85183688,Arch
43c3cae2c069c98215e2c0f1ff19e883fd6c0b86,21,1932,332,1600,12,0,12,1,25,659,1,5,3.879898184,1423,66,9,205,119,86,16604,8018,8586,135,70,65,1,91.4202827,Arch
547914cabcc95e424640559c8bdbbd317bf399ae,243,2272,11141,8869,3,71,74,0,63,342,17,74,7.015545513,63590,2,0,7404,8115,711,267218,307180,39962,3392,3824,432,1,89.5073938,Arch
4d73b089230e40c003d16dbf2f3171f1e8bf07f1,243,11147,2278,8869,71,3,74,1,65,607,17,74,7.015557816,54721,508,5,8115,7404,711,307180,267218,39962,3824,3392,432,1,89.5073938,Arch
a0aa3583bc7f0a787471d894370809749cf2cbee,259,2343,12017,9674,3,76,79,0,63,356,17,75,7.088508051,67384,10,0,7846,8607,761,281704,325756,44052,3581,4044,463,1,89.40350547,Arch
014d5594d605515e84f935eea3fcd1a201648653,261,12222,2354,9868,77,3,80,1,65,587,17,77,7.098933282,58041,510,4,8671,7901,770,328874,283928,44946,4060,3590,470,1,89.28420161,Arch
42065035b66a48782b361528a82a6d2bd9abd9ba,259,2343,12017,9674,3,76,79,0,63,356,17,75,7.088508051,67384,498,1,7846,8607,761,281704,325756,44052,3581,4044,463,1,89.31911094,Arch
fd0f71a4c82f1189bed6bd31efa4b17c297816f7,261,12099,2359,9740,77,3,80,1,65,586,17,75,7.101336007,58251,400,7,8706,7945,761,328952,284582,44370,4093,3630,463,1,89.7323049,Arch
82a5839fc733c24cef6e2178b52d8fb649b69879,18,2706,406,2300,13,1,14,1,9,101,1,3,3.521322634,2022,511,4,557,274,283,17451,8185,9266,274,138,136,0,94.54389077,Arch
cc81680e10e5c7140ec3e28091df23e9d3c3233b,19,2072,3,2069,3,0,3,1,66,826,4,7,1.901236155,9213,70,2,1764,1557,207,53256,42835,10421,919,845,74,1,91.63036562,Arch
7875e978cdea617b22b95d40755b8f761a8be1f7,298,2763,17265,14502,4,94,98,0,64,324,17,81,7.073693684,80275,500,1,9190,10482,1292,320750,387152,66402,4295,4983,688,1,93.32021107,Arch
11ac3d9d85a32b5f58e9fdbdb11e9354dc9c689e,288,16083,2717,13366,90,4,94,1,66,576,17,80,7.002542233,63377,15,0,10039,8838,1201,367828,307736,60092,4842,4191,651,1,93.41229649,Arch
81ef5efdc749d9af2fc4150f92195132b1298423,296,2724,16406,13682,4,92,96,0,64,326,17,81,7.046463492,79073,262,0,9079,10304,1225,319758,381337,61579,4268,4933,665,0,93.39275253,Arch
934f3cea7effdff3b43ddabc9d0f03535fa44e5f,297,16438,2754,13684,92,4,96,1,67,596,17,81,7.054533203,67985,0,0,10646,9421,1225,390133,328548,61585,5115,4450,665,0,93.39275253,Arch
d9a79d172be3646ce64349fe4a0454df9e382424,296,2724,16406,13682,4,92,96,0,64,326,17,81,7.046463492,79073,0,0,9079,10304,1225,319758,381337,61579,4268,4933,665,0,93.39275253,Arch
ce5628a389b5491975fda0493ab9073cca6cb87e,301,16635,2737,13898,93,4,97,1,67,598,17,82,7.076029235,65821,16,1,10367,9120,1247,383588,321020,62568,4971,4288,683,1,92.35676972,Arch
e5c46df48c153129b6085301018ccda620d15ebc,307,2755,16536,13781,4,92,96,0,64,325,17,83,7.084473563,80228,12,0,9181,10422,1241,323361,385296,61935,4326,4998,672,1,92.35314266,Arch
cc6213ebf25a129b278a2ff0d7c32c25edd71eaa,298,16765,2791,13974,93,4,97,1,68,584,17,81,7.073067204,65784,76,6,10403,9156,1247,384083,320978,63105,5001,4329,672,1,92.83615914,Arch
a38c3d4b6b9a4e828c80e88dd5a33c86fae99a06,320,3029,18623,15594,4,104,108,0,64,309,18,86,7.240552228,84738,38,0,9564,10963,1399,337022,407586,70564,4503,5245,742,1,92.68323293,Arch
8f30866fdf89f25188a358f1b1c161b2f06de3f5,320,18640,3044,15596,104,4,108,1,68,526,18,86,7.242217807,69144,86,12,10964,9564,1400,407594,337022,70572,5245,4503,742,1,92.68323293,Arch
0a12bcb928f151b5ace9a0cffc34ec717b6a8e9c,16,616,82,534,2,0,2,4,30,1206,4,10,2.205686923,11855,406,5,1810,1758,52,50028,47054,2974,695,677,18,1,96.18918919,Arch
b547e46131baf31f1cad6c79b4a5444ae82842fc,284,3028,9768,6740,6,26,32,7,113,484,21,101,6.856653391,100729,578,7,11588,12279,691,473826,510046,36220,5310,5631,321,1,91.06036263,Arch
cd5ea6c27fa92a57dc68cd9632572a77b36c446c,285,9994,3034,6960,31,6,37,8,114,821,21,100,6.868871331,93993,675,5,12294,11588,706,511020,473826,37194,5638,5310,328,1,91.04888685,Arch
39184e2fb052fc73c69934890a16b333f1ea31d5,2,151,4,147,1,0,1,1,37,59,2,2,0.437545634,1695,195,16,328,320,8,9807,9083,724,117,111,6,1,92.69574059,Arch
a82bd3cf721e32272b2cf3dee3aa1afcc726c3cb,290,3052,10064,7012,6,32,38,7,113,477,21,101,6.925468548,102928,185,16,11810,12497,687,481550,518670,37120,5467,5797,330,1,89.82767003,Arch
4fc16630ea94a8eda96ffa99a8e559ca4355c02a,2,4,151,147,0,1,1,1,37,0,2,2,0.437545634,1817,186,12,309,317,8,8905,9629,724,108,114,6,1,97.02801996,Arch
e05db7cb5c82660d83e913fa6df77a9e23d0eb8f,293,10218,3055,7163,33,6,39,8,114,807,21,101,6.943359187,96805,680,10,12627,11932,695,522005,484129,37876,5870,5534,336,1,87.55896873,Arch
3953b9aaefaee914bdd0702f27aef47c021ceb27,74,10324,42,10282,66,0,66,1,50,195,3,6,5.964666004,4847,197,11,1492,808,684,64686,23717,40969,869,339,530,1,94.72230592,Arch
dd0ed17e59da3ac19f9e528c8b071322d3035404,4,256,6,250,1,0,1,1,83,67,1,3,1.506550911,5392,199,9,924,896,28,31570,30286,1284,339,324,15,1,91.4493885,Arch
1a598277cf76e9bace980dfa87982584b5879710,6,164,69,95,1,0,1,1,84,266,1,4,2.158717905,5837,201,6,964,950,14,33124,32487,637,349,346,3,1,91.21938904,Arch
e73ab348375db71116624326d29398e0088d7334,10,614,91,523,1,0,1,1,51,978,3,4,2.344529539,6180,208,13,920,853,67,35868,32816,3052,340,309,31,2,96.21315813,Arch
ccfed53c8dc2d5c552a698d82a46aca59e39ad8a,210,1007,11468,10461,0,29,29,3,115,973,19,72,6.14599803,90525,811,0,10708,11627,919,407021,466539,59518,4782,5178,396,1,91.68308076,Arch
cc0bcdd5dc6856c655d5e40e179db5b455a7efb1,210,11543,1073,10470,34,0,34,3,127,1746,19,72,6.167326546,80069,393,0,11632,10708,924,466664,407021,59643,5182,4782,400,1,91.44881596,Arch
1be7873a35aab1ee1d6f14b8c47def83cc56cd45,210,1006,11467,10461,0,34,34,3,115,967,19,72,6.145470257,90539,410,0,10713,11632,919,407146,466664,59518,4786,5182,396,1,91.44881596,Arch
d539ff77b96f3a8ae646c448c2eeba50c6684429,210,11530,1034,10496,34,0,34,3,127,1736,19,72,6.160003483,80078,394,1,11632,10713,919,467171,407146,60025,5182,4786,396,1,91.44881596,Arch
23af2edcc54e69721a4d2d2ef46c3fe9b37d5bb1,209,1002,11463,10461,0,34,34,3,115,965,19,71,6.141681548,90213,411,1,10690,11609,919,405306,464824,59518,4773,5169,396,1,91.44881596,Arch
ed4110175534f63e0fac834a63a05440d509752c,209,11671,1003,10668,34,0,34,3,127,1737,19,71,6.158014492,79752,785,0,11633,10690,943,465862,405306,60556,5184,4773,411,1,91.44881596,Arch
1a1cabdfcea80fc19ba3c8f7f6acedaeecda1d95,31,0,6783,6783,0,29,29,2,4,6127,2,16,4.72682931,6781,395,2,0,770,770,0,28380,28380,0,195,195,1,92.3425081,Arch
18e8ce18da0323809b3d5d68cb31c92ea2d14208,238,7687,11758,4071,29,34,63,1,115,920,20,86,6.575966512,90508,0,0,11452,11639,187,433368,466348,32980,4962,5188,226,1,90.15012189,Arch
4e1df1979b963de468d873d19ec046361d18a039,238,11762,7691,4071,34,29,63,2,127,2308,20,86,6.577282284,86437,60,0,11638,11454,184,466314,433453,32861,5186,4964,222,1,90.15012189,Arch
59059e4ee76b8084c728205fbff2f85d7fc4afeb,238,7687,11758,4071,29,34,63,1,115,921,20,86,6.575966512,90508,59,0,11453,11640,187,433373,466353,32980,4962,5188,226,1,90.15012189,Arch
88525ce650e0843b555b1ef45834435ef719d2f6,240,11765,7688,4077,34,29,63,2,127,2320,20,86,6.578612465,86932,61,1,11751,11568,183,469155,436285,32870,5208,4986,222,1,90.15012189,Arch
a51184e415480b48d66a6dc48183aeb6d01a7e30,240,7687,11764,4077,29,34,63,1,115,930,20,86,6.578288995,91009,57,0,11566,11753,187,436200,469194,32994,4984,5210,226,1,90.13452915,Arch
7db424758f9a3b04bde3dfe6319345049651e617,240,11765,7688,4077,34,29,63,2,127,2320,20,86,6.578612465,86932,62,2,11751,11568,183,469155,436285,32870,5208,4986,222,1,90.13452915,Arch
4358f38e8c3d3d177d1360a7489db51e069ae1ad,240,7687,11764,4077,29,34,63,1,115,930,20,86,6.578288995,91009,412,1,11566,11753,187,436200,469194,32994,4984,5210,226,1,90.13452915,Arch
7c5a4bd9401f54635d4723a11ffe944e1783f10f,240,11765,7688,4077,34,29,63,2,127,2320,20,86,6.578612465,86932,398,4,11751,11568,183,469155,436285,32870,5208,4986,222,1,90.13452915,Arch
03454466fa38a3872a1d54d8eeef32b9ae17f910,240,7687,11764,4077,29,34,63,1,115,930,20,86,6.578288995,91009,413,2,11566,11753,187,436200,469194,32994,4984,5210,226,1,90.13452915,Arch
5901d9a6f0b66f68de75944638f23f4b9676a319,239,11775,7666,4109,33,28,61,2,127,2314,20,86,6.575252997,86932,399,5,11751,11566,185,469155,436200,32955,5208,4984,224,1,90.13452915,Arch
