CommitID,NMF, TotalAddLines , TotalDeleteLines ,LC,LC_1, FileAdd , FileDelete ,NAD, NUC, AGE, NMS, NMD, Entropy ,MLMF,NDVE,EXP,REXP,CommitComplexity,LastCommitComplexity,CFC,CommitTokenCount,LastCommitTokenCount,NCC,CommitMethodNum,LastCommitMethodNum,NMC,NIR,a2a,Tag
eb3b1bbd9c5c1648af42eca6ab33d3db80ea88d7,0,0,0,0,0,0,0,0,0,0,0,0,0,0,0,73,14,0,0,0,0,0,0,0,0,0,0,100,NoArch
86d3ba82a52c921bcf820f580405e06fd3d797cd,0,0,0,0,0,0,0,0,0,0,0,0,0,0,0,74,15,0,0,0,0,0,0,0,0,0,1,100,NoArch
86c74fb4b57813378fe2fd71d44dc1f8f7a28056,0,0,0,0,0,0,0,0,0,0,0,0,0,0,0,75,16,0,0,0,0,0,0,0,0,0,1,100,NoArch
751a179769ed29c686558cd618a7934754b6691f,4,70,19,51,89,0,0,0,10,106,1,2,1.53554765,485,1,76,10,106,95,11,3294,2991,303,30,26,4,1,93.77682403,Arch
e6715a6d0792cca5fb0fd6961d565fa869795433,0,0,0,0,0,0,0,0,0,0,0,0,0,0,0,77,9,0,0,0,0,0,0,0,0,0,1,100,NoArch
e2e7fd906abe882be5d9ffa6f8ce0ef9025f7107,1,1,1,0,2,0,0,0,16,57,1,1,0,462,1,78,7,129,129,0,2864,2863,1,30,30,0,1,100,NoArch
0039f146bd31549fee2b80119a3c977a5072a5d5,24,2740,2362,378,5102,10,4,14,17,32,1,6,4.080698285,4615,1,79,7,793,733,60,23546,23257,289,310,278,32,1,93.46642468,Arch
f352f56536e1855bdb97208b23f65c659eed3b69,61,127,61,66,188,0,0,0,18,101,1,9,5.29439242,9223,1,80,7,1517,1517,0,44391,44397,6,660,660,0,1,92.90187891,Arch
f03f432cc7d71b7969d56f9dc17ca264a3771650,0,0,0,0,0,0,0,0,0,0,0,0,0,0,0,81,5,0,0,0,0,0,0,0,0,0,1,100,NoArch
2034a4ee5bc4fd9623797590e1dbb411e4848787,15,302,326,24,628,1,3,4,18,110,1,3,3.201329052,2777,1,82,6,334,336,2,15831,15966,135,132,135,3,1,97.59358289,Arch
eeb1023f9630a576bf8ea2d5b0e485f565e90e42,0,0,0,0,0,0,0,0,0,0,0,0,0,0,0,83,6,0,0,0,0,0,0,0,0,0,2,100,NoArch
62806bad9162f22afe69f01e97ea96321d83710a,12,657,16,641,673,6,0,6,14,0,1,4,3.017296424,871,1,84,7,138,82,56,7688,5144,2544,85,47,38,1,96.40102828,Arch
127800a158ce6d6af08e5b32e01e153ade03d474,0,0,0,0,0,0,0,0,0,0,0,0,0,0,0,85,8,0,0,0,0,0,0,0,0,0,1,100,NoArch
79d571847ca673a23733377fdfd9a489017c499c,8,19,10,9,29,0,0,0,12,39,1,3,2.846301808,445,1,86,3,45,45,0,1651,1651,0,35,35,0,2,100,NoArch
a02c72575832bd9a451bd6d8fed62c7818eac611,1,12,1,11,13,0,0,0,14,45,1,1,0,270,1,87,4,72,66,6,1882,1820,62,16,15,1,1,100,NoArch
e1d53e342f55f7ee51b8f4b04fc03aaa287712dd,6,70,47,23,117,0,0,0,19,60,1,4,2.022012759,2090,1,88,2,435,438,3,11982,11818,164,194,199,5,1,100,NoArch
f736dfd4dd6089d9323cf7290ca7852c9dd045cd,6,234,5,229,239,3,0,3,13,26,1,4,1.802370874,515,1,89,3,111,90,21,3720,2604,1116,66,49,17,1,93.99538106,Arch
73b69bc59c61294a6689b695342e7f9d6b48db90,2,168,0,168,168,1,0,1,4,31,1,2,0.193196413,623,1,90,4,92,88,4,3682,2734,948,37,33,4,1,98.72881356,NoArch
b9821a460520ea9c7f5bcc6cb35a33c725295f44,3,87,2,85,89,1,0,1,5,42,1,2,0.309461189,581,1,91,5,57,51,6,1808,1427,381,32,30,2,1,99.59016393,NoArch
c529c6d5821d89bfb3f37e2c6bb0ec9b83635899,0,0,0,0,0,0,0,0,0,0,0,0,0,0,0,92,6,0,0,0,0,0,0,0,0,0,1,100,NoArch
a84db2bc15c8876d40993d29adfe22f8aa9601cd,0,0,0,0,0,0,0,0,0,0,0,0,0,0,0,93,7,0,0,0,0,0,0,0,0,0,1,100,NoArch
a1ea81add49b8684f979988f342193a547795fb0,1,8,1,7,9,0,0,0,15,17,1,1,0,281,1,94,8,75,72,3,1964,1882,82,16,16,0,1,100,NoArch
710e2379a2ef1c5c4d2cf6ada9e0dc49795f5c86,2,30,2,28,32,0,0,0,2,8,1,1,1,68,1,95,9,12,12,0,238,238,0,10,10,0,2,100,NoArch
97a5793f050400d38b07d4fbab0539809ce579ff,8,206,43,163,249,0,0,0,14,48,1,3,2.517193933,904,1,96,10,167,146,21,6056,5124,932,71,54,17,1,100,NoArch
acba0fcdc047d14f0a28a88aec0a9b8b0cf524f8,2,4,1,3,5,0,0,0,19,58,1,1,0.721928095,1046,1,97,9,267,265,2,6445,6416,29,131,131,0,1,100,NoArch
f49a465349ae11ffccfffb1ed0693363a8b28a87,0,0,0,0,0,0,0,0,0,0,0,0,0,0,0,98,10,0,0,0,0,0,0,0,0,0,1,100,NoArch
b062afaea6c4534bea3e2ec1387afb549da72570,2,350,0,350,350,2,0,2,1,0,1,2,0.994693795,0,1,99,11,74,0,74,2409,0,2409,23,0,23,1,96.7462039,Arch
490d0c72dc345c4683e9099e8f2b5244cffb868a,23,427,184,243,611,2,0,2,20,55,1,6,3.433059815,3366,1,100,5,725,685,40,21578,20064,1514,254,232,22,2,98.39449541,NoArch
c454652c1cd491976b894dc293856c8f73495725,0,0,0,0,0,0,0,0,0,0,0,0,0,0,0,101,6,0,0,0,0,0,0,0,0,0,1,100,NoArch
b43975aa1e773cd471f5771d7c7faac7a0f73a7c,5,150,107,43,257,0,0,0,20,4,1,5,1.494220774,1600,1,102,7,434,430,4,10975,10655,320,178,171,7,1,100,NoArch
7d83e93e0d50487125d747265d2aa325cdce029d,0,0,0,0,0,0,0,0,0,0,0,0,0,0,0,103,8,0,0,0,0,0,0,0,0,0,1,100,NoArch
604f27bc286f17bb8b43c25c1aa3302882c80395,2,34,0,34,34,0,0,0,3,112,1,2,1,156,1,104,9,12,12,0,708,708,0,9,9,0,0,100,NoArch
d8d90987da6300e3c0a8741dfedc8109fee49da2,0,0,0,0,0,0,0,0,0,0,0,0,0,0,0,105,10,0,0,0,0,0,0,0,0,0,0,100,NoArch
14c0ae1564cd6a067abb735c3b4f09ddf200910a,0,0,0,0,0,0,0,0,0,0,0,0,0,0,0,106,9,0,0,0,0,0,0,0,0,0,1,100,NoArch
1dbb683d17f571213a8367d8e1306019063325d3,0,0,0,0,0,0,0,0,0,0,0,0,0,0,0,107,8,0,0,0,0,0,0,0,0,0,1,100,NoArch
e6994922462bdae76cceebdd19515a76f15497bf,0,0,0,0,0,0,0,0,0,0,0,0,0,0,0,108,8,0,0,0,0,0,0,0,0,0,0,100,NoArch
12b51f98003fb0af5966eb6710a8270d69dd7ee3,0,0,0,0,0,0,0,0,0,0,0,0,0,0,0,0,0,0,0,0,0,0,0,0,0,0,0,100,NoArch
116a973813541d4f6ca000ae27090074871e714e,97,2872,5380,2508,8252,7,26,33,16,14,1,12,5.434778564,14470,1,0,0,1873,2176,303,62115,73068,10953,793,952,159,0,79.76470588,Arch
a7bfbd4b56d99655062c069e26ab6d476f5f06a0,2,15,5,10,20,0,0,0,15,56,1,2,0.286396957,499,1,131,7,118,112,6,3275,3184,91,27,27,0,1,100,NoArch
bc9491c9dcea4035f3fd4733a2c0b649d08398ed,24,88,110,22,198,0,0,0,22,99,1,7,4.074760941,5530,1,132,8,805,807,2,31496,31637,141,371,373,2,1,99.23954373,NoArch
7ddc6d64b2f81cc4022ae36aa233f7ce7e191314,0,0,0,0,0,0,0,0,0,0,0,0,0,0,0,1,1,0,0,0,0,0,0,0,0,0,1,100,NoArch
1999497b9115b71d325e87f66f05dc006a9d0e9b,0,0,0,0,0,0,0,0,0,0,0,0,0,0,0,133,9,0,0,0,0,0,0,0,0,0,1,100,NoArch
b57431769b7b42f8561ef4625ecf80e0d4bd019b,0,0,0,0,0,0,0,0,0,0,0,0,0,0,0,0,0,0,0,0,0,0,0,0,0,0,0,100,NoArch
5690cd025ce5c1bcb21b69e4f17bbb65e3db80fb,0,0,0,0,0,0,0,0,0,0,0,0,0,0,0,1,1,0,0,0,0,0,0,0,0,0,1,100,NoArch
1ecc7b63fbb0b13181ea16b38055729536c0225e,0,0,0,0,0,0,0,0,0,0,0,0,0,0,0,8,1,0,0,0,0,0,0,0,0,0,1,100,NoArch
fac2b0477cba4cd01a56c635459a949f81680a84,0,0,0,0,0,0,0,0,0,0,0,0,0,0,0,134,9,0,0,0,0,0,0,0,0,0,1,100,NoArch
21ba02b631c068abd4f295b8b903bdc392fa4573,0,0,0,0,0,0,0,0,0,0,0,0,0,0,0,2,2,0,0,0,0,0,0,0,0,0,1,100,NoArch
62e4e5bc62c1716224f60e61813103ec54704459,1,9,6,3,15,0,0,0,14,20,1,1,0,149,1,135,8,27,23,4,839,810,29,11,11,0,1,100,NoArch
d086fd7aaa4906cf4c50600744ed30fac9544269,2,35,13,22,48,0,0,0,23,20,1,2,0.249882293,1623,1,136,8,369,365,4,9400,9329,71,137,135,2,1,100,NoArch
edbb3feac1bb12c0b00934b1fa58ba7c4b094b40,3,263,136,127,399,1,0,1,23,18,1,3,0.86705026,602,1,137,9,127,115,12,4325,3665,660,50,41,9,1,99.62121212,NoArch
4d2c4381dc5019ec721b525dafec3e6197b7e972,0,0,0,0,0,0,0,0,0,0,0,0,0,0,0,2,2,0,0,0,0,0,0,0,0,0,1,100,NoArch
e83268ede627871932e5de46d3bc69be500715b2,0,0,0,0,0,0,0,0,0,0,0,0,0,0,0,138,10,0,0,0,0,0,0,0,0,0,1,100,NoArch
5f7cb7d6d00a284364c629ba85d4b3114c677cc2,0,0,0,0,0,0,0,0,0,0,0,0,0,0,0,3,3,0,0,0,0,0,0,0,0,0,1,100,NoArch
3623bbcaf7c0f889fa0973b4b9d4e38fdfddb863,0,0,0,0,0,0,0,0,0,0,0,0,0,0,0,4,4,0,0,0,0,0,0,0,0,0,1,100,NoArch
4fadaaba38d555cd869a10ac6c8e305f4b59ec61,3,118,0,118,118,2,0,2,21,6,1,2,1.501727227,359,1,139,8,105,95,10,2682,2290,392,24,20,4,1,98.88682746,NoArch
f1b834377fc2f4f7ba5436e2cc0945c4fd7a9652,0,0,0,0,0,0,0,0,0,0,0,0,0,0,0,3,2,0,0,0,0,0,0,0,0,0,1,100,NoArch
de86bbe9b92fda06368889a9554cb71fbb03bace,0,0,0,0,0,0,0,0,0,0,0,0,0,0,0,4,2,0,0,0,0,0,0,0,0,0,1,100,NoArch
8be88359e7685ffba7d71b6710c2b0d9e1a02212,0,0,0,0,0,0,0,0,0,0,0,0,0,0,0,5,3,0,0,0,0,0,0,0,0,0,1,100,NoArch
a4b6df067b9e320919b8997612c922863fc6a911,0,0,0,0,0,0,0,0,0,0,0,0,0,0,0,5,3,0,0,0,0,0,0,0,0,0,1,100,NoArch
e4a937b229b3c8d77ac10a38bd05ce8ca1f86cee,0,0,0,0,0,0,0,0,0,0,0,0,0,0,0,6,4,0,0,0,0,0,0,0,0,0,1,100,NoArch
e0871c82beaced35e4b1ea2e1d7a9023ec7e4e4a,0,0,0,0,0,0,0,0,0,0,0,0,0,0,0,140,1,0,0,0,0,0,0,0,0,0,0,100,NoArch
6c6a0cb898b7b4182ebe6ee9ee41ae5c83206075,0,0,0,0,0,0,0,0,0,0,0,0,0,0,0,141,2,0,0,0,0,0,0,0,0,0,1,100,NoArch
ea05a9146f0edb64e76a25ab30230e9b35c98092,4,110,32,78,142,0,0,0,13,131,1,2,1.518193186,613,2,142,3,97,84,13,3844,3301,543,54,47,7,1,100,NoArch
e0940cb77cd3029fd90efc6952783754a619dd8e,0,0,0,0,0,0,0,0,0,0,0,0,0,0,0,7,3,0,0,0,0,0,0,0,0,0,1,100,NoArch
8d1df9769947050afa23ae3b6371ac4a74dd4928,0,0,0,0,0,0,0,0,0,0,0,0,0,0,0,8,4,0,0,0,0,0,0,0,0,0,1,100,NoArch
a45e938a1c59fb4f1fdc66252bdafac6aa9f2069,0,0,0,0,0,0,0,0,0,0,0,0,0,0,0,9,4,0,0,0,0,0,0,0,0,0,1,100,NoArch
8d27b88ec0c3ff374952f56519896f0c932f2967,0,0,0,0,0,0,0,0,0,0,0,0,0,0,0,10,5,0,0,0,0,0,0,0,0,0,1,100,NoArch
39e6d507642777ab6ac2db0903775fbf094257a9,0,0,0,0,0,0,0,0,0,0,0,0,0,0,0,11,6,0,0,0,0,0,0,0,0,0,1,100,NoArch
76c6762906b4802dd9e41b647a7a5146a08e180b,7,135,76,59,211,0,0,0,24,127,1,5,2.513346984,2025,1,143,3,530,522,8,13709,13273,436,204,199,5,1,78.73303167,Arch
8ab3b6db708dfd187159fb2785bad2cacfc3a2b6,2,29,2,27,31,0,0,0,25,31,1,2,0.907165768,1102,1,144,4,254,250,4,7039,6901,138,138,137,1,1,100,NoArch
6b33f0278abc9a1d81f925d39673d9fccefc5370,16,419,402,17,821,0,0,0,22,131,1,4,3.036039894,1855,1,145,5,304,315,11,10050,9970,80,129,126,3,1,90.60402685,Arch
2185314c78c943fa3e5369e747c6807bc3b9d960,0,0,0,0,0,0,0,0,0,0,0,0,0,0,0,6,2,0,0,0,0,0,0,0,0,0,1,100,NoArch
f353002184959c18354700b5b5f14e9c4a5269be,0,0,0,0,0,0,0,0,0,0,0,0,0,0,0,7,3,0,0,0,0,0,0,0,0,0,1,100,NoArch
7ae507b40fd3493e02438165f1d0c982e6e79914,0,0,0,0,0,0,0,0,0,0,0,0,0,0,0,8,4,0,0,0,0,0,0,0,0,0,1,100,NoArch
21bb13cd6122a926b670945bb11cde8bc0d973a3,0,0,0,0,0,0,0,0,0,0,0,0,0,0,0,146,6,0,0,0,0,0,0,0,0,0,1,100,NoArch
8fa1312a50ec65a250de8df72794c061654cd9c9,3,25,11,14,36,0,0,0,26,71,1,2,1.369471138,1317,1,147,7,325,325,0,8183,8032,151,158,157,1,1,100,NoArch
43884c872df6d638d67a4584391bd79802dbbaa2,0,0,0,0,0,0,0,0,0,0,0,0,0,0,0,148,8,0,0,0,0,0,0,0,0,0,1,100,NoArch
ff753de85e2216415f8fda01c814af11da13c90f,0,0,0,0,0,0,0,0,0,0,0,0,0,0,0,12,7,0,0,0,0,0,0,0,0,0,1,100,NoArch
57d8f4535d9321d47dccd2148c4d0df40d011612,0,0,0,0,0,0,0,0,0,0,0,0,0,0,0,9,4,0,0,0,0,0,0,0,0,0,1,100,NoArch
2bf0a95abdec4a7b49f2ec75200c7354b6df9564,0,0,0,0,0,0,0,0,0,0,0,0,0,0,0,10,5,0,0,0,0,0,0,0,0,0,1,100,NoArch
9c9b79b536b55d252da46863e067705f52572ac5,0,0,0,0,0,0,0,0,0,0,0,0,0,0,0,11,5,0,0,0,0,0,0,0,0,0,1,100,NoArch
60ad460b6fd8d8cdd2ba3cf6b533bc0a94d7a521,0,0,0,0,0,0,0,0,0,0,0,0,0,0,0,149,9,0,0,0,0,0,0,0,0,0,1,100,NoArch
c4e01e1353f25e5acc40cacba02b753430b84a31,0,0,0,0,0,0,0,0,0,0,0,0,0,0,0,150,10,0,0,0,0,0,0,0,0,0,1,100,NoArch
dd75906e473d7df696bb73ebfea4207992444629,0,0,0,0,0,0,0,0,0,0,0,0,0,0,0,12,6,0,0,0,0,0,0,0,0,0,2,100,NoArch
d9600ed0b2e237cc7fd0cb89319c724d3251ff00,0,0,0,0,0,0,0,0,0,0,0,0,0,0,0,151,10,0,0,0,0,0,0,0,0,0,1,100,NoArch
1aa6a71c292d95f4f591713e4f8e51cf49822d8e,0,0,0,0,0,0,0,0,0,0,0,0,0,0,0,152,10,0,0,0,0,0,0,0,0,0,1,100,NoArch
19684abe028c3362ca80884fd737a1ff6a44aad3,0,0,0,0,0,0,0,0,0,0,0,0,0,0,0,153,11,0,0,0,0,0,0,0,0,0,1,100,NoArch
e2d1051e95de6628da5758bb91f2511e588d3eb1,0,0,0,0,0,0,0,0,0,0,0,0,0,0,0,154,12,0,0,0,0,0,0,0,0,0,2,100,NoArch
148436898364857155f03278e3eff328403f7226,0,0,0,0,0,0,0,0,0,0,0,0,0,0,0,155,13,0,0,0,0,0,0,0,0,0,1,100,NoArch
43bcac65cdd6cd43f73714eb3d72a51c406d8feb,2,61,0,61,61,1,0,1,2,34,1,2,0.208180946,58,1,156,14,12,6,6,521,212,309,4,3,1,1,99.23664122,NoArch
d0d4e91341d00075cc46eb3ced62761644ce2c6e,0,0,0,0,0,0,0,0,0,0,0,0,0,0,0,13,6,0,0,0,0,0,0,0,0,0,1,100,NoArch
fd1d9077277695e8f5668c062289f9d17bb9981a,2,107,10,97,117,0,0,0,23,58,1,2,0.971941752,457,1,157,15,111,105,6,3334,2778,556,32,27,5,1,98.87218045,NoArch
e0c709a3b29bdd335a9b604fb94580003f54c6af,2,12,13,1,25,0,0,0,24,13,1,1,0.634309555,668,1,158,16,175,175,0,4365,4365,0,36,36,0,1,100,NoArch
c854cd83e69bc220cd472e4006086c043efb4cc8,3,7,8,1,15,0,0,0,11,243,1,3,1.456564762,559,1,159,17,31,31,0,1785,1758,27,24,24,0,1,100,NoArch
234893c3d0ff9c18fd2b90e5c7ea0b0a9a0b2762,14,681,89,592,770,1,0,1,21,67,1,5,2.778364912,2238,1,160,17,630,516,114,16708,13276,3432,240,175,65,1,74.56359102,Arch
56d154f53715a3234a7cafd5fca4bbeb15999f6c,0,0,0,0,0,0,0,0,0,0,0,0,0,0,0,161,18,0,0,0,0,0,0,0,0,0,1,100,NoArch
6d882a3832cd9ecf2d15568dd74ff30c9c2cfe83,0,0,0,0,0,0,0,0,0,0,0,0,0,0,0,13,7,0,0,0,0,0,0,0,0,0,1,100,NoArch
6b3399f6ea202f570ad92deb26652a5480da2717,0,0,0,0,0,0,0,0,0,0,0,0,0,0,0,14,8,0,0,0,0,0,0,0,0,0,1,100,NoArch
6bf016960332ba751f3e1124e11b5993fc75e070,0,0,0,0,0,0,0,0,0,0,0,0,0,0,0,15,9,0,0,0,0,0,0,0,0,0,1,100,NoArch
91856e0e927a07b4e6940cdb48d99261b1dbaa18,0,0,0,0,0,0,0,0,0,0,0,0,0,0,0,16,10,0,0,0,0,0,0,0,0,0,1,100,NoArch
6dcb9a03a1d161425cf722d9b5dea06ffe56e675,0,0,0,0,0,0,0,0,0,0,0,0,0,0,0,162,19,0,0,0,0,0,0,0,0,0,0,100,NoArch
f1b61e8f9d5ae1c5e0f155ff1ebeb40e4e2295eb,4,65,11,54,76,0,0,0,25,28,1,3,1.967788463,564,1,163,20,119,113,6,3412,3192,220,30,26,4,1,100,NoArch
ba55ccc8e773ecbb0e71b13997c628b82f40eeac,4,26,8,18,34,0,0,0,27,16,1,3,1.866196857,1283,1,164,21,310,305,5,7649,7563,86,151,149,2,1,94.83101392,Arch
913074da585f2737160b962aca0b905bb283012a,0,0,0,0,0,0,0,0,0,0,0,0,0,0,0,17,11,0,0,0,0,0,0,0,0,0,1,100,NoArch
c7fe3355d2c8d966179aa8ff3189f354bc252ceb,8,147,68,79,215,0,0,0,19,89,1,5,1.744240214,1365,1,165,20,270,251,19,8516,7967,549,101,94,7,1,100,NoArch
21b3430f67fd55dbdd508e9593e522705247680f,0,0,0,0,0,0,0,0,0,0,0,0,0,0,0,166,17,0,0,0,0,0,0,0,0,0,1,100,NoArch
e0839ab5642e57853443d7388565c5acd6311ee3,0,0,0,0,0,0,0,0,0,0,0,0,0,0,0,167,18,0,0,0,0,0,0,0,0,0,1,100,NoArch
a976791d656760a9d724276d31bed869f6396fde,2,133,57,76,190,0,0,0,28,45,1,2,0.547246947,1129,1,168,16,274,254,20,7652,7012,640,145,139,6,1,100,NoArch
7c655949f7bd1bc0896181545204665ff0a8ed87,0,0,0,0,0,0,0,0,0,0,0,0,0,0,0,0,0,0,0,0,0,0,0,0,0,0,1,100,NoArch
8fca9cd353d16aa7396fb91c4b9a7cb4660d23fd,5,130,201,71,331,1,1,2,20,36,1,3,1.850495335,985,1,169,7,170,179,9,5595,5771,176,72,86,14,1,92.91666667,Arch
3abbd30b6ea58ef7916699d5715ebc343e49cf8e,6,40,16,24,56,0,0,0,22,15,1,4,2.406669265,1708,1,170,8,396,389,7,10836,10629,207,130,127,3,1,100,NoArch
47646602d304105ec8edac22be3ac8dd9b0bbe38,8,111,7,104,118,1,0,1,23,32,1,3,2.733285855,1847,1,171,6,397,382,15,11731,11230,501,153,146,7,1,99.59183673,NoArch
2bf92732789f7cb1ec25be368fe76f6ad8007848,2,33,0,33,33,0,0,0,29,16,1,2,0.745517843,1205,2,1,1,277,274,3,7758,7652,106,147,145,2,1,100,NoArch
4e4ef4f8834a17e879113bf9f6fc465859d2f548,5,70,14,56,84,0,0,0,23,9,1,3,2.112063347,1192,1,172,6,262,252,10,8111,7566,545,92,90,2,1,100,NoArch
cfd4b63a8bb9244e3c1cdd48fffe2dd429f8e48d,2,34,53,19,87,0,0,0,26,68,1,2,0.442958679,566,1,173,5,110,113,3,3188,3381,193,34,34,0,1,100,NoArch
a87b0c1be09e0449a2c941ea542ce0f22639fdb1,2,40,19,21,59,0,0,0,30,18,1,2,0.81792525,1238,2,174,6,278,277,1,7889,7758,131,148,147,1,1,100,NoArch
3fde11fc9af39832b871b098f18a90b15c079e82,0,0,0,0,0,0,0,0,0,0,0,0,0,0,0,175,7,0,0,0,0,0,0,0,0,0,1,100,NoArch
39c4b9c04f2232e71cca1e2f29dbc4e3319c9edf,2,10,8,2,18,0,0,0,24,58,1,2,0.764204507,459,1,176,8,102,102,0,3103,3117,14,26,26,0,1,100,NoArch
c5df78537022403f7725b273c1d9371e345cf905,4,15,10,5,25,0,0,0,27,88,1,3,1.874444455,602,1,177,0,117,117,0,3272,3251,21,30,30,0,1,100,NoArch
e2b5b07fea44c4400386da565e880900fadfa7ea,0,0,0,0,0,0,0,0,0,0,0,0,0,0,0,178,1,0,0,0,0,0,0,0,0,0,1,100,NoArch
1acc9913afd9bee7ad319ffd789a6e47a2e7baa8,0,0,0,0,0,0,0,0,0,0,0,0,0,0,0,179,2,0,0,0,0,0,0,0,0,0,0,100,NoArch
4471c7079a4e7cc62ff6d67cfe22b078a6bbe4af,11,730,24,706,754,9,0,9,5,49,1,4,3.198549137,472,1,180,3,131,81,50,5516,2489,3027,65,35,30,0,92.63565891,Arch
1d125b4a4fdabf0bf55f27d092226a53d70427ac,10,382,331,51,713,1,0,1,15,96,1,4,2.431137363,1418,1,181,4,175,162,13,7549,7820,271,89,82,7,0,97.61029412,Arch
2310971c1ca6e632a938266f68921b0221a80d61,4,14,0,14,14,0,0,0,15,246,1,2,1.610577243,764,1,182,5,79,77,2,3886,3810,76,38,36,2,1,100,NoArch
d0b76375fb71ea127d0d0f2ef38b9712efce36da,3,85,34,51,119,0,0,0,28,31,1,3,0.929398973,909,1,183,6,147,143,4,5570,5342,228,63,63,0,1,99.81751825,NoArch
162726205705d4130e4090e4c4aa24d9e7ef34a6,4,235,1,234,236,2,0,2,31,11,1,3,1.017979253,976,1,184,7,283,253,30,7117,6099,1018,134,122,12,1,96.92585895,Arch
09077d848518150782f9a44c08d25699fbd680a1,1,1,1,0,2,0,0,0,32,0,1,1,0,898,2,185,8,245,245,0,5740,5741,1,119,119,0,1,100,NoArch
939eb8a8a6f5fb7239432eb0bc42730153d46c92,1,4,2,2,6,0,0,0,2,0,1,1,0,155,1,186,9,19,19,0,675,669,6,9,9,0,1,100,NoArch
e5631c1b774681f92de43f9f7d6ec64ae15d5c9b,6,335,1,334,336,3,0,3,7,0,1,3,2.010706158,524,1,187,10,110,86,24,4271,2607,1664,54,37,17,1,96.58703072,Arch
3b522378847be1e45c11024f153dbac7f83c9c67,0,0,0,0,0,0,0,0,0,0,0,0,0,0,0,188,11,0,0,0,0,0,0,0,0,0,0,100,NoArch
2faea630242fa636cbb123597f47d2216e159136,0,0,0,0,0,0,0,0,0,0,0,0,0,0,0,189,12,0,0,0,0,0,0,0,0,0,0,100,NoArch
b0e42bf54f6575ffadd2766582cf01633d6061d7,2,116,0,116,116,2,0,2,1,0,1,2,0.992266639,0,1,190,13,8,0,8,421,0,421,8,0,8,0,98.14814815,NoArch
8911c848b1625d911a99ab846c4000985c74758c,2,3,2,1,5,0,0,0,8,314,1,1,0.970950594,208,1,191,14,26,26,0,902,885,17,14,14,0,1,100,NoArch
fee963d618d493bf630fc0afdfbc1eb8d74b5362,0,0,0,0,0,0,0,0,0,0,0,0,0,0,0,192,15,0,0,0,0,0,0,0,0,0,1,100,NoArch
0def48146dd7e2590a41f9da2c025d4024865ccc,0,0,0,0,0,0,0,0,0,0,0,0,0,0,0,193,16,0,0,0,0,0,0,0,0,0,1,100,NoArch
e5d6f00462a43a94edd3ad1e4266443c63ecf51c,10,1053,0,1053,1053,10,0,10,5,17,1,2,3.16305332,0,1,194,17,94,0,94,4550,0,4550,68,0,68,3,95.93908629,Arch
d933c26e39b707dcfeeff28a089a085506cba5e2,0,0,0,0,0,0,0,0,0,0,0,0,0,0,0,195,18,0,0,0,0,0,0,0,0,0,1,100,NoArch
7b13b5dda2f7014ed15d86887a963299232ca1d2,9,222,40,182,262,1,0,1,33,73,1,6,2.827344862,3314,1,196,19,759,738,21,21917,20871,1046,307,293,14,1,99.67213115,NoArch
853d0a7c72fbecb76748ea0ff7f4bf31f6529e6a,4,46,27,19,73,0,0,0,30,82,1,4,1.515272249,1125,2,197,20,206,207,1,6725,6585,140,86,87,1,1,100,NoArch
6a9539134694a73e1dd5bdded697461ac88b4744,7,52,42,10,94,0,0,0,25,67,1,4,1.769104212,1613,1,198,21,385,381,4,9971,9876,95,134,129,5,1,100,NoArch
8fc362ad49300d2aa145c0e0e118851fbcc563b6,2,39,2,37,41,1,0,1,20,87,1,2,0.534943699,488,1,199,22,168,164,4,3519,3417,102,51,49,2,1,96.32587859,Arch
8697acfffac7f9d677793ea65ad3d66143b6963d,0,0,0,0,0,0,0,0,0,0,0,0,0,0,0,2,0,0,0,0,0,0,0,0,0,0,1,100,NoArch
5d6bcad33de3aec97c4de7a2ff143a728837b5c1,0,0,0,0,0,0,0,0,0,0,0,0,0,0,0,200,23,0,0,0,0,0,0,0,0,0,1,100,NoArch
7c85a78d59b838852273934706bd394df56c23ee,0,0,0,0,0,0,0,0,0,0,0,0,0,0,0,201,24,0,0,0,0,0,0,0,0,0,1,100,NoArch
3765440645e1dd8a585a11fb14476334ed54f1e8,0,0,0,0,0,0,0,0,0,0,0,0,0,0,0,202,25,0,0,0,0,0,0,0,0,0,1,100,NoArch
5979ad309e117fed1d59c3610255fe16852d8d60,14,68,67,1,135,0,0,0,23,94,1,4,3.308866249,2243,1,203,26,279,279,0,12943,12764,179,169,169,0,1,100,NoArch
666ef349f0d5700803cc24ac38b1216e926d1519,0,0,0,0,0,0,0,0,0,0,0,0,0,0,0,204,27,0,0,0,0,0,0,0,0,0,1,100,NoArch
2b43cbdc5d51752325dd9f29a669dcc532a1c6b0,137,2,2,0,4,0,0,0,34,131,1,19,NaN,19731,1,205,28,2782,2782,0,98473,98473,0,1297,1297,0,1,22.72727273,Arch
198bdac00482ea898b6035e9cd6c96f00ea3f026,0,0,0,0,0,0,0,0,0,0,0,0,0,0,0,206,29,0,0,0,0,0,0,0,0,0,1,100,NoArch
107cb5e18a20a09f19fb97e4e0f4a2652574ac09,0,0,0,0,0,0,0,0,0,0,0,0,0,0,0,207,30,0,0,0,0,0,0,0,0,0,1,100,NoArch
820d85de389914cd414a0dac60ca4e9cca359b02,0,0,0,0,0,0,0,0,0,0,0,0,0,0,0,208,28,0,0,0,0,0,0,0,0,0,1,100,NoArch
6b57b501c1c93efc5c6b42c511c4d3c19974a71a,1,1,1,0,2,0,0,0,35,2,1,1,0,913,2,209,29,247,247,0,5850,5850,0,122,122,0,1,100,NoArch
56794b99650ef9343e7e7fd5b518391cfeaff032,0,0,0,0,0,0,0,0,0,0,0,0,0,0,0,210,30,0,0,0,0,0,0,0,0,0,2,100,NoArch
f3820c4131858ee2c0781dfed445b239569e61cc,0,0,0,0,0,0,0,0,0,0,0,0,0,0,0,211,31,0,0,0,0,0,0,0,0,0,1,100,NoArch
63a4e8c60a5aa8d269968e984b668c476ea18c36,1,4,4,0,8,0,0,0,18,5,1,1,0,202,2,212,32,24,24,0,1150,1149,1,9,9,0,1,99.85294118,NoArch
e634f34b9abc17de550d37b249b5bc750e1e9f59,3,14,5,9,19,0,0,0,19,2,1,2,0.774243303,477,2,213,32,53,52,1,2456,2418,38,30,29,1,1,100,NoArch
801eb60caf59f2af13fcc7edceb00787840716f6,1,22,0,22,22,0,0,0,32,5,1,1,0,433,2,214,33,38,38,0,2919,2604,315,32,32,0,1,100,NoArch
1b0d92f9f1a06faafc698b8d170999cfd582dcfd,5,21,6,15,27,0,0,0,31,5,1,3,1.763965743,814,1,215,34,137,135,2,4448,4320,128,42,41,1,1,100,NoArch
7e5266955d8c92e7c6f1b2f4de3f04d57759cc29,0,0,0,0,0,0,0,0,0,0,0,0,0,0,0,216,35,0,0,0,0,0,0,0,0,0,1,100,NoArch
e72ac6c69b0e3e06c22a6a84394b4f64dafd7b3e,2,211,20,191,231,1,0,1,6,3,1,2,0.684038436,301,1,3,1,79,50,29,2425,1149,1276,45,29,16,1,98.80597015,NoArch
e10a0be31a2495dcc9205a681e8401003e2a5bea,7,66,24,42,90,0,0,0,6,7,1,3,2.130710378,1436,2,4,2,182,179,3,6393,6202,191,112,111,1,1,100,NoArch
115547c97f36bd8cb8d95a85878eaed5d1074507,12,109,68,41,177,0,0,0,7,0,1,3,2.160812675,2728,1,5,3,437,432,5,12982,12909,73,204,200,4,1,100,NoArch
e2619a8330a83f8a4f88a5dc055fa9cc2c606873,0,0,0,0,0,0,0,0,0,0,0,0,0,0,0,217,31,0,0,0,0,0,0,0,0,0,1,100,NoArch
b6bd22843bec5f28b5c44af91c4e5fb2b1187f2b,0,0,0,0,0,0,0,0,0,0,0,0,0,0,0,218,30,0,0,0,0,0,0,0,0,0,2,100,NoArch
aaa7f4764b7396fd2d1cb63058fbdf6209e829cb,0,0,0,0,0,0,0,0,0,0,0,0,0,0,0,219,31,0,0,0,0,0,0,0,0,0,1,100,NoArch
eeb127e7edec95b9663f416cee4bebab9581e0e3,13,92,175,83,267,0,0,0,8,0,1,3,2.753568677,2914,2,220,32,433,441,8,13311,13575,264,203,208,5,2,100,NoArch
55e42a83f141d22d2c69b27167def8380e89683c,0,0,0,0,0,0,0,0,0,0,0,0,0,0,0,18,0,0,0,0,0,0,0,0,0,0,1,100,NoArch
516ad11ed8f9c3d2f7830a9b8624fc82cc2346ab,5,43,6,37,49,0,0,0,8,0,1,2,1.85201274,1077,2,6,4,144,137,7,4572,4404,168,86,84,2,1,100,NoArch
91afe7721577c98ceef926842a2a1faf4b806f39,12,136,79,57,215,0,0,0,9,0,1,3,1.956941249,2748,2,7,5,443,436,7,13148,12978,170,206,201,5,1,100,NoArch
bbf437e11f1b6ccd16f3bc79cd09af077dc0f638,0,0,0,0,0,0,0,0,0,0,0,0,0,0,0,14,0,0,0,0,0,0,0,0,0,0,1,100,NoArch
76315b92e96ff9ed61183d81124fc3acf6998249,4,9,6,3,15,0,0,0,4,12,1,2,1.832262897,461,2,8,6,35,35,0,2171,2129,42,21,21,0,1,100,NoArch
4a0d5ae8a855c9f1b1260cd5eba802fcfc18dcf1,2,192,5,187,197,0,0,0,10,0,1,2,0.602809302,636,2,9,7,105,81,24,3922,2996,926,72,57,15,1,100,NoArch
7ddcfd485ee59e909a107cf85b7af927f422c8c9,0,0,0,0,0,0,0,0,0,0,0,0,0,0,0,15,1,0,0,0,0,0,0,0,0,0,1,100,NoArch
b844f7e03bbe8dd1b787d0c077c18a4a07330a01,0,0,0,0,0,0,0,0,0,0,0,0,0,0,0,16,2,0,0,0,0,0,0,0,0,0,1,100,NoArch
771a96e26cab64a37d8dbbbcc898a2f0132db1c3,0,0,0,0,0,0,0,0,0,0,0,0,0,0,0,17,3,0,0,0,0,0,0,0,0,0,1,100,NoArch
c11181848af28d91162a4f87647400eacaafcff5,0,0,0,0,0,0,0,0,0,0,0,0,0,0,0,221,32,0,0,0,0,0,0,0,0,0,1,100,NoArch
93e81f7ce6480d3a18b7921e0263686a237bf0f6,0,0,0,0,0,0,0,0,0,0,0,0,0,0,0,222,33,0,0,0,0,0,0,0,0,0,1,100,NoArch
ca085246f097b19ba44b84768568fc56e8dfbb87,2,19,4,15,23,0,0,0,22,20,1,2,0.828055725,525,1,223,34,172,168,4,3646,3519,127,53,51,2,1,99.84848485,NoArch
b25e6a3de8adbc0a88c920e7d18ca96292835b1b,4,108,72,36,180,0,0,0,11,8,1,3,1.486663164,1369,2,10,8,216,211,5,6819,6604,215,94,90,4,1,99.54614221,NoArch
abd816c13c3e1af987e8a7b88face7f06288bde9,3,38,4,34,42,1,0,1,10,19,1,3,0.814227111,174,2,0,0,22,19,3,969,877,92,8,7,1,1,84.44108761,Arch
e3ddec6f5a87984a5d5358734f8ee5e26a6682df,0,0,0,0,0,0,0,0,0,0,0,0,0,0,0,18,4,0,0,0,0,0,0,0,0,0,1,84.63855422,Arch
904a5a7b36db75afa7f6471c005e67ef50fee665,0,0,0,0,0,0,0,0,0,0,0,0,0,0,0,19,5,0,0,0,0,0,0,0,0,0,1,100,NoArch
558af6be61eaa44c36a7c45caaf184d9eae0ab33,0,0,0,0,0,0,0,0,0,0,0,0,0,0,0,224,33,0,0,0,0,0,0,0,0,0,1,100,NoArch
015b9bc7c86d8eba331ebc2dc1aea05325444151,0,0,0,0,0,0,0,0,0,0,0,0,0,0,0,20,6,0,0,0,0,0,0,0,0,0,1,100,NoArch
25009db0b89af97cc8d863a7bd355a55cb6c89c8,0,0,0,0,0,0,0,0,0,0,0,0,0,0,0,21,7,0,0,0,0,0,0,0,0,0,1,100,NoArch
89593506cd9e34fc28bfe2d0be546ab7c9915ebe,0,0,0,0,0,0,0,0,0,0,0,0,0,0,0,22,8,0,0,0,0,0,0,0,0,0,1,100,NoArch
06896f8e3a96f125d099c1b5311eb3e6238a31f9,0,0,0,0,0,0,0,0,0,0,0,0,0,0,0,0,0,0,0,0,0,0,0,0,0,0,1,100,NoArch
77bb1e976a00ce949f5ca61421d43b08108e28e1,3,36,17,19,53,0,0,0,36,26,1,3,1.251880118,1844,3,1,1,419,414,5,11800,11692,108,190,186,4,1,100,NoArch
9de8a8d9f7c13dca27df22fcd1ee4ffe696cd144,0,0,0,0,0,0,0,0,0,0,0,0,0,0,0,23,9,0,0,0,0,0,0,0,0,0,1,100,NoArch
56f6af364fa4d8d20e1bf7ed138e8445586b1ac6,12,659,52,607,711,7,0,7,20,9,1,5,3.47026236,890,3,2,2,149,101,48,7002,4465,2537,88,54,34,1,97.65395894,Arch
7679cb3ca82f36c56238845e7c71b6139c34e8a0,0,0,0,0,0,0,0,0,0,0,0,0,0,0,0,24,10,0,0,0,0,0,0,0,0,0,1,100,NoArch
01193b5705a8a36d0df95dd1e35ebfce3fc6c318,0,0,0,0,0,0,0,0,0,0,0,0,0,0,0,25,11,0,0,0,0,0,0,0,0,0,1,100,NoArch
005f0a6a6d474f7e80b308a1cddbe73c5d061895,0,0,0,0,0,0,0,0,0,0,0,0,0,0,0,26,12,0,0,0,0,0,0,0,0,0,1,100,NoArch
8590c10521e043f068999d182d616c80cd8b34e2,0,0,0,0,0,0,0,0,0,0,0,0,0,0,0,19,1,0,0,0,0,0,0,0,0,0,1,100,NoArch
f24e3146f5515d4be9841bffd8840de492274d69,0,0,0,0,0,0,0,0,0,0,0,0,0,0,0,20,2,0,0,0,0,0,0,0,0,0,2,100,NoArch
d5f3181c9bd0dae7597349302c4d9d0a822bdb6d,0,0,0,0,0,0,0,0,0,0,0,0,0,0,0,225,25,0,0,0,0,0,0,0,0,0,1,100,NoArch
520b9b4f09dd9bec743be83722530133a7f1e3de,0,0,0,0,0,0,0,0,0,0,0,0,0,0,0,27,13,0,0,0,0,0,0,0,0,0,1,100,NoArch
61aad5477d396fcb9dfa27ae660e05fcac0b2dc8,1,15,6,9,21,0,0,0,7,17,1,1,0,300,2,11,8,48,47,1,1667,1649,18,29,28,1,1,100,NoArch
fbc0ac7c6c17e991e1dd6c3079df84efcbf3c0e7,0,0,0,0,0,0,0,0,0,0,0,0,0,0,0,12,9,0,0,0,0,0,0,0,0,0,1,100,NoArch
ceba79182df36c355ad56298bdf33dc23d913264,0,0,0,0,0,0,0,0,0,0,0,0,0,0,0,28,14,0,0,0,0,0,0,0,0,0,1,100,NoArch
27c7ad120beb6a432e3afa67acc9a532140cf6fd,1,12,5,7,17,0,0,0,7,36,1,1,0,303,2,13,10,49,48,1,1329,1288,41,29,29,0,1,100,NoArch
26f53a11450952dc17b2248d6d08d18cb106acf7,3,16,8,8,24,0,0,0,10,36,1,1,1.040852083,693,2,14,11,104,101,3,3631,3609,22,79,78,1,1,100,NoArch
8cbe31ef59354a9eff47aa82b13fd72650874b89,1,49,0,49,49,1,0,1,1,0,1,1,0,0,1,15,12,3,0,3,174,0,174,3,0,3,1,99.71428571,NoArch
8a4ddb52579070a3744a2bb9a0baf42d5da6b0a5,1,1,0,1,1,0,0,0,10,33,1,1,0,424,2,16,13,79,79,0,2254,2246,8,36,36,0,1,100,NoArch
c85ab4b4f9a40f760fe781542d50a414cf1393e4,6,77,17,60,94,1,0,1,16,14,1,3,1.591578524,689,3,3,3,68,64,4,3494,3175,319,49,45,4,1,99.29078014,NoArch
c635452b1d8ce1f26364bfd18b118595bfed3945,0,0,0,0,0,0,0,0,0,0,0,0,0,0,0,4,4,0,0,0,0,0,0,0,0,0,1,100,NoArch
2be9e693c4d68e1afac5a0c75d9e2de4d910c5df,0,0,0,0,0,0,0,0,0,0,0,0,0,0,0,29,15,0,0,0,0,0,0,0,0,0,1,100,NoArch
e790f4837a3ee242a6e8b523ee4b10cb45d59bbc,0,0,0,0,0,0,0,0,0,0,0,0,0,0,0,30,16,0,0,0,0,0,0,0,0,0,1,100,NoArch
0319db2a8fe241b364968693afbb9bd741ee148d,0,0,0,0,0,0,0,0,0,0,0,0,0,0,0,31,17,0,0,0,0,0,0,0,0,0,1,100,NoArch
8f3ad160ce8c452bfbafc4ca09ab263a2e6aa06a,2,7,1,6,8,0,0,0,23,36,1,2,0.811278124,666,3,5,5,187,185,2,4586,4553,33,65,64,1,1,100,NoArch
6915f0c35380fc41ba0af682ba0dc2c21f6cd5f3,0,0,0,0,0,0,0,0,0,0,0,0,0,0,0,32,18,0,0,0,0,0,0,0,0,0,1,100,NoArch
b73d4499cb85dda67ba432ce156a22a74e78f142,0,0,0,0,0,0,0,0,0,0,0,0,0,0,0,21,2,0,0,0,0,0,0,0,0,0,1,100,NoArch
3dfd487bf2a7b4f83b33f5ef9a9ed3e101bfe369,2,16,8,8,24,0,0,0,7,29,1,2,0.811278124,668,1,17,10,93,91,2,2921,2883,38,37,36,1,1,99.85875706,NoArch
7a0078b786f0e3575fef5d98a8242c13530ceccd,5,255,19,236,274,1,0,1,12,20,1,4,1.786943458,1414,1,18,10,249,217,32,7992,6837,1155,103,95,8,1,94.73684211,Arch
2e4f32687d9c6b669bcda7b8a0b42d71daf97a2c,8,89,39,50,128,0,0,0,21,11,1,3,2.735845517,1181,3,6,6,133,124,9,5949,5732,217,75,74,1,1,96.72131148,Arch
6e4ae0b6566b795e14dadf6d1902cfbd69bbe2b7,4,18,7,11,25,0,0,0,13,19,1,3,1.681541933,1322,2,19,9,195,195,0,6227,6208,19,72,72,0,1,100,NoArch
1167caf735140964f5dcba441b76d99e7c9ceed1,2,26,2,24,28,0,0,0,11,0,1,2,0.591672779,585,2,20,10,102,102,0,3081,2929,152,15,15,0,1,100,NoArch
bf7db0c2ecb2104fb087f0eea560a7d36935929c,3,20,5,15,25,0,0,0,12,21,1,2,0.916118214,1458,2,21,11,247,246,1,7365,7301,64,41,41,0,1,100,NoArch
6c7b0e1396e9e6326f80a82515f4de44d4f0ebf9,2,86,2,84,88,0,0,0,37,32,1,2,0.658743531,1382,3,7,7,296,289,7,9611,8845,766,161,158,3,1,100,NoArch
f86e0305115fdf9aaa90b19e3bb8ee58324a1406,13,116,79,37,195,2,0,2,32,55,1,4,3.088504419,2140,1,226,2,533,543,10,12743,12941,198,161,158,3,1,93.37121212,Arch
1b9263f5e8587f147c7d2920552c639f1bbf9759,2,14,1,13,15,0,0,0,25,0,1,2,0.836640742,553,1,227,2,175,173,2,3824,3730,94,55,54,1,1,100,NoArch
7e4037de2a891fa738aaf8a4fc56f424d6c6833a,8,337,272,65,609,0,0,0,38,33,1,6,1.63685474,3112,2,22,11,654,684,30,18499,18860,361,293,280,13,1,99.88636364,NoArch
a861b870bd09f49ecea1a56146a9edf8fc173cb1,0,0,0,0,0,0,0,0,0,0,0,0,0,0,0,8,7,0,0,0,0,0,0,0,0,0,1,100,NoArch
1c5dc778b032b9b4bf5605e883b79fe36ce62363,0,0,0,0,0,0,0,0,0,0,0,0,0,0,0,33,10,0,0,0,0,0,0,0,0,0,1,100,NoArch
e1e7220560d799b380d79c257dfc0aaac949a623,2,37,0,37,37,1,0,1,7,34,1,2,0.571354974,87,1,228,3,21,18,3,539,404,135,11,9,2,1,97.5308642,Arch
a27490c186343bce568e64075f4e4dbfe13945ea,0,0,0,0,0,0,0,0,0,0,0,0,0,0,0,229,4,0,0,0,0,0,0,0,0,0,2,100,NoArch
00df8fbcb882af2c5f02e44483c07d2fe0c91a20,0,0,0,0,0,0,0,0,0,0,0,0,0,0,0,34,11,0,0,0,0,0,0,0,0,0,1,100,NoArch
710f365be8bc4b94b690f3a669976c7675d54704,0,0,0,0,0,0,0,0,0,0,0,0,0,0,0,1,0,0,0,0,0,0,0,0,0,0,1,100,NoArch
05b3442fbf6f20ede5212cbc8ce3c9b709341af2,0,0,0,0,0,0,0,0,0,0,0,0,0,0,0,2,1,0,0,0,0,0,0,0,0,0,1,100,NoArch
441e55023dbb9774ac2fd6b6543968d63a0c1d42,0,0,0,0,0,0,0,0,0,0,0,0,0,0,0,3,2,0,0,0,0,0,0,0,0,0,1,100,NoArch
cd1e3ed623a6edc0dba743dfc327ce5a4092d159,5,12,7,5,19,0,0,0,10,70,1,1,2.21260991,484,1,230,5,57,57,0,2201,2191,10,33,33,0,2,100,NoArch
8c3259ba2089f1af607e60296a8de56292ea91b9,2,3,1,2,4,0,0,0,39,5,1,2,0.811278124,1471,3,231,6,298,297,1,9661,9643,18,162,162,0,1,100,NoArch
62cba7ee3c6f0b73f1d195934b940b5061757a84,4,110,36,74,146,0,0,0,4,65,1,2,1.820612629,354,2,232,7,29,23,6,2097,1662,435,16,15,1,1,91.88235294,Arch
79c0980088a4e97c114e75c4f251db3f95b72618,0,0,0,0,0,0,0,0,0,0,0,0,0,0,0,233,8,0,0,0,0,0,0,0,0,0,1,100,NoArch
b57e524fc1c9477515bb5ca9523b86f66461494c,0,0,0,0,0,0,0,0,0,0,0,0,0,0,0,35,12,0,0,0,0,0,0,0,0,0,1,100,NoArch
340c58f3c11c90d1b678bd0ceea8dd4fdc90ff94,0,0,0,0,0,0,0,0,0,0,0,0,0,0,0,36,8,0,0,0,0,0,0,0,0,0,1,100,NoArch
fc1935c78e8b885708edaa05adb790da9b63a4c8,0,0,0,0,0,0,0,0,0,0,0,0,0,0,0,37,9,0,0,0,0,0,0,0,0,0,1,100,NoArch
e1c17e745462a8ac3d93ddef0bdaba3cdfac0a71,0,0,0,0,0,0,0,0,0,0,0,0,0,0,0,38,10,0,0,0,0,0,0,0,0,0,1,100,NoArch
258d4191bf1c8030686d65e38db74534eb7f0a71,0,0,0,0,0,0,0,0,0,0,0,0,0,0,0,39,11,0,0,0,0,0,0,0,0,0,1,100,NoArch
c06063a88b9956fab43db106157d5ea1c640fa37,0,0,0,0,0,0,0,0,0,0,0,0,0,0,0,40,12,0,0,0,0,0,0,0,0,0,1,100,NoArch
f4e4771f13fc9bc7921f71c1b9e094d5a4309134,1,2,6,4,8,0,0,0,5,30,1,1,0,212,2,234,8,31,32,1,931,942,11,13,13,0,1,100,NoArch
c8ee72a75cf26b5c364a8ec032e7d9235af8f469,0,0,0,0,0,0,0,0,0,0,0,0,0,0,0,41,12,0,0,0,0,0,0,0,0,0,1,100,NoArch
835e48610941ae55f70c71c7542482f30500e961,18,367,157,210,524,0,0,0,40,37,1,8,2.616700083,5671,2,23,10,1234,1203,31,35331,34978,353,491,464,27,1,100,NoArch
3e3f0fbe27d319893393f34a887b2ab427a038c0,0,0,0,0,0,0,0,0,0,0,0,0,0,0,0,235,9,0,0,0,0,0,0,0,0,0,1,100,NoArch
5fa06695d45c1ae7afc6e7f7ad4716e0ff32886d,0,0,0,0,0,0,0,0,0,0,0,0,0,0,0,42,12,0,0,0,0,0,0,0,0,0,1,100,NoArch
02b9415b1d31f0c4a5d8c52ca9821e18dd060d31,0,0,0,0,0,0,0,0,0,0,0,0,0,0,0,236,10,0,0,0,0,0,0,0,0,0,1,100,NoArch
1d6b6c5549fd0086e0682d519527d879b1efda33,1,52,0,52,52,1,0,1,1,0,1,1,0,0,1,24,7,1,0,1,233,0,233,1,0,1,1,97.0959596,Arch
a2a731f3f58e82d58e6359c32d8c423eee63a3c8,0,0,0,0,0,0,0,0,0,0,0,0,0,0,0,4,3,0,0,0,0,0,0,0,0,0,1,100,NoArch
c39ca5896e0d6c665c601666d2a9abf6aa0cd61a,0,0,0,0,0,0,0,0,0,0,0,0,0,0,0,5,4,0,0,0,0,0,0,0,0,0,1,100,NoArch
f24c33c97cacbab60f6f3f0f5a26cb350c5cce28,0,0,0,0,0,0,0,0,0,0,0,0,0,0,0,6,5,0,0,0,0,0,0,0,0,0,1,100,NoArch
ac2a19f791bfe80ce526139fcc3043f1972b0c34,0,0,0,0,0,0,0,0,0,0,0,0,0,0,0,7,6,0,0,0,0,0,0,0,0,0,1,100,NoArch
89d56e9e23bee4db4c19a8f22d755a191e6cf0e5,0,0,0,0,0,0,0,0,0,0,0,0,0,0,0,237,9,0,0,0,0,0,0,0,0,0,1,100,NoArch
dff585bd6876f20b5148ee2848e42e95d6ae94c2,0,0,0,0,0,0,0,0,0,0,0,0,0,0,0,238,10,0,0,0,0,0,0,0,0,0,1,100,NoArch
c221b63f52afd4d2b2c75b45360eb41bb9e55b7b,0,0,0,0,0,0,0,0,0,0,0,0,0,0,0,239,11,0,0,0,0,0,0,0,0,0,1,100,NoArch
6595bb6610b4a43060471b4d54d53c1b874fa851,0,0,0,0,0,0,0,0,0,0,0,0,0,0,0,240,12,0,0,0,0,0,0,0,0,0,1,100,NoArch
281f46ff26ed61d76d65cdfbd6e79382a804d236,0,0,0,0,0,0,0,0,0,0,0,0,0,0,0,241,7,0,0,0,0,0,0,0,0,0,1,100,NoArch
fcb06cfeebb753332463b4f0ed2b404e2ed3b5f4,0,0,0,0,0,0,0,0,0,0,0,0,0,0,0,242,8,0,0,0,0,0,0,0,0,0,1,100,NoArch
674deee1e61c6ef21041951ad8db0771b4547a75,0,0,0,0,0,0,0,0,0,0,0,0,0,0,0,243,9,0,0,0,0,0,0,0,0,0,1,100,NoArch
5d523b4d7f0f99cb0d231c05f847cda331d0fb4f,0,0,0,0,0,0,0,0,0,0,0,0,0,0,0,244,10,0,0,0,0,0,0,0,0,0,1,100,NoArch
be98c2990d9d557e77424c0ea5d7b4b5a279a463,0,0,0,0,0,0,0,0,0,0,0,0,0,0,0,22,0,0,0,0,0,0,0,0,0,0,1,100,NoArch
03e67154953150c38fbf92e079ada74aec75398d,24,1907,361,1546,2268,2,0,2,37,60,1,6,2.784853928,6064,2,245,11,986,796,190,38787,32118,6669,445,354,91,1,90.73405535,Arch
2789bebdba3125304cf69747c95e80ba1e98fc67,0,0,0,0,0,0,0,0,0,0,0,0,0,0,0,246,12,0,0,0,0,0,0,0,0,0,1,100,NoArch
1e9fe807f93282fe8c98cab35642ca160ec1e368,8,410,66,344,476,1,0,1,18,17,1,2,2.5427071,956,1,247,13,166,116,50,5866,4040,1826,88,69,19,1,99.31584949,NoArch
728362023bc6fbef9130e979818aa358c9152635,0,0,0,0,0,0,0,0,0,0,0,0,0,0,0,248,14,0,0,0,0,0,0,0,0,0,0,100,NoArch
af00ca67a7726c88f9e875f242cb09ea5a72f56f,1,1,1,0,2,0,0,0,23,3,1,1,0,240,4,25,2,28,28,0,1436,1436,0,12,12,0,1,100,NoArch
c3a37aae3698172059b0f863d3d9fbdef21f140d,0,0,0,0,0,0,0,0,0,0,0,0,0,0,0,249,14,0,0,0,0,0,0,0,0,0,1,100,NoArch
d5526daad1db62eec60e793b7278a47413a9e634,0,0,0,0,0,0,0,0,0,0,0,0,0,0,0,43,0,0,0,0,0,0,0,0,0,0,1,100,NoArch
e5479e7b975bfc7c0251c49ba0bd40a0e1c46edd,0,0,0,0,0,0,0,0,0,0,0,0,0,0,0,44,1,0,0,0,0,0,0,0,0,0,1,100,NoArch
e2c272282eb8911e286eb16c98dc2cd844eeae56,0,0,0,0,0,0,0,0,0,0,0,0,0,0,0,250,13,0,0,0,0,0,0,0,0,0,1,100,NoArch
2b1580376f7ad813683a981657e9a88615397568,0,0,0,0,0,0,0,0,0,0,0,0,0,0,0,251,14,0,0,0,0,0,0,0,0,0,1,100,NoArch
80703c0d8501452c9e1853c1057f9a8158a93b97,0,0,0,0,0,0,0,0,0,0,0,0,0,0,0,252,15,0,0,0,0,0,0,0,0,0,0,100,NoArch
06031e96d66961f1ab0f88adc8b143972890b4fa,0,0,0,0,0,0,0,0,0,0,0,0,0,0,0,253,16,0,0,0,0,0,0,0,0,0,0,100,NoArch
ec7215a1ea56ae66567f536d76ab45cf86d446fd,0,0,0,0,0,0,0,0,0,0,0,0,0,0,0,254,17,0,0,0,0,0,0,0,0,0,0,100,NoArch
54c7c5e90a77e298f09fb884520b00b1496cde90,0,0,0,0,0,0,0,0,0,0,0,0,0,0,0,0,0,0,0,0,0,0,0,0,0,0,0,100,NoArch
8e900b4a1450bc64057a257efa7682daf5da1c8b,235,14209,22784,8575,36993,79,131,210,21,2,2,33,NaN,23912,1,0,0,2281,3225,944,76779,116845,40066,1012,1563,551,0,24.21652422,Arch
466dc8fc715889dbccd793e7fb7802dfcfe1063d,0,0,0,0,0,0,0,0,0,0,0,0,0,0,0,268,8,0,0,0,0,0,0,0,0,0,0,100,NoArch
9008a28bff4e06852815d26f4d1dcc2c38654edf,0,0,0,0,0,0,0,0,0,0,0,0,0,0,0,269,9,0,0,0,0,0,0,0,0,0,0,100,NoArch
cdeb6ea2198cc94f450ca2ff949c0c198a4f8b00,13,1089,0,1089,1089,13,0,13,1,0,1,2,3.637703795,0,1,269,4,104,0,104,5198,0,5198,64,0,64,1,95.67147614,Arch
492dc3b8f8a1b5dbf98b6c30b79b18ec87e7e89e,0,0,0,0,0,0,0,0,0,0,0,0,0,0,0,0,0,0,0,0,0,0,0,0,0,0,1,100,NoArch
e7456bf58156eaf072e18416e90a6ec2494eae94,0,0,0,0,0,0,0,0,0,0,0,0,0,0,0,1,1,0,0,0,0,0,0,0,0,0,1,100,NoArch
be73ec7ae269c3f503e55211add6b8cf9cb1fe50,0,0,0,0,0,0,0,0,0,0,0,0,0,0,0,2,2,0,0,0,0,0,0,0,0,0,1,100,NoArch
9b8e375aea658b40495f91bfad343464d3824dfa,0,0,0,0,0,0,0,0,0,0,0,0,0,0,0,3,3,0,0,0,0,0,0,0,0,0,1,100,NoArch
11dc42ad6478ab67d753a9f1b657cdaba0669b29,0,0,0,0,0,0,0,0,0,0,0,0,0,0,0,4,4,0,0,0,0,0,0,0,0,0,0,100,NoArch
e18f9ca99b848f301b6349869d2512f706dc73f3,0,0,0,0,0,0,0,0,0,0,0,0,0,0,0,59,0,0,0,0,0,0,0,0,0,0,1,100,NoArch
ed9239ee042925d1d37949e7954ae971fe391fc6,0,0,0,0,0,0,0,0,0,0,0,0,0,0,0,60,1,0,0,0,0,0,0,0,0,0,1,100,NoArch
a23505906e4fe76706365ff7aa92f386fb6fcf97,0,0,0,0,0,0,0,0,0,0,0,0,0,0,0,10,0,0,0,0,0,0,0,0,0,0,1,100,NoArch
f85120ba79690dc094ea33606facda1db19631ae,0,0,0,0,0,0,0,0,0,0,0,0,0,0,0,23,0,0,0,0,0,0,0,0,0,0,1,100,NoArch
5c7b7486d1cbedbc006d5e9a7dfbcea7678a8311,0,0,0,0,0,0,0,0,0,0,0,0,0,0,0,5,5,0,0,0,0,0,0,0,0,0,1,100,NoArch
ff664ef8a34de6dac9044875d4059c1493ce6528,0,0,0,0,0,0,0,0,0,0,0,0,0,0,0,6,6,0,0,0,0,0,0,0,0,0,1,100,NoArch
e1311b64517df7b121eb4878b8bde174db88f0cf,0,0,0,0,0,0,0,0,0,0,0,0,0,0,0,7,7,0,0,0,0,0,0,0,0,0,1,100,NoArch
0ac105e163d7fe4feaabc3d00521cf7e1d7d78d2,0,0,0,0,0,0,0,0,0,0,0,0,0,0,0,24,1,0,0,0,0,0,0,0,0,0,1,100,NoArch
87b64a3b0530a433520bd32ca81858207bd64588,0,0,0,0,0,0,0,0,0,0,0,0,0,0,0,25,2,0,0,0,0,0,0,0,0,0,1,100,NoArch
8c1db2821e3a0e87e7ab96498d4be14cb75f49d7,0,0,0,0,0,0,0,0,0,0,0,0,0,0,0,8,8,0,0,0,0,0,0,0,0,0,1,100,NoArch
48da0df6c57ad2fd51ed91a971b44b415e17de4d,0,0,0,0,0,0,0,0,0,0,0,0,0,0,0,9,9,0,0,0,0,0,0,0,0,0,1,100,NoArch
bc40723fc8aeeb0b57d83e8b2cbe1377d4a1ebe3,0,0,0,0,0,0,0,0,0,0,0,0,0,0,0,10,10,0,0,0,0,0,0,0,0,0,2,100,NoArch
754bbd5a43f0156acaeb84bc2573274be1da8a69,0,0,0,0,0,0,0,0,0,0,0,0,0,0,0,11,11,0,0,0,0,0,0,0,0,0,1,100,NoArch
9e422555234952d9d7090d14d86eb25e8114c586,0,0,0,0,0,0,0,0,0,0,0,0,0,0,0,26,3,0,0,0,0,0,0,0,0,0,1,100,NoArch
66243cb6fd778eeb5c2dc960b0430584088fc943,0,0,0,0,0,0,0,0,0,0,0,0,0,0,0,27,4,0,0,0,0,0,0,0,0,0,1,100,NoArch
1857557df701c5c27093dd2762cd60110f06a5f3,3,33,1,32,34,0,0,0,31,203,1,3,1.395123307,754,2,26,0,116,115,1,3686,3602,84,46,45,1,1,100,NoArch
3b1b3f0d79608c32df9acebcac1dd757ea3fef24,2,60,44,16,104,0,0,0,2,64,1,1,0.998932655,198,2,27,1,18,18,0,1047,985,62,10,10,0,1,100,NoArch
00c23392cc9a6a902217d58a5f20360163b61450,1,3,6,3,9,0,0,0,19,199,1,1,0,374,3,28,2,48,48,0,1818,1839,21,29,29,0,1,100,NoArch
93a483eb1efafadd9cac2e104ecbe31ae2b9451d,0,0,0,0,0,0,0,0,0,0,0,0,0,0,0,12,0,0,0,0,0,0,0,0,0,0,1,100,NoArch
bbcfd0b3e23062b1f33e9f81eb94ff0c2093ad41,0,0,0,0,0,0,0,0,0,0,0,0,0,0,0,13,1,0,0,0,0,0,0,0,0,0,1,100,NoArch
0c4cb52cbdc1b12732ec154dcfc70594ea9e9088,0,0,0,0,0,0,0,0,0,0,0,0,0,0,0,11,0,0,0,0,0,0,0,0,0,0,1,100,NoArch
7a42efd0d6c07d85f89c46ced85bf3949f60fc02,0,0,0,0,0,0,0,0,0,0,0,0,0,0,0,12,1,0,0,0,0,0,0,0,0,0,1,100,NoArch
3f7443f350516b697e9e409c757c432be4540662,0,0,0,0,0,0,0,0,0,0,0,0,0,0,0,13,2,0,0,0,0,0,0,0,0,0,1,100,NoArch
0fa29793bb738f3b1848063806c6fb53d44fca01,0,0,0,0,0,0,0,0,0,0,0,0,0,0,0,14,3,0,0,0,0,0,0,0,0,0,1,100,NoArch
c22739175bc664887b4195f58cdec1e63e15959e,0,0,0,0,0,0,0,0,0,0,0,0,0,0,0,270,0,0,0,0,0,0,0,0,0,0,0,100,NoArch
d77c7ecb8e3438e4ca4b25dd28373b3ae05a5c49,0,0,0,0,0,0,0,0,0,0,0,0,0,0,0,0,0,0,0,0,0,0,0,0,0,0,0,100,NoArch
d8e96da726d2d2e57d40afdd9deb6dbac09719ca,17,7,1141,1134,1148,0,13,13,30,6,1,6,3.797918375,2262,0,0,0,163,268,105,5441,10764,5323,74,139,65,0,95.67147614,Arch
627d42de01bbd935ac469ff0ca0af135b75cef1e,20,1172,7,1165,1179,13,0,13,31,90,1,7,3.909228562,1728,1,271,1,448,338,110,14747,9231,5516,196,129,67,1,95.33851276,Arch
0d274c9617ee25f51abfcef572e881b93e8216b7,2,18,3,15,21,0,0,0,31,150,1,2,0.998363673,930,2,272,2,179,177,2,6665,6583,82,72,71,1,1,100,NoArch
dd7d8f60f47002c6c785c59783b66ea5abf4bc60,20,301,97,204,398,0,0,0,34,302,1,4,3.363037747,2621,1,273,3,404,343,61,15295,14254,1041,186,164,22,1,100,NoArch
c2d9f070a66e2dd4203a8474ff8d53e4a6e0f406,0,0,0,0,0,0,0,0,0,0,0,0,0,0,0,274,4,0,0,0,0,0,0,0,0,0,1,100,NoArch
abdbc5744d15001bf473cf0701ad3b1b490e6fde,42,106,1490,1384,1596,0,13,13,33,87,1,12,4.641485782,6663,0,0,0,858,1031,173,30068,36707,6639,364,454,90,1,95.33851276,Arch
117a8a2474e69cfcc696f97dfd3336aa82d57702,0,0,0,0,0,0,0,0,0,0,0,0,0,0,0,1,1,0,0,0,0,0,0,0,0,0,1,100,NoArch
4c8ef34d89fd8ff2277c901a092c961bebe3269a,42,1491,107,1384,1598,13,0,13,34,183,1,12,4.640219762,5279,1,14,0,1031,858,173,36707,30068,6639,454,364,90,1,95.33851276,Arch
e70a61217cd55cf6449b814b49a02939363b120d,0,0,0,0,0,0,0,0,0,0,0,0,0,0,0,0,0,0,0,0,0,0,0,0,0,0,1,100,NoArch
37f6d5bc4ffdb794c4a7e03c5e2dd073c6d50cf4,0,0,0,0,0,0,0,0,0,0,0,0,0,0,0,1,1,0,0,0,0,0,0,0,0,0,1,100,NoArch
9c81a5237f5c72819ec66e8e7a1e87f3c71afc35,0,0,0,0,0,0,0,0,0,0,0,0,0,0,0,2,2,0,0,0,0,0,0,0,0,0,1,100,NoArch
a2365d95f8b7a8d20730a44654b2a20215bf9156,0,0,0,0,0,0,0,0,0,0,0,0,0,0,0,15,0,0,0,0,0,0,0,0,0,0,1,100,NoArch
e9c1d6396e4178b837181a624b65a958af03fd34,0,0,0,0,0,0,0,0,0,0,0,0,0,0,0,16,1,0,0,0,0,0,0,0,0,0,0,100,NoArch
21a4eb06f5be66acfe2eaedaa8d7988a44b37338,42,106,1490,1384,1596,0,13,13,33,87,1,12,4.641485782,6663,0,10,0,858,1031,173,30068,36707,6639,364,454,90,0,95.33851276,Arch
9c3095aeab368e4984fde046e10d0c274cf240c0,42,1491,107,1384,1598,13,0,13,34,183,1,12,4.640219762,5279,1,3,3,1031,858,173,36707,30068,6639,454,364,90,1,95.33851276,Arch
b79cc95f1c33e84ec79c32abddf7bb2551440f0d,0,0,0,0,0,0,0,0,0,0,0,0,0,0,0,4,4,0,0,0,0,0,0,0,0,0,1,100,NoArch
7eaba5aa09a2bff529590a1c309b9575a25a497e,0,0,0,0,0,0,0,0,0,0,0,0,0,0,0,15,1,0,0,0,0,0,0,0,0,0,0,100,NoArch
5949f5e5a36e47dc613b250a9b7f279f306240d0,0,0,0,0,0,0,0,0,0,0,0,0,0,0,0,16,2,0,0,0,0,0,0,0,0,0,1,100,NoArch
2550e35bbce6b5cd487259405e44ff2802416cc7,42,106,1490,1384,1596,0,13,13,33,87,1,12,4.641485782,6663,0,11,1,858,1031,173,30068,36707,6639,364,454,90,1,95.33851276,Arch
51afd620dad36eb6d3276486a76ed7f166560563,0,0,0,0,0,0,0,0,0,0,0,0,0,0,0,12,2,0,0,0,0,0,0,0,0,0,1,100,NoArch
4b6626bca48cc797380e9e0c6a91c3e2bc7a01f8,0,0,0,0,0,0,0,0,0,0,0,0,0,0,0,13,3,0,0,0,0,0,0,0,0,0,1,100,NoArch
1b1f7247d396f8818f497a82ce2c6d1d3fade76a,0,0,0,0,0,0,0,0,0,0,0,0,0,0,0,14,4,0,0,0,0,0,0,0,0,0,1,100,NoArch
bf3c5d7aff6b0070c557d7044aec4e0d98032fb7,0,0,0,0,0,0,0,0,0,0,0,0,0,0,0,15,5,0,0,0,0,0,0,0,0,0,1,100,NoArch
8d4b6f7996928759108ed74693ef4426601bfda4,0,0,0,0,0,0,0,0,0,0,0,0,0,0,0,16,6,0,0,0,0,0,0,0,0,0,0,100,NoArch
c6564e1bff0e92bd913561752fde2334cc7d82f4,0,0,0,0,0,0,0,0,0,0,0,0,0,0,0,270,0,0,0,0,0,0,0,0,0,0,0,100,NoArch
4e7eafa0669dace70113cb5e92ac075a207f0856,3,33,1,32,34,0,0,0,31,339,1,3,1.395123307,754,2,271,1,116,115,1,3686,3602,84,46,45,1,1,100,NoArch
3604f4fd70c81c782d26b7f7b0c2d6fa54240ae2,39,1458,106,1352,1564,13,0,13,34,187,1,10,4.55898651,4525,1,275,0,915,743,172,33021,26466,6555,408,319,89,1,95.33851276,Arch
32d4ad76def63559a83def91582320ce8e31ab74,38,99,1454,1355,1553,0,13,13,33,95,1,9,4.535194503,5506,0,272,2,695,867,172,24627,31203,6576,290,379,89,1,95.33851276,Arch
1b5c4e428e3ac83bee7d0a73e518880819f34541,38,1455,100,1355,1555,13,0,13,34,182,1,9,4.533979536,4151,1,276,1,867,695,172,31203,24627,6576,379,290,89,1,95.33851276,Arch
e33fc2bc1fedbb746f38b9daa41b8b657a9bbfc5,36,96,1436,1340,1532,0,13,13,33,100,1,8,4.478930535,4561,0,273,3,518,688,170,18044,24538,6494,219,307,88,1,95.33851276,Arch
cb3dab05528ea8597fa41d4c09618b2907d544d8,36,1437,97,1340,1534,13,0,13,34,191,1,8,4.4777467,3221,1,277,2,688,518,170,24538,18044,6494,307,219,88,1,95.33851276,Arch
6f8dcb9a14c843936358784ba5bb7bca13d6a84d,36,96,1436,1340,1532,0,13,13,33,100,1,8,4.478930535,4561,0,17,7,518,688,170,18044,24538,6494,219,307,88,0,95.33851276,Arch
8dfd1a6027d2c293fac298c3197567b80c2f0402,36,1437,97,1340,1534,13,0,13,34,191,1,8,4.4777467,3221,1,17,2,688,518,170,24538,18044,6494,307,219,88,1,95.33851276,Arch
e1de8c0286840cf021dd686d78525ab47b6dc0d1,36,96,1436,1340,1532,0,13,13,33,100,1,8,4.478930535,4561,0,18,8,518,688,170,18044,24538,6494,219,307,88,1,95.33851276,Arch
9b31fdd70fcd6aa0bac31f6d91256d1df81a86c8,36,1437,97,1340,1534,13,0,13,34,191,1,8,4.4777467,3221,1,18,3,688,518,170,24538,18044,6494,307,219,88,1,95.33851276,Arch
913345d239e7aa67bfbfb80e8d1f2394c5de64c4,36,96,1436,1340,1532,0,13,13,33,100,1,8,4.478930535,4561,0,19,9,518,688,170,18044,24538,6494,219,307,88,1,95.33851276,Arch
7619f71555551379339a326f5bccc040b00a227f,0,0,0,0,0,0,0,0,0,0,0,0,0,0,0,2,0,0,0,0,0,0,0,0,0,0,1,100,NoArch
79fb7bd60fac7e8ec35b2d44291266071445c44c,0,0,0,0,0,0,0,0,0,0,0,0,0,0,0,3,1,0,0,0,0,0,0,0,0,0,1,100,NoArch
533a6096f62304c4ce4a0ebfec9f3897b3762c4a,0,0,0,0,0,0,0,0,0,0,0,0,0,0,0,4,2,0,0,0,0,0,0,0,0,0,1,100,NoArch
d4215397c2945ff1c5bd612a7681b704b65753b3,0,0,0,0,0,0,0,0,0,0,0,0,0,0,0,5,3,0,0,0,0,0,0,0,0,0,1,100,NoArch
42be92e2828ebf2da5fbc84662fc1791633d18ce,0,0,0,0,0,0,0,0,0,0,0,0,0,0,0,6,4,0,0,0,0,0,0,0,0,0,0,100,NoArch
256ac332d3a018af9eec51998c4237c8a6a3d58c,0,0,0,0,0,0,0,0,0,0,0,0,0,0,0,7,5,0,0,0,0,0,0,0,0,0,1,100,NoArch
60a8a0dcdb6706199165bdbb8f4838bad75adb69,0,0,0,0,0,0,0,0,0,0,0,0,0,0,0,8,6,0,0,0,0,0,0,0,0,0,1,100,NoArch
98a1cab4a36e8e262197e056a67c5737fd4ee7ad,0,0,0,0,0,0,0,0,0,0,0,0,0,0,0,9,7,0,0,0,0,0,0,0,0,0,1,100,NoArch
000624777a914363e6e1a2518db1dce6288a7746,0,0,0,0,0,0,0,0,0,0,0,0,0,0,0,10,8,0,0,0,0,0,0,0,0,0,1,100,NoArch
35d465b2ffd1337b546e03e491189aaa9fee16f5,0,0,0,0,0,0,0,0,0,0,0,0,0,0,0,11,9,0,0,0,0,0,0,0,0,0,2,100,NoArch
8a289341e3146da77f407b40180e843fcc1a9898,0,0,0,0,0,0,0,0,0,0,0,0,0,0,0,12,10,0,0,0,0,0,0,0,0,0,1,100,NoArch
da0761234832a2d219a4f72f70b94e141a05410b,0,0,0,0,0,0,0,0,0,0,0,0,0,0,0,13,11,0,0,0,0,0,0,0,0,0,1,100,NoArch
dee2db099e7c42c6c8c6d28bdff51102ef47081f,0,0,0,0,0,0,0,0,0,0,0,0,0,0,0,14,12,0,0,0,0,0,0,0,0,0,1,100,NoArch
3366d78cf9725f737b764468d2b4ffe6bc18fa4e,0,0,0,0,0,0,0,0,0,0,0,0,0,0,0,15,13,0,0,0,0,0,0,0,0,0,1,100,NoArch
cc6242c018f675e9cd576df850713e995c729504,0,0,0,0,0,0,0,0,0,0,0,0,0,0,0,16,14,0,0,0,0,0,0,0,0,0,0,100,NoArch
05cc368353d72c798b261d9dbfcee05d8c7cdaa5,36,1437,97,1340,1534,13,0,13,34,191,1,8,4.4777467,3221,1,17,2,688,518,170,24538,18044,6494,307,219,88,1,95.33851276,Arch
33a9b04bb67cf8f0434d25922642d145ff3f83a1,36,96,1436,1340,1532,0,13,13,33,100,1,8,4.478930535,4561,0,17,15,518,688,170,18044,24538,6494,219,307,88,1,95.33851276,Arch
221bc1ac679c4bad41960ae4613ee67ceec713cb,0,0,0,0,0,0,0,0,0,0,0,0,0,0,0,20,10,0,0,0,0,0,0,0,0,0,0,100,NoArch
a4c97afaf377cb1461faee2654a1a7c00e0a92c1,36,1437,97,1340,1534,13,0,13,34,191,1,8,4.4777467,3221,1,19,4,688,518,170,24538,18044,6494,307,219,88,1,95.33851276,Arch
cb61f04eb422c48fb7c6c5d0c1ff7b9834bbe4a4,36,96,1436,1340,1532,0,13,13,33,100,1,8,4.478930535,4561,0,21,11,518,688,170,18044,24538,6494,219,307,88,1,95.33851276,Arch
615c019ac2ba1739a7d220fea2fdf67560723cbc,0,0,0,0,0,0,0,0,0,0,0,0,0,0,0,22,12,0,0,0,0,0,0,0,0,0,0,100,NoArch
2660351b81bb6ea57f5c8c33a935600132db1d57,36,1437,97,1340,1534,13,0,13,34,191,1,8,4.4777467,3221,1,28,0,688,518,170,24538,18044,6494,307,219,88,1,95.33851276,Arch
ea4bd94d187975224470dfc66d568d69dd32ed39,36,96,1436,1340,1532,0,13,13,33,100,1,8,4.478930535,4561,0,22,12,518,688,170,18044,24538,6494,219,307,88,0,95.33851276,Arch
625d88ca5ce134b9f7572e4266a39bfb41d3bb02,158,24136,0,24136,24136,158,0,158,25,122,1,22,6.662493493,0,1,23,13,3246,0,3246,118102,0,118102,1575,0,1575,0,58.81826321,Arch
a317436c7b069bad1f171acfe3b17c1480dd6724,158,0,24136,24136,24136,0,158,158,0,0,1,22,6.662493493,24136,0,23,0,0,3246,3246,0,118102,118102,0,1575,1575,1,58.81826321,Arch
e970ad393094f498242631a92b7cd7dc9c17cd06,0,0,0,0,0,0,0,0,0,0,0,0,0,0,0,23,13,0,0,0,0,0,0,0,0,0,0,100,NoArch
395bb7f9c666410c0fc3a0fe10ad213a5257fcdf,0,0,0,0,0,0,0,0,0,0,0,0,0,0,0,26,16,0,0,0,0,0,0,0,0,0,0,100,NoArch
af73cd3f2d5249dd386dc299a9d4d1e4f9b3bec2,36,1437,97,1340,1534,13,0,13,34,191,1,8,4.4777467,3221,1,278,3,688,518,170,24538,18044,6494,307,219,88,0,95.33851276,Arch
bed2354c5d0f773aedffc5299b4e18554e0b28ed,0,0,0,0,0,0,0,0,0,0,0,0,0,0,0,279,4,0,0,0,0,0,0,0,0,0,1,100,NoArch
a052723e1b0f22ec061865f6cdad2ad45c67ac93,36,96,1436,1340,1532,0,13,13,33,100,1,8,4.478930535,4561,0,27,16,518,688,170,18044,24538,6494,219,307,88,0,95.33851276,Arch
3c71a148c09d3951aaabdb7dcf6639d70905016f,36,1437,97,1340,1534,13,0,13,34,191,1,8,4.4777467,3221,1,20,3,688,518,170,24538,18044,6494,307,219,88,0,95.33851276,Arch
50755b27a23a8ae8968f1126dbcff5ad91dd0a9f,0,0,0,0,0,0,0,0,0,0,0,0,0,0,0,21,4,0,0,0,0,0,0,0,0,0,1,100,NoArch
7da52d806e8ad31fe039140e461ab7986fa7d948,0,0,0,0,0,0,0,0,0,0,0,0,0,0,0,22,5,0,0,0,0,0,0,0,0,0,1,100,NoArch
e6407b570ecbb06e93efe178194bd3fe33bfb0e5,0,0,0,0,0,0,0,0,0,0,0,0,0,0,0,23,6,0,0,0,0,0,0,0,0,0,1,100,NoArch
2bce9ea43fada2e40501477af25c94c0f5fa771e,0,0,0,0,0,0,0,0,0,0,0,0,0,0,0,280,5,0,0,0,0,0,0,0,0,0,1,100,NoArch
cac9e93d3984bf05f67c86fba0d7024b82469ae1,29,1624,58,1566,1682,15,0,15,28,128,1,12,4.298145929,2463,1,281,6,624,437,187,21704,14058,7646,285,184,101,1,88.83034773,Arch
2ca528fa31870b767f7d89550d8781c40c6b8bcf,3,140,0,140,140,1,0,1,3,128,1,2,1.14022707,204,1,282,7,30,16,14,1902,1120,782,20,8,12,1,97.97979798,Arch
76bf17aaebe0ac8a6bd3d0c787a9e4616a00f5b1,0,0,0,0,0,0,0,0,0,0,0,0,0,0,0,283,8,0,0,0,0,0,0,0,0,0,1,100,NoArch
3e8840cd1454bb16d170c9dec2b1f2b40171bdc8,1,0,0,0,0,0,0,0,2,0,1,1,NaN,59,1,284,9,5,5,0,241,241,0,3,3,0,1,99.59758551,NoArch
bbb830dff638cb1e80395941db1d0e0b58103eff,2,47,9,38,56,0,0,0,35,281,1,2,0.924133542,668,1,285,10,131,127,4,4150,3859,291,39,38,1,1,100,NoArch
5874b2ab91721eaae00afb492b5b52bf58e0335f,0,0,0,0,0,0,0,0,0,0,0,0,0,0,0,24,7,0,0,0,0,0,0,0,0,0,1,100,NoArch
9c56ed4e8af0f977fe76f82d231757c2563d2094,4,244,7,237,251,2,0,2,12,102,1,1,1.648237882,170,1,286,8,32,14,18,1909,760,1149,14,7,7,1,88.58921162,Arch
26fb764f5bbf47abd0531c1e8633386171c1e1bf,3,19,19,0,38,0,0,0,13,308,1,2,1.210810026,336,2,287,9,40,40,0,1553,1553,0,16,16,0,1,99.14346895,NoArch
5cbc5e25099098ff17761b21fedc3581b27d05fc,3,170,5,165,175,1,0,1,3,326,1,2,1.563853487,299,2,9,0,52,32,20,2132,1345,787,33,23,10,1,99.24973205,NoArch
0fcfe2863c26eb73d5cec07a6d552b0d130f362b,7,120,31,89,151,0,0,0,21,246,1,2,2.494648942,1083,1,288,7,139,130,9,5488,5096,392,69,63,6,1,100,NoArch
14b6af1c75a552e6d0718a1e9fde95f18a394bc3,0,0,0,0,0,0,0,0,0,0,0,0,0,0,0,289,3,0,0,0,0,0,0,0,0,0,1,100,NoArch
f739842c9055909dbd9bf8fc6e49dcd34661b84f,4,635,0,635,635,4,0,4,1,0,1,2,1.836714815,0,1,290,4,59,0,59,3086,0,3086,43,0,43,1,96.8238691,Arch
7f5901e8bdc281305ab29a32fd5630c5024b4feb,3,15,3,12,18,0,0,0,14,356,1,2,1.122113677,839,2,29,0,114,114,0,4147,4087,60,23,23,0,1,100,NoArch
d4a3c058e80030e85eb5dbe4b9d2a44819b22202,22,50,16,34,66,0,0,0,22,264,1,7,3.195262175,2151,1,291,0,181,180,1,11135,10996,139,123,121,2,1,100,NoArch
76088c6238f58ba05a5c891e3439b288ef0d0bc5,2,27,24,3,51,0,0,0,3,2,1,2,0.139232999,206,1,292,1,13,12,1,1133,1122,11,11,10,1,1,100,NoArch
905586f88119ff02fb5eb9c3c713c6f6bad2301d,3,383,74,309,457,0,0,0,5,381,1,2,1.411381262,407,2,10,0,54,31,23,3933,2005,1928,33,23,10,1,99.2139738,NoArch
a90142c5321e6d48b46da96bc11fb56389cb6bb0,3,71,380,309,451,0,0,0,6,0,1,2,1.418782847,716,2,293,2,31,54,23,2005,3933,1928,23,33,10,1,99.2139738,NoArch
ce35df9fb9c907883e9cede03109765e900248e7,29,1185,424,761,1609,9,1,10,38,223,1,9,3.92073633,2455,1,294,3,393,286,107,17862,13173,4689,260,168,92,2,89.93288591,Arch
1c37d4cee7042d64acc446007b30c99357c158b9,1,3,1,2,4,0,0,0,36,113,1,1,0,430,3,295,4,107,107,0,2654,2636,18,25,25,0,1,100,NoArch
0457a5785252d997d93cebb4c275e2a355577d75,5,459,74,385,533,2,0,2,7,12,1,2,1.959087684,407,2,11,1,59,31,28,4187,2005,2182,36,23,13,1,97.23991507,Arch
2dc24e02526e29a3bd385276d7db162f8624fc65,6,77,5,72,82,0,0,0,23,256,1,4,2.450371212,749,3,296,5,91,79,12,4554,4194,360,66,62,4,1,100,NoArch
53aca6d7e502e83f1c38e8926ae671b026bd3872,2,77,40,37,117,0,0,0,41,282,1,2,0.421166015,1703,3,297,4,338,329,9,10703,10376,327,193,189,4,1,100,NoArch
cc369c8d7ac793349eecf0fcdfe1ee82f79c6f88,1,6,0,6,6,0,0,0,42,0,1,1,0,1116,3,298,5,283,281,2,6587,6549,38,142,142,0,1,100,NoArch
5aa8b0cccef971441fcda29b86eee652ee6884a3,0,0,0,0,0,0,0,0,0,0,0,0,0,0,0,299,6,0,0,0,0,0,0,0,0,0,1,100,NoArch
2182b994ccaaeff046c37965d99a75a6709aa692,3,20,12,8,32,0,0,0,32,322,1,3,1.014097656,490,1,300,7,97,96,1,2440,2424,16,39,38,1,1,100,NoArch
4c6d01f9bc333e20cf44f603804ce28bc7612501,0,0,0,0,0,0,0,0,0,0,0,0,0,0,0,301,6,0,0,0,0,0,0,0,0,0,1,100,NoArch
819709d877b8f21d4c680d8d1a91f70cfd6bbadb,14,2358,4,2354,2362,13,0,13,20,8,1,3,3.442132587,252,1,12,1,217,33,184,13504,1432,12072,82,9,73,1,94.59459459,Arch
a71d0cf565522bac947fd25f8da16e90d59b4b81,1,3,2,1,5,0,0,0,2,2,1,1,0,220,2,302,7,8,8,0,1585,1574,11,5,5,0,1,100,NoArch
de5d14395bed3d9eeae07c7a1d60975b6778e3d2,27,180,140,40,320,1,0,1,40,145,1,12,4.100905002,6318,1,303,7,1098,1089,9,37059,36977,82,486,482,4,1,93.90774587,Arch
d7041830569503ca674fe0600c0d18f3707779cd,2,4,2,2,6,0,0,0,4,626,1,2,0.650022422,143,2,304,8,8,8,0,609,588,21,5,5,0,1,100,NoArch
de72584e5d5262f3c28f4b7be7ffd719482484d1,4,325,46,279,371,1,0,1,34,470,1,4,1.468546093,1168,2,305,9,243,201,42,7291,5951,1340,141,107,34,1,99.1290578,NoArch
230b96c418e4638d8529e1adbe61a195f142f0cd,4,66,1,65,67,0,0,0,5,60,1,2,1.669311823,412,1,306,9,41,32,9,2604,2132,472,25,20,5,1,100,NoArch
5b06c3290bd7f43e9a1061aed66e1f751b885e05,8,641,12,629,653,2,0,2,3,16,1,2,1.835681021,895,1,13,1,151,79,72,7268,4127,3141,52,30,22,1,98.96988906,NoArch
e213cfe5d3614e2826c87ea604796838e428ce9e,3,228,7,221,235,0,0,0,43,26,1,3,0.681162934,2134,3,307,10,485,425,60,14442,12855,1587,238,226,12,1,100,NoArch
8349f69f13cafcb3b8de4e004725a85d6bdbc65c,1,8,1,7,9,0,0,0,38,21,1,1,0,432,3,308,11,107,107,0,2677,2654,23,25,25,0,1,100,NoArch
a3a4644d45779fddb50789f7ea48ddaa2d1f1afc,2,7,6,1,13,0,0,0,6,182,1,2,0.619382195,235,2,309,7,30,30,0,1024,1026,2,12,12,0,1,100,NoArch
094c95b0a7ce084a1dd97776bc67d0f84786af08,0,0,0,0,0,0,0,0,0,0,0,0,0,0,0,310,8,0,0,0,0,0,0,0,0,0,1,100,NoArch
7afee340172a95bf1d7df4038ce615448f719a0d,2,16,0,16,16,0,0,0,44,2,1,2,0.543564443,1969,3,311,9,402,400,2,12445,12351,94,206,205,1,1,100,NoArch
77a7965f776d2e6932d0abaac69c0747ac33d2d6,2,52,22,30,74,0,0,0,43,12,1,2,0.727300679,873,3,312,10,104,98,6,5700,5511,189,76,74,2,1,100,NoArch
8a0ee2eea940e235ec42f0203b293fc7c155f7ca,0,0,0,0,0,0,0,0,0,0,0,0,0,0,0,14,1,0,0,0,0,0,0,0,0,0,1,100,NoArch
ec468882133c8ed33b3eeee9243b38f152727781,0,0,0,0,0,0,0,0,0,0,0,0,0,0,0,15,2,0,0,0,0,0,0,0,0,0,1,100,NoArch
c62f97dd29b803040d573845f335ac1ecaa765d7,13,872,78,794,950,4,0,4,4,63,1,3,2.96061103,1576,1,16,3,263,168,95,11388,7462,3926,111,56,55,1,98.0127186,NoArch
b2c40ab4701dbc1fd7a2968afd69ee431a96beef,0,0,0,0,0,0,0,0,0,0,0,0,0,0,0,313,10,0,0,0,0,0,0,0,0,0,0,100,NoArch
0f0875da373007f87acd3ad6a8bd88b9b747494d,2,54,1,53,55,0,0,0,6,34,1,1,0.225363639,227,1,314,11,19,16,3,1728,1372,356,10,9,1,1,100,NoArch
18249237dc0ff1623c14239519d798963ef93269,2,37,0,37,37,0,0,0,44,81,1,2,0.99947302,1136,3,315,12,171,159,12,7076,6814,262,65,65,0,1,100,NoArch
19dccec28aeb48d40b403de97502df1490e17f67,0,0,0,0,0,0,0,0,0,0,0,0,0,0,0,316,13,0,0,0,0,0,0,0,0,0,1,100,NoArch
bb4d21dec8fd0ab0ae233332197b90a783218082,0,0,0,0,0,0,0,0,0,0,0,0,0,0,0,317,14,0,0,0,0,0,0,0,0,0,1,100,NoArch
4d31386d2a9c184b349a6f50b45bcdf73e7bb3f7,0,0,0,0,0,0,0,0,0,0,0,0,0,0,0,17,4,0,0,0,0,0,0,0,0,0,1,100,NoArch
94c4c520a055d7e32dde19bdafac8c6ccfd72d08,0,0,0,0,0,0,0,0,0,0,0,0,0,0,0,18,5,0,0,0,0,0,0,0,0,0,1,100,NoArch
35bb270f96850e789372c9e68855a9727e64aa9c,4,200,150,50,350,0,0,0,21,382,1,2,1.83958346,968,1,318,12,142,133,9,4977,4746,231,74,64,10,1,100,NoArch
ce397913a36beaf1077aa2f98cab98f9b2a0a45a,3,36,3,33,39,1,0,1,33,271,1,3,1.453147172,940,2,319,13,183,178,5,6739,6652,87,73,71,2,1,99.84326019,NoArch
e0bbd4f474776009648b4f8389deefccbefb39a9,5,45,1,44,46,0,0,0,34,38,1,3,1.590506546,1738,2,320,14,412,404,8,11995,11637,358,155,152,3,1,99.76544175,NoArch
6593926aed7eb2a142e32d2d58894738c3de0f51,0,0,0,0,0,0,0,0,0,0,0,0,0,0,0,321,15,0,0,0,0,0,0,0,0,0,5,100,NoArch
8c2d1e975ddb3516e2c42de73d78f3d40556c13b,0,0,0,0,0,0,0,0,0,0,0,0,0,0,0,322,16,0,0,0,0,0,0,0,0,0,1,100,NoArch
5355146c7a871aa70d4f8ed1ad6d82de516f1b96,6,17,11,6,28,0,0,0,23,39,1,4,2.113571995,1273,2,323,16,128,128,0,6828,6799,29,53,53,0,1,100,NoArch
4537345e599d764591ff4ccb2fd8e11efe5cbc67,1,1,0,1,1,0,0,0,24,0,1,1,0,237,1,324,17,29,29,0,1355,1346,9,6,6,0,1,100,NoArch
61a54e4487501db5ce5ce3447363560fb0d880d6,0,0,0,0,0,0,0,0,0,0,0,0,0,0,0,18,0,0,0,0,0,0,0,0,0,0,1,100,NoArch
c6cbf0b58c33dfc1db464aa439679e828dec7b3f,0,0,0,0,0,0,0,0,0,0,0,0,0,0,0,325,18,0,0,0,0,0,0,0,0,0,1,100,NoArch
5a7bae1a5937682448a0b67ad0aaf19b7da49279,4,73,0,73,73,0,0,0,5,110,1,4,1.999597534,419,2,326,19,35,35,0,2294,2294,0,25,25,0,0,100,NoArch
5d2ea9dc0e8ebbdeb3a99f47869ce245a4d4d441,4,102,26,76,128,1,0,1,4,6,1,2,1.46757542,915,1,19,6,114,104,10,5213,4717,496,59,53,6,1,99.68823071,NoArch
bdedfc82349d9c3c4fa6fe8e55acefddd7a4d0b7,0,0,0,0,0,0,0,0,0,0,0,0,0,0,0,327,20,0,0,0,0,0,0,0,0,0,1,100,NoArch
72d74a4d1548083846adc8f18fa53881b713df8c,0,0,0,0,0,0,0,0,0,0,0,0,0,0,0,328,21,0,0,0,0,0,0,0,0,0,1,100,NoArch
90e38800b75f2ddc58a8ccb4fe160a060a419b6a,1,17,0,17,17,0,0,0,2,2,1,1,0,29,2,329,22,2,2,0,227,227,0,1,1,0,0,100,NoArch
eb58b60d05ee2c2a7a614a4a6a24da57b3cbbb41,0,0,0,0,0,0,0,0,0,0,0,0,0,0,0,330,23,0,0,0,0,0,0,0,0,0,0,100,NoArch
cd9aa253250737f9649a08e11522774229a84826,0,0,0,0,0,0,0,0,0,0,0,0,0,0,0,331,24,0,0,0,0,0,0,0,0,0,0,100,NoArch
cd1d8831b80421b643d11400abdc33e6838c61ac,8,49,61,12,110,0,0,0,45,64,1,4,2.682356251,2863,3,332,25,587,587,0,17389,17437,48,212,211,1,1,99.9222395,NoArch
0159d0db21d2475df1cd1dbed89f6550ee2896e4,0,0,0,0,0,0,0,0,0,0,0,0,0,0,0,333,26,0,0,0,0,0,0,0,0,0,1,100,NoArch
d573e2abea020b3e3e5c4d7c64f0979503b1d8b2,0,0,0,0,0,0,0,0,0,0,0,0,0,0,0,334,27,0,0,0,0,0,0,0,0,0,0,100,NoArch
8565f52b5594659e5c3f7b4b1a50ff7baaeafbbb,0,0,0,0,0,0,0,0,0,0,0,0,0,0,0,335,28,0,0,0,0,0,0,0,0,0,0,100,NoArch
e12f05c24875091e93194d3eb610ca429ffa5118,0,0,0,0,0,0,0,0,0,0,0,0,0,0,0,336,29,0,0,0,0,0,0,0,0,0,2,100,NoArch
39fced28170987bd6ce7efbd0cc6809867c8acc0,1,1,1,0,2,0,0,0,17,4,1,1,0,194,1,337,28,63,63,0,1327,1327,0,10,10,0,1,100,NoArch
3fc1496f58de3794d8ac9043c3d04a3d8a28f096,0,0,0,0,0,0,0,0,0,0,0,0,0,0,0,338,25,0,0,0,0,0,0,0,0,0,1,100,NoArch
68ecf375afdaf8ede38be3308d40ad9a78b2b121,2,36,0,36,36,0,0,0,24,582,1,2,0.710676854,409,4,339,26,58,53,5,2381,2193,188,29,27,2,1,100,NoArch
2fa4cd0b15a6c68e2f1ffe6db992daafa5748184,1,13,6,7,19,0,0,0,37,10,1,1,0,389,3,340,27,86,86,0,2146,2106,40,33,33,0,1,100,NoArch
5f1806b2eb1b2d0bcb38a3af8d4412f839b4d273,0,0,0,0,0,0,0,0,0,0,0,0,0,0,0,341,19,0,0,0,0,0,0,0,0,0,0,100,NoArch
db2aff843fca366f96f98e3830811a4c0cfabbd1,0,0,0,0,0,0,0,0,0,0,0,0,0,0,0,330,23,0,0,0,0,0,0,0,0,0,0,100,NoArch
91b8e3c3df7ac9afe8b45e9d6c713686fab49b55,7,274,3,271,277,3,0,3,8,40,1,2,2.195529186,1110,1,20,6,107,83,24,6925,5845,1080,46,36,10,1,99.53271028,NoArch
5bc80f6428c46f41e88ce70f8f23866da762f70f,0,0,0,0,0,0,0,0,0,0,0,0,0,0,0,331,24,0,0,0,0,0,0,0,0,0,0,100,NoArch
2b664be8e81f68125e14b3b920ce5980fbd00120,8,49,61,12,110,0,0,0,45,63,1,4,2.682356251,2894,3,332,25,592,592,0,17488,17536,48,214,213,1,1,99.92199688,NoArch
cd1d8831b80421b643d11400abdc33e6838c61ac,7,3,274,271,277,0,3,3,5,11,1,2,2.195529186,1366,0,332,25,81,105,24,5716,6796,1080,36,46,10,1,99.53271028,NoArch
3418c6ed05c8bafaad7c3f4e94584aa6ac6e50e3,7,274,3,271,277,3,0,3,8,39,1,2,2.195529186,1095,1,333,26,105,81,24,6796,5716,1080,46,36,10,1,99.53271028,NoArch
0159d0db21d2475df1cd1dbed89f6550ee2896e4,7,3,274,271,277,0,3,3,5,11,1,2,2.195529186,1366,0,333,26,81,105,24,5716,6796,1080,36,46,10,1,99.53271028,NoArch
7d9919f7d80450bb7a7c0116820484d16444b6ae,7,274,3,271,277,3,0,3,8,39,1,2,2.195529186,1095,1,334,27,105,81,24,6796,5716,1080,46,36,10,0,99.53271028,NoArch
fdfd71874ee5a66580dfabd27551ac3c2150c286,0,0,0,0,0,0,0,0,0,0,0,0,0,0,0,335,28,0,0,0,0,0,0,0,0,0,0,100,NoArch
d573e2abea020b3e3e5c4d7c64f0979503b1d8b2,7,3,274,271,277,0,3,3,5,11,1,2,2.195529186,1366,0,334,27,81,105,24,5716,6796,1080,36,46,10,0,99.53271028,NoArch
679c5317c3b60f7cb4ca7b799fdf97edf80c3e98,7,274,3,271,277,3,0,3,8,39,1,2,2.195529186,1095,1,336,29,105,81,24,6796,5716,1080,46,36,10,0,99.53271028,NoArch
8565f52b5594659e5c3f7b4b1a50ff7baaeafbbb,7,3,274,271,277,0,3,3,5,11,1,2,2.195529186,1366,0,335,28,81,105,24,5716,6796,1080,36,46,10,0,99.53271028,NoArch
3af2f76c6d3f62785d4017c127b0a0657870eb03,7,274,3,271,277,3,0,3,8,39,1,2,2.195529186,1095,1,337,30,105,81,24,6796,5716,1080,46,36,10,1,99.53271028,NoArch
e12f05c24875091e93194d3eb610ca429ffa5118,7,3,274,271,277,0,3,3,5,11,1,2,2.195529186,1366,0,336,29,81,105,24,5716,6796,1080,36,46,10,2,99.53271028,NoArch
cac87ab452a3b1ab60f02730db30e7b4977dae30,8,275,4,271,279,3,0,3,17,33,1,3,2.241164338,1289,1,338,29,168,144,24,8123,7043,1080,56,46,10,1,99.53271028,NoArch
39fced28170987bd6ce7efbd0cc6809867c8acc0,7,3,274,271,277,0,3,3,5,11,1,2,2.195529186,1366,0,337,28,81,105,24,5716,6796,1080,36,46,10,1,99.53271028,NoArch
825c34115bfbd2e97fbd519ce9cb8e303c8a4e08,7,274,3,271,277,3,0,3,8,39,1,2,2.195529186,1095,1,339,26,105,81,24,6796,5716,1080,46,36,10,1,99.53271028,NoArch
3fc1496f58de3794d8ac9043c3d04a3d8a28f096,7,3,274,271,277,0,3,3,5,11,1,2,2.195529186,1366,0,338,25,81,105,24,5716,6796,1080,36,46,10,1,99.53271028,NoArch
73feedb2d246bc9e89259e96a35e869e166fe248,9,310,3,307,313,3,0,3,24,156,1,4,2.539610128,1504,1,340,27,163,134,29,9177,7909,1268,75,63,12,1,99.53271028,NoArch
68ecf375afdaf8ede38be3308d40ad9a78b2b121,7,3,274,271,277,0,3,3,5,11,1,2,2.195529186,1366,0,339,26,81,105,24,5716,6796,1080,36,46,10,1,99.53271028,NoArch
8fed51d2d0faf08c744611b6feef61f853d43244,8,287,9,278,296,3,0,3,37,34,1,3,2.398454655,1484,1,341,28,191,167,24,8942,7822,1120,79,69,10,1,99.53271028,NoArch
2fa4cd0b15a6c68e2f1ffe6db992daafa5748184,7,3,274,271,277,0,3,3,5,11,1,2,2.195529186,1366,0,340,27,81,105,24,5716,6796,1080,36,46,10,1,99.53271028,NoArch
7c882e7677f1217d52a97e6c60e4554802470a86,0,0,0,0,0,0,0,0,0,0,0,0,0,0,0,341,18,0,0,0,0,0,0,0,0,0,0,100,NoArch
a3d6e2d839e1c1eeb81a08fdd1d3ad199326aee0,7,274,3,271,277,3,0,3,8,39,1,2,2.195529186,1095,1,25,0,105,81,24,6796,5716,1080,46,36,10,1,99.53271028,NoArch
9b6148ddf8b1b7a231f06cdb41bb70fe263d48fc,0,0,0,0,0,0,0,0,0,0,0,0,0,0,0,342,5,0,0,0,0,0,0,0,0,0,1,100,NoArch
9e3d6fd35ac79736f6339cedc5d94fe13d2f3fab,0,0,0,0,0,0,0,0,0,0,0,0,0,0,0,343,6,0,0,0,0,0,0,0,0,0,1,100,NoArch
2e71d784454216317f419886cfc62f500a30633f,7,3,274,271,277,0,3,3,5,11,1,2,2.195529186,1366,0,342,6,81,105,24,5716,6796,1080,36,46,10,2,99.53271028,NoArch
1086f2ae3dc617dfcb8fec7333d62e3e72217ac7,8,290,6,284,296,3,0,3,45,42,1,3,2.398454655,2406,1,344,7,452,424,28,14891,13725,1166,200,189,11,1,99.53271028,NoArch
c7a365600f1323625dad5a4b32d8d5a2da221bbf,7,3,274,271,277,0,3,3,5,11,1,2,2.195529186,1366,0,343,7,81,105,24,5716,6796,1080,36,46,10,1,99.53271028,NoArch
25dabab47a6dcdaee4c291b47467b0e63a850357,7,274,3,271,277,3,0,3,8,39,1,2,2.195529186,1095,1,30,0,105,81,24,6796,5716,1080,46,36,10,1,99.53271028,NoArch
3efcc1ed043bc4f9866a34d9d9206f75a8e0b905,2,69,13,56,82,0,0,0,32,215,1,2,0.999570839,614,3,0,0,195,188,7,4555,4094,461,64,62,2,1,99.68774395,NoArch
f9c3ccc83b9b5f89c786a593c9bc23af10209f00,5,739,12,727,751,4,0,4,13,35,1,2,1.861840305,111,1,345,3,128,13,115,4457,474,3983,67,7,60,1,89.16728077,Arch
64fda09d97f5f68897262e0d305deec5ca363f56,9,15,342,327,357,0,3,3,31,40,1,4,2.695188546,2036,0,344,3,269,300,31,9810,11351,1541,98,110,12,1,88.84026258,Arch
13bf69f3eda8d6046a61ffb3bf281e3dde3298f4,18,854,28,826,882,8,0,8,32,109,1,8,3.40033386,2194,1,346,4,399,328,71,16286,11996,4290,178,138,40,1,88.06941432,Arch
007dbc2a7b9d709f5ef77c36d59733a859f3b887,9,15,342,327,357,0,3,3,31,40,1,4,2.695188546,2036,0,345,4,269,300,31,9810,11351,1541,98,110,12,1,92.44505495,Arch
3397abb9d37d1a84a9d26c2e90558fc4e4be26d9,11,407,28,379,435,3,0,3,32,189,1,6,3.043232737,2012,3,21,0,331,292,39,13288,11394,1894,126,112,14,1,92.44505495,Arch
13c020ed4a76f0da417cd72416cf96aabcee75cc,0,0,0,0,0,0,0,0,0,0,0,0,0,0,0,347,5,0,0,0,0,0,0,0,0,0,0,100,NoArch
1ff170419245138b875bc315cdf51d51f34955cd,7,73,20,53,93,0,0,0,22,541,1,3,2.727557532,1931,1,348,6,271,264,7,8626,8427,199,160,152,8,1,100,NoArch
a2a7d5453ea09936cf9dbf0bbb5e79f0cba252a7,9,14,337,323,351,0,3,3,7,12,1,4,2.657140766,1721,3,346,5,104,136,32,7300,8733,1433,50,62,12,3,92.78350515,Arch
b56ff0fecbf61869aa29d319f575187c0ef4f8b8,9,338,15,323,353,3,0,3,8,185,1,4,2.657409796,1398,3,22,1,136,104,32,8733,7300,1433,62,50,12,0,92.78350515,Arch
4bcde0be98a25e6246b8e56bd0786c75791401ec,0,0,0,0,0,0,0,0,0,0,0,0,0,0,0,61,0,0,0,0,0,0,0,0,0,0,1,100,NoArch
b5097567812c1e09e91cc610bd0860c7cd16df4b,2,36,5,31,41,0,0,0,46,93,1,2,0.989245297,2035,3,349,0,418,411,7,12923,12739,184,209,208,1,1,100,NoArch
f7245d4546960c783d48d6bba27465a8bb99b04b,0,0,0,0,0,0,0,0,0,0,0,0,0,0,0,350,1,0,0,0,0,0,0,0,0,0,1,100,NoArch
dc6db274036bd925416436ac8c138cd40cd782e0,11,19,373,354,392,0,3,3,45,17,1,6,2.966077139,3787,3,347,0,515,554,39,20039,21656,1617,258,271,13,1,92.78350515,Arch
4dda8ddb4f6ca16d11b908f5597e299bb7fd8d76,11,374,20,354,394,3,0,3,46,167,1,6,2.965556843,3433,3,351,2,554,515,39,21656,20039,1617,271,258,13,1,92.78350515,Arch
ff8221710612c83b365d105091c816caf90c22e2,0,0,0,0,0,0,0,0,0,0,0,0,0,0,0,352,3,0,0,0,0,0,0,0,0,0,1,100,NoArch
a0ee4f676223b7d14f622c083833b63501b2113e,11,19,373,354,392,0,3,3,45,17,1,6,2.966077139,3787,3,348,1,515,554,39,20039,21656,1617,258,271,13,1,92.78350515,Arch
e4aac2776c8d6d0bbd611778ca2c36f1bf4b50b4,0,0,0,0,0,0,0,0,0,0,0,0,0,0,0,349,2,0,0,0,0,0,0,0,0,0,0,100,NoArch
f19a3b63053794835d340f1f62057a3df99a09ab,0,0,0,0,0,0,0,0,0,0,0,0,0,0,0,350,3,0,0,0,0,0,0,0,0,0,0,100,NoArch
c646fd429e1b3ee92c25c6691c21c3454546332e,0,0,0,0,0,0,0,0,0,0,0,0,0,0,0,351,4,0,0,0,0,0,0,0,0,0,0,100,NoArch
48cbce8f86cc008c4d8f2e0685dae992ccab4922,11,374,20,354,394,3,0,3,46,167,1,6,2.965556843,3433,3,353,4,554,515,39,21656,20039,1617,271,258,13,0,92.78350515,Arch
4794325c1b416be59dfdc8c40d2d12d1cacc8b10,0,0,0,0,0,0,0,0,0,0,0,0,0,0,0,354,5,0,0,0,0,0,0,0,0,0,1,100,NoArch
63ad1ce82e49b683a073745223a017057db8acab,0,0,0,0,0,0,0,0,0,0,0,0,0,0,0,355,6,0,0,0,0,0,0,0,0,0,1,100,NoArch
954df1fc6c138b8213b7a8a3c6cb5a7888e51c7b,0,0,0,0,0,0,0,0,0,0,0,0,0,0,0,356,7,0,0,0,0,0,0,0,0,0,1,100,NoArch
77f169d8e43f9cd919cb9ef2154878e821ce85ac,9,119,87,32,206,0,0,0,38,156,1,4,2.850944207,2702,2,357,4,629,626,3,17542,17278,264,229,229,0,1,99.93131868,NoArch
dd8e3d56354a611ed79f765d2a6775bd7df3db7f,2,18,0,18,18,0,0,0,11,499,1,2,0.764204507,402,2,358,5,64,63,1,2048,1960,88,33,32,1,1,100,NoArch
78d9518f26978baafb69670fefd1417a36bb10e7,14,28,25,3,53,0,0,0,25,312,1,6,3.211678467,1390,1,359,6,135,135,0,7234,7208,26,90,90,0,1,100,NoArch
ddf2947a0493dad44c4151689d20adc01a1870e0,2,32,2,30,34,0,0,0,47,62,1,2,0.672294817,2066,3,360,3,425,418,7,13147,12923,224,210,209,1,1,100,NoArch
ba0a281322583b6d92bbea81ab37bdf849b1f5e3,1,4,2,2,6,0,0,0,16,201,1,1,0,465,2,361,4,107,107,0,2475,2455,20,11,11,0,1,100,NoArch
efd4e04a712622b7a3df63b60e9b58f9a3f47d9c,5,492,182,310,674,2,0,2,48,88,1,3,1.777739445,1470,1,362,5,253,200,53,10609,9086,1523,111,94,17,0,99.51956074,NoArch
c9e3bcf524da7c3618201aa2b7189ba54900e1e1,1,2,0,2,2,0,0,0,41,12,1,1,0,384,4,0,0,86,86,0,1923,1914,9,25,25,0,1,100,NoArch
9ecce5d7f857f099bc3038e87c09974bae4b8b77,1,1,1,0,2,0,0,0,22,254,1,1,0,370,4,1,1,49,49,0,1762,1762,0,29,29,0,1,100,NoArch
4d73af83a5ec618781a1476e55d60b5e3a6e72f5,4,227,2,225,229,2,0,2,23,120,1,3,1.145040263,471,1,2,1,76,59,17,3552,2289,1263,38,33,5,1,97.29916898,Arch
7adf61bb2083f9f027901fd63441b3bf06607fd5,3,127,16,111,143,0,0,0,6,256,1,2,0.829065741,410,2,3,2,40,31,9,2885,2208,677,29,23,6,1,97.78085992,Arch
0c52cf1c8f6ae6878787541fbc8973e8e71d9a8c,2,15,0,15,15,0,0,0,49,89,1,2,0.721928095,2097,4,4,3,426,425,1,13242,13155,87,211,210,1,1,100,NoArch
5440e53a1a9792b3f67eaf3eedc0c7c5f38629e8,3,24,6,18,30,0,0,0,17,413,1,3,1.517915957,926,2,31,0,154,151,3,4582,4451,131,31,30,1,1,100,NoArch
615d3d16d6cb969c8521c4c6b681dcf11aa29183,2,27,0,27,27,0,0,0,8,379,1,2,0.764204507,148,2,5,1,19,16,3,918,753,165,11,9,2,1,100,NoArch
2145bb9893c44e3506c9e6f6bb1d981e0999c5e8,5,260,5,255,265,1,0,1,25,205,1,4,0.852732035,612,5,6,2,120,75,45,4644,3158,1486,60,41,19,1,99.86282579,NoArch
6647059e85e3c70c01a1596fe11f4a12f69125a7,5,68,15,53,83,1,0,1,14,418,1,2,1.601366836,546,2,7,3,64,58,6,2843,2660,183,32,30,2,1,93.96551724,Arch
bc55a1460c19c127d143736baef3e1881f22418c,2,20,6,14,26,0,0,0,15,2,1,1,0.840358672,250,2,8,4,36,34,2,1160,1051,109,18,18,0,1,100,NoArch
759ef5d44b57bc23ac86a4eaf94f7d76d6e79f11,2,32,4,28,36,0,0,0,10,880,1,2,0.764204507,605,2,9,5,85,84,1,3606,3399,207,46,45,1,1,99.83212087,NoArch
e0d56061638d04a592b7fcff2e1435182f4a4ec8,2,23,2,21,25,0,0,0,34,208,1,2,0.795040279,682,4,10,6,200,196,4,4738,4590,148,67,66,1,1,100,NoArch
352bc86e525eda5f83f13485cac01e57ab9447bb,4,45,2,43,47,0,0,0,26,238,1,3,1.686468915,817,4,11,6,104,100,4,4863,4640,223,48,45,3,1,100,NoArch
d5ec60896fef71973d49436df077664b830aaa46,1,2,2,0,4,0,0,0,24,2,1,1,0,272,3,12,7,35,34,1,1554,1545,9,9,9,0,1,100,NoArch
4631aef659d3795b5d3d7dc8e458b131387c2640,252,456,19,437,475,4,0,4,50,389,1,38,NaN,37640,3,1,0,4868,4791,77,189963,187470,2493,2392,2365,27,1,37.28598605,Arch
50b4f76b01b201bcd3d272cdbe805c3c367c111b,0,0,0,0,0,0,0,0,0,0,0,0,0,0,0,2,1,0,0,0,0,0,0,0,0,0,1,100,NoArch
69c78580f2a0862e90f69a79fc73b66b5e2dc75a,2,72,2,70,74,0,0,0,36,2,1,2,0.922734621,703,4,13,8,219,200,19,5221,4738,483,69,67,2,1,100,NoArch
cb2aca3e71e9098c8ef2cfe7415039ad5954e27e,0,0,0,0,0,0,0,0,0,0,0,0,0,0,0,14,9,0,0,0,0,0,0,0,0,0,1,100,NoArch
d2d8ce9cbdf9c8a05afb51ddcd3a1f8f65a21d49,0,0,0,0,0,0,0,0,0,0,0,0,0,0,0,15,10,0,0,0,0,0,0,0,0,0,1,100,NoArch
e623053db00a27e9c6ce80bb352f788b7759e806,0,0,0,0,0,0,0,0,0,0,0,0,0,0,0,16,3,0,0,0,0,0,0,0,0,0,1,100,NoArch
c5890b7be7522db5484a0bc1e95913ec438aab9d,0,0,0,0,0,0,0,0,0,0,0,0,0,0,0,17,4,0,0,0,0,0,0,0,0,0,1,100,NoArch
a612645c98b33802c70259bc9599e39afc32b385,10,271,12,259,283,1,0,1,37,36,1,3,1.903047895,1712,3,18,5,338,298,40,12665,10708,1957,198,166,32,1,91.40794224,Arch
1116da410809a4572e6134c01b1e8e4be6627647,3,59,2,57,61,1,0,1,15,38,1,2,0.55410153,333,1,19,3,32,31,1,1969,1729,240,21,20,1,1,90.27993779,Arch
9ea51393c75b1ec5a47ce6ce4cd66a4169c9da3d,1,12,11,1,23,0,0,0,4,68,1,1,0,116,4,20,4,3,3,0,713,713,0,1,1,0,1,100,NoArch
5a8078804ce08c49c2c5e5314fec94cb72415f2a,2,85,4,81,89,1,0,1,26,34,1,2,0.472547222,272,1,21,5,45,35,10,2020,1554,466,19,9,10,1,91.41414141,Arch
701473043802d2e54638df2c8c112af8d8d4504a,8,139,55,84,194,0,0,0,28,64,1,3,2.403916776,930,3,22,6,97,78,19,5000,4692,308,74,59,15,1,95.71890145,Arch
6cac5fe1283d797f62e40b1dd755e40f5b213d7b,7,54,2,52,56,1,0,1,37,45,1,5,1.583478878,1604,5,23,7,328,324,4,9942,9758,184,131,128,3,1,93.09803922,Arch
ee5428d3eb38c34ef2a9ded2f0cd447fe3f2f959,3,51,1,50,52,1,0,1,7,30,1,3,1.140115679,139,1,24,8,10,7,3,823,667,156,5,2,3,1,99.68823071,NoArch
a0d444d9eb8ffac43ecabb7476f80cbae998170a,0,0,0,0,0,0,0,0,0,0,0,0,0,0,0,25,9,0,0,0,0,0,0,0,0,0,1,100,NoArch
161206d6d49f352e1a9158f884c8020709f5b1ff,0,0,0,0,0,0,0,0,0,0,0,0,0,0,0,5,0,0,0,0,0,0,0,0,0,0,1,100,NoArch
02fc973f779bc18482554841abc43844562da75a,0,0,0,0,0,0,0,0,0,0,0,0,0,0,0,6,1,0,0,0,0,0,0,0,0,0,1,100,NoArch
8028574ba42ff2aa8d1faf4085f84ca3d13d55b3,0,0,0,0,0,0,0,0,0,0,0,0,0,0,0,7,2,0,0,0,0,0,0,0,0,0,1,100,NoArch
7febb30db2f2038ab9b750457a6df016cd583a04,0,0,0,0,0,0,0,0,0,0,0,0,0,0,0,8,3,0,0,0,0,0,0,0,0,0,1,100,NoArch
44eb7b879277cd5be5fa3f23376d299d8f4a6067,0,0,0,0,0,0,0,0,0,0,0,0,0,0,0,9,4,0,0,0,0,0,0,0,0,0,1,100,NoArch
2a3841f9419723b3007832d368a8c365d89ffd17,0,0,0,0,0,0,0,0,0,0,0,0,0,0,0,10,5,0,0,0,0,0,0,0,0,0,1,100,NoArch
8bb68f7949fa14c10fd2549bcae2e4ddfdb817da,0,0,0,0,0,0,0,0,0,0,0,0,0,0,0,11,6,0,0,0,0,0,0,0,0,0,1,100,NoArch
c69a5bb3780fcae1ca02439ef03c2f2d6188774b,0,0,0,0,0,0,0,0,0,0,0,0,0,0,0,12,7,0,0,0,0,0,0,0,0,0,1,100,NoArch
2f5d854451fc832fda13e170323c065c9b048c3c,0,0,0,0,0,0,0,0,0,0,0,0,0,0,0,13,8,0,0,0,0,0,0,0,0,0,1,100,NoArch
d88f0e4b854b5317555ad2a08c2c0b8ce4fe5b90,0,0,0,0,0,0,0,0,0,0,0,0,0,0,0,14,9,0,0,0,0,0,0,0,0,0,1,100,NoArch
a2d92d73cdc29f92091ac958511ffef36d2f9e1f,0,0,0,0,0,0,0,0,0,0,0,0,0,0,0,15,10,0,0,0,0,0,0,0,0,0,1,100,NoArch
fe2631a02ad01d755199076f43398a770b9750f4,0,0,0,0,0,0,0,0,0,0,0,0,0,0,0,16,11,0,0,0,0,0,0,0,0,0,1,100,NoArch
4f8f908cf16850f7f6225c9359de2cbf9f770de6,0,0,0,0,0,0,0,0,0,0,0,0,0,0,0,26,10,0,0,0,0,0,0,0,0,0,1,100,NoArch
5a5a90960f2a25e98198c8845e193b47ffeb208a,0,0,0,0,0,0,0,0,0,0,0,0,0,0,0,3,0,0,0,0,0,0,0,0,0,0,1,100,NoArch
f036caa094c30ad39abd76e75858aee4cca0cb62,0,0,0,0,0,0,0,0,0,0,0,0,0,0,0,4,1,0,0,0,0,0,0,0,0,0,1,100,NoArch
d0985f9e601ba97754bf072ac77e754a6c0a8c92,1,0,1,1,1,0,0,0,17,20,1,1,0,105,4,5,2,14,14,0,576,585,9,9,9,0,1,100,NoArch
6076010d1b73aa9061b3a2a44f4242b6ab1d2230,4,89,76,13,165,1,0,1,16,66,1,3,1.39706645,476,4,6,3,41,41,0,2682,2646,36,24,24,0,1,99.68968192,NoArch
309b4a3eddea7cf386d56c7371fc11159f0bb402,0,0,0,0,0,0,0,0,0,0,0,0,0,0,0,7,4,0,0,0,0,0,0,0,0,0,1,100,NoArch
f46af6b5788544d8789bec5e8fdeb58d9d9d2d47,0,0,0,0,0,0,0,0,0,0,0,0,0,0,0,8,5,0,0,0,0,0,0,0,0,0,1,100,NoArch
914bdb53b61b9b65e3260459217bdf6063b9b83b,0,0,0,0,0,0,0,0,0,0,0,0,0,0,0,9,6,0,0,0,0,0,0,0,0,0,1,100,NoArch
a1eb97af3d931594b450321eb277817d186e1f50,3,24,2,22,26,0,0,0,28,30,1,2,0.892995357,594,3,27,8,74,71,3,3446,3272,174,21,20,1,1,100,NoArch
baab72449d90842142032a6cc668c52d855de716,0,0,0,0,0,0,0,0,0,0,0,0,0,0,0,10,7,0,0,0,0,0,0,0,0,0,1,100,NoArch
c849a8f76708f8995c311396f3933421b80bdaa7,0,0,0,0,0,0,0,0,0,0,0,0,0,0,0,17,12,0,0,0,0,0,0,0,0,0,1,100,NoArch
b4f29d127108be85af3ea0f856c4ef3b52a2a798,0,0,0,0,0,0,0,0,0,0,0,0,0,0,0,18,13,0,0,0,0,0,0,0,0,0,1,100,NoArch
a1e801aadba4ba65ce54b078d6c02b8617a88774,0,0,0,0,0,0,0,0,0,0,0,0,0,0,0,19,14,0,0,0,0,0,0,0,0,0,1,100,NoArch
26ea6ca388642f96d4d0dfab28150d6b0f51aa33,0,0,0,0,0,0,0,0,0,0,0,0,0,0,0,20,15,0,0,0,0,0,0,0,0,0,1,100,NoArch
335d72590281875b500f776afd3b43fc24c1e4dc,0,0,0,0,0,0,0,0,0,0,0,0,0,0,0,21,16,0,0,0,0,0,0,0,0,0,1,100,NoArch
bd1c8fedb2c9566a9b161749fb6b49904b8caad8,0,0,0,0,0,0,0,0,0,0,0,0,0,0,0,22,5,0,0,0,0,0,0,0,0,0,1,100,NoArch
9403bef4294b16c9eb59e6876f7a6fb6cecfaa0a,63,183,150,33,333,1,0,1,51,96,1,23,NaN,10183,2,11,8,1227,1227,0,55176,54856,320,589,589,0,2,84.10774411,Arch
330e7fb6c2708b4dba775d9bad05a62b0ce2146e,0,0,0,0,0,0,0,0,0,0,0,0,0,0,0,32,0,0,0,0,0,0,0,0,0,0,1,100,NoArch
7fedde60b8704c2715526f6da81d6c43c4ca03e3,0,0,0,0,0,0,0,0,0,0,0,0,0,0,0,23,6,0,0,0,0,0,0,0,0,0,1,100,NoArch
5ca4688a84af2406da81c0915ef781a790a016cb,1,934,474,460,1408,0,0,0,13,143,1,1,0,655,3,12,1,192,96,96,6245,3301,2944,105,62,43,1,96.37681159,Arch
bb9b1c9796fab5960839e5b3eb8ff53b036eb6ad,0,0,0,0,0,0,0,0,0,0,0,0,0,0,0,28,0,0,0,0,0,0,0,0,0,0,1,100,NoArch
214803f7333fa6681caf0c36abf5899b7e861992,5,159,39,120,198,1,0,1,27,42,1,4,1.891622654,479,1,13,2,57,55,2,3093,2868,225,31,30,1,2,95.88414634,Arch
9a34604d54723f44660d71d3e0ecd609fbf7d8a1,1,16,9,7,25,0,0,0,40,161,1,1,0,382,4,14,3,86,84,2,2125,2112,13,31,31,0,1,100,NoArch
0011118ad62f56a42559fb432c2d46155649ade9,4,95,24,71,119,0,0,0,28,124,1,2,1.666824618,1158,6,29,1,176,169,7,6278,5859,419,94,88,6,1,100,NoArch
e020bbab1ba977e7b2f0cd0693d0d20c2c73441f,1,19,8,11,27,0,0,0,14,21,1,1,0,1115,3,15,4,193,192,1,6292,6245,47,106,105,1,1,100,NoArch
555df469c341e8aedc6a4a2822735edeed8ec095,1,53,43,10,96,0,0,0,10,182,1,1,0,983,3,16,4,135,133,2,3845,3821,24,70,69,1,1,100,NoArch
4becf049d94e442f0b7aed95d61cc7574454f96c,0,0,0,0,0,0,0,0,0,0,0,0,0,0,0,0,0,0,0,0,0,0,0,0,0,0,1,100,NoArch
c6469bfc32c0ebd53439b42feebc28439ac04506,0,0,0,0,0,0,0,0,0,0,0,0,0,0,0,1,1,0,0,0,0,0,0,0,0,0,1,100,NoArch
9075618bf7890a8761107fa96da92dedf73d8a3e,2,9,4,5,13,0,0,0,52,120,1,2,0.961236605,2112,5,30,1,427,426,1,13262,13244,18,211,211,0,1,100,NoArch
1ab4eec4d462d7384045a6efec7da0973ca71492,4,59,4,55,63,0,0,0,16,173,1,4,1.181445038,574,2,17,3,110,107,3,4090,3683,407,33,31,2,1,98.67394696,NoArch
b366fd1f242f160f86d473cf3c883e8a5d4ac8e5,0,0,0,0,0,0,0,0,0,0,0,0,0,0,0,18,4,0,0,0,0,0,0,0,0,0,1,100,NoArch
f7e0c4a5c396077c936beedf145c6178167bc0ee,0,0,0,0,0,0,0,0,0,0,0,0,0,0,0,19,5,0,0,0,0,0,0,0,0,0,1,100,NoArch
bccc9984b80b6f94e92281767500632c77286eed,2,74,0,74,74,0,0,0,38,67,1,2,0.753197991,820,4,31,2,232,221,11,6159,5571,588,74,70,4,1,100,NoArch
dcbfacdced7d0a7b50edf39afc1c50c87b1dcd7a,0,0,0,0,0,0,0,0,0,0,0,0,0,0,0,33,0,0,0,0,0,0,0,0,0,0,1,100,NoArch
1c5bbe95f612b841bfeec3880e660d1b6ec44fab,6,81,40,41,121,0,0,0,31,93,1,6,2.054663018,966,5,32,3,159,158,1,5852,5517,335,64,63,1,1,98.67394696,NoArch
a21cdcde9e3b9f9d203a441abce5b2e3aa2a583f,0,0,0,0,0,0,0,0,0,0,0,0,0,0,0,20,5,0,0,0,0,0,0,0,0,0,1,100,NoArch
6fccf353fcbf236c93f8afefdd20be5f7cd3fd5b,2,110,2,108,112,1,0,1,6,106,1,2,0.954434003,72,1,24,0,17,8,9,838,240,598,14,6,8,2,99.29133858,NoArch
8b173f0e65b83415ac4d6b6b772ed146ae499559,0,0,0,0,0,0,0,0,0,0,0,0,0,0,0,33,3,0,0,0,0,0,0,0,0,0,0,100,NoArch
507684968666f97c5af23116884cf0ba88c60be4,20,119,413,294,532,0,2,2,53,121,1,10,2.412555959,5769,1,34,4,1110,1171,61,33749,35683,1934,426,437,11,1,87.95275591,Arch
9852becf651de1d845b1bf6e80ab2deeacbd6d9c,3,9,0,9,9,0,0,0,5,210,1,1,1.584962501,104,3,35,5,17,14,3,275,242,33,10,7,3,1,100,NoArch
690bcb19471a3e5bf201665b5a75c1247f021e1d,0,0,0,0,0,0,0,0,0,0,0,0,0,0,0,36,6,0,0,0,0,0,0,0,0,0,1,100,NoArch
82ba2e6a9320d3d81c0b9e9cdaa40f5be528ee3a,1,6,2,4,8,0,0,0,4,144,1,1,0,266,3,37,7,30,29,1,1276,1256,20,23,22,1,1,100,NoArch
3962eec7f14fc83542437a50c49dcd2d4b481410,44,1857,494,1363,2351,5,0,5,54,92,1,17,4.078405814,12153,3,21,5,1887,1765,122,71752,65983,5769,889,811,78,1,92.5900277,Arch
5f561248fa164725ec1e7600124fa4aa65a81c9c,0,0,0,0,0,0,0,0,0,0,0,0,0,0,0,2,2,0,0,0,0,0,0,0,0,0,1,100,NoArch
9534b3cd1c35add821f13f736fdfec28cbd8ccef,0,0,0,0,0,0,0,0,0,0,0,0,0,0,0,3,3,0,0,0,0,0,0,0,0,0,0,100,NoArch
aa3e9607963bb35f9067d3539b8881fe154c14cb,0,0,0,0,0,0,0,0,0,0,0,0,0,0,0,4,4,0,0,0,0,0,0,0,0,0,1,100,NoArch
7f0c2f36e04d80eeca72df974c9c3eb6fb4c4914,0,0,0,0,0,0,0,0,0,0,0,0,0,0,0,5,5,0,0,0,0,0,0,0,0,0,1,100,NoArch
474cd6bb4632dc0bec91e9f4ec2707673cf96890,0,0,0,0,0,0,0,0,0,0,0,0,0,0,0,6,6,0,0,0,0,0,0,0,0,0,1,100,NoArch
3e897246bf0cb958aa80ca1749fdf3514a8fd2b6,0,0,0,0,0,0,0,0,0,0,0,0,0,0,0,7,7,0,0,0,0,0,0,0,0,0,1,100,NoArch
16987f2bbedcc310a29e000b2ee72685170727be,0,0,0,0,0,0,0,0,0,0,0,0,0,0,0,8,8,0,0,0,0,0,0,0,0,0,1,100,NoArch
196a252b6657068013d76e903b1f90ad33ad5c8e,0,0,0,0,0,0,0,0,0,0,0,0,0,0,0,9,9,0,0,0,0,0,0,0,0,0,1,100,NoArch
3b5d0336153495e29ee42605e6b11fa27a3fec5b,36,395,278,117,673,0,0,0,55,51,1,12,3.48266342,12259,3,38,8,1697,1685,12,62729,62447,282,788,784,4,1,93.26788219,Arch
4d58a729c799e8d1fe3de8605bb53f14bd3374a2,0,0,0,0,0,0,0,0,0,0,0,0,0,0,0,39,9,0,0,0,0,0,0,0,0,0,0,100,NoArch
6120553b1cf2eeefc84d0a0eaf4c1f8f5e50f50d,0,0,0,0,0,0,0,0,0,0,0,0,0,0,0,40,10,0,0,0,0,0,0,0,0,0,0,100,NoArch
1fb314ad0f0f957beab347fc3a736e7c942ca13f,0,0,0,0,0,0,0,0,0,0,0,0,0,0,0,41,11,0,0,0,0,0,0,0,0,0,0,100,NoArch
48dd07d1650427ad985aef4adf271b319bd6f4b2,0,0,0,0,0,0,0,0,0,0,0,0,0,0,0,42,12,0,0,0,0,0,0,0,0,0,0,100,NoArch
2c5159a435f5caaaeedb3586b9be6cc460e25b39,7,34,15,19,49,0,0,0,14,8,1,1,2.776922602,2127,4,43,13,205,204,1,6170,6137,33,123,122,1,1,100,NoArch
b83a473183dd6d17d92fd036aa7f76b9f5ab0570,0,0,0,0,0,0,0,0,0,0,0,0,0,0,0,44,13,0,0,0,0,0,0,0,0,0,0,100,NoArch
cc70fc15a521d4ea221e51d833505bb8b3c0d430,2,15,3,12,18,0,0,0,43,30,1,1,0.918295834,594,4,45,12,129,127,2,3293,3271,22,54,52,2,0,100,NoArch
b96f626cc38ba3f3318f2e2e522b1ceeda037eb4,2,8,1,7,9,0,0,0,21,138,1,1,0.918295834,277,3,46,13,37,36,1,1233,1201,32,22,21,1,1,100,NoArch
639d6f2316a36225dcc18d75cea283c37eebfe96,5,53,21,32,74,0,0,0,33,92,1,2,1.841799478,1154,5,47,14,141,137,4,6144,6017,127,73,69,4,1,100,NoArch
727e7ace74fa9ed32216fbe656e57edaac9d76bc,0,0,0,0,0,0,0,0,0,0,0,0,0,0,0,48,15,0,0,0,0,0,0,0,0,0,0,100,NoArch
1ae46026f857255d457f0ccb8bf4ad968f8a71a3,0,0,0,0,0,0,0,0,0,0,0,0,0,0,0,49,16,0,0,0,0,0,0,0,0,0,0,100,NoArch
6ee867478ca18135507c4f4e0db49186d08fdbfe,0,0,0,0,0,0,0,0,0,0,0,0,0,0,0,50,7,0,0,0,0,0,0,0,0,0,0,100,NoArch
e8dc149b002aa76473084894171f8df7e81ab767,0,0,0,0,0,0,0,0,0,0,0,0,0,0,0,40,10,0,0,0,0,0,0,0,0,0,0,100,NoArch
b328ff0683899b44bb931d6a10a9e6b3624d9a44,7,34,15,19,49,0,0,0,14,8,1,1,2.776922602,2127,4,41,11,205,204,1,6170,6137,33,123,122,1,1,100,NoArch
2c5159a435f5caaaeedb3586b9be6cc460e25b39,0,0,0,0,0,0,0,0,0,0,0,0,0,0,0,43,13,0,0,0,0,0,0,0,0,0,1,100,NoArch
e73a781d5a2ef9259749f882820d4b5932014d96,0,0,0,0,0,0,0,0,0,0,0,0,0,0,0,42,11,0,0,0,0,0,0,0,0,0,0,100,NoArch
1b144474a26da6ea77d8d959a8b4dc8b07896cb4,2,15,3,12,18,0,0,0,43,30,1,1,0.918295834,594,4,43,10,129,127,2,3293,3271,22,54,52,2,1,100,NoArch
cc70fc15a521d4ea221e51d833505bb8b3c0d430,0,0,0,0,0,0,0,0,0,0,0,0,0,0,0,45,12,0,0,0,0,0,0,0,0,0,0,100,NoArch
ad935798984a24a6e9e9d2c136ff06a93b761ead,2,8,1,7,9,0,0,0,21,138,1,1,0.918295834,277,3,44,11,37,36,1,1233,1201,32,22,21,1,1,100,NoArch
b96f626cc38ba3f3318f2e2e522b1ceeda037eb4,0,0,0,0,0,0,0,0,0,0,0,0,0,0,0,46,13,0,0,0,0,0,0,0,0,0,1,100,NoArch
16f9fbc19a28d6c22e6a8fe8550ff5801b853d0b,5,53,21,32,74,0,0,0,33,92,1,2,1.841799478,1154,5,45,12,141,137,4,6144,6017,127,73,69,4,1,100,NoArch
639d6f2316a36225dcc18d75cea283c37eebfe96,0,0,0,0,0,0,0,0,0,0,0,0,0,0,0,47,14,0,0,0,0,0,0,0,0,0,1,100,NoArch
b63f694a7efa6b0a4bc22c70bc2ac6747880267e,0,0,0,0,0,0,0,0,0,0,0,0,0,0,0,46,13,0,0,0,0,0,0,0,0,0,0,100,NoArch
c567683f528d5af38e6835773e55092e3e2749bc,1,1,0,1,1,0,0,0,18,120,1,1,0,144,4,0,0,16,16,0,635,629,6,8,8,0,0,100,NoArch
49681761a71ee17e1f554e3a411860a28a91fa18,1,1,1,0,2,0,0,0,19,0,1,1,0,145,4,1,1,16,16,0,635,635,0,8,8,0,0,100,NoArch
addcbe199d2fe5fbc690554c2309b947f5dd3d54,0,0,0,0,0,0,0,0,0,0,0,0,0,0,0,34,0,0,0,0,0,0,0,0,0,0,1,100,NoArch
3d64951d77db4a070e4f4be187dc03a92fc03c7e,0,0,0,0,0,0,0,0,0,0,0,0,0,0,0,35,1,0,0,0,0,0,0,0,0,0,1,100,NoArch
b7d0d2bdc56d4bc7b5514feb534a5194335445fc,4,33,10,23,43,0,0,0,56,116,1,4,1.762930646,2169,5,47,0,474,470,4,14724,14553,171,161,159,2,1,100,NoArch
1836020a6521743e41fa0fa8d3d7e58e0f78b93f,1,0,1,1,1,0,0,0,17,129,1,1,0,145,3,49,0,16,16,0,629,635,6,8,8,0,1,100,NoArch
60e5ddfd8fd3a41e513e22ef1b228117943886ca,1,1,0,1,1,0,0,0,19,0,1,1,0,144,4,48,1,16,16,0,635,629,6,8,8,0,1,100,NoArch
fc14d7df136932096fbb59d84a1f340c6a64280e,1,0,1,1,1,0,0,0,17,129,1,1,0,145,3,50,1,16,16,0,629,635,6,8,8,0,1,100,NoArch
554434befcb9df043e6ac918966e4271482eb1f4,1,1,0,1,1,0,0,0,19,0,1,1,0,144,4,36,2,16,16,0,635,629,6,8,8,0,1,100,NoArch
0963e563fde59a0848c9200da08885783bd0c637,0,0,0,0,0,0,0,0,0,0,0,0,0,0,0,49,2,0,0,0,0,0,0,0,0,0,3,100,NoArch
886dcb53c4c921a5a31838c919fce9b9cdb2eb66,1,0,1,1,1,0,0,0,17,129,1,1,0,145,3,51,2,16,16,0,629,635,6,8,8,0,3,100,NoArch
7784b56a4aeda94de1de3bbe12a468108b7b8e0e,1,1,0,1,1,0,0,0,19,0,1,1,0,144,4,50,3,16,16,0,635,629,6,8,8,0,1,100,NoArch
41420b66128c0bb6ee47a5480ee48a31b99b7243,1,0,1,1,1,0,0,0,17,129,1,1,0,145,3,52,3,16,16,0,629,635,6,8,8,0,1,100,NoArch
a02c5c2ce3edae38b70648b177a78cc7a64a7b25,4,11,1,10,12,0,0,0,40,49,1,3,1.418295834,1303,4,51,4,235,232,3,8695,8633,62,97,96,1,1,100,NoArch
d6964478b3ef5bf894cc95ecd73d9f7e490f135c,1,0,1,1,1,0,0,0,17,129,1,1,0,145,3,53,4,16,16,0,629,635,6,8,8,0,1,100,NoArch
e9dbb30d296595f0ebd28350eb7904f4e596370d,1,1,0,1,1,0,0,0,19,0,1,1,0,144,4,52,5,16,16,0,635,629,6,8,8,0,1,100,NoArch
fb8d5a0b64bed038374fff83de4abfeeb89c9461,0,0,0,0,0,0,0,0,0,0,0,0,0,0,0,53,6,0,0,0,0,0,0,0,0,0,1,100,NoArch
6f07501a2f17b7b4f7b33b37702ac2280e24daed,1,0,1,1,1,0,0,0,17,129,1,1,0,145,3,54,5,16,16,0,629,635,6,8,8,0,1,100,NoArch
e3315556f1a58ed027e52047516b02992d26278d,2,7,0,7,7,0,0,0,53,52,1,2,0.591672779,1496,4,54,7,377,374,3,8997,8934,63,164,164,0,1,100,NoArch
75ec9fc42937995b052c1aadf86e5cf0ae76515a,1,0,1,1,1,0,0,0,17,129,1,1,0,145,3,55,6,16,16,0,629,635,6,8,8,0,1,100,NoArch
361b0fb520d83636b0301203295a25682939d582,1,1,0,1,1,0,0,0,19,0,1,1,0,144,4,55,8,16,16,0,635,629,6,8,8,0,1,100,NoArch
f7afbb36388ea70bb0798e6b65239a92e0296f81,1,0,1,1,1,0,0,0,17,129,1,1,0,145,3,56,7,16,16,0,629,635,6,8,8,0,1,100,NoArch
fb9e558d5f831a8ec27cb578014a122dc36dfd33,1,1,0,1,1,0,0,0,19,0,1,1,0,144,4,56,9,16,16,0,635,629,6,8,8,0,1,100,NoArch
84f5086ee8c88fecd0c7afac871d267d9269e1e1,1,0,1,1,1,0,0,0,17,129,1,1,0,145,3,57,8,16,16,0,629,635,6,8,8,0,1,100,NoArch
26b4efe10915380de91b0ab5672df6a08d79dd7f,1,1,0,1,1,0,0,0,19,0,1,1,0,144,4,37,2,16,16,0,635,629,6,8,8,0,1,100,NoArch
9d567ae97e945f0c5997b0f65d0e4697fd1d732b,0,0,0,0,0,0,0,0,0,0,0,0,0,0,0,38,3,0,0,0,0,0,0,0,0,0,1,100,NoArch
8921ae305c2eb1b57f5936c0e32639eb6fbda47b,1,0,1,1,1,0,0,0,17,129,1,1,0,145,3,58,9,16,16,0,629,635,6,8,8,0,2,100,NoArch
77047acd0d8b5b269047f471d5c2df7aad3cbf25,8,105,1,104,106,1,0,1,29,205,1,5,1.347348812,967,3,57,10,107,93,14,5431,4926,505,62,53,9,1,99.83766234,NoArch
ad8dc617191dffc7dae010eb37facc7d684ee098,1,0,1,1,1,0,0,0,17,129,1,1,0,145,3,59,10,16,16,0,629,635,6,8,8,0,1,100,NoArch
3f9db28ce5abc7163e7b8a718136d1d0b7e54caf,3,30,5,25,35,0,0,0,57,62,1,3,0.500711588,1386,5,22,0,179,176,3,8344,8228,116,101,99,2,1,100,NoArch
9f34df4ffa72adf599f8b2202de0af000159ef70,1,41,1,40,42,0,0,0,4,374,1,1,0,210,3,58,1,13,11,2,1569,1294,275,10,8,2,1,100,NoArch
4ed7ff8e89a89af2df7a56f3dc83996a080adece,3,192,17,175,209,1,0,1,3,248,1,2,1.032455232,187,1,59,2,29,12,17,1948,849,1099,11,6,5,1,99.5951417,NoArch
df001ad422e33182514811b50d0b63d81f868acd,1,18,7,11,25,0,0,0,2,39,1,1,0,81,1,60,3,12,11,1,463,348,115,7,7,0,1,100,NoArch
a364235bde361cb9d4336fdc5564e8a1b392291f,5,98,13,85,111,0,0,0,5,308,1,2,1.928299614,384,3,61,3,34,23,11,2260,1873,387,27,16,11,1,100,NoArch
142ff4d1abb3ede4cedf9756557bae990c3d2630,1,0,1,1,1,0,0,0,17,129,1,1,0,145,3,60,0,16,16,0,629,635,6,8,8,0,4,100,NoArch
03933b393626604faabfb2d4a5adf3463bede4bb,1,1,0,1,1,0,0,0,19,0,1,1,0,144,4,62,4,16,16,0,635,629,6,8,8,0,1,100,NoArch
a69182d3c5799614c65bab37111f359cd0699f0f,1,0,1,1,1,0,0,0,17,129,1,1,0,145,3,61,1,16,16,0,629,635,6,8,8,0,1,100,NoArch
7833e4baa36951829a4ed4cbb81ae37df617464f,3,43,3,40,46,0,0,0,19,164,1,2,1.112212925,583,3,63,5,103,98,5,3256,3017,239,51,49,2,1,94.73684211,Arch
8133bbece36805c61644f2d6f3718d1e7f8a2c6f,1,0,1,1,1,0,0,0,17,129,1,1,0,145,3,62,2,16,16,0,629,635,6,8,8,0,1,100,NoArch
4601ccfd84bafa293d74ab4d2c9cd953652277c2,1,1,0,1,1,0,0,0,19,0,1,1,0,144,4,64,6,16,16,0,635,629,6,8,8,0,1,100,NoArch
2d839cfabd8ea4fd4ddd09cecff2e106576d086e,1,0,1,1,1,0,0,0,17,129,1,1,0,145,3,63,3,16,16,0,629,635,6,8,8,0,1,100,NoArch
d1e46b246eeecee53c5c84a08578a066698e0c8e,5,253,0,253,253,3,0,3,19,70,1,3,1.928481638,280,3,65,7,50,27,23,2772,1495,1277,27,14,13,1,99.29015084,NoArch
33875473fdc76427e73286de4caa8b27b90ec512,1,0,1,1,1,0,0,0,17,129,1,1,0,145,3,64,4,16,16,0,629,635,6,8,8,0,1,100,NoArch
7472d98289bcb9776339ad253285a6f6dfa939cf,3,14,0,14,14,0,0,0,19,268,1,3,0.734529921,887,4,66,8,84,84,0,3931,3866,65,61,61,0,1,100,NoArch
6b3fcbd2a508b42faf02d51b1d93ee95d610346b,1,0,1,1,1,0,0,0,17,129,1,1,0,145,3,65,5,16,16,0,629,635,6,8,8,0,1,100,NoArch
b34848d4b561098b6515ef8fc5217cf18a55a9f5,1,1,0,1,1,0,0,0,19,0,1,1,0,144,4,67,9,16,16,0,635,629,6,8,8,0,1,100,NoArch
58c99c0890bf014513d6d1d5b0502d27d8cab377,1,0,1,1,1,0,0,0,17,129,1,1,0,145,3,66,6,16,16,0,629,635,6,8,8,0,1,100,NoArch
afa1fd51ad1defb83e622260625cedf597057458,4,4,3,1,7,0,0,0,19,204,1,2,1.950212065,354,2,68,10,26,26,0,1133,1127,6,17,17,0,1,100,NoArch
c01549301d656e413ee6a60b209cbf470f368663,1,0,1,1,1,0,0,0,17,129,1,1,0,145,3,67,7,16,16,0,629,635,6,8,8,0,1,100,NoArch
064d76042fc429844fb51fed01c9399240a83020,1,1,0,1,1,0,0,0,19,0,1,1,0,144,4,69,11,16,16,0,635,629,6,8,8,0,0,100,NoArch
12e0994f02ea22e8b7ffb56b61ccbf09e7b0a6fb,1,0,1,1,1,0,0,0,17,129,1,1,0,145,3,68,8,16,16,0,629,635,6,8,8,0,0,100,NoArch
3ea269b831f04da1159b8156536fe8e823767714,5,92,25,67,117,0,0,0,19,220,1,2,0.642610328,745,3,2,0,85,71,14,3865,3545,320,63,52,11,0,100,NoArch
3eb8a8c93c9388d1bd79b2297118a1d381bde51d,0,0,0,0,0,0,0,0,0,0,0,0,0,0,0,3,1,0,0,0,0,0,0,0,0,0,0,100,NoArch
99460bfd03b981b3265600a9201cc3397a269591,5,25,92,67,117,0,0,0,17,80,1,2,0.642610328,812,2,69,5,71,85,14,3545,3865,320,52,63,11,0,100,NoArch
fbab55fdd499dae4736f099111aecf2bc8e488e3,5,92,25,67,117,0,0,0,19,220,1,2,0.642610328,745,3,10,0,85,71,14,3865,3545,320,63,52,11,1,100,NoArch
14c80a58973ea5559beef0483f98ba9536e14161,5,25,92,67,117,0,0,0,17,80,1,2,0.642610328,812,2,10,0,71,85,14,3545,3865,320,52,63,11,0,100,NoArch
947bd7daab9ac512bba06f09d27f9dd29b55bef7,5,92,25,67,117,0,0,0,19,220,1,2,0.642610328,745,3,11,1,85,71,14,3865,3545,320,63,52,11,1,100,NoArch
453e32abf94756a4aae5e5cd422cd7f08be32239,5,25,92,67,117,0,0,0,17,80,1,2,0.642610328,812,2,11,1,71,85,14,3545,3865,320,52,63,11,0,100,NoArch
85bc4f8916fa5db77b6ac3d78747e98844780d04,5,92,25,67,117,0,0,0,19,158,1,2,0.642610328,745,3,70,0,85,71,14,3865,3545,320,63,52,11,1,100,NoArch
ac835f5458ee587f937312bb1eeb3b70699d3aee,0,0,0,0,0,0,0,0,0,0,0,0,0,0,0,71,1,0,0,0,0,0,0,0,0,0,0,100,NoArch
e05d7e823c8b05c18d4245b894eb43db66df21b6,2,7,1,6,8,0,0,0,36,146,1,2,0.811278124,780,4,72,2,151,149,2,5424,5362,62,65,64,1,1,100,NoArch
1dbd63f4d14887ad4f7ac4c74db576f336b8c95f,0,0,0,0,0,0,0,0,0,0,0,0,0,0,0,73,3,0,0,0,0,0,0,0,0,0,0,100,NoArch
19674f6c6f234d74255d8037493905f0acdd75a2,5,25,92,67,117,0,0,0,17,80,1,2,0.642610328,812,2,70,1,71,85,14,3545,3865,320,52,63,11,1,100,NoArch
ea05ebd20d8ae1fc7e6cdfa64c6a40c204d728fe,7,144,28,116,172,0,0,0,30,167,1,4,1.626524187,1384,3,74,4,171,150,21,7578,7033,545,108,94,14,1,100,NoArch
7531554db608e4083db3db59f48c74f0488fb7dc,5,25,92,67,117,0,0,0,17,80,1,2,0.642610328,812,2,71,2,71,85,14,3545,3865,320,52,63,11,1,100,NoArch
b65bfcf9cf6004ae8c2cff0cd58e251032e4c719,10,360,60,300,420,2,0,2,19,114,1,4,2.392637895,1092,3,75,5,131,97,34,7323,5576,1747,84,64,20,1,99.20983319,NoArch
2460ec2ed8782a1e43962c49cd7be0e4acc541b6,5,25,92,67,117,0,0,0,17,80,1,2,0.642610328,812,2,72,2,71,85,14,3545,3865,320,52,63,11,1,100,NoArch
215c50fe20bd74b0d7cdf0e41aaa93bf39f6be91,5,92,25,67,117,0,0,0,19,158,1,2,0.642610328,745,3,76,6,85,71,14,3865,3545,320,63,52,11,1,100,NoArch
15954213389383aa5898c0f710b8158aa20963f9,5,25,92,67,117,0,0,0,17,80,1,2,0.642610328,812,2,73,3,71,85,14,3545,3865,320,52,63,11,1,100,NoArch
94d4da5ee1ee30e5f65f051885732e02fddef2f0,5,92,25,67,117,0,0,0,19,158,1,2,0.642610328,745,3,12,0,85,71,14,3865,3545,320,63,52,11,1,100,NoArch
89d8396263807fd5bf94e3ee39e8b34baef28476,0,0,0,0,0,0,0,0,0,0,0,0,0,0,0,13,1,0,0,0,0,0,0,0,0,0,1,100,NoArch
c2ad1e6d0358bd3e842b5bb9161d29a429ab4940,5,25,92,67,117,0,0,0,17,80,1,2,0.642610328,812,2,12,0,71,85,14,3545,3865,320,52,63,11,1,100,NoArch
535f4ba55859d64d4a566ec68eea64aec774f3f6,5,92,25,67,117,0,0,0,19,158,1,2,0.642610328,745,3,14,2,85,71,14,3865,3545,320,63,52,11,1,100,NoArch
47e7213a9fe64ee67f037f63f9ea889d363970f0,5,25,92,67,117,0,0,0,17,80,1,2,0.642610328,812,2,13,1,71,85,14,3545,3865,320,52,63,11,1,100,NoArch
452ed338b64e52116e0c0c3e24705ad09cb27584,5,92,25,67,117,0,0,0,19,158,1,2,0.642610328,745,3,23,0,85,71,14,3865,3545,320,63,52,11,1,100,NoArch
d4867eb2aba282ebc38d4a25631ea8cd802b2b18,7,80,15,65,95,0,0,0,32,308,1,6,2.046994292,1025,3,77,3,112,105,7,6419,5855,564,59,53,6,1,100,NoArch
6c6b08cf33fb1911dd50c6abc2a5e7bfeb1c1a16,0,0,0,0,0,0,0,0,0,0,0,0,0,0,0,78,4,0,0,0,0,0,0,0,0,0,0,100,NoArch
e82da45639e88db3c04aba76aa09ebdde05f2d21,5,25,92,67,117,0,0,0,17,80,1,2,0.642610328,812,2,74,3,71,85,14,3545,3865,320,52,63,11,1,100,NoArch
153ce108ab9334a4a74e266c078f4d0c08e2f485,14,1341,251,1090,1592,4,0,4,34,149,1,5,2.779660774,1576,3,79,0,284,170,114,12745,7949,4796,154,93,61,1,95.36480687,Arch
77c3c699fa348c191cee812392dc025f6ed1331e,0,0,0,0,0,0,0,0,0,0,0,0,0,0,0,80,1,0,0,0,0,0,0,0,0,0,2,100,NoArch
416522f794abd14f3b23b2700be6c9b49c4f2da6,2,1,2,1,3,0,0,0,17,305,1,1,0.918295834,299,3,75,0,28,28,0,1432,1438,6,17,17,0,2,100,NoArch
52ae42f054fc9ac62262b28b6a5c5d3ba4a288fd,2,2,1,1,3,0,0,0,19,46,1,1,0.918295834,298,4,24,0,28,28,0,1438,1432,6,17,17,0,1,100,NoArch
3a282bd65030c4361ea901a8e09a495227df15b0,2,42,0,42,42,0,0,0,41,309,1,2,0.892623013,943,4,81,2,249,242,7,6855,6430,425,82,80,2,1,100,NoArch
2f5cdaf1a0d0003a01184ee201ca8e81bd8a9db0,1,1,1,0,2,0,0,0,7,371,1,1,0,85,3,82,3,6,6,0,424,424,0,3,3,0,1,100,NoArch
5b88de9f8724e046c745869b335b82a4af439af3,0,0,0,0,0,0,0,0,0,0,0,0,0,0,0,25,1,0,0,0,0,0,0,0,0,0,1,100,NoArch
460b26da6b3d929887c9e0fa814851562e2a797f,3,28,1,27,29,0,0,0,58,286,1,3,1.073551999,2589,5,83,3,501,497,4,15756,15628,128,252,249,3,1,100,NoArch
8fa7ddbff5c8a715e55cfee259f7232935cf53a9,5,2,45,43,47,0,0,0,40,140,1,4,1.448478954,1369,3,76,1,276,283,7,8286,8717,431,100,102,2,1,100,NoArch
6a584228314e7ea255c6aa68edee4b770dc6e899,5,45,2,43,47,0,0,0,41,215,1,4,1.448478954,1326,3,84,4,283,276,7,8717,8286,431,102,100,2,1,100,NoArch
cd6452119d58dba1752f6c98fede471f3c986d4f,4,2,44,42,46,0,0,0,40,144,1,4,1.3281888,1224,3,77,2,260,267,7,7657,8082,425,92,94,2,1,100,NoArch
0a3c5b470e8882e478052af07283b2a6b46ba79f,10,258,23,235,281,1,0,1,41,308,1,7,2.230547647,1730,3,85,4,325,309,16,12141,10638,1503,125,121,4,1,99.83164983,NoArch
cd50b81836131e56355a8617be5ea9b1be5d63d9,0,0,0,0,0,0,0,0,0,0,0,0,0,0,0,86,5,0,0,0,0,0,0,0,0,0,0,100,NoArch
c4f243262392626c8a9e95ba1e4c355e21ab388a,6,323,80,243,403,0,0,0,34,92,1,4,1.548209047,1622,1,87,6,187,168,19,9090,8138,952,102,90,12,1,100,NoArch
bf63908f5a3cdebf152e904567ab6c212ae6cbe1,10,23,258,235,281,0,1,1,40,131,1,7,2.230547647,1965,3,78,2,309,325,16,10638,12141,1503,121,125,4,1,99.83164983,NoArch
df5f9be0214ea3884fc15181d88a0b3e0da4bf3c,11,295,24,271,319,1,0,1,55,225,1,8,2.388923286,3109,3,88,7,696,673,23,20865,19090,1775,287,279,8,1,99.83164983,NoArch
07c66f99ada606e5e832d0b9cad0eab776c98c83,0,0,0,0,0,0,0,0,0,0,0,0,0,0,0,89,8,0,0,0,0,0,0,0,0,0,1,100,NoArch
47a03007d32784ecedeb78cd435360bd7e75f9d4,11,24,295,271,319,0,1,1,54,143,1,8,2.388923286,3380,3,79,3,673,696,23,19090,20865,1775,279,287,8,1,99.83164983,NoArch
0cc2905bb678d3b729a14913ae7bd7a6ee10aa28,11,295,24,271,319,1,0,1,55,225,1,8,2.388923286,3109,3,90,9,696,673,23,20865,19090,1775,287,279,8,1,99.83164983,NoArch
31abd2b47cab8446aafc375bf5ed17e38475efa7,11,24,295,271,319,0,1,1,54,143,1,8,2.388923286,3380,3,80,4,673,696,23,19090,20865,1775,279,287,8,1,99.83164983,NoArch
6b2b0e56a70b56f70179775d07f3e9e7a8aed5f5,0,0,0,0,0,0,0,0,0,0,0,0,0,0,0,81,5,0,0,0,0,0,0,0,0,0,0,100,NoArch
b623e6f1019798c69c9178c3eb3e2101fb0fe383,12,316,54,262,370,1,0,1,55,226,1,9,2.638187439,3201,3,91,9,706,685,21,21285,19553,1732,294,286,8,1,99.83164983,NoArch
34d6f3ac20492b8b39d05c8e71333bf4d46a59b9,0,0,0,0,0,0,0,0,0,0,0,0,0,0,0,15,0,0,0,0,0,0,0,0,0,0,0,100,NoArch
1fa65b7921fd9a718a70b53c9c2f61efbcbfc279,0,0,0,0,0,0,0,0,0,0,0,0,0,0,0,16,1,0,0,0,0,0,0,0,0,0,1,100,NoArch
23b9833e7f7fc164e9ed715062ed84aec8d2a27e,0,0,0,0,0,0,0,0,0,0,0,0,0,0,0,17,2,0,0,0,0,0,0,0,0,0,1,100,NoArch
aae39c90a3e5ac80d940471b5694aef1ab193803,0,0,0,0,0,0,0,0,0,0,0,0,0,0,0,18,3,0,0,0,0,0,0,0,0,0,1,100,NoArch
3dff33cb9b8bc5d4c8a1f94a964bc4e5c4d7e5ff,0,0,0,0,0,0,0,0,0,0,0,0,0,0,0,19,4,0,0,0,0,0,0,0,0,0,1,100,NoArch
c9f6f4eb4756d387746ea458bc27a4bd08e121ca,0,0,0,0,0,0,0,0,0,0,0,0,0,0,0,20,5,0,0,0,0,0,0,0,0,0,1,100,NoArch
6d3e2f0facaf2f21e049bd71e5f555c365f8c71e,0,0,0,0,0,0,0,0,0,0,0,0,0,0,0,21,6,0,0,0,0,0,0,0,0,0,1,100,NoArch
78ab4204ce33450f466e7cacb1949b53c5b053f5,0,0,0,0,0,0,0,0,0,0,0,0,0,0,0,92,0,0,0,0,0,0,0,0,0,0,1,100,NoArch
b61743eb5b604f50aeed13abcdd5164e2d71f706,2,160,0,160,160,1,0,1,41,178,1,2,0.168660931,479,1,93,1,128,118,10,4529,3520,1009,32,25,7,1,99.83221477,NoArch
827cac5eccfc507d829d7f734f9365f816eaf6d0,0,0,0,0,0,0,0,0,0,0,0,0,0,0,0,94,2,0,0,0,0,0,0,0,0,0,4,100,NoArch
1bcd8bb5ac635844096a7b177f68597d2ebc226d,11,24,295,271,319,0,1,1,54,143,1,8,2.388923286,3380,3,82,0,673,696,23,19090,20865,1775,279,287,8,4,99.83221477,NoArch
a03c19564906b179de1845c9614a985523162f6a,13,315,31,284,346,1,0,1,55,265,1,9,2.67505885,3418,3,95,0,783,758,25,22833,21019,1814,309,299,10,1,99.83221477,NoArch
646bfb81eece405f0e898b8caa9165579295859d,1,77,21,56,98,0,0,0,56,126,1,1,0,1383,5,96,1,376,366,10,8685,8478,207,166,158,8,1,100,NoArch
b1bb350b513bfc925960faeb65a28351e7e9ceaa,1,51,20,31,71,0,0,0,57,0,1,1,0,1439,5,97,2,389,376,13,8794,8685,109,168,166,2,1,100,NoArch
2679a8b0563aea563d1d8ca4e124662e6d381db0,0,0,0,0,0,0,0,0,0,0,0,0,0,0,0,98,3,0,0,0,0,0,0,0,0,0,0,100,NoArch
8a05b75cd6a4082107b2fd50b4a2c303ca57f34b,13,72,443,371,515,0,1,1,54,142,1,9,2.656969034,3789,3,83,0,758,806,48,21019,23149,2130,299,319,20,0,99.83221477,NoArch
a51fa638d9510bf07fb712e6c91950500eb04d21,0,0,0,0,0,0,0,0,0,0,0,0,0,0,0,84,1,0,0,0,0,0,0,0,0,0,0,100,NoArch
4f693b17f1065f1a688628af3578ee34c55bfbe8,13,444,72,372,516,1,0,1,57,277,1,9,2.655725835,3418,3,99,4,806,758,48,23156,21019,2137,319,299,20,1,99.83221477,NoArch
174f5a8898511b7275a81a9b7e8f89ad6c7a40f4,0,0,0,0,0,0,0,0,0,0,0,0,0,0,0,100,5,0,0,0,0,0,0,0,0,0,1,100,NoArch
d3d6134e08a361a1ad774b527adc5ef7330c09ac,0,0,0,0,0,0,0,0,0,0,0,0,0,0,0,101,5,0,0,0,0,0,0,0,0,0,0,100,NoArch
5b359c150696c6c7de3fdbc7072c05b61988bcaf,13,72,444,372,516,0,1,1,54,142,1,9,2.655725835,3790,3,85,2,758,806,48,21019,23156,2137,299,319,20,0,99.83221477,NoArch
79b61b53124d555583791061429f12db0f7c4810,13,444,72,372,516,1,0,1,57,277,1,9,2.655725835,3418,3,102,6,806,758,48,23156,21019,2137,319,299,20,1,99.83221477,NoArch
86754a60ffe77977fc654a9184775410fd5e8564,13,51,367,316,418,0,1,1,55,134,1,9,2.82121212,3790,3,86,3,768,806,38,21226,23156,1930,307,319,12,1,99.83221477,NoArch
1462c10fb5ae684dfa9fb03b4eb5d54903c8a384,18,648,63,585,711,4,0,4,57,265,1,12,3.429836976,3969,1,103,7,946,875,71,26808,23570,3238,363,336,27,1,99.08333333,NoArch
4f0fe80f2525c398e18ec48cd48be27f4c7fcc95,13,51,367,316,418,0,1,1,55,134,1,9,2.82121212,3790,3,87,4,768,806,38,21226,23156,1930,307,319,12,1,99.83443709,NoArch
341d12014ead1a0bf5bafb1c666c0cc668a62308,13,367,51,316,418,1,0,1,57,277,1,9,2.82121212,3474,3,104,8,806,768,38,23156,21226,1930,319,307,12,0,99.83443709,NoArch
1c11eb7b19eac6776687c484444e5ffcfd0232ab,13,51,367,316,418,0,1,1,55,134,1,9,2.82121212,3790,3,88,5,768,806,38,21226,23156,1930,307,319,12,0,99.83443709,NoArch
d15cce120f81f5118ea590fa48d3e7e6150d920f,13,367,51,316,418,1,0,1,57,277,1,9,2.82121212,3474,3,105,9,806,768,38,23156,21226,1930,319,307,12,1,99.83443709,NoArch
0814c3e38c8e33d757eb946697471207db1ae2f6,13,51,367,316,418,0,1,1,55,134,1,9,2.82121212,3790,3,89,6,768,806,38,21226,23156,1930,307,319,12,1,99.83443709,NoArch
3be4df96cf956e38c56561e4e7954cb0ebc96cae,13,367,51,316,418,1,0,1,57,277,1,9,2.82121212,3474,3,106,10,806,768,38,23156,21226,1930,319,307,12,1,99.83443709,NoArch
31d1e9b84baf9c6ee4ea234ddad9a7b584e11d0c,0,0,0,0,0,0,0,0,0,0,0,0,0,0,0,107,11,0,0,0,0,0,0,0,0,0,1,100,NoArch
4a1a11e575f6914bf2d2a2c5fea762cd3984fdf7,13,51,367,316,418,0,1,1,55,134,1,9,2.82121212,3790,3,90,7,768,806,38,21226,23156,1930,307,319,12,2,99.83443709,NoArch
203cbd49010dfcd677af4a6d8ce8b4065d4e629d,13,367,51,316,418,1,0,1,57,277,1,9,2.82121212,3474,3,108,12,806,768,38,23156,21226,1930,319,307,12,0,99.83443709,NoArch
5d264aabbfcaf9edb85818b05faecac304ef3175,13,51,367,316,418,0,1,1,55,134,1,9,2.82121212,3790,3,91,8,768,806,38,21226,23156,1930,307,319,12,0,99.83443709,NoArch
666be14b735fa4b6e03c20b5c15d229f90efd437,47,2794,362,2432,3156,12,0,12,57,297,1,23,4.676674038,8761,1,109,11,1727,1480,247,67131,52045,15086,789,666,123,1,93.85692068,Arch
72c9d6bb7aa23546a0bf82c2ce546fd1278bd72b,2,21,0,21,21,0,0,0,35,119,1,2,0.998363673,884,5,110,9,110,106,4,4707,4562,145,56,55,1,1,100,NoArch
401eb42a3bfad01266049cb0385fed6b8edb8c84,47,362,2794,2432,3156,0,12,12,55,115,1,23,4.676674038,11204,1,92,7,1481,1728,247,52135,67221,15086,667,790,123,1,93.85692068,Arch
7c2bfeb2c6ebb2f69eaa4aafbf586ddd2c000629,47,2794,362,2432,3156,12,0,12,57,287,1,23,4.676674038,8772,1,111,10,1728,1481,247,67221,52135,15086,790,667,123,1,93.85692068,Arch
45c9b60be4681d36f07247c0ed9c1faca55b8936,47,362,2794,2432,3156,0,12,12,55,115,1,23,4.676674038,11204,1,93,8,1481,1728,247,52135,67221,15086,667,790,123,1,93.85692068,Arch
b4d6a171e5e2d96d4e6fad49e06aca19c916420a,47,2794,362,2432,3156,12,0,12,57,287,1,23,4.676674038,8772,1,112,11,1728,1481,247,67221,52135,15086,790,667,123,0,93.85692068,Arch
4df83ff5373d7438bdf7789ab2cd5eb547b6db0b,47,362,2794,2432,3156,0,12,12,55,115,1,23,4.676674038,11204,1,94,9,1481,1728,247,52135,67221,15086,667,790,123,0,93.85692068,Arch
2566695ad9b64198e2905db121e1727b3f90c8d5,0,0,0,0,0,0,0,0,0,0,0,0,0,0,0,95,10,0,0,0,0,0,0,0,0,0,0,100,NoArch
76dbd5fe19eba2f6ec343f9f51a5b654e36e9827,0,0,0,0,0,0,0,0,0,0,0,0,0,0,0,96,4,0,0,0,0,0,0,0,0,0,0,100,NoArch
5f2cc474348dfdc8cfca669f3f4f0d75bc9e7ae9,52,3355,402,2953,3757,16,0,16,57,258,1,25,4.864427037,9255,1,113,3,1941,1601,340,73644,55692,17952,850,692,158,1,93.2046332,Arch
7185321c45049659c172d64651c2ebe83143a031,0,0,0,0,0,0,0,0,0,0,0,0,0,0,0,114,4,0,0,0,0,0,0,0,0,0,1,100,NoArch
fed95bb179d5459bd58538028f7deafe703f2f90,2,10,8,2,18,0,0,0,2,0,1,2,0.503258335,387,1,115,5,82,82,0,2339,2330,9,19,19,0,1,100,NoArch
ce10b0708139dd131a6342d5e189f5d857000c19,1,1,1,0,2,0,0,0,2,0,1,1,0,87,1,116,6,11,11,0,408,402,6,9,9,0,1,100,NoArch
bfdee03fe22f9743dbfddb593de3821fcfa737a8,0,0,0,0,0,0,0,0,0,0,0,0,0,0,0,117,7,0,0,0,0,0,0,0,0,0,1,100,NoArch
dba584208bc0006ce773c2919469b6027da753ed,0,0,0,0,0,0,0,0,0,0,0,0,0,0,0,118,8,0,0,0,0,0,0,0,0,0,1,100,NoArch
8feed041e4d0f296e954d1b4d38ce952d64bc07d,3,19,4,15,23,0,0,0,46,537,1,3,1.353448505,1196,4,119,9,253,249,4,6059,5962,97,96,94,2,1,100,NoArch
6ea146d357b041e1c16167124afd7fc4d0f36c21,2,128,0,128,128,2,0,2,1,0,1,2,0.912999214,0,1,120,10,9,0,9,582,0,582,7,0,7,1,91.36331192,Arch
afc36212528a46d6e00a1031764a3defe66bed45,2,13,2,11,15,0,0,0,43,202,1,2,0.918295834,1048,4,121,8,198,196,2,7550,7482,68,80,79,1,1,100,NoArch
895ce26802026187f1a6ac227bf0ec1482178247,0,0,0,0,0,0,0,0,0,0,0,0,0,0,0,122,9,0,0,0,0,0,0,0,0,0,1,100,NoArch
e93f2ff7ca53586dbfd3941035fdaf67cb8ae306,3,125,14,111,139,1,0,1,18,486,1,2,0.958176013,317,5,123,10,39,28,11,2284,1719,565,23,16,7,1,95.85714286,Arch
3fe4738eff4bfe13116094a48ce5e22e4934bfbc,3,98,1,97,99,1,0,1,46,52,1,3,0.974351241,428,1,124,11,100,89,11,2693,2236,457,40,36,4,1,99.85549133,NoArch
fe169ad3db467159b48da150c639c4ad7c06c0bf,0,0,0,0,0,0,0,0,0,0,0,0,0,0,0,125,12,0,0,0,0,0,0,0,0,0,1,100,NoArch
471b3f5f896035f264f29cf4f6a136a23a0b40b3,0,0,0,0,0,0,0,0,0,0,0,0,0,0,0,22,0,0,0,0,0,0,0,0,0,0,1,100,NoArch
d6d9116c6bfb31535491912f55a658d4f0291fb5,0,0,0,0,0,0,0,0,0,0,0,0,0,0,0,23,1,0,0,0,0,0,0,0,0,0,1,100,NoArch
e1fa71998aa7ecbf230b7b5dc8af8b446a2870f1,0,0,0,0,0,0,0,0,0,0,0,0,0,0,0,24,2,0,0,0,0,0,0,0,0,0,1,100,NoArch
47161bac6a9c3e0ff5fbf3885cd922fa29848adb,0,0,0,0,0,0,0,0,0,0,0,0,0,0,0,25,3,0,0,0,0,0,0,0,0,0,1,100,NoArch
27493bbf6257f48278df922517bc9e38be2df8d2,0,0,0,0,0,0,0,0,0,0,0,0,0,0,0,26,4,0,0,0,0,0,0,0,0,0,1,100,NoArch
7a1cdae26c92bb14e63ac71eab4ee7ce3859752b,0,0,0,0,0,0,0,0,0,0,0,0,0,0,0,27,5,0,0,0,0,0,0,0,0,0,1,100,NoArch
fd02845b1307edba65587a6e2cefda72e54ed8b9,4,211,0,211,211,4,0,4,1,0,1,3,1.946767684,0,1,126,11,8,0,8,555,0,555,7,0,7,1,99.42611191,NoArch
d6d8e36128e1b733b520abfc2f6687914e0cd9e0,0,0,0,0,0,0,0,0,0,0,0,0,0,0,0,127,10,0,0,0,0,0,0,0,0,0,1,100,NoArch
21223692e8066b2bdf2100641fb7befdae453e8e,5,326,11,315,337,0,0,0,16,654,1,3,0.943403568,1512,2,39,0,255,218,37,8635,7009,1626,132,123,9,1,91.23674912,Arch
2b4a20cddc3856755e1104775398c5d95d7570d5,1,7,2,5,9,0,0,0,9,328,1,1,0,154,4,128,9,13,12,1,828,803,25,10,9,1,1,100,NoArch
ce9db305e58824d3f892a9fe89c38537f7e75a39,0,0,0,0,0,0,0,0,0,0,0,0,0,0,0,129,10,0,0,0,0,0,0,0,0,0,0,100,NoArch
3f01ca6b4de96fc5b9167651d4f700b2fcb2c5f4,12,4186,6,4180,4192,9,0,9,47,60,1,4,2.277466706,1413,1,130,9,1237,385,852,32605,8589,24016,506,126,380,1,98.75518672,NoArch
126e9769f45f978f42321c4fc465198982df482b,2,7,1,6,8,0,0,0,59,225,1,2,0.811278124,2343,5,131,8,466,465,1,14413,14376,37,231,230,1,1,100,NoArch
29f33991babbc6ba48cb03b067d063d38751a7e9,3,25,6,19,31,0,0,0,16,228,1,3,1.540251345,554,3,132,8,66,65,1,2929,2775,154,45,44,1,1,100,NoArch
5c4ebdc2113e15afcbde83756a0dc1c0d09935ba,5,34,27,7,61,0,0,0,48,13,1,3,1.521099626,1942,1,133,9,508,508,0,12028,11944,84,161,160,1,1,100,NoArch
86fa1ce37647ccc27cf85365ace50aa593073394,3,19,24,5,43,0,0,0,8,557,1,2,1.21132135,394,2,40,1,34,33,1,2091,2091,0,12,12,0,1,100,NoArch
748e8c1be6a8c44e2a5cda05d05c5668526a7b25,0,0,0,0,0,0,0,0,0,0,0,0,0,0,0,41,2,0,0,0,0,0,0,0,0,0,1,100,NoArch
d7dbac1ad7177bc8065298cc452466b2a39d7a9c,1,1,1,0,2,0,0,0,5,119,1,1,0,183,4,42,3,18,18,0,1126,1126,0,4,4,0,1,100,NoArch
240c6945700aa1f2fd7e9c508ae24543a34211f7,2,1650,2,1648,1652,1,0,1,3,34,1,1,0.024530133,79,1,134,10,315,1,314,9400,424,8976,178,1,177,1,99.65916837,NoArch
c4fa8c58b9952951ba2307cc2ec796ad05e822e2,5,25,15,10,40,0,0,0,7,349,1,3,1.930240673,569,2,43,4,39,38,1,3091,3008,83,17,17,0,1,100,NoArch
a614a28bc9e2f90bf516577252863b8af1cd2e00,0,0,0,0,0,0,0,0,0,0,0,0,0,0,0,44,5,0,0,0,0,0,0,0,0,0,1,100,NoArch
fdc2c4899f2ba71a661a3b3f239cc17fa7221fb2,0,0,0,0,0,0,0,0,0,0,0,0,0,0,0,45,6,0,0,0,0,0,0,0,0,0,1,100,NoArch
85949e751323c72ed55af0a1ba1f47f3a55a318f,0,0,0,0,0,0,0,0,0,0,0,0,0,0,0,46,7,0,0,0,0,0,0,0,0,0,1,100,NoArch
efc3db5634563602e2e504b8b1fe16475f431112,0,0,0,0,0,0,0,0,0,0,0,0,0,0,0,135,9,0,0,0,0,0,0,0,0,0,0,100,NoArch
ff1e35fb0774691aa77ff47b196c5a1e7335240b,1,5,1,4,6,0,0,0,20,684,1,1,0,99,4,136,10,12,11,1,575,549,26,7,7,0,1,100,NoArch
844ea7709ce2ef022cca280b4376cefb6d579c4b,0,0,0,0,0,0,0,0,0,0,0,0,0,0,0,137,11,0,0,0,0,0,0,0,0,0,1,100,NoArch
c7acde0a81b8413c40b40c5cef2fed13faa1b85d,0,0,0,0,0,0,0,0,0,0,0,0,0,0,0,47,8,0,0,0,0,0,0,0,0,0,1,100,NoArch
874faae7323ea0888769ef96bc0d12d23db052ca,0,0,0,0,0,0,0,0,0,0,0,0,0,0,0,48,9,0,0,0,0,0,0,0,0,0,1,100,NoArch
da44c2318c5dc9bfc4116cd713bcd0eb872e6e5a,36,317,140,177,457,0,0,0,59,364,1,16,4.506325286,10652,1,138,11,1853,1820,33,56161,55146,1015,768,757,11,1,96.1352657,Arch
eb895229861088c0b25dc0b23693920ccee5d593,0,0,0,0,0,0,0,0,0,0,0,0,0,0,0,49,10,0,0,0,0,0,0,0,0,0,1,100,NoArch
c4c44266b38bce822072c200343520c58b4b6902,0,0,0,0,0,0,0,0,0,0,0,0,0,0,0,50,11,0,0,0,0,0,0,0,0,0,1,100,NoArch
6e774f574bc75ade354423dadacfa9dd6aa5ff2b,0,0,0,0,0,0,0,0,0,0,0,0,0,0,0,51,12,0,0,0,0,0,0,0,0,0,1,100,NoArch
122353642cc8ca30c04908f20e7636b342c30a0d,0,0,0,0,0,0,0,0,0,0,0,0,0,0,0,52,13,0,0,0,0,0,0,0,0,0,1,100,NoArch
883f32a9d1060d6578176efcc974ae453fc38e72,0,0,0,0,0,0,0,0,0,0,0,0,0,0,0,53,14,0,0,0,0,0,0,0,0,0,1,100,NoArch
287f348e2e331ebfca808275413585dd99e6865f,0,0,0,0,0,0,0,0,0,0,0,0,0,0,0,54,15,0,0,0,0,0,0,0,0,0,1,100,NoArch
8fad411325a514d8dbf782c2a15ec169f3e428e6,0,0,0,0,0,0,0,0,0,0,0,0,0,0,0,55,16,0,0,0,0,0,0,0,0,0,1,100,NoArch
5c7076df6a213fb62838a246fa061a34d24858fa,0,0,0,0,0,0,0,0,0,0,0,0,0,0,0,28,0,0,0,0,0,0,0,0,0,0,1,100,NoArch
acbb703c989806356d7edb1d7ff563c913a5cb0e,0,0,0,0,0,0,0,0,0,0,0,0,0,0,0,29,1,0,0,0,0,0,0,0,0,0,1,100,NoArch
d5e1e385ce6464c2c95e1d3aaab7b5d015bf3e81,0,0,0,0,0,0,0,0,0,0,0,0,0,0,0,30,2,0,0,0,0,0,0,0,0,0,1,100,NoArch
c909aa17c9f592da6db3dffc3505e91af7545b86,0,0,0,0,0,0,0,0,0,0,0,0,0,0,0,31,3,0,0,0,0,0,0,0,0,0,1,100,NoArch
0c0a454e4e06cb35fb9db9d5054684f8ea6c16fd,0,0,0,0,0,0,0,0,0,0,0,0,0,0,0,32,4,0,0,0,0,0,0,0,0,0,1,100,NoArch
29fa142825a7b094abb61475e2f787ca3495a316,0,0,0,0,0,0,0,0,0,0,0,0,0,0,0,33,5,0,0,0,0,0,0,0,0,0,1,100,NoArch
35f6ce9cbc8cbba05efe70a3578bc78ef29da594,0,0,0,0,0,0,0,0,0,0,0,0,0,0,0,34,6,0,0,0,0,0,0,0,0,0,1,100,NoArch
67142f000666b7bb8f344dcd45b0b2608457226d,0,0,0,0,0,0,0,0,0,0,0,0,0,0,0,35,7,0,0,0,0,0,0,0,0,0,1,100,NoArch
9eed34dac2bc0203e2e42242d08e90b96fc56fbb,0,0,0,0,0,0,0,0,0,0,0,0,0,0,0,56,16,0,0,0,0,0,0,0,0,0,1,100,NoArch
b4bd442ba87dddefa58143a9793b31df3cb7e708,0,0,0,0,0,0,0,0,0,0,0,0,0,0,0,57,17,0,0,0,0,0,0,0,0,0,1,100,NoArch
fc986ce223a13e88c11d611c6d3870d023e99d08,0,0,0,0,0,0,0,0,0,0,0,0,0,0,0,58,18,0,0,0,0,0,0,0,0,0,1,100,NoArch
6310f6945fd409d27bc1347e993d8dab5c5da8f1,0,0,0,0,0,0,0,0,0,0,0,0,0,0,0,59,19,0,0,0,0,0,0,0,0,0,1,100,NoArch
ee35b2176aa020353549c1877052094f0cbd35ac,0,0,0,0,0,0,0,0,0,0,0,0,0,0,0,60,20,0,0,0,0,0,0,0,0,0,1,100,NoArch
60c0c5450755ee4dc21d3e6cb575f9291bc7656e,2,208,1,207,209,1,0,1,60,18,1,2,0.528259588,879,5,139,9,112,77,35,6888,5619,1269,72,63,9,1,99.86013986,NoArch
db12764c2637364addfb835b783533460d49a159,1,1,1,0,2,0,0,0,6,155,1,1,0,522,3,140,10,110,110,0,3993,3989,4,100,100,0,1,100,NoArch
2c39d103b922c3796e3771df1d979daa49cf494f,0,0,0,0,0,0,0,0,0,0,0,0,0,0,0,141,11,0,0,0,0,0,0,0,0,0,1,100,NoArch
1628df0503496cef5d3c55b255c44a90a0daa624,0,0,0,0,0,0,0,0,0,0,0,0,0,0,0,61,18,0,0,0,0,0,0,0,0,0,1,100,NoArch
6debff5cf9e7054aeffca17f9e91e87a2fc122f2,0,0,0,0,0,0,0,0,0,0,0,0,0,0,0,62,19,0,0,0,0,0,0,0,0,0,1,100,NoArch
f6ddbe438d7f488314c50d536e2a1b2dd79adf8c,3,7,5,2,12,0,0,0,5,24,1,1,1.584962501,294,3,63,20,19,19,0,882,861,21,9,9,0,1,100,NoArch
2eef70c41920acb336d7910acb0f577a1e83c968,0,0,0,0,0,0,0,0,0,0,0,0,0,0,0,64,17,0,0,0,0,0,0,0,0,0,1,100,NoArch
b151f1f3a0fbb14a840aa33048a42427134f5fb5,0,0,0,0,0,0,0,0,0,0,0,0,0,0,0,142,4,0,0,0,0,0,0,0,0,0,0,100,NoArch
c542500c8316da5bfc83f9dba58ec8bb07c2a0a8,2,3,7,4,10,0,0,0,48,43,1,2,0.970950594,863,4,23,0,170,171,1,4572,4585,13,45,45,0,1,100,NoArch
23c645641c0dcceff6515a2f00b3d7bc940aba9a,0,0,0,0,0,0,0,0,0,0,0,0,0,0,0,36,8,0,0,0,0,0,0,0,0,0,1,100,NoArch
37f4c480cdfb3367f5482cf07ccd099d1d7a59ab,0,0,0,0,0,0,0,0,0,0,0,0,0,0,0,37,9,0,0,0,0,0,0,0,0,0,1,100,NoArch
ba6b305d9bf41d7e695132340147809f42e93b23,0,0,0,0,0,0,0,0,0,0,0,0,0,0,0,38,10,0,0,0,0,0,0,0,0,0,1,100,NoArch
cd30b485062b1920887276cc44552590d703f443,2,18,5,13,23,0,0,0,44,98,1,2,0.998635964,1059,4,143,5,200,198,2,7660,7550,110,80,80,0,1,100,NoArch
af78321f7d6fb7d35f7eba2116cb8811e38d5ab6,5,89,0,89,89,0,0,0,2,99,1,4,2.321559629,287,1,144,6,14,14,0,1073,1073,0,11,11,0,0,100,NoArch
1ef1b15816702ad7a9bad27a40d8abff34a4b4b8,0,0,0,0,0,0,0,0,0,0,0,0,0,0,0,145,7,0,0,0,0,0,0,0,0,0,0,100,NoArch
12fce370b665d14852bb757f92bd5de99ab5859c,0,0,0,0,0,0,0,0,0,0,0,0,0,0,0,146,8,0,0,0,0,0,0,0,0,0,0,100,NoArch
04d3e592f34d38d17c04a6e7b0217f7ae7ea1feb,0,0,0,0,0,0,0,0,0,0,0,0,0,0,0,147,9,0,0,0,0,0,0,0,0,0,0,100,NoArch
cc434590d3e8970208bd60c822146b2e2a91382c,0,0,0,0,0,0,0,0,0,0,0,0,0,0,0,65,9,0,0,0,0,0,0,0,0,0,1,100,NoArch
08d0b88a9975956c107f1bbd378ae91550843be6,1,13,2,11,15,0,0,0,28,50,1,1,0,260,3,148,9,82,80,2,1854,1750,104,15,15,0,1,100,NoArch
b0da28f5ba067365251aa0964caf5f3baee6d1bd,3,109,47,62,156,0,0,0,4,64,1,3,1.401163781,1761,1,149,10,437,417,20,11294,10921,373,120,114,6,1,100,NoArch
14bad855be78ba3416a0ff477ca8c6ca688ec9a8,1,3,7,4,10,0,0,0,8,734,1,1,0,144,3,150,11,18,18,0,756,759,3,11,11,0,1,100,NoArch
28fbfce69cb4ad3f9622c18c965c9ca8233c77f3,0,0,0,0,0,0,0,0,0,0,0,0,0,0,0,151,12,0,0,0,0,0,0,0,0,0,0,100,NoArch
43180cf8a9fb0f3c665e66ab5d94f3a1202cca3e,0,0,0,0,0,0,0,0,0,0,0,0,0,0,0,152,13,0,0,0,0,0,0,0,0,0,0,100,NoArch
7b60f03ad832976b0c771c4af68c3e66a0a4b201,0,0,0,0,0,0,0,0,0,0,0,0,0,0,0,153,11,0,0,0,0,0,0,0,0,0,0,100,NoArch
66a34cf75e174d15451746f1b509993538603df3,0,0,0,0,0,0,0,0,0,0,0,0,0,0,0,197,5,0,0,0,0,0,0,0,0,0,1,100,NoArch
87c3c2f57e0e2b67088ec3148a8a410ef8e4c0e6,0,0,0,0,0,0,0,0,0,0,0,0,0,0,0,198,5,0,0,0,0,0,0,0,0,0,0,100,NoArch
0ea74a36cebb2e5fbc37e599814a05c33cb7d424,4,647,0,647,647,4,0,4,1,0,1,3,1.968890359,0,1,199,6,86,0,86,3389,0,3389,31,0,31,1,99.31034483,NoArch
989b7b643a038f32a84f14f428ca901b5bbfdef0,0,0,0,0,0,0,0,0,0,0,0,0,0,0,0,200,7,0,0,0,0,0,0,0,0,0,0,100,NoArch
17e0ec1ab5762644682900251ae5ad4eb8bdd249,0,0,0,0,0,0,0,0,0,0,0,0,0,0,0,0,0,0,0,0,0,0,0,0,0,0,2,100,NoArch
23fc278df3a8ae5a2b9093f9b91934d58a184fee,0,0,0,0,0,0,0,0,0,0,0,0,0,0,0,1,1,0,0,0,0,0,0,0,0,0,0,100,NoArch
36f9b467e714eff199edac938c00e017accefa5a,3,28,6,22,34,0,0,0,52,126,1,3,1.082720388,1466,2,201,3,319,318,1,10598,10436,162,107,106,1,1,100,NoArch
b72784d7a5f8f932edaacbee75ce05ff5d3544ef,7,6,675,669,681,0,4,4,51,88,1,6,2.210731911,2135,2,198,0,318,405,87,10436,13987,3551,106,138,32,0,99.31034483,NoArch
5cac72e7c1173faae8da920eb9461b9ea958f96f,7,676,6,670,682,4,0,4,52,68,1,6,2.210384474,1466,2,69,0,403,318,85,13977,10436,3541,138,106,32,1,99.31034483,NoArch
446bd1be05c2e1c385d24b31e79504a9fcb1b4b2,44,6208,0,6208,6208,44,0,44,1,0,1,9,5.021740929,0,1,202,0,402,0,402,26712,0,26712,268,0,268,1,88.84172226,Arch
2cb83f478424c00d36d2b58cae1508d1ab4df235,0,0,0,0,0,0,0,0,0,0,0,0,0,0,0,203,1,0,0,0,0,0,0,0,0,0,1,100,NoArch
6fd751939e1759654c174b863637fad12ced9269,0,0,0,0,0,0,0,0,0,0,0,0,0,0,0,70,1,0,0,0,0,0,0,0,0,0,1,100,NoArch
64664a630cb0674f145a1b8f4ef132b83bde9523,0,0,0,0,0,0,0,0,0,0,0,0,0,0,0,71,2,0,0,0,0,0,0,0,0,0,1,100,NoArch
52ea2d88416fbf964cfd6bf1c6c959596ed1063e,0,0,0,0,0,0,0,0,0,0,0,0,0,0,0,54,0,0,0,0,0,0,0,0,0,0,1,100,NoArch
03dfcb3c4ce15896c12b39f96dbe3de1894dc172,0,0,0,0,0,0,0,0,0,0,0,0,0,0,0,55,1,0,0,0,0,0,0,0,0,0,1,100,NoArch
acfa07feb6b47e554d14429c3c98a8810ac3be42,0,0,0,0,0,0,0,0,0,0,0,0,0,0,0,204,0,0,0,0,0,0,0,0,0,0,3,100,NoArch
6cf7a47b16039ee50cd616eedf23e8e166d457e4,0,0,0,0,0,0,0,0,0,0,0,0,0,0,0,205,1,0,0,0,0,0,0,0,0,0,1,100,NoArch
34ece34c097347fd06b0e4f717d5d102266e25ff,1,2,2,0,4,0,0,0,2,76,1,1,0,127,2,72,0,6,6,0,574,574,0,3,3,0,1,100,NoArch
6eb2c5801e9029b22e5800a86986bde03d5541b9,0,0,0,0,0,0,0,0,0,0,0,0,0,0,0,73,1,0,0,0,0,0,0,0,0,0,1,100,NoArch
b50ab97269c4c52bf45db27d5b54e0d6e0e4154c,2,9,2,7,11,0,0,0,13,1430,1,2,0.945660305,923,4,74,2,153,153,0,4477,4467,10,31,31,0,1,100,NoArch
563afdbf1e35b7d12723d0c88562a8f277ddd353,0,0,0,0,0,0,0,0,0,0,0,0,0,0,0,75,3,0,0,0,0,0,0,0,0,0,1,100,NoArch
0b0a574620b6ab87f36e4cad8480e9872c40f90a,0,0,0,0,0,0,0,0,0,0,0,0,0,0,0,76,4,0,0,0,0,0,0,0,0,0,1,100,NoArch
5e8664c16e75d4d9a4523d368ef75290fd0ea4c2,0,0,0,0,0,0,0,0,0,0,0,0,0,0,0,77,5,0,0,0,0,0,0,0,0,0,0,100,NoArch
c6cf5d5fc36c69525dbf3712af42014a3da417e0,0,0,0,0,0,0,0,0,0,0,0,0,0,0,0,78,6,0,0,0,0,0,0,0,0,0,1,100,NoArch
7d46ba4ab4c4589e544f3df51b9d4552771b14fb,0,0,0,0,0,0,0,0,0,0,0,0,0,0,0,79,7,0,0,0,0,0,0,0,0,0,1,100,NoArch
e16dd633702a190f91767a14c33393e2d0bbbf91,1,2,2,0,4,0,0,0,28,1089,1,1,0,407,5,206,2,54,54,0,1927,1928,1,33,33,0,1,100,NoArch
7fb563982d6f44d05a6f3c578a6948e7c7d6f1e5,2,74,1,73,75,1,0,1,31,148,1,2,0.665273523,277,1,207,3,97,83,14,2285,1891,394,25,16,9,1,99.61811238,NoArch
02802d57b0698cacf72668fa50ca93e77c12b302,4,30,4,26,34,0,0,0,65,225,1,4,1.214210357,3647,5,208,4,783,781,2,23645,23436,209,337,336,1,1,100,NoArch
4a6cd2780b741db3a01296f758abdd6fcaa71a40,0,0,0,0,0,0,0,0,0,0,0,0,0,0,0,209,5,0,0,0,0,0,0,0,0,0,0,100,NoArch
5be068e83656f026c68ebe78bb039b84165564e5,9,208,14,194,222,1,0,1,51,621,1,6,1.973779552,2695,1,210,6,446,429,17,15418,14321,1097,210,200,10,1,99.89071038,NoArch
1f3580f5d53746eaf8eb1d5d0fad00a18971666c,1,13,11,2,24,0,0,0,30,0,1,1,0,406,5,211,7,54,54,0,1870,1904,34,34,33,1,1,99.94541485,NoArch
2020c8a8cc19c58eaef2d9de75260e7341099038,6,408,5,403,413,3,0,3,49,0,1,4,1.639100432,1269,1,212,8,304,239,65,11210,8850,2360,138,98,40,1,99.67302452,NoArch
f84b9a4b6af31a7758f48f947e6a8fde1f126661,2,8,0,8,8,0,0,0,50,0,1,2,0.543564443,1121,4,213,9,214,212,2,8112,8053,59,86,85,1,1,100,NoArch
d4151ed11a8a0f2a5a2032d524951efb3d50560e,2,34,1,33,35,1,0,1,28,148,1,2,0.315997133,565,1,214,10,124,123,1,3294,3202,92,60,59,1,1,99.89130435,NoArch
d3b4045aa537e048c2df007afd6e54b7ace5f272,1,1,0,1,1,0,0,0,16,228,1,1,0,133,3,215,11,26,25,1,636,625,11,17,17,0,1,100,NoArch
91af47b9ef66965d1df524c555d29af24d9b75c4,2,60,4,56,64,1,0,1,50,241,1,2,0.757878463,690,1,216,12,156,155,1,3930,3686,244,43,42,1,1,99.78319783,NoArch
dc4d37dd6d5d69ea27ffff797d926b9042719643,0,0,0,0,0,0,0,0,0,0,0,0,0,0,0,217,13,0,0,0,0,0,0,0,0,0,1,100,NoArch
2567f66612bc97f984f52be54b0b213882a52287,0,0,0,0,0,0,0,0,0,0,0,0,0,0,0,218,14,0,0,0,0,0,0,0,0,0,1,100,NoArch
aa24373e12a75bff689a543711391597d0e63e6b,0,0,0,0,0,0,0,0,0,0,0,0,0,0,0,56,0,0,0,0,0,0,0,0,0,0,1,100,NoArch
e7619cc5dec31c6db342d341504635048d60afb1,0,0,0,0,0,0,0,0,0,0,0,0,0,0,0,57,1,0,0,0,0,0,0,0,0,0,1,100,NoArch
24673177ca18128f1c5dd137e5968ae4e8359e7f,0,0,0,0,0,0,0,0,0,0,0,0,0,0,0,58,2,0,0,0,0,0,0,0,0,0,1,100,NoArch
78b172c040f934ad59635b69ff797a09ff039136,0,0,0,0,0,0,0,0,0,0,0,0,0,0,0,59,3,0,0,0,0,0,0,0,0,0,1,100,NoArch
b49babe09e3c2a83fee4d52b11822d500ebc67f1,0,0,0,0,0,0,0,0,0,0,0,0,0,0,0,60,4,0,0,0,0,0,0,0,0,0,1,100,NoArch
46726e0e5b5a722096a2594c83946ac5c996bd10,0,0,0,0,0,0,0,0,0,0,0,0,0,0,0,61,5,0,0,0,0,0,0,0,0,0,1,100,NoArch
60d75c554ccbc72b8a60c5759f0175ae07e8254a,0,0,0,0,0,0,0,0,0,0,0,0,0,0,0,62,6,0,0,0,0,0,0,0,0,0,1,100,NoArch
fbb36181e2b30571b71d177986f0e75285736866,0,0,0,0,0,0,0,0,0,0,0,0,0,0,0,63,7,0,0,0,0,0,0,0,0,0,1,100,NoArch
bc4e7d8066a1ee564c096fc940e34f1b45c07eec,0,0,0,0,0,0,0,0,0,0,0,0,0,0,0,64,8,0,0,0,0,0,0,0,0,0,1,100,NoArch
034665d0cd02b90558bb39115f7f1f2b42e4e156,0,0,0,0,0,0,0,0,0,0,0,0,0,0,0,80,8,0,0,0,0,0,0,0,0,0,1,100,NoArch
b6632258952f5e60a1a40c10ea2625ba6c1f841f,0,0,0,0,0,0,0,0,0,0,0,0,0,0,0,81,9,0,0,0,0,0,0,0,0,0,1,100,NoArch
099e20794a818ccb5cbab71d1934c784ed45ac14,0,0,0,0,0,0,0,0,0,0,0,0,0,0,0,65,9,0,0,0,0,0,0,0,0,0,1,100,NoArch
3c2cec4957178552c5e325e622da270d863815f6,0,0,0,0,0,0,0,0,0,0,0,0,0,0,0,66,10,0,0,0,0,0,0,0,0,0,1,100,NoArch
b52d006922d50150e4de9b447f44be574bef9633,0,0,0,0,0,0,0,0,0,0,0,0,0,0,0,2,0,0,0,0,0,0,0,0,0,0,0,100,NoArch
ab4fe4f2647bca4123a6c1f5f5012958d75affcf,3,54,0,54,54,0,0,0,2,10,1,2,1.584962501,288,1,219,15,39,39,0,1623,1623,0,26,26,0,0,100,NoArch
c7e3f4a687564b125686f4a075d8fcfa90d63aaf,2,747,0,747,747,2,0,2,1,0,1,2,0.845867078,0,1,220,16,62,0,62,2918,0,2918,29,0,29,1,99.46495452,NoArch
a581cf389f5d4ce82ff95f3d9d98efbe326cacae,2,15,0,15,15,0,0,0,15,1016,1,2,0.566509507,1415,3,221,15,190,188,2,6584,6482,102,101,100,1,1,100,NoArch
ea125d9f3a7aaa3876bab84b08a0d7f1fa2e8904,0,0,0,0,0,0,0,0,0,0,0,0,0,0,0,222,16,0,0,0,0,0,0,0,0,0,1,100,NoArch
172408e77233aa562d5b3a5c3fae9c8a7160ca86,0,0,0,0,0,0,0,0,0,0,0,0,0,0,0,223,17,0,0,0,0,0,0,0,0,0,1,100,NoArch
f9a423d2a85d820cec8404a254b605f56eb070c7,0,0,0,0,0,0,0,0,0,0,0,0,0,0,0,224,18,0,0,0,0,0,0,0,0,0,0,100,NoArch
3a7cc7ea565e8ff1a5dc6b106f7828e0922916c7,0,0,0,0,0,0,0,0,0,0,0,0,0,0,0,67,0,0,0,0,0,0,0,0,0,0,1,100,NoArch
a39e6deea243dcd9a09df8f67af724003dec1d02,2,67,4,63,71,1,0,1,17,359,1,2,0.507935356,702,1,225,0,120,114,6,3646,3388,258,46,41,5,1,96.83985003,Arch
a760e09477b74b640ff8796c02da1c2be8585d1f,0,0,0,0,0,0,0,0,0,0,0,0,0,0,0,226,1,0,0,0,0,0,0,0,0,0,0,100,NoArch
36ce7e802d599f31b099dfbed930978d17452b2b,0,0,0,0,0,0,0,0,0,0,0,0,0,0,0,227,2,0,0,0,0,0,0,0,0,0,0,100,NoArch
45af853873551ab8fceca5bc43cdf5e742c1080e,0,0,0,0,0,0,0,0,0,0,0,0,0,0,0,228,3,0,0,0,0,0,0,0,0,0,0,100,NoArch
e9ec68ed9fc5186e7156202327ee9d9e02ef05c4,0,0,0,0,0,0,0,0,0,0,0,0,0,0,0,263,21,0,0,0,0,0,0,0,0,0,0,100,NoArch
ba55d815ea63d923fea504d1da8baa1e5920701f,0,0,0,0,0,0,0,0,0,0,0,0,0,0,0,262,16,0,0,0,0,0,0,0,0,0,0,100,NoArch
79323b0bd6a3e77469f9b4c23f33783460324e09,1,4,4,0,8,0,0,0,22,1185,1,1,0,477,4,263,17,111,111,0,2558,2562,4,11,11,0,1,100,NoArch
1b896e1a8456c2320f3dba8eef43beffd15d2d91,3,2,5,3,7,0,0,0,6,1569,1,2,1.148834854,349,3,264,18,26,26,0,1901,1919,18,21,21,0,1,100,NoArch
c1aca86bf8ab2715e0ba732ed48d18fb3becf54d,4,9,6,3,15,0,0,0,21,335,1,3,1.532914564,823,3,264,18,137,137,0,4481,4459,22,32,32,0,0,100,NoArch
c3577650285efd083a22a86670e33137d0fc6cdf,8,47,126,79,173,0,1,1,22,894,1,7,2.034466654,2308,2,3,0,273,276,3,8713,9024,311,101,104,3,1,92.4037981,Arch
f920d4e1067e5951b5ea7b38b6cb5d925d60b99b,0,0,0,0,0,0,0,0,0,0,0,0,0,0,0,265,16,0,0,0,0,0,0,0,0,0,0,100,NoArch
01f774f28153d220f59bff026ade4982d20ace2d,0,0,0,0,0,0,0,0,0,0,0,0,0,0,0,3,0,0,0,0,0,0,0,0,0,0,1,100,NoArch
1dbb07ac2f068dbc6b0bea963bf2abacab7cc434,0,0,0,0,0,0,0,0,0,0,0,0,0,0,0,266,1,0,0,0,0,0,0,0,0,0,1,100,NoArch
3c15fc6183d1df06abc2eb1904f9c4514ef4f665,5,181,151,30,332,1,0,1,66,402,1,3,1.788221648,3669,5,267,0,753,756,3,21941,21845,96,336,340,4,1,97.20998532,Arch
9b9068a00a3a1fac2525fe245365238b58370120,3,72,0,72,72,1,0,1,52,100,1,3,1.560535828,1380,3,268,1,190,184,6,10050,9686,364,63,61,2,1,99.90224829,NoArch
9e5e0462b1957c372bd7351b7f5e6c68d4a41b5d,0,0,0,0,0,0,0,0,0,0,0,0,0,0,0,269,2,0,0,0,0,0,0,0,0,0,1,100,NoArch
f261733c575fbb57ced1f11e8af69ec88b573b8a,2,6,2,4,8,0,0,0,7,920,1,1,0.954434003,233,4,4,0,16,16,0,726,704,22,6,6,0,1,100,NoArch
121b98ddc5a9db44040260bf5a6ec7bb106ad3de,2,174,0,174,174,0,0,0,31,1022,1,2,0.383269164,267,4,5,1,72,44,28,2560,1434,1126,46,24,22,1,99.60841899,NoArch
b81a91a57a111650245aa803a3c2233995b3bf56,2,2,6,4,8,0,0,0,8,0,1,1,0.954434003,237,4,6,2,16,16,0,704,726,22,6,6,0,1,100,NoArch
957ccf706a1d124c7fb74caf31862b9c03a99a1b,2,65,2,63,67,0,0,0,9,10,1,1,0.879458774,233,4,7,3,27,16,11,984,704,280,6,6,0,1,100,NoArch
1638ebb5ea88f277fe065babd90551fbf74439df,2,69,18,51,87,1,0,1,9,678,1,2,0.995325107,522,3,270,3,114,110,4,3975,3993,18,102,100,2,1,99.70631424,NoArch
c8fe3e085e7afb5ee7de69561f0578a8ca2f046c,7,35,25,10,60,0,0,0,55,365,1,7,2.290018766,2622,1,271,4,459,458,1,15297,15241,56,203,202,1,1,97.41463415,Arch
22d55ddf3e6ff8021da1743c8bb989111391b32a,2,108,0,108,108,2,0,2,1,0,1,1,0.99975261,0,1,272,4,4,0,4,681,0,681,2,0,2,1,97.22492697,Arch
88736f8d389c17584508a105d608bca2b3281084,5,200,1,199,201,4,0,4,7,170,1,2,2.16056545,99,1,273,4,15,6,9,935,412,523,9,3,6,1,98.67582148,NoArch
a2a7aeae62aa0eb9f3225ce0befde7a7bedfbad2,4,177,35,142,212,1,0,1,56,148,1,3,1.592668878,1132,1,274,5,329,311,18,7782,7088,694,121,107,14,1,99.34967484,NoArch
a8a905895a6a8a71617158bf4059f15905b3dd71,3,34,0,34,34,1,0,1,9,415,1,2,0.381580488,294,1,275,6,53,53,0,1783,1698,85,36,36,0,1,99.74709155,NoArch
fab6363adf4cf07db4004017c8e1dc5968850475,0,0,0,0,0,0,0,0,0,0,0,0,0,0,0,276,4,0,0,0,0,0,0,0,0,0,1,100,NoArch
0c5813b70f38952cbac69f5217bbf13e0e0b1a4c,2,4,4,0,8,0,0,0,3,316,1,2,1,1099,2,277,5,104,104,0,3407,3407,0,43,43,0,1,100,NoArch
2efa6cee3abd81f2816cff9631606647ed5998fb,0,0,0,0,0,0,0,0,0,0,0,0,0,0,0,278,6,0,0,0,0,0,0,0,0,0,1,100,NoArch
fb165e6ec812d4d03ea89de09ca1b758a7cdab6c,0,0,0,0,0,0,0,0,0,0,0,0,0,0,0,279,7,0,0,0,0,0,0,0,0,0,1,100,NoArch
23c2acf93231095ae5f7eb58c08748b62c83d9b5,2,29,22,7,51,0,0,0,14,1245,1,1,0.818955502,1409,4,280,8,242,237,5,6855,6822,33,94,89,5,1,100,NoArch
47308d10309622d3e04912485b1c951f67d4ca73,6,215,11,204,226,0,0,0,53,248,1,3,1.429010054,1242,4,281,9,223,199,24,6752,5701,1051,71,56,15,2,100,NoArch
2eb0672964db2f8a0b047c62f0f50a4c8222cdc5,0,0,0,0,0,0,0,0,0,0,0,0,0,0,0,282,10,0,0,0,0,0,0,0,0,0,0,100,NoArch
8e33d6c26000e31ee22e1f32e73324582f669ebc,0,0,0,0,0,0,0,0,0,0,0,0,0,0,0,25,0,0,0,0,0,0,0,0,0,0,1,100,NoArch
dc1eadb8806821000412fa77963e86a60f78267b,0,0,0,0,0,0,0,0,0,0,0,0,0,0,0,26,1,0,0,0,0,0,0,0,0,0,1,100,NoArch
d160f17357c241a2c925a182e064f4068db22fe6,0,0,0,0,0,0,0,0,0,0,0,0,0,0,0,283,11,0,0,0,0,0,0,0,0,0,0,100,NoArch
f0e4e90568d40992c78e0b2e5e2367d33b1d05e1,0,0,0,0,0,0,0,0,0,0,0,0,0,0,0,80,0,0,0,0,0,0,0,0,0,0,1,100,NoArch
785523bf05b62b0681e5c81ed210843262b59546,0,0,0,0,0,0,0,0,0,0,0,0,0,0,0,284,11,0,0,0,0,0,0,0,0,0,0,100,NoArch
37b4bb9745e7ea08c0bc76ad520d90d76f711ac7,0,0,0,0,0,0,0,0,0,0,0,0,0,0,0,285,12,0,0,0,0,0,0,0,0,0,0,100,NoArch
bffc3c6701a3fc7f0776dea6e61f5ae25c14c602,0,0,0,0,0,0,0,0,0,0,0,0,0,0,0,286,10,0,0,0,0,0,0,0,0,0,0,100,NoArch
bfc1bdc733da592fd665a56692a4f5c08e731f53,0,0,0,0,0,0,0,0,0,0,0,0,0,0,0,285,9,0,0,0,0,0,0,0,0,0,0,100,NoArch
a77d713671e7a53a3c7ebed1d3f5b843b224a6da,0,0,0,0,0,0,0,0,0,0,0,0,0,0,0,4,0,0,0,0,0,0,0,0,0,0,1,100,NoArch
111c5c91507b943acfdb1370dd9401de4a63b5a8,3,237,0,237,237,3,0,3,1,0,1,1,1.478328754,0,1,8,0,17,0,17,1326,0,1326,9,0,9,1,98.02431611,NoArch
588288be89c3d8aeca79f6aa41d09f3efe5a0918,1,5,1,4,6,0,0,0,5,1699,1,1,0,168,3,286,1,19,18,1,1107,1079,28,8,7,1,1,100,NoArch
6774ee3b5f08666c6ba1e9ee6040283932d0f875,2,5,3,2,8,0,0,0,36,1128,1,2,0.811278124,457,2,287,2,50,49,1,2161,2158,3,16,16,0,1,100,NoArch
a4769d950af7074c060d7f962fada88352620dbe,2,14,0,14,14,0,0,0,2,374,1,2,0.371232327,412,1,288,0,67,66,1,2714,2631,83,28,27,1,1,100,NoArch
53fa2dcc0773985912ce5ced3c1dea1e5b2d0a45,0,0,0,0,0,0,0,0,0,0,0,0,0,0,0,9,0,0,0,0,0,0,0,0,0,0,1,100,NoArch
77c48330740108e658cb3fcc94c4d8e04324e547,2,12,0,12,12,0,0,0,2,382,1,2,0.41381685,573,1,289,1,111,110,1,3947,3829,118,43,42,1,1,100,NoArch
7e141b815cd05d75a210b00010a6cad8edbb84b7,9,76,5,71,81,0,0,0,3,212,1,5,2.374449339,1715,1,290,2,346,326,20,11122,10663,459,124,118,6,1,100,NoArch
350f09f3cefec53e20762e7862cb37f38c6251e6,6,165,15,150,180,2,0,2,8,1424,1,3,1.738281676,342,1,291,3,52,37,15,1851,1219,632,34,27,7,1,98.22154472,NoArch
30e1a5222aba7f80e9609b020816931e857d35ef,2,9,1,8,10,0,0,0,54,258,1,2,0.970950594,854,3,292,4,172,171,1,4490,4422,68,54,53,1,1,100,NoArch
fd4edf6088965a6edda1bfc17ce992b0e0e1c37c,3,100,0,100,100,1,0,1,9,1033,1,3,1.162073433,515,1,293,5,47,42,5,4100,3527,573,30,26,4,1,98.51129363,NoArch
7666029b4a61c67530f24ee3bc109a520c296f95,2,2,0,2,2,0,0,0,8,172,1,1,1,296,1,294,6,55,53,2,1754,1718,36,38,36,2,1,100,NoArch
dc0d13f9456637e26b4e977bc187453d584d87e8,2,2,1,1,3,0,0,0,4,571,1,2,0.918295834,364,1,295,7,41,41,0,1642,1638,4,26,26,0,1,99.79274611,NoArch
acf33453c71da6b92f9feface1a9e7c8d36456a0,1,5,4,1,9,0,0,0,4,51,1,1,0,363,1,296,1,82,82,0,2137,2110,27,25,25,0,1,100,NoArch
ed8c6144f8fd716203a933fab8b43a9cb79e71e2,6,276,67,209,343,1,0,1,57,371,1,4,2.254551006,1750,1,297,2,423,392,31,11924,10778,1146,137,130,7,1,99.74133471,NoArch
d84d4df196746d00c85657672b64e20be3c0d2e8,3,20,2,18,22,0,0,0,53,795,1,3,1.502220254,674,3,298,3,138,135,3,3481,3420,61,62,59,3,1,100,NoArch
e73d18ddd3554dcaf36063ce7bc26f418155cff2,2,60,5,55,65,1,0,1,2,223,1,2,0.779349837,114,1,299,4,9,7,2,888,599,289,4,2,2,1,99.84520124,NoArch
57c9811a1695761d3e0f224b7e89e8174d927e43,4,56,19,37,75,0,0,0,23,1382,1,1,1.25704865,1267,4,300,4,226,216,10,6169,5982,187,77,67,10,1,100,NoArch
448249366ff5ab9f5cfe4117b26ef0ab3bc7d047,3,208,0,208,208,2,0,2,20,151,1,2,1.035360097,102,1,26,0,21,10,11,1462,515,947,12,4,8,1,94.37119675,Arch
68bdc4317ef2c5e33ad23bbc78f0b0690350e459,2,18,0,18,18,0,0,0,16,510,1,2,0.764204507,1437,3,301,5,197,194,3,6758,6648,110,106,105,1,1,100,NoArch
cf495ef5736b6fc960196dda969fb1072ead324e,3,378,0,378,378,2,0,2,21,2,1,2,0.996671657,103,1,302,6,42,10,32,2696,520,2176,17,4,13,1,99.75099602,NoArch
4d8a4dd7a2582ad4fa59b8ed3e0db27b91559334,10,527,18,509,545,4,0,4,11,768,1,8,2.986944419,503,2,303,7,70,27,43,4417,2136,2281,47,18,29,1,95.49727857,Arch
c6d00c7462eaef15703f1b4ac635ac278263a6fe,2,16,3,13,19,0,0,0,33,980,1,2,0.981940787,701,7,304,8,91,89,2,3775,3735,40,48,48,0,1,100,NoArch
e044aadc7c2d7da7f5f50a651b219d3270494263,3,148,0,148,148,2,0,2,2,155,1,2,1.087623966,44,1,305,9,14,5,9,710,126,584,5,1,4,1,99.75429975,NoArch
e32e2198384ed0c887c8d96f30c791dc0cfd91dc,12,145,48,97,193,0,0,0,54,1549,1,7,3.093478905,1886,5,306,10,305,288,17,10560,9905,655,183,166,17,1,100,NoArch
21c239025f435bea117e11e61792b89d20a9110e,4,345,5,340,350,2,0,2,4,808,1,3,0.964750357,266,1,307,11,83,24,59,3096,1081,2015,52,13,39,1,97.48134328,Arch
85b9c2c8c79c34b2ebbd6187da58f6b46652f440,0,0,0,0,0,0,0,0,0,0,0,0,0,0,0,308,12,0,0,0,0,0,0,0,0,0,1,100,NoArch
267bda8996a1c8ae0d016b25486731ce122cf222,3,133,116,17,249,1,0,1,16,380,1,1,1.252482532,422,1,309,13,38,43,5,2156,2146,10,31,34,3,0,98.95738894,NoArch
f5c61dab3264c77e5ec12d7b1ddb95bd2239b51f,2,106,37,69,143,0,0,0,4,498,1,2,0.927338928,921,1,310,14,86,78,8,5346,4613,733,40,38,2,1,100,NoArch
9eae49165b55cc25f441b5d52eafe95367fe9441,14,1153,19,1134,1172,12,0,12,2,68,1,3,3.626321454,250,1,311,12,71,15,56,6027,1480,4547,51,9,42,1,98.03742583,NoArch
a78127b2356b9f6c2efab7e36cee442be5be90f4,0,0,0,0,0,0,0,0,0,0,0,0,0,0,0,312,13,0,0,0,0,0,0,0,0,0,1,100,NoArch
8e8de3360c93cca2b6e2877f96423cdf0b48e747,0,0,0,0,0,0,0,0,0,0,0,0,0,0,0,313,14,0,0,0,0,0,0,0,0,0,1,100,NoArch
1dc08581ba6ad5c17d20555818faef9da300478c,0,0,0,0,0,0,0,0,0,0,0,0,0,0,0,314,15,0,0,0,0,0,0,0,0,0,1,100,NoArch
b99318cc3b18e60a051cb03699e592611a50919e,0,0,0,0,0,0,0,0,0,0,0,0,0,0,0,315,16,0,0,0,0,0,0,0,0,0,0,100,NoArch
f7ce4ab5922dfe16c2b35bd21815c3180d7643ca,2,14,8,6,22,0,0,0,2,6,1,1,1,331,1,316,16,21,19,2,1966,1936,30,15,13,2,1,100,NoArch
bce7288b1ec5bec012ef4d7252f0ebe714ee188b,0,0,0,0,0,0,0,0,0,0,0,0,0,0,0,317,17,0,0,0,0,0,0,0,0,0,0,100,NoArch
7364df6e10977e5c36d2921b06064d1abe5832d4,0,0,0,0,0,0,0,0,0,0,0,0,0,0,0,318,16,0,0,0,0,0,0,0,0,0,0,100,NoArch
882b0b32e1b0e01aee5d5ed6aeff8207f43919ed,0,0,0,0,0,0,0,0,0,0,0,0,0,0,0,317,12,0,0,0,0,0,0,0,0,0,0,100,NoArch
84ad7a72bbf42ae7f1e22fceddc9edf48b81655d,0,0,0,0,0,0,0,0,0,0,0,0,0,0,0,318,8,0,0,0,0,0,0,0,0,0,1,100,NoArch
1788948bc9b1bbc36449e5039c8a5b8bf4626963,0,0,0,0,0,0,0,0,0,0,0,0,0,0,0,319,8,0,0,0,0,0,0,0,0,0,1,100,NoArch
48c7b54ccf006935df64853f5c6443b8430b3c75,0,0,0,0,0,0,0,0,0,0,0,0,0,0,0,320,0,0,0,0,0,0,0,0,0,0,1,100,NoArch
a3b38ebfdaf93eb77860fe80540bbc788e9589df,14,402,192,210,594,1,1,2,56,474,1,8,3.362319914,4228,1,321,1,851,817,34,25129,23877,1252,346,328,18,1,98.04923363,NoArch
253e96e9d84da192c9095210529a84def74f6ec6,5,60,7,53,67,0,0,0,5,424,1,1,1.34285416,852,1,322,2,170,159,11,4694,4434,260,72,70,2,1,100,NoArch
0820a9e0e2442730395da77ece1c6a550a86383d,2,179,15,164,194,0,0,0,4,628,1,2,0.98700443,810,2,0,0,83,68,15,4361,3465,896,41,33,8,1,100,NoArch
3726dc2888b2b7d1c5e93f257563043fa9305b89,1,6,4,2,10,0,0,0,17,2334,1,1,0,142,5,1,1,31,29,2,1052,1010,42,7,7,0,1,100,NoArch
1e7a16eb1d624fd10b5b7676ade9a37b77234bb5,0,0,0,0,0,0,0,0,0,0,0,0,0,0,0,2,2,0,0,0,0,0,0,0,0,0,1,100,NoArch
0d22770de46e3aad404dff8901264067cdfdc714,2,13,0,13,13,0,0,0,67,498,1,2,0.89049164,2352,5,323,0,467,464,3,14760,14650,110,233,232,1,1,100,NoArch
c56c4366f80f95a095090e30c511ed0ad4acf2a5,0,0,0,0,0,0,0,0,0,0,0,0,0,0,0,27,0,0,0,0,0,0,0,0,0,0,1,100,NoArch
ebe57473f9a64f540cd4f0dd977313f21de42f6f,2,32,0,32,32,0,0,0,9,240,1,2,1,570,1,324,1,116,108,8,3740,3316,424,74,74,0,1,100,NoArch
2985e27b367370c8c7176f52a26077044b0e77a1,9,104,106,2,210,0,0,0,9,2128,1,1,2.221007122,840,4,325,2,68,71,3,3823,3999,176,34,30,4,1,99.76076555,NoArch
eb7a72136b48a827aae62296b1ba65d63ad0ead5,0,0,0,0,0,0,0,0,0,0,0,0,0,0,0,28,1,0,0,0,0,0,0,0,0,0,1,100,NoArch
3eb36b556128ddcc237489366996b8c237ecdcb8,3,408,31,377,439,0,0,0,6,1570,1,2,0.55870446,2057,1,326,3,469,399,70,13692,11474,2218,253,199,54,1,100,NoArch
9a501d91b962ade5554e8ddeb8bbacde544fb9b8,2,60,1,59,61,0,0,0,10,456,1,2,0.747394446,134,1,327,4,25,15,10,914,540,374,18,12,6,1,91.95979899,Arch
c880210c65d0289d96ca6472ad333fc8068f4e03,5,446,38,408,484,0,0,0,7,688,1,2,0.578869404,2583,1,328,5,570,487,83,17185,14334,2851,305,268,37,1,100,NoArch
6983e7cf8fc86ae26d192cbeca779a57b3d75df5,0,0,0,0,0,0,0,0,0,0,0,0,0,0,0,3,3,0,0,0,0,0,0,0,0,0,1,100,NoArch
3e35fd44125397c1a9d2313220e225c1059b04e0,4,628,0,628,628,2,0,2,22,57,1,2,1.353034008,261,1,329,6,82,25,57,4634,1048,3586,36,13,23,1,98.37362637,NoArch
866a68df261cc259074d864a2e584b077fa6b2bb,6,1494,4,1490,1498,3,0,3,68,380,1,3,1.001165149,2683,1,10,0,842,707,135,22104,15798,6306,390,271,119,1,99.69176574,NoArch
2d90087552098f008bc8d4b6d9ae60f84b345b90,0,0,0,0,0,0,0,0,0,0,0,0,0,0,0,30,0,0,0,0,0,0,0,0,0,0,0,100,NoArch
40650540dcb8ca8a6b6235de5cdd36c0f6e2eb31,15,1726,179,1547,1905,7,0,7,57,291,1,5,3.338131157,3938,4,31,1,947,677,270,30730,22398,8332,487,327,160,1,93.91377853,Arch
2e102f67b8ac4a29afba03b121b4f928ee27f09b,2,10,7,3,17,0,0,0,2,4,1,1,0.322756959,175,1,32,2,18,17,1,707,682,25,15,15,0,1,100,NoArch
258f800dce8433d0de3ced0916167df0446e9390,5,17,12,5,29,0,0,0,59,114,1,3,2.214152221,2204,1,330,1,566,565,1,13084,13073,11,173,172,1,0,100,NoArch
52fe3505338ceb51a2299d1303d0f0c7c8afac2d,5,343,0,343,343,4,0,4,23,7,1,2,2.031136782,105,1,331,2,32,10,22,2289,530,1759,16,4,12,1,99.43181818,NoArch
23201deb6d468b4cd8be4db7f812f37285358f5b,3,19,2,17,21,0,0,0,60,980,1,2,1.441166544,1403,4,332,3,321,319,2,9398,9265,133,107,105,2,1,96.10058309,Arch
82441729dd69fc5d431cabc8b1ffa25e924b8bbe,2,5,2,3,7,0,0,0,2,256,1,2,0.985228136,167,1,333,4,14,14,0,692,671,21,8,8,0,1,100,NoArch
e10bd69255549a854d1ef178ab9df4dbd99dd2ac,0,0,0,0,0,0,0,0,0,0,0,0,0,0,0,334,5,0,0,0,0,0,0,0,0,0,1,100,NoArch
711a4ed4230c0ba1627670e7b89db88472575e1f,7,149,10,139,159,1,0,1,69,371,1,5,2.54921066,3632,1,335,6,723,712,11,23386,22654,732,306,299,7,1,99.933687,NoArch
d32617f83f4b4b78c1a852127595e02d2ffb77f2,3,3,0,3,3,0,0,0,11,498,1,1,1.584962501,275,4,33,1,15,15,0,929,929,0,9,9,0,1,100,NoArch
9199bac9f99f1d5ec8d8f4c396b030c2ae08cd79,1,2,4,2,6,0,0,0,70,20,1,1,0,1449,6,336,6,389,390,1,8761,8771,10,169,169,0,2,100,NoArch
16c626006f3d29f65f4fb1b648e09531106405f5,0,0,0,0,0,0,0,0,0,0,0,0,0,0,0,34,1,0,0,0,0,0,0,0,0,0,1,100,NoArch
2fd8d25b142048ed159731b7e110aa9c3edba843,0,0,0,0,0,0,0,0,0,0,0,0,0,0,0,81,0,0,0,0,0,0,0,0,0,0,1,100,NoArch
0b9ac6561d279342f2eaf85985e2ebf5675691c5,0,0,0,0,0,0,0,0,0,0,0,0,0,0,0,82,1,0,0,0,0,0,0,0,0,0,1,100,NoArch
b790897340eefc626c107c1578f26ee49a3de412,0,0,0,0,0,0,0,0,0,0,0,0,0,0,0,89,0,0,0,0,0,0,0,0,0,0,1,100,NoArch
923b619a011733c9f0669556ab96322335568951,0,0,0,0,0,0,0,0,0,0,0,0,0,0,0,90,1,0,0,0,0,0,0,0,0,0,1,100,NoArch
710684f733c19928f4e5132b25f0c858ea9dfa3f,0,0,0,0,0,0,0,0,0,0,0,0,0,0,0,91,2,0,0,0,0,0,0,0,0,0,1,100,NoArch
d2a8de16fcafeb94b381c38dbe4110b83a16872f,0,0,0,0,0,0,0,0,0,0,0,0,0,0,0,92,3,0,0,0,0,0,0,0,0,0,1,100,NoArch
a1796711e1470ba794f37ae74eb9a34101ff7daa,0,0,0,0,0,0,0,0,0,0,0,0,0,0,0,337,0,0,0,0,0,0,0,0,0,0,1,100,NoArch
1074bbd253c7275648ff8845c54e8f15e70e5428,0,0,0,0,0,0,0,0,0,0,0,0,0,0,0,338,1,0,0,0,0,0,0,0,0,0,0,100,NoArch
ecee999e3be6ea7ffec8f3c7bce267efe9395d4d,1,7,1,6,8,0,0,0,13,875,1,1,0,555,5,339,2,61,60,1,2299,2278,21,29,29,0,1,100,NoArch
c979ba8577fa3d29bd7ebbcf5d8f083c4033f4e2,1,73,10,63,83,0,0,0,14,0,1,1,0,561,5,340,3,71,61,10,2570,2299,271,32,29,3,1,100,NoArch
ae6eede41c9fca1bc235f65fece131816bda3d9d,7,159,18,141,177,0,0,0,61,538,1,7,2.096629821,3337,1,341,4,736,720,16,20935,20150,785,230,214,16,1,100,NoArch
9d9ab81eead6ad75ef182de58f0c0c421fc52237,0,0,0,0,0,0,0,0,0,0,0,0,0,0,0,342,5,0,0,0,0,0,0,0,0,0,1,100,NoArch
b6c2905a5e28233f824147242e40a3c7df52f7da,0,0,0,0,0,0,0,0,0,0,0,0,0,0,0,343,6,0,0,0,0,0,0,0,0,0,1,100,NoArch
6e79ea1e08f7ba0414934c7c65a3dad381a20562,2,6,2,4,8,0,0,0,10,236,1,2,1,602,1,344,7,116,116,0,3740,3740,0,74,74,0,1,100,NoArch
1579ab1ac95731630af58fc303a07c9bf28541d6,1,16,1,15,17,0,0,0,15,36,1,1,0,624,5,6,0,72,71,1,2586,2570,16,33,32,1,1,100,NoArch
4cd58297e1c30930d4cca53c10ff3cd99a33269c,0,0,0,0,0,0,0,0,0,0,0,0,0,0,0,83,0,0,0,0,0,0,0,0,0,0,1,100,NoArch
9b0a633bca2f657e250ddd602468d1fccdc5c027,0,0,0,0,0,0,0,0,0,0,0,0,0,0,0,84,1,0,0,0,0,0,0,0,0,0,1,100,NoArch
05e9ff1711b968388c7cb54e5488e91c8be630af,0,0,0,0,0,0,0,0,0,0,0,0,0,0,0,85,2,0,0,0,0,0,0,0,0,0,1,100,NoArch
e6549b48822e7491406344397c5fce8b1e1f091e,4,3011,1139,1872,4150,0,0,0,11,594,1,3,0.775191447,1683,4,35,0,356,154,202,17060,7315,9745,322,128,194,1,99.90056347,NoArch
b7897db6425377d3f0a6e6a9df169f65737b580b,1,1,1,0,2,0,0,0,3,2874,1,1,0,60,2,36,1,6,6,0,225,225,0,6,6,0,1,100,NoArch
00f36ae402b34d5b47ca5a6349ad5488e2ec5bcd,3,132,0,132,132,2,0,2,24,412,1,2,0.954042522,107,3,345,0,24,10,14,1094,540,554,11,4,7,1,99.83449189,NoArch
fe114b90dff01f10d91055577e58c4325dd45a6e,3,35,3,32,38,0,0,0,6,1017,1,3,1.08622182,593,2,346,1,64,58,6,2618,2433,185,44,44,0,1,100,NoArch
d6b1d2cd0d1bb625f5fb73ef3931a63bbb622953,0,0,0,0,0,0,0,0,0,0,0,0,0,0,0,347,2,0,0,0,0,0,0,0,0,0,0,100,NoArch
8af840b2cd1ad273e6417f58d359e9b113a1c927,17,653,27,626,680,7,0,7,71,535,1,4,3.562157613,4193,5,348,3,964,906,58,28140,25490,2650,439,409,30,1,93.25337331,Arch
854daafa0d91b3e0da986841ba6ad023eddddeca,23,351,80,271,431,0,0,0,62,1011,1,8,3.998639397,4492,1,349,4,775,743,32,25325,23846,1479,295,274,21,1,93.15181518,Arch
74811387064c8668aaf6c538a54284d394bb1d09,0,0,0,0,0,0,0,0,0,0,0,0,0,0,0,350,5,0,0,0,0,0,0,0,0,0,0,100,NoArch
1b52ab8aee659aa8360d25ea444ed0dd771bb2d2,0,0,0,0,0,0,0,0,0,0,0,0,0,0,0,351,6,0,0,0,0,0,0,0,0,0,0,100,NoArch
de1904f0a6b9f2239d715c2a2e8ec71349071d8b,0,0,0,0,0,0,0,0,0,0,0,0,0,0,0,352,7,0,0,0,0,0,0,0,0,0,0,100,NoArch
3c6c62ad7917e5ee712bdc3494ac6fad9905924c,0,0,0,0,0,0,0,0,0,0,0,0,0,0,0,405,8,0,0,0,0,0,0,0,0,0,0,100,NoArch
9ef7389146407441220a6d79af05ee754fcf73df,0,0,0,0,0,0,0,0,0,0,0,0,0,0,0,404,7,0,0,0,0,0,0,0,0,0,0,100,NoArch
b19df789480e063ee36eb5f2b1fef47f9c2e90c4,0,0,0,0,0,0,0,0,0,0,0,0,0,0,0,405,1,0,0,0,0,0,0,0,0,0,0,100,NoArch
86a642787c9bac4d608d053b9c7b3be1128368d9,0,0,0,0,0,0,0,0,0,0,0,0,0,0,0,406,2,0,0,0,0,0,0,0,0,0,1,100,NoArch
9bae616d4f9948c6bb2c8d7b75a2c53d456a1646,2,22,16,6,38,0,0,0,10,445,1,2,0.74248757,2754,1,407,3,552,551,1,16034,16001,33,289,289,0,1,100,NoArch
1c43a60e65da433cf1d0f2e5088ed30f9f8d8bca,0,0,0,0,0,0,0,0,0,0,0,0,0,0,0,408,4,0,0,0,0,0,0,0,0,0,1,100,NoArch
7be037b56f722005ea568b5b19766538434bc1c0,0,0,0,0,0,0,0,0,0,0,0,0,0,0,0,409,5,0,0,0,0,0,0,0,0,0,1,100,NoArch
06711d38a9a5913a3816c6eb8a5dc47b4b612e24,0,0,0,0,0,0,0,0,0,0,0,0,0,0,0,410,6,0,0,0,0,0,0,0,0,0,1,100,NoArch
a0f75f971f81c1b01efd083888e65e968c057846,1,1,1,0,2,0,0,0,5,235,1,1,0,184,3,411,7,17,17,0,1229,1229,0,4,4,0,0,100,NoArch
49593cc38c388b89b85433b4533501a2d11e722f,7,928,26,902,954,6,0,6,5,213,1,2,2.483065282,88,1,412,8,80,7,73,4392,470,3922,54,5,49,1,98.53889128,NoArch
5e2e176168f7d8f528704a05608ee0ab68e32b63,0,0,0,0,0,0,0,0,0,0,0,0,0,0,0,413,9,0,0,0,0,0,0,0,0,0,1,100,NoArch
364444783b65832b07a1436ee3a93faece63d484,2,102,3,99,105,0,0,0,76,234,1,2,0.721928095,2407,5,414,10,508,473,35,15630,15083,547,244,238,6,1,100,NoArch
41b8efb05a6de0a1112c0ea08dfb0c63a86b3614,1,1,1,0,2,0,0,0,2,2,1,1,0,218,1,415,11,14,14,0,652,648,4,6,6,0,1,100,NoArch
706131388a81646d12a53ce31cf4c4557f93c017,2,20,2,18,22,0,0,0,52,382,1,2,0.439496987,1364,5,13,0,198,194,4,8599,8449,150,142,141,1,1,100,NoArch
e0966a1ec55a6ca45baf5d3f53ad6b0e7a049452,2,12,6,6,18,0,0,0,64,1389,1,2,0.99107606,1134,2,14,1,303,298,5,7227,7173,54,90,90,0,1,100,NoArch
8dd83708d454f9dc7caebf2769b3f5c513ba242c,3,19,1,18,20,0,0,0,65,1339,1,3,1.44064545,1523,1,416,0,346,339,7,10177,9967,210,120,119,1,1,91.22725152,Arch
63b868907ada80f8621610ceefc47a0ec4fd26f4,0,0,0,0,0,0,0,0,0,0,0,0,0,0,0,417,1,0,0,0,0,0,0,0,0,0,1,100,NoArch
6e1e0bcf4fb4a0466e0cedb4ac00a0d4bbfed8e1,2,62,11,51,73,0,0,0,77,110,1,2,0.30642473,2506,5,418,2,514,508,6,16076,15630,446,249,244,5,1,100,NoArch
4405ed978425b779a2e2fdd238af2e1a95bfd8b8,1,3,1,2,4,0,0,0,66,30,1,1,0,1040,7,419,3,298,298,0,6475,6460,15,89,89,0,1,100,NoArch
c81303a746f4706b3c039635af37a81d6cfcc962,0,0,0,0,0,0,0,0,0,0,0,0,0,0,0,420,4,0,0,0,0,0,0,0,0,0,1,100,NoArch
14cae5dd0114a28f9a750c718291abba2763fcbd,3,47,1,46,48,0,0,0,58,834,1,3,1.109534908,1060,4,421,5,197,193,4,5773,5444,329,64,62,2,1,100,NoArch
f88cabc1e1271c8d4d2135807fc861664062c276,0,0,0,0,0,0,0,0,0,0,0,0,0,0,0,422,6,0,0,0,0,0,0,0,0,0,1,100,NoArch
4fec1d9c1fde62c384d59ed520dfc80b4a4205a5,6,216,4,212,220,2,0,2,69,231,1,2,2.15259304,2791,6,15,0,555,535,20,18036,17113,923,240,227,13,1,86.97674419,Arch
7122ddad939d59f03da8c60bd41eb9247352c449,6,4,216,212,220,0,2,2,70,18,1,2,2.15259304,3003,6,16,1,535,555,20,17113,18036,923,227,240,13,1,86.97674419,Arch
c754127aae3f252e59d4533f93c8cfaec5608529,0,0,0,0,0,0,0,0,0,0,0,0,0,0,0,0,0,0,0,0,0,0,0,0,0,0,1,100,NoArch
c533aeff68af47a99f3f61d091451a4cff700e19,3,15,9,6,24,0,0,0,18,1489,1,2,1.040852083,810,2,423,0,61,61,0,3295,3242,53,38,38,0,1,100,NoArch
4deed74fe934dbc1edf207cefde92aed587c96a2,1,1,1,0,2,0,0,0,78,228,1,1,0,1544,6,424,1,426,426,0,9298,9299,1,176,176,0,1,100,NoArch
c3a67e5ad90ff19d7557eb627678a3d0a09446e5,4,402,3,399,405,1,0,1,8,1518,1,3,0.880642852,1836,1,425,2,525,439,86,13713,11369,2344,159,122,37,1,99.89754098,NoArch
71c2fc608a443404d0872b12ea08269a84f02d41,2,35,0,35,35,1,0,1,25,304,1,2,0.187176257,478,1,426,3,113,111,2,2682,2555,127,12,11,1,1,99.79560552,NoArch
30e914cf37160bfd0aa4daf97feadd8e57435a33,2,103,0,103,103,0,0,0,5,994,1,2,0.748293286,880,1,427,4,62,54,8,4514,3849,665,46,40,6,1,89.06037222,Arch
5c5e2ea98e792d8a09e5ba173818e02ba570aabc,3,98,4,94,102,0,0,0,9,24,1,3,0.508729019,1928,1,428,5,494,467,27,12542,11961,581,133,127,6,1,100,NoArch
98ec5f2a172391cb5dfa7b4d85f39065bae22754,11,637,0,637,637,10,0,10,19,41,1,3,3.272866961,588,1,17,0,124,74,50,4562,2587,1975,89,59,30,1,99.11147011,NoArch
3e9479b3c8ec6c18f4f7dbe5b1a5a68671296206,0,0,0,0,0,0,0,0,0,0,0,0,0,0,0,429,4,0,0,0,0,0,0,0,0,0,1,100,NoArch
a076f6f6f9848090776080b876fa0c1f2ca660a5,0,0,0,0,0,0,0,0,0,0,0,0,0,0,0,430,4,0,0,0,0,0,0,0,0,0,1,100,NoArch
070c430b72098481e544052d1dc116a624dbcce8,0,0,0,0,0,0,0,0,0,0,0,0,0,0,0,431,4,0,0,0,0,0,0,0,0,0,1,100,NoArch
cc7ec43e22f65fdea2bec9be04832f194c9bc6b8,2,17,0,17,17,0,0,0,64,385,1,2,0.322756959,1745,5,18,1,315,312,3,12276,12148,128,130,128,2,1,100,NoArch
b723741bfd071077c50d998131af1417c4371c26,0,0,0,0,0,0,0,0,0,0,0,0,0,0,0,96,0,0,0,0,0,0,0,0,0,0,1,100,NoArch
010091fc66a92292525c18713117a673bee14831,0,0,0,0,0,0,0,0,0,0,0,0,0,0,0,97,1,0,0,0,0,0,0,0,0,0,1,100,NoArch
289ea57aa60c151f4fd2eb59c73b8d81c141d2b8,2,15,4,11,19,0,0,0,79,173,1,2,0.981940787,2557,6,432,0,515,514,1,16129,16075,54,250,249,1,1,100,NoArch
ce9888491b24b295865940ec68a21a43b0bca467,0,0,0,0,0,0,0,0,0,0,0,0,0,0,0,433,1,0,0,0,0,0,0,0,0,0,0,100,NoArch
11a18d9b686d98f7731904584ed8a809cd86dea8,3,91,4,87,95,0,0,0,26,1427,1,3,1.181532551,960,4,434,2,177,161,16,5182,4706,476,36,31,5,1,100,NoArch
b67cea15443e22db2e57c30dfdc5da2697e5ecb5,0,0,0,0,0,0,0,0,0,0,0,0,0,0,0,4,0,0,0,0,0,0,0,0,0,0,1,100,NoArch
3e997c3b63fd10ec27b1bc0061e14881da5e4dab,0,0,0,0,0,0,0,0,0,0,0,0,0,0,0,5,1,0,0,0,0,0,0,0,0,0,1,100,NoArch
175a67d10cabb1672d4c966182432dec62e8d288,4,74,6,68,80,0,0,0,65,599,1,2,1.385907251,1959,5,435,3,348,336,12,13387,13049,338,152,148,4,1,99.40452561,NoArch
f406cb4693a95842ae99bea8d9971513ea975b27,1,18,0,18,18,0,0,0,2,73,1,1,0,20,2,436,4,0,0,0,24,24,0,0,0,0,1,100,NoArch
f3e482fd2339cd697d3eb2136f0d76b7b602525a,0,0,0,0,0,0,0,0,0,0,0,0,0,0,0,437,5,0,0,0,0,0,0,0,0,0,0,100,NoArch
d5f32e1624696c6a67923595da82d53c1103e6c8,0,0,0,0,0,0,0,0,0,0,0,0,0,0,0,438,6,0,0,0,0,0,0,0,0,0,0,100,NoArch
082fb97eb5d1c29b12e41115e45be357553afc8e,0,0,0,0,0,0,0,0,0,0,0,0,0,0,0,0,0,0,0,0,0,0,0,0,0,0,1,100,NoArch
0478e9cea93142e1ec0eefb9e0d7d19962a8bf0f,0,0,0,0,0,0,0,0,0,0,0,0,0,0,0,98,0,0,0,0,0,0,0,0,0,0,0,100,NoArch
1de668f8390edef0ee135b1c02c490a40e1a165e,0,0,0,0,0,0,0,0,0,0,0,0,0,0,0,439,4,0,0,0,0,0,0,0,0,0,1,100,NoArch
2cf39f749f0e58e0a48754d71bdb106540b4ca86,0,0,0,0,0,0,0,0,0,0,0,0,0,0,0,440,1,0,0,0,0,0,0,0,0,0,0,100,NoArch
def5dab27dbd1f17f9124df5845f469b5c7a8aa0,0,0,0,0,0,0,0,0,0,0,0,0,0,0,0,441,2,0,0,0,0,0,0,0,0,0,0,100,NoArch
06d463b1a119c5d8bc4347fa9e280f4096551080,2,5,3,2,8,0,0,0,69,354,1,2,0.954434003,1444,4,441,2,333,333,0,9683,9663,20,113,112,1,1,100,NoArch
f457317854f7111a8209111a9f573dae46704660,0,0,0,0,0,0,0,0,0,0,0,0,0,0,0,443,4,0,0,0,0,0,0,0,0,0,0,100,NoArch
b1e93f10a08ab95e79913580441f8a63c72dcc20,0,0,0,0,0,0,0,0,0,0,0,0,0,0,0,444,5,0,0,0,0,0,0,0,0,0,0,100,NoArch
f457317854f7111a8209111a9f573dae46704660,2,5,3,2,8,0,0,0,69,354,1,2,0.954434003,1446,4,443,4,333,333,0,9683,9663,20,113,112,1,0,100,NoArch
d9f748e1469e5a37f1369270722f8b0d12376264,0,0,0,0,0,0,0,0,0,0,0,0,0,0,0,442,3,0,0,0,0,0,0,0,0,0,0,100,NoArch
0d577247ca54ca9f180d2902c5ce6cf182b67904,2,67,4,63,71,0,0,0,4,1699,1,2,0.417864262,559,2,19,0,56,55,1,3202,2704,498,37,36,1,1,100,NoArch
b8dec14716b112a07ffba2df39cee9da1ee08725,2,37,0,37,37,0,0,0,70,50,1,2,0.179256067,1448,4,443,1,335,333,2,10025,9683,342,114,113,1,1,100,NoArch
0781e9f27d2f92af283e2033e4284ea18b3794a2,0,0,0,0,0,0,0,0,0,0,0,0,0,0,0,444,2,0,0,0,0,0,0,0,0,0,0,100,NoArch
2a618069759cb7c68e3204edf3de28821721ffee,0,0,0,0,0,0,0,0,0,0,0,0,0,0,0,445,3,0,0,0,0,0,0,0,0,0,0,100,NoArch
919ace25804400a6b14d42dc60f5685578b5fcb9,0,0,0,0,0,0,0,0,0,0,0,0,0,0,0,446,4,0,0,0,0,0,0,0,0,0,1,100,NoArch
d3e984ec25fb0c0a99cd080fa4320cbe3432ee6c,0,0,0,0,0,0,0,0,0,0,0,0,0,0,0,447,0,0,0,0,0,0,0,0,0,0,0,100,NoArch
aad41f750d1332d6a90ad52a70ba2791bd74969a,2,32,15,17,47,0,0,0,14,800,1,2,0.983939395,329,5,448,1,30,27,3,1918,1807,111,22,19,3,1,100,NoArch
7aa6d34cf9f0bee928a2fcb69003fb579de67b25,0,0,0,0,0,0,0,0,0,0,0,0,0,0,0,20,0,0,0,0,0,0,0,0,0,0,1,100,NoArch
884c3fcbc57cc5d8afff87dccd4caf87ce478aed,22,2851,1080,1771,3931,0,0,0,12,1718,1,6,2.039779618,8521,1,449,1,1700,1533,167,54888,47823,7065,791,713,78,1,100,NoArch
7c0f04e97f6b324ce2447afc4f05665bf83762a8,2,104,0,104,104,1,0,1,66,121,1,2,0.278171008,729,1,450,2,186,181,5,5869,5287,582,46,42,4,1,99.92119779,NoArch
fdb45a7968cc0ba7f57bc5fa97777995dc946820,4,28,12,16,40,0,0,0,12,1199,1,4,1.712887622,923,1,451,3,147,144,3,5219,5124,95,88,88,0,1,100,NoArch
fb28910e926f1c442b90e650c3bd9e6ecfb80a79,3,198,6,192,204,0,0,0,27,326,1,3,1.448394189,684,1,452,3,147,132,15,4948,3871,1077,30,22,8,1,99.49592865,NoArch
4eec345521b9b7ec5a27e4f495a2e9a5b7d09efc,6,81,6,75,87,0,0,0,71,1182,1,4,1.98988298,2802,3,453,4,457,452,5,18548,18074,474,204,200,4,1,100,NoArch
f71e0cd28d1ebc039ec57cd303ba30e190e72dce,13,418,34,384,452,2,0,2,59,1286,1,7,2.865565594,2430,1,454,5,536,475,61,16144,13678,2466,256,210,46,1,88.9827856,Arch
f426a75e9c8dc48fdc4901224313edbb9c4739a1,2,129,26,103,155,1,0,1,25,894,1,2,0.996363935,178,1,455,6,42,25,17,1464,981,483,20,16,4,1,95.59112609,Arch
5af5e3992a6a58dcb3e52969e4e2b5d903a076c3,11,489,69,420,558,1,0,1,10,2553,1,4,2.893098107,1134,1,456,4,147,110,37,7730,5501,2229,67,62,5,1,88.8580354,Arch
4a78a2da6a4d648d62249a9de048c419084320c0,0,0,0,0,0,0,0,0,0,0,0,0,0,0,0,457,5,0,0,0,0,0,0,0,0,0,1,100,NoArch
2cfab13bb3cb9474745f1b34afeaed103def2999,1,5,2,3,7,0,0,0,10,428,1,1,0,262,2,21,0,54,54,0,1730,1712,18,19,19,0,1,100,NoArch
c915fb13a26bd885200591148af91fe483d8723b,0,0,0,0,0,0,0,0,0,0,0,0,0,0,0,458,0,0,0,0,0,0,0,0,0,0,1,100,NoArch
4f6eb207b1df2ff438d952e383041021f0275705,0,0,0,0,0,0,0,0,0,0,0,0,0,0,0,459,1,0,0,0,0,0,0,0,0,0,1,100,NoArch
3b8740860e33fa1b28609901b5e1bd554b11b090,1,13,4,9,17,0,0,0,12,95,1,1,0,74,4,22,1,11,9,2,380,340,40,8,6,2,1,100,NoArch
535f6efca296d80f01e1bad2050b1bdc453f4800,1,25,8,17,33,0,0,0,8,95,1,1,0,155,1,460,2,19,20,1,927,815,112,14,15,1,1,90.53414469,Arch
97165abbb62a558fe498c33999c34a73a35b6bd8,0,0,0,0,0,0,0,0,0,0,0,0,0,0,0,461,3,0,0,0,0,0,0,0,0,0,1,100,NoArch
d84eef25161d31bcc69829810e7c00e730f45935,1,34,38,4,72,0,0,0,8,3073,1,1,0,187,5,462,4,16,20,4,1107,1158,51,5,4,1,1,100,NoArch
4210b05960b6657b4f0ca98f97c49649e1de7139,3,26,14,12,40,0,0,0,60,105,1,3,1.493469276,1321,3,463,5,284,282,2,7567,7485,82,84,83,1,1,100,NoArch
77e7fa0274b85742937026b95a839590368d2879,2,35,4,31,39,0,0,0,2,2000,1,2,0.619382195,188,1,464,6,24,21,3,1074,888,186,12,10,2,1,99.09356725,NoArch
5b9b847fa099d2476ba497ad971ac36495add960,23,0,4138,4138,4138,0,23,23,10,3827,1,2,4.207378222,4138,4,465,5,0,382,382,0,20842,20842,0,168,168,1,95.34487653,Arch
3bb62d24aa90230d17da5ab612042799f5c2d7c9,2,98,1,97,99,1,0,1,18,581,1,2,0.14257333,375,1,23,1,67,64,3,2358,1757,601,36,34,2,1,99.94617869,NoArch
5cc99503deea276eabfb9deb8c88fd1f01f5ebad,4,502,0,502,502,2,0,2,25,350,1,3,1.024934575,483,1,24,2,137,74,63,5355,2302,3053,63,38,25,1,96.49565461,Arch
f66a7875b8b904e21e0f0e40a418627ea98d9ce7,15,496,42,454,538,2,0,2,80,1348,1,11,2.812294511,6150,4,25,3,945,872,73,40130,37580,2550,425,402,23,1,99.85350132,NoArch
ad27ed0d9430ea9b944ad6e70138a355aebe10e0,3,135,35,100,170,0,0,0,11,266,1,3,0.381580488,2277,1,466,1,578,549,29,15095,14441,654,144,139,5,1,100,NoArch
fbaf3c399e2f34e57008d8625c76f0543a3cadf4,2,94,0,94,94,1,0,1,16,749,1,2,0.550984443,639,1,467,2,80,72,8,2908,2586,322,35,33,2,1,96.64516129,Arch
5009caa85de9f61c3d8144713c5fecd0331eee61,2,72,2,70,74,0,0,0,67,194,1,2,0.821812731,833,1,468,3,190,186,4,6240,5869,371,47,46,1,1,99.85627021,NoArch
d2cd7b84dccb647c9637074986edc0baec70e50d,0,0,0,0,0,0,0,0,0,0,0,0,0,0,0,26,0,0,0,0,0,0,0,0,0,0,1,100,NoArch
6501dd51fc3a910a4cdc3e5abc73f49ed47240bc,4,68,0,68,68,0,0,0,2,99,1,3,2,519,2,27,1,68,68,0,4103,4103,0,22,22,0,1,100,NoArch
71c29bdef8fb3c43ecbf1c5ddae8a10f6f38d830,2,144,58,86,202,0,0,0,14,218,1,2,1,644,1,469,0,120,120,0,4052,4052,0,78,78,0,1,100,NoArch
7d61edb1057f9b3361f142228ec6da2797bc2dec,0,0,0,0,0,0,0,0,0,0,0,0,0,0,0,470,1,0,0,0,0,0,0,0,0,0,1,100,NoArch
34174efd237c8aabdcf8b546d9b1b2bd1e16b01e,5,292,17,275,309,1,0,1,61,48,1,5,1.392842022,1909,1,471,2,413,396,17,12244,10702,1542,164,154,10,1,99.92821249,NoArch
7c0a16b8385c95c3e319de1aca9b7f20c7e61c46,0,0,0,0,0,0,0,0,0,0,0,0,0,0,0,472,3,0,0,0,0,0,0,0,0,0,1,100,NoArch
510a61709411918fc7d4126b46176954189bb85f,2,29,4,25,33,0,0,0,72,224,1,2,0.884963636,1508,4,473,4,337,337,0,10323,10177,146,117,116,1,1,100,NoArch
3fdea9c2021b1491825f45547c62b52d75dc505c,2,150,2,148,152,1,0,1,4,757,1,2,0.464810709,60,1,474,5,17,6,11,1054,225,829,16,6,10,1,86.85208597,Arch
3414ca077b774e98db41d32b69128cd8a7ed12b2,0,0,0,0,0,0,0,0,0,0,0,0,0,0,0,28,2,0,0,0,0,0,0,0,0,0,1,100,NoArch
005c7e0fd6377162a1bd7cc425cb35a23cdf9d52,0,0,0,0,0,0,0,0,0,0,0,0,0,0,0,29,0,0,0,0,0,0,0,0,0,0,1,100,NoArch
56838397367fbe3570e3f361034aec24ba9e0f64,0,0,0,0,0,0,0,0,0,0,0,0,0,0,0,30,1,0,0,0,0,0,0,0,0,0,1,100,NoArch
a34ae84b27d7060fcbd41dd744d047d316ce449e,0,0,0,0,0,0,0,0,0,0,0,0,0,0,0,31,2,0,0,0,0,0,0,0,0,0,1,100,NoArch
a471a726a499081c912d50fe9a6ad722e5fe3b4d,2,21,0,21,21,0,0,0,81,854,1,2,0.998363673,1647,2,475,0,436,433,3,9972,9829,143,185,182,3,1,100,NoArch
6a80468a68de9bd035d5cc21d2ee664e1956c884,1,52,0,52,52,0,0,0,2,142,1,1,0,205,2,32,0,8,7,1,1788,1293,495,7,6,1,1,100,NoArch
2e5acf3e5fd1e6c0f193bea0c2234c09a848f17a,5,662,7,655,669,1,0,1,73,816,1,3,1.065416408,2205,1,0,0,659,569,90,18291,14290,4001,215,163,52,1,99.03258656,NoArch
42abe4f510cafa843d46805662a5b564e13f6aea,0,0,0,0,0,0,0,0,0,0,0,0,0,0,0,1,0,0,0,0,0,0,0,0,0,0,1,100,NoArch
5a52b4b8c9201102183ea643307ceae932e5b8f5,0,0,0,0,0,0,0,0,0,0,0,0,0,0,0,2,1,0,0,0,0,0,0,0,0,0,1,100,NoArch
630562a0b16ae73c8cb8d85da723bca6b28de6db,1,2,4,2,6,0,0,0,82,228,1,1,0,1590,7,3,2,432,432,0,9465,9478,13,182,182,0,1,100,NoArch
60d9ef0ad24d91735210830b2481e884ec45c9e7,2,45,2,43,47,0,0,0,83,164,1,2,0.997059057,1666,3,4,0,442,436,6,10241,9959,282,190,185,5,1,100,NoArch
eb31746cd5efd5e2c9c57780a651afaccd5cfe06,13,2180,22,2158,2202,7,0,7,84,206,1,6,2.992199706,4511,1,5,0,1425,1144,281,40725,27497,13228,545,407,138,1,89.13443831,Arch
ab938b84b2cd305eef3fbd238edf78945bd043e9,2,108,5,103,113,1,0,1,34,892,1,2,0.711180663,468,1,33,0,68,59,9,2565,1951,614,43,37,6,1,99.91582492,NoArch
83cb47e04c057627ac839a16e03972ed7481ca02,0,0,0,0,0,0,0,0,0,0,0,0,0,0,0,34,1,0,0,0,0,0,0,0,0,0,1,100,NoArch
1e1b379463d0dbe1d2e0d162586dcebceb6af1e6,0,0,0,0,0,0,0,0,0,0,0,0,0,0,0,6,0,0,0,0,0,0,0,0,0,0,1,100,NoArch
b81761e72307bfc62843c0b207a4712aa2d9c9c0,4,96,22,74,118,0,0,0,31,1266,1,4,1.344852003,2017,2,35,2,271,270,1,13551,13522,29,155,155,0,1,100,NoArch
4f7013b1465959d6c17e21c969dcb90b5a0d6a25,1,6,6,0,12,0,0,0,4,693,1,1,0,608,2,36,3,23,23,0,3407,3407,0,20,20,0,1,100,NoArch
f2d7c194ddd2734e567e77b9810ffb44ed65d6bd,0,0,0,0,0,0,0,0,0,0,0,0,0,0,0,37,4,0,0,0,0,0,0,0,0,0,1,100,NoArch
c5fe80507610fcf24e53516365cd7c2efb2291dd,0,0,0,0,0,0,0,0,0,0,0,0,0,0,0,38,5,0,0,0,0,0,0,0,0,0,1,100,NoArch
ba10e8bf61efbceaad0a8f95ba73c659f678bc1e,0,0,0,0,0,0,0,0,0,0,0,0,0,0,0,39,6,0,0,0,0,0,0,0,0,0,0,100,NoArch
9e9f0e86e00ba71f501ac2c8b09f98f8e3f9365e,0,0,0,0,0,0,0,0,0,0,0,0,0,0,0,40,7,0,0,0,0,0,0,0,0,0,1,100,NoArch
d3f854449e540cd2f34a0a96df15d379d8c1d525,0,0,0,0,0,0,0,0,0,0,0,0,0,0,0,41,8,0,0,0,0,0,0,0,0,0,1,100,NoArch
a6743849b29b67f5013bf9b917daf70b19810929,0,0,0,0,0,0,0,0,0,0,0,0,0,0,0,42,9,0,0,0,0,0,0,0,0,0,1,100,NoArch
dfdbb60a8d9f97b43db981b6ee08f434a288111a,3,493,5,488,498,2,0,2,2,43,1,3,1.5302269,218,1,7,1,100,44,56,3835,1045,2790,62,18,44,1,99.79018044,NoArch
c4c3739dedd51a6fe02731adc617b30d3f4bbd80,0,0,0,0,0,0,0,0,0,0,0,0,0,0,0,43,7,0,0,0,0,0,0,0,0,0,1,100,NoArch
74b444929bfdbdd0bcdf45a80dec7b507f805428,0,0,0,0,0,0,0,0,0,0,0,0,0,0,0,44,8,0,0,0,0,0,0,0,0,0,1,100,NoArch
e12bdb0bee1e298c5a2ab352e1b2ac3dac6448fa,5,447,29,418,476,1,0,1,75,116,1,3,0.826249921,2605,1,45,9,702,660,42,19083,16804,2279,222,190,32,1,99.79079498,NoArch
96c95a93cc5cc4c4fc19ea16edb926ffb4625156,0,0,0,0,0,0,0,0,0,0,0,0,0,0,0,46,10,0,0,0,0,0,0,0,0,0,1,100,NoArch
7fcfcf12648d322728da549a56994607baf989ae,0,0,0,0,0,0,0,0,0,0,0,0,0,0,0,47,11,0,0,0,0,0,0,0,0,0,1,100,NoArch
fe306bf207ab4fd290893651a9c92caae611aff3,0,0,0,0,0,0,0,0,0,0,0,0,0,0,0,48,12,0,0,0,0,0,0,0,0,0,1,100,NoArch
4de802425783c8abbb97a0574741670cab776dff,0,0,0,0,0,0,0,0,0,0,0,0,0,0,0,49,13,0,0,0,0,0,0,0,0,0,1,100,NoArch
90d02b4bfa2154ba71a8a05b6c2661cf792d062d,0,0,0,0,0,0,0,0,0,0,0,0,0,0,0,50,14,0,0,0,0,0,0,0,0,0,1,100,NoArch
65841fc8967c4599e29b99dafe8c8f7272b7a4c2,0,0,0,0,0,0,0,0,0,0,0,0,0,0,0,51,15,0,0,0,0,0,0,0,0,0,0,100,NoArch
2c76eb516ccff61f29ea4efd15cff44c7832fd33,10,180,0,180,180,0,0,0,3,87,1,6,3.321928095,2753,2,52,16,299,299,0,16134,16134,0,201,201,0,0,100,NoArch
946e96680764095588e5a3e40e97a821b5fb9038,0,0,0,0,0,0,0,0,0,0,0,0,0,0,0,53,17,0,0,0,0,0,0,0,0,0,1,100,NoArch
bc657e4d93166b6d5c2cdc587aaeca17760099a6,0,0,0,0,0,0,0,0,0,0,0,0,0,0,0,54,18,0,0,0,0,0,0,0,0,0,1,100,NoArch
8570a93e1f6ebc14bc3c78692256122b9ba2c1ea,0,0,0,0,0,0,0,0,0,0,0,0,0,0,0,55,19,0,0,0,0,0,0,0,0,0,0,100,NoArch
82ee5b448983f5074e513c053258c6ed23c8701b,0,0,0,0,0,0,0,0,0,0,0,0,0,0,0,8,0,0,0,0,0,0,0,0,0,0,1,100,NoArch
e90092bce9d3e9436475dc61521e0cd019831a67,0,0,0,0,0,0,0,0,0,0,0,0,0,0,0,56,0,0,0,0,0,0,0,0,0,0,0,100,NoArch
a42a522f34f910961f92ca9145e58647aded8c83,0,0,0,0,0,0,0,0,0,0,0,0,0,0,0,57,1,0,0,0,0,0,0,0,0,0,0,100,NoArch
72846f1daeadda01b3af29f922dc6f840b224b0e,0,0,0,0,0,0,0,0,0,0,0,0,0,0,0,57,1,0,0,0,0,0,0,0,0,0,0,100,NoArch
31a057f5d3db73b196e2bd70ca3ee58015c3e156,0,0,0,0,0,0,0,0,0,0,0,0,0,0,0,58,2,0,0,0,0,0,0,0,0,0,0,100,NoArch
0c771b9a62b93055b93d8426c283be5ab87c212c,0,0,0,0,0,0,0,0,0,0,0,0,0,0,0,59,3,0,0,0,0,0,0,0,0,0,0,100,NoArch
248c4bfefdc5fcc6966910ff2bf0b91d9c4da4ac,0,0,0,0,0,0,0,0,0,0,0,0,0,0,0,58,2,0,0,0,0,0,0,0,0,0,0,100,NoArch
710a001a1b41d465db7a300bfcc03040fcef03b3,2,13,2,11,15,0,0,0,76,498,1,2,0.721928095,1300,4,59,0,321,320,1,8090,7937,153,104,103,1,1,100,NoArch
fe9330e56d2d6d356344d5152ca8b4ff3b52b89c,0,0,0,0,0,0,0,0,0,0,0,0,0,0,0,60,0,0,0,0,0,0,0,0,0,0,1,100,NoArch
069f00e0e849775a93c08a74e48fc10b34566d02,0,0,0,0,0,0,0,0,0,0,0,0,0,0,0,9,0,0,0,0,0,0,0,0,0,0,1,100,NoArch
4fdc75209ba54f60b2c5798cff731a11053fbcfd,0,0,0,0,0,0,0,0,0,0,0,0,0,0,0,10,1,0,0,0,0,0,0,0,0,0,1,100,NoArch
4686716c4ef7bb139a371d1de881ad1aaf93a144,0,0,0,0,0,0,0,0,0,0,0,0,0,0,0,0,0,0,0,0,0,0,0,0,0,0,1,100,NoArch
782a9505e82028be7a087ac269e0a30c32ee3258,0,0,0,0,0,0,0,0,0,0,0,0,0,0,0,0,0,0,0,0,0,0,0,0,0,0,1,100,NoArch
e0096f2f9d0036e02f16eb0b111fd68470758351,0,0,0,0,0,0,0,0,0,0,0,0,0,0,0,1,1,0,0,0,0,0,0,0,0,0,1,100,NoArch
d94b460db57b5b7f0c981fbcc5794057c6680aaa,0,0,0,0,0,0,0,0,0,0,0,0,0,0,0,1,1,0,0,0,0,0,0,0,0,0,1,100,NoArch
0f5758b2d0f75c8234443e72c43d2fd38fe1894d,0,0,0,0,0,0,0,0,0,0,0,0,0,0,0,11,0,0,0,0,0,0,0,0,0,0,1,100,NoArch
4707d9abe1202c7266aa8d58711fd22907863cbd,6,24,6,18,30,0,0,0,85,1169,1,2,2.031729149,2295,5,12,1,500,499,1,12895,12877,18,215,214,1,1,100,NoArch
bc19e3a12e033e60c4f5c6c1d7a20fc9f8182da6,0,0,0,0,0,0,0,0,0,0,0,0,0,0,0,13,2,0,0,0,0,0,0,0,0,0,1,100,NoArch
5cb83db6a66a6d60aa01b41160a9c90ad4987736,0,0,0,0,0,0,0,0,0,0,0,0,0,0,0,14,3,0,0,0,0,0,0,0,0,0,1,100,NoArch
3585c45902b99ae5cf5e3086d1dfc61389017d7f,0,0,0,0,0,0,0,0,0,0,0,0,0,0,0,15,4,0,0,0,0,0,0,0,0,0,1,100,NoArch
bdc98484730275bebcc4f22d6e3ffd9f97616920,0,0,0,0,0,0,0,0,0,0,0,0,0,0,0,60,0,0,0,0,0,0,0,0,0,0,1,100,NoArch
ed6a4e1f2aad7cea85bd956165fb7f66277533ea,6,6,24,18,30,0,0,0,84,712,1,2,2.031729149,2313,4,61,0,499,500,1,12877,12895,18,214,215,1,1,100,NoArch
5662cbbffa89fb8d363ccbee03fe85980e17ba15,6,24,6,18,30,0,0,0,85,1169,1,2,2.031729149,2295,5,99,0,500,499,1,12895,12877,18,215,214,1,1,100,NoArch
df5c513f1e7a606b7333975b6d28784702f77077,0,0,0,0,0,0,0,0,0,0,0,0,0,0,0,16,0,0,0,0,0,0,0,0,0,0,1,100,NoArch
96d2d35fa20a7ec14f699e0c899cc7e21ae3393b,0,0,0,0,0,0,0,0,0,0,0,0,0,0,0,17,1,0,0,0,0,0,0,0,0,0,1,100,NoArch
ada69ac5e0be21c96cdc683ae5152b0a8216e14f,0,0,0,0,0,0,0,0,0,0,0,0,0,0,0,18,2,0,0,0,0,0,0,0,0,0,1,100,NoArch
e11c588ebe034d5f2a043598e600791e38e124bb,0,0,0,0,0,0,0,0,0,0,0,0,0,0,0,19,3,0,0,0,0,0,0,0,0,0,1,100,NoArch
2c6c570d3b66975cfac367334d8a6971801397e5,0,0,0,0,0,0,0,0,0,0,0,0,0,0,0,20,4,0,0,0,0,0,0,0,0,0,1,100,NoArch
f49b2d31fd9a0249a64c049da800db6648792ee0,10,156,5,151,161,0,0,0,17,2213,2,6,3.310856643,1547,2,21,5,210,210,0,8814,8814,0,137,137,0,1,100,NoArch
bf751dfaada53680f66bc200f3acb04a4d538fd1,4,0,64,64,64,0,0,0,18,0,1,2,2,898,2,22,6,122,122,0,4244,4244,0,80,80,0,1,100,NoArch
2863a185ee8c6a036ce811e1ecd80eefd7f54401,0,0,0,0,0,0,0,0,0,0,0,0,0,0,0,23,7,0,0,0,0,0,0,0,0,0,1,100,NoArch
02418de9dee7b330552d43183109efa0b50ddf1f,0,0,0,0,0,0,0,0,0,0,0,0,0,0,0,24,8,0,0,0,0,0,0,0,0,0,1,100,NoArch
80ba788ecdccaff5fbc011f6ad619bb62815dc04,0,0,0,0,0,0,0,0,0,0,0,0,0,0,0,25,9,0,0,0,0,0,0,0,0,0,1,100,NoArch
273106bd1186680c54c8101e75e0e7a8a0d83fd1,0,0,0,0,0,0,0,0,0,0,0,0,0,0,0,26,10,0,0,0,0,0,0,0,0,0,1,100,NoArch
4590538073b1b9cb8d4d471e082cfcfc3e1940ff,2,15,3,12,18,0,0,0,77,710,1,2,0.918295834,1631,5,27,11,352,351,1,10939,10845,94,124,122,2,1,100,NoArch
ee28a20bef542d693312a3fc39239eee33800879,0,0,0,0,0,0,0,0,0,0,0,0,0,0,0,28,12,0,0,0,0,0,0,0,0,0,1,100,NoArch
1ccb4c22c1723d8137c3fa21dc16252af593d76c,0,0,0,0,0,0,0,0,0,0,0,0,0,0,0,29,13,0,0,0,0,0,0,0,0,0,0,100,NoArch
8c30a2d55d841e3da32554b01850fb40aeff9c0f,0,0,0,0,0,0,0,0,0,0,0,0,0,0,0,30,14,0,0,0,0,0,0,0,0,0,0,100,NoArch
b1c5555a70e296c7ea2768c9b6a4adc135ced3bc,0,0,0,0,0,0,0,0,0,0,0,0,0,0,0,31,15,0,0,0,0,0,0,0,0,0,0,100,NoArch
eff0765112207fb19c9d2efd0a14077822a7df0a,0,0,0,0,0,0,0,0,0,0,0,0,0,0,0,66,0,0,0,0,0,0,0,0,0,0,0,100,NoArch
561671b051f565418d4989a1bbed357c8e9a3871,0,0,0,0,0,0,0,0,0,0,0,0,0,0,0,67,1,0,0,0,0,0,0,0,0,0,0,100,NoArch
ab8a15ac2b6685264d88d2c7aaa48d16907ecd17,0,0,0,0,0,0,0,0,0,0,0,0,0,0,0,6,0,0,0,0,0,0,0,0,0,0,1,100,NoArch
37d9f0ca38ccdf1c51ecacf9d679a506d359e2be,0,0,0,0,0,0,0,0,0,0,0,0,0,0,0,7,1,0,0,0,0,0,0,0,0,0,1,100,NoArch
9d5ae9919dfdd8d634704ae47c22c2b43662f7e6,0,0,0,0,0,0,0,0,0,0,0,0,0,0,0,8,2,0,0,0,0,0,0,0,0,0,1,100,NoArch
a8a39c2900559bf2c3f59282f62e7b13603408db,0,0,0,0,0,0,0,0,0,0,0,0,0,0,0,68,0,0,0,0,0,0,0,0,0,0,1,100,NoArch
059e6dff3b0f6ccec866f7061815766f43d7ce22,0,0,0,0,0,0,0,0,0,0,0,0,0,0,0,69,1,0,0,0,0,0,0,0,0,0,1,100,NoArch
7a282100438736e70e0361b94891b5b59157d62f,0,0,0,0,0,0,0,0,0,0,0,0,0,0,0,70,2,0,0,0,0,0,0,0,0,0,1,100,NoArch
faf5af028c53802f30f0d8995d03f8afa1d0ea5c,0,0,0,0,0,0,0,0,0,0,0,0,0,0,0,9,3,0,0,0,0,0,0,0,0,0,1,100,NoArch
bc7091cad925828bfb18c5c282394194e30e2901,0,0,0,0,0,0,0,0,0,0,0,0,0,0,0,71,3,0,0,0,0,0,0,0,0,0,1,100,NoArch
c42c40f728c338b4c144c5cbd431e0513dabf7fe,1,14,1,13,15,0,0,0,26,1265,1,1,0,109,5,72,4,13,10,3,638,550,88,5,4,1,1,100,NoArch
a7a547cb8a3b7bb16531ef956b81c663c197fe75,0,0,0,0,0,0,0,0,0,0,0,0,0,0,0,10,1,0,0,0,0,0,0,0,0,0,1,100,NoArch
edd9f5557b344be58b03ed01c3588734c793ac46,2,38,5,33,43,1,0,1,6,913,1,2,0.854180205,364,5,73,5,69,69,0,1650,1591,59,33,33,0,1,90.995671,Arch
c1be0a192c21792df5d167fbb87eaf2a3f8c0672,1,3,3,0,6,0,0,0,78,103,1,1,0,1145,8,74,6,311,311,0,7013,7018,5,95,95,0,1,100,NoArch
9330bcbcf3d91cf72a32ba3c251c634a0f2b9a2b,0,0,0,0,0,0,0,0,0,0,0,0,0,0,0,11,2,0,0,0,0,0,0,0,0,0,1,100,NoArch
a38ca8957c021e8dc532132652c2fb289d8e1d6a,0,0,0,0,0,0,0,0,0,0,0,0,0,0,0,12,3,0,0,0,0,0,0,0,0,0,1,100,NoArch
e810734de79c0be44e2038bede4129189fe68648,0,0,0,0,0,0,0,0,0,0,0,0,0,0,0,13,4,0,0,0,0,0,0,0,0,0,1,100,NoArch
162aa95c11c935a43f2e2130ca3e28279b3ce6fa,0,0,0,0,0,0,0,0,0,0,0,0,0,0,0,14,5,0,0,0,0,0,0,0,0,0,1,100,NoArch
2d192b499d04ff42afb10d06ea178543bc978077,1,1,16,15,17,0,0,0,5,21,1,1,0,366,2,75,4,68,69,1,1526,1617,91,33,33,0,1,100,NoArch
adfe620a98d4b0cd7baec266d58ad886a13a3663,0,0,0,0,0,0,0,0,0,0,0,0,0,0,0,76,5,0,0,0,0,0,0,0,0,0,0,100,NoArch
1c648145f37ccfa331c7790663c005858d35627c,0,0,0,0,0,0,0,0,0,0,0,0,0,0,0,15,6,0,0,0,0,0,0,0,0,0,1,100,NoArch
f896e3381ed648eeca4b90930659e3855d5a097a,0,0,0,0,0,0,0,0,0,0,0,0,0,0,0,77,6,0,0,0,0,0,0,0,0,0,0,100,NoArch
318cbcdf0e314b52950a5a9e93bda97fe307a7a2,0,0,0,0,0,0,0,0,0,0,0,0,0,0,0,78,7,0,0,0,0,0,0,0,0,0,0,100,NoArch
85c9b5f628d16da82e84cfd89c68bbe8942f2ca5,0,0,0,0,0,0,0,0,0,0,0,0,0,0,0,78,7,0,0,0,0,0,0,0,0,0,0,100,NoArch
674b67670758ffa3aa7cc19c83d46720d35bd029,0,0,0,0,0,0,0,0,0,0,0,0,0,0,0,80,9,0,0,0,0,0,0,0,0,0,0,100,NoArch
b2f47a1f498fc758d05a9159fd2a3cb5092e8cd1,0,0,0,0,0,0,0,0,0,0,0,0,0,0,0,81,7,0,0,0,0,0,0,0,0,0,0,100,NoArch
8a3960ab1cdd9d575a7f5863f8e85f8bebd0419d,0,0,0,0,0,0,0,0,0,0,0,0,0,0,0,0,0,0,0,0,0,0,0,0,0,0,1,100,NoArch
133fafacdd6e39d68d14e2f903e2a49c6d6aad16,0,0,0,0,0,0,0,0,0,0,0,0,0,0,0,1,1,0,0,0,0,0,0,0,0,0,1,100,NoArch
ec9e1e14b3137324b3201c0a439a91253fa64c9d,2,26,4,22,30,0,0,0,86,2623,1,2,0.881290899,1742,2,0,0,456,453,3,10507,10322,185,200,197,3,1,100,NoArch
1bc650dd6dbe7e87c59553e13f037481ee50abb6,2,4,2,2,6,0,0,0,79,403,1,2,0.918295834,1641,5,32,0,352,352,0,10957,10934,23,124,124,0,1,100,NoArch
cb3e24b5bb3ec9049a0e7258003e09f1bddfad6f,2,90,1,89,91,1,0,1,20,1058,1,2,0.670856159,627,1,33,1,99,88,11,3143,2757,386,64,61,3,1,100,NoArch
9d3bcfa2f7a39ec6136baab18286a3d6006e4df7,0,0,0,0,0,0,0,0,0,0,0,0,0,0,0,34,2,0,0,0,0,0,0,0,0,0,1,100,NoArch
6dbaf6af9bd32fa31dfefdde199f16d9892127ee,0,0,0,0,0,0,0,0,0,0,0,0,0,0,0,100,0,0,0,0,0,0,0,0,0,0,1,100,NoArch
7251072c317cea12cb4bf6056d7149d82516db73,0,0,0,0,0,0,0,0,0,0,0,0,0,0,0,101,1,0,0,0,0,0,0,0,0,0,1,100,NoArch
60450656cb3bdddb73a322d24be27aeb854738b8,0,0,0,0,0,0,0,0,0,0,0,0,0,0,0,102,2,0,0,0,0,0,0,0,0,0,1,100,NoArch
ec8a091819a25bccf03adc868449f57f9c076d19,2,41,4,37,45,1,0,1,71,458,1,2,0.764204507,903,1,35,3,220,218,2,6482,6245,237,51,50,1,1,91.01123596,Arch
44ce5eb8a2180409237c81b9a53b64708262a690,1,1,1,0,2,0,0,0,20,1632,1,1,0,378,6,36,4,65,65,0,1769,1767,2,35,35,0,1,100,NoArch
ce64ff7ba8f51a8f54c910407b89cb99b12f79df,1,0,2,2,2,0,0,0,72,0,1,1,0,905,6,37,5,218,218,0,6255,6277,22,50,50,0,1,91.10535406,Arch
039272b89c6f08f1bd56721ead3d79618b70f797,2,155,2,153,157,0,0,0,62,1959,1,2,0.945191769,1063,2,0,0,222,204,18,6525,5658,867,76,66,10,1,99.82078853,NoArch
f10aacc3f646d4609d56aa632d091b55fa491dcc,0,0,0,0,0,0,0,0,0,0,0,0,0,0,0,0,0,0,0,0,0,0,0,0,0,0,1,100,NoArch
29f509f91b4b7687f9abe239f731011a74c04835,0,0,0,0,0,0,0,0,0,0,0,0,0,0,0,1,1,0,0,0,0,0,0,0,0,0,1,100,NoArch
b010898beeaa1d3203634a3acf7bfad15a7b5789,1,18,0,18,18,0,0,0,2,0,1,1,0,35,1,38,6,2,2,0,205,205,0,1,1,0,1,100,NoArch
d1c85231fc0d42aeb63c575707450e0b2fd0e237,3,49,11,38,60,0,0,0,87,2300,1,2,1.156676652,2249,3,0,0,567,561,6,13367,13085,282,248,246,2,2,100,NoArch
8826b38b16f8c4aa5a3df33e6dbd8a339093a38d,2,12,0,12,12,0,0,0,17,970,1,2,1,808,3,2,2,120,120,0,4052,4052,0,78,78,0,1,100,NoArch
0ca11231b09cf8b15a361de932e7d6998cc11f3e,2,14,8,6,22,0,0,0,18,0,1,2,1,820,3,3,3,120,120,0,4010,4052,42,78,78,0,1,100,NoArch
27ea8ffb31e53e867083c5090993deab3220bbc7,0,0,0,0,0,0,0,0,0,0,0,0,0,0,0,4,4,0,0,0,0,0,0,0,0,0,1,100,NoArch
ade55151d2afbf18dabeea8f36844051b95febf9,318,3037,3037,0,6074,0,0,0,88,3243,2,60,7.256039695,73665,2,5,5,9832,9832,0,381164,381164,0,4997,4997,0,1,100,NoArch
b9940d798e0cb2db524b5ad6ff3589b15659cfd2,0,0,0,0,0,0,0,0,0,0,0,0,0,0,0,6,6,0,0,0,0,0,0,0,0,0,0,100,NoArch
6de8e985675034fbb3cac4dc8bd3cbed31461b33,2,22,4,18,26,0,0,0,19,0,1,2,0.930586129,765,3,39,7,123,120,3,3768,3646,122,47,46,1,1,87.11683696,Arch
c6b5368af236f2c2e7ae72fb754bea734062364c,0,0,0,0,0,0,0,0,0,0,0,0,0,0,0,40,8,0,0,0,0,0,0,0,0,0,1,100,NoArch
a0663ae2b40baf697fda3936642a5bb95fac3f5d,0,0,0,0,0,0,0,0,0,0,0,0,0,0,0,7,7,0,0,0,0,0,0,0,0,0,1,100,NoArch
2ecd0a547f97da9608e6dbae72f8dc2076dfa2fe,0,0,0,0,0,0,0,0,0,0,0,0,0,0,0,8,8,0,0,0,0,0,0,0,0,0,1,100,NoArch
bd369bafbfcecbfdda8666f5fadc4ddc44a8fcaf,0,0,0,0,0,0,0,0,0,0,0,0,0,0,0,9,9,0,0,0,0,0,0,0,0,0,1,100,NoArch
4f9faeb6c2148c3f79deb822afee969a622ee58e,0,0,0,0,0,0,0,0,0,0,0,0,0,0,0,10,10,0,0,0,0,0,0,0,0,0,1,100,NoArch
85b4313dce7e7a896d9ea1d9869baeebeb05a998,1,2,0,2,2,0,0,0,3,1561,1,1,0,153,2,41,9,48,48,0,1134,1118,16,5,5,0,1,100,NoArch
bb9b589e0ebd7aed7fa477b273881c42409969ac,9,1545,2,1543,1547,3,0,3,64,0,1,5,1.950148742,1749,3,42,10,578,328,250,17930,9332,8598,271,128,143,1,87.87268332,Arch
d2ff5e6ed926233fd0626537e333e87744e181a4,0,0,0,0,0,0,0,0,0,0,0,0,0,0,0,43,11,0,0,0,0,0,0,0,0,0,1,100,NoArch
bf3f0f92116c937d02d54a11361981d667451aab,0,0,0,0,0,0,0,0,0,0,0,0,0,0,0,44,12,0,0,0,0,0,0,0,0,0,1,100,NoArch
eb1c1c6b28e92167a7147a9be1c4091c9ecb41ab,0,0,0,0,0,0,0,0,0,0,0,0,0,0,0,45,13,0,0,0,0,0,0,0,0,0,1,100,NoArch
4806ede8850a1a0511c2fb66abb8dc5bda6787a7,0,0,0,0,0,0,0,0,0,0,0,0,0,0,0,46,14,0,0,0,0,0,0,0,0,0,1,100,NoArch
5f79943cebccada17b8095c580d457c8b2be04dc,0,0,0,0,0,0,0,0,0,0,0,0,0,0,0,47,15,0,0,0,0,0,0,0,0,0,1,100,NoArch
df3f0547cad95f5491c98444c24d03d2086cd091,0,0,0,0,0,0,0,0,0,0,0,0,0,0,0,48,16,0,0,0,0,0,0,0,0,0,1,100,NoArch
ca6c57106d9853fcbf2dadba43ec9a54b7bb85a9,0,0,0,0,0,0,0,0,0,0,0,0,0,0,0,49,17,0,0,0,0,0,0,0,0,0,1,100,NoArch
ff5bb456e751e9128606c6bbffe638e256ee2c1c,15,497,74,423,571,0,0,0,65,309,1,8,3.227672571,4881,3,0,0,876,828,48,27124,24982,2142,379,360,19,1,90.66455696,Arch
941187a2295197d9da2d9a865fda41e621813f4e,2,121,12,109,133,0,0,0,66,86,1,2,0.907942863,1406,4,1,0,249,242,7,8703,7848,855,88,84,4,2,100,NoArch
39481e665620fec527085552c4c71571f5aeb68f,2,87,9,78,96,0,0,0,81,784,1,2,0.946422051,1383,3,476,0,336,325,11,9174,8629,545,113,106,7,1,100,NoArch
628457545e441b888a597b9ea3a283445c738233,1,1,1,0,2,0,0,0,82,0,1,1,0,1165,9,477,1,315,315,0,7122,7120,2,96,96,0,1,100,NoArch
fb7f023daf40c6373dc60db436fe302c70805493,0,0,0,0,0,0,0,0,0,0,0,0,0,0,0,50,0,0,0,0,0,0,0,0,0,0,1,100,NoArch
1fbf64bf84750b8b768f8bcf2800889f9d590588,1,2,1,1,3,0,0,0,4,407,1,1,0,236,3,51,1,55,55,0,1383,1385,2,14,14,0,1,100,NoArch
9d9d5e76c64f168b3d8c91e0afbdbf6dd87b9a7d,13,1250,0,1250,1250,12,0,12,7,68,1,4,3.328008232,31,6,52,2,74,0,74,4425,33,4392,55,0,55,1,98.91122278,NoArch
c80d1eec0229ea733e0ed0f4e7c0c4b90d81f841,6,202,7,195,209,1,0,1,20,361,1,4,2.100465504,2671,4,53,3,412,399,13,16045,14939,1106,254,241,13,1,89.30369128,Arch
40388e5c9c9cb7b3dd567eff97b28e1278c7fcdb,0,0,0,0,0,0,0,0,0,0,0,0,0,0,0,0,0,0,0,0,0,0,0,0,0,0,1,100,NoArch
391dc158b76ca509c40fce262bfc8377eee6d2bf,0,0,0,0,0,0,0,0,0,0,0,0,0,0,0,0,0,0,0,0,0,0,0,0,0,0,1,100,NoArch
cd760da972d3eb6f9b083f28bab5bd4921509f16,2,23,8,15,31,0,0,0,44,262,1,2,0.708835673,413,7,0,0,101,100,1,2683,2559,124,24,24,0,1,100,NoArch
fa46c9794767d512522824948f3c792dd634b828,2,40,2,38,42,0,0,0,2,0,1,2,0.453716339,431,1,54,4,32,29,3,2598,2322,276,20,17,3,1,100,NoArch
b55036724d220082f54cdb0060b3926314565da4,0,0,0,0,0,0,0,0,0,0,0,0,0,0,0,0,0,0,0,0,0,0,0,0,0,0,1,100,NoArch
1c9ef72b4b7f3b34d16748c7161ec26b193e7299,0,0,0,0,0,0,0,0,0,0,0,0,0,0,0,55,5,0,0,0,0,0,0,0,0,0,1,100,NoArch
988a3790eef104642546fb9bef8a4cae5a148558,0,0,0,0,0,0,0,0,0,0,0,0,0,0,0,0,0,0,0,0,0,0,0,0,0,0,1,100,NoArch
d60d26639a176494c133b5ef45eb77e5737e002b,1,9,3,6,12,0,0,0,67,321,1,1,0,996,10,0,0,212,211,1,5002,4981,21,65,64,1,1,100,NoArch
e1c52301082680a0a729d3aaeb8b3b6bbd96e624,0,0,0,0,0,0,0,0,0,0,0,0,0,0,0,0,0,0,0,0,0,0,0,0,0,0,1,100,NoArch
968550da18708c76fd04c13722d996461aa23cb7,2,26,1,25,27,0,0,0,22,1413,1,2,0.950956048,831,3,56,6,111,107,4,4351,4198,153,76,74,2,1,100,NoArch
79a6d8d81517d45544dba215432f786a9523f76f,2,4,3,1,7,0,0,0,68,262,1,2,0.863120569,1744,6,57,7,245,245,0,11372,11365,7,88,88,0,2,100,NoArch
ba848e21ab275d81b7f33bbcf124efe7f67822bc,0,0,0,0,0,0,0,0,0,0,0,0,0,0,0,58,8,0,0,0,0,0,0,0,0,0,1,100,NoArch
b5d67d41fc6d64558d482f0e6d5b7a699dc62c91,0,0,0,0,0,0,0,0,0,0,0,0,0,0,0,59,9,0,0,0,0,0,0,0,0,0,1,100,NoArch
d5c65e95827ce32ff63e53972787b3f3df7a0788,3,16,10,6,26,0,0,0,21,174,1,3,1.465536041,1263,4,11,0,195,195,0,6775,6671,104,127,127,0,1,100,NoArch
7a15dcdf5252b3b8fc1d1ad440f6080afc06d242,2,34,0,34,34,0,0,0,3,203,1,1,1,325,2,12,1,14,14,0,1868,1868,0,11,11,0,1,100,NoArch
06f4a1220af45bbd1e428450cf278bf6795fb402,4,21,5,16,26,0,0,0,69,0,1,4,0.998952569,2403,5,0,0,378,375,3,13181,13074,107,172,172,0,1,100,NoArch
651decfc442179f72064b35ee6a75b14bf6b2194,0,0,0,0,0,0,0,0,0,0,0,0,0,0,0,478,0,0,0,0,0,0,0,0,0,0,1,100,NoArch
322a0731337b27f45a40b5f28d7afa2b1b844e4b,0,0,0,0,0,0,0,0,0,0,0,0,0,0,0,479,1,0,0,0,0,0,0,0,0,0,1,100,NoArch
97e442c83ab4e4547aaeb2df51d79c9b29fe2e3d,0,0,0,0,0,0,0,0,0,0,0,0,0,0,0,0,0,0,0,0,0,0,0,0,0,0,1,100,NoArch
58c0aac536e2ffbf1d1a0ff2f7855f34b036eedb,0,0,0,0,0,0,0,0,0,0,0,0,0,0,0,480,2,0,0,0,0,0,0,0,0,0,1,100,NoArch
a62613adfd7aac53efd19b07ca30bcda5c0093b2,0,0,0,0,0,0,0,0,0,0,0,0,0,0,0,0,0,0,0,0,0,0,0,0,0,0,1,100,NoArch
aa0ee44822a62fd087fa8cca169dfef4e182af0f,2,74,7,67,81,0,0,0,83,359,1,2,0.825626526,1660,6,13,2,360,356,4,11663,11060,603,126,125,1,1,99.95751912,NoArch
f02db39114cd3b1bd02e87b86812f2c0cafdba86,2,21,1,20,22,0,0,0,89,524,1,2,0.439496987,2349,4,481,3,471,470,1,16782,16581,201,218,217,1,1,100,NoArch
1b91c06e92c4b5dd8e3a3e936b36e54fb9c9e023,2,16,5,11,21,0,0,0,5,2313,1,2,0.958711883,1134,2,482,4,116,114,2,5205,5169,36,41,41,0,1,100,NoArch
69a343b9c37a5410e4f20fd6cf870a68ebf023ce,4,112,1,111,113,1,0,1,23,0,1,4,1.262668528,1068,5,14,3,149,141,8,5495,4980,515,98,90,8,1,99.83029275,NoArch
b2a2256775b56eb21c7b3599dc9a766067cd6c27,3,108,13,95,121,1,0,1,39,348,1,2,1.451083153,693,3,1,1,109,100,9,4663,4233,430,65,57,8,1,98.93162393,NoArch
30f90d1237060171f9909d0696bd0bb0d0b8c719,1,11,3,8,14,0,0,0,18,524,1,1,0,180,7,0,0,21,19,2,976,929,47,16,16,0,1,100,NoArch
92ed81fd2eade11f5352fb0b9395b167f3153d47,2,129,7,122,136,0,0,0,84,0,1,2,0.822725596,1727,6,15,4,364,360,4,12871,11663,1208,127,126,1,1,100,NoArch
b28f0d5f8dd5c99d3fff87527627a44be5fd44c4,0,0,0,0,0,0,0,0,0,0,0,0,0,0,0,1,1,0,0,0,0,0,0,0,0,0,1,100,NoArch
16870af3aa3abe5e2cdc8ccc48ba4ecf20f10f9c,1,7,0,7,7,0,0,0,7,407,1,1,0,352,4,2,2,68,68,0,1573,1526,47,33,33,0,1,100,NoArch
338b443f0d1452b9b1ac4a00eaef162e5a644be7,0,0,0,0,0,0,0,0,0,0,0,0,0,0,0,0,0,0,0,0,0,0,0,0,0,0,1,100,NoArch
c693f54f185c5b3f4a7314f1749693da4ce3b299,0,0,0,0,0,0,0,0,0,0,0,0,0,0,0,60,10,0,0,0,0,0,0,0,0,0,1,100,NoArch
d9017ce768891815ef8a48c7390a5ac40af713a3,0,0,0,0,0,0,0,0,0,0,0,0,0,0,0,61,11,0,0,0,0,0,0,0,0,0,0,100,NoArch
620b2807eb2cee03baa146503454a1cb0054c7f0,0,0,0,0,0,0,0,0,0,0,0,0,0,0,0,62,12,0,0,0,0,0,0,0,0,0,1,100,NoArch
695efafb45f96c9d9ae0f905ef3c33fe75751612,1,3,1,2,4,0,0,0,8,0,1,1,0,359,4,63,13,69,68,1,1586,1573,13,33,33,0,1,100,NoArch
edf6a7e6c38f1a5e941fbc79fd8c7d37d04344cf,0,0,0,0,0,0,0,0,0,0,0,0,0,0,0,64,14,0,0,0,0,0,0,0,0,0,1,100,NoArch
bec6349f46b40fe0a4674062179966696e3026b1,0,0,0,0,0,0,0,0,0,0,0,0,0,0,0,65,15,0,0,0,0,0,0,0,0,0,1,100,NoArch
7ec35ea24ff0270586a26afbc6f6f530d272d1f7,0,0,0,0,0,0,0,0,0,0,0,0,0,0,0,66,16,0,0,0,0,0,0,0,0,0,1,100,NoArch
b2e1627632227d8de32c1ad5631e06e3bb124c14,1,9,0,9,9,0,0,0,15,802,1,1,0,93,7,0,0,14,13,1,447,429,18,11,10,1,1,100,NoArch
9ae13913c9de6dbc6b6ca05cdfb82f5564a1f5b6,0,0,0,0,0,0,0,0,0,0,0,0,0,0,0,0,0,0,0,0,0,0,0,0,0,0,1,100,NoArch
bd457af368e4de281607835e196e78800278b94e,3,25,1,24,26,1,0,1,5,578,1,3,1.105612401,2753,1,0,0,353,350,3,10305,10096,209,286,285,1,1,99.91386736,NoArch
6bbcf7658e31cd7e92c459300fd70263b9b89de6,0,0,0,0,0,0,0,0,0,0,0,0,0,0,0,1,0,0,0,0,0,0,0,0,0,0,0,100,NoArch
e38f7074d7c8f9156b39c8310302486ced93767a,1,17,0,17,17,0,0,0,2,114,1,1,0,19,2,2,1,1,1,0,140,140,0,1,1,0,1,100,NoArch
7f2b8dda4be515a3d1f0b60d5175ee500dbe16e2,0,0,0,0,0,0,0,0,0,0,0,0,0,0,0,3,2,0,0,0,0,0,0,0,0,0,1,100,NoArch
fe9330e56d2d6d356344d5152ca8b4ff3b52b89c,2,13,2,11,15,0,0,0,76,498,1,2,0.721928095,1303,3,60,0,321,312,9,8090,7020,1070,104,95,9,1,100,NoArch
1c5205ef3f1516fa5f3a323057139bffd5758182,3,387,44,343,431,2,0,2,20,527,1,3,1.465314378,627,1,0,0,151,88,63,5078,2757,2321,71,61,10,2,94.83585393,Arch
ed6a4e1f2aad7cea85bd956165fb7f66277533ea,3,44,387,343,431,0,2,2,19,150,1,3,1.465314378,970,0,61,0,88,151,63,2757,5078,2321,61,71,10,1,94.83585393,Arch
1f6fa7b79efde2eb999de34334b686a77b23e46a,15,503,55,448,558,2,0,2,85,1572,2,9,2.640519997,3635,4,0,0,739,566,173,22543,15683,6860,343,267,76,2,94.83585393,Arch
57bea12e3a0860958b2060cab4f1193391584839,0,0,0,0,0,0,0,0,0,0,0,0,0,0,0,2,1,0,0,0,0,0,0,0,0,0,1,100,NoArch
8c30a2d55d841e3da32554b01850fb40aeff9c0f,5,59,390,331,449,0,2,2,77,373,1,5,1.686085404,2599,0,30,14,440,463,23,13696,12110,1586,185,166,19,0,94.83585393,Arch
1910fade19f52b4beccc167507bdc8d417672b81,0,0,0,0,0,0,0,0,0,0,0,0,0,0,0,30,14,0,0,0,0,0,0,0,0,0,0,100,NoArch
a3957200a86a4582c6622738caacd153f0ad7882,0,0,0,0,0,0,0,0,0,0,0,0,0,0,0,6,0,0,0,0,0,0,0,0,0,0,1,100,NoArch
146c5285030aab67ac172b659e8b748335cd2275,0,0,0,0,0,0,0,0,0,0,0,0,0,0,0,7,1,0,0,0,0,0,0,0,0,0,1,100,NoArch
00b1c43740a78540c64c36731b4de64b3402d181,0,0,0,0,0,0,0,0,0,0,0,0,0,0,0,8,2,0,0,0,0,0,0,0,0,0,1,100,NoArch
7ff749b8f26a3f3c90d3b480a35434fb0352b278,0,0,0,0,0,0,0,0,0,0,0,0,0,0,0,61,0,0,0,0,0,0,0,0,0,0,1,100,NoArch
1abf6c2dc31528cc6cd0675a215932c81e7075c9,0,0,0,0,0,0,0,0,0,0,0,0,0,0,0,62,1,0,0,0,0,0,0,0,0,0,1,100,NoArch
e747a43c3fbb5189175ddce143c1a587f1e8a26c,0,0,0,0,0,0,0,0,0,0,0,0,0,0,0,63,2,0,0,0,0,0,0,0,0,0,1,100,NoArch
cfa305bc381a8bc4d428ce88eb1a3ff6668d7953,0,0,0,0,0,0,0,0,0,0,0,0,0,0,0,9,3,0,0,0,0,0,0,0,0,0,1,100,NoArch
080cd772f235a8f490928ce512aa62089af0f203,0,0,0,0,0,0,0,0,0,0,0,0,0,0,0,64,3,0,0,0,0,0,0,0,0,0,1,100,NoArch
2564afeb1fdc4792603f7ddc1a7b3b347d05b54e,1,14,1,13,15,0,0,0,26,1263,1,1,0,109,5,31,0,13,10,3,638,550,88,5,4,1,2,100,NoArch
c42c40f728c338b4c144c5cbd431e0513dabf7fe,0,0,0,0,0,0,0,0,0,0,0,0,0,0,0,72,4,0,0,0,0,0,0,0,0,0,1,100,NoArch
f7ec67996b66444f9de2284d1ddfaa66297ba51e,2,38,5,33,43,1,0,1,6,911,1,2,0.854180205,364,1,32,1,69,69,0,1650,1591,59,33,33,0,1,90.995671,Arch
a7a547cb8a3b7bb16531ef956b81c663c197fe75,2,5,38,33,43,0,1,1,3,8,1,2,0.854180205,397,0,10,1,69,69,0,1591,1650,59,33,33,0,1,90.995671,Arch
60365c1b05181960e141b71ca035164137f2cf64,2,38,5,33,43,1,0,1,6,911,1,2,0.854180205,364,1,10,1,69,69,0,1650,1591,59,33,33,0,1,90.995671,Arch
edd9f5557b344be58b03ed01c3588734c793ac46,0,0,0,0,0,0,0,0,0,0,0,0,0,0,0,73,5,0,0,0,0,0,0,0,0,0,1,100,NoArch
363360229e7ea5f816d87f9d5747dd4494d3b862,1,3,3,0,6,0,0,0,78,103,1,1,0,1148,5,65,4,311,311,0,7013,7018,5,95,95,0,1,100,NoArch
c1be0a192c21792df5d167fbb87eaf2a3f8c0672,0,0,0,0,0,0,0,0,0,0,0,0,0,0,0,74,6,0,0,0,0,0,0,0,0,0,1,100,NoArch
5a2febcb97cd5c71cc620c4f294f2d4d12be3aa9,0,0,0,0,0,0,0,0,0,0,0,0,0,0,0,11,2,0,0,0,0,0,0,0,0,0,1,100,NoArch
693ba378fc15ef8774cddd6ac11b8177a1d3e4f5,0,0,0,0,0,0,0,0,0,0,0,0,0,0,0,12,3,0,0,0,0,0,0,0,0,0,1,100,NoArch
7f2afa8df4167435f4e92c715d65519d01bda2f8,0,0,0,0,0,0,0,0,0,0,0,0,0,0,0,13,4,0,0,0,0,0,0,0,0,0,1,100,NoArch
05f3fced7811cb5c6b3cb07361a4c4563bec5632,0,0,0,0,0,0,0,0,0,0,0,0,0,0,0,14,5,0,0,0,0,0,0,0,0,0,1,100,NoArch
4c9b159c3e03dc0965f5d0eac1884a04856c258a,1,1,16,15,17,0,0,0,5,19,1,1,0,366,2,33,2,68,69,1,1526,1617,91,33,33,0,1,100,NoArch
9330bcbcf3d91cf72a32ba3c251c634a0f2b9a2b,1,16,1,15,17,0,0,0,4,548,1,1,0,351,2,11,2,69,68,1,1617,1526,91,33,33,0,1,100,NoArch
257aba0638a18380a5f99b6226d01db0a0390e26,0,0,0,0,0,0,0,0,0,0,0,0,0,0,0,66,2,0,0,0,0,0,0,0,0,0,0,100,NoArch
315d842148d57590a58fafecf6e5ea378e9e0d74,0,0,0,0,0,0,0,0,0,0,0,0,0,0,0,15,6,0,0,0,0,0,0,0,0,0,1,100,NoArch
274c510db79c651cc2141c4e1eaa07df292295dc,0,0,0,0,0,0,0,0,0,0,0,0,0,0,0,67,3,0,0,0,0,0,0,0,0,0,0,100,NoArch
499b756e7dbc5e0cde8f385ec7bd76023dc2534f,0,0,0,0,0,0,0,0,0,0,0,0,0,0,0,68,4,0,0,0,0,0,0,0,0,0,0,100,NoArch
a50068f11e121bf87fa8bc24639af0fc62064633,0,0,0,0,0,0,0,0,0,0,0,0,0,0,0,0,0,0,0,0,0,0,0,0,0,0,1,100,NoArch
9101a42badd32f0540caa28e27ca053a36e936e3,0,0,0,0,0,0,0,0,0,0,0,0,0,0,0,1,1,0,0,0,0,0,0,0,0,0,1,100,NoArch
5e6ffb8d444c0ed3fb6d0180718a9a7c131f2ce6,2,26,4,22,30,0,0,0,86,2374,1,2,0.881290899,1742,2,0,0,456,437,19,10507,9615,892,200,186,14,1,100,NoArch
62ad11dcf765d6735ef652f4252d19e4ded7afae,2,4,2,2,6,0,0,0,79,178,1,2,0.918295834,1641,3,34,0,352,352,0,10957,10934,23,124,124,0,1,100,NoArch
482adcfa1857033f2a76b07b429a266b0231f433,2,90,1,89,91,1,0,1,20,967,1,2,0.670856159,627,1,35,0,99,88,11,3143,2757,386,64,61,3,1,100,NoArch
fd6c4228fbecc6eff3e3ecd5ee27d2ceb46339ff,3,378,44,334,422,2,0,2,21,1,1,3,1.449527081,641,1,0,0,152,92,60,5146,2872,2274,72,62,10,2,91.04606113,Arch
c299da64ee53de57ea34e589b858d7fe8ada72fd,0,0,0,0,0,0,0,0,0,0,0,0,0,0,0,4,1,0,0,0,0,0,0,0,0,0,1,100,NoArch
3ff1fa8cac828bfaabd082cb82d7ea3a3827f02f,1,2,3,1,5,0,0,0,22,0,1,1,0,641,6,5,2,92,92,0,2872,2870,2,62,62,0,1,100,NoArch
ce16a3fc9e493d50425ecc697e397c486e9c62dd,1,43,42,1,85,0,0,0,23,0,1,1,0,640,6,6,3,92,92,0,2872,2872,0,62,62,0,1,100,NoArch
1158152de6debcf8e5a532585a68a39ab64d78ed,1,174,179,5,353,0,0,0,2,54,1,1,0,229,1,7,0,57,57,0,1576,1576,0,8,8,0,0,100,NoArch
b5e13ff04d1e9b6e5bb02b482b6ef0111268a9ed,0,0,0,0,0,0,0,0,0,0,0,0,0,0,0,8,1,0,0,0,0,0,0,0,0,0,0,100,NoArch
df57d3ad29918b6c45b6fce15d4f0815024d49f2,1,56,54,2,110,0,0,0,2,54,1,1,0,105,1,9,2,3,3,0,727,700,27,2,2,0,0,100,NoArch
a084fcdb5e79b1b8b86710f836ac6afce08c4a54,1,1,1,0,2,0,0,0,3,0,1,1,0,224,1,10,3,57,57,0,1576,1576,0,8,8,0,0,100,NoArch
32067dec274ba93aa0775fcfe990eef3b87b534c,2,0,331,331,331,0,2,2,0,0,1,2,0.907894446,331,0,36,0,0,60,60,0,2303,2303,0,10,10,1,91.04606113,Arch
e98caa9937c47a4b44c80e0497995fd404102755,0,0,0,0,0,0,0,0,0,0,0,0,0,0,0,100,0,0,0,0,0,0,0,0,0,0,1,100,NoArch
683bc7135b6a69a8d524393f91ada8310a8f9f88,0,0,0,0,0,0,0,0,0,0,0,0,0,0,0,101,1,0,0,0,0,0,0,0,0,0,1,100,NoArch
1de82871ccf2886171efd917aac822b7f2486ad3,0,0,0,0,0,0,0,0,0,0,0,0,0,0,0,102,2,0,0,0,0,0,0,0,0,0,1,100,NoArch
58daaf08a2637e0976cc124571200ce198b3143d,2,41,4,37,45,1,0,1,71,415,1,2,0.764204507,903,1,37,1,220,218,2,6482,6245,237,51,50,1,1,91.01123596,Arch
f4f226378918cce8a722d9795f3df4a6c7219746,1,1,1,0,2,0,0,0,20,1548,1,1,0,378,4,38,2,65,65,0,1769,1767,2,35,35,0,1,100,NoArch
54eefb8d780237a7108c2a0c91b12282686426ad,1,0,2,2,2,0,0,0,72,0,1,1,0,905,4,39,3,218,218,0,6255,6277,22,50,50,0,1,91.10535406,Arch
e62b98c7c6ff0c38f142b72d3b3fed7f3d717710,2,155,2,153,157,0,0,0,62,1874,1,2,0.945191769,1063,1,0,0,222,18,204,6525,1266,5259,76,10,66,1,99.82078853,NoArch
4996990874d127f4908c9f55f7bc3a4334e2aed4,0,0,0,0,0,0,0,0,0,0,0,0,0,0,0,0,0,0,0,0,0,0,0,0,0,0,1,100,NoArch
2875665a5bace62f4e7dfb01060cd50a08637b86,0,0,0,0,0,0,0,0,0,0,0,0,0,0,0,1,1,0,0,0,0,0,0,0,0,0,1,100,NoArch
b30b9e7a3365f50aa6f4481705937c462914764d,1,18,0,18,18,0,0,0,2,3,1,1,0,35,1,40,4,2,0,2,205,0,205,1,0,1,1,100,NoArch
a593cb03f93a9d449723c0e5d765bf2dcf55e132,7,338,213,125,551,2,1,3,70,245,1,7,2.21548273,2550,1,11,4,547,507,40,15973,14754,1219,161,162,1,0,90.79569892,Arch
cc224aba71ae32f7f371139701bf8f1a9587ad38,1,42,23,19,65,0,0,0,4,40,1,1,0,224,1,12,5,57,57,0,1576,1576,0,8,8,0,0,100,NoArch
21efba087b9fec37500b59e21a8bf5be546ea5a8,1,13,3,10,16,0,0,0,5,0,1,1,0,243,1,13,6,60,57,3,1643,1576,67,8,8,0,0,100,NoArch
4c1463cba1bc268c2ccf2a506d27e6ee84030316,10,262,378,116,640,1,2,3,87,1219,1,9,2.521166669,4953,2,0,0,1074,925,149,28121,24733,3388,410,351,59,2,90.79569892,Arch
ea242ffa266502e9c5ba01a964fc346d217b5846,2,12,0,12,12,0,0,0,19,432,1,2,1,808,4,2,2,120,0,120,4052,0,4052,78,0,78,1,100,NoArch
4cac7c8980791856c3fb7d3377d249cf8dd44b86,2,14,8,6,22,0,0,0,20,8,1,2,1,820,4,3,3,120,120,0,4010,4052,42,78,78,0,1,100,NoArch
96ef881811ac4f8f4017319d5344bcd3164a7bc4,0,0,0,0,0,0,0,0,0,0,0,0,0,0,0,4,4,0,0,0,0,0,0,0,0,0,1,100,NoArch
da22ffcba82efa50aa384b3acdf26561085e14f6,318,3037,3037,0,6074,0,0,0,88,3180,2,60,7.256039695,73665,2,5,3,9832,9832,0,381164,381164,0,4997,4997,0,1,100,NoArch
4fe9b453333c2cf1a0c212fa469b26ba5cf589ed,0,0,0,0,0,0,0,0,0,0,0,0,0,0,0,6,4,0,0,0,0,0,0,0,0,0,0,100,NoArch
7e10babe3eaad11c90cfed41553fc0c1ff90c16a,2,22,4,18,26,0,0,0,19,18,1,2,0.930586129,765,3,41,0,123,114,9,3768,3388,380,47,41,6,1,87.11683696,Arch
02f623bfe62fd35914b41a8727e041de70635655,0,0,0,0,0,0,0,0,0,0,0,0,0,0,0,42,1,0,0,0,0,0,0,0,0,0,1,100,NoArch
f614e15e6255877d31bb4836ae880eceda90484e,0,0,0,0,0,0,0,0,0,0,0,0,0,0,0,7,5,0,0,0,0,0,0,0,0,0,1,100,NoArch
bedf2f21a05715c3c1aa3b151329f2368c43c965,0,0,0,0,0,0,0,0,0,0,0,0,0,0,0,8,6,0,0,0,0,0,0,0,0,0,1,100,NoArch
51a260a27f3b2d6a046d2ed005eeff0dc7fa6e76,0,0,0,0,0,0,0,0,0,0,0,0,0,0,0,9,6,0,0,0,0,0,0,0,0,0,1,100,NoArch
fc34234028264bc15e779350204b78056d65810a,0,0,0,0,0,0,0,0,0,0,0,0,0,0,0,10,7,0,0,0,0,0,0,0,0,0,1,100,NoArch
f793202c4b87ec258326513568dd62353850f1d0,1,2,0,2,2,0,0,0,3,1561,1,1,0,153,2,43,2,48,0,48,1134,0,1134,5,0,5,1,100,NoArch
c22a1a102d78558e04249dad2cc086ca647fc2dd,9,1545,2,1543,1547,3,0,3,64,29,1,5,1.950148742,1749,2,44,3,578,64,514,17930,1704,16226,271,26,245,1,87.87268332,Arch
48239bb2207b1d1adecb35035898efd064a146ab,0,0,0,0,0,0,0,0,0,0,0,0,0,0,0,45,4,0,0,0,0,0,0,0,0,0,1,100,NoArch
8a3960ab1cdd9d575a7f5863f8e85f8bebd0419d,327,3276,5214,1938,8490,1,6,7,85,705,2,64,6.887239725,75914,1,0,0,9888,10181,293,383303,393957,10654,5011,5174,163,1,87.89110118,Arch
ec9e1e14b3137324b3201c0a439a91253fa64c9d,2,26,4,22,30,0,0,0,86,2623,1,2,0.881290899,1742,2,0,0,456,437,19,10507,9615,892,200,186,14,1,100,NoArch
1bc650dd6dbe7e87c59553e13f037481ee50abb6,2,4,2,2,6,0,0,0,79,403,1,2,0.918295834,1641,3,32,0,352,352,0,10957,10934,23,124,124,0,1,100,NoArch
44ce5eb8a2180409237c81b9a53b64708262a690,1,1,1,0,2,0,0,0,20,1632,1,1,0,378,4,36,4,65,65,0,1769,1767,2,35,35,0,1,100,NoArch
ce64ff7ba8f51a8f54c910407b89cb99b12f79df,1,0,2,2,2,0,0,0,72,0,1,1,0,905,4,37,5,218,218,0,6255,6277,22,50,50,0,1,91.10535406,Arch
039272b89c6f08f1bd56721ead3d79618b70f797,2,155,2,153,157,0,0,0,62,1959,1,2,0.945191769,1063,1,0,0,222,18,204,6525,1266,5259,76,10,66,1,99.82078853,NoArch
b010898beeaa1d3203634a3acf7bfad15a7b5789,1,18,0,18,18,0,0,0,2,0,1,1,0,35,1,38,6,2,0,2,205,0,205,1,0,1,1,100,NoArch
d1c85231fc0d42aeb63c575707450e0b2fd0e237,3,49,11,38,60,0,0,0,87,2300,1,2,1.156676652,2249,2,0,0,567,561,6,13367,13085,282,248,246,2,2,100,NoArch
8826b38b16f8c4aa5a3df33e6dbd8a339093a38d,2,12,0,12,12,0,0,0,17,970,1,2,1,808,3,2,2,120,0,120,4052,0,4052,78,0,78,1,100,NoArch
6de8e985675034fbb3cac4dc8bd3cbed31461b33,2,22,4,18,26,0,0,0,19,0,1,2,0.930586129,765,3,39,7,123,114,9,3768,3388,380,47,41,6,1,87.11683696,Arch
85b4313dce7e7a896d9ea1d9869baeebeb05a998,1,2,0,2,2,0,0,0,3,1561,1,1,0,153,2,41,9,48,0,48,1134,0,1134,5,0,5,1,100,NoArch
bb9b589e0ebd7aed7fa477b273881c42409969ac,9,1545,2,1543,1547,3,0,3,64,0,1,5,1.950148742,1749,2,42,10,578,64,514,17930,1704,16226,271,26,245,1,87.87268332,Arch
ae3b78f7df9acf255c1534599c697106cf0c5e6d,0,0,0,0,0,0,0,0,0,0,0,0,0,0,0,46,5,0,0,0,0,0,0,0,0,0,1,100,NoArch
191badb80281498611ffcbc0e79b9b020a3d5096,0,0,0,0,0,0,0,0,0,0,0,0,0,0,0,47,0,0,0,0,0,0,0,0,0,0,1,100,NoArch
89a31b9236c92b2036b8f4ddd190183a18c630fc,15,497,74,423,571,0,0,0,65,327,1,8,3.227672571,4881,3,0,0,876,677,199,27124,20392,6732,379,291,88,1,90.66455696,Arch
b26d194c974f2b29aeb4ba13054adcb339310dfa,15,74,497,423,571,0,0,0,64,1117,1,8,3.227672571,5304,2,4,0,828,876,48,24982,27124,2142,360,379,19,1,90.66455696,Arch
ff5bb456e751e9128606c6bbffe638e256ee2c1c,15,497,74,423,571,0,0,0,65,309,1,8,3.227672571,4881,3,0,0,876,677,199,27124,20392,6732,379,291,88,1,90.66455696,Arch
0376544cf47600eb1a23f0dc098051fbc75ec00c,1,2,1,1,3,0,0,0,4,17,1,1,0,236,3,48,0,55,55,0,1383,1385,2,14,14,0,1,100,NoArch
c3964345189581db8347bf0e038a0559d7a7626c,331,3679,5568,1889,9247,3,5,8,86,700,2,65,6.831651852,76907,1,14,0,10064,10328,264,388925,398755,9830,5076,5242,166,0,86.44351464,Arch
f2c7b08c3395cd9065730c21bd1a6dc25a57dbf4,331,5568,3679,1889,9247,5,3,8,88,2993,2,65,6.831651852,75018,2,0,0,10328,9948,380,398755,386281,12474,5242,5038,204,0,86.44351464,Arch
5259f26ecee6c268f0ddc86ef45104fe967f267a,2,121,12,109,133,0,0,0,66,86,1,2,0.907942863,1406,3,1,0,249,206,43,8703,4903,3800,88,62,26,2,100,NoArch
941187a2295197d9da2d9a865fda41e621813f4e,1,1,2,1,3,0,0,0,3,1029,1,1,0,237,3,1,0,55,55,0,1385,1383,2,14,14,0,2,100,NoArch
e3c5da696d4762b287bfec0d133efec20ddb8b14,14,1252,1,1251,1253,12,0,12,7,42,1,5,3.344335048,267,1,49,0,129,55,74,5808,1385,4423,69,14,55,1,98.91122278,NoArch
f6c044e56f9de7d3e34eeb1702c11fa4add04d84,6,202,7,195,209,1,0,1,22,115,1,4,2.100465504,2671,4,50,1,412,247,165,16045,7929,8116,254,154,100,1,89.30369128,Arch
f01f61b96dce5b402939fd81f9247313b4b8da0c,0,0,0,0,0,0,0,0,0,0,0,0,0,0,0,0,0,0,0,0,0,0,0,0,0,0,1,100,NoArch
be1639c44b16ddec8c54ecfca050364048daf896,2,87,9,78,96,0,0,0,81,801,1,2,0.946422051,1383,3,476,0,336,311,25,9174,7019,2155,113,95,18,1,100,NoArch
9456db01859dd3619fb09a6d4205ab433b357b02,1,1,1,0,2,0,0,0,82,0,1,1,0,1165,6,477,1,315,315,0,7122,7120,2,96,96,0,1,100,NoArch
5d45505b85fb55d4d3753b695bd3afc3f15b0c30,1,1,1,0,2,0,0,0,83,1,1,1,0,1165,7,2,0,315,315,0,7120,7122,2,96,96,0,1,100,NoArch
07c8f328603a4cacca087133ec3fb45337867aaf,2,9,87,78,96,0,0,0,84,0,1,2,0.946422051,1461,4,3,1,325,336,11,8629,9174,545,106,113,7,1,100,NoArch
973aa71a97e99293a99da965c973c20ce6e0a84a,2,87,9,78,96,0,0,0,85,0,1,2,0.946422051,1383,4,478,2,336,311,25,9174,7019,2155,113,95,18,1,100,NoArch
9cfd33870092d5c16a35b523305950215d1feabe,1,1,1,0,2,0,0,0,86,0,1,1,0,1165,7,479,3,315,315,0,7122,7120,2,96,96,0,1,100,NoArch
39481e665620fec527085552c4c71571f5aeb68f,21,9,1455,1446,1464,0,13,13,81,138,1,10,3.768277817,5549,3,476,0,769,856,87,23477,28975,5498,351,419,68,1,88.33757422,Arch
628457545e441b888a597b9ea3a283445c738233,1,1,1,0,2,0,0,0,82,0,1,1,0,1165,6,477,1,315,315,0,7122,7120,2,96,96,0,1,100,NoArch
749934f3cd13c413e293815e7f64848a688a6e60,20,1454,8,1446,1462,13,0,13,22,60,1,9,3.758443164,2938,4,0,0,541,302,239,21853,9314,12539,323,168,155,1,88.33757422,Arch
fa0059c55a31813634188eb85e53b68e33644489,2,23,8,15,31,0,0,0,44,247,1,2,0.708835673,413,2,0,0,101,100,1,2683,2507,176,24,24,0,1,100,NoArch
17cfe99d72121fad1ead76e8bf80729c5c7f7e6b,2,40,2,38,42,0,0,0,2,122,1,2,0.453716339,431,1,51,0,32,17,15,2598,631,1967,20,8,12,1,100,NoArch
d7e12314832f1ef58f87d2f5106ac6b49c5a0be9,0,0,0,0,0,0,0,0,0,0,0,0,0,0,0,0,0,0,0,0,0,0,0,0,0,0,1,100,NoArch
30408a9c192c5f4eaaf42f01f0ffbfffd705aa57,0,0,0,0,0,0,0,0,0,0,0,0,0,0,0,52,1,0,0,0,0,0,0,0,0,0,1,100,NoArch
c37d05e87957d7b46c32c5fadcb569dc9be44117,0,0,0,0,0,0,0,0,0,0,0,0,0,0,0,0,0,0,0,0,0,0,0,0,0,0,1,100,NoArch
e6d2c4d864222290e6e24039365476c8eeb2ea1e,1,9,3,6,12,0,0,0,67,135,1,1,0,996,7,0,0,212,211,1,5002,4981,21,65,64,1,1,100,NoArch
64f898c4322ec641379c9916007303acfe817f84,0,0,0,0,0,0,0,0,0,0,0,0,0,0,0,0,0,0,0,0,0,0,0,0,0,0,1,100,NoArch
5acae5e10ee5d9d7d98b208e29a930f1e66f40ae,2,26,1,25,27,0,0,0,22,1245,1,2,0.950956048,831,3,53,2,111,92,19,4351,2872,1479,76,62,14,1,100,NoArch
4c992a58743b564fba831bb7349e3bc07fca4b8e,2,4,3,1,7,0,0,0,68,198,1,2,0.863120569,1744,5,54,3,245,245,0,11372,11365,7,88,88,0,2,100,NoArch
832512edcd7591c238c35b5a479e15ac0709e4cb,0,0,0,0,0,0,0,0,0,0,0,0,0,0,0,55,4,0,0,0,0,0,0,0,0,0,1,100,NoArch
33d495840c896b693b7f37b5ec786ac1acacd3b4,0,0,0,0,0,0,0,0,0,0,0,0,0,0,0,56,5,0,0,0,0,0,0,0,0,0,1,100,NoArch
4810d48cf9643850587e98a1cde17215feb24655,3,16,10,6,26,0,0,0,23,239,1,3,1.465536041,1263,4,11,0,195,195,0,6775,6671,104,127,127,0,1,100,NoArch
27cb9e271715b00ff5784164a9fb02de00e57203,2,34,0,34,34,0,0,0,3,204,1,1,1,325,2,12,1,14,0,14,1868,0,1868,11,0,11,1,100,NoArch
bafac8d9d80bfcf8207f42629862617442a01481,2,360,0,360,360,2,0,2,5,27,1,2,0.877868813,0,1,15,0,63,0,63,2370,0,2370,10,0,10,1,98.98175647,NoArch
be33922c03bd229b885fb9d664b55ce308f6ffaf,6,21,365,344,386,0,2,2,69,35,1,6,1.24200883,2763,5,0,0,378,226,152,13181,10443,2738,172,117,55,1,98.98175647,NoArch
fcd0a65f64984fc4b469760f44e07e1bdf8d1644,0,0,0,0,0,0,0,0,0,0,0,0,0,0,0,480,0,0,0,0,0,0,0,0,0,0,1,100,NoArch
ab25bf2037f98a2fc99179b8ee175d3d876f87b3,0,0,0,0,0,0,0,0,0,0,0,0,0,0,0,481,1,0,0,0,0,0,0,0,0,0,1,100,NoArch
1296ce9238a315b4323db351483dc66ec1a1afe3,0,0,0,0,0,0,0,0,0,0,0,0,0,0,0,0,0,0,0,0,0,0,0,0,0,0,1,100,NoArch
a92c8f5413e537c116e6b09021b7ed9944467e32,0,0,0,0,0,0,0,0,0,0,0,0,0,0,0,482,2,0,0,0,0,0,0,0,0,0,1,100,NoArch
bc3fffb067c93ebece18a80f455ea4662a240e0b,0,0,0,0,0,0,0,0,0,0,0,0,0,0,0,0,0,0,0,0,0,0,0,0,0,0,1,100,NoArch
2b1639ce5adc100760118ed6ea0cbb66786bec4d,0,0,0,0,0,0,0,0,0,0,0,0,0,0,0,483,3,0,0,0,0,0,0,0,0,0,0,100,NoArch
e276aa5e40cf51e36b581750c135c9c3875cac84,2,74,7,67,81,0,0,0,87,281,1,2,0.825626526,1660,4,13,0,360,315,45,11663,7122,4541,126,96,30,1,99.95751912,NoArch
ef0e1a1a011298ee77f1112ec9709ef03c5035ab,2,21,1,20,22,0,0,0,89,470,1,2,0.439496987,2349,4,484,3,471,437,34,16782,9630,7152,218,186,32,1,100,NoArch
0a74e1e0fb45dae8785f204f17d05bd86d0a2d2b,2,16,5,11,21,0,0,0,5,2223,1,2,0.958711883,1134,2,485,4,116,114,2,5205,5169,36,41,41,0,1,100,NoArch
8ecb2f130fdb1f730e1e8df667ab99bd31af15b2,4,112,1,111,113,1,0,1,25,71,1,4,1.262668528,1068,5,14,1,149,17,132,5495,628,4867,98,8,90,1,99.83029275,NoArch
420824c13381c4014d102c8e51e231c694ddacf2,3,108,13,95,121,1,0,1,39,362,1,2,1.451083153,693,3,1,0,109,100,9,4663,4233,430,65,57,8,1,98.93162393,NoArch
e2d1073bf5095af38fc6ed194d92fc82de225fc9,1,11,3,8,14,0,0,0,18,545,1,1,0,180,6,0,0,21,19,2,976,929,47,16,16,0,1,100,NoArch
67bec06dbdc910856fdc33d149aece97c26a59b1,2,129,7,122,136,0,0,0,88,84,1,2,0.822725596,1727,4,15,0,364,360,4,12871,11663,1208,127,126,1,1,100,NoArch
b2cd78d549ad72cc1a1441562ea1bc5181116040,0,0,0,0,0,0,0,0,0,0,0,0,0,0,0,1,1,0,0,0,0,0,0,0,0,0,1,100,NoArch
bf7f3934c3f33bbd1d8923bf3c33e0fe45831ec5,1,7,0,7,7,0,0,0,7,408,1,1,0,352,4,2,2,68,0,68,1573,0,1573,33,0,33,1,100,NoArch
ecc2adb31a1bcd61d073d87de8be18b2a91f5e6d,0,0,0,0,0,0,0,0,0,0,0,0,0,0,0,0,0,0,0,0,0,0,0,0,0,0,1,100,NoArch
fb7f023daf40c6373dc60db436fe302c70805493,39,62,2090,2028,2152,0,15,15,88,375,1,20,4.568678693,14897,3,50,0,2113,2242,129,77585,86960,9375,981,1074,93,1,87.4839812,Arch
9d9d5e76c64f168b3d8c91e0afbdbf6dd87b9a7d,13,1250,0,1250,1250,12,0,12,7,68,1,4,3.328008232,31,2,52,2,74,0,74,4425,0,4425,55,0,55,1,98.91122278,NoArch
c80d1eec0229ea733e0ed0f4e7c0c4b90d81f841,6,202,7,195,209,1,0,1,20,361,1,4,2.100465504,2671,4,53,3,412,247,165,16045,7929,8116,254,154,100,1,89.30369128,Arch
cd760da972d3eb6f9b083f28bab5bd4921509f16,2,23,8,15,31,0,0,0,44,262,1,2,0.708835673,413,3,0,0,101,100,1,2683,2507,176,24,24,0,1,100,NoArch
fa46c9794767d512522824948f3c792dd634b828,2,40,2,38,42,0,0,0,2,0,1,2,0.453716339,431,1,54,4,32,17,15,2598,631,1967,20,8,12,1,100,NoArch
d60d26639a176494c133b5ef45eb77e5737e002b,1,9,3,6,12,0,0,0,67,321,1,1,0,996,7,0,0,212,211,1,5002,4981,21,65,64,1,1,100,NoArch
968550da18708c76fd04c13722d996461aa23cb7,2,26,1,25,27,0,0,0,22,1413,1,2,0.950956048,831,3,56,6,111,92,19,4351,2872,1479,76,62,14,1,100,NoArch
79a6d8d81517d45544dba215432f786a9523f76f,2,4,3,1,7,0,0,0,68,262,1,2,0.863120569,1744,5,57,7,245,245,0,11372,11365,7,88,88,0,2,100,NoArch
7a15dcdf5252b3b8fc1d1ad440f6080afc06d242,2,34,0,34,34,0,0,0,3,203,1,1,1,325,2,12,1,14,0,14,1868,0,1868,11,0,11,1,100,NoArch
06f4a1220af45bbd1e428450cf278bf6795fb402,4,21,5,16,26,0,0,0,69,0,1,4,0.998952569,2403,5,0,0,378,163,215,13181,8073,5108,172,107,65,1,100,NoArch
aa0ee44822a62fd087fa8cca169dfef4e182af0f,2,74,7,67,81,0,0,0,83,359,1,2,0.825626526,1660,4,13,2,360,315,45,11663,7122,4541,126,96,30,1,99.95751912,NoArch
f02db39114cd3b1bd02e87b86812f2c0cafdba86,2,21,1,20,22,0,0,0,89,524,1,2,0.439496987,2349,4,481,3,471,437,34,16782,9630,7152,218,186,32,1,100,NoArch
69a343b9c37a5410e4f20fd6cf870a68ebf023ce,4,112,1,111,113,1,0,1,23,0,1,4,1.262668528,1068,5,14,3,149,17,132,5495,628,4867,98,8,90,1,99.83029275,NoArch
30f90d1237060171f9909d0696bd0bb0d0b8c719,1,11,3,8,14,0,0,0,18,524,1,1,0,180,6,0,0,21,19,2,976,929,47,16,16,0,1,100,NoArch
92ed81fd2eade11f5352fb0b9395b167f3153d47,2,129,7,122,136,0,0,0,84,0,1,2,0.822725596,1727,4,15,4,364,360,4,12871,11663,1208,127,126,1,1,100,NoArch
16870af3aa3abe5e2cdc8ccc48ba4ecf20f10f9c,1,7,0,7,7,0,0,0,7,407,1,1,0,352,4,2,2,68,0,68,1573,0,1573,33,0,33,1,100,NoArch
23de4d0133f04fd9d33b54a7c304f92b6802049e,0,0,0,0,0,0,0,0,0,0,0,0,0,0,0,57,0,0,0,0,0,0,0,0,0,0,1,100,NoArch
454db15472ee849e58220fb714638610eb869bac,1,3,1,2,4,0,0,0,8,0,1,1,0,359,4,58,1,69,68,1,1586,1573,13,33,33,0,1,100,NoArch
7a398e0f373fcbe4e9fe5e068c3e720530f0a849,0,0,0,0,0,0,0,0,0,0,0,0,0,0,0,59,2,0,0,0,0,0,0,0,0,0,1,100,NoArch
695efafb45f96c9d9ae0f905ef3c33fe75751612,0,0,0,0,0,0,0,0,0,0,0,0,0,0,0,63,13,0,0,0,0,0,0,0,0,0,1,100,NoArch
cae491a6204b8167481fcc46e7f7eed061a44a82,0,0,0,0,0,0,0,0,0,0,0,0,0,0,0,60,3,0,0,0,0,0,0,0,0,0,1,100,NoArch
a53a4fd10072471aa7c8170499a10792e61e0d95,3,37,8,29,45,0,0,0,26,756,1,3,1.294487566,1167,5,16,0,137,128,9,6520,4460,2060,94,86,8,1,100,NoArch
152fa0954bb74e8e1e627751ccab55ada4f5b375,3,99,6,93,105,0,0,0,27,48,1,3,1.103307409,1196,5,17,0,145,128,17,7004,4516,2488,98,86,12,1,100,NoArch
d559a7e877777096b3a2ad656606a5a2a88a2df9,1,2,2,0,4,0,0,0,3,758,1,1,0,50,3,3,0,2,2,0,227,224,3,1,1,0,1,100,NoArch
4f53fa933447865d7afb22c5d7d472d87fc2a4ae,1,4,0,4,4,0,0,0,20,740,1,1,0,703,6,0,0,116,0,116,3434,0,3434,41,0,41,1,100,NoArch
d9338a4cf008b445ea3efbe2523288d07162ec71,2,42,4,38,46,0,0,0,89,513,1,2,0.347816914,1455,5,1,1,356,349,7,9109,8886,223,127,121,6,1,99.9137931,NoArch
68a5418bf4b71c15876347260fd1df2b17069c99,2,360,0,360,360,2,0,2,5,27,1,2,0.877868813,0,1,16,0,63,0,63,2370,0,2370,10,0,10,1,98.03921569,NoArch
f8c70a3a9fe5a410363544493a03dc2d10340cbd,6,143,377,234,520,0,2,2,14,1714,1,4,2.035689709,1361,2,0,0,93,111,18,6241,4249,1992,46,31,15,1,98.03921569,NoArch
6bdc8f43e1ac2019e5a405c3edb4cf8fb795ccf8,7,14,5,9,19,0,0,0,90,1125,1,3,2.655050539,2309,3,1,0,531,61,470,12550,2087,10463,249,44,205,1,100,NoArch
630e6bc0e789d5baa5bf84cecd124ec1bb6486d2,0,0,0,0,0,0,0,0,0,0,0,0,0,0,0,0,0,0,0,0,0,0,0,0,0,0,1,100,NoArch
f5cbd7378142dc4d730a234059543b2b1e083c0b,0,0,0,0,0,0,0,0,0,0,0,0,0,0,0,0,0,0,0,0,0,0,0,0,0,0,1,100,NoArch
3ab93ca43aa2dbcac3c7b50c201bd3e297dc493b,0,0,0,0,0,0,0,0,0,0,0,0,0,0,0,1,1,0,0,0,0,0,0,0,0,0,1,100,NoArch
ad42bb36c96e7dda17cc04900e3dedfd7b8ea9e7,0,0,0,0,0,0,0,0,0,0,0,0,0,0,0,2,2,0,0,0,0,0,0,0,0,0,1,100,NoArch
57983af07b751809141cfc3b6a0ed07f4ea5ae9d,0,0,0,0,0,0,0,0,0,0,0,0,0,0,0,3,3,0,0,0,0,0,0,0,0,0,1,100,NoArch
cc31afef46b76eef0feb60c1e506db206d0df593,0,0,0,0,0,0,0,0,0,0,0,0,0,0,0,4,4,0,0,0,0,0,0,0,0,0,1,100,NoArch
92b83f5a6ca234b2ac7e3323e3bd2e0b58c758f0,0,0,0,0,0,0,0,0,0,0,0,0,0,0,0,0,0,0,0,0,0,0,0,0,0,0,1,100,NoArch
2ac78613d444332194669c2e9807d2ea55c674b6,0,0,0,0,0,0,0,0,0,0,0,0,0,0,0,103,0,0,0,0,0,0,0,0,0,0,0,100,NoArch
a974984e6e7150b2c6e757bce9cc994b740094c1,0,0,0,0,0,0,0,0,0,0,0,0,0,0,0,5,5,0,0,0,0,0,0,0,0,0,1,100,NoArch
b2e1627632227d8de32c1ad5631e06e3bb124c14,19,51,341,290,392,0,0,0,89,1647,1,13,3.221110122,7077,2,0,0,1221,1243,22,37132,38565,1433,558,562,4,1,99.9137931,NoArch
94d15f4be1f4e25e5d6170ad32b5251ac14a4736,19,341,51,290,392,0,0,0,90,1130,1,13,3.221110122,6787,3,0,0,1256,602,654,38994,17983,21011,572,284,288,1,99.9137931,NoArch
c3384e4d016bac264f6577fff9543199a1fb1970,18,771,158,613,929,6,0,6,89,1402,1,10,2.959006979,3538,1,17,1,733,637,96,22248,19220,3028,321,305,16,0,97.37171464,Arch
b735b4259d0512482477a2648b92d095a29cfa54,18,158,771,613,929,0,6,6,90,1052,1,10,2.959006979,4151,2,4,0,637,238,399,19220,8301,10919,305,95,210,1,97.37171464,Arch
656b2bb525b087d3d65f93a58f566164616e1766,0,0,0,0,0,0,0,0,0,0,0,0,0,0,0,0,0,0,0,0,0,0,0,0,0,0,1,100,NoArch
30b5d4dfa98bf49e7165ca47e86fc55ad51fa2bd,0,0,0,0,0,0,0,0,0,0,0,0,0,0,0,4,0,0,0,0,0,0,0,0,0,0,1,100,NoArch
29129abeecd58d387fd8f8986fba052a4868fc7c,0,0,0,0,0,0,0,0,0,0,0,0,0,0,0,0,0,0,0,0,0,0,0,0,0,0,1,100,NoArch
9ae13913c9de6dbc6b6ca05cdfb82f5564a1f5b6,19,51,341,290,392,0,0,0,89,1647,1,13,3.221110122,7077,2,0,0,1221,1243,22,37132,38565,1433,558,562,4,1,99.9137931,NoArch
e9fd99ffa53e95ddbb1d136ddd6fabbfd2961f7f,19,341,51,290,392,0,0,0,90,1130,1,13,3.221110122,6787,3,0,0,1256,602,654,38994,17983,21011,572,284,288,1,99.9137931,NoArch
ce36fffca8dd0bf8f5282041ba473e84193483c1,0,0,0,0,0,0,0,0,0,0,0,0,0,0,0,6,0,0,0,0,0,0,0,0,0,0,1,100,NoArch
ec8514f711b739307d460b23bcb6eccc784f419a,0,0,0,0,0,0,0,0,0,0,0,0,0,0,0,104,0,0,0,0,0,0,0,0,0,0,1,100,NoArch
230c7e75392d3c3dc2598f027603b4fc9d78d041,0,0,0,0,0,0,0,0,0,0,0,0,0,0,0,105,1,0,0,0,0,0,0,0,0,0,1,100,NoArch
52d12bbc11a2990d5c4b49fd7a971341f4474922,1,22,13,9,35,0,0,0,9,881,1,1,0,691,4,5,1,52,50,2,3630,3569,61,31,31,0,1,100,NoArch
0e24e2ab452ff85641cad8e8b74da81890fb6d03,0,0,0,0,0,0,0,0,0,0,0,0,0,0,0,106,2,0,0,0,0,0,0,0,0,0,0,100,NoArch
5ec94b9aff523cd0b847af823243f6fb11cf23c4,0,0,0,0,0,0,0,0,0,0,0,0,0,0,0,0,0,0,0,0,0,0,0,0,0,0,0,100,NoArch
27355642317a0c87b4dc7350203a4197232d83b1,0,0,0,0,0,0,0,0,0,0,0,0,0,0,0,107,3,0,0,0,0,0,0,0,0,0,0,100,NoArch
db6bb9d7a9f404e907d12a1380b65caac776b8a3,3,25,1,24,26,1,0,1,5,590,1,3,1.105612401,2753,1,0,0,353,48,305,10305,1134,9171,286,5,281,0,99.91386736,NoArch
43297652d0d08b680b5ab75060d3f7de54e5aa3e,0,0,0,0,0,0,0,0,0,0,0,0,0,0,0,7,1,0,0,0,0,0,0,0,0,0,0,100,NoArch
e06b40163584f46cb77ddf4a85002a5f1b45b9d5,3,1,25,24,26,0,1,1,6,0,1,3,1.105612401,2777,2,5,0,350,353,3,10096,10305,209,285,286,1,0,99.91386736,NoArch
37ce7f72478fcd3dd15637efe25b422f9631bacc,3,25,1,24,26,1,0,1,7,0,1,3,1.105612401,2753,2,1,1,353,48,305,10305,1134,9171,286,5,281,1,99.91386736,NoArch
bd457af368e4de281607835e196e78800278b94e,20,64,363,299,427,0,0,0,89,1799,1,14,3.366157841,7777,2,0,0,1271,1295,24,40701,42195,1494,589,593,4,1,99.91394148,NoArch
884fbabd3a07e6442dac9a43f34eb9ca0e5a0cbc,26,1078,65,1013,1143,5,0,5,90,992,1,18,3.501453382,7497,3,18,0,1424,653,771,46540,21692,24848,623,316,307,0,97.29053772,Arch
0550d2cce2793d1b810960a652f03fadf88b02ff,6,1,715,714,716,0,5,5,3,0,1,4,2.060193345,733,0,0,0,1,116,115,140,3916,3776,1,20,19,1,97.37390579,Arch
4b3677c32b879e0e7f717eb95f9135ac654da760,0,0,0,0,0,0,0,0,0,0,0,0,0,0,0,1,0,0,0,0,0,0,0,0,0,0,1,100,NoArch
6bbcf7658e31cd7e92c459300fd70263b9b89de6,20,64,363,299,427,0,0,0,89,1799,1,14,3.366157841,7777,2,1,0,1271,1295,24,40701,42195,1494,589,593,4,0,99.91394148,NoArch
874fff780dfe6d6ee8a3fa13f461110794b56f35,30,1425,65,1360,1490,9,0,9,90,832,1,19,3.956671437,7497,3,19,1,1458,653,805,48129,21692,26437,645,316,329,0,96.89054726,Arch
64c482fdeeaeac9d19511f9e4ea58447dbfcb91e,1,1,1,0,2,0,0,0,3,0,1,1,0,19,2,22,2,1,1,0,140,140,0,1,1,0,1,100,NoArch
e38f7074d7c8f9156b39c8310302486ced93767a,30,81,1424,1343,1505,0,9,9,89,1200,1,19,3.99190632,8857,2,2,1,1272,1444,172,40841,47560,6719,590,634,44,1,96.89054726,Arch
fc3d582617c027f6215f92f8bcdf1bd55f9310aa,21,363,81,282,444,0,0,0,90,1065,1,15,3.471661666,7514,3,0,0,1309,653,656,42764,21692,21072,604,316,288,0,99.91394148,NoArch
17f2d75132021fafeca29edbdcade40df960fdc9,0,0,0,0,0,0,0,0,0,0,0,0,0,0,0,1,1,0,0,0,0,0,0,0,0,0,0,100,NoArch
ce1654df5e6b3c9e4b142678b61d36f19c9da359,9,1049,0,1049,1049,9,0,9,7,77,1,4,2.959224685,0,1,23,0,149,0,149,5321,0,5321,41,0,41,0,96.973466,Arch
60b78961ae0117492062370f5a9774b10ea48255,0,0,0,0,0,0,0,0,0,0,0,0,0,0,0,24,1,0,0,0,0,0,0,0,0,0,1,100,NoArch
ce0bad58393fb1d1d5a446062aca16f1a68d1260,0,0,0,0,0,0,0,0,0,0,0,0,0,0,0,25,2,0,0,0,0,0,0,0,0,0,0,100,NoArch
9132015450a2ad6f56cd582b393e8f1b8df573c9,11,552,278,274,830,2,2,4,8,158,1,4,2.715001715,1049,1,8,0,181,149,32,6911,5321,1590,67,41,26,0,99.59935897,NoArch
008cd8a209564a958e9065a5f6ff05526a41f4a5,0,0,0,0,0,0,0,0,0,0,0,0,0,0,0,26,3,0,0,0,0,0,0,0,0,0,1,100,NoArch
53156fd1e475d976df2d55231cbe40b6e0f5dec8,0,0,0,0,0,0,0,0,0,0,0,0,0,0,0,108,0,0,0,0,0,0,0,0,0,0,0,100,NoArch
1f4ec52df822f5b5689cb15c8d005c224a271b6d,0,0,0,0,0,0,0,0,0,0,0,0,0,0,0,27,4,0,0,0,0,0,0,0,0,0,1,100,NoArch
5795c5e505b817d6481eb1863068c0aa0ad329b9,3,5,7,2,12,0,0,0,9,42,1,2,1.384431504,544,2,28,1,107,107,0,3033,3053,20,26,26,0,0,100,NoArch
9d76342ae8d7d017b0fb71c673bf5774b7bf6f61,0,0,0,0,0,0,0,0,0,0,0,0,0,0,0,29,2,0,0,0,0,0,0,0,0,0,0,100,NoArch
e0a3907a58956bf35e64193d0e26f644905c7a1a,3,7,5,2,12,0,0,0,8,50,1,2,1.384431504,542,2,108,0,107,107,0,3053,3033,20,26,26,0,0,100,NoArch
e1d331dcec98e820f9d5bce6d1f18415fd45b3d5,3,5,7,2,12,0,0,0,9,51,1,2,1.384431504,544,2,26,0,107,107,0,3033,3053,20,26,26,0,0,100,NoArch
2cb0638bcaa0147134feb644a293a0512c499741,0,0,0,0,0,0,0,0,0,0,0,0,0,0,0,27,1,0,0,0,0,0,0,0,0,0,0,100,NoArch
81ca4dba8176c1a577205d12e1088880b7714947,0,0,0,0,0,0,0,0,0,0,0,0,0,0,0,109,1,0,0,0,0,0,0,0,0,0,0,100,NoArch
7fcd5eb3382f13e4100a424dce43079ed9c7e07e,0,0,0,0,0,0,0,0,0,0,0,0,0,0,0,9,0,0,0,0,0,0,0,0,0,0,1,100,NoArch
0b74bd5e7a37ccdb42918a0ab7768e9292df5dab,0,0,0,0,0,0,0,0,0,0,0,0,0,0,0,111,2,0,0,0,0,0,0,0,0,0,0,100,NoArch
c9f2c49241397fb3967bd281225f7cce353c32fc,2,63,2,61,65,0,0,0,8,1162,1,2,0.391243564,423,5,2,0,56,34,22,2500,830,1670,41,20,21,1,100,NoArch
ddfcabcee064d137fb0b9082e8c522ab900433c2,0,0,0,0,0,0,0,0,0,0,0,0,0,0,0,0,0,0,0,0,0,0,0,0,0,0,1,100,NoArch
8336f7ece1dc65b1dc17edff5dab9d9ad7aa9666,2,64,18,46,82,0,0,0,5,1534,1,2,0.499179836,206,3,3,0,20,15,5,1334,1093,241,12,8,4,1,100,NoArch
c04a17c86078431d0ae33a3045520e3ec9d9787d,2,34,3,31,37,0,0,0,74,1222,1,2,0.84185219,1954,5,4,1,361,218,143,13465,6255,7210,144,50,94,1,100,NoArch
edd8edda0659f802e203e36bcb9d8ec51d821f26,3,43,2,41,45,0,0,0,75,411,1,2,1.153868724,2022,6,0,0,366,142,224,13797,7275,6522,147,94,53,1,99.14250715,NoArch
528a1c8a997a0831e83b525173c6a70b08ee681a,8,86,36,50,122,0,0,0,70,1868,1,6,2.869258018,2529,6,6,0,408,402,6,12686,12488,198,150,150,0,1,100,NoArch
e5ae42e5703b8b193e5c2a61458e28a931c5774e,1,1,1,0,2,0,0,0,91,243,1,1,0,1624,8,486,0,439,439,0,9653,9653,0,186,186,0,1,100,NoArch
49ddc8938e3268166a41f100269b93e7e3da652e,1,1,1,0,2,0,0,0,90,533,1,1,0,1624,8,0,0,439,439,0,9653,9653,0,186,186,0,0,100,NoArch
d145b8b6463a7b0d1821d7ebdd561524f9d80914,2,1,2,1,3,0,0,0,91,754,1,2,0.918295834,2648,4,487,1,528,528,0,16481,16488,7,260,260,0,1,100,NoArch
9bff02fbfa5b5d8356aa8af57e250bac7a92ca7f,0,0,0,0,0,0,0,0,0,0,0,0,0,0,0,5,0,0,0,0,0,0,0,0,0,0,1,100,NoArch
21b369895cc6826b862605796bc35704bd142841,0,0,0,0,0,0,0,0,0,0,0,0,0,0,0,6,0,0,0,0,0,0,0,0,0,0,1,100,NoArch
f72b620b9d700cf5f2febb0022079b69b9c9577e,0,0,0,0,0,0,0,0,0,0,0,0,0,0,0,7,0,0,0,0,0,0,0,0,0,0,1,100,NoArch
b1233fd6468d4de546891cc12d19f905c55604cc,0,0,0,0,0,0,0,0,0,0,0,0,0,0,0,2,0,0,0,0,0,0,0,0,0,0,1,100,NoArch
3801888fa8c9dc96a1613e41cbc33800bc84f1b4,1,0,1,1,1,0,0,0,3,1352,1,1,0,133,3,0,0,17,17,0,501,512,11,11,11,0,1,100,NoArch
224f75f64982fa65c56039e4c413b5d9c138800b,1,8,8,0,16,0,0,0,3,1352,1,1,0,145,3,1,1,26,26,0,694,689,5,17,17,0,1,100,NoArch
d0cce25208ad83a9fb6fcce825ae64881bdda420,1,5,23,18,28,0,0,0,90,563,1,1,0,1196,9,2,2,315,321,6,7194,7336,142,94,96,2,1,100,NoArch
91d4cc03bbe84ca2aa0ed7f9094a20061b04a8a3,2,2,12,10,14,0,0,0,11,2617,1,2,0.749595257,269,4,3,3,25,25,0,1052,1070,18,17,17,0,1,100,NoArch
14488e35bc31f299de8cd88bd6d1ac07576eaa3e,2,28,5,23,33,0,0,0,18,1352,1,2,0.884963636,1455,4,4,4,200,197,3,6891,6758,133,107,106,1,1,100,NoArch
5e852265ea7197efe809a8c37ec6a0c34811d3ba,0,0,0,0,0,0,0,0,0,0,0,0,0,0,0,0,0,0,0,0,0,0,0,0,0,0,1,100,NoArch
040a3be09216f188dff2b1bf1c23d21ecd4a265c,1,2,2,0,4,0,0,0,22,1406,1,1,0,378,6,5,0,65,65,0,1769,1769,0,35,35,0,1,100,NoArch
15651fc95e058d1b3cc165a70c367d1dc2bad8b7,3,329,6,323,335,1,0,1,6,630,1,2,0.755214937,1145,3,0,0,136,93,43,7671,1798,5873,59,21,38,1,99.95843724,NoArch
09c997e206615c4b23ab9ae2ab5f6a3d793e9afb,1,1,1,0,2,0,0,0,92,170,1,1,0,1624,9,0,0,439,439,0,9658,9653,5,186,186,0,1,100,NoArch
189368ed485f5577528824dd88856991a51b6918,2,2,3,1,5,0,0,0,11,1250,1,2,0.970950594,786,4,7,0,57,57,0,5930,5930,0,35,35,0,1,100,NoArch
db8ed216eaf13c8f3862eb31152185f0504c4467,10,1270,345,925,1615,7,0,7,7,120,1,2,2.964500138,1391,1,1,0,194,134,60,12533,6932,5601,88,55,33,1,99.25373134,NoArch
50eebb8a0b96565641bb56a0f11e326b3f5cc50b,4,125,9,116,134,0,0,0,30,395,1,2,0.936673281,1753,5,8,1,196,166,30,11722,7837,3885,71,46,25,1,100,NoArch
6f8c72773753079527e6c5bc37f6ed7842915a24,0,0,0,0,0,0,0,0,0,0,0,0,0,0,0,8,0,0,0,0,0,0,0,0,0,0,1,100,NoArch
ce3f821a79d2a653a08da2ac26a14df9deccb7ec,1,6,9,3,15,0,0,0,4,5755,1,1,0,128,3,6,0,7,6,1,570,574,4,3,3,0,1,100,NoArch
9f3ceefda1ee31c388f535a8d3007f0749119447,1,5,4,1,9,0,0,0,5,1493,1,1,0,735,4,7,1,77,77,0,1833,1813,20,43,43,0,1,100,NoArch
3af404efb31a1dc2fd720384ef9a3f7326c2d303,5,86,61,25,147,0,0,0,11,2826,1,4,1.696602831,498,3,0,0,43,39,4,2431,2294,137,30,28,2,1,99.58609272,NoArch
2df0775d2f368b326e3ac6442ce4850e3fe62edc,10,664,268,396,932,1,0,1,9,197,1,2,2.160934993,1909,2,0,0,193,173,20,12385,9727,2658,82,72,10,1,99.83450559,NoArch
8466975290773f5e0d19a16d2c36c05d64ea5134,10,254,650,396,904,0,1,1,8,6,1,2,2.200533077,2305,1,0,0,173,193,20,9727,12385,2658,72,82,10,1,99.83450559,NoArch
7bbbf92cd699dd82240caa395ee5f6136f22f2b0,10,664,268,396,932,1,0,1,9,197,1,2,2.160934993,1909,2,18,0,193,173,20,12385,9727,2658,82,72,10,1,99.83450559,NoArch
b8c37b32256113bd64f35f0b97e673d74ef61db2,6,52,6,46,58,1,0,1,28,999,1,4,1.211483034,1490,4,0,0,183,176,7,8935,8636,299,115,113,2,2,99.91742362,NoArch
b84f64023c4a8e61d1274fc8a3e9c26acfb15c5b,2,26,4,22,30,0,0,0,29,0,1,2,1,924,7,0,0,132,132,0,4606,4606,0,86,86,0,1,100,NoArch
c412267d1d32ab10a929f189cb53cfb3cc619300,9,40,79,39,119,0,1,1,76,1196,1,6,2.494874179,3623,3,0,0,546,181,365,22662,8846,13816,262,113,149,1,99.91742362,NoArch
03a3d6f9affa0e70858725bccb11756f975784fb,9,79,40,39,119,1,0,1,75,538,1,6,2.494874179,3584,4,19,1,549,546,3,22737,22662,75,262,262,0,1,99.91742362,NoArch
164ee588cf822588df2c877f07ba03cb1a4a9482,9,43,79,36,122,0,1,1,76,1136,1,6,2.487271603,3623,3,1,1,547,181,366,22710,8846,13864,262,113,149,1,99.91742362,NoArch
ba11ddab1558f408905d0f730096e9963cb58f4c,11,114,43,71,157,1,0,1,75,576,1,8,2.921064456,3771,4,20,2,584,547,37,23924,22710,1214,271,262,9,1,99.91742362,NoArch
53a9af762acbfdc734a3cadf7d3c6d8736e1ec61,11,45,115,70,160,0,1,1,76,236,1,8,2.97031573,3842,3,2,2,582,216,366,23897,10033,13864,271,122,149,1,99.91742362,NoArch
ff5099c85ddb668af8a80560d706a8914f717356,15,382,93,289,475,2,0,2,91,611,1,11,2.576564748,5704,4,21,3,997,946,51,36435,34723,1712,429,413,16,1,99.71134021,NoArch
5040c6413b112665cd051c415f368f9a51426b97,3,35,2,33,37,0,0,0,76,183,1,2,1.041464763,2065,7,488,0,371,0,371,14074,93,13981,149,0,149,1,100,NoArch
1f9553a759d05b46e91e7380699b0c646fa21e86,35,519,2334,1815,2853,0,10,10,90,1053,1,18,3.995551522,11066,3,0,0,1377,1481,104,52250,61344,9094,579,631,52,1,98.55252275,NoArch
c7a3c960902abffcbd3e9caf084f0dc5fae9f7f0,37,2373,556,1817,2929,10,0,10,91,939,1,19,4.120295253,9350,4,22,4,1500,976,524,62743,37432,25311,644,423,221,1,98.55252275,NoArch
48b2abca0f3b7873519f3566eb46a49cb4d15db7,6,75,41,34,116,0,0,0,10,340,1,2,2.493440314,818,2,32,0,140,83,57,4032,2761,1271,33,23,10,1,100,NoArch
41653853c66143796e0bac503064e24cc0353a87,4,4,10,6,14,0,0,0,6,0,1,1,1.863120569,523,3,23,5,90,90,0,2270,2270,0,17,17,0,1,100,NoArch
a79b4366305d8796aeac60bb7b68bfc86fbde804,0,0,0,0,0,0,0,0,0,0,0,0,0,0,0,24,6,0,0,0,0,0,0,0,0,0,1,100,NoArch
2e25d2edd2d06c665502afe788c197a63ce663fa,0,0,0,0,0,0,0,0,0,0,0,0,0,0,0,25,7,0,0,0,0,0,0,0,0,0,1,100,NoArch
ea23e37f8fe3bc87248d917dd539575103aacfef,0,0,0,0,0,0,0,0,0,0,0,0,0,0,0,0,0,0,0,0,0,0,0,0,0,0,0,100,NoArch
4b69cb20ad51d80b9404b505c4550dec1ba32df5,40,63,63,0,126,0,0,0,93,1930,1,24,5.123717423,14629,3,26,5,2091,2091,0,67061,67061,0,1084,1084,0,1,100,NoArch
706d8ce0da8aa595061e880288682385cc77a0d0,6,70,70,0,140,0,0,0,16,1104,1,5,1.412253883,2490,3,27,6,294,294,0,13971,13971,0,185,185,0,1,100,NoArch
42afa621c8a3ce6fc2d1de73b15db5f253e5990d,0,0,0,0,0,0,0,0,0,0,0,0,0,0,0,28,7,0,0,0,0,0,0,0,0,0,1,100,NoArch
8bc495109e8be07dc4fb502131414059cbf7e3ca,262,1282,1286,4,2568,0,0,0,94,2047,1,62,6.995285848,67022,2,29,8,8408,8413,5,372830,375162,2332,4162,4162,0,1,99.91786448,NoArch
2bbb99602e9e925058ead86fc8ac4e27055b05d6,517,518,518,0,1036,0,0,0,95,1544,2,71,9.012947284,89190,2,30,9,10147,10147,0,453604,453604,0,5341,5341,0,1,100,NoArch
61ab73837a56b5ce89b6a05d205b38b78d58cea9,45,8,181,173,189,0,0,0,77,40,1,15,4.833284539,12084,2,31,10,1600,1600,0,71633,73162,1529,805,805,0,1,90.36850921,Arch
6a4dd09b8d24c2c62420f2eaf90365789606b2e3,14,51,54,3,105,0,0,0,42,0,1,9,3.113669592,3289,2,32,11,300,300,0,20666,20748,82,216,216,0,1,100,NoArch
a3e05bee1c81b54eed8cb37b278652cf80666121,9,11,11,0,22,0,0,0,41,0,1,5,3.095795255,4374,2,33,12,465,465,0,19709,19740,31,364,364,0,1,100,NoArch
a7a43da6de9bd44e57e057319127c64b2fca56a0,2,8,0,8,8,0,0,0,96,10,1,2,0.954434003,1727,4,34,12,448,0,448,10337,0,10337,193,0,193,1,100,NoArch
673261c8656124cc58bee65fe5e8c779350779ee,3,106,10,96,116,1,0,1,39,10,1,3,1.126456155,716,1,9,0,106,97,9,3216,2880,336,62,58,4,1,98.85198852,NoArch
37bd84dc608c39f611c19557d4b2d1052d08db32,0,0,0,0,0,0,0,0,0,0,0,0,0,0,0,10,1,0,0,0,0,0,0,0,0,0,1,100,NoArch
7f9cbca12af13d4b8b5709edba2bae4d4a808102,2,30,6,24,36,0,0,0,26,74,1,2,0.918295834,1059,7,0,0,118,94,24,5896,2892,3004,80,62,18,1,100,NoArch
027d196fd3f6f990977a4e86c1c07464506cabc3,2,75,2,73,77,0,0,0,4,82,1,2,0.964547659,396,4,0,0,42,20,22,2657,595,2062,40,20,20,1,99.92125984,NoArch
51a92fea4ad197c6f8ddd91cefc1e35840c15c4a,0,0,0,0,0,0,0,0,0,0,0,0,0,0,0,1,0,0,0,0,0,0,0,0,0,0,1,100,NoArch
e74ab07e9a37650baac391da3d0d7a9cb626ad85,0,0,0,0,0,0,0,0,0,0,0,0,0,0,0,2,1,0,0,0,0,0,0,0,0,0,0,100,NoArch
517e617d450074ba00781e7b9ff90a6ff0b10ee7,0,0,0,0,0,0,0,0,0,0,0,0,0,0,0,3,2,0,0,0,0,0,0,0,0,0,0,100,NoArch
340ef224eb856c7c5472051b4e5f9b30ce628f03,4,42,20,22,62,0,0,0,79,136,1,3,1.423050818,3276,4,489,0,549,544,5,21662,21528,134,211,209,2,1,100,NoArch
338f250b69af0e577304aed7ec24be7b16c38f7c,4,20,42,22,62,0,0,0,78,0,1,3,1.423050818,3298,3,35,0,544,549,5,21528,21662,134,209,211,2,1,100,NoArch
407c48afdb9cb31f477d64b966184a5766545e3c,4,42,20,22,62,0,0,0,79,136,1,3,1.423050818,3276,4,490,1,549,544,5,21662,21528,134,211,209,2,1,100,NoArch
9c200c993147dd3ac0b5f6ed94b558ad863d7c18,0,0,0,0,0,0,0,0,0,0,0,0,0,0,0,491,2,0,0,0,0,0,0,0,0,0,1,100,NoArch
26894395cb480790488e0db283f8a503bd093909,2,12,6,6,18,0,0,0,97,159,1,2,0.99107606,1790,4,492,3,447,445,2,11137,11095,42,192,191,1,1,100,NoArch
61befce7e70aeb13ab5a8d6ff3c336d4f982b9a9,0,0,0,0,0,0,0,0,0,0,0,0,0,0,0,493,4,0,0,0,0,0,0,0,0,0,1,100,NoArch
94f12b85c3d269cdb510f8c0b843008469e4f826,1,9,2,7,11,0,0,0,14,189,1,1,0,348,2,494,4,89,88,1,2174,2138,36,24,24,0,1,100,NoArch
86bc2604c6832a56f806121dcde5fd3e91c9d3a4,0,0,0,0,0,0,0,0,0,0,0,0,0,0,0,0,0,0,0,0,0,0,0,0,0,0,0,100,NoArch
5c270dad2a281f4e70fb8c8a657d93a0cc72b7a8,0,0,0,0,0,0,0,0,0,0,0,0,0,0,0,495,1,0,0,0,0,0,0,0,0,0,1,100,NoArch
82a57ada210dcda48a206b3ab47cb320a3e96bec,2,290,0,290,290,0,0,0,10,266,1,2,0.182138465,3350,5,0,0,346,0,346,18627,0,18627,321,0,321,1,100,NoArch
463fbc07df0072570789a2b36592def8f3611fd0,0,0,0,0,0,0,0,0,0,0,0,0,0,0,0,496,0,0,0,0,0,0,0,0,0,0,1,100,NoArch
33c165b32eb73547905362766991b46765fba686,2,0,290,290,290,0,0,0,9,0,1,2,0.182138465,3640,4,112,0,337,346,9,16076,18627,2551,312,321,9,0,100,NoArch
bdeb76be063268756ebe84983475a93ee3fdc59b,2,290,0,290,290,0,0,0,10,266,1,2,0.182138465,3350,5,10,0,346,0,346,18627,0,18627,321,0,321,0,100,NoArch
79e4e9d41002ee8677cbd64148a62a0035d5512e,0,0,0,0,0,0,0,0,0,0,0,0,0,0,0,11,1,0,0,0,0,0,0,0,0,0,0,100,NoArch
3b6658dfcfea85e140420de207fb29d583a6df0e,0,0,0,0,0,0,0,0,0,0,0,0,0,0,0,12,2,0,0,0,0,0,0,0,0,0,1,100,NoArch
0f25ed1f6a78ad0356f4d0202f570cf09ed3f601,9,1149,0,1149,1149,9,0,9,1,0,1,2,3.052985933,0,1,0,0,121,0,121,5766,0,5766,72,0,72,1,98.95913647,NoArch
238714d324d1623f144ca09c0dfb10330a2ba2c4,18,266,1167,901,1433,1,9,10,98,112,1,6,3.621903171,8783,0,0,0,1148,1199,51,42546,35244,7302,608,624,16,1,90.46372476,Arch
d5eeeed469fc7de4e141042da9b347d18c084b9e,9,1149,0,1149,1149,9,0,9,1,0,1,2,3.052985933,0,1,497,0,121,0,121,5766,0,5766,72,0,72,1,98.9427634,NoArch
b71dcf24f252da5858bd95bfd4bd56402e3a458c,0,0,0,0,0,0,0,0,0,0,0,0,0,0,0,2,0,0,0,0,0,0,0,0,0,0,1,100,NoArch
18164dc87649265c85f1dca76efd4ac5d16424dc,0,0,0,0,0,0,0,0,0,0,0,0,0,0,0,9,0,0,0,0,0,0,0,0,0,0,1,100,NoArch
5e8168a25494b04ef0aeaf6421a033d7192f5625,1,1,1,0,2,0,0,0,12,131,1,1,0,2616,8,0,0,305,305,0,9012,9012,0,282,282,0,1,100,NoArch
5f885281acb5a4c3e6bae402761036828c6736d4,0,0,0,0,0,0,0,0,0,0,0,0,0,0,0,36,0,0,0,0,0,0,0,0,0,0,1,100,NoArch
d8ad935132bc5a375f339c5aa18af36423628b59,0,0,0,0,0,0,0,0,0,0,0,0,0,0,0,13,0,0,0,0,0,0,0,0,0,0,1,100,NoArch
cf2f30336efe0ecc3debc7bede86fde6d23f7c79,6,185,1,184,186,2,0,2,42,424,1,4,1.481711093,720,4,10,0,81,9,72,4634,322,4312,46,8,38,1,95.40186916,Arch
ff1e23f2bdb5bd49ecbd20817647b65badc1e681,0,0,0,0,0,0,0,0,0,0,0,0,0,0,0,0,0,0,0,0,0,0,0,0,0,0,0,100,NoArch
390a85409006f829d4d3564c2308c06ade211920,0,0,0,0,0,0,0,0,0,0,0,0,0,0,0,0,0,0,0,0,0,0,0,0,0,0,1,100,NoArch
67204b83ddbce6d62f48fdf9dbe073f0b9f3abf1,0,0,0,0,0,0,0,0,0,0,0,0,0,0,0,0,0,0,0,0,0,0,0,0,0,0,0,100,NoArch
b41da12492f084c0da0af84e37711348f92f0898,0,0,0,0,0,0,0,0,0,0,0,0,0,0,0,1,1,0,0,0,0,0,0,0,0,0,0,100,NoArch
e1c30a236a6b8244fc6e78e759c886617e9a05fb,0,0,0,0,0,0,0,0,0,0,0,0,0,0,0,37,0,0,0,0,0,0,0,0,0,0,1,100,NoArch
dc15bfcdbb210396f4cf0580e485e7776d77d383,0,0,0,0,0,0,0,0,0,0,0,0,0,0,0,1,0,0,0,0,0,0,0,0,0,0,0,100,NoArch
e83caaf341af5368cf39a461bb5a15fe6108a21b,0,0,0,0,0,0,0,0,0,0,0,0,0,0,0,2,1,0,0,0,0,0,0,0,0,0,1,100,NoArch
b814cd0b76b63b08cd7772f43c3cb904a1dcbff5,18,1703,66,1637,1769,3,0,3,73,675,1,8,2.534364845,3663,5,0,0,675,486,189,27002,18095,8907,342,211,131,1,99.37718957,NoArch
3efbd4c1a5d81966ab5dd01b394c4b0a188bf871,0,0,0,0,0,0,0,0,0,0,0,0,0,0,0,14,0,0,0,0,0,0,0,0,0,0,1,100,NoArch
fec162dda29ecbf36579ebb61a666bd17ed9bb01,0,0,0,0,0,0,0,0,0,0,0,0,0,0,0,15,1,0,0,0,0,0,0,0,0,0,0,100,NoArch
a943df760f6df520702a54e9b061e98250172c8e,0,0,0,0,0,0,0,0,0,0,0,0,0,0,0,16,2,0,0,0,0,0,0,0,0,0,1,100,NoArch
355d51ba1e09ae73737160880ee2f07f953ceb6e,0,0,0,0,0,0,0,0,0,0,0,0,0,0,0,15,1,0,0,0,0,0,0,0,0,0,0,100,NoArch
4505b498da9800f2d3143d7487ee07e99177808b,0,0,0,0,0,0,0,0,0,0,0,0,0,0,0,18,4,0,0,0,0,0,0,0,0,0,1,100,NoArch
993cedea14eb511e6341e1ed2692112bd253e3d3,0,0,0,0,0,0,0,0,0,0,0,0,0,0,0,17,3,0,0,0,0,0,0,0,0,0,0,100,NoArch
389231ef31b02d444a73105ea4d6b5e0cbaac1d4,0,0,0,0,0,0,0,0,0,0,0,0,0,0,0,19,5,0,0,0,0,0,0,0,0,0,1,100,NoArch
f7f2f82cc511e334db25015d32a911addce0c064,18,66,1703,1637,1769,0,3,3,72,952,1,8,2.534364845,5300,4,3,2,486,675,189,18095,27002,8907,211,342,131,0,99.37718957,NoArch
c83acd5ac1443c9afd5ae06eb5e3a802c2b1eeee,0,0,0,0,0,0,0,0,0,0,0,0,0,0,0,4,3,0,0,0,0,0,0,0,0,0,0,100,NoArch
2cf3c9909a970039b7f85af4c59bf5fd8068bc88,18,1703,66,1637,1769,3,0,3,73,675,1,8,2.534364845,3663,5,1,0,675,486,189,27002,18095,8907,342,211,131,0,99.37718957,NoArch
377bc5848d066a851560fb921b6b77996f7d150f,0,0,0,0,0,0,0,0,0,0,0,0,0,0,0,2,1,0,0,0,0,0,0,0,0,0,1,100,NoArch
54a79769987d78384899062b59d413412c577de3,0,0,0,0,0,0,0,0,0,0,0,0,0,0,0,20,6,0,0,0,0,0,0,0,0,0,0,100,NoArch
6b6ddfeb920f901d851ca12c6be3476ca00a58a9,0,0,0,0,0,0,0,0,0,0,0,0,0,0,0,22,8,0,0,0,0,0,0,0,0,0,1,100,NoArch
bbd41db436a8185e9c66cf3c59272d7a65f80ecc,0,0,0,0,0,0,0,0,0,0,0,0,0,0,0,1,0,0,0,0,0,0,0,0,0,0,0,100,NoArch
a11bd49e86d50f5a840ab2cdfe4f6927bedb4f93,0,0,0,0,0,0,0,0,0,0,0,0,0,0,0,0,0,0,0,0,0,0,0,0,0,0,1,100,NoArch
f20b566febaac5d68a16802350272d8517c3775f,0,0,0,0,0,0,0,0,0,0,0,0,0,0,0,3,2,0,0,0,0,0,0,0,0,0,0,100,NoArch
a9f286b6d27d432ba2028495ec9ecd251382108f,0,0,0,0,0,0,0,0,0,0,0,0,0,0,0,4,3,0,0,0,0,0,0,0,0,0,0,100,NoArch
8be63e391e698f743c4c84ce5708fd472f62e469,0,0,0,0,0,0,0,0,0,0,0,0,0,0,0,8,4,0,0,0,0,0,0,0,0,0,0,100,NoArch
787be93d3cb1ef8f90e9e136cff6b0d2b66f4bcb,0,0,0,0,0,0,0,0,0,0,0,0,0,0,0,9,5,0,0,0,0,0,0,0,0,0,0,100,NoArch
089ee708b2b2deb0a3cb1f1c937288954c6a5700,0,0,0,0,0,0,0,0,0,0,0,0,0,0,0,23,9,0,0,0,0,0,0,0,0,0,1,100,NoArch
47923b7bec3ed1326941ad4db5cef9babfd2d106,0,0,0,0,0,0,0,0,0,0,0,0,0,0,0,0,0,0,0,0,0,0,0,0,0,0,0,100,NoArch
421a37058d305a9f723aba0912bca25f4dad30b8,0,0,0,0,0,0,0,0,0,0,0,0,0,0,0,24,10,0,0,0,0,0,0,0,0,0,0,100,NoArch
563e79d0f2d64b64d5407f1c3b8b579b91f6446d,0,0,0,0,0,0,0,0,0,0,0,0,0,0,0,25,11,0,0,0,0,0,0,0,0,0,1,100,NoArch
d695a50ae56398b7daeac40f9a0bbbd605b68731,1,6,4,2,10,0,0,0,7,66,1,1,0,335,5,1,0,12,12,0,2225,2179,46,10,10,0,1,100,NoArch
b4ede4b116b24b5308e8419504a73e02b7f7e406,12,410,14,396,424,1,0,1,80,589,1,8,2.884599258,4643,8,0,0,909,320,589,28787,11082,17705,334,119,215,1,99.92242048,NoArch
764c9322c136f0e3b8bd1e3f646d683321927e1a,0,0,0,0,0,0,0,0,0,0,0,0,0,0,0,1,1,0,0,0,0,0,0,0,0,0,1,100,NoArch
c9a62f3c2530f5c957edca4b5096f74c78b408a3,0,0,0,0,0,0,0,0,0,0,0,0,0,0,0,26,3,0,0,0,0,0,0,0,0,0,1,100,NoArch
8d2a2ce10db3fdef107f834a0fe0c9297b043a94,1,68,10,58,78,0,0,0,22,914,1,1,0,1752,4,1,0,312,290,22,10519,9998,521,181,181,0,0,100,NoArch
9373b13259181895faab95b02d7576ad51260249,0,0,0,0,0,0,0,0,0,0,0,0,0,0,0,2,0,0,0,0,0,0,0,0,0,0,0,100,NoArch
63d0524a75b753dc4cf679ef9e2f423a639196c6,0,0,0,0,0,0,0,0,0,0,0,0,0,0,0,3,1,0,0,0,0,0,0,0,0,0,0,100,NoArch
0ebd2c8448979daf97b5d1605d85de6b36c434a9,0,0,0,0,0,0,0,0,0,0,0,0,0,0,0,4,2,0,0,0,0,0,0,0,0,0,0,100,NoArch
46d2c8b5da67b87f8f427140cb6964c3125c84cb,0,0,0,0,0,0,0,0,0,0,0,0,0,0,0,0,0,0,0,0,0,0,0,0,0,0,0,100,NoArch
8e069398b7da9d74f3b46a430ea869470eb299da,0,0,0,0,0,0,0,0,0,0,0,0,0,0,0,5,3,0,0,0,0,0,0,0,0,0,0,100,NoArch
26700949812e39f6ddedc63c53f8cb5562fd7f15,2,2,0,2,2,0,0,0,16,94,1,1,1,192,7,0,0,11,0,11,726,0,726,6,0,6,1,100,NoArch
943411d20d27c9f11f9bd0311ae5c4438b7cc81c,1,9,2,7,11,0,0,0,23,8,1,1,0,1810,4,2,1,313,312,1,10571,10519,52,181,181,0,1,100,NoArch
95234db14b7afca9593829f43c41a9851e08dcd7,26,210,145,65,355,0,0,0,99,769,1,18,4.054734857,15649,3,6,4,2604,2603,1,89768,89384,384,1153,1153,0,0,100,NoArch
9855529f1af979ade479d5658bbe90917ae2734b,0,0,0,0,0,0,0,0,0,0,0,0,0,0,0,0,0,0,0,0,0,0,0,0,0,0,0,100,NoArch
d799e1829a39ca0379f3e12d2e8cfdf5fcd26151,16,277,147,130,424,1,0,1,100,114,1,12,3.127280101,9170,3,7,5,1947,1810,137,52383,48358,4025,706,638,68,1,95.06454062,Arch
c78a3d5ea4e7e511ba9f6182157956db3e65e1a0,13,95,107,12,202,0,1,1,96,684,1,9,3.072479363,4946,4,8,6,970,962,8,29384,29449,65,338,335,3,0,99.92553984,NoArch
fd26721a5b333d59ebf37d39ed69fedcf33dc8dd,1,4,2,2,6,0,0,0,66,0,1,1,0,1144,8,9,7,149,149,0,7653,7625,28,99,99,0,0,100,NoArch
25032e10a86851bdabfa29b99885ccfc03c6667e,97,1536,1876,340,3412,0,1,1,78,730,1,21,5.533997794,26812,3,2,0,2399,2332,67,166047,163404,2643,1507,1451,56,1,95.49005682,Arch
9e60e59c53e006629a341822a39a22fa35f8270c,0,0,0,0,0,0,0,0,0,0,0,0,0,0,0,0,0,0,0,0,0,0,0,0,0,0,1,100,NoArch
a318a34d1f5f8146fb441c092c73b6170719e88a,3,101,29,72,130,0,0,0,101,12,1,1,1.114729977,2524,11,10,8,614,605,9,14625,14303,322,268,263,5,1,99.8982706,NoArch
33f7177e66e04c4843676e3d7a9cf739ba812304,0,0,0,0,0,0,0,0,0,0,0,0,0,0,0,3,0,0,0,0,0,0,0,0,0,0,1,100,NoArch
6527d6d1d5081d38168b9ea14bd7d715c5e2af8d,0,0,0,0,0,0,0,0,0,0,0,0,0,0,0,1,1,0,0,0,0,0,0,0,0,0,1,100,NoArch
aa5860fc355d7d44c3d567fdb1fb2d20ad474cc0,1,14,3,11,17,0,0,0,10,114,1,1,0,204,6,0,0,24,23,1,1114,1038,76,7,7,0,1,100,NoArch
c4386ad21f16b4fdd761eeb5ac4332f6221aac3f,1,12,92,80,104,0,0,0,77,17,1,1,0,1134,13,3,1,222,243,21,5107,5477,370,74,78,4,1,100,NoArch
409dac80e9e042f308d097f64b496df122c58dd2,3,96,128,32,224,1,2,3,6,102,1,1,1.556254104,128,2,0,0,5,6,1,398,525,127,3,2,1,1,90.27088897,Arch
9623e50cb0da0140fd0427c04f6fa29b518e4034,0,0,0,0,0,0,0,0,0,0,0,0,0,0,0,11,9,0,0,0,0,0,0,0,0,0,0,100,NoArch
33bbf35c3dcc6a89b8ac6a8433ccf4bca21c7435,0,0,0,0,0,0,0,0,0,0,0,0,0,0,0,12,10,0,0,0,0,0,0,0,0,0,0,100,NoArch
561a811f671a16139403741f707da6bfdf23997c,2,49,2,47,51,0,0,0,97,3,1,2,0.462749059,1828,7,0,0,360,315,45,13154,7183,5971,126,94,32,0,100,NoArch
43dbc590a0ef1d954b505b14c1f48b66f10f650a,1,1,1,0,2,0,0,0,24,47,1,1,0,326,5,0,0,47,47,0,1470,1470,0,17,17,0,0,100,NoArch
c8ea9dac88b112d8bb282b9502cd463bf9249396,1,0,1,1,1,0,0,0,43,0,1,1,0,692,7,13,11,45,45,0,5952,5961,9,32,32,0,0,100,NoArch
c6f772b408046c61b3269d8aecc5f1684bcad6fb,8,93,9,84,102,3,0,3,26,585,1,3,2.537838264,2067,4,0,0,319,316,3,9377,9221,156,164,161,3,1,90.29618083,Arch
207d4ff95d4dd48a4267e3d2577f86b304d0b11b,1,2,35,33,37,0,0,0,21,942,1,1,0,175,4,14,12,27,31,4,671,865,194,18,20,2,0,100,NoArch
4fad66df0132c815a2a74c01704168d87f47009f,1,21,0,21,21,0,0,0,22,0,1,1,0,142,4,15,13,30,0,30,793,0,793,19,0,19,0,100,NoArch
ca1ef06d87424630f80ade31afcd8a1108dd5fed,0,0,0,0,0,0,0,0,0,0,0,0,0,0,0,2,2,0,0,0,0,0,0,0,0,0,1,100,NoArch
bb6a79ea79315037956c1665b83b8c80a3016c73,0,0,0,0,0,0,0,0,0,0,0,0,0,0,0,27,0,0,0,0,0,0,0,0,0,0,0,100,NoArch
07bd95a82f93458196d44f8e285435a865d3d70d,7,56,93,37,149,0,0,0,12,770,1,1,2.699387797,736,2,1,1,79,80,1,2679,2744,65,54,55,1,1,100,NoArch
6d4f6bef8d03f6bb5d452b65e68074f11892ccbf,0,0,0,0,0,0,0,0,0,0,0,0,0,0,0,4,2,0,0,0,0,0,0,0,0,0,1,100,NoArch
4a8e814327be1f18b203784778f8b17d7f9da8b0,0,0,0,0,0,0,0,0,0,0,0,0,0,0,0,0,0,0,0,0,0,0,0,0,0,0,1,100,NoArch
9bf8b01243b059911dc042ed2b0ecf4729005cf0,0,0,0,0,0,0,0,0,0,0,0,0,0,0,0,5,3,0,0,0,0,0,0,0,0,0,1,100,NoArch
a8875da2cff6bd08c4169f3126b1871f09c557e3,0,0,0,0,0,0,0,0,0,0,0,0,0,0,0,6,4,0,0,0,0,0,0,0,0,0,1,100,NoArch
88de5c89207d92f402cf250f2225bf7898af3c0c,0,0,0,0,0,0,0,0,0,0,0,0,0,0,0,28,1,0,0,0,0,0,0,0,0,0,0,100,NoArch
40a5e6ae4cc4cd2d8065880c2641d640d1ca2f8f,1,33,0,33,33,0,0,0,2,12,1,1,0,96,1,2,2,6,0,6,561,0,561,4,0,4,1,100,NoArch
80632f46e75f447739c2fe91b13d26910bc527ac,0,0,0,0,0,0,0,0,0,0,0,0,0,0,0,29,2,0,0,0,0,0,0,0,0,0,0,100,NoArch
71be8a456ffb250abb22f2a956ae0c6acd5104fa,1,47,80,33,127,0,0,0,5,17,1,1,0,280,3,7,5,15,15,0,1893,1945,52,12,12,0,1,100,NoArch
113ea7f4397fd9a24746d1ab7c8124d3c3bf6bac,0,0,0,0,0,0,0,0,0,0,0,0,0,0,0,1,1,0,0,0,0,0,0,0,0,0,1,100,NoArch
5bd23ddf297952d816166083f2f02b83abae344a,0,0,0,0,0,0,0,0,0,0,0,0,0,0,0,30,3,0,0,0,0,0,0,0,0,0,0,100,NoArch
89f3503af2acc7a6ef52bde01d4961a7f49899a8,1,2,1,1,3,0,0,0,24,41,1,1,0,1817,5,2,0,313,313,0,10587,10571,16,181,181,0,1,100,NoArch
a7fb39172ddec93e289127e1a58d7ea1e0b3a498,6,97,122,25,219,0,0,0,102,27,1,4,2.211810353,3899,7,16,8,681,681,0,25307,25527,220,321,320,1,1,100,NoArch
21098529e659743e551f2c35652d1a93c1528082,4,45,10,35,55,0,0,0,84,16,1,2,1.397786827,1252,10,17,9,264,233,31,7727,6674,1053,81,62,19,0,100,NoArch
fe6a2fc4c4178633d85d84657520967893f18aec,0,0,0,0,0,0,0,0,0,0,0,0,0,0,0,4,1,0,0,0,0,0,0,0,0,0,1,100,NoArch
e6a3126e6f23ddabf829e47efa27d4ec2f76f7e0,0,0,0,0,0,0,0,0,0,0,0,0,0,0,0,5,2,0,0,0,0,0,0,0,0,0,0,100,NoArch
eb06f71861025c9261b5ad7a09cab0c46f2ac311,14,85,310,225,395,0,2,2,79,363,1,8,2.377382028,3310,3,31,4,311,292,19,19471,17017,2454,180,165,15,1,93.59831164,Arch
39500088491512aeccf3e9dc7b76d99b91a82436,0,0,0,0,0,0,0,0,0,0,0,0,0,0,0,6,3,0,0,0,0,0,0,0,0,0,1,100,NoArch
e04c2c291395339b8eb488a5e045500d366553b6,1,11,7,4,18,0,0,0,9,38,1,1,0,351,6,32,5,12,12,0,2264,2274,10,10,10,0,1,100,NoArch
04d4423d4ee4f86e308fa761c6918223b55a6c5c,6,108,0,108,108,0,0,0,78,229,1,3,1.802988042,1981,8,18,8,286,0,286,9850,0,9850,106,0,106,1,100,NoArch
021c01c4c2756f793a4eee3a0f914c2c131823ac,3,185,15,170,200,0,0,0,103,30,1,3,1.336666482,2411,11,19,9,537,8,529,16115,680,15435,244,7,237,1,100,NoArch
01a347e996a20406b0bf13026dd375725c4efb7f,3,55,4,51,59,1,0,1,85,16,1,2,1.480725487,2083,10,0,0,379,227,152,14190,6452,7738,155,55,100,1,99.92977528,NoArch
619c6c0bf5b3440cfe80fff8b1c399b91d1d69db,1,17,0,17,17,0,0,0,2,0,1,1,0,17,2,3,0,0,0,0,76,0,76,0,0,0,1,100,NoArch
f86da24a94fb0cd9d31f266c2639f4b82a3392b7,0,0,0,0,0,0,0,0,0,0,0,0,0,0,0,0,0,0,0,0,0,0,0,0,0,0,0,100,NoArch
fe58b5a5d434c60bf3971a5dce4079bde33363d7,1,153,34,119,187,0,0,0,25,31,1,1,0,1818,5,4,1,332,313,19,11311,10587,724,191,181,10,1,100,NoArch
008b19051b0de6b81a57b93442b341916a6acf8a,0,0,0,0,0,0,0,0,0,0,0,0,0,0,0,5,2,0,0,0,0,0,0,0,0,0,0,100,NoArch
2950a10eb9bbaf4f6a52f4692f6a151e00997cd1,0,0,0,0,0,0,0,0,0,0,0,0,0,0,0,6,3,0,0,0,0,0,0,0,0,0,1,100,NoArch
563cfb76e846e307426afd020d3e8c59d29cc1df,0,0,0,0,0,0,0,0,0,0,0,0,0,0,0,0,0,0,0,0,0,0,0,0,0,0,0,100,NoArch
d3c726fce8d5dd9632960939858af134895ff3ea,1,1,1,0,2,0,0,0,17,73,1,1,0,183,5,0,0,20,20,0,897,897,0,10,10,0,1,100,NoArch
39ec1a3f0addfce06869f705f7a17c03d538fe16,1,1,1,0,2,0,0,0,14,73,1,1,0,2617,10,0,0,305,305,0,9018,9018,0,282,282,0,1,100,NoArch
6eb25603b96169bf8d77269176218c63c181e9f4,6,237,69,168,306,0,0,0,37,205,1,5,2.280589437,2716,9,3,1,505,351,154,14773,10388,4385,188,123,65,1,100,NoArch
226013fdc311fca600af1207e756518e1b153de8,0,0,0,0,0,0,0,0,0,0,0,0,0,0,0,1,1,0,0,0,0,0,0,0,0,0,1,100,NoArch
bbea1cec3ed6ffae631b4c0d975639a098687ab4,2,14,7,7,21,0,0,0,98,62,1,2,0.453716339,1874,8,2,2,361,360,1,13199,13145,54,127,126,1,1,100,NoArch
30a5725789d4cf77beec0e504371a766529ad7a0,0,0,0,0,0,0,0,0,0,0,0,0,0,0,0,7,3,0,0,0,0,0,0,0,0,0,0,100,NoArch
e2e11cba3303b189f090383c931f0ae60c4fa952,2,16,0,16,16,0,0,0,34,4,1,2,1,1134,10,20,4,182,0,182,6258,0,6258,94,0,94,1,100,NoArch
0beb39d78f6bdccb803b8c6eb58af02b2cc80429,2,120,1,119,121,1,0,1,104,13,1,2,0.318855419,1717,1,0,0,461,458,3,10812,10137,675,195,193,2,1,99.54513646,NoArch
734eddefb2b271cdbe5386f6f78a17d7a7a1809e,1,17,0,17,17,0,0,0,2,0,1,1,0,114,2,21,5,2,0,2,641,0,641,2,0,2,0,100,NoArch
3e5cf4a94dd1f71e42a45c812f26a53c7b89e945,0,0,0,0,0,0,0,0,0,0,0,0,0,0,0,0,0,0,0,0,0,0,0,0,0,0,1,100,NoArch
6583fcce6d32627c55faf9e1df35cc353b8c8841,3,110,0,110,110,1,0,1,15,357,1,2,1.368297198,757,4,0,0,106,0,106,4070,0,4070,48,0,48,1,99.75652174,NoArch
ee5008d9ed66f3237cf1304484b1d1e6836c8a33,2,71,4,67,75,0,0,0,21,535,1,2,0.996791632,337,5,0,0,40,28,12,2373,1913,460,29,22,7,1,100,NoArch
b07dfbcc6c37da1b730a4bd897d4cfdeabe63cdc,0,0,0,0,0,0,0,0,0,0,0,0,0,0,0,1,1,0,0,0,0,0,0,0,0,0,0,100,NoArch
b991c93ad1238a1b128213a5d7ef754ddeaa827e,0,0,0,0,0,0,0,0,0,0,0,0,0,0,0,0,0,0,0,0,0,0,0,0,0,0,0,100,NoArch
54fc3f53807f7cfa535100d826e19e66aa5cad8e,0,0,0,0,0,0,0,0,0,0,0,0,0,0,0,2,2,0,0,0,0,0,0,0,0,0,1,100,NoArch
d9d95871441b015353429585baa3ae821fdb39c1,2,49,1,48,50,1,0,1,30,508,1,1,0.327444919,132,1,0,0,17,13,4,949,669,280,8,5,3,1,99.54861111,NoArch
b5bec5ca18901507f6fc01d635f10465fd3edcdf,0,0,0,0,0,0,0,0,0,0,0,0,0,0,0,0,0,0,0,0,0,0,0,0,0,0,3,100,NoArch
3299a9f0fa36367c7b5a68dc6bde633fe6e1ae1c,0,0,0,0,0,0,0,0,0,0,0,0,0,0,0,0,0,0,0,0,0,0,0,0,0,0,0,100,NoArch
c5aa1d6962ee16812d8d8c19b167b1b256e8002f,3,41,3,38,44,0,0,0,10,678,1,2,1.219748493,298,3,3,3,40,37,3,1621,1540,81,13,12,1,1,100,NoArch
0e6df4837b1032a51e7fd85c95451781991d4856,0,0,0,0,0,0,0,0,0,0,0,0,0,0,0,0,0,0,0,0,0,0,0,0,0,0,1,100,NoArch
b64081ee174e5b5aefcd93c3bc6c5aefe6acbf49,1,12,29,17,41,0,0,0,86,43,1,1,0,956,12,4,4,227,229,2,6420,6508,88,54,55,1,1,100,NoArch
915cb4541fa0e7d3d96646947f449cbb4b75589a,0,0,0,0,0,0,0,0,0,0,0,0,0,0,0,0,0,0,0,0,0,0,0,0,0,0,1,100,NoArch
eaa7cca922b916ab7ad0fac6e109330197f8c75f,0,0,0,0,0,0,0,0,0,0,0,0,0,0,0,0,0,0,0,0,0,0,0,0,0,0,1,100,NoArch
602a2c5b5258d5e1f0f60f71506b16801cbdf156,0,0,0,0,0,0,0,0,0,0,0,0,0,0,0,1,1,0,0,0,0,0,0,0,0,0,1,100,NoArch
0530d6cebf1979ca65b6abb7b2df080460910127,0,0,0,0,0,0,0,0,0,0,0,0,0,0,0,0,0,0,0,0,0,0,0,0,0,0,0,100,NoArch
de5d8ebc897407eda369cbbab1facff61076e780,0,0,0,0,0,0,0,0,0,0,0,0,0,0,0,0,0,0,0,0,0,0,0,0,0,0,0,100,NoArch
8c99b3409005feae42d24529687860220b7d25d6,0,0,0,0,0,0,0,0,0,0,0,0,0,0,0,0,0,0,0,0,0,0,0,0,0,0,0,100,NoArch
6eda0b41796d5d039ace7720bbd8066f0b7835e5,0,0,0,0,0,0,0,0,0,0,0,0,0,0,0,1,0,0,0,0,0,0,0,0,0,0,0,100,NoArch
eaaf263372229f9aad9970f54767e043b1e104dc,0,0,0,0,0,0,0,0,0,0,0,0,0,0,0,22,2,0,0,0,0,0,0,0,0,0,1,100,NoArch
b9409b3bee5a45e8ffc67430e6a878be564569ce,0,0,0,0,0,0,0,0,0,0,0,0,0,0,0,23,3,0,0,0,0,0,0,0,0,0,0,100,NoArch
b597c3ab93ef1c6a37a9c1fa3584d86d20723784,0,0,0,0,0,0,0,0,0,0,0,0,0,0,0,0,0,0,0,0,0,0,0,0,0,0,4,100,NoArch
7fbedbb8923bb203409f5d5576a38ac70aba9f4b,0,0,0,0,0,0,0,0,0,0,0,0,0,0,0,1,1,0,0,0,0,0,0,0,0,0,1,100,NoArch
4b1ab225fef8e8f66cb95d6605bdd4fd568929ed,0,0,0,0,0,0,0,0,0,0,0,0,0,0,0,24,4,0,0,0,0,0,0,0,0,0,1,100,NoArch
e37a52d909b913059ba4493f509ede7d46dcf0e1,0,0,0,0,0,0,0,0,0,0,0,0,0,0,0,0,0,0,0,0,0,0,0,0,0,0,0,100,NoArch
269d0ff7d3025cf3370023e353a373916dd67433,3,18,2,16,20,0,0,0,87,57,1,3,1.336666482,2533,10,25,5,490,338,152,16866,9150,7716,185,83,102,1,100,NoArch
4d07366aae24b6701c304dd5124b7c5bae5ea6ab,0,0,0,0,0,0,0,0,0,0,0,0,0,0,0,0,0,0,0,0,0,0,0,0,0,0,0,100,NoArch
c8436998ae107996c1c48c9b7efcbb98b8b92930,0,0,0,0,0,0,0,0,0,0,0,0,0,0,0,0,0,0,0,0,0,0,0,0,0,0,1,100,NoArch
6971ac739aee41bfd62dcd4031f6c848bb0b2d4e,0,0,0,0,0,0,0,0,0,0,0,0,0,0,0,1,0,0,0,0,0,0,0,0,0,0,0,100,NoArch
67dbda933bb2e1286a28fd832ea4316d34906005,0,0,0,0,0,0,0,0,0,0,0,0,0,0,0,0,0,0,0,0,0,0,0,0,0,0,1,100,NoArch
5432cd09da963bb72796729dafa2bf5954d57772,0,0,0,0,0,0,0,0,0,0,0,0,0,0,0,1,1,0,0,0,0,0,0,0,0,0,1,100,NoArch
e65411f5cce2d58588fbb96a366560f6e6803dab,4,14,14,0,28,0,0,0,35,864,1,4,1.724407818,1476,10,26,6,201,201,0,8682,8723,41,108,108,0,1,100,NoArch
595643cba16a2b4d7be68d46ee8f79c4e380cbf7,4,58,13,45,71,0,0,0,28,324,1,3,0.866987402,1946,5,0,0,270,264,6,10472,10166,306,136,133,3,1,100,NoArch
d55f5e152c288a2037d65d15a7169d76aa9be2be,2,120,1,119,121,1,0,1,26,0,1,2,0.439496987,763,1,0,0,120,117,3,4251,3637,614,43,41,2,1,99.54923717,NoArch
254ee8ff595c6c52580128aec9355394f96382d5,1,8,13,5,21,0,0,0,27,0,1,1,0,772,9,27,7,116,118,2,3626,3657,31,41,41,0,1,100,NoArch
475904893244b23e612073f9f8cf476380cec812,1,17,0,17,17,0,0,0,2,0,1,1,0,110,2,28,8,2,0,2,594,0,594,2,0,2,0,100,NoArch
beef86697a0dbd09d4d99a735f8a5afe37e5d976,0,0,0,0,0,0,0,0,0,0,0,0,0,0,0,0,0,0,0,0,0,0,0,0,0,0,1,100,NoArch
7ed38d7c7e150987ef8bf035196576fc158e03eb,23,747,73,674,820,7,0,7,99,85,1,11,3.918194014,6620,11,0,0,1248,520,728,38499,17453,21046,516,243,273,2,92.57142857,Arch
726c7bf18300ece22199b37b2c4b2b1c4cc9ffc8,0,0,0,0,0,0,0,0,0,0,0,0,0,0,0,29,9,0,0,0,0,0,0,0,0,0,0,100,NoArch
4b498e5c76569dfa7acb7e62f175075db3d314e2,4,268,0,268,268,4,0,4,11,52,1,4,1.628356075,0,1,0,0,23,0,23,975,0,975,13,0,13,1,99.76108309,NoArch
67014e575a96a1172b1601254ab7bfab19bceb88,1,2,2,0,4,0,0,0,2,0,1,1,0,137,2,30,10,13,13,0,580,580,0,5,5,0,0,100,NoArch
c011d76436a1c11c614a133ae06abbc19baf2436,0,0,0,0,0,0,0,0,0,0,0,0,0,0,0,0,0,0,0,0,0,0,0,0,0,0,0,100,NoArch
34aa0fa4c674c281c1060515dec0a72b1c973778,0,0,0,0,0,0,0,0,0,0,0,0,0,0,0,0,0,0,0,0,0,0,0,0,0,0,0,100,NoArch
a262a107ddd403e3ac5a773c735110a6565104de,3,95,6,89,101,1,0,1,40,392,1,2,1.263199462,754,1,0,0,112,103,9,3665,3270,395,64,61,3,1,99.84147952,NoArch
52a53e9520d7657bd237cae3e92e3ed015c71811,0,0,0,0,0,0,0,0,0,0,0,0,0,0,0,33,0,0,0,0,0,0,0,0,0,0,1,100,NoArch
29e1d662bafc66499e198a6af9b0920aa79695e5,0,0,0,0,0,0,0,0,0,0,0,0,0,0,0,34,1,0,0,0,0,0,0,0,0,0,0,100,NoArch
d2f92b445cf07683b7aa9afd2f69e2b23a033e6b,0,0,0,0,0,0,0,0,0,0,0,0,0,0,0,35,2,0,0,0,0,0,0,0,0,0,0,100,NoArch
6599fb29fb0ba8a2c3dba0b0e39feb31cfe2111c,0,0,0,0,0,0,0,0,0,0,0,0,0,0,0,5,0,0,0,0,0,0,0,0,0,0,0,100,NoArch
7182fda6eb3f4b8aa43016ac8c32692103b0cb9e,1,1,1,0,2,0,0,0,14,448,1,1,0,169,5,6,1,9,9,0,1037,1038,1,9,9,0,0,100,NoArch
4eb2bed0bbbf7c25d9a25ab06eb368348771e918,0,0,0,0,0,0,0,0,0,0,0,0,0,0,0,7,2,0,0,0,0,0,0,0,0,0,1,100,NoArch
b1249403bc0e9e62af8e87f61bb4a33e44007b4d,1,12,10,2,22,0,0,0,6,1086,1,1,0,1991,3,0,0,347,347,0,11677,11693,16,233,233,0,1,100,NoArch
a9ec22cce3c5d0bbde162dca99a96adf4584b429,2,10,8,2,18,0,0,0,10,76,1,2,0.650022422,420,2,8,3,21,21,0,2491,2477,14,15,15,0,0,100,NoArch
fab3d4051c6bf5cacf6bd80895a72332ae5f362f,1,4,4,0,8,0,0,0,5,1086,1,1,0,317,3,9,4,84,84,0,2096,2104,8,24,24,0,1,100,NoArch
35dd8813b6366b68ad302c38217ff5a7e26553d2,0,0,0,0,0,0,0,0,0,0,0,0,0,0,0,36,3,0,0,0,0,0,0,0,0,0,0,100,NoArch
904a9146cbb95ef39ff85610e953b1ab428192e9,0,0,0,0,0,0,0,0,0,0,0,0,0,0,0,37,4,0,0,0,0,0,0,0,0,0,0,100,NoArch
6c1e81c8ce9140e7a9f9e1d389654e9aa6f4231f,0,0,0,0,0,0,0,0,0,0,0,0,0,0,0,38,5,0,0,0,0,0,0,0,0,0,0,100,NoArch
b3d027654b943899c609d5bcf529a45a458dfa56,0,0,0,0,0,0,0,0,0,0,0,0,0,0,0,39,6,0,0,0,0,0,0,0,0,0,0,100,NoArch
8f94f5647b6351c219fa105f37cd01f156427f71,0,0,0,0,0,0,0,0,0,0,0,0,0,0,0,40,7,0,0,0,0,0,0,0,0,0,1,100,NoArch
202748df75a29e8b27ce4e374ff289cfe8a91040,0,0,0,0,0,0,0,0,0,0,0,0,0,0,0,41,8,0,0,0,0,0,0,0,0,0,0,100,NoArch
d3dbf7122d3b8386ae72f46f0e966c8b69b8621a,0,0,0,0,0,0,0,0,0,0,0,0,0,0,0,42,9,0,0,0,0,0,0,0,0,0,1,100,NoArch
0917c496a26877a3bb260a5a09ff60b3d1ab85d8,0,0,0,0,0,0,0,0,0,0,0,0,0,0,0,43,10,0,0,0,0,0,0,0,0,0,0,100,NoArch
7da2a4f05f80a044a1d5033048d0040a9f7f2445,0,0,0,0,0,0,0,0,0,0,0,0,0,0,0,43,10,0,0,0,0,0,0,0,0,0,0,100,NoArch
a296ebc8894ad52ae7c0946e635b93cadc709e70,0,0,0,0,0,0,0,0,0,0,0,0,0,0,0,44,11,0,0,0,0,0,0,0,0,0,1,100,NoArch
e61751efd9f72cc299fce55c16e1d15e2ee1addc,0,0,0,0,0,0,0,0,0,0,0,0,0,0,0,46,13,0,0,0,0,0,0,0,0,0,1,100,NoArch
1e5f62c8bd3b58d5d622d8abeb665d601c978f75,0,0,0,0,0,0,0,0,0,0,0,0,0,0,0,47,14,0,0,0,0,0,0,0,0,0,0,100,NoArch
1d7f2d7b46794348394a2f0a70658d94c38530a1,0,0,0,0,0,0,0,0,0,0,0,0,0,0,0,48,15,0,0,0,0,0,0,0,0,0,1,100,NoArch
0c223c9da6d0286c9e16257cef8b9988099cf8a2,1,5,4,1,9,0,0,0,11,24,1,1,0,356,8,31,0,12,12,0,2308,2271,37,10,10,0,1,100,NoArch
7622817b35b5511607d33facb6c0877e08b6c21f,0,0,0,0,0,0,0,0,0,0,0,0,0,0,0,49,16,0,0,0,0,0,0,0,0,0,0,100,NoArch
2b8513f94ba04b3b14867d639ae37750db56f765,0,0,0,0,0,0,0,0,0,0,0,0,0,0,0,50,17,0,0,0,0,0,0,0,0,0,0,100,NoArch
1a934e37e1d3bf63fdec844d676d6a5c129e1b67,0,0,0,0,0,0,0,0,0,0,0,0,0,0,0,51,18,0,0,0,0,0,0,0,0,0,0,100,NoArch
efd6274a4c7a9ed7c1c0d41477649b68baeefa0b,0,0,0,0,0,0,0,0,0,0,0,0,0,0,0,52,19,0,0,0,0,0,0,0,0,0,1,100,NoArch
7740efa3ee8e3ddd01405c8f3af1937859f6bd1a,0,0,0,0,0,0,0,0,0,0,0,0,0,0,0,8,0,0,0,0,0,0,0,0,0,0,1,100,NoArch
9133577129111a75103d9bcfa5444f9847abb515,0,0,0,0,0,0,0,0,0,0,0,0,0,0,0,9,1,0,0,0,0,0,0,0,0,0,0,100,NoArch
dd31b7eb4d537d83197ba04059953283c58696fc,0,0,0,0,0,0,0,0,0,0,0,0,0,0,0,53,18,0,0,0,0,0,0,0,0,0,0,100,NoArch
a7e72b5b581605d70919b8d244414b879533bd8f,0,0,0,0,0,0,0,0,0,0,0,0,0,0,0,54,19,0,0,0,0,0,0,0,0,0,1,100,NoArch
298047ba76ad69007a5d9ba7e931322c933a03b3,0,0,0,0,0,0,0,0,0,0,0,0,0,0,0,55,20,0,0,0,0,0,0,0,0,0,0,100,NoArch
e5fdce55138d59839ff16797aac02e4b1d916ab9,0,0,0,0,0,0,0,0,0,0,0,0,0,0,0,56,21,0,0,0,0,0,0,0,0,0,0,100,NoArch
63a34a693763f0f103b15e4fd77dcfc8547829dc,0,0,0,0,0,0,0,0,0,0,0,0,0,0,0,57,22,0,0,0,0,0,0,0,0,0,0,100,NoArch
6660870e3e13ceb91bcf9d4b8ff5cad8fa142856,0,0,0,0,0,0,0,0,0,0,0,0,0,0,0,55,20,0,0,0,0,0,0,0,0,0,1,100,NoArch
c3a488cb1808f0de86f4f0ab27acbc26095c6f09,0,0,0,0,0,0,0,0,0,0,0,0,0,0,0,58,23,0,0,0,0,0,0,0,0,0,0,100,NoArch
695d83d02d5c5cd074c3fed0655f0940e0f3c4de,0,0,0,0,0,0,0,0,0,0,0,0,0,0,0,59,24,0,0,0,0,0,0,0,0,0,0,100,NoArch
29ebfc3af238de33dc4bbbf508c4b6daf3306b38,0,0,0,0,0,0,0,0,0,0,0,0,0,0,0,60,25,0,0,0,0,0,0,0,0,0,0,100,NoArch
8a42cd0642fcadca7765f59d83a059b1eddb26bd,0,0,0,0,0,0,0,0,0,0,0,0,0,0,0,61,26,0,0,0,0,0,0,0,0,0,0,100,NoArch
7f116b8d58655ac369e3ae2c31cd68bc93f0b903,0,0,0,0,0,0,0,0,0,0,0,0,0,0,0,0,0,0,0,0,0,0,0,0,0,0,0,100,NoArch
55acae0fdb725aec974dd125086d161c097b0dac,0,0,0,0,0,0,0,0,0,0,0,0,0,0,0,32,1,0,0,0,0,0,0,0,0,0,0,100,NoArch
7a098485a585fa3e387e2ad2b2e4af682a88a997,0,0,0,0,0,0,0,0,0,0,0,0,0,0,0,63,27,0,0,0,0,0,0,0,0,0,1,100,NoArch
114cf9c826c38c925292f81109e3dce0837d71ed,0,0,0,0,0,0,0,0,0,0,0,0,0,0,0,33,2,0,0,0,0,0,0,0,0,0,0,100,NoArch
9a05375436385b7fce75d32cfdcd359e279e0628,0,0,0,0,0,0,0,0,0,0,0,0,0,0,0,2,0,0,0,0,0,0,0,0,0,0,3,100,NoArch
806adf7bba3dbff20002b6dd2d64d6e3be062321,4,58,3,55,61,0,0,0,100,629,1,2,1.909887141,2479,9,0,0,485,114,371,16411,2904,13507,178,44,134,0,100,NoArch
2084ca42ffd22b7827cc7e240cf249534b9f9d45,0,0,0,0,0,0,0,0,0,0,0,0,0,0,0,34,3,0,0,0,0,0,0,0,0,0,0,100,NoArch
5a64ea53d2e37449295c8d29f3d33ce849691155,0,0,0,0,0,0,0,0,0,0,0,0,0,0,0,64,15,0,0,0,0,0,0,0,0,0,0,100,NoArch
6d0323cc950f0b05a7e30a81fa5970df312be736,0,0,0,0,0,0,0,0,0,0,0,0,0,0,0,65,16,0,0,0,0,0,0,0,0,0,1,100,NoArch
0d997e5e5952546e0bdeab3080ef7c00d8caffc1,0,0,0,0,0,0,0,0,0,0,0,0,0,0,0,1,0,0,0,0,0,0,0,0,0,0,1,100,NoArch
05171ee872bb8d6e9173a34b7832f522b2a56763,7,22,11,11,33,0,0,0,80,812,1,4,2.248495256,2877,5,0,0,417,414,3,14817,14789,28,190,189,1,1,100,NoArch
411cfb96db6126a06df9e8093106e690b7e35dfc,1,22,39,17,61,0,0,0,21,111,1,1,0,785,12,35,3,63,66,3,5610,5668,58,39,39,0,1,100,NoArch
2eea14c10f87029dfe89e7575fbd587cb23b812d,0,0,0,0,0,0,0,0,0,0,0,0,0,0,0,3,1,0,0,0,0,0,0,0,0,0,1,100,NoArch
5896f1a1bdcbc2f7450b09b1dbbdeb4ad0cb13b6,2,5,2,3,7,0,0,0,14,126,1,2,0.985228136,229,5,8,0,19,8,11,1311,632,679,12,4,8,1,100,NoArch
c3e0c4974db92bf6001a6da654870455cac70eac,0,0,0,0,0,0,0,0,0,0,0,0,0,0,0,10,0,0,0,0,0,0,0,0,0,0,1,100,NoArch
8643e3bd73cab8dbbbcac1203a19c2d2cdc62cfe,0,0,0,0,0,0,0,0,0,0,0,0,0,0,0,9,1,0,0,0,0,0,0,0,0,0,1,100,NoArch
384061c05720287aa93a756a742aab2572b75e79,0,0,0,0,0,0,0,0,0,0,0,0,0,0,0,0,0,0,0,0,0,0,0,0,0,0,1,100,NoArch
10445fe1c366cbafcd5de4ddf4520ac5f91183cb,0,0,0,0,0,0,0,0,0,0,0,0,0,0,0,11,1,0,0,0,0,0,0,0,0,0,0,100,NoArch
3c16299956d64dc4a1b76161228ebb545d3d400b,14,45,85,40,130,0,0,0,88,558,1,11,3.750085681,3813,4,0,0,683,694,11,21219,21378,159,283,283,0,1,100,NoArch
bcc79e90540f55dc9e1dd34da7a1f5901ee22b2a,1,3,7,4,10,0,0,0,6,1187,1,1,0,237,5,1,1,53,55,2,1366,1383,17,14,14,0,1,100,NoArch
0de805575f41c2d7deff9fcbe408e51606f88269,1,3,3,0,6,0,0,0,101,43,1,1,0,1200,15,2,2,319,319,0,7246,7258,12,97,97,0,1,100,NoArch
4fad0f252d06f5cf4c51fbfdfa2ac966daf55a1f,0,0,0,0,0,0,0,0,0,0,0,0,0,0,0,36,2,0,0,0,0,0,0,0,0,0,0,100,NoArch
e03f9d44faaaa5fd0908f9402340164972415c0d,0,0,0,0,0,0,0,0,0,0,0,0,0,0,0,4,0,0,0,0,0,0,0,0,0,0,1,100,NoArch
cef06d90fd2e4156f83498f6a77b325115491a49,0,0,0,0,0,0,0,0,0,0,0,0,0,0,0,0,0,0,0,0,0,0,0,0,0,0,0,100,NoArch
a780991e7316762cda2a7cc8bc7092c4c61ccf63,0,0,0,0,0,0,0,0,0,0,0,0,0,0,0,66,0,0,0,0,0,0,0,0,0,0,0,100,NoArch
99393272e65c24778254e97be11ec87e02d5689e,0,0,0,0,0,0,0,0,0,0,0,0,0,0,0,12,1,0,0,0,0,0,0,0,0,0,0,100,NoArch
6b5963d64e8c339c5266b6b14c707ea9cb10f8fa,0,0,0,0,0,0,0,0,0,0,0,0,0,0,0,10,0,0,0,0,0,0,0,0,0,0,1,100,NoArch
f4425913940a11870bc8fda602d29217cff53af0,0,0,0,0,0,0,0,0,0,0,0,0,0,0,0,11,1,0,0,0,0,0,0,0,0,0,1,100,NoArch
7e64b40104f0918b04ddc83038ef0bb779ff1c95,0,0,0,0,0,0,0,0,0,0,0,0,0,0,0,13,1,0,0,0,0,0,0,0,0,0,0,100,NoArch
c1faf3b56504de9e366000ceeb4a65ef9567f8d2,3,2,13,11,15,0,0,0,2,840,1,1,1.584962501,342,2,14,2,34,34,0,1597,1639,42,21,21,0,1,100,NoArch
ba30662a00fe5f883d643c956d7b982a5d4b8751,0,0,0,0,0,0,0,0,0,0,0,0,0,0,0,15,3,0,0,0,0,0,0,0,0,0,1,100,NoArch
1f88d9ede26daad76f1343ca300f16cc824ef712,0,0,0,0,0,0,0,0,0,0,0,0,0,0,0,16,4,0,0,0,0,0,0,0,0,0,1,100,NoArch
c4f880eb00b07a4cc6fbab24ae9f5c9d970d269b,0,0,0,0,0,0,0,0,0,0,0,0,0,0,0,17,5,0,0,0,0,0,0,0,0,0,1,100,NoArch
95cd62055fd24910d8873b4d8ab209eec198239e,0,0,0,0,0,0,0,0,0,0,0,0,0,0,0,12,2,0,0,0,0,0,0,0,0,0,1,100,NoArch
ac95febf82b15ffa564cac1d92475cdf6efed9f6,27,105,52,53,157,0,0,0,21,1085,1,10,4.389798373,4594,4,37,1,396,393,3,21133,20546,587,227,226,1,1,97.37817797,Arch
e0ab6bd54ab632569782a577b7e9a1d419e08845,3,9,7,2,16,0,0,0,17,907,1,2,1.505240815,532,3,0,0,102,101,1,3183,3149,34,35,34,1,2,99.92025518,NoArch
114fee5317ca2bb2b09864c66da99e86190faffb,0,0,0,0,0,0,0,0,0,0,0,0,0,0,0,0,0,0,0,0,0,0,0,0,0,0,1,100,NoArch
e44acccf69a0b40f12f904144df67b345a5138ad,0,0,0,0,0,0,0,0,0,0,0,0,0,0,0,13,3,0,0,0,0,0,0,0,0,0,1,100,NoArch
2aa4946f42541369b31094538801c2caec251c67,0,0,0,0,0,0,0,0,0,0,0,0,0,0,0,3,0,0,0,0,0,0,0,0,0,0,1,100,NoArch
c62a8f9d11c85c18a9df1f28d23fe0396f7766b9,0,0,0,0,0,0,0,0,0,0,0,0,0,0,0,14,4,0,0,0,0,0,0,0,0,0,1,100,NoArch
ff11298e397977b820bdeed612e61dab17f118b9,0,0,0,0,0,0,0,0,0,0,0,0,0,0,0,15,5,0,0,0,0,0,0,0,0,0,1,100,NoArch
e2ca27ef053becb47d3b18a00215e9df3da3ad2a,0,0,0,0,0,0,0,0,0,0,0,0,0,0,0,16,1,0,0,0,0,0,0,0,0,0,1,100,NoArch
b82a370b1607d6f45c3ec9db6125dd527d5eaab5,0,0,0,0,0,0,0,0,0,0,0,0,0,0,0,17,2,0,0,0,0,0,0,0,0,0,1,100,NoArch
846a9a1bb85e9832b696970c96e6089d43c3ee6b,0,0,0,0,0,0,0,0,0,0,0,0,0,0,0,5,0,0,0,0,0,0,0,0,0,0,1,100,NoArch
a56108835a0aa35530c8f367ce8a50d0c5861192,0,0,0,0,0,0,0,0,0,0,0,0,0,0,0,6,1,0,0,0,0,0,0,0,0,0,1,100,NoArch
5714c9e837428279329b9758e415ce89118be646,0,0,0,0,0,0,0,0,0,0,0,0,0,0,0,0,0,0,0,0,0,0,0,0,0,0,0,100,NoArch
4468b34b5da5fba1a7ed5bf79a829e1efcffbd63,0,0,0,0,0,0,0,0,0,0,0,0,0,0,0,1,1,0,0,0,0,0,0,0,0,0,0,100,NoArch
3ec3db79af89d5674c2cfe5cedb7c784787e9bcd,0,0,0,0,0,0,0,0,0,0,0,0,0,0,0,18,3,0,0,0,0,0,0,0,0,0,1,100,NoArch
d93a33a3860787da855822c0d6e0cfd425f4583b,0,0,0,0,0,0,0,0,0,0,0,0,0,0,0,18,0,0,0,0,0,0,0,0,0,0,0,100,NoArch
4a3609cd854e9ef5bdda5b43e188a3309a93aef9,7,101,8,93,109,1,0,1,102,1215,1,6,1.159378587,1290,5,0,0,331,323,8,8202,7627,575,109,101,8,1,99.73418394,NoArch
e561b5a95caecf9d394186031868251b7a229f2e,0,0,0,0,0,0,0,0,0,0,0,0,0,0,0,19,1,0,0,0,0,0,0,0,0,0,0,100,NoArch
02e08dafd35b31e9e596564b0996dc63bd2fb1ed,0,0,0,0,0,0,0,0,0,0,0,0,0,0,0,0,0,0,0,0,0,0,0,0,0,0,1,100,NoArch
2f2025201bf937cb163d263396a097bbc5fad1b0,2,0,143,143,143,0,2,2,4,1298,1,2,0.974129188,143,3,1,1,0,16,16,0,543,543,0,10,10,1,99.86677325,NoArch
f173ae8d690b5f90e8cc5899b654762a9d11e17d,1,3,3,0,6,0,0,0,15,299,1,1,0,2617,11,2,2,305,305,0,9018,9018,0,282,282,0,1,100,NoArch
f715c974b9f7eb4d4809c1e0f04b7b4ff12837b3,0,0,0,0,0,0,0,0,0,0,0,0,0,0,0,3,0,0,0,0,0,0,0,0,0,0,1,100,NoArch
e16f30abf6d1b7befcc36f49a5bc39166a75f814,1,8,5,3,13,0,0,0,5,1299,1,1,0,218,3,4,1,14,14,0,670,645,25,6,6,0,1,100,NoArch
ef8349ffd6da5c6f4693ac46548c96e22eeb7cd7,3,35,50,15,85,0,0,0,103,485,1,3,0.320827992,2562,13,5,2,635,648,13,16435,16569,134,172,172,0,1,100,NoArch
8c3c590d7bfa6d486f5741c5e2f5214a1f2436c1,1,4,3,1,7,0,0,0,20,369,1,1,0,1008,6,6,3,141,142,1,4006,4007,1,73,73,0,1,100,NoArch
6d0698705299e67e2f463216b95bf962ab6f11a2,1,5,9,4,14,0,0,0,52,270,1,1,0,488,8,7,4,119,120,1,2926,2942,16,32,32,0,1,100,NoArch
a7a5aeba3927404f6d83306caeb546a7f3a5e705,1,2,2,0,4,0,0,0,18,95,1,1,0,355,5,0,0,89,89,0,2180,2180,0,24,24,0,0,100,NoArch
d195e1fc626f960eef7ef9a5aaeb3851cb4fda31,1,29,14,15,43,0,0,0,21,2,1,1,0,1009,6,8,5,141,141,0,4007,4006,1,73,73,0,1,100,NoArch
6fddbae08fcf0aba1d51289d1b90681c3bfa9477,1,18,19,1,37,0,0,0,22,0,1,1,0,1024,6,9,6,140,141,1,3996,4007,11,73,73,0,1,100,NoArch
3d51ba5e96556136c2084838591aa325e81bfca9,190,1024,739,285,1763,0,0,0,105,617,1,54,6.347343862,59192,3,20,2,8218,6174,2044,314775,248766,66009,4095,3094,1001,0,100,NoArch
63e02101cf94d8ab0e1ae01baafe04c5767aa371,1,32,17,15,49,0,0,0,11,1314,1,1,0,361,6,10,7,69,69,0,1551,1583,32,33,33,0,1,100,NoArch
0e6977d1b89c9a103cec0be5bd4bbeceb740d50f,6,15,19,4,34,0,0,0,106,281,1,6,2.254447579,4259,4,11,8,1031,1031,0,23989,24024,35,362,362,0,1,100,NoArch
fb3c25f92baa17249219e263e0fe17568c67eadc,2,3,10,7,13,0,0,0,107,0,1,2,0.995727452,1971,7,12,9,496,498,2,11546,11600,54,205,205,0,1,100,NoArch
46485b555dc16b38be59aa8e777aaecf74185fab,1,0,1,1,1,0,0,0,10,0,1,1,0,230,7,21,3,39,39,0,1296,1307,11,12,12,0,0,100,NoArch
1119b6eb5b92730b27e9798793bc67f192591c15,157,775,1373,598,2148,0,0,0,108,339,1,60,6.355159396,53681,3,22,4,7076,7161,85,295316,298914,3598,3514,3530,16,0,100,NoArch
8026c8ffe4ef67ab419dba73910636bf2c1a691c,548,18961,19651,690,38612,0,0,0,109,417,1,78,7.829641153,106113,3,23,3,12780,12778,2,543693,543758,65,6738,6736,2,1,99.9733191,NoArch
8f0eca6990a584707c0cc7690fc1d325803a5287,1,2,0,2,2,0,0,0,44,5,1,1,0,344,8,13,0,55,0,55,1539,0,1539,26,0,26,1,100,NoArch
d81bffd41c348d8ffe11506fe26c66c58a37a580,6,135,14,121,149,2,0,2,48,69,1,4,2.206616272,748,6,37,0,84,77,7,4496,4089,407,50,43,7,1,99.8401279,NoArch
b2f4790ab20537907d9bc29050e9eb31f711f671,1,15,14,1,29,0,0,0,85,6,1,1,0,1219,17,38,0,253,253,0,5655,5643,12,84,84,0,0,100,NoArch
ff6a4e8317689928056ed18805a944057ae666ad,10,31,30,1,61,0,0,0,86,0,1,6,NaN,2848,8,39,1,412,399,13,15109,14669,440,166,157,9,0,100,NoArch
c1abf35eec063f582da2551bc9121ae0beee65f5,6,51,14,37,65,0,0,0,87,107,1,6,1.869557962,4043,11,40,2,566,503,63,25235,19622,5613,249,210,39,0,100,NoArch
05ad1a7b49568b400268e7e2d504eac3ed97f0d1,2,7,0,7,7,0,0,0,88,0,1,2,0.591672779,1935,13,41,3,316,0,316,11374,0,11374,123,0,123,1,100,NoArch
48ed810a0d1352adcb3f608ff33b186ed433e784,41,5112,0,5112,5112,40,0,40,28,10,1,7,5.280279968,1972,1,14,1,762,0,762,38876,0,38876,449,0,449,1,89.33823529,Arch
8197803dceb89d53d6f5a3e9143f46c035d6558b,5,720,0,720,720,1,0,1,89,108,1,5,0.546514543,1712,4,42,4,415,0,415,11494,0,11494,207,0,207,1,99.90952955,NoArch
c552c1746ff9bac97512fc7db2523f3cff1bd15d,25,85,86,1,171,0,0,0,45,0,1,16,4.278604499,9308,4,15,2,1296,1298,2,45360,45216,144,698,698,0,1,100,NoArch
c369dd1b4d2f807bfdec5b25317a5adee855d7fc,13,699,679,20,1378,2,2,4,90,0,1,6,3.191020235,5616,2,11,0,769,767,2,30824,30819,5,430,429,1,0,92.23268325,Arch
db992cf8686ffa681b0c592696b37ad519c33ee6,0,0,0,0,0,0,0,0,0,0,0,0,0,0,0,24,2,0,0,0,0,0,0,0,0,0,1,100,NoArch
392c761952ec7f679b29ae28129403ea8cf307ea,0,0,0,0,0,0,0,0,0,0,0,0,0,0,0,10,0,0,0,0,0,0,0,0,0,0,1,100,NoArch
de48a0a8a0343b61fdb255011fde38c619761046,3,97,22,75,119,0,0,0,93,15,1,2,1.580649601,1096,5,1,0,244,223,21,7655,6385,1270,65,54,11,1,99.96194825,NoArch
451deec474935db54824069dcf5cfe7ae49a1b11,2,91,34,57,125,0,0,0,5,18,1,2,0.505919244,222,3,0,0,32,23,9,1325,927,398,14,13,1,1,99.92383854,NoArch
22c4685e1711235e7435a2acbdb4df48f39e3f92,1,27,1,26,28,0,0,0,6,0,1,1,0,182,4,1,1,25,22,3,881,784,97,7,6,1,1,100,NoArch
dbf977989105217b37a798d30793d90e747eceb1,1,11,256,245,267,0,0,0,31,11,1,1,0,760,12,0,0,93,116,23,2652,3630,978,37,41,4,1,100,NoArch
e0871378317e2e10e60f7a6ec992802e341e240f,1,13,11,2,24,0,0,0,32,0,1,1,0,515,12,1,1,93,93,0,2660,2652,8,37,37,0,0,100,NoArch
7cd66387b7a249eabcfbd57fb651613d9eb1b8c4,2,184,0,184,184,2,0,2,1,0,1,2,0.932111568,0,1,0,0,3,0,3,1056,0,1056,3,0,3,1,98.80463205,NoArch
f7f1a5ec111a781201c5b720e058342b4ed69613,1,4,4,0,8,0,0,0,2,0,1,1,0,120,2,0,0,1,1,0,799,799,0,1,1,0,0,100,NoArch
763591d28c1c82245aa4360b9dad1949ef16a62d,0,0,0,0,0,0,0,0,0,0,0,0,0,0,0,43,5,0,0,0,0,0,0,0,0,0,0,100,NoArch
689ca49e41764d12df6963f5fd418052f0159900,2,20,27,7,47,0,0,0,3,0,1,2,0.997059057,184,3,44,6,3,3,0,1056,1056,0,3,3,0,0,100,NoArch
6337479d5dff9bef5d249ace16fddaf8346923c4,1,12,10,2,22,0,0,0,4,0,1,1,0,112,3,45,7,4,1,3,802,799,3,1,1,0,0,100,NoArch
a5e0f4ad01703eb4a724e71dfcf99306819c6bf3,1,12,9,3,21,0,0,0,13,18,1,1,0,99,4,46,8,15,12,3,363,328,35,5,5,0,1,100,NoArch
3a7786ed1a3bedf05e6bce7924aea2f75b576912,0,0,0,0,0,0,0,0,0,0,0,0,0,0,0,0,0,0,0,0,0,0,0,0,0,0,1,100,NoArch
bd89d59def7c3b273e122635b9a2ccfa9ada2f7f,9,4650,665,3985,5315,6,0,6,23,6,1,4,1.805818985,3893,1,1,0,1308,573,735,39103,17264,21839,615,296,319,1,99.3797884,NoArch
4c0e41cebc0804c563dffe98a58c06b1c39098e1,22,104,121,17,225,0,0,0,94,83,1,13,3.588312035,5392,6,47,9,642,648,6,32584,32754,170,309,311,2,1,95.83492549,Arch
1c679b12bab24c315a3547efa0aee1fd7838bbba,2,32,23,9,55,0,0,0,110,28,1,1,0.980597441,2842,7,48,10,597,596,1,13935,13926,9,236,235,1,1,100,NoArch
df9ce91231d26655ea1fc11ece5132b389fdf860,2,8,8,0,16,0,0,0,106,30,1,2,0.811278124,2058,9,49,11,366,366,0,13308,13308,0,131,131,0,1,100,NoArch
73506f295a7835334d31c68da35e4beabdeb4443,0,0,0,0,0,0,0,0,0,0,0,0,0,0,0,50,12,0,0,0,0,0,0,0,0,0,1,100,NoArch
b09726d066111d3e884872960f511f97a0215d34,4,122,1,121,123,1,0,1,33,21,1,2,1.015676375,431,4,51,13,60,13,47,2523,658,1865,29,5,24,1,99.91941982,NoArch
22d5483a1fe8a242f3a512cc0bb7131268e23e92,0,0,0,0,0,0,0,0,0,0,0,0,0,0,0,52,14,0,0,0,0,0,0,0,0,0,1,100,NoArch
9839e2a67373a5cfd700182a15f949822ce3df99,0,0,0,0,0,0,0,0,0,0,0,0,0,0,0,53,15,0,0,0,0,0,0,0,0,0,1,100,NoArch
fa1a8ef805111c4bb0d6e5fc59e635cf72d33d14,6,166,136,30,302,0,0,0,111,21,1,3,1.338489189,6581,4,54,16,974,971,3,34861,34619,242,609,609,0,1,100,NoArch
bf8f9edcaa8545c134ad2eab1b2715cb32f44e16,1,1,1,0,2,0,0,0,45,27,1,1,0,346,9,0,0,55,55,0,1537,1539,2,26,26,0,0,100,NoArch
5ca17a271a8f31449cb51fb1f58fb8f9748d9447,1,1,1,0,2,0,0,0,46,0,1,1,0,346,9,1,1,55,55,0,1543,1537,6,26,26,0,0,100,NoArch
996c6382aa0dd9d3bb7955094f9247c77054c6fd,1,1,1,0,2,0,0,0,47,0,1,1,0,346,10,55,17,55,55,0,1543,1543,0,26,26,0,0,100,NoArch
3a0f663db8294ea855d3520e43686c9ead28e5b9,0,0,0,0,0,0,0,0,0,0,0,0,0,0,0,25,2,0,0,0,0,0,0,0,0,0,0,100,NoArch
3c3171eaa13e2aa6265577bff9cabf751bf29c4f,0,0,0,0,0,0,0,0,0,0,0,0,0,0,0,26,3,0,0,0,0,0,0,0,0,0,0,100,NoArch
adcd8a5fcce05fbfcf919d103cf4077a96084ba6,0,0,0,0,0,0,0,0,0,0,0,0,0,0,0,27,4,0,0,0,0,0,0,0,0,0,0,100,NoArch
95534f4ca63293fc51df3a533f07b5a9cae7f473,0,0,0,0,0,0,0,0,0,0,0,0,0,0,0,28,5,0,0,0,0,0,0,0,0,0,1,100,NoArch
c847de572528d64dfa28ad5a3a67deac692c3fe1,0,0,0,0,0,0,0,0,0,0,0,0,0,0,0,29,6,0,0,0,0,0,0,0,0,0,1,100,NoArch
d0354df648e8b0067f87ee162edf322dff60523c,0,0,0,0,0,0,0,0,0,0,0,0,0,0,0,30,7,0,0,0,0,0,0,0,0,0,1,100,NoArch
a02495613d514e984ff486f334890099b1c922e7,0,0,0,0,0,0,0,0,0,0,0,0,0,0,0,31,8,0,0,0,0,0,0,0,0,0,1,100,NoArch
71fb2b29fc3e5f200b3d1ccbd177a95691910986,0,0,0,0,0,0,0,0,0,0,0,0,0,0,0,32,9,0,0,0,0,0,0,0,0,0,0,100,NoArch
350a3f0beb779c783daecf6f1b1de58e53e5f3fa,0,0,0,0,0,0,0,0,0,0,0,0,0,0,0,56,18,0,0,0,0,0,0,0,0,0,1,100,NoArch
ee6386f44a288f20cf2df5933fd29b4ab54f9e55,0,0,0,0,0,0,0,0,0,0,0,0,0,0,0,19,0,0,0,0,0,0,0,0,0,0,1,100,NoArch
c41939351d00f2e1bb87ac8e8b8e1c721150c1ef,0,0,0,0,0,0,0,0,0,0,0,0,0,0,0,12,1,0,0,0,0,0,0,0,0,0,0,100,NoArch
94b3faeccfd7507d63a69027d7d1703a4bd18c9d,3,63,6,57,69,0,0,0,95,51,1,2,1.251518814,2211,12,2,0,373,368,5,14394,13979,415,157,154,3,1,100,NoArch
39d959e1c6a1f339f03dab18289e47f27c10be7f,6,960,570,390,1530,1,0,1,41,54,1,4,1.576827249,2185,6,7,0,442,383,59,14936,13022,1914,115,98,17,1,99.91954948,NoArch
ea61af812478af7e6922b83e0818bf06b91c0052,3,102,88,14,190,0,0,0,112,13,1,2,0.66324221,2980,11,8,1,675,676,1,15811,15644,167,218,220,2,1,100,NoArch
d39077d2f02ae0f11ad6c3af851c37567e70270f,1,91,57,34,148,0,0,0,3,0,1,1,0,689,1,9,2,154,153,1,3469,3258,211,24,23,1,1,100,NoArch
b5ef7f8683d23df96b7621ba1db4558424f35767,1,9,2,7,11,0,0,0,4,0,1,1,0,723,1,10,3,154,154,0,3469,3469,0,24,24,0,1,100,NoArch
918d04e517625de96b6931eb47f61abbc26487bf,7,380,335,45,715,0,0,0,113,0,1,4,1.179602616,4601,7,67,0,896,896,0,25565,25562,3,304,304,0,0,100,NoArch
da50f7f205a7c3f8f69096fd27652d69066224e8,18,1487,1145,342,2632,2,1,3,111,66,1,8,2.947284413,12524,2,0,0,2260,2106,154,66228,61676,4552,951,892,59,1,99.59871589,NoArch
b8b8ef5a44a7a3f25e943a9438772fc3bbc870bb,7,1059,569,490,1628,1,0,1,113,0,1,4,1.591890018,4156,7,68,1,896,837,59,25565,23270,2295,304,288,16,1,99.91993595,NoArch
1c2ee80cb6a090b82585cf65dd9be6fd0b28a805,0,0,0,0,0,0,0,0,0,0,0,0,0,0,0,20,1,0,0,0,0,0,0,0,0,0,0,100,NoArch
ad512fdef069810046d184c1dde6f9a1c3296a5d,0,0,0,0,0,0,0,0,0,0,0,0,0,0,0,21,2,0,0,0,0,0,0,0,0,0,0,100,NoArch
0169398211e688d8e61beb272703cb9891d5ae97,0,0,0,0,0,0,0,0,0,0,0,0,0,0,0,22,2,0,0,0,0,0,0,0,0,0,0,100,NoArch
47449fb8bb5c1f756ee5647f46568de75154cbe5,0,0,0,0,0,0,0,0,0,0,0,0,0,0,0,23,3,0,0,0,0,0,0,0,0,0,0,100,NoArch
36d232fad3f25f30928d3d1a53a9ae154f78fa5a,0,0,0,0,0,0,0,0,0,0,0,0,0,0,0,24,4,0,0,0,0,0,0,0,0,0,0,100,NoArch
db59c8bd399b7a501cffd4b714dcf20f407c278f,4,23,20,3,43,0,0,0,56,65,1,3,1.466609395,1739,10,25,5,341,341,0,8468,8453,15,88,88,0,0,99.59935897,NoArch
342a8ea7f0f7603147faf035b3c04905f393ed4c,0,0,0,0,0,0,0,0,0,0,0,0,0,0,0,26,6,0,0,0,0,0,0,0,0,0,0,100,NoArch
4607730012293fe1e58957760e8f7b5474abd408,0,0,0,0,0,0,0,0,0,0,0,0,0,0,0,27,7,0,0,0,0,0,0,0,0,0,0,100,NoArch
58d7dfac6bc109dfc98d66dec03a25e4cdb6f27d,0,0,0,0,0,0,0,0,0,0,0,0,0,0,0,11,0,0,0,0,0,0,0,0,0,0,1,100,NoArch
8dbe05a17363a1281482e8611cfead4c04645f47,2,16,1,15,17,0,0,0,114,65,1,2,0.522559375,2897,8,0,0,544,454,90,17901,10246,7655,265,190,75,1,100,NoArch
2f03c4073693c017358bcb972baada541eff4d49,0,0,0,0,0,0,0,0,0,0,0,0,0,0,0,57,0,0,0,0,0,0,0,0,0,0,0,100,NoArch
37e8a0f09b987f98c2ae379b7e5f07399b620a47,0,0,0,0,0,0,0,0,0,0,0,0,0,0,0,58,1,0,0,0,0,0,0,0,0,0,0,100,NoArch
24ff48c32d8d13433a1e31e485ef2af187d1eb62,0,0,0,0,0,0,0,0,0,0,0,0,0,0,0,59,2,0,0,0,0,0,0,0,0,0,0,100,NoArch
16de62a54297a42e21c0f0c5197a8bf0432f2bce,0,0,0,0,0,0,0,0,0,0,0,0,0,0,0,28,8,0,0,0,0,0,0,0,0,0,0,100,NoArch
3c76495e9524ef322726d03d7ee406be89e8fde0,4,40,6,34,46,1,0,1,38,69,1,4,1.241524204,1313,11,1,0,202,201,1,6875,6785,90,111,110,1,1,99.91980754,NoArch
4349497ecc68f66b74e35fea01f07153bf0c9146,2,27,6,21,33,0,0,0,111,166,1,2,0.195909271,2203,23,0,0,350,85,265,13110,6956,6154,138,52,86,1,100,NoArch
0cade259473d55e9d6995ac65ba76c6dae0c8030,0,0,0,0,0,0,0,0,0,0,0,0,0,0,0,24,0,0,0,0,0,0,0,0,0,0,1,100,NoArch
757bfd566367ec6077bef5595105103ca9bb01c6,0,0,0,0,0,0,0,0,0,0,0,0,0,0,0,0,0,0,0,0,0,0,0,0,0,0,1,100,NoArch
6aa5791cd9505ff11056f09f95fdcc574c0629e1,1,39,0,39,39,1,0,1,1,0,1,1,0,0,1,1,1,2,0,2,114,0,114,1,0,1,1,99.94840041,NoArch
c0adf1b9bfbcec553cbdb7b434afcb78cd6d4135,0,0,0,0,0,0,0,0,0,0,0,0,0,0,0,91,0,0,0,0,0,0,0,0,0,0,0,100,NoArch
df1d01009d84e8276f8fd1919e78a927cda8f18e,0,0,0,0,0,0,0,0,0,0,0,0,0,0,0,92,1,0,0,0,0,0,0,0,0,0,0,100,NoArch
9591ee481519d6b0fc76fcdd717f93bbd23ac161,0,0,0,0,0,0,0,0,0,0,0,0,0,0,0,32,0,0,0,0,0,0,0,0,0,0,1,100,NoArch
23c7802841f2ba997c6330f99a23704ea476b9de,0,0,0,0,0,0,0,0,0,0,0,0,0,0,0,2,2,0,0,0,0,0,0,0,0,0,1,100,NoArch
becde91a74fc720443e1dfa5ed560c336271d47e,1,93,0,93,93,1,0,1,1,0,1,1,0,0,1,3,3,11,0,11,443,0,443,11,0,11,1,99.94845361,NoArch
73a12dd51334a6ecc80e9aa13ca327894c445cf3,0,0,0,0,0,0,0,0,0,0,0,0,0,0,0,93,2,0,0,0,0,0,0,0,0,0,0,100,NoArch
c7aaa7f078380ac6b16de51223f2fc52f815a7b2,10,537,4,533,541,4,0,4,26,1252,1,6,2.719423044,566,1,4,4,102,34,68,5483,1385,4098,60,17,43,1,99.71736896,NoArch
59623db58cb2385c93ca0a4d902e3c8bb86a6586,0,0,0,0,0,0,0,0,0,0,0,0,0,0,0,94,3,0,0,0,0,0,0,0,0,0,0,100,NoArch
4a1fb59bba00ba89ee09eb127b8ae8f8d765fc5f,0,0,0,0,0,0,0,0,0,0,0,0,0,0,0,33,1,0,0,0,0,0,0,0,0,0,1,100,NoArch
759c5cfc13f64f62e808814183713b9695b1eab9,0,0,0,0,0,0,0,0,0,0,0,0,0,0,0,0,0,0,0,0,0,0,0,0,0,0,1,100,NoArch
bdded91429839b7aa4be6becc14102382e84a010,0,0,0,0,0,0,0,0,0,0,0,0,0,0,0,1,1,0,0,0,0,0,0,0,0,0,2,100,NoArch
ae7b140272165106412acc309787eb0da37642ee,0,0,0,0,0,0,0,0,0,0,0,0,0,0,0,0,0,0,0,0,0,0,0,0,0,0,1,100,NoArch
6aa3b0a1806bbd3e3ec92378e56403e03f6bf0f1,0,0,0,0,0,0,0,0,0,0,0,0,0,0,0,91,0,0,0,0,0,0,0,0,0,0,1,100,NoArch
9b2de4ac2febea6f18c4f7877164027350224f91,0,0,0,0,0,0,0,0,0,0,0,0,0,0,0,0,0,0,0,0,0,0,0,0,0,0,1,100,NoArch
ad63664df02bf5bfb63a6a4b3fefccede0e19352,4,56,6,50,62,1,0,1,105,756,1,4,1.280606313,1665,5,5,0,358,355,3,10274,10108,166,96,94,2,1,99.89756722,NoArch
ffc04f434f6be74ef6edd7c87eaa03fe2a3331e6,0,0,0,0,0,0,0,0,0,0,0,0,0,0,0,92,1,0,0,0,0,0,0,0,0,0,1,100,NoArch
a50eb40f1559a0b71a52a2dd304092c68d952287,0,0,0,0,0,0,0,0,0,0,0,0,0,0,0,6,1,0,0,0,0,0,0,0,0,0,0,100,NoArch
64ecf4ab19c57fa3e0d1596368e8f535727c6623,5,91,8,83,99,1,0,1,131,1637,1,3,1.653577775,2604,7,5,3,584,91,493,13753,2250,11503,228,18,210,1,99.82097187,NoArch
8c33103c24b20aa2b107f1057b4d22b5111fad42,0,0,0,0,0,0,0,0,0,0,0,0,0,0,0,6,4,0,0,0,0,0,0,0,0,0,3,100,NoArch
a10746a3ecb1c79d58a1f8cfbdc87a87fefd5998,0,0,0,0,0,0,0,0,0,0,0,0,0,0,0,7,2,0,0,0,0,0,0,0,0,0,1,100,NoArch
b79275fa2ebfa155aee13e1afd77bc1749c56e64,0,0,0,0,0,0,0,0,0,0,0,0,0,0,0,0,0,0,0,0,0,0,0,0,0,0,1,100,NoArch
e2a6c30cd178a7a63ee3fccb7099c2b29c22f991,0,0,0,0,0,0,0,0,0,0,0,0,0,0,0,26,0,0,0,0,0,0,0,0,0,0,1,100,NoArch
1dc89523d47461fa5fe0eaf57ec9e53c85e642fc,0,0,0,0,0,0,0,0,0,0,0,0,0,0,0,25,0,0,0,0,0,0,0,0,0,0,1,100,NoArch
aae1b9baaf8aae2741a56874d3d84f8a508b4ac1,0,0,0,0,0,0,0,0,0,0,0,0,0,0,0,69,0,0,0,0,0,0,0,0,0,0,1,100,NoArch
bc36c4a0b99a728abd08fba2dfc4defc106c6370,7,21,21,0,42,0,0,0,44,294,1,2,2.807354922,3685,16,4,0,537,537,0,18260,18281,21,318,318,0,1,100,NoArch
980046077dda2d0192d101178af87ca510578b2a,0,0,0,0,0,0,0,0,0,0,0,0,0,0,0,5,1,0,0,0,0,0,0,0,0,0,1,100,NoArch
38782db2b03ffdf0176b268716f29e42e4f06ec9,0,0,0,0,0,0,0,0,0,0,0,0,0,0,0,95,0,0,0,0,0,0,0,0,0,0,0,100,NoArch
f5ce159bb6e581add91b329488b7aeea7f1adcca,0,0,0,0,0,0,0,0,0,0,0,0,0,0,0,96,1,0,0,0,0,0,0,0,0,0,0,100,NoArch
32646e07b8a2f5217fd4f3e173fed0597bde07c8,0,0,0,0,0,0,0,0,0,0,0,0,0,0,0,97,2,0,0,0,0,0,0,0,0,0,0,100,NoArch
c5e024af00dffcf35059c039b69b22329abedbc0,0,0,0,0,0,0,0,0,0,0,0,0,0,0,0,98,3,0,0,0,0,0,0,0,0,0,0,100,NoArch
5b841714f7e2143db271870aeec90956c0094ec1,0,0,0,0,0,0,0,0,0,0,0,0,0,0,0,99,4,0,0,0,0,0,0,0,0,0,0,100,NoArch
c691e7821184d4e8b97bbc63711d961f6d4e67a9,0,0,0,0,0,0,0,0,0,0,0,0,0,0,0,100,5,0,0,0,0,0,0,0,0,0,0,100,NoArch
ba887727eaff11935ac4665460c585c776570f13,0,0,0,0,0,0,0,0,0,0,0,0,0,0,0,5,0,0,0,0,0,0,0,0,0,0,1,100,NoArch
f38b88f1458cf4ac7859aaaec648b051565ae3d2,0,0,0,0,0,0,0,0,0,0,0,0,0,0,0,101,6,0,0,0,0,0,0,0,0,0,0,100,NoArch
9644244d9af85e4097a5ce4a9f60c74463e6e4f4,0,0,0,0,0,0,0,0,0,0,0,0,0,0,0,102,7,0,0,0,0,0,0,0,0,0,0,100,NoArch
f56d052683ce26f42d131a7a318361357b850ca8,0,0,0,0,0,0,0,0,0,0,0,0,0,0,0,103,8,0,0,0,0,0,0,0,0,0,0,100,NoArch
0903f739a12ad92c9fedf0540a69f0ef85ecab6b,0,0,0,0,0,0,0,0,0,0,0,0,0,0,0,8,0,0,0,0,0,0,0,0,0,0,1,100,NoArch
d980ce42a5bdb3462b4117d5ff7850b282d44a5a,0,0,0,0,0,0,0,0,0,0,0,0,0,0,0,6,1,0,0,0,0,0,0,0,0,0,1,100,NoArch
ad4113424f428544ca8b8d590a8a46f8ad3f905c,0,0,0,0,0,0,0,0,0,0,0,0,0,0,0,104,9,0,0,0,0,0,0,0,0,0,0,100,NoArch
fbf3858ba83b3a840ba0c0ac5eb305217b809c35,0,0,0,0,0,0,0,0,0,0,0,0,0,0,0,105,10,0,0,0,0,0,0,0,0,0,0,100,NoArch
330fda1ac27c78ae69942f1303a7598fe5fdc67a,0,0,0,0,0,0,0,0,0,0,0,0,0,0,0,106,11,0,0,0,0,0,0,0,0,0,0,100,NoArch
39f2eaf7421b7973a76fd3b9c3f388fa97831942,0,0,0,0,0,0,0,0,0,0,0,0,0,0,0,107,12,0,0,0,0,0,0,0,0,0,0,100,NoArch
2807d133e9e32c3107339944fb7a1fead71c141d,0,0,0,0,0,0,0,0,0,0,0,0,0,0,0,108,13,0,0,0,0,0,0,0,0,0,0,100,NoArch
7b6d2ac767e9dedb08015d99fd80e039da58c4d8,0,0,0,0,0,0,0,0,0,0,0,0,0,0,0,109,14,0,0,0,0,0,0,0,0,0,0,100,NoArch
bfee6323f2a4118e70943cec0e2805cafed6c09b,4,4,4,0,8,0,0,0,19,1737,1,4,2,953,6,6,2,63,63,0,6646,6646,0,58,58,0,0,100,NoArch
4a7ba0169c7096488f302cf95b4bbb9a3f3452ef,6,62,87,25,149,0,0,0,19,2646,1,1,2.473790681,843,5,9,1,22,22,0,5292,5286,6,17,17,0,1,100,NoArch
ed74ad96676ee98372d660a902460aaabc30210d,2,15,4,11,19,0,0,0,112,176,1,2,0.485460761,2224,24,10,2,351,350,1,13149,13110,39,138,138,0,1,100,NoArch
99f2eb6ec2058f9a68438f10cb2543850298577b,1,16,12,4,28,0,0,0,132,73,1,1,0,2059,28,7,3,466,466,0,10599,10621,22,196,196,0,0,100,NoArch
02a0b72889579e391b74f06709f0b4e9d4616ef3,1,6,7,1,13,0,0,0,27,1813,1,1,0,181,5,8,4,35,35,0,1205,1207,2,9,9,0,0,100,NoArch
742a7679ec2845ac746469fe5a96f4e8963de56a,0,0,0,0,0,0,0,0,0,0,0,0,0,0,0,27,0,0,0,0,0,0,0,0,0,0,1,100,NoArch
7704f5ac462dd61486938df11f5e76aa16ed2f7e,0,0,0,0,0,0,0,0,0,0,0,0,0,0,0,110,13,0,0,0,0,0,0,0,0,0,0,100,NoArch
b93d8d925ee0346e0d22364e0619984b71b7aef9,0,0,0,0,0,0,0,0,0,0,0,0,0,0,0,111,14,0,0,0,0,0,0,0,0,0,0,100,NoArch
b1760409124b0d129bf06691f0aa5f005e707425,0,0,0,0,0,0,0,0,0,0,0,0,0,0,0,112,15,0,0,0,0,0,0,0,0,0,0,100,NoArch
d4ef1f1c144e0b7d4026765c209c83cb0acfe311,0,0,0,0,0,0,0,0,0,0,0,0,0,0,0,28,1,0,0,0,0,0,0,0,0,0,1,100,NoArch
80a2a6f275ad31a71ba228ead3032d0afe6dbfcd,0,0,0,0,0,0,0,0,0,0,0,0,0,0,0,113,12,0,0,0,0,0,0,0,0,0,0,100,NoArch
4b60d817a072b4fd6be096603828d2a0167c757b,0,0,0,0,0,0,0,0,0,0,0,0,0,0,0,114,13,0,0,0,0,0,0,0,0,0,0,100,NoArch
e24cba1d4ce35696c998a5508aaede687421ff89,0,0,0,0,0,0,0,0,0,0,0,0,0,0,0,0,0,0,0,0,0,0,0,0,0,0,1,100,NoArch
825adb27867696d7864c3962f386f3bfb29726be,0,0,0,0,0,0,0,0,0,0,0,0,0,0,0,11,3,0,0,0,0,0,0,0,0,0,1,100,NoArch
8e19785a6e0083db58027b912c727ea4abc2bde0,0,0,0,0,0,0,0,0,0,0,0,0,0,0,0,115,9,0,0,0,0,0,0,0,0,0,0,100,NoArch
c211f4448ebbc52a89119e0cd7204683e534a244,0,0,0,0,0,0,0,0,0,0,0,0,0,0,0,69,0,0,0,0,0,0,0,0,0,0,1,100,NoArch
a2e37ae187c8edd29f2a7db69f4bac4229b42cf9,0,0,0,0,0,0,0,0,0,0,0,0,0,0,0,9,2,0,0,0,0,0,0,0,0,0,1,100,NoArch
9554cafc264c3589bb6eac505e7314a18c79ce26,0,0,0,0,0,0,0,0,0,0,0,0,0,0,0,10,3,0,0,0,0,0,0,0,0,0,1,100,NoArch
20ecac350a6e77b21c5447528cf747146adfea24,0,0,0,0,0,0,0,0,0,0,0,0,0,0,0,7,0,0,0,0,0,0,0,0,0,0,1,100,NoArch
3babacbf4a0bb61a913ffabdf5e635eeee74ac55,0,0,0,0,0,0,0,0,0,0,0,0,0,0,0,1,1,0,0,0,0,0,0,0,0,0,1,100,NoArch
332e403d0639490c9ed4b253532bdda137d232f1,0,0,0,0,0,0,0,0,0,0,0,0,0,0,0,2,2,0,0,0,0,0,0,0,0,0,1,100,NoArch
4b5c9b11a6355ed512a377999562dee958b62d26,0,0,0,0,0,0,0,0,0,0,0,0,0,0,0,3,3,0,0,0,0,0,0,0,0,0,1,100,NoArch
dd33275ca8eda2831f7acbbdb2c0276ea9a9e544,0,0,0,0,0,0,0,0,0,0,0,0,0,0,0,4,4,0,0,0,0,0,0,0,0,0,1,100,NoArch
ef3fb50465f4f44859a40b665f5ca23870299905,0,0,0,0,0,0,0,0,0,0,0,0,0,0,0,5,5,0,0,0,0,0,0,0,0,0,1,100,NoArch
adfd147d3ac403b73233c2aedeb59bfdcbedcca4,0,0,0,0,0,0,0,0,0,0,0,0,0,0,0,116,6,0,0,0,0,0,0,0,0,0,0,100,NoArch
e6eaf20053f01d0c41945a49d4ad1f465d185e17,0,0,0,0,0,0,0,0,0,0,0,0,0,0,0,6,6,0,0,0,0,0,0,0,0,0,1,100,NoArch
4cd90d08a97d3d9dbc74113efd6df142aa749a3d,0,0,0,0,0,0,0,0,0,0,0,0,0,0,0,7,7,0,0,0,0,0,0,0,0,0,1,100,NoArch
76ccd2b7fd125da86df34f431ac2d9dd2364bbcb,0,0,0,0,0,0,0,0,0,0,0,0,0,0,0,8,8,0,0,0,0,0,0,0,0,0,1,100,NoArch
af76dccce0bf375109cbea11ad12a0df694361bd,0,0,0,0,0,0,0,0,0,0,0,0,0,0,0,12,1,0,0,0,0,0,0,0,0,0,1,100,NoArch
e2e1638c583af8c5a22122bfda392eafa19ad018,0,0,0,0,0,0,0,0,0,0,0,0,0,0,0,0,0,0,0,0,0,0,0,0,0,0,0,100,NoArch
4416e27faed9ddfab1f3703d830c19f9c7819f2a,0,0,0,0,0,0,0,0,0,0,0,0,0,0,0,9,9,0,0,0,0,0,0,0,0,0,1,100,NoArch
5db9a0d887c0b9fb7be46d21adfb7a8b5c4403ee,0,0,0,0,0,0,0,0,0,0,0,0,0,0,0,10,10,0,0,0,0,0,0,0,0,0,1,100,NoArch
2afe66d1ae48ac0bda78a59ce4fe3341a8e11ddb,0,0,0,0,0,0,0,0,0,0,0,0,0,0,0,11,11,0,0,0,0,0,0,0,0,0,1,100,NoArch
d5f474bc246f1c3c122f570b7da7eb10c32377ed,0,0,0,0,0,0,0,0,0,0,0,0,0,0,0,12,12,0,0,0,0,0,0,0,0,0,1,100,NoArch
e679b1b05f5a212896b325e20ee786c35a7a4cd6,0,0,0,0,0,0,0,0,0,0,0,0,0,0,0,13,13,0,0,0,0,0,0,0,0,0,1,100,NoArch
101e30305eecdd97a21dff14a6a9de5cda6d617e,0,0,0,0,0,0,0,0,0,0,0,0,0,0,0,14,14,0,0,0,0,0,0,0,0,0,1,100,NoArch
1e4ff08dfe739a108d515cdac994af7ad02158b9,0,0,0,0,0,0,0,0,0,0,0,0,0,0,0,8,1,0,0,0,0,0,0,0,0,0,1,100,NoArch
b8028322c56361df1cd1e38d10a17f6fb3e0d342,0,0,0,0,0,0,0,0,0,0,0,0,0,0,0,15,15,0,0,0,0,0,0,0,0,0,1,100,NoArch
81812a0b6c9426647b2827a02b7d33a5ba340480,0,0,0,0,0,0,0,0,0,0,0,0,0,0,0,13,2,0,0,0,0,0,0,0,0,0,1,100,NoArch
2d337f93436b42ca50ae981a0741b7f5ec9055c2,0,0,0,0,0,0,0,0,0,0,0,0,0,0,0,0,0,0,0,0,0,0,0,0,0,0,0,100,NoArch
8aa071cd4135525e3ca550f0fc16623a1cf2750a,0,0,0,0,0,0,0,0,0,0,0,0,0,0,0,0,0,0,0,0,0,0,0,0,0,0,1,100,NoArch
cd53fadd0229eff796faf4ba7d970a45cd7baf34,0,0,0,0,0,0,0,0,0,0,0,0,0,0,0,14,3,0,0,0,0,0,0,0,0,0,1,100,NoArch
76d1cc34cfd8196c2eadeb6b26339e6ce332d996,0,0,0,0,0,0,0,0,0,0,0,0,0,0,0,15,4,0,0,0,0,0,0,0,0,0,1,100,NoArch
27d4ea6abeea335fa525768a31d814681d70c1a3,0,0,0,0,0,0,0,0,0,0,0,0,0,0,0,117,7,0,0,0,0,0,0,0,0,0,0,100,NoArch
32e79fba3ab92f616658d939e3cdd14b18d63c3f,0,0,0,0,0,0,0,0,0,0,0,0,0,0,0,118,8,0,0,0,0,0,0,0,0,0,0,100,NoArch
355cf468ce37af8e1e97975d6a413633dc1c6837,0,0,0,0,0,0,0,0,0,0,0,0,0,0,0,16,5,0,0,0,0,0,0,0,0,0,1,100,NoArch
2cb26f6bfc638f741e918f4ad0a42d99b2c2e832,0,0,0,0,0,0,0,0,0,0,0,0,0,0,0,17,6,0,0,0,0,0,0,0,0,0,1,100,NoArch
e217c5e542f6377a73d9ca5346c3ed97a6089f48,0,0,0,0,0,0,0,0,0,0,0,0,0,0,0,18,7,0,0,0,0,0,0,0,0,0,3,100,NoArch
e6849d13d4ead05333f491ba37756974dae1f5de,0,0,0,0,0,0,0,0,0,0,0,0,0,0,0,119,9,0,0,0,0,0,0,0,0,0,0,100,NoArch
578c81bc0a2ae3ffee1b4b58d6947a81c23054e2,0,0,0,0,0,0,0,0,0,0,0,0,0,0,0,0,0,0,0,0,0,0,0,0,0,0,1,100,NoArch
02aa8d4cbba2f5c6f8050f5e2cc92915b70c13e4,0,0,0,0,0,0,0,0,0,0,0,0,0,0,0,11,2,0,0,0,0,0,0,0,0,0,1,100,NoArch
bad06d0b14de58a7419688493254c16477677373,0,0,0,0,0,0,0,0,0,0,0,0,0,0,0,12,3,0,0,0,0,0,0,0,0,0,1,100,NoArch
522c60409aef60778ab43cb704de1636de137bee,0,0,0,0,0,0,0,0,0,0,0,0,0,0,0,1,1,0,0,0,0,0,0,0,0,0,1,100,NoArch
5d1e525ef00f84d28929633e4400b356a74f1000,0,0,0,0,0,0,0,0,0,0,0,0,0,0,0,13,4,0,0,0,0,0,0,0,0,0,1,100,NoArch
33019d75eec9c9dd414b645a912a4fe5cd84f28a,0,0,0,0,0,0,0,0,0,0,0,0,0,0,0,14,5,0,0,0,0,0,0,0,0,0,0,100,NoArch
1b019814dc1a875c90e37a6edf61ca392f1567a3,0,0,0,0,0,0,0,0,0,0,0,0,0,0,0,19,8,0,0,0,0,0,0,0,0,0,1,100,NoArch
66f2b47edc2b550616f007fc6e41d5f66771f569,0,0,0,0,0,0,0,0,0,0,0,0,0,0,0,20,9,0,0,0,0,0,0,0,0,0,1,100,NoArch
f66f7470a982f706e812dedbc66abba530ff82e5,0,0,0,0,0,0,0,0,0,0,0,0,0,0,0,21,10,0,0,0,0,0,0,0,0,0,1,100,NoArch
e8ce233387929144ae2a8ca78865956b443624b1,0,0,0,0,0,0,0,0,0,0,0,0,0,0,0,22,11,0,0,0,0,0,0,0,0,0,1,100,NoArch
1a2d0a36b910fab16cc85399d38dd030dcd74f5c,0,0,0,0,0,0,0,0,0,0,0,0,0,0,0,0,0,0,0,0,0,0,0,0,0,0,1,100,NoArch
5af11f3c70ed93a19ed77cf6a48351bacdae215d,0,0,0,0,0,0,0,0,0,0,0,0,0,0,0,23,12,0,0,0,0,0,0,0,0,0,1,100,NoArch
9164b7d497e9c473d56e2d2c50f1797f3b39caba,0,0,0,0,0,0,0,0,0,0,0,0,0,0,0,15,6,0,0,0,0,0,0,0,0,0,1,100,NoArch
f666c568ccd11493292acdafcc2ebf2a5818eed0,0,0,0,0,0,0,0,0,0,0,0,0,0,0,0,16,7,0,0,0,0,0,0,0,0,0,1,100,NoArch
f256aed6747b7feaa7fa32d5fd722d18cf64a7f8,0,0,0,0,0,0,0,0,0,0,0,0,0,0,0,17,8,0,0,0,0,0,0,0,0,0,1,100,NoArch
c81e1aa349bc6cf9114b69641a95f99e981b845a,0,0,0,0,0,0,0,0,0,0,0,0,0,0,0,18,9,0,0,0,0,0,0,0,0,0,1,100,NoArch
34ba17f1c486f1fd7e801e6a204ad62b78d80ee3,0,0,0,0,0,0,0,0,0,0,0,0,0,0,0,24,13,0,0,0,0,0,0,0,0,0,1,100,NoArch
029cd6169c3f0201402f4db7f9f69232ec4f6afa,0,0,0,0,0,0,0,0,0,0,0,0,0,0,0,120,10,0,0,0,0,0,0,0,0,0,0,100,NoArch
ee2953e0aabc8bf67872e5006e898c502c16e4e0,0,0,0,0,0,0,0,0,0,0,0,0,0,0,0,25,14,0,0,0,0,0,0,0,0,0,1,100,NoArch
ceaf64952e2297964e82f400f426fc0490bf7fea,3,51,8,43,59,0,0,0,113,77,1,3,0.821498557,2786,25,0,0,476,471,5,16504,16297,207,173,170,3,1,100,NoArch
abc861b54199b2d8b597b2ca97d8f26d4ed4e51a,0,0,0,0,0,0,0,0,0,0,0,0,0,0,0,0,0,0,0,0,0,0,0,0,0,0,1,100,NoArch
9e39086df0cac713a4813ec79687f42819ec0cd8,0,0,0,0,0,0,0,0,0,0,0,0,0,0,0,16,16,0,0,0,0,0,0,0,0,0,1,100,NoArch
2e63629d461eb932fdfd6e0f1ac5140aae756391,0,0,0,0,0,0,0,0,0,0,0,0,0,0,0,17,17,0,0,0,0,0,0,0,0,0,1,100,NoArch
ba27d3f9bd77ce06ae562fa53fc8e6cd7c8f68b0,0,0,0,0,0,0,0,0,0,0,0,0,0,0,0,18,18,0,0,0,0,0,0,0,0,0,1,100,NoArch
064a1ab945963baff282912a8f5b7e0691683d40,0,0,0,0,0,0,0,0,0,0,0,0,0,0,0,19,19,0,0,0,0,0,0,0,0,0,1,100,NoArch
a3d4e1d2ecbc5fb0edfc40723723122e06185f86,0,0,0,0,0,0,0,0,0,0,0,0,0,0,0,19,10,0,0,0,0,0,0,0,0,0,0,100,NoArch
4be25dfd2b04b565b57ac391c80c7b9e1c0c48db,0,0,0,0,0,0,0,0,0,0,0,0,0,0,0,121,11,0,0,0,0,0,0,0,0,0,0,100,NoArch
513da007d41970fdca061e010b662a702be9e75f,0,0,0,0,0,0,0,0,0,0,0,0,0,0,0,20,11,0,0,0,0,0,0,0,0,0,0,100,NoArch
756c79d889b1411d783ed2a4014e94dbe5493edd,0,0,0,0,0,0,0,0,0,0,0,0,0,0,0,9,2,0,0,0,0,0,0,0,0,0,1,100,NoArch
be59c1b9158966f74394b778f6ea40fab7ecae95,0,0,0,0,0,0,0,0,0,0,0,0,0,0,0,26,15,0,0,0,0,0,0,0,0,0,1,100,NoArch
7b7ed02fee2c32f7d3ed3b6e02691e565077525e,0,0,0,0,0,0,0,0,0,0,0,0,0,0,0,0,0,0,0,0,0,0,0,0,0,0,0,100,NoArch
d72b50f5d7fcb7a85bea700177f3e45beab567ef,0,0,0,0,0,0,0,0,0,0,0,0,0,0,0,21,12,0,0,0,0,0,0,0,0,0,0,100,NoArch
e67b16b516bba54b20662b7fa7423eb8704bcda2,0,0,0,0,0,0,0,0,0,0,0,0,0,0,0,93,0,0,0,0,0,0,0,0,0,0,0,100,NoArch
dcc63f9cc15339a4b7f0b7835e77d8474d6b2f71,0,0,0,0,0,0,0,0,0,0,0,0,0,0,0,22,13,0,0,0,0,0,0,0,0,0,0,100,NoArch
98217a3fc33806998df4e35e07c36b739b78d246,0,0,0,0,0,0,0,0,0,0,0,0,0,0,0,20,20,0,0,0,0,0,0,0,0,0,1,100,NoArch
8f80ac5cc2577ada4b0fce347f6435bf9e778127,0,0,0,0,0,0,0,0,0,0,0,0,0,0,0,21,21,0,0,0,0,0,0,0,0,0,1,100,NoArch
b2085e1fba2fb40a14116d9207030b3285f45f26,0,0,0,0,0,0,0,0,0,0,0,0,0,0,0,22,22,0,0,0,0,0,0,0,0,0,1,100,NoArch
1bc79861c3d7202d117ecf88711f3418c57d637e,0,0,0,0,0,0,0,0,0,0,0,0,0,0,0,23,23,0,0,0,0,0,0,0,0,0,1,100,NoArch
5c96c60912c97dbf58818e4abeae8938534e253b,0,0,0,0,0,0,0,0,0,0,0,0,0,0,0,24,24,0,0,0,0,0,0,0,0,0,1,100,NoArch
be565d430feae8943e3947e0750301d5f7874e53,0,0,0,0,0,0,0,0,0,0,0,0,0,0,0,25,25,0,0,0,0,0,0,0,0,0,1,100,NoArch
1af074275397a698e64a0b9a64b3270a04032aee,0,0,0,0,0,0,0,0,0,0,0,0,0,0,0,26,26,0,0,0,0,0,0,0,0,0,1,100,NoArch
bf0f1175464e2a8a847ffebb020d8eb3edaee5ee,0,0,0,0,0,0,0,0,0,0,0,0,0,0,0,27,27,0,0,0,0,0,0,0,0,0,3,100,NoArch
ea797c9226bb6a29293901e670038cc2dffb3692,0,0,0,0,0,0,0,0,0,0,0,0,0,0,0,28,28,0,0,0,0,0,0,0,0,0,1,100,NoArch
b99890fa3c83a7fe016939b82e2c3a9248d6f384,0,0,0,0,0,0,0,0,0,0,0,0,0,0,0,29,29,0,0,0,0,0,0,0,0,0,3,100,NoArch
a057bb1e49b9a72b8e11ba1da37400753a8c863e,0,0,0,0,0,0,0,0,0,0,0,0,0,0,0,30,30,0,0,0,0,0,0,0,0,0,3,100,NoArch
3a600f36db48d3bf236f06a4b7ae9a264443ae7e,4,34,3,31,37,0,0,0,22,2156,1,3,1.834567814,1663,7,0,0,189,159,30,10555,5558,4997,55,29,26,1,95.61177078,Arch
a28d1088ab76771a73108be5a908973ae0ca8f06,0,0,0,0,0,0,0,0,0,0,0,0,0,0,0,122,7,0,0,0,0,0,0,0,0,0,0,100,NoArch
e6201e79bc701df4100bacaa35dffc501f2b1350,0,0,0,0,0,0,0,0,0,0,0,0,0,0,0,123,8,0,0,0,0,0,0,0,0,0,0,100,NoArch
1551d61a07e6a62bc6cbc1f78c742bde97843b92,0,0,0,0,0,0,0,0,0,0,0,0,0,0,0,124,9,0,0,0,0,0,0,0,0,0,0,100,NoArch
34e75a3995feb26721ecb90e89023392e27d9f8b,0,0,0,0,0,0,0,0,0,0,0,0,0,0,0,7,0,0,0,0,0,0,0,0,0,0,1,100,NoArch
767e7fe1e1459339942d9d8d2c4f7cb3f01b05dc,2,48,37,11,85,0,0,0,23,170,1,2,0.450066658,349,9,8,1,32,21,11,2040,1754,286,17,11,6,1,100,NoArch
d2c36d447368f184d5002149339dd8b75a85066e,0,0,0,0,0,0,0,0,0,0,0,0,0,0,0,9,2,0,0,0,0,0,0,0,0,0,1,100,NoArch
460b2b3683d98d40630da86d3b466e94015b9d7e,1,1,1,0,2,0,0,0,114,18,1,1,0,1326,34,2,0,267,267,0,6181,6181,0,88,88,0,1,100,NoArch
f126908aa18a2874512067bfc41f14cd8b6f55c4,0,0,0,0,0,0,0,0,0,0,0,0,0,0,0,23,12,0,0,0,0,0,0,0,0,0,1,100,NoArch
ba0bd1dbdf50501d5034ec55b679d3865f2dcdf7,0,0,0,0,0,0,0,0,0,0,0,0,0,0,0,10,3,0,0,0,0,0,0,0,0,0,1,100,NoArch
a249c148976c68307777a194ebfa9c3e2231d8bf,8,256,21,235,277,1,0,1,106,1037,1,4,1.122372574,3775,1,27,15,724,682,42,20804,19769,1035,268,247,21,1,99.94788953,NoArch
a9de24e44874642c114593ca0e4122954505dd2b,0,0,0,0,0,0,0,0,0,0,0,0,0,0,0,0,0,0,0,0,0,0,0,0,0,0,1,100,NoArch
c59909c8e6988db75e0ca6a006b8aaed5abd81cb,0,0,0,0,0,0,0,0,0,0,0,0,0,0,0,125,8,0,0,0,0,0,0,0,0,0,0,100,NoArch
ebad7afa647fb1c02394d4eac545db35e538fb88,0,0,0,0,0,0,0,0,0,0,0,0,0,0,0,24,3,0,0,0,0,0,0,0,0,0,0,100,NoArch
c2cc66aa84476139bd8629dda59e55dfac2f58fc,2,20,6,14,26,0,0,0,28,1486,1,2,0.391243564,277,6,28,1,42,6,36,1654,347,1307,13,4,9,1,98.09474768,NoArch
198cccdbae9ff40b7d9eff34dd2636ece298ae6a,2,6,1,5,7,0,0,0,133,313,1,2,0.863120569,2427,13,3,1,506,466,40,13501,10599,2902,235,196,39,1,100,NoArch
b0fbd92ddce1f44bd7b8b41f14069ec2e360087b,18,953,32,921,985,13,0,13,71,101,1,6,3.845980073,1469,6,4,2,331,245,86,12122,7980,4142,145,105,40,2,99.21657822,NoArch
28d6c802b73948d6f3a8e97441a865bf0115b669,2,4,6,2,10,0,0,0,29,4,1,2,0.881290899,291,6,29,2,42,42,0,1632,1654,22,13,13,0,1,100,NoArch
a2a1c8130a4d114a5a8b61f94b6a09bd3d91cdf7,0,0,0,0,0,0,0,0,0,0,0,0,0,0,0,25,2,0,0,0,0,0,0,0,0,0,0,100,NoArch
065fb7d721b99aff1e4523f3eeb268f8b8ad0e33,0,0,0,0,0,0,0,0,0,0,0,0,0,0,0,126,4,0,0,0,0,0,0,0,0,0,0,100,NoArch
fa8938faef01767ba086aab3082c928d457a14d1,0,0,0,0,0,0,0,0,0,0,0,0,0,0,0,26,3,0,0,0,0,0,0,0,0,0,1,100,NoArch
f89c79dff3076b15076fcb7ad3665c5605fedff8,0,0,0,0,0,0,0,0,0,0,0,0,0,0,0,27,4,0,0,0,0,0,0,0,0,0,0,100,NoArch
cbbb957a2fa0944b6fca4a0eba02e9fba7496859,0,0,0,0,0,0,0,0,0,0,0,0,0,0,0,28,5,0,0,0,0,0,0,0,0,0,1,100,NoArch
d69b8fcc13beb861773eb5a94ce1d46bb34f5530,0,0,0,0,0,0,0,0,0,0,0,0,0,0,0,29,6,0,0,0,0,0,0,0,0,0,0,100,NoArch
6c14b21b51cab705d1e8953000b63d109d74a7a4,0,0,0,0,0,0,0,0,0,0,0,0,0,0,0,30,7,0,0,0,0,0,0,0,0,0,0,100,NoArch
377c895864a10d13544a2f2e69ef6a0b423b2eb5,0,0,0,0,0,0,0,0,0,0,0,0,0,0,0,31,8,0,0,0,0,0,0,0,0,0,0,100,NoArch
3e9c37f102a8e07876ae628dcd367fad0107c0f8,0,0,0,0,0,0,0,0,0,0,0,0,0,0,0,32,9,0,0,0,0,0,0,0,0,0,0,100,NoArch
7c6e849a4d9da8e055bf517554993916c0546231,0,0,0,0,0,0,0,0,0,0,0,0,0,0,0,29,0,0,0,0,0,0,0,0,0,0,1,100,NoArch
3bd81cf55fef06a1350cdea40195910a48732575,0,0,0,0,0,0,0,0,0,0,0,0,0,0,0,30,1,0,0,0,0,0,0,0,0,0,1,100,NoArch
d401b5558ac3365697f6ca7a2b8b6b3310be48fd,0,0,0,0,0,0,0,0,0,0,0,0,0,0,0,31,2,0,0,0,0,0,0,0,0,0,1,100,NoArch
f55f91ad7193f45125823348539fdc32e4bfbd7e,0,0,0,0,0,0,0,0,0,0,0,0,0,0,0,33,9,0,0,0,0,0,0,0,0,0,1,100,NoArch
b36261509b2e1c538ce982e6f5a1fb2def4e98cb,0,0,0,0,0,0,0,0,0,0,0,0,0,0,0,32,3,0,0,0,0,0,0,0,0,0,1,100,NoArch
83642cff010519f1be8fa35bf98a53929855c894,0,0,0,0,0,0,0,0,0,0,0,0,0,0,0,33,4,0,0,0,0,0,0,0,0,0,1,100,NoArch
5dc9aed6cf9a0cb8fef0a3d0eeee0ba5992fe7ba,0,0,0,0,0,0,0,0,0,0,0,0,0,0,0,34,5,0,0,0,0,0,0,0,0,0,1,100,NoArch
f34f3d07ff4376a9d6e9c93b5558947dc32bf15a,0,0,0,0,0,0,0,0,0,0,0,0,0,0,0,11,0,0,0,0,0,0,0,0,0,0,0,100,NoArch
bf0b22f4ec2212a869ffb6fa68e6ad1309d0b88c,0,0,0,0,0,0,0,0,0,0,0,0,0,0,0,34,10,0,0,0,0,0,0,0,0,0,1,100,NoArch
da1b0c2849fbbbece47a547d6011343bd4e3dc4b,0,0,0,0,0,0,0,0,0,0,0,0,0,0,0,127,2,0,0,0,0,0,0,0,0,0,0,100,NoArch
4c79e57be5c0ac5f7e5e476faff77368014b792c,0,0,0,0,0,0,0,0,0,0,0,0,0,0,0,128,3,0,0,0,0,0,0,0,0,0,0,100,NoArch
46ac7008c4d533a51d5ff24a3dc410b2860a00e0,0,0,0,0,0,0,0,0,0,0,0,0,0,0,0,12,1,0,0,0,0,0,0,0,0,0,1,100,NoArch
59d884ccae30d50b6cdca367f0e2cd496e74c0ae,0,0,0,0,0,0,0,0,0,0,0,0,0,0,0,35,6,0,0,0,0,0,0,0,0,0,1,100,NoArch
3394798a71a503ce057c755d2395d1ab98090459,0,0,0,0,0,0,0,0,0,0,0,0,0,0,0,129,4,0,0,0,0,0,0,0,0,0,0,100,NoArch
b796146cf41d1889d7f011e89576da5a529ccd9a,0,0,0,0,0,0,0,0,0,0,0,0,0,0,0,13,2,0,0,0,0,0,0,0,0,0,1,100,NoArch
410231a05597da7cd2dc0591db045eecf9c7a4ab,0,0,0,0,0,0,0,0,0,0,0,0,0,0,0,30,2,0,0,0,0,0,0,0,0,0,1,100,NoArch
1f6749d0250405106db6aaf21266cfe907d6f191,0,0,0,0,0,0,0,0,0,0,0,0,0,0,0,36,7,0,0,0,0,0,0,0,0,0,1,100,NoArch
c5e10d75d700862d230dc1aff1c5d7e82931f54b,0,0,0,0,0,0,0,0,0,0,0,0,0,0,0,37,8,0,0,0,0,0,0,0,0,0,1,100,NoArch
08405f71971e1e70a9d7571decf5c13d13bd6086,0,0,0,0,0,0,0,0,0,0,0,0,0,0,0,31,3,0,0,0,0,0,0,0,0,0,1,100,NoArch
307adc0c3acc600205c2777ac71bdc9cafabc523,0,0,0,0,0,0,0,0,0,0,0,0,0,0,0,32,4,0,0,0,0,0,0,0,0,0,1,100,NoArch
96c10ab3bce90dd52a3f44ce0915de8fb673244e,1,15,0,15,15,0,0,0,21,731,1,1,0,844,13,33,5,47,0,47,9937,0,9937,44,0,44,1,100,NoArch
ae77f72f93cfdb91397d878e7a4cdb7f32d61cdf,0,0,0,0,0,0,0,0,0,0,0,0,0,0,0,130,4,0,0,0,0,0,0,0,0,0,0,100,NoArch
3edb024ac4f7d70ba2ac1969651fff3a83404e6e,0,0,0,0,0,0,0,0,0,0,0,0,0,0,0,14,3,0,0,0,0,0,0,0,0,0,1,100,NoArch
7bbbbc975e3bd6ac8e9ab4faa86a9c49ee965b09,0,0,0,0,0,0,0,0,0,0,0,0,0,0,0,31,0,0,0,0,0,0,0,0,0,0,3,100,NoArch
93941e323c467b6381c4157c9ff9ebb02d64a5f8,0,0,0,0,0,0,0,0,0,0,0,0,0,0,0,34,4,0,0,0,0,0,0,0,0,0,1,100,NoArch
9e2191a460f6edec201fa87d08c75c407c9df12d,0,0,0,0,0,0,0,0,0,0,0,0,0,0,0,1,0,0,0,0,0,0,0,0,0,0,1,100,NoArch
23a1c882a7215c0737e751de8f4e6ca92588d270,0,0,0,0,0,0,0,0,0,0,0,0,0,0,0,35,5,0,0,0,0,0,0,0,0,0,1,100,NoArch
0de8c6e2b1cde3da9bb03ab15747001408559f93,0,0,0,0,0,0,0,0,0,0,0,0,0,0,0,38,9,0,0,0,0,0,0,0,0,0,1,100,NoArch
6980d52cbe290ecdaa72d22902a1ca8e61c560ce,0,0,0,0,0,0,0,0,0,0,0,0,0,0,0,39,10,0,0,0,0,0,0,0,0,0,1,100,NoArch
dcb2b06e8472c2d64a31470c67931df780fe71c9,0,0,0,0,0,0,0,0,0,0,0,0,0,0,0,131,4,0,0,0,0,0,0,0,0,0,0,100,NoArch
b1da3332d8ba6ac76946447bc1834c248c427aa5,0,0,0,0,0,0,0,0,0,0,0,0,0,0,0,40,5,0,0,0,0,0,0,0,0,0,1,100,NoArch
11e265fccbb31add03d0182f13aa125ff0f3ee30,2,18,1,17,19,0,0,0,49,2233,1,2,0.485460761,697,6,10,0,129,126,3,3897,3479,418,64,61,3,1,99.97491219,NoArch
c714bdb2c426acf75778d61fd7ed966be4019841,0,0,0,0,0,0,0,0,0,0,0,0,0,0,0,132,1,0,0,0,0,0,0,0,0,0,0,100,NoArch
cc5e93de2d11ec2adfad734dffd4db50606e7f22,0,0,0,0,0,0,0,0,0,0,0,0,0,0,0,133,2,0,0,0,0,0,0,0,0,0,0,100,NoArch
60259435f3a0ebb4bc248eb800095a5ff9f07545,0,0,0,0,0,0,0,0,0,0,0,0,0,0,0,134,3,0,0,0,0,0,0,0,0,0,0,100,NoArch
2bb7eb3a42b98f846936b4d9bc1e4345f6de6e5b,0,0,0,0,0,0,0,0,0,0,0,0,0,0,0,2,1,0,0,0,0,0,0,0,0,0,1,100,NoArch
150f91006df8cc32923bebe2bbbef462f749b511,0,0,0,0,0,0,0,0,0,0,0,0,0,0,0,15,0,0,0,0,0,0,0,0,0,0,1,100,NoArch
6fcd63c768f60f8f4ad59c56ddca1deb936f10ca,0,0,0,0,0,0,0,0,0,0,0,0,0,0,0,41,3,0,0,0,0,0,0,0,0,0,1,100,NoArch
7497d55d785818e7e1956d98d390c2ccdb3e8ef7,3,67,5,62,72,1,0,1,21,356,1,2,1.559379646,764,8,11,1,110,25,85,4039,2078,1961,69,23,46,1,99.84943538,NoArch
e9faaaab775606d6e8478f89b5c283c403a0c5d6,0,0,0,0,0,0,0,0,0,0,0,0,0,0,0,3,2,0,0,0,0,0,0,0,0,0,1,100,NoArch
359cedb13dc1335766aa39d60c12ae5de330681b,0,0,0,0,0,0,0,0,0,0,0,0,0,0,0,4,3,0,0,0,0,0,0,0,0,0,1,100,NoArch
7d0ad3fe030d694c1796651f23afbac26fd27c07,0,0,0,0,0,0,0,0,0,0,0,0,0,0,0,135,4,0,0,0,0,0,0,0,0,0,0,100,NoArch
26daa9e9375a557267784139d6fb9ad30287e507,0,0,0,0,0,0,0,0,0,0,0,0,0,0,0,136,5,0,0,0,0,0,0,0,0,0,0,100,NoArch
a9a422fd7b970c510aa55ee732b42110df24f4d2,0,0,0,0,0,0,0,0,0,0,0,0,0,0,0,36,1,0,0,0,0,0,0,0,0,0,1,100,NoArch
0531004a3edb01a428959c09daf539a8807cd24a,0,0,0,0,0,0,0,0,0,0,0,0,0,0,0,37,2,0,0,0,0,0,0,0,0,0,1,100,NoArch
6f8dbfe595b5cd677f8607ae42b5eedb3b1e6efe,0,0,0,0,0,0,0,0,0,0,0,0,0,0,0,5,3,0,0,0,0,0,0,0,0,0,1,100,NoArch
25214c631166336870197c1f4b6847ea248013a8,0,0,0,0,0,0,0,0,0,0,0,0,0,0,0,38,2,0,0,0,0,0,0,0,0,0,1,100,NoArch
861550958089f14576ad9f714d082a7c335e2d28,0,0,0,0,0,0,0,0,0,0,0,0,0,0,0,39,3,0,0,0,0,0,0,0,0,0,1,100,NoArch
cf62b38f13cdf878c6615e03e5a58ec6d43d4678,0,0,0,0,0,0,0,0,0,0,0,0,0,0,0,12,1,0,0,0,0,0,0,0,0,0,1,100,NoArch
47d816ffca840761075c501d678652893d77fade,0,0,0,0,0,0,0,0,0,0,0,0,0,0,0,16,1,0,0,0,0,0,0,0,0,0,1,100,NoArch
5fddcd2a24ee9d368aacaf861d27aaa538709a90,0,0,0,0,0,0,0,0,0,0,0,0,0,0,0,17,2,0,0,0,0,0,0,0,0,0,0,100,NoArch
ec47e23c7e64f828706b518f2af4503c141f36d4,0,0,0,0,0,0,0,0,0,0,0,0,0,0,0,18,3,0,0,0,0,0,0,0,0,0,1,100,NoArch
ff45ec9b7192be52abf7e57fdf8142112679ee9d,0,0,0,0,0,0,0,0,0,0,0,0,0,0,0,1,0,0,0,0,0,0,0,0,0,0,1,100,NoArch
ed37da7d3296d5997ff42eed3f26c6c3fb450821,0,0,0,0,0,0,0,0,0,0,0,0,0,0,0,19,4,0,0,0,0,0,0,0,0,0,1,100,NoArch
1324c6880f1127616dd4212ac926cc1ae6e96c5a,0,0,0,0,0,0,0,0,0,0,0,0,0,0,0,6,4,0,0,0,0,0,0,0,0,0,1,100,NoArch
b67c34c13007f5248bdb041ca2ae7228d57f773e,0,0,0,0,0,0,0,0,0,0,0,0,0,0,0,40,0,0,0,0,0,0,0,0,0,0,1,100,NoArch
ef98bc694cf05c0121f7433b95f1dfa369c1d17d,0,0,0,0,0,0,0,0,0,0,0,0,0,0,0,32,0,0,0,0,0,0,0,0,0,0,3,100,NoArch
c673f643ab3284c2b40a73c94447d1e2a2aaa14f,1,13,12,1,25,0,0,0,50,102,1,1,0,646,12,13,0,127,126,1,3491,3483,8,61,61,0,1,100,NoArch
94bbb7bcaf1f70742d21b30c701983061763bec9,0,0,0,0,0,0,0,0,0,0,0,0,0,0,0,41,1,0,0,0,0,0,0,0,0,0,1,100,NoArch
12e75f1fcfee5cd9f4388e0907d5f21503a528c9,0,0,0,0,0,0,0,0,0,0,0,0,0,0,0,137,0,0,0,0,0,0,0,0,0,0,0,100,NoArch
f771e3b1c5bd2e6ec1837984b1841201728152cd,0,0,0,0,0,0,0,0,0,0,0,0,0,0,0,42,2,0,0,0,0,0,0,0,0,0,1,100,NoArch
72ccbf8b829cf5d7c2aa1b95eaa0ea9c6bd8ab8c,0,0,0,0,0,0,0,0,0,0,0,0,0,0,0,33,1,0,0,0,0,0,0,0,0,0,2,100,NoArch
2602398a35450b2253cfeb54db32ae2aa2efab48,0,0,0,0,0,0,0,0,0,0,0,0,0,0,0,7,0,0,0,0,0,0,0,0,0,0,1,100,NoArch
cb1dbe9fd27aeb5c3f3c06c9cc503f26d43bf11f,0,0,0,0,0,0,0,0,0,0,0,0,0,0,0,43,3,0,0,0,0,0,0,0,0,0,1,100,NoArch
6412c13b5a56866639bb4f06258e767bf8de76fb,0,0,0,0,0,0,0,0,0,0,0,0,0,0,0,35,0,0,0,0,0,0,0,0,0,0,1,100,NoArch
724d85bcaa8a71f63d2bf99dcecb6722e23c1f9d,0,0,0,0,0,0,0,0,0,0,0,0,0,0,0,44,4,0,0,0,0,0,0,0,0,0,1,100,NoArch
67f6a4cdf19579dcf3e87de89e5164efdff4343b,0,0,0,0,0,0,0,0,0,0,0,0,0,0,0,45,5,0,0,0,0,0,0,0,0,0,1,100,NoArch
fbc9841cf8d7af6913cdc244bbb793eb1914004b,0,0,0,0,0,0,0,0,0,0,0,0,0,0,0,34,2,0,0,0,0,0,0,0,0,0,3,100,NoArch
bdd86d12a6315cdfd7edf3bd4511d07a683fb5b9,0,0,0,0,0,0,0,0,0,0,0,0,0,0,0,35,3,0,0,0,0,0,0,0,0,0,3,100,NoArch
51906dcbb62baf486210a20529ce7258e2b31f8d,0,0,0,0,0,0,0,0,0,0,0,0,0,0,0,36,4,0,0,0,0,0,0,0,0,0,3,100,NoArch
3d23a1621558627532cd2f8417c19e59b8bec6e7,0,0,0,0,0,0,0,0,0,0,0,0,0,0,0,0,0,0,0,0,0,0,0,0,0,0,1,100,NoArch
910eb90b4d8a8e57c27da7cd5d16d1f06693947d,0,0,0,0,0,0,0,0,0,0,0,0,0,0,0,37,5,0,0,0,0,0,0,0,0,0,3,100,NoArch
fd0df76dce4cc058261f31b2bf7c86accc3b0e32,0,0,0,0,0,0,0,0,0,0,0,0,0,0,0,20,0,0,0,0,0,0,0,0,0,0,1,100,NoArch
972e33af7a10c9a53feaf17ea60214fe4191f02e,0,0,0,0,0,0,0,0,0,0,0,0,0,0,0,0,0,0,0,0,0,0,0,0,0,0,1,100,NoArch
30a5c2ee75249778e5a7f2584ca1b47523c3253c,0,0,0,0,0,0,0,0,0,0,0,0,0,0,0,21,1,0,0,0,0,0,0,0,0,0,1,100,NoArch
70b37a70e6efd3591af5921f231446c9b013593a,0,0,0,0,0,0,0,0,0,0,0,0,0,0,0,46,6,0,0,0,0,0,0,0,0,0,1,100,NoArch
71da7a3634e6ceacaef363de343a72e8df4d4728,0,0,0,0,0,0,0,0,0,0,0,0,0,0,0,138,1,0,0,0,0,0,0,0,0,0,0,100,NoArch
4e670a36b6ae7f9aa3c824a8020877ad93924b8d,0,0,0,0,0,0,0,0,0,0,0,0,0,0,0,38,6,0,0,0,0,0,0,0,0,0,3,100,NoArch
05cbc2ba8ca438f71dfbc338475481b83180eefa,0,0,0,0,0,0,0,0,0,0,0,0,0,0,0,47,7,0,0,0,0,0,0,0,0,0,1,100,NoArch
d36fa68da7dd1a9060b6716ecf8bb09cb7d74eb1,0,0,0,0,0,0,0,0,0,0,0,0,0,0,0,22,2,0,0,0,0,0,0,0,0,0,1,100,NoArch
38a41d7a03ea0b5d51e459ded19abf5a88fdb50a,0,0,0,0,0,0,0,0,0,0,0,0,0,0,0,23,3,0,0,0,0,0,0,0,0,0,1,100,NoArch
0a6881aaba5fcf219401777f46b1f77b7b617cc8,0,0,0,0,0,0,0,0,0,0,0,0,0,0,0,48,8,0,0,0,0,0,0,0,0,0,1,100,NoArch
6fb62006b7bcda4365f3e86ed93ad5b98703938d,0,0,0,0,0,0,0,0,0,0,0,0,0,0,0,39,7,0,0,0,0,0,0,0,0,0,1,100,NoArch
87efd11a326274d7f87ac27f1fc5e0d652aa6e16,0,0,0,0,0,0,0,0,0,0,0,0,0,0,0,49,9,0,0,0,0,0,0,0,0,0,1,100,NoArch
b3a797b91e483eab72aefebbbb6ba70abdc762cb,0,0,0,0,0,0,0,0,0,0,0,0,0,0,0,50,10,0,0,0,0,0,0,0,0,0,1,100,NoArch
71675806326518b41268f84cca4c953f786b5b7b,0,0,0,0,0,0,0,0,0,0,0,0,0,0,0,51,11,0,0,0,0,0,0,0,0,0,2,100,NoArch
420716030c8ceeb40ab218ad10d4f84865044ea0,0,0,0,0,0,0,0,0,0,0,0,0,0,0,0,139,2,0,0,0,0,0,0,0,0,0,0,100,NoArch
dcdc3562d223bbf837761d99cfbf4fda3b630394,0,0,0,0,0,0,0,0,0,0,0,0,0,0,0,140,3,0,0,0,0,0,0,0,0,0,0,100,NoArch
8847826577a3315fe3663ec95ad1aa877ed44b5c,0,0,0,0,0,0,0,0,0,0,0,0,0,0,0,141,4,0,0,0,0,0,0,0,0,0,0,100,NoArch
3a8c8c9e7033fa1260046f63ac39411a6cd66ffe,0,0,0,0,0,0,0,0,0,0,0,0,0,0,0,142,5,0,0,0,0,0,0,0,0,0,0,100,NoArch
ee2911785823f26fa6cc4ed1bf285838405e3dd8,0,0,0,0,0,0,0,0,0,0,0,0,0,0,0,40,8,0,0,0,0,0,0,0,0,0,1,100,NoArch
36126feb661484f4c33e2091b9145b236a77e572,0,0,0,0,0,0,0,0,0,0,0,0,0,0,0,41,9,0,0,0,0,0,0,0,0,0,3,100,NoArch
25cc1b6f850c37605542b56efc72e339e27f7bca,0,0,0,0,0,0,0,0,0,0,0,0,0,0,0,143,6,0,0,0,0,0,0,0,0,0,0,100,NoArch
a19261e69775ec821de87eeadbfdd0afb8cdfd9f,0,0,0,0,0,0,0,0,0,0,0,0,0,0,0,144,7,0,0,0,0,0,0,0,0,0,0,100,NoArch
0f0db7e0fb8c6905e66fb33b9918118bb8abd2ae,0,0,0,0,0,0,0,0,0,0,0,0,0,0,0,8,1,0,0,0,0,0,0,0,0,0,1,100,NoArch
9a248d26b1267d6d23e3ca6bde4c34b85fd355f2,0,0,0,0,0,0,0,0,0,0,0,0,0,0,0,0,0,0,0,0,0,0,0,0,0,0,1,100,NoArch
2839bb76d525f63e63b6652df399c375a5f11e0d,3,31,14,17,45,0,0,0,36,1846,1,1,1.125682832,970,11,0,0,155,113,42,4580,3231,1349,78,59,19,1,100,NoArch
f2f01f10e44d1c314986e6c0c8b3db934d3ffa35,0,0,0,0,0,0,0,0,0,0,0,0,0,0,0,83,0,0,0,0,0,0,0,0,0,0,0,100,NoArch
e7eac0bb5e3b56958d126339048fcef2f633ca0a,0,0,0,0,0,0,0,0,0,0,0,0,0,0,0,36,0,0,0,0,0,0,0,0,0,0,0,100,NoArch
be2b3aa6405b5648e14b31682ab7dbb74a7724ed,0,0,0,0,0,0,0,0,0,0,0,0,0,0,0,145,6,0,0,0,0,0,0,0,0,0,0,100,NoArch
ed43466baf132154d173432fde1904d0891beb1e,0,0,0,0,0,0,0,0,0,0,0,0,0,0,0,146,7,0,0,0,0,0,0,0,0,0,0,100,NoArch
c38f8b4957dea20737b4bbbe3cc18872c46e2b28,0,0,0,0,0,0,0,0,0,0,0,0,0,0,0,147,8,0,0,0,0,0,0,0,0,0,0,100,NoArch
10eaa51f1c70d191f94c2ccebe265f1a811dc00d,0,0,0,0,0,0,0,0,0,0,0,0,0,0,0,42,3,0,0,0,0,0,0,0,0,0,1,100,NoArch
85a87258342d0de75e21e736a5a0ac4c39c025a3,0,0,0,0,0,0,0,0,0,0,0,0,0,0,0,24,1,0,0,0,0,0,0,0,0,0,1,100,NoArch
e36cc076fb431093b393fad58b64b8481f3240a5,0,0,0,0,0,0,0,0,0,0,0,0,0,0,0,25,2,0,0,0,0,0,0,0,0,0,1,100,NoArch
d6f6b79a19100190774a242b973fd5607f694f29,2,129,0,129,129,2,0,2,1,0,1,1,0.999956652,0,1,9,1,4,0,4,643,0,643,4,0,4,41,99.79944848,NoArch
01058c125217b8680fc5e55467d0c2401de4d150,0,0,0,0,0,0,0,0,0,0,0,0,0,0,0,52,0,0,0,0,0,0,0,0,0,0,1,100,NoArch
1254a4034da893ae6d58f412c732ba062026e1be,0,0,0,0,0,0,0,0,0,0,0,0,0,0,0,10,2,0,0,0,0,0,0,0,0,0,1,100,NoArch
2f17464908194b7c6b76bd04cca20b107ed4d075,0,0,0,0,0,0,0,0,0,0,0,0,0,0,0,11,3,0,0,0,0,0,0,0,0,0,1,100,NoArch
2b16e71ca773dd6c0e75aa06c8d86926ed8e1012,0,0,0,0,0,0,0,0,0,0,0,0,0,0,0,12,3,0,0,0,0,0,0,0,0,0,1,100,NoArch
eab0404a02d7d93ff371e9aaabd5a18eda19b511,0,0,0,0,0,0,0,0,0,0,0,0,0,0,0,53,1,0,0,0,0,0,0,0,0,0,1,100,NoArch
817727623788177fc86a64b45f3fb1d5dd7f2955,0,0,0,0,0,0,0,0,0,0,0,0,0,0,0,54,2,0,0,0,0,0,0,0,0,0,1,100,NoArch
fd6bedfee826ac21c469e6301781bdaace019a6e,0,0,0,0,0,0,0,0,0,0,0,0,0,0,0,55,3,0,0,0,0,0,0,0,0,0,1,100,NoArch
2f441fd1a5e4c64c77e83da2c1fef11312bf5097,0,0,0,0,0,0,0,0,0,0,0,0,0,0,0,56,4,0,0,0,0,0,0,0,0,0,1,100,NoArch
78b73a9894f5b91aaab4bbc2a2bec0502f2f0f96,0,0,0,0,0,0,0,0,0,0,0,0,0,0,0,57,5,0,0,0,0,0,0,0,0,0,1,100,NoArch
74d696be1b4f4fad831cb606daa9e39e860d9d09,0,0,0,0,0,0,0,0,0,0,0,0,0,0,0,148,0,0,0,0,0,0,0,0,0,0,0,100,NoArch
b015fe3a22b1f700cfd921bcc04f960a279fac83,0,0,0,0,0,0,0,0,0,0,0,0,0,0,0,149,1,0,0,0,0,0,0,0,0,0,0,100,NoArch
8639b766e0afaa564f76b1e43d8039d632412230,0,0,0,0,0,0,0,0,0,0,0,0,0,0,0,150,2,0,0,0,0,0,0,0,0,0,0,100,NoArch
c290e1da80f270065d858a8698c1742f1152d358,0,0,0,0,0,0,0,0,0,0,0,0,0,0,0,151,3,0,0,0,0,0,0,0,0,0,0,100,NoArch
cc6101f13330ab7c02d9fa37d28faba76358b873,0,0,0,0,0,0,0,0,0,0,0,0,0,0,0,152,4,0,0,0,0,0,0,0,0,0,0,100,NoArch
81833df4f4fd9713ca73644aa11711adb4712f13,0,0,0,0,0,0,0,0,0,0,0,0,0,0,0,153,5,0,0,0,0,0,0,0,0,0,0,100,NoArch
872038d4da35360bb71b73471c0bb73a1f60dcca,0,0,0,0,0,0,0,0,0,0,0,0,0,0,0,154,6,0,0,0,0,0,0,0,0,0,0,100,NoArch
cf7f9492ad8682459b4b9db18f203fd6e2c2f7f8,0,0,0,0,0,0,0,0,0,0,0,0,0,0,0,58,5,0,0,0,0,0,0,0,0,0,1,100,NoArch
8e6a24eaa182203ac1b1d929a53aa563638b0b65,0,0,0,0,0,0,0,0,0,0,0,0,0,0,0,155,7,0,0,0,0,0,0,0,0,0,0,100,NoArch
4981fd8d75ff092b590a6741b8d88349b202ee62,0,0,0,0,0,0,0,0,0,0,0,0,0,0,0,156,8,0,0,0,0,0,0,0,0,0,0,100,NoArch
a31c8b5517f04b0fbcfc32b7c9bd5a589ba05672,0,0,0,0,0,0,0,0,0,0,0,0,0,0,0,157,9,0,0,0,0,0,0,0,0,0,0,100,NoArch
fff979a3162cce5b286baa4de28e71d2142c0425,0,0,0,0,0,0,0,0,0,0,0,0,0,0,0,158,10,0,0,0,0,0,0,0,0,0,0,100,NoArch
29cd96ac06ec4a83af8de2725ad875b29557d28c,0,0,0,0,0,0,0,0,0,0,0,0,0,0,0,59,2,0,0,0,0,0,0,0,0,0,1,100,NoArch
af766fa76c2d7ee35b60c2256230a158b11bca53,0,0,0,0,0,0,0,0,0,0,0,0,0,0,0,159,3,0,0,0,0,0,0,0,0,0,0,100,NoArch
3bbbf512ed42289b0bc8dc9e3cf0a8fe81529a76,0,0,0,0,0,0,0,0,0,0,0,0,0,0,0,160,4,0,0,0,0,0,0,0,0,0,0,100,NoArch
ac8218b304ed029293554227469a1734bbba9da2,0,0,0,0,0,0,0,0,0,0,0,0,0,0,0,161,5,0,0,0,0,0,0,0,0,0,0,100,NoArch
6af6c06786081a6baed1ca03101c3becad4396b2,0,0,0,0,0,0,0,0,0,0,0,0,0,0,0,60,1,0,0,0,0,0,0,0,0,0,1,100,NoArch
804206f4d1302320183bc84cd457dcbdce16d845,0,0,0,0,0,0,0,0,0,0,0,0,0,0,0,61,2,0,0,0,0,0,0,0,0,0,1,100,NoArch
d19a6707fb2dd2966af0216af073cafebacd4c61,0,0,0,0,0,0,0,0,0,0,0,0,0,0,0,37,0,0,0,0,0,0,0,0,0,0,1,100,NoArch
de7545cbbfedd4ec7d6df8d2d49103d56393e986,0,0,0,0,0,0,0,0,0,0,0,0,0,0,0,14,0,0,0,0,0,0,0,0,0,0,1,100,NoArch
59aa0078e1224c77d6a52eac227ba06be7455d45,0,0,0,0,0,0,0,0,0,0,0,0,0,0,0,0,0,0,0,0,0,0,0,0,0,0,1,100,NoArch
b5bd312324d5a47890b3e8a802995f1d0c4346bb,0,0,0,0,0,0,0,0,0,0,0,0,0,0,0,0,0,0,0,0,0,0,0,0,0,0,1,100,NoArch
87778e6c56ed0d01a8fdcf0b670e327d5dad814f,2,4,1,3,5,0,0,0,107,369,1,2,0.970950594,1606,20,0,0,355,120,235,9947,3159,6788,91,32,59,1,100,NoArch
06cde1a7f92fb773ea33021865921efdd67ba449,0,0,0,0,0,0,0,0,0,0,0,0,0,0,0,42,0,0,0,0,0,0,0,0,0,0,1,100,NoArch
77258c88c90ef567f3b05eeb2d86ff8dfa99b302,0,0,0,0,0,0,0,0,0,0,0,0,0,0,0,162,3,0,0,0,0,0,0,0,0,0,0,100,NoArch
0bd6fcc72d98318be1a58fd140d0d1118b8483b2,1,1,1,0,2,0,0,0,2,2267,1,1,0,50,2,1,1,2,2,0,168,168,0,1,1,0,1,100,NoArch
d640182ac078049ec874d2228272cef23564d7ba,0,0,0,0,0,0,0,0,0,0,0,0,0,0,0,43,1,0,0,0,0,0,0,0,0,0,1,100,NoArch
e380e2fd6d9183771df6234ec202d56b8005518d,0,0,0,0,0,0,0,0,0,0,0,0,0,0,0,44,2,0,0,0,0,0,0,0,0,0,1,100,NoArch
0cee52e70b8f8ea2c0a540cacbbdc5e440233b1b,0,0,0,0,0,0,0,0,0,0,0,0,0,0,0,1,1,0,0,0,0,0,0,0,0,0,1,100,NoArch
913bf36d81984d9bc44d873cc8d1655cda2347e2,0,0,0,0,0,0,0,0,0,0,0,0,0,0,0,15,1,0,0,0,0,0,0,0,0,0,1,100,NoArch
3e630d396a31539a3bbc933850ddf9470952b683,0,0,0,0,0,0,0,0,0,0,0,0,0,0,0,2,2,0,0,0,0,0,0,0,0,0,1,100,NoArch
440ab18b097fce7ea0ca1ab03488f3e4c8769095,0,0,0,0,0,0,0,0,0,0,0,0,0,0,0,62,0,0,0,0,0,0,0,0,0,0,1,100,NoArch
ca278f93ad4b6568cb02eca1d2f1c7caf502f4f3,0,0,0,0,0,0,0,0,0,0,0,0,0,0,0,0,0,0,0,0,0,0,0,0,0,0,1,100,NoArch
ea3eb118e80e0cc66964963bea721c0e487990be,2,54,1,53,55,0,0,0,134,378,1,2,0.997852777,2432,14,2,2,512,466,46,13784,10606,3178,238,196,42,1,100,NoArch
5691fa3c0aa9e632c0729fd2feb58f9f7f697325,0,0,0,0,0,0,0,0,0,0,0,0,0,0,0,45,3,0,0,0,0,0,0,0,0,0,1,100,NoArch
9773314ed1988deb3d1c78a3ef2d45e3ff993301,0,0,0,0,0,0,0,0,0,0,0,0,0,0,0,63,1,0,0,0,0,0,0,0,0,0,1,100,NoArch
26e158038d8129341f9b9ffb9f2f24b39a7bb8a2,0,0,0,0,0,0,0,0,0,0,0,0,0,0,0,64,2,0,0,0,0,0,0,0,0,0,1,100,NoArch
96de1933d992a2aee568341eba6491e99203769d,0,0,0,0,0,0,0,0,0,0,0,0,0,0,0,163,1,0,0,0,0,0,0,0,0,0,0,100,NoArch
9cfd50f9882141ab00b234a70314ef46441acd16,0,0,0,0,0,0,0,0,0,0,0,0,0,0,0,46,4,0,0,0,0,0,0,0,0,0,1,100,NoArch
702ecd9e72a97d418b152433480182fce1b3d4bc,0,0,0,0,0,0,0,0,0,0,0,0,0,0,0,47,5,0,0,0,0,0,0,0,0,0,1,100,NoArch
01f020f959093185a2ab4562a3f4de88d76b23b5,0,0,0,0,0,0,0,0,0,0,0,0,0,0,0,48,6,0,0,0,0,0,0,0,0,0,1,100,NoArch
204f03feffd678221ccf191928d29aa7e45545bc,0,0,0,0,0,0,0,0,0,0,0,0,0,0,0,164,2,0,0,0,0,0,0,0,0,0,0,100,NoArch
1ab3cf1933f7e6da60b1709b772c04cb59012e48,0,0,0,0,0,0,0,0,0,0,0,0,0,0,0,49,7,0,0,0,0,0,0,0,0,0,1,100,NoArch
babc435b38d90caa1685004909b0e407b9195222,0,0,0,0,0,0,0,0,0,0,0,0,0,0,0,50,8,0,0,0,0,0,0,0,0,0,1,100,NoArch
510220da46469e30e04b6aeab16b50511ec0ea26,0,0,0,0,0,0,0,0,0,0,0,0,0,0,0,51,9,0,0,0,0,0,0,0,0,0,1,100,NoArch
f94e1e210757cf8868bf5c14f39be02df232521d,0,0,0,0,0,0,0,0,0,0,0,0,0,0,0,52,10,0,0,0,0,0,0,0,0,0,1,100,NoArch
27eda1cf777deedb80632e4f324fc5b3e86044bd,0,0,0,0,0,0,0,0,0,0,0,0,0,0,0,53,11,0,0,0,0,0,0,0,0,0,1,100,NoArch
ff8fb1627380885dfd3d36518f826932880e121b,0,0,0,0,0,0,0,0,0,0,0,0,0,0,0,65,3,0,0,0,0,0,0,0,0,0,0,100,NoArch
ad851035c3ab0e9cfea7e3e89e1ad00ac732e7bc,0,0,0,0,0,0,0,0,0,0,0,0,0,0,0,66,4,0,0,0,0,0,0,0,0,0,1,100,NoArch
b7168caefe59fb8fbd0a59fa0f4a601918ffbbf9,0,0,0,0,0,0,0,0,0,0,0,0,0,0,0,67,5,0,0,0,0,0,0,0,0,0,1,100,NoArch
8caab7bd4a47e2c8e048f2c42478bdb22b18c993,1,15,2,13,17,0,0,0,13,1460,1,1,0,113,5,0,0,11,9,2,644,578,66,4,3,1,1,100,NoArch
161387ce6570abbcffc4cc227739a68fc766fbab,0,0,0,0,0,0,0,0,0,0,0,0,0,0,0,68,6,0,0,0,0,0,0,0,0,0,2,100,NoArch
3ee93cf65787d59a7bd718af39cf16b85af25022,0,0,0,0,0,0,0,0,0,0,0,0,0,0,0,165,2,0,0,0,0,0,0,0,0,0,0,100,NoArch
42787b7926631b0a6dff4388ec66116373fc2365,2,198,24,174,222,1,0,1,78,215,1,2,0.995252549,626,1,3,2,136,112,24,3795,2909,886,58,44,14,1,94.19424851,Arch
31f3800fbcc55bd33552ea0d2aedf8dd7e22d7df,0,0,0,0,0,0,0,0,0,0,0,0,0,0,0,54,11,0,0,0,0,0,0,0,0,0,1,100,NoArch
6cf169a4b02de5b36fa3fb1396c42e0fd3358bad,0,0,0,0,0,0,0,0,0,0,0,0,0,0,0,0,0,0,0,0,0,0,0,0,0,0,1,100,NoArch
4d82fb5dd8ea28594248cc1ac44b8519781f66dd,11,210,1,209,211,0,0,0,45,1392,1,4,1.625282754,3883,6,4,2,581,9,572,20754,279,20475,342,6,336,1,100,NoArch
e2a249ae83108717791f44c24a3c32cf72e65270,0,0,0,0,0,0,0,0,0,0,0,0,0,0,0,166,3,0,0,0,0,0,0,0,0,0,0,100,NoArch
4ab2c3604d89b98c468836acb2129c2e50346d76,0,0,0,0,0,0,0,0,0,0,0,0,0,0,0,167,4,0,0,0,0,0,0,0,0,0,0,100,NoArch
27dc094a54b5c73336f355649ddd5e70d04ae6d6,0,0,0,0,0,0,0,0,0,0,0,0,0,0,0,69,6,0,0,0,0,0,0,0,0,0,1,100,NoArch
b8463f21db3088690e6b1ce267966d8c57f1b706,0,0,0,0,0,0,0,0,0,0,0,0,0,0,0,0,0,0,0,0,0,0,0,0,0,0,1,100,NoArch
0c24fe973530ded3c00027440e3151b4b7d6b901,0,0,0,0,0,0,0,0,0,0,0,0,0,0,0,168,5,0,0,0,0,0,0,0,0,0,0,100,NoArch
5fde49f6467df8246859b4a2474b2e6fbc9d1cc8,0,0,0,0,0,0,0,0,0,0,0,0,0,0,0,169,6,0,0,0,0,0,0,0,0,0,0,100,NoArch
abe6f8fdd690ffed2cf5ed7279a2075a84f3f8f5,0,0,0,0,0,0,0,0,0,0,0,0,0,0,0,170,7,0,0,0,0,0,0,0,0,0,0,100,NoArch
b6753a287ac0e6bd8c6dd3fac43164f2a8b9929a,0,0,0,0,0,0,0,0,0,0,0,0,0,0,0,171,8,0,0,0,0,0,0,0,0,0,0,100,NoArch
f6196a22b8a98cafb2cdc3329fadc17fdcd4b3be,0,0,0,0,0,0,0,0,0,0,0,0,0,0,0,172,9,0,0,0,0,0,0,0,0,0,0,100,NoArch
c8a8ed0a4715102580f30fd709e6a115c5cd6cc2,0,0,0,0,0,0,0,0,0,0,0,0,0,0,0,173,8,0,0,0,0,0,0,0,0,0,0,100,NoArch
87f99908500dffa0935f881142ffdcecb73a9559,0,0,0,0,0,0,0,0,0,0,0,0,0,0,0,174,9,0,0,0,0,0,0,0,0,0,0,100,NoArch
126ef790723701b919bebbb8bad814e01e81cefb,0,0,0,0,0,0,0,0,0,0,0,0,0,0,0,175,9,0,0,0,0,0,0,0,0,0,0,100,NoArch
b897fb5e9bac0b7109bd7761ba213d8bdfd519f4,3,94,97,3,191,0,0,0,53,1420,1,2,1.365873152,868,11,5,1,77,78,1,6141,6085,56,44,45,1,1,100,NoArch
d9710c7cc01dbd0ec8af19306da67f11e355aee9,1,3,3,0,6,0,0,0,15,2732,1,1,0,244,6,0,0,16,16,0,1618,1618,0,11,11,0,1,100,NoArch
d879c360b61a8d0ec35cc16124f04f6db324b012,0,0,0,0,0,0,0,0,0,0,0,0,0,0,0,176,10,0,0,0,0,0,0,0,0,0,0,100,NoArch
fe5f2f07917053a5bbf4c9527b6e751e72bb05c6,0,0,0,0,0,0,0,0,0,0,0,0,0,0,0,6,2,0,0,0,0,0,0,0,0,0,1,100,NoArch
fa3d83ae9502341c321edbe368552badd26af4ac,0,0,0,0,0,0,0,0,0,0,0,0,0,0,0,0,0,0,0,0,0,0,0,0,0,0,1,100,NoArch
5a587c1069a296e7c84c2dd8ce8323aaa230e622,0,0,0,0,0,0,0,0,0,0,0,0,0,0,0,177,9,0,0,0,0,0,0,0,0,0,0,100,NoArch
429f75f355b038a2090710aa435aa6f73f9244d7,0,0,0,0,0,0,0,0,0,0,0,0,0,0,0,178,10,0,0,0,0,0,0,0,0,0,0,100,NoArch
2f012d532fb54952b96230d73718e92c512a372f,0,0,0,0,0,0,0,0,0,0,0,0,0,0,0,179,11,0,0,0,0,0,0,0,0,0,0,100,NoArch
d6a0d0a790274de27b2cfde07d14151a4a327a96,1,1,1,0,2,0,0,0,12,2380,1,1,0,393,4,108,0,83,84,1,2209,2213,4,25,25,0,1,100,NoArch
d7b808270c8a6d68ffdceb3ba4215d2f183c3fef,0,0,0,0,0,0,0,0,0,0,0,0,0,0,0,180,12,0,0,0,0,0,0,0,0,0,0,100,NoArch
5a7bf346fdb44f540deeaf6c6b830492af04f8ac,0,0,0,0,0,0,0,0,0,0,0,0,0,0,0,181,13,0,0,0,0,0,0,0,0,0,0,100,NoArch
183a075e7a3b538be6fe1692be668184a745d812,0,0,0,0,0,0,0,0,0,0,0,0,0,0,0,182,14,0,0,0,0,0,0,0,0,0,0,100,NoArch
0e89c57b9884d25b47136a3f344a96539c05337e,0,0,0,0,0,0,0,0,0,0,0,0,0,0,0,0,0,0,0,0,0,0,0,0,0,0,1,100,NoArch
565a8f77e66402da40bc6e2783549383923e817c,0,0,0,0,0,0,0,0,0,0,0,0,0,0,0,0,0,0,0,0,0,0,0,0,0,0,0,100,NoArch
3a9e5a789b5165e0c8c4da799c387fdf84bfb75e,0,0,0,0,0,0,0,0,0,0,0,0,0,0,0,55,0,0,0,0,0,0,0,0,0,0,0,100,NoArch
