NMF, TotalAddLines , TotalDeleteLines ,LC,LC_1, FileAdd , FileDelete ,NAD, NUC, AGE, NMS, NMD, Entropy ,MLMF,NDVE,EXP,REXP,CommitComplexity,LastCommitComplexity,CFC,CommitTokenCount,LastCommitTokenCount,NCC,CommitMethodNum,LastCommitMethodNum,NFC,NIR,a2a,Tag
0,0,0,0,0,0,0,0,0,0,0,0,0.0,0,0,147,9,0,0,0,0,0,0,0,0,0,0,100.0,NoArch
2,10,7,3,17,0,0,0,2,4,1,1,0.322756959,175,1,32,2,18,17,1,707,682,25,15,15,0,1,100.0,NoArch
2,4,4,0,8,0,0,0,3,316,1,2,1.0,1099,2,277,5,104,104,0,3407,3407,0,43,43,0,1,100.0,NoArch
0,0,0,0,0,0,0,0,0,0,0,0,0.0,0,0,35,1,0,0,0,0,0,0,0,0,0,1,100.0,NoArch
3,47,1,46,48,0,0,0,58,834,1,3,1.109534908,1060,4,421,5,197,193,4,5773,5444,329,64,62,2,1,100.0,NoArch
0,0,0,0,0,0,0,0,0,0,0,0,0.0,0,0,106,2,0,0,0,0,0,0,0,0,0,0,100.0,NoArch
0,0,0,0,0,0,0,0,0,0,0,0,0.0,0,0,52,0,0,0,0,0,0,0,0,0,0,1,100.0,NoArch
1,0,1,1,1,0,0,0,17,129,1,1,0.0,145,3,65,5,16,16,0,629,635,6,8,8,0,1,100.0,NoArch
1,21,0,21,21,0,0,0,22,0,1,1,0.0,142,4,15,13,30,0,30,793,0,793,19,0,19,0,100.0,NoArch
3,101,29,72,130,0,0,0,101,12,1,1,1.114729977,2524,11,10,8,614,605,9,14625,14303,322,268,263,5,1,99.8982706,NoArch
3,101,29,72,130,0,0,0,101,12,1,1,1.114729977,2524,11,10,8,614,605,9,14625,14303,322,268,263,5,1,99.8982706,NoArch
0,0,0,0,0,0,0,0,0,0,0,0,0.0,0,0,18,0,0,0,0,0,0,0,0,0,0,1,100.0,NoArch
0,0,0,0,0,0,0,0,0,0,0,0,0.0,0,0,4,4,0,0,0,0,0,0,0,0,0,1,100.0,NoArch
0,0,0,0,0,0,0,0,0,0,0,0,0.0,0,0,13,1,0,0,0,0,0,0,0,0,0,1,100.0,NoArch
0,0,0,0,0,0,0,0,0,0,0,0,0.0,0,0,15,6,0,0,0,0,0,0,0,0,0,1,100.0,NoArch
1,1,2,1,3,0,0,0,3,1029,1,1,0.0,237,3,1,0,55,55,0,1385,1383,2,14,14,0,2,100.0,NoArch
0,0,0,0,0,0,0,0,0,0,0,0,0.0,0,0,314,15,0,0,0,0,0,0,0,0,0,1,100.0,NoArch
13,92,175,83,267,0,0,0,8,0,1,3,2.753568677,2914,2,220,32,433,441,8,13311,13575,264,203,208,5,2,100.0,NoArch
0,0,0,0,0,0,0,0,0,0,0,0,0.0,0,0,0,0,0,0,0,0,0,0,0,0,0,1,100.0,NoArch
0,0,0,0,0,0,0,0,0,0,0,0,0.0,0,0,439,4,0,0,0,0,0,0,0,0,0,1,100.0,NoArch
0,0,0,0,0,0,0,0,0,0,0,0,0.0,0,0,102,2,0,0,0,0,0,0,0,0,0,1,100.0,NoArch
2,12,0,12,12,0,0,0,17,970,1,2,1.0,808,3,2,2,120,120,0,4052,4052,0,78,78,0,1,100.0,NoArch
0,0,0,0,0,0,0,0,0,0,0,0,0.0,0,0,4,3,0,0,0,0,0,0,0,0,0,1,100.0,NoArch
0,0,0,0,0,0,0,0,0,0,0,0,0.0,0,0,1,1,0,0,0,0,0,0,0,0,0,1,100.0,NoArch
0,0,0,0,0,0,0,0,0,0,0,0,0.0,0,0,6,1,0,0,0,0,0,0,0,0,0,1,100.0,NoArch
0,0,0,0,0,0,0,0,0,0,0,0,0.0,0,0,148,8,0,0,0,0,0,0,0,0,0,1,100.0,NoArch
0,0,0,0,0,0,0,0,0,0,0,0,0.0,0,0,70,2,0,0,0,0,0,0,0,0,0,1,100.0,NoArch
0,0,0,0,0,0,0,0,0,0,0,0,0.0,0,0,23,12,0,0,0,0,0,0,0,0,0,1,100.0,NoArch
0,0,0,0,0,0,0,0,0,0,0,0,0.0,0,0,11,2,0,0,0,0,0,0,0,0,0,1,100.0,NoArch
5,34,27,7,61,0,0,0,48,13,1,3,1.521099626,1942,1,133,9,508,508,0,12028,11944,84,161,160,1,1,100.0,NoArch
0,0,0,0,0,0,0,0,0,0,0,0,0.0,0,0,7,1,0,0,0,0,0,0,0,0,0,1,100.0,NoArch
5,25,92,67,117,0,0,0,17,80,1,2,0.642610328,812,2,13,1,71,85,14,3545,3865,320,52,63,11,1,100.0,NoArch
2,7,1,6,8,0,0,0,23,36,1,2,0.811278124,666,3,5,5,187,185,2,4586,4553,33,65,64,1,1,100.0,NoArch
4,46,27,19,73,0,0,0,30,82,1,4,1.515272249,1125,2,197,20,206,207,1,6725,6585,140,86,87,1,1,100.0,NoArch
0,0,0,0,0,0,0,0,0,0,0,0,0.0,0,0,57,5,0,0,0,0,0,0,0,0,0,1,100.0,NoArch
0,0,0,0,0,0,0,0,0,0,0,0,0.0,0,0,57,1,0,0,0,0,0,0,0,0,0,0,100.0,NoArch
1,1,1,0,2,0,0,0,12,131,1,1,0.0,2616,8,0,0,305,305,0,9012,9012,0,282,282,0,1,100.0,NoArch
2,87,9,78,96,0,0,0,81,784,1,2,0.946422051,1383,3,476,0,336,325,11,9174,8629,545,113,106,7,1,100.0,NoArch
7,101,8,93,109,1,0,1,102,1215,1,6,1.159378587,1290,5,0,0,331,323,8,8202,7627,575,109,101,8,1,99.73418394,NoArch
0,0,0,0,0,0,0,0,0,0,0,0,0.0,0,0,0,0,0,0,0,0,0,0,0,0,0,0,100.0,NoArch
0,0,0,0,0,0,0,0,0,0,0,0,0.0,0,0,2,1,0,0,0,0,0,0,0,0,0,1,100.0,NoArch
0,0,0,0,0,0,0,0,0,0,0,0,0.0,0,0,2,2,0,0,0,0,0,0,0,0,0,1,100.0,NoArch
0,0,0,0,0,0,0,0,0,0,0,0,0.0,0,0,36,6,0,0,0,0,0,0,0,0,0,1,100.0,NoArch
1,1,16,15,17,0,0,0,5,21,1,1,0.0,366,2,75,4,68,69,1,1526,1617,91,33,33,0,1,100.0,NoArch
2,16,5,11,21,0,0,0,5,2313,1,2,0.958711883,1134,2,482,4,116,114,2,5205,5169,36,41,41,0,1,100.0,NoArch
0,0,0,0,0,0,0,0,0,0,0,0,0.0,0,0,0,0,0,0,0,0,0,0,0,0,0,1,100.0,NoArch
12,145,48,97,193,0,0,0,54,1549,1,7,3.093478905,1886,5,306,10,305,288,17,10560,9905,655,183,166,17,1,100.0,NoArch
4,14,14,0,28,0,0,0,35,864,1,4,1.724407818,1476,10,26,6,201,201,0,8682,8723,41,108,108,0,1,100.0,NoArch
0,0,0,0,0,0,0,0,0,0,0,0,0.0,0,0,238,10,0,0,0,0,0,0,0,0,0,1,100.0,NoArch
0,0,0,0,0,0,0,0,0,0,0,0,0.0,0,0,53,14,0,0,0,0,0,0,0,0,0,1,100.0,NoArch
0,0,0,0,0,0,0,0,0,0,0,0,0.0,0,0,133,2,0,0,0,0,0,0,0,0,0,0,100.0,NoArch
2,26,1,25,27,0,0,0,22,1245,1,2,0.950956048,831,3,53,2,111,92,19,4351,2872,1479,76,62,14,1,100.0,NoArch
0,0,0,0,0,0,0,0,0,0,0,0,0.0,0,0,23,1,0,0,0,0,0,0,0,0,0,1,100.0,NoArch
0,0,0,0,0,0,0,0,0,0,0,0,0.0,0,0,1,1,0,0,0,0,0,0,0,0,0,1,100.0,NoArch
0,0,0,0,0,0,0,0,0,0,0,0,0.0,0,0,103,0,0,0,0,0,0,0,0,0,0,0,100.0,NoArch
0,0,0,0,0,0,0,0,0,0,0,0,0.0,0,0,1,1,0,0,0,0,0,0,0,0,0,1,100.0,NoArch
0,0,0,0,0,0,0,0,0,0,0,0,0.0,0,0,8,8,0,0,0,0,0,0,0,0,0,1,100.0,NoArch
1,5,4,1,9,0,0,0,4,51,1,1,0.0,363,1,296,1,82,82,0,2137,2110,27,25,25,0,1,100.0,NoArch
0,0,0,0,0,0,0,0,0,0,0,0,0.0,0,0,0,0,0,0,0,0,0,0,0,0,0,1,100.0,NoArch
0,0,0,0,0,0,0,0,0,0,0,0,0.0,0,0,15,10,0,0,0,0,0,0,0,0,0,1,100.0,NoArch
0,0,0,0,0,0,0,0,0,0,0,0,0.0,0,0,69,6,0,0,0,0,0,0,0,0,0,1,100.0,NoArch
0,0,0,0,0,0,0,0,0,0,0,0,0.0,0,0,417,1,0,0,0,0,0,0,0,0,0,1,100.0,NoArch
1,0,1,1,1,0,0,0,17,129,1,1,0.0,145,3,64,4,16,16,0,629,635,6,8,8,0,1,100.0,NoArch
0,0,0,0,0,0,0,0,0,0,0,0,0.0,0,0,7,0,0,0,0,0,0,0,0,0,0,1,100.0,NoArch
0,0,0,0,0,0,0,0,0,0,0,0,0.0,0,0,58,23,0,0,0,0,0,0,0,0,0,0,100.0,NoArch
0,0,0,0,0,0,0,0,0,0,0,0,0.0,0,0,4,3,0,0,0,0,0,0,0,0,0,0,100.0,NoArch
0,0,0,0,0,0,0,0,0,0,0,0,0.0,0,0,22,0,0,0,0,0,0,0,0,0,0,1,100.0,NoArch
0,0,0,0,0,0,0,0,0,0,0,0,0.0,0,0,250,13,0,0,0,0,0,0,0,0,0,1,100.0,NoArch
0,0,0,0,0,0,0,0,0,0,0,0,0.0,0,0,105,10,0,0,0,0,0,0,0,0,0,0,100.0,NoArch
0,0,0,0,0,0,0,0,0,0,0,0,0.0,0,0,7,2,0,0,0,0,0,0,0,0,0,1,100.0,NoArch
0,0,0,0,0,0,0,0,0,0,0,0,0.0,0,0,77,5,0,0,0,0,0,0,0,0,0,0,100.0,NoArch
3,47,1,46,48,0,0,0,58,834,1,3,1.109534908,1060,4,421,5,197,193,4,5773,5444,329,64,62,2,1,100.0,NoArch
25,85,86,1,171,0,0,0,45,0,1,16,4.278604499,9308,4,15,2,1296,1298,2,45360,45216,144,698,698,0,1,100.0,NoArch
0,0,0,0,0,0,0,0,0,0,0,0,0.0,0,0,153,11,0,0,0,0,0,0,0,0,0,0,100.0,NoArch
0,0,0,0,0,0,0,0,0,0,0,0,0.0,0,0,150,2,0,0,0,0,0,0,0,0,0,0,100.0,NoArch
0,0,0,0,0,0,0,0,0,0,0,0,0.0,0,0,0,0,0,0,0,0,0,0,0,0,0,1,100.0,NoArch
1,6,9,3,15,0,0,0,4,5755,1,1,0.0,128,3,6,0,7,6,1,570,574,4,3,3,0,1,100.0,NoArch
0,0,0,0,0,0,0,0,0,0,0,0,0.0,0,0,0,0,0,0,0,0,0,0,0,0,0,1,100.0,NoArch
2,40,19,21,59,0,0,0,30,18,1,2,0.81792525,1238,2,174,6,278,277,1,7889,7758,131,148,147,1,1,100.0,NoArch
3,16,10,6,26,0,0,0,21,174,1,3,1.465536041,1263,4,11,0,195,195,0,6775,6671,104,127,127,0,1,100.0,NoArch
0,0,0,0,0,0,0,0,0,0,0,0,0.0,0,0,478,0,0,0,0,0,0,0,0,0,0,1,100.0,NoArch
0,0,0,0,0,0,0,0,0,0,0,0,0.0,0,0,40,8,0,0,0,0,0,0,0,0,0,1,100.0,NoArch
0,0,0,0,0,0,0,0,0,0,0,0,0.0,0,0,57,1,0,0,0,0,0,0,0,0,0,0,100.0,NoArch
0,0,0,0,0,0,0,0,0,0,0,0,0.0,0,0,317,12,0,0,0,0,0,0,0,0,0,0,100.0,NoArch
0,0,0,0,0,0,0,0,0,0,0,0,0.0,0,0,58,5,0,0,0,0,0,0,0,0,0,1,100.0,NoArch
4,200,150,50,350,0,0,0,21,382,1,2,1.83958346,968,1,318,12,142,133,9,4977,4746,231,74,64,10,1,100.0,NoArch
0,0,0,0,0,0,0,0,0,0,0,0,0.0,0,0,25,2,0,0,0,0,0,0,0,0,0,1,100.0,NoArch
1,18,19,1,37,0,0,0,22,0,1,1,0.0,1024,6,9,6,140,141,1,3996,4007,11,73,73,0,1,100.0,NoArch
0,0,0,0,0,0,0,0,0,0,0,0,0.0,0,0,42,11,0,0,0,0,0,0,0,0,0,0,100.0,NoArch
2,2,3,1,5,0,0,0,11,1250,1,2,0.970950594,786,4,7,0,57,57,0,5930,5930,0,35,35,0,1,100.0,NoArch
0,0,0,0,0,0,0,0,0,0,0,0,0.0,0,0,91,0,0,0,0,0,0,0,0,0,0,1,100.0,NoArch
2,74,7,67,81,0,0,0,87,281,1,2,0.825626526,1660,4,13,0,360,315,45,11663,7122,4541,126,96,30,1,99.95751912,NoArch
0,0,0,0,0,0,0,0,0,0,0,0,0.0,0,0,2,2,0,0,0,0,0,0,0,0,0,1,100.0,NoArch
0,0,0,0,0,0,0,0,0,0,0,0,0.0,0,0,52,13,0,0,0,0,0,0,0,0,0,1,100.0,NoArch
2,3,7,4,10,0,0,0,48,43,1,2,0.970950594,863,4,23,0,170,171,1,4572,4585,13,45,45,0,1,100.0,NoArch
0,0,0,0,0,0,0,0,0,0,0,0,0.0,0,0,23,9,0,0,0,0,0,0,0,0,0,1,100.0,NoArch
0,0,0,0,0,0,0,0,0,0,0,0,0.0,0,0,26,10,0,0,0,0,0,0,0,0,0,1,100.0,NoArch
0,0,0,0,0,0,0,0,0,0,0,0,0.0,0,0,1,1,0,0,0,0,0,0,0,0,0,1,100.0,NoArch
0,0,0,0,0,0,0,0,0,0,0,0,0.0,0,0,56,5,0,0,0,0,0,0,0,0,0,1,100.0,NoArch
0,0,0,0,0,0,0,0,0,0,0,0,0.0,0,0,5,3,0,0,0,0,0,0,0,0,0,1,100.0,NoArch
0,0,0,0,0,0,0,0,0,0,0,0,0.0,0,0,28,1,0,0,0,0,0,0,0,0,0,1,100.0,NoArch
0,0,0,0,0,0,0,0,0,0,0,0,0.0,0,0,1,1,0,0,0,0,0,0,0,0,0,1,100.0,NoArch
0,0,0,0,0,0,0,0,0,0,0,0,0.0,0,0,0,0,0,0,0,0,0,0,0,0,0,0,100.0,NoArch
0,0,0,0,0,0,0,0,0,0,0,0,0.0,0,0,73,3,0,0,0,0,0,0,0,0,0,0,100.0,NoArch
0,0,0,0,0,0,0,0,0,0,0,0,0.0,0,0,37,2,0,0,0,0,0,0,0,0,0,1,100.0,NoArch
0,0,0,0,0,0,0,0,0,0,0,0,0.0,0,0,14,5,0,0,0,0,0,0,0,0,0,1,100.0,NoArch
4,9,6,3,15,0,0,0,4,12,1,2,1.832262897,461,2,8,6,35,35,0,2171,2129,42,21,21,0,1,100.0,NoArch
0,0,0,0,0,0,0,0,0,0,0,0,0.0,0,0,349,2,0,0,0,0,0,0,0,0,0,0,100.0,NoArch
0,0,0,0,0,0,0,0,0,0,0,0,0.0,0,0,243,9,0,0,0,0,0,0,0,0,0,1,100.0,NoArch
2,26,4,22,30,0,0,0,86,2623,1,2,0.881290899,1742,2,0,0,456,437,19,10507,9615,892,200,186,14,1,100.0,NoArch
0,0,0,0,0,0,0,0,0,0,0,0,0.0,0,0,313,14,0,0,0,0,0,0,0,0,0,1,100.0,NoArch
5,43,6,37,49,0,0,0,8,0,1,2,1.85201274,1077,2,6,4,144,137,7,4572,4404,168,86,84,2,1,100.0,NoArch
0,0,0,0,0,0,0,0,0,0,0,0,0.0,0,0,178,1,0,0,0,0,0,0,0,0,0,1,100.0,NoArch
0,0,0,0,0,0,0,0,0,0,0,0,0.0,0,0,0,0,0,0,0,0,0,0,0,0,0,0,100.0,NoArch
0,0,0,0,0,0,0,0,0,0,0,0,0.0,0,0,64,15,0,0,0,0,0,0,0,0,0,0,100.0,NoArch
0,0,0,0,0,0,0,0,0,0,0,0,0.0,0,0,21,10,0,0,0,0,0,0,0,0,0,1,100.0,NoArch
3,94,97,3,191,0,0,0,53,1420,1,2,1.365873152,868,11,5,1,77,78,1,6141,6085,56,44,45,1,1,100.0,NoArch
0,0,0,0,0,0,0,0,0,0,0,0,0.0,0,0,330,23,0,0,0,0,0,0,0,0,0,0,100.0,NoArch
5,200,1,199,201,4,0,4,7,170,1,2,2.16056545,99,1,273,4,15,6,9,935,412,523,9,3,6,1,98.67582148,NoArch
1,1,1,0,2,0,0,0,23,3,1,1,0.0,240,4,25,2,28,28,0,1436,1436,0,12,12,0,1,100.0,NoArch
0,0,0,0,0,0,0,0,0,0,0,0,0.0,0,0,458,0,0,0,0,0,0,0,0,0,0,1,100.0,NoArch
0,0,0,0,0,0,0,0,0,0,0,0,0.0,0,0,30,3,0,0,0,0,0,0,0,0,0,0,100.0,NoArch
3,106,10,96,116,1,0,1,39,10,1,3,1.126456155,716,1,9,0,106,97,9,3216,2880,336,62,58,4,1,98.85198852,NoArch
0,0,0,0,0,0,0,0,0,0,0,0,0.0,0,0,114,4,0,0,0,0,0,0,0,0,0,1,100.0,NoArch
0,0,0,0,0,0,0,0,0,0,0,0,0.0,0,0,64,3,0,0,0,0,0,0,0,0,0,1,100.0,NoArch
4,647,0,647,647,4,0,4,1,0,1,3,1.968890359,0,1,199,6,86,0,86,3389,0,3389,31,0,31,1,99.31034483,NoArch
0,0,0,0,0,0,0,0,0,0,0,0,0.0,0,0,250,13,0,0,0,0,0,0,0,0,0,1,100.0,NoArch
0,0,0,0,0,0,0,0,0,0,0,0,0.0,0,0,49,10,0,0,0,0,0,0,0,0,0,1,100.0,NoArch
18,66,1703,1637,1769,0,3,3,72,952,1,8,2.534364845,5300,4,3,2,486,675,189,18095,27002,8907,211,342,131,0,99.37718957,NoArch
0,0,0,0,0,0,0,0,0,0,0,0,0.0,0,0,317,14,0,0,0,0,0,0,0,0,0,1,100.0,NoArch
0,0,0,0,0,0,0,0,0,0,0,0,0.0,0,0,155,7,0,0,0,0,0,0,0,0,0,0,100.0,NoArch
0,0,0,0,0,0,0,0,0,0,0,0,0.0,0,0,106,11,0,0,0,0,0,0,0,0,0,0,100.0,NoArch
0,0,0,0,0,0,0,0,0,0,0,0,0.0,0,0,15,15,0,0,0,0,0,0,0,0,0,1,100.0,NoArch
0,0,0,0,0,0,0,0,0,0,0,0,0.0,0,0,218,14,0,0,0,0,0,0,0,0,0,1,100.0,NoArch
0,0,0,0,0,0,0,0,0,0,0,0,0.0,0,0,2,0,0,0,0,0,0,0,0,0,0,0,100.0,NoArch
1,8,1,7,9,0,0,0,38,21,1,1,0.0,432,3,308,11,107,107,0,2677,2654,23,25,25,0,1,100.0,NoArch
0,0,0,0,0,0,0,0,0,0,0,0,0.0,0,0,4,4,0,0,0,0,0,0,0,0,0,1,100.0,NoArch
3,87,2,85,89,1,0,1,5,42,1,2,0.309461189,581,1,91,5,57,51,6,1808,1427,381,32,30,2,1,99.59016393,NoArch
0,0,0,0,0,0,0,0,0,0,0,0,0.0,0,0,28,8,0,0,0,0,0,0,0,0,0,0,100.0,NoArch
0,0,0,0,0,0,0,0,0,0,0,0,0.0,0,0,0,0,0,0,0,0,0,0,0,0,0,1,100.0,NoArch
0,0,0,0,0,0,0,0,0,0,0,0,0.0,0,0,153,11,0,0,0,0,0,0,0,0,0,1,100.0,NoArch
0,0,0,0,0,0,0,0,0,0,0,0,0.0,0,0,40,10,0,0,0,0,0,0,0,0,0,0,100.0,NoArch
6,81,6,75,87,0,0,0,71,1182,1,4,1.98988298,2802,3,453,4,457,452,5,18548,18074,474,204,200,4,1,100.0,NoArch
0,0,0,0,0,0,0,0,0,0,0,0,0.0,0,0,181,13,0,0,0,0,0,0,0,0,0,0,100.0,NoArch
0,0,0,0,0,0,0,0,0,0,0,0,0.0,0,0,1,1,0,0,0,0,0,0,0,0,0,1,100.0,NoArch
0,0,0,0,0,0,0,0,0,0,0,0,0.0,0,0,10,10,0,0,0,0,0,0,0,0,0,1,100.0,NoArch
1,0,1,1,1,0,0,0,17,129,1,1,0.0,145,3,63,3,16,16,0,629,635,6,8,8,0,1,100.0,NoArch
2,2,0,2,2,0,0,0,8,172,1,1,1.0,296,1,294,6,55,53,2,1754,1718,36,38,36,2,1,100.0,NoArch
1,17,0,17,17,0,0,0,2,0,1,1,0.0,17,2,3,0,0,0,0,76,0,76,0,0,0,1,100.0,NoArch
1,3,1,2,4,0,0,0,8,0,1,1,0.0,359,4,63,13,69,68,1,1586,1573,13,33,33,0,1,100.0,NoArch
0,0,0,0,0,0,0,0,0,0,0,0,0.0,0,0,19,1,0,0,0,0,0,0,0,0,0,1,100.0,NoArch
2,0,290,290,290,0,0,0,9,0,1,2,0.182138465,3640,4,112,0,337,346,9,16076,18627,2551,312,321,9,0,100.0,NoArch
0,0,0,0,0,0,0,0,0,0,0,0,0.0,0,0,30,2,0,0,0,0,0,0,0,0,0,1,100.0,NoArch
0,0,0,0,0,0,0,0,0,0,0,0,0.0,0,0,58,8,0,0,0,0,0,0,0,0,0,1,100.0,NoArch
0,0,0,0,0,0,0,0,0,0,0,0,0.0,0,0,39,9,0,0,0,0,0,0,0,0,0,0,100.0,NoArch
0,0,0,0,0,0,0,0,0,0,0,0,0.0,0,0,19,3,0,0,0,0,0,0,0,0,0,1,100.0,NoArch
0,0,0,0,0,0,0,0,0,0,0,0,0.0,0,0,34,2,0,0,0,0,0,0,0,0,0,1,100.0,NoArch
0,0,0,0,0,0,0,0,0,0,0,0,0.0,0,0,53,17,0,0,0,0,0,0,0,0,0,1,100.0,NoArch
2,129,7,122,136,0,0,0,84,0,1,2,0.822725596,1727,6,15,4,364,360,4,12871,11663,1208,127,126,1,1,100.0,NoArch
7,676,6,670,682,4,0,4,52,68,1,6,2.210384474,1466,2,69,0,403,318,85,13977,10436,3541,138,106,32,1,99.31034483,NoArch
0,0,0,0,0,0,0,0,0,0,0,0,0.0,0,0,28,0,0,0,0,0,0,0,0,0,0,1,100.0,NoArch
4,628,0,628,628,2,0,2,22,57,1,2,1.353034008,261,1,329,6,82,25,57,4634,1048,3586,36,13,23,1,98.37362637,NoArch
0,0,0,0,0,0,0,0,0,0,0,0,0.0,0,0,178,10,0,0,0,0,0,0,0,0,0,0,100.0,NoArch
7,34,15,19,49,0,0,0,14,8,1,1,2.776922602,2127,4,43,13,205,204,1,6170,6137,33,123,122,1,1,100.0,NoArch
4,4,4,0,8,0,0,0,19,1737,1,4,2.0,953,6,6,2,63,63,0,6646,6646,0,58,58,0,0,100.0,NoArch
0,0,0,0,0,0,0,0,0,0,0,0,0.0,0,0,301,6,0,0,0,0,0,0,0,0,0,1,100.0,NoArch
0,0,0,0,0,0,0,0,0,0,0,0,0.0,0,0,6,0,0,0,0,0,0,0,0,0,0,1,100.0,NoArch
0,0,0,0,0,0,0,0,0,0,0,0,0.0,0,0,6,6,0,0,0,0,0,0,0,0,0,0,100.0,NoArch
0,0,0,0,0,0,0,0,0,0,0,0,0.0,0,0,63,2,0,0,0,0,0,0,0,0,0,1,100.0,NoArch
3,20,12,8,32,0,0,0,32,322,1,3,1.014097656,490,1,300,7,97,96,1,2440,2424,16,39,38,1,1,100.0,NoArch
1,22,39,17,61,0,0,0,21,111,1,1,0.0,785,12,35,3,63,66,3,5610,5668,58,39,39,0,1,100.0,NoArch
3,101,29,72,130,0,0,0,101,12,1,1,1.114729977,2524,11,10,8,614,605,9,14625,14303,322,268,263,5,1,99.8982706,NoArch
0,0,0,0,0,0,0,0,0,0,0,0,0.0,0,0,20,11,0,0,0,0,0,0,0,0,0,0,100.0,NoArch
5,34,27,7,61,0,0,0,48,13,1,3,1.521099626,1942,1,133,9,508,508,0,12028,11944,84,161,160,1,1,100.0,NoArch
5,492,182,310,674,2,0,2,48,88,1,3,1.777739445,1470,1,362,5,253,200,53,10609,9086,1523,111,94,17,0,99.51956074,NoArch
12,316,54,262,370,1,0,1,55,226,1,9,2.638187439,3201,3,91,9,706,685,21,21285,19553,1732,294,286,8,1,99.83164983,NoArch
0,0,0,0,0,0,0,0,0,0,0,0,0.0,0,0,45,13,0,0,0,0,0,0,0,0,0,1,100.0,NoArch
0,0,0,0,0,0,0,0,0,0,0,0,0.0,0,0,14,5,0,0,0,0,0,0,0,0,0,0,100.0,NoArch
0,0,0,0,0,0,0,0,0,0,0,0,0.0,0,0,81,5,0,0,0,0,0,0,0,0,0,0,100.0,NoArch
4,45,2,43,47,0,0,0,26,238,1,3,1.686468915,817,4,11,6,104,100,4,4863,4640,223,48,45,3,1,100.0,NoArch
9,1149,0,1149,1149,9,0,9,1,0,1,2,3.052985933,0,1,0,0,121,0,121,5766,0,5766,72,0,72,1,98.95913647,NoArch
3,35,3,32,38,0,0,0,6,1017,1,3,1.08622182,593,2,346,1,64,58,6,2618,2433,185,44,44,0,1,100.0,NoArch
0,0,0,0,0,0,0,0,0,0,0,0,0.0,0,0,3,3,0,0,0,0,0,0,0,0,0,1,100.0,NoArch
0,0,0,0,0,0,0,0,0,0,0,0,0.0,0,0,12,1,0,0,0,0,0,0,0,0,0,1,100.0,NoArch
1,5,4,1,9,0,0,0,5,1493,1,1,0.0,735,4,7,1,77,77,0,1833,1813,20,43,43,0,1,100.0,NoArch
0,0,0,0,0,0,0,0,0,0,0,0,0.0,0,0,11,0,0,0,0,0,0,0,0,0,0,1,100.0,NoArch
0,0,0,0,0,0,0,0,0,0,0,0,0.0,0,0,149,1,0,0,0,0,0,0,0,0,0,0,100.0,NoArch
0,0,0,0,0,0,0,0,0,0,0,0,0.0,0,0,58,8,0,0,0,0,0,0,0,0,0,1,100.0,NoArch
0,0,0,0,0,0,0,0,0,0,0,0,0.0,0,0,25,7,0,0,0,0,0,0,0,0,0,1,100.0,NoArch
0,0,0,0,0,0,0,0,0,0,0,0,0.0,0,0,45,3,0,0,0,0,0,0,0,0,0,1,100.0,NoArch
0,0,0,0,0,0,0,0,0,0,0,0,0.0,0,0,7,7,0,0,0,0,0,0,0,0,0,1,100.0,NoArch
2,168,0,168,168,1,0,1,4,31,1,2,0.193196413,623,1,90,4,92,88,4,3682,2734,948,37,33,4,1,98.72881356,NoArch
1,1,1,0,2,0,0,0,32,0,1,1,0.0,898,2,185,8,245,245,0,5740,5741,1,119,119,0,1,100.0,NoArch
4,70,19,51,89,0,0,0,10,106,1,2,1.53554765,485,1,76,10,106,95,11,3294,2991,303,30,26,4,1,93.77682403,Arch
24,2740,2362,378,5102,10,4,14,17,32,1,6,4.080698285,4615,1,79,7,793,733,60,23546,23257,289,310,278,32,1,93.46642468,Arch
61,127,61,66,188,0,0,0,18,101,1,9,5.29439242,9223,1,80,7,1517,1517,0,44391,44397,6,660,660,0,1,92.90187891,Arch
15,302,326,24,628,1,3,4,18,110,1,3,3.201329052,2777,1,82,6,334,336,2,15831,15966,135,132,135,3,1,97.59358289,Arch
12,657,16,641,673,6,0,6,14,0,1,4,3.017296424,871,1,84,7,138,82,56,7688,5144,2544,85,47,38,1,96.40102828,Arch
6,234,5,229,239,3,0,3,13,26,1,4,1.802370874,515,1,89,3,111,90,21,3720,2604,1116,66,49,17,1,93.99538106,Arch
2,350,0,350,350,2,0,2,1,0,1,2,0.994693795,0,1,99,11,74,0,74,2409,0,2409,23,0,23,1,96.7462039,Arch
97,2872,5380,2508,8252,7,26,33,16,14,1,12,5.434778564,14470,1,0,0,1873,2176,303,62115,73068,10953,793,952,159,0,79.76470588,Arch
7,135,76,59,211,0,0,0,24,127,1,5,2.513346984,2025,1,143,3,530,522,8,13709,13273,436,204,199,5,1,78.73303167,Arch
16,419,402,17,821,0,0,0,22,131,1,4,3.036039894,1855,1,145,5,304,315,11,10050,9970,80,129,126,3,1,90.60402685,Arch
14,681,89,592,770,1,0,1,21,67,1,5,2.778364912,2238,1,160,17,630,516,114,16708,13276,3432,240,175,65,1,74.56359102,Arch
4,26,8,18,34,0,0,0,27,16,1,3,1.866196857,1283,1,164,21,310,305,5,7649,7563,86,151,149,2,1,94.83101392,Arch
5,130,201,71,331,1,1,2,20,36,1,3,1.850495335,985,1,169,7,170,179,9,5595,5771,176,72,86,14,1,92.91666667,Arch
11,730,24,706,754,9,0,9,5,49,1,4,3.198549137,472,1,180,3,131,81,50,5516,2489,3027,65,35,30,0,92.63565891,Arch
10,382,331,51,713,1,0,1,15,96,1,4,2.431137363,1418,1,181,4,175,162,13,7549,7820,271,89,82,7,0,97.61029412,Arch
4,235,1,234,236,2,0,2,31,11,1,3,1.017979253,976,1,184,7,283,253,30,7117,6099,1018,134,122,12,1,96.92585895,Arch
6,335,1,334,336,3,0,3,7,0,1,3,2.010706158,524,1,187,10,110,86,24,4271,2607,1664,54,37,17,1,96.58703072,Arch
10,1053,0,1053,1053,10,0,10,5,17,1,2,3.16305332,0,1,194,17,94,0,94,4550,0,4550,68,0,68,3,95.93908629,Arch
2,39,2,37,41,1,0,1,20,87,1,2,0.534943699,488,1,199,22,168,164,4,3519,3417,102,51,49,2,1,96.32587859,Arch
137,2,2,0,4,0,0,0,34,131,1,19,,19731,1,205,28,2782,2782,0,98473,98473,0,1297,1297,0,1,22.72727273,Arch
3,38,4,34,42,1,0,1,10,19,1,3,0.814227111,174,2,0,0,22,19,3,969,877,92,8,7,1,1,84.44108761,Arch
0,0,0,0,0,0,0,0,0,0,0,0,0.0,0,0,18,4,0,0,0,0,0,0,0,0,0,1,84.63855422,Arch
12,659,52,607,711,7,0,7,20,9,1,5,3.47026236,890,3,2,2,149,101,48,7002,4465,2537,88,54,34,1,97.65395894,Arch
5,255,19,236,274,1,0,1,12,20,1,4,1.786943458,1414,1,18,10,249,217,32,7992,6837,1155,103,95,8,1,94.73684211,Arch
8,89,39,50,128,0,0,0,21,11,1,3,2.735845517,1181,3,6,6,133,124,9,5949,5732,217,75,74,1,1,96.72131148,Arch
13,116,79,37,195,2,0,2,32,55,1,4,3.088504419,2140,1,226,2,533,543,10,12743,12941,198,161,158,3,1,93.37121212,Arch
2,37,0,37,37,1,0,1,7,34,1,2,0.571354974,87,1,228,3,21,18,3,539,404,135,11,9,2,1,97.5308642,Arch
4,110,36,74,146,0,0,0,4,65,1,2,1.820612629,354,2,232,7,29,23,6,2097,1662,435,16,15,1,1,91.88235294,Arch
1,52,0,52,52,1,0,1,1,0,1,1,0.0,0,1,24,7,1,0,1,233,0,233,1,0,1,1,97.0959596,Arch
24,1907,361,1546,2268,2,0,2,37,60,1,6,2.784853928,6064,2,245,11,986,796,190,38787,32118,6669,445,354,91,1,90.73405535,Arch
235,14209,22784,8575,36993,79,131,210,21,2,2,33,,23912,1,0,0,2281,3225,944,76779,116845,40066,1012,1563,551,0,24.21652422,Arch
13,1089,0,1089,1089,13,0,13,1,0,1,2,3.637703795,0,1,269,4,104,0,104,5198,0,5198,64,0,64,1,95.67147614,Arch
17,7,1141,1134,1148,0,13,13,30,6,1,6,3.797918375,2262,0,0,0,163,268,105,5441,10764,5323,74,139,65,0,95.67147614,Arch
20,1172,7,1165,1179,13,0,13,31,90,1,7,3.909228562,1728,1,271,1,448,338,110,14747,9231,5516,196,129,67,1,95.33851276,Arch
42,106,1490,1384,1596,0,13,13,33,87,1,12,4.641485782,6663,0,0,0,858,1031,173,30068,36707,6639,364,454,90,1,95.33851276,Arch
42,1491,107,1384,1598,13,0,13,34,183,1,12,4.640219762,5279,1,14,0,1031,858,173,36707,30068,6639,454,364,90,1,95.33851276,Arch
42,106,1490,1384,1596,0,13,13,33,87,1,12,4.641485782,6663,0,10,0,858,1031,173,30068,36707,6639,364,454,90,0,95.33851276,Arch
42,1491,107,1384,1598,13,0,13,34,183,1,12,4.640219762,5279,1,3,3,1031,858,173,36707,30068,6639,454,364,90,1,95.33851276,Arch
42,106,1490,1384,1596,0,13,13,33,87,1,12,4.641485782,6663,0,11,1,858,1031,173,30068,36707,6639,364,454,90,1,95.33851276,Arch
39,1458,106,1352,1564,13,0,13,34,187,1,10,4.55898651,4525,1,275,0,915,743,172,33021,26466,6555,408,319,89,1,95.33851276,Arch
38,99,1454,1355,1553,0,13,13,33,95,1,9,4.535194503,5506,0,272,2,695,867,172,24627,31203,6576,290,379,89,1,95.33851276,Arch
38,1455,100,1355,1555,13,0,13,34,182,1,9,4.533979536,4151,1,276,1,867,695,172,31203,24627,6576,379,290,89,1,95.33851276,Arch
36,96,1436,1340,1532,0,13,13,33,100,1,8,4.478930535,4561,0,273,3,518,688,170,18044,24538,6494,219,307,88,1,95.33851276,Arch
36,1437,97,1340,1534,13,0,13,34,191,1,8,4.4777467,3221,1,277,2,688,518,170,24538,18044,6494,307,219,88,1,95.33851276,Arch
36,96,1436,1340,1532,0,13,13,33,100,1,8,4.478930535,4561,0,17,7,518,688,170,18044,24538,6494,219,307,88,0,95.33851276,Arch
36,1437,97,1340,1534,13,0,13,34,191,1,8,4.4777467,3221,1,17,2,688,518,170,24538,18044,6494,307,219,88,1,95.33851276,Arch
36,96,1436,1340,1532,0,13,13,33,100,1,8,4.478930535,4561,0,18,8,518,688,170,18044,24538,6494,219,307,88,1,95.33851276,Arch
36,1437,97,1340,1534,13,0,13,34,191,1,8,4.4777467,3221,1,18,3,688,518,170,24538,18044,6494,307,219,88,1,95.33851276,Arch
36,96,1436,1340,1532,0,13,13,33,100,1,8,4.478930535,4561,0,19,9,518,688,170,18044,24538,6494,219,307,88,1,95.33851276,Arch
36,1437,97,1340,1534,13,0,13,34,191,1,8,4.4777467,3221,1,17,2,688,518,170,24538,18044,6494,307,219,88,1,95.33851276,Arch
36,96,1436,1340,1532,0,13,13,33,100,1,8,4.478930535,4561,0,17,15,518,688,170,18044,24538,6494,219,307,88,1,95.33851276,Arch
36,1437,97,1340,1534,13,0,13,34,191,1,8,4.4777467,3221,1,19,4,688,518,170,24538,18044,6494,307,219,88,1,95.33851276,Arch
36,96,1436,1340,1532,0,13,13,33,100,1,8,4.478930535,4561,0,21,11,518,688,170,18044,24538,6494,219,307,88,1,95.33851276,Arch
36,1437,97,1340,1534,13,0,13,34,191,1,8,4.4777467,3221,1,28,0,688,518,170,24538,18044,6494,307,219,88,1,95.33851276,Arch
36,96,1436,1340,1532,0,13,13,33,100,1,8,4.478930535,4561,0,22,12,518,688,170,18044,24538,6494,219,307,88,0,95.33851276,Arch
158,24136,0,24136,24136,158,0,158,25,122,1,22,6.662493493,0,1,23,13,3246,0,3246,118102,0,118102,1575,0,1575,0,58.81826321,Arch
158,0,24136,24136,24136,0,158,158,0,0,1,22,6.662493493,24136,0,23,0,0,3246,3246,0,118102,118102,0,1575,1575,1,58.81826321,Arch
36,1437,97,1340,1534,13,0,13,34,191,1,8,4.4777467,3221,1,278,3,688,518,170,24538,18044,6494,307,219,88,0,95.33851276,Arch
36,96,1436,1340,1532,0,13,13,33,100,1,8,4.478930535,4561,0,27,16,518,688,170,18044,24538,6494,219,307,88,0,95.33851276,Arch
36,1437,97,1340,1534,13,0,13,34,191,1,8,4.4777467,3221,1,20,3,688,518,170,24538,18044,6494,307,219,88,0,95.33851276,Arch
29,1624,58,1566,1682,15,0,15,28,128,1,12,4.298145929,2463,1,281,6,624,437,187,21704,14058,7646,285,184,101,1,88.83034773,Arch
3,140,0,140,140,1,0,1,3,128,1,2,1.14022707,204,1,282,7,30,16,14,1902,1120,782,20,8,12,1,97.97979798,Arch
4,244,7,237,251,2,0,2,12,102,1,1,1.648237882,170,1,286,8,32,14,18,1909,760,1149,14,7,7,1,88.58921162,Arch
4,635,0,635,635,4,0,4,1,0,1,2,1.836714815,0,1,290,4,59,0,59,3086,0,3086,43,0,43,1,96.8238691,Arch
29,1185,424,761,1609,9,1,10,38,223,1,9,3.92073633,2455,1,294,3,393,286,107,17862,13173,4689,260,168,92,2,89.93288591,Arch
5,459,74,385,533,2,0,2,7,12,1,2,1.959087684,407,2,11,1,59,31,28,4187,2005,2182,36,23,13,1,97.23991507,Arch
14,2358,4,2354,2362,13,0,13,20,8,1,3,3.442132587,252,1,12,1,217,33,184,13504,1432,12072,82,9,73,1,94.59459459,Arch
27,180,140,40,320,1,0,1,40,145,1,12,4.100905002,6318,1,303,7,1098,1089,9,37059,36977,82,486,482,4,1,93.90774587,Arch
5,739,12,727,751,4,0,4,13,35,1,2,1.861840305,111,1,345,3,128,13,115,4457,474,3983,67,7,60,1,89.16728077,Arch
9,15,342,327,357,0,3,3,31,40,1,4,2.695188546,2036,0,344,3,269,300,31,9810,11351,1541,98,110,12,1,88.84026258,Arch
18,854,28,826,882,8,0,8,32,109,1,8,3.40033386,2194,1,346,4,399,328,71,16286,11996,4290,178,138,40,1,88.06941432,Arch
9,15,342,327,357,0,3,3,31,40,1,4,2.695188546,2036,0,345,4,269,300,31,9810,11351,1541,98,110,12,1,92.44505495,Arch
11,407,28,379,435,3,0,3,32,189,1,6,3.043232737,2012,3,21,0,331,292,39,13288,11394,1894,126,112,14,1,92.44505495,Arch
9,14,337,323,351,0,3,3,7,12,1,4,2.657140766,1721,3,346,5,104,136,32,7300,8733,1433,50,62,12,3,92.78350515,Arch
9,338,15,323,353,3,0,3,8,185,1,4,2.657409796,1398,3,22,1,136,104,32,8733,7300,1433,62,50,12,0,92.78350515,Arch
11,19,373,354,392,0,3,3,45,17,1,6,2.966077139,3787,3,347,0,515,554,39,20039,21656,1617,258,271,13,1,92.78350515,Arch
11,374,20,354,394,3,0,3,46,167,1,6,2.965556843,3433,3,351,2,554,515,39,21656,20039,1617,271,258,13,1,92.78350515,Arch
11,19,373,354,392,0,3,3,45,17,1,6,2.966077139,3787,3,348,1,515,554,39,20039,21656,1617,258,271,13,1,92.78350515,Arch
11,374,20,354,394,3,0,3,46,167,1,6,2.965556843,3433,3,353,4,554,515,39,21656,20039,1617,271,258,13,0,92.78350515,Arch
4,227,2,225,229,2,0,2,23,120,1,3,1.145040263,471,1,2,1,76,59,17,3552,2289,1263,38,33,5,1,97.29916898,Arch
3,127,16,111,143,0,0,0,6,256,1,2,0.829065741,410,2,3,2,40,31,9,2885,2208,677,29,23,6,1,97.78085992,Arch
5,68,15,53,83,1,0,1,14,418,1,2,1.601366836,546,2,7,3,64,58,6,2843,2660,183,32,30,2,1,93.96551724,Arch
252,456,19,437,475,4,0,4,50,389,1,38,,37640,3,1,0,4868,4791,77,189963,187470,2493,2392,2365,27,1,37.28598605,Arch
10,271,12,259,283,1,0,1,37,36,1,3,1.903047895,1712,3,18,5,338,298,40,12665,10708,1957,198,166,32,1,91.40794224,Arch
3,59,2,57,61,1,0,1,15,38,1,2,0.55410153,333,1,19,3,32,31,1,1969,1729,240,21,20,1,1,90.27993779,Arch
2,85,4,81,89,1,0,1,26,34,1,2,0.472547222,272,1,21,5,45,35,10,2020,1554,466,19,9,10,1,91.41414141,Arch
8,139,55,84,194,0,0,0,28,64,1,3,2.403916776,930,3,22,6,97,78,19,5000,4692,308,74,59,15,1,95.71890145,Arch
7,54,2,52,56,1,0,1,37,45,1,5,1.583478878,1604,5,23,7,328,324,4,9942,9758,184,131,128,3,1,93.09803922,Arch
63,183,150,33,333,1,0,1,51,96,1,23,,10183,2,11,8,1227,1227,0,55176,54856,320,589,589,0,2,84.10774411,Arch
1,934,474,460,1408,0,0,0,13,143,1,1,0.0,655,3,12,1,192,96,96,6245,3301,2944,105,62,43,1,96.37681159,Arch
5,159,39,120,198,1,0,1,27,42,1,4,1.891622654,479,1,13,2,57,55,2,3093,2868,225,31,30,1,2,95.88414634,Arch
20,119,413,294,532,0,2,2,53,121,1,10,2.412555959,5769,1,34,4,1110,1171,61,33749,35683,1934,426,437,11,1,87.95275591,Arch
44,1857,494,1363,2351,5,0,5,54,92,1,17,4.078405814,12153,3,21,5,1887,1765,122,71752,65983,5769,889,811,78,1,92.5900277,Arch
36,395,278,117,673,0,0,0,55,51,1,12,3.48266342,12259,3,38,8,1697,1685,12,62729,62447,282,788,784,4,1,93.26788219,Arch
3,43,3,40,46,0,0,0,19,164,1,2,1.112212925,583,3,63,5,103,98,5,3256,3017,239,51,49,2,1,94.73684211,Arch
14,1341,251,1090,1592,4,0,4,34,149,1,5,2.779660774,1576,3,79,0,284,170,114,12745,7949,4796,154,93,61,1,95.36480687,Arch
47,2794,362,2432,3156,12,0,12,57,297,1,23,4.676674038,8761,1,109,11,1727,1480,247,67131,52045,15086,789,666,123,1,93.85692068,Arch
47,362,2794,2432,3156,0,12,12,55,115,1,23,4.676674038,11204,1,92,7,1481,1728,247,52135,67221,15086,667,790,123,1,93.85692068,Arch
47,2794,362,2432,3156,12,0,12,57,287,1,23,4.676674038,8772,1,111,10,1728,1481,247,67221,52135,15086,790,667,123,1,93.85692068,Arch
47,362,2794,2432,3156,0,12,12,55,115,1,23,4.676674038,11204,1,93,8,1481,1728,247,52135,67221,15086,667,790,123,1,93.85692068,Arch
47,2794,362,2432,3156,12,0,12,57,287,1,23,4.676674038,8772,1,112,11,1728,1481,247,67221,52135,15086,790,667,123,0,93.85692068,Arch
47,362,2794,2432,3156,0,12,12,55,115,1,23,4.676674038,11204,1,94,9,1481,1728,247,52135,67221,15086,667,790,123,0,93.85692068,Arch
52,3355,402,2953,3757,16,0,16,57,258,1,25,4.864427037,9255,1,113,3,1941,1601,340,73644,55692,17952,850,692,158,1,93.2046332,Arch
2,128,0,128,128,2,0,2,1,0,1,2,0.912999214,0,1,120,10,9,0,9,582,0,582,7,0,7,1,91.36331192,Arch
3,125,14,111,139,1,0,1,18,486,1,2,0.958176013,317,5,123,10,39,28,11,2284,1719,565,23,16,7,1,95.85714286,Arch
5,326,11,315,337,0,0,0,16,654,1,3,0.943403568,1512,2,39,0,255,218,37,8635,7009,1626,132,123,9,1,91.23674912,Arch
36,317,140,177,457,0,0,0,59,364,1,16,4.506325286,10652,1,138,11,1853,1820,33,56161,55146,1015,768,757,11,1,96.1352657,Arch
44,6208,0,6208,6208,44,0,44,1,0,1,9,5.021740929,0,1,202,0,402,0,402,26712,0,26712,268,0,268,1,88.84172226,Arch
2,67,4,63,71,1,0,1,17,359,1,2,0.507935356,702,1,225,0,120,114,6,3646,3388,258,46,41,5,1,96.83985003,Arch
8,47,126,79,173,0,1,1,22,894,1,7,2.034466654,2308,2,3,0,273,276,3,8713,9024,311,101,104,3,1,92.4037981,Arch
5,181,151,30,332,1,0,1,66,402,1,3,1.788221648,3669,5,267,0,753,756,3,21941,21845,96,336,340,4,1,97.20998532,Arch
7,35,25,10,60,0,0,0,55,365,1,7,2.290018766,2622,1,271,4,459,458,1,15297,15241,56,203,202,1,1,97.41463415,Arch
2,108,0,108,108,2,0,2,1,0,1,1,0.99975261,0,1,272,4,4,0,4,681,0,681,2,0,2,1,97.22492697,Arch
3,208,0,208,208,2,0,2,20,151,1,2,1.035360097,102,1,26,0,21,10,11,1462,515,947,12,4,8,1,94.37119675,Arch
10,527,18,509,545,4,0,4,11,768,1,8,2.986944419,503,2,303,7,70,27,43,4417,2136,2281,47,18,29,1,95.49727857,Arch
4,345,5,340,350,2,0,2,4,808,1,3,0.964750357,266,1,307,11,83,24,59,3096,1081,2015,52,13,39,1,97.48134328,Arch
2,60,1,59,61,0,0,0,10,456,1,2,0.747394446,134,1,327,4,25,15,10,914,540,374,18,12,6,1,91.95979899,Arch
15,1726,179,1547,1905,7,0,7,57,291,1,5,3.338131157,3938,4,31,1,947,677,270,30730,22398,8332,487,327,160,1,93.91377853,Arch
3,19,2,17,21,0,0,0,60,980,1,2,1.441166544,1403,4,332,3,321,319,2,9398,9265,133,107,105,2,1,96.10058309,Arch
17,653,27,626,680,7,0,7,71,535,1,4,3.562157613,4193,5,348,3,964,906,58,28140,25490,2650,439,409,30,1,93.25337331,Arch
23,351,80,271,431,0,0,0,62,1011,1,8,3.998639397,4492,1,349,4,775,743,32,25325,23846,1479,295,274,21,1,93.15181518,Arch
3,19,1,18,20,0,0,0,65,1339,1,3,1.44064545,1523,1,416,0,346,339,7,10177,9967,210,120,119,1,1,91.22725152,Arch
6,216,4,212,220,2,0,2,69,231,1,2,2.15259304,2791,6,15,0,555,535,20,18036,17113,923,240,227,13,1,86.97674419,Arch
6,4,216,212,220,0,2,2,70,18,1,2,2.15259304,3003,6,16,1,535,555,20,17113,18036,923,227,240,13,1,86.97674419,Arch
2,103,0,103,103,0,0,0,5,994,1,2,0.748293286,880,1,427,4,62,54,8,4514,3849,665,46,40,6,1,89.06037222,Arch
13,418,34,384,452,2,0,2,59,1286,1,7,2.865565594,2430,1,454,5,536,475,61,16144,13678,2466,256,210,46,1,88.9827856,Arch
2,129,26,103,155,1,0,1,25,894,1,2,0.996363935,178,1,455,6,42,25,17,1464,981,483,20,16,4,1,95.59112609,Arch
11,489,69,420,558,1,0,1,10,2553,1,4,2.893098107,1134,1,456,4,147,110,37,7730,5501,2229,67,62,5,1,88.8580354,Arch
1,25,8,17,33,0,0,0,8,95,1,1,0.0,155,1,460,2,19,20,1,927,815,112,14,15,1,1,90.53414469,Arch
23,0,4138,4138,4138,0,23,23,10,3827,1,2,4.207378222,4138,4,465,5,0,382,382,0,20842,20842,0,168,168,1,95.34487653,Arch
4,502,0,502,502,2,0,2,25,350,1,3,1.024934575,483,1,24,2,137,74,63,5355,2302,3053,63,38,25,1,96.49565461,Arch
2,94,0,94,94,1,0,1,16,749,1,2,0.550984443,639,1,467,2,80,72,8,2908,2586,322,35,33,2,1,96.64516129,Arch
2,150,2,148,152,1,0,1,4,757,1,2,0.464810709,60,1,474,5,17,6,11,1054,225,829,16,6,10,1,86.85208597,Arch
13,2180,22,2158,2202,7,0,7,84,206,1,6,2.992199706,4511,1,5,0,1425,1144,281,40725,27497,13228,545,407,138,1,89.13443831,Arch
2,38,5,33,43,1,0,1,6,913,1,2,0.854180205,364,5,73,5,69,69,0,1650,1591,59,33,33,0,1,90.995671,Arch
2,41,4,37,45,1,0,1,71,458,1,2,0.764204507,903,1,35,3,220,218,2,6482,6245,237,51,50,1,1,91.01123596,Arch
1,0,2,2,2,0,0,0,72,0,1,1,0.0,905,6,37,5,218,218,0,6255,6277,22,50,50,0,1,91.10535406,Arch
2,22,4,18,26,0,0,0,19,0,1,2,0.930586129,765,3,39,7,123,120,3,3768,3646,122,47,46,1,1,87.11683696,Arch
9,1545,2,1543,1547,3,0,3,64,0,1,5,1.950148742,1749,3,42,10,578,328,250,17930,9332,8598,271,128,143,1,87.87268332,Arch
15,497,74,423,571,0,0,0,65,309,1,8,3.227672571,4881,3,0,0,876,828,48,27124,24982,2142,379,360,19,1,90.66455696,Arch
6,202,7,195,209,1,0,1,20,361,1,4,2.100465504,2671,4,53,3,412,399,13,16045,14939,1106,254,241,13,1,89.30369128,Arch
3,387,44,343,431,2,0,2,20,527,1,3,1.465314378,627,1,0,0,151,88,63,5078,2757,2321,71,61,10,2,94.83585393,Arch
3,44,387,343,431,0,2,2,19,150,1,3,1.465314378,970,0,61,0,88,151,63,2757,5078,2321,61,71,10,1,94.83585393,Arch
15,503,55,448,558,2,0,2,85,1572,2,9,2.640519997,3635,4,0,0,739,566,173,22543,15683,6860,343,267,76,2,94.83585393,Arch
5,59,390,331,449,0,2,2,77,373,1,5,1.686085404,2599,0,30,14,440,463,23,13696,12110,1586,185,166,19,0,94.83585393,Arch
2,38,5,33,43,1,0,1,6,911,1,2,0.854180205,364,1,32,1,69,69,0,1650,1591,59,33,33,0,1,90.995671,Arch
2,5,38,33,43,0,1,1,3,8,1,2,0.854180205,397,0,10,1,69,69,0,1591,1650,59,33,33,0,1,90.995671,Arch
2,38,5,33,43,1,0,1,6,911,1,2,0.854180205,364,1,10,1,69,69,0,1650,1591,59,33,33,0,1,90.995671,Arch
3,378,44,334,422,2,0,2,21,1,1,3,1.449527081,641,1,0,0,152,92,60,5146,2872,2274,72,62,10,2,91.04606113,Arch
2,0,331,331,331,0,2,2,0,0,1,2,0.907894446,331,0,36,0,0,60,60,0,2303,2303,0,10,10,1,91.04606113,Arch
2,41,4,37,45,1,0,1,71,415,1,2,0.764204507,903,1,37,1,220,218,2,6482,6245,237,51,50,1,1,91.01123596,Arch
1,0,2,2,2,0,0,0,72,0,1,1,0.0,905,4,39,3,218,218,0,6255,6277,22,50,50,0,1,91.10535406,Arch
7,338,213,125,551,2,1,3,70,245,1,7,2.21548273,2550,1,11,4,547,507,40,15973,14754,1219,161,162,1,0,90.79569892,Arch
10,262,378,116,640,1,2,3,87,1219,1,9,2.521166669,4953,2,0,0,1074,925,149,28121,24733,3388,410,351,59,2,90.79569892,Arch
2,22,4,18,26,0,0,0,19,18,1,2,0.930586129,765,3,41,0,123,114,9,3768,3388,380,47,41,6,1,87.11683696,Arch
9,1545,2,1543,1547,3,0,3,64,29,1,5,1.950148742,1749,2,44,3,578,64,514,17930,1704,16226,271,26,245,1,87.87268332,Arch
327,3276,5214,1938,8490,1,6,7,85,705,2,64,6.887239725,75914,1,0,0,9888,10181,293,383303,393957,10654,5011,5174,163,1,87.89110118,Arch
2,41,4,37,45,1,0,1,71,458,1,2,0.764204507,903,1,35,3,220,218,2,6482,6245,237,51,50,1,1,91.01123596,Arch
1,0,2,2,2,0,0,0,72,0,1,1,0.0,905,4,37,5,218,218,0,6255,6277,22,50,50,0,1,91.10535406,Arch
2,22,4,18,26,0,0,0,19,0,1,2,0.930586129,765,3,39,7,123,114,9,3768,3388,380,47,41,6,1,87.11683696,Arch
9,1545,2,1543,1547,3,0,3,64,0,1,5,1.950148742,1749,2,42,10,578,64,514,17930,1704,16226,271,26,245,1,87.87268332,Arch
15,497,74,423,571,0,0,0,65,327,1,8,3.227672571,4881,3,0,0,876,677,199,27124,20392,6732,379,291,88,1,90.66455696,Arch
15,74,497,423,571,0,0,0,64,1117,1,8,3.227672571,5304,2,4,0,828,876,48,24982,27124,2142,360,379,19,1,90.66455696,Arch
15,497,74,423,571,0,0,0,65,309,1,8,3.227672571,4881,3,0,0,876,677,199,27124,20392,6732,379,291,88,1,90.66455696,Arch
331,3679,5568,1889,9247,3,5,8,86,700,2,65,6.831651852,76907,1,14,0,10064,10328,264,388925,398755,9830,5076,5242,166,0,86.44351464,Arch
331,5568,3679,1889,9247,5,3,8,88,2993,2,65,6.831651852,75018,2,0,0,10328,9948,380,398755,386281,12474,5242,5038,204,0,86.44351464,Arch
6,202,7,195,209,1,0,1,22,115,1,4,2.100465504,2671,4,50,1,412,247,165,16045,7929,8116,254,154,100,1,89.30369128,Arch
21,9,1455,1446,1464,0,13,13,81,138,1,10,3.768277817,5549,3,476,0,769,856,87,23477,28975,5498,351,419,68,1,88.33757422,Arch
20,1454,8,1446,1462,13,0,13,22,60,1,9,3.758443164,2938,4,0,0,541,302,239,21853,9314,12539,323,168,155,1,88.33757422,Arch
39,62,2090,2028,2152,0,15,15,88,375,1,20,4.568678693,14897,3,50,0,2113,2242,129,77585,86960,9375,981,1074,93,1,87.4839812,Arch
6,202,7,195,209,1,0,1,20,361,1,4,2.100465504,2671,4,53,3,412,247,165,16045,7929,8116,254,154,100,1,89.30369128,Arch
18,771,158,613,929,6,0,6,89,1402,1,10,2.959006979,3538,1,17,1,733,637,96,22248,19220,3028,321,305,16,0,97.37171464,Arch
18,158,771,613,929,0,6,6,90,1052,1,10,2.959006979,4151,2,4,0,637,238,399,19220,8301,10919,305,95,210,1,97.37171464,Arch
26,1078,65,1013,1143,5,0,5,90,992,1,18,3.501453382,7497,3,18,0,1424,653,771,46540,21692,24848,623,316,307,0,97.29053772,Arch
6,1,715,714,716,0,5,5,3,0,1,4,2.060193345,733,0,0,0,1,116,115,140,3916,3776,1,20,19,1,97.37390579,Arch
30,1425,65,1360,1490,9,0,9,90,832,1,19,3.956671437,7497,3,19,1,1458,653,805,48129,21692,26437,645,316,329,0,96.89054726,Arch
30,81,1424,1343,1505,0,9,9,89,1200,1,19,3.99190632,8857,2,2,1,1272,1444,172,40841,47560,6719,590,634,44,1,96.89054726,Arch
9,1049,0,1049,1049,9,0,9,7,77,1,4,2.959224685,0,1,23,0,149,0,149,5321,0,5321,41,0,41,0,96.973466,Arch
45,8,181,173,189,0,0,0,77,40,1,15,4.833284539,12084,2,31,10,1600,1600,0,71633,73162,1529,805,805,0,1,90.36850921,Arch
18,266,1167,901,1433,1,9,10,98,112,1,6,3.621903171,8783,0,0,0,1148,1199,51,42546,35244,7302,608,624,16,1,90.46372476,Arch
6,185,1,184,186,2,0,2,42,424,1,4,1.481711093,720,4,10,0,81,9,72,4634,322,4312,46,8,38,1,95.40186916,Arch
16,277,147,130,424,1,0,1,100,114,1,12,3.127280101,9170,3,7,5,1947,1810,137,52383,48358,4025,706,638,68,1,95.06454062,Arch
97,1536,1876,340,3412,0,1,1,78,730,1,21,5.533997794,26812,3,2,0,2399,2332,67,166047,163404,2643,1507,1451,56,1,95.49005682,Arch
3,96,128,32,224,1,2,3,6,102,1,1,1.556254104,128,2,0,0,5,6,1,398,525,127,3,2,1,1,90.27088897,Arch
8,93,9,84,102,3,0,3,26,585,1,3,2.537838264,2067,4,0,0,319,316,3,9377,9221,156,164,161,3,1,90.29618083,Arch
14,85,310,225,395,0,2,2,79,363,1,8,2.377382028,3310,3,31,4,311,292,19,19471,17017,2454,180,165,15,1,93.59831164,Arch
23,747,73,674,820,7,0,7,99,85,1,11,3.918194014,6620,11,0,0,1248,520,728,38499,17453,21046,516,243,273,2,92.57142857,Arch
27,105,52,53,157,0,0,0,21,1085,1,10,4.389798373,4594,4,37,1,396,393,3,21133,20546,587,227,226,1,1,97.37817797,Arch
41,5112,0,5112,5112,40,0,40,28,10,1,7,5.280279968,1972,1,14,1,762,0,762,38876,0,38876,449,0,449,1,89.33823529,Arch
13,699,679,20,1378,2,2,4,90,0,1,6,3.191020235,5616,2,11,0,769,767,2,30824,30819,5,430,429,1,0,92.23268325,Arch
22,104,121,17,225,0,0,0,94,83,1,13,3.588312035,5392,6,47,9,642,648,6,32584,32754,170,309,311,2,1,95.83492549,Arch
4,34,3,31,37,0,0,0,22,2156,1,3,1.834567814,1663,7,0,0,189,159,30,10555,5558,4997,55,29,26,1,95.61177078,Arch
2,198,24,174,222,1,0,1,78,215,1,2,0.995252549,626,1,3,2,136,112,24,3795,2909,886,58,44,14,1,94.19424851,Arch
