CommitID,NMF,TotalAddLines,TotalDeleteLines,LC,LC_1,FileAdd,FileDelete,NAD,NUC,AGE,NMS,NMD,Entropy ,MLMF,NDVE,EXP,REXP,CommitComplexity,LastCommitComplexity,CFC,CommitTokenCount,LastCommitTokenCount,NCC,CommitMethodNum,LastCommitMethodNum,NFC,NIR,a2a,Tag
a322a829a586cf03685152f06cc7025d66062202,1,58,0,58,58,1,0,1,2,0,1,1,0,812,2,10,10,119,110,9,2854,2703,151,10,10,0,0,100,NoArch
8169b159895f5f727287f6dff351e61569d03f48,1,78,0,78,78,1,0,1,1,0,1,1,0,0,1,21,21,4,0,4,76,0,76,4,0,4,0,99.47916667,NoArch
a93ff66772451264ef054ed19e98448d3f01953b,1,2,3,1,5,0,0,0,3,0,1,1,0,870,2,11,11,119,119,0,2853,2854,1,10,10,0,0,100,NoArch
fae44a3dbc26273587a40250d4fa94ff8b2c22a9,1,2,0,2,2,1,0,1,4,0,1,1,0,869,2,12,12,119,119,0,2858,2853,5,10,10,0,0,100,NoArch
87578c39d8d55b8eab63b497391eed80b50120f4,1,33,0,33,33,1,0,1,2,0,1,1,0,921,2,13,13,113,110,3,2441,2360,81,105,102,3,0,100,NoArch
b9a41b6d1eb59897187c91fbb45526ef347fdeae,1,42,0,42,42,1,0,1,3,0,1,1,0,954,2,14,14,116,113,3,2549,2441,108,108,105,3,0,100,NoArch
e7619d322d9d735e947756cf5c87917e1e7921b2,6,38,1,37,39,5,0,5,2,0,1,4,2.091340039,1718,1,22,22,215,209,6,7221,7032,189,111,106,5,0,99.82698962,NoArch
82661774a6c5e65d33ab2e7f3c830026c0556f4d,6,96,17,79,113,2,0,2,5,0,1,5,2.314716936,5400,2,15,15,622,606,16,16559,16253,306,333,330,3,0,100,NoArch
1b3f8b9f8a7432daa6f9b49f4a703fa1097e96c4,2,21,3,18,24,1,0,1,6,0,1,2,0.811278124,1936,2,16,16,270,267,3,6510,6452,58,54,54,0,0,100,NoArch
8b51c36c2360acfbbe7b2b572121f6d447b82a07,1,4,0,4,4,1,0,1,2,0,1,1,0,70,1,23,23,4,3,1,75,60,15,3,3,0,0,100,NoArch
6ba7af92409900eb55e0dd46c9b71ea535357feb,3,49,9,40,58,1,0,1,3,0,1,3,0.942333447,671,2,24,24,96,96,0,2690,2695,5,32,32,0,0,100,NoArch
f9687e8b03815eb10e960906263f058524e5b880,2,10,0,10,10,2,0,2,3,0,1,2,1,1315,1,25,25,68,66,2,2998,2948,50,64,62,2,0,100,NoArch
e754912d3fe84dde93da285a18ce65b7180569db,0,0,0,0,0,0,0,0,0,0,0,0,0,0,0,17,16,0,0,0,0,0,0,0,0,0,0,100,NoArch
422e8974e233d8e687d9be6bc5f75743478980be,1,10,0,10,10,1,0,1,4,0,1,1,0,599,2,18,17,98,96,2,2701,2651,50,33,32,1,0,100,NoArch
192b631e7be302ecde822546ba70a9853ddbda01,2,2,2,0,4,0,0,0,4,0,1,2,1,1325,2,19,18,68,68,0,2998,2998,0,64,64,0,0,100,NoArch
192543f43bf728e3ed887744fa0fcaf33dc460ed,2,2,2,0,4,0,0,0,5,0,1,2,1,1325,2,20,19,68,68,0,2992,2998,6,64,64,0,0,100,NoArch
bbadbfd40824d8491df547a8b20f790830ee94a7,2,5,3,2,8,0,0,0,5,0,1,1,1,1665,2,21,20,247,245,2,6291,6265,26,77,77,0,0,100,NoArch
a6ee72a353768d98a43c2f0bd3ac3b1546414b91,1,15,0,15,15,1,0,1,6,0,1,1,0,611,2,22,21,102,100,2,2800,2725,75,34,33,1,0,99.48186528,NoArch
af40753aee0a0369706de26c0ab8dd5c7bd0b95c,2,23,0,23,23,2,0,2,7,0,1,1,0.998635964,1682,2,23,22,252,249,3,6465,6366,99,80,78,2,0,99.65517241,NoArch
25cb20748a6397853a170d29319fe80d3bc0914a,0,0,0,0,0,0,0,0,0,0,0,0,0,0,0,26,26,0,0,0,0,0,0,0,0,0,0,100,NoArch
535bf948c749b427e8a1b0e87f4af2e80165fe60,3,47,5,42,52,2,0,2,3,0,1,3,1.395790502,1067,1,27,27,142,137,5,4899,4707,192,77,74,3,0,100,NoArch
9d244e987eb3611331b3cbebb1e936ae5e70862e,1,27,36,9,63,0,0,0,4,0,1,1,0,815,1,28,28,108,103,5,3914,3890,24,46,46,0,0,100,NoArch
d686ebbc47931e3063ce7202ade17327f12fb5d8,4,65,51,14,116,1,0,1,5,0,1,4,0.984268642,1240,1,29,29,163,162,1,5344,5258,86,92,92,0,0,100,NoArch
8dcc001e4e0cdc059daa0fd2e1ebcc1bd30bf222,5,182,0,182,182,5,0,5,6,0,1,3,1.392534296,1289,1,30,30,172,160,12,6154,5884,270,89,77,12,0,98.8034188,NoArch
e71542f9a8ed01a1ef4e21a53482a0fd2d54b62f,1,22,0,22,22,1,0,1,4,0,1,1,0,135,1,31,31,19,15,4,462,376,86,11,10,1,0,100,NoArch
b252b507ce2d843c715444bde0fa496e060be433,0,0,0,0,0,0,0,0,0,0,0,0,0,0,0,32,32,0,0,0,0,0,0,0,0,0,0,100,NoArch
353a95546fc90b751084cda0d93ad19054cf1e3b,0,0,0,0,0,0,0,0,0,0,0,0,0,0,0,33,33,0,0,0,0,0,0,0,0,0,0,100,NoArch
45504114aa13670726bd204e29c3e5a8bdc356f4,3,57,14,43,71,1,0,1,8,0,1,2,1.477972632,2925,2,24,23,322,313,9,9413,9260,153,137,137,0,0,100,NoArch
65f8c34b408ec4ca6ce16f35dfd47dbb100f978e,2,31,5,26,36,1,0,1,9,0,1,1,0.183122068,1736,2,25,24,268,261,7,6665,6558,107,80,80,0,0,100,NoArch
51286f1559f59473a50379eea8ac4e4fac34f0f1,2,71,0,71,71,2,0,2,10,0,1,1,0.967559482,1762,2,26,25,274,268,6,7006,6665,341,82,80,2,0,99.49066214,NoArch
698df9f5b0816e05bbf97a390428f8ef94e0cdbf,6,70,4,66,74,4,0,4,11,0,1,5,2.519671998,5688,2,27,26,665,657,8,17722,17489,233,345,340,5,0,95.57522124,Arch
eb885b0bdbf61bb0a8f37bc4dd4248c4beb9d2e3,1,0,4,4,4,0,0,0,10,0,1,1,0,1144,2,28,27,157,158,1,3883,3894,11,47,47,0,0,100,NoArch
f604e00970231c359771075b86642ea275c5bf1f,7,149,109,40,258,0,0,0,7,0,1,3,2.344231962,1430,1,34,34,159,149,10,5584,5320,264,83,78,5,0,94.02460457,Arch
d1963f1be79aeb0dca8aa012659f725e1ffc96f9,11,102,32,70,134,5,0,5,12,0,1,6,2.39600235,2515,1,35,35,335,320,15,9804,9475,329,150,143,7,0,100,NoArch
3a030a7df8cac8301c1369605ac473d8550d2cf4,0,0,0,0,0,0,0,0,0,0,0,0,0,0,0,36,36,0,0,0,0,0,0,0,0,0,0,100,NoArch
4fb3f2922e3aef0c494c315241826a7c9cb8e371,1,58,0,58,58,1,0,1,2,2,1,1,0,359,1,37,37,48,41,7,1350,1193,157,27,20,7,0,100,NoArch
e2c6289ab695e2b52dc9dd67338a05142219fed3,1,65,0,65,65,1,0,1,1,0,1,1,0,0,1,38,38,2,0,2,50,0,50,2,0,2,0,99.66555184,NoArch
633b279871a1d06256ead3b2c20f5c75cab15753,0,0,0,0,0,0,0,0,0,0,0,0,0,0,0,39,39,0,0,0,0,0,0,0,0,0,0,100,NoArch
4b57f35033653f14244ec6aaca1188bc52451a51,0,0,0,0,0,0,0,0,0,0,0,0,0,0,0,40,40,0,0,0,0,0,0,0,0,0,0,100,NoArch
76636a8b0f9ffc07cbb5dc758ed30d413a084c76,4,90,0,90,90,4,0,4,9,0,1,3,0.785607389,1282,1,41,41,169,163,6,5896,5759,137,82,76,6,0,99.33665008,NoArch
f7ff091a963c69a24f554581e2d3444cee0b3877,4,87,0,87,87,4,0,4,10,0,1,3,0.845030252,1295,1,42,42,170,165,5,5938,5807,131,83,78,5,0,99.01477833,NoArch
34d9b8096cbc92714295ce6c681bc8082934a399,2,76,33,43,109,1,0,1,8,4,1,1,0.92429098,936,2,29,24,132,127,5,3262,3070,192,14,13,1,0,100,NoArch
3bf1171e37bb8e093687f4aa5cbd2e8009c1adaa,3,44,2,42,46,1,0,1,11,0,1,2,0.746598325,1226,1,43,43,179,173,6,5526,5317,209,79,77,2,0,100,NoArch
ceff290a80c05567d52b67bfd9de4e5d64dbdd02,0,0,0,0,0,0,0,0,0,0,0,0,0,0,0,44,44,0,0,0,0,0,0,0,0,0,0,100,NoArch
12326d101e800a711b95749eb5b4dafbbc3ffe37,1,1,1,0,2,0,0,0,2,5,1,1,0,230,1,45,45,27,27,0,770,770,0,23,23,0,0,100,NoArch
198bddc586a97a05e26c146541bf46b7aade1730,2,48,0,48,48,2,0,2,13,3,1,1,0.968461009,1873,2,30,25,287,280,7,7331,7150,181,87,85,2,0,100,NoArch
6dbfbc970ecb142630809d21cadf2a14c994b5f6,0,0,0,0,0,0,0,0,0,0,0,0,0,0,0,46,46,0,0,0,0,0,0,0,0,0,0,100,NoArch
797fdd674036b65151138b10aecb475c8b26a9f5,3,100,29,71,129,1,0,1,12,1,1,3,0.314101022,1442,1,47,47,213,189,24,6375,5914,461,96,86,10,0,100,NoArch
b2b4e9bfb2addcdd081beb2eec257065147b6a02,0,0,0,0,0,0,0,0,0,0,0,0,0,0,0,48,48,0,0,0,0,0,0,0,0,0,0,100,NoArch
ea53eef5ce6a983fc8d35ccfe4bfeff0e6d9c65c,1,9,0,9,9,1,0,1,2,5,1,1,0,56,1,49,49,2,0,2,48,16,32,2,0,2,0,100,NoArch
44ef41e36b833081ab4a689170a4871ccabe7aaa,1,9,0,9,9,1,0,1,4,4,1,1,0,204,1,50,50,23,21,2,762,733,29,21,19,2,0,100,NoArch
b8cd37938ed7a1779294f8f5da01b4e4675e9f9a,8,35,23,12,58,0,0,0,13,0,1,3,1.960494261,1675,1,51,51,181,182,1,6312,6259,53,100,102,2,0,100,NoArch
0bb5a5fd890ad6ca46694555b208d3c30328e879,3,15,15,0,30,0,0,0,3,3,1,1,1.485475297,186,2,31,26,4,4,0,133,134,1,4,4,0,0,97.39837398,Arch
28fb7a567bcd349164067b330a4c3225894071e4,3,89,16,73,105,1,0,1,14,0,1,3,0.48750376,1212,1,52,52,176,168,8,5719,5329,390,83,81,2,0,100,NoArch
667a2cec4caf86d18474cc6e385888e3d328b3d0,0,0,0,0,0,0,0,0,0,0,0,0,0,0,0,53,53,0,0,0,0,0,0,0,0,0,0,100,NoArch
5a787ab2b618731249d84b9fe612924d27d5edfb,2,26,13,13,39,1,0,1,15,4,1,2,0.552495114,1121,1,54,53,153,151,2,5117,5051,66,63,62,1,0,100,NoArch
1dc96b90f0612ad2642a415227379e02c48a4e5e,1,33,0,33,33,1,0,1,14,15,1,1,0,752,2,32,27,130,126,4,3518,3355,163,41,39,2,0,97.04433498,Arch
f53518d75b28e0e796c2910fbeda51989233a5cf,1,64,0,64,64,1,0,1,1,0,1,1,0,0,1,55,50,2,0,2,42,0,42,2,0,2,0,99.33665008,NoArch
1118237196e19816492fe64a21f6509c1c78d892,2,81,42,39,123,0,0,0,16,8,1,2,0.744116307,1134,1,56,51,162,153,9,5322,5117,205,65,63,2,0,100,NoArch
2c1ff2909feecd7523fbefe2bbd6a0baeb1154ef,0,0,0,0,0,0,0,0,0,0,0,0,0,0,0,57,52,0,0,0,0,0,0,0,0,0,0,100,NoArch
5bc34028c9e802c2219c670dbabfb7aebb91584e,1,4,0,4,4,1,0,1,15,0,1,1,0,785,2,58,53,130,130,0,3539,3518,21,41,41,0,0,100,NoArch
9fa095a4774516bba3a725246afdc8b7d44ccbd9,2,47,3,44,50,0,0,0,16,8,1,1,0.826746372,1958,2,33,28,296,291,5,7664,7515,149,89,89,0,0,100,NoArch
c8d36fce6c447b6a861d929e6fd222bd621f532c,1,0,4,4,4,0,0,0,17,0,1,1,0,800,2,34,29,131,131,0,3555,3576,21,41,41,0,0,100,NoArch
aa72c6ba578c1e24a5a2264368a61ca6c7664947,0,0,0,0,0,0,0,0,0,0,0,0,0,0,0,59,53,0,0,0,0,0,0,0,0,0,0,100,NoArch
acdd96311f3ed570443e8ff839606b0c1bcd4666,4,59,18,41,77,0,0,0,17,7,1,3,1.132677183,1565,1,60,54,208,201,7,7060,6832,228,97,95,2,0,100,NoArch
2033d90b48c1be062033f5c7548cdd0f0c87dc1b,6,38,4,34,42,3,0,3,18,10,1,4,2.199979327,1782,1,61,55,233,227,6,7480,7294,186,128,127,1,0,100,NoArch
3ebd65a22530b0a8216ad4457d1ee6a8108cbe1c,3,20,12,8,32,1,0,1,5,7,1,3,1.208538233,878,1,62,56,119,118,1,3710,3639,71,48,47,1,0,100,NoArch
cd84934930f011c6787c0cf52be437db18d88656,1,0,1,1,1,0,0,0,5,0,1,1,0,165,1,63,57,12,12,0,764,775,11,7,7,0,0,100,NoArch
9579572382d06fc5bee6392cd4832ccff7941198,0,0,0,0,0,0,0,0,0,0,0,0,0,0,0,64,58,0,0,0,0,0,0,0,0,0,0,100,NoArch
6c6a60679f5d61268446efcb0a01109e199101d5,0,0,0,0,0,0,0,0,0,0,0,0,0,0,0,65,59,0,0,0,0,0,0,0,0,0,0,100,NoArch
3a0e164308dbf76322cc7473f6181694ca7e4867,2,19,3,16,22,0,0,0,19,0,1,2,0.439496987,1811,2,66,60,275,273,2,8481,8401,80,93,92,1,0,100,NoArch
ecce4047414cafb254541307247c8d9101646609,2,28,4,24,32,1,0,1,20,0,1,2,0.448864489,1216,1,67,61,182,170,12,5675,5535,140,68,66,2,0,100,NoArch
c4eeee65c9e525b823a407ecae31219f3328241c,7,462,8,454,470,5,0,5,12,15,1,6,2.079985146,956,1,68,62,171,124,47,4976,3575,1401,91,72,19,0,99.18166939,NoArch
488bd06ca39a9b38166b173c14779eea761a9c8b,3,231,44,187,275,0,0,0,21,5,1,3,1.079986945,1373,1,69,60,226,194,32,7391,6216,1175,75,68,7,0,100,NoArch
71f30c5c9ce9a8b2780177331987d1d4168baaf2,0,0,0,0,0,0,0,0,0,0,0,0,0,0,0,70,61,0,0,0,0,0,0,0,0,0,0,100,NoArch
d0f22e3e9bc9d5bba803c06b2953e95176685dc0,19,414,78,336,492,10,0,10,22,10,1,7,3.11624131,3796,1,71,61,503,466,37,15640,14283,1357,246,222,24,0,96.66136725,Arch
f467c013a0f3a1f3043d068b0e4a62ba03fee44e,0,0,0,0,0,0,0,0,0,0,0,0,0,0,0,72,61,0,0,0,0,0,0,0,0,0,0,100,NoArch
34eb1636c6a6341bf6649b6149ece1464c59e5d6,0,0,0,0,0,0,0,0,0,0,0,0,0,0,0,73,62,0,0,0,0,0,0,0,0,0,0,100,NoArch
e38d71166fc8cd7ebb7217fd4b7d7465a10b6d7c,2,49,26,23,75,0,0,0,23,2,1,2,0.40217919,1258,1,74,62,171,166,5,6164,6072,92,59,58,1,0,100,NoArch
0959d745de54ea70865e428e07c35c8c52f2dc73,0,0,0,0,0,0,0,0,0,0,0,0,0,0,0,75,63,0,0,0,0,0,0,0,0,0,0,100,NoArch
508ae5fd99ab1307043918ffd4b1c87de9af9f6f,1,43,0,43,43,1,0,1,19,13,1,1,0,812,2,35,25,138,132,6,3773,3631,142,44,42,2,0,99.84423676,NoArch
27b550493debc84f9b5584bab85018126c00e956,2,22,3,19,25,1,0,1,7,2,1,2,0.855450811,782,1,76,64,122,119,3,3332,3241,91,47,45,2,0,98.4375,NoArch
901b3294774cdd73c5591233f01a9b2f875310ae,1,0,7,7,7,0,0,0,24,0,1,1,0,1200,1,77,65,167,168,1,6007,6031,24,56,56,0,0,100,NoArch
aafff1d384f611a66edd1b95108502c27789e2cc,4,65,0,65,65,4,0,4,20,19,1,3,1.933101212,4042,2,36,26,455,449,6,13133,12919,214,238,234,4,0,100,NoArch
ab534ea577a2b38f89d372b485b76d05202bd5c8,0,0,0,0,0,0,0,0,0,0,0,0,0,0,0,37,27,0,0,0,0,0,0,0,0,0,0,100,NoArch
a30c3cc287de122be0d31cb7e974c063c74ac04d,3,139,2,137,141,1,0,1,21,0,1,2,1.213331405,3358,2,38,28,380,370,10,11376,10940,436,158,153,5,0,100,NoArch
8bb86a7c791bad2e23c48b05a713aef372762e25,0,0,0,0,0,0,0,0,0,0,0,0,0,0,0,39,29,0,0,0,0,0,0,0,0,0,0,100,NoArch
ac25c02414dfa1ee48e0450f921fe95a677df7d3,1,21,6,15,27,0,0,0,15,0,1,1,0,1317,2,40,30,174,172,2,4413,4401,12,52,51,1,0,100,NoArch
5c59489ac07b761559d4caf69d11e9b05eded9b4,0,0,0,0,0,0,0,0,0,0,0,0,0,0,0,78,64,0,0,0,0,0,0,0,0,0,0,100,NoArch
3984fb4ff4a7364c9aa963abc25b4c032df8b534,0,0,0,0,0,0,0,0,0,0,0,0,0,0,0,79,65,0,0,0,0,0,0,0,0,0,0,100,NoArch
804c3b48c4e3fce0931d0c2a127d11f293b891da,0,0,0,0,0,0,0,0,0,0,0,0,0,0,0,80,66,0,0,0,0,0,0,0,0,0,0,100,NoArch
8b234d043e9da0a7f53df462730d3707d4431f04,0,0,0,0,0,0,0,0,0,0,0,0,0,0,0,81,67,0,0,0,0,0,0,0,0,0,0,100,NoArch
251297d1056b4c13e25e233ef34ed3da8da15480,0,0,0,0,0,0,0,0,0,0,0,0,0,0,0,82,65,0,0,0,0,0,0,0,0,0,0,100,NoArch
a0ed26028c87342036eafb46d9e51d6d1dd0405d,2,18,11,7,29,0,0,0,16,17,1,2,0.79732651,2245,2,41,31,300,299,1,7422,7405,17,63,62,1,0,100,NoArch
57af1390271670c354511a8e949fa0629aa9b243,1,3,1,2,4,0,0,0,25,2,1,1,0,1193,1,83,66,167,167,0,6021,6007,14,56,56,0,0,100,NoArch
b1666e2150bc34e33fab0d3d83d1c1bf3249c62f,4,39,22,17,61,2,0,2,8,2,1,2,1.47109171,1189,1,84,67,168,166,2,4764,4649,115,66,64,2,0,100,NoArch
7444652de672344da40a46c6b7846f82aa8ee015,1,0,4,4,4,0,0,0,6,0,1,1,0,543,1,85,68,90,90,0,2362,2399,37,19,19,0,0,100,NoArch
40f82da1eadd6d55ce0473f254bf7760fca6d3b4,5,111,5,106,116,4,0,4,26,9,1,3,1.348866089,1798,1,86,69,238,229,9,8473,8263,210,105,96,9,0,99.53125,NoArch
215f9d1348f0c7cb148ee8fa14cc8b637d81b524,2,11,4,7,15,0,0,0,7,0,1,1,0.566509507,805,1,87,70,129,127,2,3294,3253,41,30,30,0,0,100,NoArch
51ae3d70057882a98cc4b1d697d14c400b2f54ba,7,106,32,74,138,1,0,1,27,17,1,6,2.257056113,2111,1,88,71,264,255,9,9907,9480,427,115,108,7,0,98.58934169,NoArch
ea7269bb5924fa4648abdeed59c241977da62ad6,1,3,12,9,15,0,0,0,6,38,1,1,0,1003,2,42,32,117,117,0,2543,2567,24,109,109,0,0,100,NoArch
c9dfc35ca3f6c22adf4d5affd55c61d7e66b52a6,0,0,0,0,0,0,0,0,0,0,0,0,0,0,0,43,33,0,0,0,0,0,0,0,0,0,0,100,NoArch
be3c7412dcfa4cab0da1a1ff529025862c8dfdca,0,0,0,0,0,0,0,0,0,0,0,0,0,0,0,44,34,0,0,0,0,0,0,0,0,0,0,100,NoArch
3144c0e9c7b76f1df693f16e982b1da451c42c2c,3,36,37,1,73,0,0,0,9,0,1,2,0.904684359,1085,1,89,71,162,163,1,4350,4327,23,59,59,0,0,100,NoArch
b85c6f0fd98dd3ced6276f2165db15c398aa5c54,3,64,26,38,90,0,0,0,28,6,1,3,1.069021803,1600,1,90,71,208,204,4,8015,7781,234,87,85,2,0,100,NoArch
8aaa352a5ae8e0385b18518cecfcbb9574a0b3fd,1,0,1,1,1,0,0,0,29,0,1,1,0,1265,1,91,72,173,173,0,6430,6439,9,59,59,0,0,100,NoArch
4c08f63a1b49cf77dd61e1eccdbcf4e078b72bf4,0,0,0,0,0,0,0,0,0,0,0,0,0,0,0,92,73,0,0,0,0,0,0,0,0,0,0,100,NoArch
bb2273b91f88397490f67e5be94c9eb9d2a741ad,5,176,4,172,180,3,0,3,9,10,1,3,1.90257307,1252,1,93,67,197,177,20,5439,4830,609,75,69,6,0,97.21362229,Arch
d72a224aab439e2e2bcad6434c664c78eac58c0c,2,21,17,4,38,0,0,0,10,4,1,1,0.981940787,714,1,94,68,111,112,1,2955,3005,50,25,23,2,0,100,NoArch
0a961254c3cadcf54ec173a9d430e385f7c9612d,2,46,15,31,61,0,0,0,30,1,1,2,0.912734156,1496,1,95,69,209,205,4,7453,7271,182,78,78,0,0,100,NoArch
32eae498a30735777a77903a8283f0363b900a3d,1,39,0,39,39,1,0,1,6,0,1,1,0,504,1,96,64,83,73,10,2025,1873,152,39,37,2,0,100,NoArch
e1ea7417a7e9e48b963dfa540e125a956c24e691,2,15,7,8,22,1,0,1,11,0,1,2,0.945660305,741,1,97,63,111,109,2,3250,3199,51,30,28,2,0,96.05055292,Arch
20a38d9b2a87c052a4db498f16fef549e330474c,3,165,9,156,174,2,0,2,9,0,1,2,1.449876753,266,1,98,64,45,37,8,1082,889,193,16,11,5,0,99.18433931,NoArch
e24bf2ac875032b3eeb51e3ce7d20d573b6149d5,2,84,1,83,85,1,0,1,22,3,1,1,0.997502546,2233,2,45,16,329,318,11,8764,8417,347,101,99,2,0,99.35170178,NoArch
aeefc364386b14a766bb4bd95d3449bf249191f8,0,0,0,0,0,0,0,0,0,0,0,0,0,0,0,46,17,0,0,0,0,0,0,0,0,0,0,100,NoArch
75ff13e895bc7427bd34ac7582b874c0887ec5e0,0,0,0,0,0,0,0,0,0,0,0,0,0,0,0,47,18,0,0,0,0,0,0,0,0,0,0,100,NoArch
74cc1c4e4b05746fb7328a3dada2305703157005,0,0,0,0,0,0,0,0,0,0,0,0,0,0,0,48,19,0,0,0,0,0,0,0,0,0,0,100,NoArch
2983b9e0a398cc5d156e2f446f2f203868ce292c,6,302,65,237,367,3,0,3,31,0,1,5,2.252746265,1944,1,99,62,262,243,19,9894,9275,619,116,104,12,0,93.30289193,Arch
e7c6356960f41a8775799d228e717f0ecafd98a5,0,0,0,0,0,0,0,0,0,0,0,0,0,0,0,100,61,0,0,0,0,0,0,0,0,0,0,100,NoArch
ec6321cde182487f05c420be436833f232e78862,43,192,50,142,242,1,0,1,32,18,1,12,3.614873727,10056,1,101,58,947,933,14,35350,35170,180,625,619,6,0,93.28571429,Arch
c8d5dd000fe3aac2c0caf370f7fd395236130be3,110,109,201,92,310,0,1,1,33,0,1,19,5.63687376,15066,1,102,59,1254,1268,14,42300,42658,358,765,771,6,0,99.71428571,NoArch
4b16c08bf91ca588468973546db61c46708528c1,0,0,0,0,0,0,0,0,0,0,0,0,0,0,0,103,48,0,0,0,0,0,0,0,0,0,0,100,NoArch
06a456ec1670fb26a86f8a18f5b55017ac961f39,5,171,26,145,197,2,0,2,34,8,1,4,1.61962672,1776,1,104,49,251,235,16,9032,8524,508,101,94,7,0,99.71428571,NoArch
a7ce06e318dd27e1065b1e106d0ad64f790fb3a2,7,86,19,67,105,2,0,2,35,4,1,5,1.870135502,2164,1,105,50,257,256,1,10169,10099,70,98,97,1,0,99.71590909,NoArch
538fc8498dc01d9d8f7edf2749f9e17b334e02ab,2,30,10,20,40,0,0,0,36,2,1,2,0.384311544,1421,1,106,51,191,189,2,7130,7054,76,64,63,1,0,100,NoArch
44df07fcba99d7d219ef8381c6c7b7342e9ed319,3,59,32,27,91,0,0,0,4,3,1,2,1.211719917,412,1,107,52,42,37,5,1536,1409,127,20,19,1,0,100,NoArch
e8945a22885b9c366f1c110977912e990754b8c5,2,132,1,131,133,1,0,1,5,2,1,2,0.937053526,73,1,108,53,8,2,6,512,119,393,5,2,3,0,98.44192635,NoArch
fd96e18b2d982a127e2ba32ebc21fa7bcae5d153,2,42,19,23,61,0,0,0,6,0,1,2,0.999806133,204,1,109,53,12,8,4,586,512,74,6,5,1,0,99.29278642,NoArch
82f0514cdab58c920cac1392febbd8ffa4a49ce7,17,512,37,475,549,13,0,13,37,9,1,6,3.065700452,4091,1,110,48,560,513,47,19016,17187,1829,251,221,30,0,92.20183486,Arch
0eff0372ae226c9a480e4551595a25d3e5037c4c,6,17,5,12,22,2,0,2,14,0,1,4,2.2089873,1482,1,111,49,203,203,0,5915,5833,82,74,74,0,0,98.65319865,NoArch
783141f75b42e513b4b731e819f36123f91f98d8,9,416,25,391,441,5,0,5,14,2,1,5,2.550741116,1447,1,112,47,215,178,37,6346,5176,1170,95,79,16,0,98.48484848,NoArch
cd94a5fa593d63ed6ad177d8e6a67b51fe513943,9,149,46,103,195,3,0,3,15,6,1,3,2.089782679,2468,1,113,45,365,347,18,9656,9175,481,149,141,8,0,100,NoArch
deed915a3f0a1afaf1f0ae1582f79d2900027ee3,1,2,1,1,3,0,0,0,2,1,1,1,0,64,1,114,46,1,1,0,56,56,0,1,1,0,0,100,NoArch
d89ec6f75a1c4853517e43cb3df1cc7108b67c9b,1,18,1,17,19,0,0,0,18,25,1,1,0,1385,2,49,14,184,181,3,4671,4615,56,54,54,0,0,100,NoArch
2ab37f264c8c1e8fbc08846ed8d5bafc7269f2ea,1,4,0,4,4,1,0,1,9,3,1,1,0,169,1,115,47,14,13,1,594,581,13,7,6,1,0,100,NoArch
425d36a3978b55e7cfd66b7977e9487a18fab8f2,17,344,81,263,425,6,0,6,38,7,1,9,3.302607673,3376,1,116,47,394,359,35,14477,13560,917,187,169,18,0,96.74796748,Arch
1c86825f8baeb9c34c433c059340a6fb70b0576e,12,319,197,122,516,5,0,5,39,27,1,8,2.131029175,6729,2,50,15,803,775,28,27028,26066,962,294,276,18,0,96.90880989,Arch
009a7bd4de6fac2a90bea208507903a0dfcdc602,10,520,260,260,780,7,0,7,7,11,1,5,2.027675373,1244,1,51,16,132,108,24,5382,4109,1273,81,64,17,0,96.54135338,Arch
f9a57bc4ffc9100f7ab689ef2ab65a5985a9f577,1,39,0,39,39,1,0,1,1,0,1,1,0,0,1,52,17,5,0,5,120,0,120,5,0,5,0,99.40209268,NoArch
149de3deb79bb4b7f03995b46f6b002840d027a6,2,39,5,34,44,0,0,0,24,0,1,1,0.994030211,2405,2,53,18,343,339,4,9284,9172,112,105,105,0,1,100,NoArch
bc3e65b5e6d0b0c10c946a20dcae67e2f61aeaf5,64,410,324,86,734,9,0,9,40,0,1,12,5.142816077,8859,1,117,48,807,799,8,29228,28326,902,464,456,8,0,79.94579946,Arch
62b45cc40e7662b76107f68fd650db3b503ed415,0,0,0,0,0,0,0,0,0,0,0,0,0,0,0,118,49,0,0,0,0,0,0,0,0,0,0,100,NoArch
37c8e745890efe601d8a49d60c612ea3b11e26f5,2,42,3,39,45,1,0,1,13,3,1,2,0.721928095,954,1,119,50,163,151,12,4341,4097,244,59,57,2,0,100,NoArch
f3eae213c50ba50aa9841155ffb0f2ff839a4fb9,4,25,68,43,93,2,0,2,11,9,1,3,1.224567438,951,2,120,51,116,114,2,3517,3490,27,55,55,0,0,96.46910467,Arch
5f0531504712ab766f7cc24e8e1ee03089994444,15,318,97,221,415,8,0,8,41,1,1,8,3.027393077,3740,1,121,52,529,498,31,16958,16624,334,202,184,18,0,94.71649485,Arch
813ba98f4b9e3421dc62021dd63f2de806cff34a,0,0,0,0,0,0,0,0,0,0,0,0,0,0,0,122,53,0,0,0,0,0,0,0,0,0,0,100,NoArch
2f9c51e8a76c53346a9f3c5c9111ab926da0e467,0,0,0,0,0,0,0,0,0,0,0,0,0,0,0,0,0,0,0,0,0,0,0,0,0,0,0,100,NoArch
87fe7387851580b2230a0b0fd383f9a1a137cf62,4,124,8,116,132,1,0,1,26,7,1,2,1.533849909,1286,2,123,52,194,187,7,5416,5097,319,81,77,4,0,95.92105263,Arch
2731d2cb54338969aca4883d390979ae0d8d0883,1,10,1,9,11,0,0,0,27,0,1,1,0,953,2,124,52,154,153,1,4023,3997,26,48,48,0,0,100,NoArch
48a2a52233d07135908162e23f3f85d970dbbab7,10,693,70,623,763,8,0,8,28,1,1,5,2.330595717,1567,1,125,53,260,205,55,7397,5871,1526,102,74,28,0,98.28722003,NoArch
28f7cd947c9fec0d596f42c1f5542f74a316a355,0,0,0,0,0,0,0,0,0,0,0,0,0,0,0,54,19,0,0,0,0,0,0,0,0,0,0,100,NoArch
871c85f7db5bb270bd308cb25fdfc40f82843b2d,3,151,55,96,206,0,0,0,21,11,1,2,0.762776798,3087,2,55,20,275,257,18,10578,10286,292,122,118,4,0,100,NoArch
9a2424fcfa0eed1c492756f4c0cf61f24a3a3461,5,47,48,1,95,3,0,3,29,0,1,4,1.310056652,1902,1,126,54,258,256,2,7479,7456,23,101,98,3,0,100,NoArch
a98591ea64a749df9d9a5dcca9c5183456d39dc6,3,214,83,131,297,1,0,1,10,3,1,2,1.505268612,920,1,127,54,158,147,11,4371,3943,428,38,34,4,0,97.52604167,Arch
a71476aae7c79aac1e8587c133b252c2b9f8af58,2,466,0,466,466,2,0,2,2,1,1,2,0.125226198,131,1,128,50,77,11,66,2221,338,1883,24,4,20,0,98.18887451,NoArch
16feef2705fc7386de9b7edbc9b81e249b5f77b6,6,252,26,226,278,3,0,3,42,0,1,5,1.937778025,2125,1,129,51,295,267,28,10899,9985,914,125,101,24,0,98.59335038,NoArch
03eabc785d4d5bf11ce5cb68d142757c96d1f2ce,1,2,11,9,13,0,0,0,22,2,1,1,0,1548,2,56,18,203,205,2,5187,5214,27,59,59,0,0,100,NoArch
cf7e86f8f2b8881cef3dca68785f786f8c21ca46,1,2,11,9,13,0,0,0,23,0,1,1,0,1539,2,57,19,201,203,2,5160,5187,27,59,59,0,0,100,NoArch
1f4ae8eb982a34d2c8d90ddb843d754db20b531d,3,10,17,7,27,1,0,1,24,0,1,3,1.380094336,3272,2,58,20,283,285,2,11339,11346,7,122,123,1,0,100,NoArch
a5526d7078ad53122d920c47dc1a1b9e8e5c3619,4,23,29,6,52,0,0,0,11,33,1,4,1.352030102,3941,2,59,21,392,392,0,10698,10712,14,265,265,0,1,100,NoArch
b12b6c0c8748dbca39f9470c8b86f65fb0a6c6a0,2,31,0,31,31,2,0,2,30,0,1,1,0.99323382,2471,2,60,22,356,353,3,9258,9130,128,108,106,2,1,99.87277354,NoArch
d13fd3bdf36c516addd65d619d46dd7af64b0a83,0,0,0,0,0,0,0,0,0,0,0,0,0,0,0,130,48,0,0,0,0,0,0,0,0,0,0,100,NoArch
764ab7a732a72c0585966fcbb62c2b30466738c9,7,139,17,122,156,1,0,1,43,4,1,5,1.708445582,2234,2,131,42,284,277,7,10934,10589,345,108,103,5,0,97.96437659,Arch
5fa9102b4ac439c84385f2018b4176b0193b789d,2,85,2,83,87,1,0,1,31,2,1,1,0.978449329,2502,2,61,16,367,356,11,9577,9258,319,112,108,4,0,100,NoArch
3eb4e92469fd21863b1af1b87caf882349a8abb0,9,288,34,254,322,5,0,5,44,0,1,5,2.516572355,2394,1,132,43,311,292,19,11875,10901,974,130,121,9,0,97.37827715,Arch
cbd28af10e92e673517813626e64b6481b077961,1,20,14,6,34,0,0,0,14,7,1,1,0,176,1,133,44,14,13,1,877,845,32,9,8,1,0,100,NoArch
4fde6d5f44e7587eea10554f8bdf71aa284e6fb1,2,39,11,28,50,1,0,1,32,1,1,2,0.141440543,1472,2,62,17,230,228,2,6231,6141,90,71,71,0,0,100,NoArch
4e5fee40f36e16b602bd901e42711bb2f5ccc716,8,73,38,35,111,2,0,2,45,2,1,4,2.411672132,2340,1,134,43,268,262,6,10991,10653,338,97,92,5,0,97.3006135,Arch
ae4cdc39a5e44a0c34067cefd9a5aea167db3684,0,0,0,0,0,0,0,0,0,0,0,0,0,0,0,135,44,0,0,0,0,0,0,0,0,0,0,100,NoArch
d964b37e5f6ab3e3d56259b64bd96221b79d495d,1,5,0,5,5,1,0,1,5,9,1,1,0,86,1,136,45,6,5,1,186,160,26,6,5,1,0,100,NoArch
a03930c1046a323bc1ade98605c24c7032ae67b2,21,607,204,403,811,4,0,4,46,1,1,11,3.493144536,6353,1,137,38,940,871,69,28181,25920,2261,343,301,42,0,95.53679131,Arch
beb55e185d0706c8fb66a838bb0dfad7500f95ce,0,0,0,0,0,0,0,0,0,0,0,0,0,0,0,138,37,0,0,0,0,0,0,0,0,0,0,100,NoArch
573d6796c8ccfd4181bc7fe0c5ec67701448d0c6,18,191,122,69,313,1,0,1,47,0,1,12,3.570745743,4731,1,139,36,592,574,18,19553,18968,585,235,219,16,0,96.37002342,Arch
7cdfaa32723c10eaa5952a8d301f07bb0a14b548,45,2672,223,2449,2895,13,0,13,48,13,1,16,4.459156113,7228,1,140,1,1193,863,330,37237,27318,9919,541,373,168,0,92.68817204,Arch
85b3019b8664b754651aafa1a984058f52ee7d8b,11,453,5,448,458,7,0,7,18,18,1,7,2.567446415,1065,1,141,1,141,106,35,4539,3274,1265,67,44,23,0,99.00398406,NoArch
d6f982d71c45bf93e360a7c86cb40990eb030fbf,0,0,0,0,0,0,0,0,0,0,0,0,0,0,0,142,2,0,0,0,0,0,0,0,0,0,0,100,NoArch
bcaff35259c34e1a649843686d4e616d7cb973c0,1,84,0,84,84,1,0,1,1,0,1,1,0,0,1,143,3,1,0,1,175,0,175,1,0,1,0,99.80276134,NoArch
bd636278c86b76d937a317239a0cb3c6e5339b1e,0,0,0,0,0,0,0,0,0,0,0,0,0,0,0,144,4,0,0,0,0,0,0,0,0,0,0,100,NoArch
f597fbbe455f099f497f9c62e1b64c6176b79e23,0,0,0,0,0,0,0,0,0,0,0,0,0,0,0,145,5,0,0,0,0,0,0,0,0,0,0,100,NoArch
f56ae1712b769047d1110e6bb3e81dae91235965,0,0,0,0,0,0,0,0,0,0,0,0,0,0,0,146,6,0,0,0,0,0,0,0,0,0,0,100,NoArch
8d670edb7eefe43068ec18f3a503465c199de854,6,100,8,92,108,3,0,3,49,55,1,4,1.851509224,2746,1,147,7,401,391,10,13221,12965,256,131,125,6,0,98.82468168,NoArch
d1f70c83368b5c2f4ad945988ce42bf412c13c99,1,2,1,1,3,0,0,0,35,0,1,1,0,1056,2,148,8,168,168,0,4430,4430,0,53,53,0,0,100,NoArch
5fca5512e13537a31c94b66c42f63862107706c5,1,3,1,2,4,0,0,0,3,0,1,1,0,17,1,149,9,3,2,1,95,85,10,2,2,0,0,100,NoArch
2e1443876bf6645ba1d54fe5b256b0c9e82b1287,3,39,32,7,71,0,0,0,36,31,1,3,0.849856659,1187,2,150,10,174,172,2,4594,4510,84,59,57,2,0,100,NoArch
1d55ffb66c16705d520e8f130c08c8d6e58ebd80,0,0,0,0,0,0,0,0,0,0,0,0,0,0,0,151,11,0,0,0,0,0,0,0,0,0,0,100,NoArch
24a7559a97b7565f860dee5e52680e90d4fee7ae,34,36,34,2,70,2,0,2,16,37,1,10,5.049145296,7279,2,152,12,546,546,0,23832,23825,7,438,438,0,0,97.66081871,Arch
bb5f006adf75b0998ca507d50d83bb581b84ea60,0,0,0,0,0,0,0,0,0,0,0,0,0,0,0,153,13,0,0,0,0,0,0,0,0,0,0,100,NoArch
5cff992a4671706180bf2ad0bb9f696bdec7a7e7,0,0,0,0,0,0,0,0,0,0,0,0,0,0,0,154,14,0,0,0,0,0,0,0,0,0,0,100,NoArch
c525bfb600998c4e07805b4647a358153ff94174,2,9,0,9,9,2,0,2,50,8,1,2,0.99107606,1624,1,155,15,221,218,3,8399,8345,54,70,69,1,0,100,NoArch
6b9f84a87e37ec0a6d73f79d8ad1ec128ff4ed38,0,0,0,0,0,0,0,0,0,0,0,0,0,0,0,156,16,0,0,0,0,0,0,0,0,0,0,100,NoArch
c210f1b05392425fce4490d679a7d39d7e65428f,0,0,0,0,0,0,0,0,0,0,0,0,0,0,0,157,17,0,0,0,0,0,0,0,0,0,0,100,NoArch
f9ef0e15712dceb2a1e1667bac5766d93abad5ed,1,15,1,14,16,0,0,0,15,15,1,1,0,890,1,158,18,145,143,2,3703,3676,27,70,68,2,0,100,NoArch
c19b715babd13b7d78bc8acfce63dc9bf4be5a9c,3,381,0,381,381,3,0,3,1,0,1,2,1.465616919,0,1,159,19,41,0,41,1180,0,1180,35,0,35,0,95.07874016,Arch
6ffeb5b3727c94e7ce6338be1a38b06344db9843,5,45,49,4,94,3,0,3,3,26,1,3,1.254703437,552,1,160,20,60,52,8,1670,1481,189,49,45,4,0,100,NoArch
08b7c19ae069e9207871c8c79d00ba74e083ec76,2,61,0,61,61,2,0,2,1,0,1,1,0.966985296,0,1,161,21,7,0,7,214,0,214,7,0,7,0,99.50544016,NoArch
7ba68a0c79ceff8a7351685c3894794be12e6c58,1,10,0,10,10,1,0,1,7,5,1,1,0,1507,2,162,22,61,60,1,5105,5068,37,55,54,1,0,100,NoArch
cd0e16c366a3f92d3f9d5f961cdbd6aacbe458b0,1,1,1,0,2,0,0,0,3,1,1,1,0,107,1,163,23,9,9,0,272,285,13,5,5,0,1,100,NoArch
5b53ce0baf40bdc47363120fbd400abd55d12808,5,76,45,31,121,1,0,1,16,12,1,4,1.836607534,1266,1,164,24,166,167,1,4884,4974,90,81,82,1,0,99.60707269,NoArch
ec7ffa7f48bd13674078c476f74e84b38834199d,1,70,43,27,113,0,0,0,2,0,1,1,0,59,1,165,25,7,0,7,230,19,211,4,0,4,0,99.70530452,NoArch
cd86ac0d2a799bd6f6ba88d674afb8bbe6d89fcc,0,0,0,0,0,0,0,0,0,0,0,0,0,0,0,166,26,0,0,0,0,0,0,0,0,0,0,100,NoArch
589a80953496f6c0a985687b509ad9c45094fd5b,1,19,3,16,22,0,0,0,3,0,1,1,0,86,1,167,27,7,7,0,230,230,0,4,4,0,0,100,NoArch
4fc7930512d91776bf4b98b314d48d05acd8daca,0,0,0,0,0,0,0,0,0,0,0,0,0,0,0,168,28,0,0,0,0,0,0,0,0,0,0,100,NoArch
7d189d19c62554f5ab9ab75b3c365a6fb594743b,6,230,68,162,298,2,0,2,37,22,1,5,1.960758446,1579,1,169,29,216,206,10,7052,6770,282,79,69,10,0,99.31439765,NoArch
d5166cb9237df134d018db74429c505e62de596d,10,287,190,97,477,1,1,2,38,16,1,6,2.72448858,2835,1,170,30,404,390,14,12277,11744,533,135,124,11,0,97.19535783,Arch
7527e15eacc8cb59884ae3c9273dcc0682f6126e,7,358,149,209,507,4,0,4,51,17,1,3,1.821109772,2481,1,171,31,362,319,43,12924,11888,1036,162,127,35,0,99.52061361,NoArch
f5e523e800ca154a9609d96d10265cb2fa73e89a,5,95,11,84,106,3,0,3,39,28,1,4,1.370219612,2860,1,172,32,397,393,4,10597,10310,287,134,131,3,0,99.4269341,NoArch
b8393d4b46f4311ba83430c142ed103e5bd6219e,7,222,34,188,256,5,0,5,8,10,1,5,2.20896342,1892,1,173,33,105,95,10,6534,6139,395,87,83,4,0,95.80223881,Arch
c333d4d9947816433ede10bee2719bde7b136329,2,25,1,24,26,1,0,1,6,10,1,1,0.619382195,312,1,174,34,43,36,7,1028,876,152,29,26,3,0,100,NoArch
00f64cb5bdc0d06c8a6bf36084e5e89e3711ecd3,5,206,39,167,245,3,0,3,52,0,1,4,1.221620246,1910,1,175,35,264,247,17,9848,9325,523,93,85,8,0,99.81751825,NoArch
2740d735a29eeaa09fa0f34c89d1822756fb5c5f,1,6,6,0,12,0,0,0,1,0,1,1,0,128,1,176,36,9,9,0,368,368,0,6,6,0,0,99.63570128,NoArch
110cce3295b75815370f29216257e6eafd99c702,2,12,2,10,14,1,0,1,53,74,1,2,0.985228136,1597,1,177,37,229,227,2,8473,8443,30,69,69,0,0,100,NoArch
50e248449f9a86d1b206e58b18ed3596bdd86b03,0,0,0,0,0,0,0,0,0,0,0,0,0,0,0,178,38,0,0,0,0,0,0,0,0,0,0,100,NoArch
3ed2958db35093ac3942baae852ce0d153e529f6,1,4,0,4,4,1,0,1,54,0,1,1,0,1592,2,179,39,229,228,1,8473,8447,26,68,68,0,0,100,NoArch
7e2eea1ab03eea82d1053c133ae63e6958337ff6,0,0,0,0,0,0,0,0,0,0,0,0,0,0,0,180,40,0,0,0,0,0,0,0,0,0,0,100,NoArch
003b6f98b051f6b7584877faba67f8f9a3fcfe2e,3,186,7,179,193,1,0,1,7,0,1,3,0.678215447,352,1,181,41,54,41,13,1703,1162,541,34,25,9,0,99.63800905,NoArch
2c9079ed221f427ffe798f261a9f42ea40b6d8f8,9,410,51,359,461,4,0,4,19,3,1,6,2.775077413,1375,1,182,42,196,173,23,6542,5420,1122,106,84,22,0,95.04950495,Arch
3ba1012170a4faa0b4ba9ef61cee1525fcbfd61c,3,13,4,9,17,0,0,0,55,4,1,3,1.022420704,2720,2,183,43,415,413,2,13689,13664,25,116,116,0,0,100,NoArch
68643220d3b5479efcd286d6374f3b62e43cf4cf,2,34,1,33,35,1,0,1,56,4,1,2,0.970950594,1774,2,184,44,249,245,4,9195,9057,138,81,79,2,0,100,NoArch
3f4098860c33d380ee56c3613a18670d62da34ad,6,87,12,75,99,2,0,2,40,16,1,5,1.770260795,1894,1,185,45,262,255,7,7964,7807,157,103,101,2,0,99.82046679,NoArch
8da7197ed36f29264839523aa8f74093b8bd3aa8,3,68,2,66,70,2,0,2,12,57,1,3,1.503343568,3185,2,186,46,314,307,7,8666,8507,159,182,180,2,0,100,NoArch
2136db5373f2abba90ccc24165f082490dc96fec,0,0,0,0,0,0,0,0,0,0,0,0,0,0,0,187,47,0,0,0,0,0,0,0,0,0,0,100,NoArch
d19012604c4d3c10b9e0472f6602b12512b735f5,5,67,21,46,88,4,0,4,57,19,1,4,1.84844153,5636,1,188,48,682,674,8,21725,21526,199,248,245,3,0,100,NoArch
353ef84ee8e2cb01fd24e4414721d2b59387c4ac,16,65,1364,1299,1429,4,0,4,58,25,1,6,3.128888783,3784,1,189,49,343,444,101,11853,16840,4987,157,225,68,0,95.22091975,Arch
d257099d278c6034278e7a8ebdebef9b70a1d780,21,88,34,54,122,4,0,4,59,28,1,12,3.65321423,7355,1,190,50,1054,1034,20,31889,31631,258,393,383,10,0,97.36098021,Arch
f7ec04e558df28e02d3382e4b0f234f65aa8dc76,1,2,0,2,2,1,0,1,7,5,1,1,0,180,1,191,51,15,15,0,585,585,0,12,12,0,0,100,NoArch
69bd2d501ac6b7cb536e28957369fb5f94a8880d,0,0,0,0,0,0,0,0,0,0,0,0,0,0,0,192,52,0,0,0,0,0,0,0,0,0,0,100,NoArch
7a28ec948738f8bb9cee5b3d3cb653fae51e2e6d,0,0,0,0,0,0,0,0,0,0,0,0,0,0,0,193,53,0,0,0,0,0,0,0,0,0,0,100,NoArch
0b0c8c5c4f01e0fa1e424471dcf126c39f62d30a,0,0,0,0,0,0,0,0,0,0,0,0,0,0,0,194,54,0,0,0,0,0,0,0,0,0,0,100,NoArch
89ea63ba5a60d69b1527dd57eec570113b6d5618,0,0,0,0,0,0,0,0,0,0,0,0,0,0,0,195,54,0,0,0,0,0,0,0,0,0,0,100,NoArch
0b6a27495d842f2b30fb14834383d5996405463e,0,0,0,0,0,0,0,0,0,0,0,0,0,0,0,196,55,0,0,0,0,0,0,0,0,0,0,100,NoArch
8f68d7ee27131b6b10924f2643b0fe3e782c7a6d,2,115,0,115,115,2,0,2,1,0,1,1,0.89665545,0,1,197,54,15,0,15,440,0,440,11,0,11,0,99.51314508,NoArch
76503c73ddb8d7d4c7c2dd50aea4aa96d61cc40b,1,33,15,18,48,0,0,0,29,20,1,1,0,1590,2,63,0,207,205,2,5392,5356,36,61,61,0,1,100,NoArch
449241d5fa1aeadd5eb9fa1280d4104dc0dfb891,2,8,6,2,14,1,0,1,43,9,1,1,0.591672779,2671,2,64,1,379,377,2,9962,9944,18,114,114,0,1,100,NoArch
16ef4a2c7fa6d00e211511a869df7a407cfc682e,0,0,0,0,0,0,0,0,0,0,0,0,0,0,0,198,51,0,0,0,0,0,0,0,0,0,0,100,NoArch
9aea94143332fab22a01f01b6ee1f3580b4055dc,2,68,6,62,74,1,0,1,60,19,1,2,0.639457132,1724,1,199,52,249,242,7,9100,8773,327,76,73,3,0,100,NoArch
5608638949e4407758ebb457c352f361ea70d5d0,4,106,4,102,110,0,0,0,44,31,1,3,1.15001036,2901,2,65,2,399,389,10,11198,10734,464,125,123,2,1,99.80713597,NoArch
3c420e1f7aa364af175279b7ccb7d4677abf66ee,2,6,5,1,11,0,0,0,61,9,1,2,0.684038436,1803,2,200,53,250,250,0,9182,9198,16,77,77,0,0,100,NoArch
6128d56631731f853be23c5b12c973c66ded4152,1,12,1,11,13,0,0,0,62,0,1,1,0,1701,2,201,54,244,243,1,9021,8950,71,73,73,0,0,100,NoArch
e03f681c24109f23b69f4dcf9223f1aaeae9ce75,3,33,5,28,38,0,0,0,45,0,1,3,1.371243785,1321,2,202,52,191,185,6,5599,5464,135,65,63,2,0,97.44318182,Arch
e5326a51552b5b1b50cfb3b006919f81e607ec31,0,0,0,0,0,0,0,0,0,0,0,0,0,0,0,203,53,0,0,0,0,0,0,0,0,0,0,100,NoArch
f083156c9555d2d137d98556ce66cc1395566e03,4,33,18,15,51,0,0,0,46,25,1,3,1.695552313,1472,2,204,53,207,204,3,6051,5925,126,76,76,0,0,100,NoArch
c8117d090a970289aa9e4a995ed820e879e47cf0,2,13,4,9,17,1,0,1,47,22,1,2,0.997502546,1194,2,205,54,185,183,2,4909,4877,32,60,58,2,0,100,NoArch
204791e14882277a31f317f73fe3732ff94dbcaa,2,9,6,3,15,0,0,0,48,1,1,1,0.721928095,2783,2,66,3,391,391,0,10462,10453,9,116,116,0,0,100,NoArch
1f352c82fae5c2dc5187f85c6c4cc295f4c74404,0,0,0,0,0,0,0,0,0,0,0,0,0,0,0,206,51,0,0,0,0,0,0,0,0,0,0,100,NoArch
822a5936b20c3ad6c92e044932fa0b3dbb55d6b8,2,14,2,12,16,0,0,0,63,19,1,2,0.69621226,2593,1,207,52,390,387,3,12701,12660,41,142,141,1,0,100,NoArch
c0d7b88427a76246ac539cde0f1afddef503d97e,20,937,216,721,1153,9,0,9,64,40,1,9,3.552197147,5509,1,208,25,811,749,62,26127,24238,1889,295,258,37,0,96.36363636,Arch
28fb372c53619544589c483e97f3f0c07c95d7e0,0,0,0,0,0,0,0,0,0,0,0,0,0,0,0,209,26,0,0,0,0,0,0,0,0,0,0,100,NoArch
5e0ab8b9e44d03231b23500b0428ccb668d6f621,1,4,0,4,4,1,0,1,3,1,1,1,0,236,1,210,27,37,35,2,877,852,25,17,16,1,0,100,NoArch
3d4ff33edf59f75bf2e35f9678bd958e610bdd6a,6,75,19,56,94,1,0,1,65,2,1,5,2.310216409,3595,1,211,27,514,510,4,17054,16694,360,195,193,2,0,99.59677419,NoArch
0714803502cbe0fea29f94bb614baa02d9910a96,0,0,0,0,0,0,0,0,0,0,0,0,0,0,0,212,28,0,0,0,0,0,0,0,0,0,0,100,NoArch
ff67da0c83b96a94bbfb95cb4655a13d416b7e83,0,0,0,0,0,0,0,0,0,0,0,0,0,0,0,213,29,0,0,0,0,0,0,0,0,0,0,100,NoArch
e52182853d6eba9eb662038359c3ede678197db5,0,0,0,0,0,0,0,0,0,0,0,0,0,0,0,214,30,0,0,0,0,0,0,0,0,0,0,100,NoArch
0de685ca192e9e842b28ec565711103a6a16c5ec,1,8,4,4,12,0,0,0,7,37,1,1,0,397,2,215,31,49,48,1,1114,1101,13,27,27,0,0,100,NoArch
7d9459adc275bd417586376fe3f9e566c8d60e00,1,2,2,0,4,0,0,0,8,0,1,1,0,401,2,216,32,49,49,0,1114,1114,0,27,27,0,0,100,NoArch
924a837392d2418921e892c2c1bf856f6622168a,6,94,5,89,99,3,0,3,66,48,1,4,1.485886475,2645,1,217,33,370,366,4,13081,13036,45,150,149,1,1,99.8389694,NoArch
a1cf98a395e3defdce74ad3b59ab08451ff1abc2,1,9,2,7,11,0,0,0,14,5,1,1,0,928,2,218,34,163,160,3,4381,4349,32,31,31,0,0,100,NoArch
bbe3958737ba6ee6a4ddc8c38743981f55313dbb,2,10,1,9,11,1,0,1,67,2,1,2,0.994030211,2136,1,219,35,306,305,1,10963,10897,66,119,118,1,1,100,NoArch
f1b35cf6f0b1c2fa77d37421409b87395000170e,1,1,1,0,2,0,0,0,20,0,1,1,0,185,1,220,36,14,14,0,906,906,0,9,9,0,0,100,NoArch
8becf4135629763ad2a0848c19f3a28a931efaa0,2,29,3,26,32,1,0,1,19,18,1,2,0.448864489,1069,1,221,31,163,159,4,4343,4242,101,83,80,3,0,100,NoArch
b610a251c9cb222c03ab901e5fd5460fc0786cd8,3,126,0,126,126,3,0,3,23,1,1,2,0.70536392,1300,1,222,32,214,205,9,5677,5262,415,88,85,3,0,99.83948636,NoArch
6a42b66fd29b4cc86f1c27f6662b59d7ae6fae77,1,2,0,2,2,1,0,1,2,72,1,1,0,521,1,223,33,66,66,0,2797,2781,16,12,12,0,0,100,NoArch
023aa2533a70affe651db101569787db25a451ad,3,4,4,0,8,0,0,0,68,3,1,3,1.5,2064,1,224,33,295,295,0,10347,10349,2,105,105,0,0,100,NoArch
a3df5aea751325b89a4da1e0b4e4c0dcc8f7382c,1,3,3,0,6,0,0,0,15,6,1,1,0,935,2,225,34,163,163,0,4381,4381,0,31,31,0,0,100,NoArch
37d2909898fc3a41758568d11597b62f71007b98,1,5,0,5,5,1,0,1,9,4,1,1,0,205,1,226,35,19,19,0,711,686,25,15,15,0,0,100,NoArch
0da929c9aa440ce863d1517f306f2d0a3ccffc44,3,127,0,127,127,3,0,3,69,14,1,3,0.183012699,1898,2,227,36,270,263,7,9967,9602,365,86,81,5,0,99.84,NoArch
e3444c678ba65ffb260ab05a9a3d694f8b928739,0,0,0,0,0,0,0,0,0,0,0,0,0,0,0,67,4,0,0,0,0,0,0,0,0,0,0,100,NoArch
6c9fb3555b04ff9a22283cab5151b8e558089d4c,0,0,0,0,0,0,0,0,0,0,0,0,0,0,0,68,5,0,0,0,0,0,0,0,0,0,0,100,NoArch
ab8d13b1c898516ee8f96c4f69bd1b5b700c2fe0,0,0,0,0,0,0,0,0,0,0,0,0,0,0,0,69,6,0,0,0,0,0,0,0,0,0,0,100,NoArch
4323c4ba67cf49d955a002a63f9395abe5fc4fc2,16,1150,190,960,1340,8,0,8,19,27,1,9,3.258456313,2851,1,228,33,497,396,101,16050,12772,3278,200,143,57,0,96.13486842,Arch
6bde6ac226bc95f2fc702b0ffe75fcf6e64a0761,0,0,0,0,0,0,0,0,0,0,0,0,0,0,0,70,7,0,0,0,0,0,0,0,0,0,0,100,NoArch
381e8e3488b0836c53348c3a0885136ceb14ce88,0,0,0,0,0,0,0,0,0,0,0,0,0,0,0,71,8,0,0,0,0,0,0,0,0,0,0,100,NoArch
08ffd0e6298219ae3e48ff46fad1ef3a65175aca,0,0,0,0,0,0,0,0,0,0,0,0,0,0,0,72,9,0,0,0,0,0,0,0,0,0,0,100,NoArch
5bf57d28f7eef2ae287a98f84d2e5681ee07cfb1,2,1,5,4,6,0,0,0,4,1,1,2,0.918295834,667,1,229,34,77,77,0,3248,3296,48,17,17,0,0,100,NoArch
d527b05dec9ee5fa943ed715a577fb0a511d2ebe,0,0,0,0,0,0,0,0,0,0,0,0,0,0,0,230,35,0,0,0,0,0,0,0,0,0,0,100,NoArch
22a8586051d2839b6513a3663427ea6b9f3a4767,1,6,3,3,9,0,0,0,33,28,1,1,0,1684,2,73,10,215,214,1,5754,5743,11,62,62,0,1,100,NoArch
99bb69f450b7d904942a7d643820f040b52b86df,1,6,0,6,6,1,0,1,10,10,1,1,0,210,2,0,0,19,19,0,718,711,7,15,15,0,0,100,NoArch
27ea8e1eb5cacff552d076b6e754338c5616fa95,3,144,8,136,152,1,0,1,70,14,1,3,0.347705617,1902,3,1,1,278,268,10,10241,9624,617,86,84,2,0,99.83079526,NoArch
fb05612dbacbb9f73693dbe026c075876bdaf849,2,0,4,4,4,0,0,0,71,0,1,2,1,1894,3,2,2,268,268,0,9526,9570,44,84,84,0,0,100,NoArch
46dff37d3f9687c0bdd33ebed423f4f96e4fc8b3,1,4,1,3,5,0,0,0,72,0,1,1,0,1773,3,3,3,255,255,0,9235,9217,18,74,74,0,0,100,NoArch
114e9ea6a14f42c74da9957c1d1fb6260534d2a9,2,27,16,11,43,0,0,0,12,58,1,2,0.968164732,1945,3,4,4,249,248,1,5548,5631,83,121,120,1,0,100,NoArch
99acb82ba3065a7eb5cf8c8a7a0ea4220b56c2a1,11,168,17,151,185,4,0,4,73,14,1,7,2.849158602,5604,3,5,5,782,767,15,24626,24119,507,296,287,9,0,96.07843137,Arch
98076bc1e9fd328febf6e3a0d3f516963b501865,2,5,1,4,6,1,0,1,7,73,1,1,0.650022422,203,3,6,6,20,19,1,519,488,31,15,15,0,0,100,NoArch
bae92548df537bf7cfa7a63711e0998e41090a0b,1,65,0,65,65,1,0,1,13,2,1,1,0,929,3,7,7,138,130,8,3278,3003,275,10,10,0,0,100,NoArch
64c78e0d8d7146dd22ff06e80bbbdcd38f92111b,5,122,20,102,142,1,0,1,74,2,1,4,1.721659044,3184,1,8,8,493,482,11,15923,15577,346,158,152,6,0,99.85380117,NoArch
a984abaa14efd14e7332d89e7ab27ec9c1c7fddc,0,0,0,0,0,0,0,0,0,0,0,0,0,0,0,231,29,0,0,0,0,0,0,0,0,0,0,100,NoArch
01ce3536ecacac313c2792bd43013aa3852034ad,0,0,0,0,0,0,0,0,0,0,0,0,0,0,0,232,30,0,0,0,0,0,0,0,0,0,0,100,NoArch
0ab6465a7dece117c61c3efd3ec95d20524bdad6,1,21,0,21,21,1,0,1,21,20,1,1,0,898,1,233,31,148,146,2,3795,3713,82,71,70,1,0,100,NoArch
d5ef2ff394f80d17fe2f533127658189b5171c12,0,0,0,0,0,0,0,0,0,0,0,0,0,0,0,234,30,0,0,0,0,0,0,0,0,0,0,100,NoArch
bd5b32b844ccf140eb774a16473bd0d56327ecb7,0,0,0,0,0,0,0,0,0,0,0,0,0,0,0,235,31,0,0,0,0,0,0,0,0,0,0,100,NoArch
0e973c2879bc8f82a8b8b3cc9937ef5c8d9e1263,0,0,0,0,0,0,0,0,0,0,0,0,0,0,0,236,32,0,0,0,0,0,0,0,0,0,0,100,NoArch
e93cb99f78d8c1e1dc017b61008ef00acd6d8cb9,0,0,0,0,0,0,0,0,0,0,0,0,0,0,0,237,33,0,0,0,0,0,0,0,0,0,0,100,NoArch
986de73e9f342b5d1ff0366ea9d46593328e6c36,2,60,3,57,63,0,0,0,5,62,1,1,0.99107606,282,1,238,33,57,44,13,1175,855,320,28,23,5,0,99.9270073,NoArch
6bfe0b6f394c8f7bdcf6e8dc6c69a13e464431b2,1,157,0,157,157,1,0,1,22,6,1,1,0,919,2,0,0,186,148,38,4761,3795,966,80,71,9,0,100,NoArch
2d670997287093043c7bb38c1857abc0651ca8d1,1,33,27,6,60,0,0,0,23,0,1,1,0,1076,2,1,1,186,186,0,4754,4761,7,80,80,0,0,100,NoArch
b28e36d3c4c7766e857972c04e5449e3a4e74c3b,1,4,0,4,4,1,0,1,3,22,1,1,0,120,1,239,31,8,7,1,329,319,10,6,5,1,0,100,NoArch
18698831cbb263a1766ae047a5e0b96879925f25,10,192,38,154,230,4,0,4,75,56,1,8,2.376869639,7930,2,9,9,1004,983,21,30791,30186,605,339,334,5,0,100,NoArch
c89bcb9be9e3cd7a1340fd31e21c916d2a2c4b65,1,14,2,12,16,0,0,0,17,43,1,1,0,369,1,240,16,52,51,1,1802,1698,104,46,45,1,0,100,NoArch
8725e3e7ddc59020d26741095c32e6a67ebcf49c,2,101,9,92,110,0,0,0,52,6,1,1,0.999761525,2795,3,241,17,411,398,13,10821,10520,301,117,116,1,0,100,NoArch
a198fb8e8a5da8c88ce60eccbe332137023354f9,0,0,0,0,0,0,0,0,0,0,0,0,0,0,0,242,18,0,0,0,0,0,0,0,0,0,0,100,NoArch
7e8549c24f3c68d57b2b24a58d3713088ed3624d,2,3,3,0,6,0,0,0,76,15,1,2,0.650022422,1953,3,10,10,271,271,0,9976,9955,21,83,83,0,0,100,NoArch
8f3eb2563fb335d3f73443c336a26e64e72026f3,1,24,0,24,24,1,0,1,15,7,1,1,0,1343,3,11,11,69,68,1,3146,3094,52,65,64,1,0,100,NoArch
1ce0b04eff4025879efeb2ec6338d7cf51def3b5,3,41,2,39,43,2,0,2,53,2,1,2,1.421133835,3352,3,12,12,485,479,6,12864,12696,168,137,135,2,1,100,NoArch
5ec6b5e86b7cbc71dc2341217c153ed60698df56,2,12,9,3,21,1,0,1,23,88,1,2,0.791858353,332,2,13,13,48,47,1,1308,1279,29,37,36,1,0,100,NoArch
891443950f9204379a5b265a373fd18584a6a921,1,3,4,1,7,0,0,0,15,7,1,1,0,1032,3,14,14,141,141,0,3399,3409,10,10,10,0,0,100,NoArch
7b8480744ea6e6fb41efd4329bb470c8f3c763db,6,316,0,316,316,6,0,6,3,19,1,1,2.191309691,176,1,243,19,30,12,18,701,279,422,28,10,18,0,99.27536232,NoArch
e5532b3cda0bf96bbc1d3bfd3ad4de931186be86,6,142,156,14,298,3,0,3,77,12,1,3,2.160187426,5178,3,244,20,726,735,9,22508,22591,83,239,252,13,0,95.41484716,Arch
953ccd9e31ee069d0c5d3b7a33aef0a81b41830a,1,45,2,43,47,0,0,0,55,0,1,1,0,1154,3,245,21,196,188,8,5225,5005,220,61,57,4,0,99.41477688,NoArch
e36e6a37b53beb96814b9df5bd45214e1c090916,4,95,43,52,138,0,0,0,78,10,1,3,1.066130477,4905,1,246,22,705,699,6,21419,21076,343,213,211,2,0,100,NoArch
9374a7fbef47d51b2c41377f544bc9bfcee983c4,6,146,35,111,181,4,0,4,79,19,1,5,1.867624434,3465,1,247,23,517,505,12,16845,16135,710,212,204,8,0,99.92732558,NoArch
565b468d6cf9ad3209b50e86fa888ae9ecb98433,0,0,0,0,0,0,0,0,0,0,0,0,0,0,0,248,24,0,0,0,0,0,0,0,0,0,0,100,NoArch
2636a236a64ba9e33994d505f2445061a85bb576,2,31,9,22,40,1,0,1,80,0,1,2,0.468995594,3719,3,249,25,502,499,3,16399,16283,116,146,145,1,0,100,NoArch
97a05fa1e40ba174a20a2270f8ac9f861dd70ad8,4,14,10,4,24,0,0,0,81,0,1,3,1.614005463,3416,1,250,26,508,507,1,16673,16648,25,204,203,1,0,100,NoArch
554f4f662a9966d665ccec126c566e67d6feaacc,1,29,41,12,70,0,0,0,16,2,1,1,0,1031,3,15,15,141,141,0,3369,3399,30,10,10,0,0,100,NoArch
0d8af45846026421f75611b9aabf532d8750a665,0,0,0,0,0,0,0,0,0,0,0,0,0,0,0,74,7,0,0,0,0,0,0,0,0,0,0,100,NoArch
55929dd1a13c17998b90b6c9734016e2451e921c,0,0,0,0,0,0,0,0,0,0,0,0,0,0,0,16,16,0,0,0,0,0,0,0,0,0,0,100,NoArch
7643187030a99be3f099607bd8be1f2ba44cd561,0,0,0,0,0,0,0,0,0,0,0,0,0,0,0,75,8,0,0,0,0,0,0,0,0,0,0,100,NoArch
94ddb3d742e7db63831c3c0b8c17c2fe507566fe,2,39,18,21,57,1,0,1,82,0,1,2,0.366578013,2195,2,251,27,317,312,5,11517,11401,116,116,114,2,0,100,NoArch
0f6a3ccbff6b8d78323a5a31069b3c47e21e3e11,0,0,0,0,0,0,0,0,0,0,0,0,0,0,0,252,23,0,0,0,0,0,0,0,0,0,0,100,NoArch
5d0abaebf0bd4b5d98f9ef173f23b3be5e6fb37f,7,250,346,96,596,2,0,2,83,70,1,4,0.392806764,3833,2,253,24,530,524,6,18196,18063,133,165,164,1,0,99.70866715,NoArch
1778619d68952a221bd26ea862f8f068c228bf27,0,0,0,0,0,0,0,0,0,0,0,0,0,0,0,254,25,0,0,0,0,0,0,0,0,0,0,100,NoArch
879a38f37f8ed32b5e7ac61ff0cd383c2ead32c5,6,572,237,335,809,3,0,3,84,40,1,3,1.24587307,2175,1,255,24,321,294,27,12121,11111,1010,107,93,14,0,97.75449102,Arch
18863657de21dd073451a2664314e81ca4fd2bef,7,361,94,267,455,2,0,2,85,53,1,4,1.694956619,2459,1,256,25,361,317,44,12831,11689,1142,124,108,16,0,99.69348659,NoArch
ba0a78a07d703e2835ed92ec63f7b286ea37d861,0,0,0,0,0,0,0,0,0,0,0,0,0,0,0,257,26,0,0,0,0,0,0,0,0,0,0,100,NoArch
d325674b3bed00f6054d79da1ff2a630b8f052e1,2,64,62,2,126,0,0,0,86,2,1,2,0.117594666,2172,1,258,27,310,308,2,11569,11533,36,85,85,0,0,100,NoArch
83e891772fc955bab69f1b2a417911f5f9f34813,0,0,0,0,0,0,0,0,0,0,0,0,0,0,0,259,28,0,0,0,0,0,0,0,0,0,1,100,NoArch
00775b5033149348536f880d9d9fd9df5febf5cd,2,41,37,4,78,0,0,0,87,0,1,2,0.172036949,2174,1,260,29,310,310,0,11608,11569,39,85,85,0,0,100,NoArch
fba894477f251afdf61f71af08d525e42718afee,4,293,86,207,379,2,0,2,5,43,1,2,1.521971186,447,1,261,29,59,41,18,2090,1206,884,33,20,13,0,99.61656442,NoArch
7f8c9d36a9f8265944ab11209037a0e0373c44f5,1,3,3,0,6,0,0,0,3,0,1,1,0,308,1,262,30,33,33,0,1125,1129,4,17,17,0,0,100,NoArch
43a48b97ddc1341d5de901b55d27b64dc6a65f7a,0,0,0,0,0,0,0,0,0,0,0,0,0,0,0,263,31,0,0,0,0,0,0,0,0,0,0,100,NoArch
0ff050420e294f6f368818ad4166ef2eea58db75,0,0,0,0,0,0,0,0,0,0,0,0,0,0,0,264,30,0,0,0,0,0,0,0,0,0,0,100,NoArch
394286558402b596a121cc62d713b64b5e55ad37,0,0,0,0,0,0,0,0,0,0,0,0,0,0,0,265,31,0,0,0,0,0,0,0,0,0,0,100,NoArch
83c1338d2988f95184dba2a3e9c3ba661609f2c1,1,12,4,8,16,0,0,0,2,0,1,1,0,90,1,266,32,7,5,2,186,139,47,4,4,0,0,100,NoArch
81f560066d6bbf849c88089dc395b43971b122f8,1,17,0,17,17,1,0,1,3,0,1,1,0,98,1,267,33,9,7,2,284,186,98,5,4,1,0,100,NoArch
fc65e34ec85887acb689023f02613d9d53b4a176,2,58,28,30,86,0,0,0,88,6,1,2,0.407076806,3322,3,268,34,519,509,10,16979,16845,134,146,145,1,0,100,NoArch
81a49a5e795a39f73a4d6d9ef735613fe34f4865,1,81,76,5,157,0,0,0,26,18,1,1,0,1105,2,269,35,194,191,3,4958,4880,78,86,85,1,0,100,NoArch
e4d3a73efc41d709c49dbcf5de54ac40fb90b6f2,6,221,3,218,224,4,0,4,89,6,1,4,1.842411843,3711,3,270,36,579,557,22,19216,18668,548,201,181,20,0,98.77017679,NoArch
54e9fd496703ac8b2b60a8dc1975559c843f240a,4,166,84,82,250,1,0,1,90,7,1,3,0.517423177,5274,1,271,32,777,766,11,23901,23538,363,225,222,3,0,100,NoArch
83fbb62f317053fb3afa815ccda1b2e3dd1d2258,3,52,29,23,81,0,0,0,61,7,1,2,1.384170271,4416,3,272,33,517,517,0,14994,14881,113,197,195,2,0,100,NoArch
9063e6ec3341c131e1a97c4f83becc57577e4e1b,6,82,29,53,111,2,0,2,91,11,1,5,1.996369807,8702,3,273,34,1108,1100,8,33046,32884,162,410,407,3,0,100,NoArch
777b7900708442d36bbacd504494855fe1a0e79b,3,173,88,85,261,0,0,0,6,19,1,1,1.21746584,551,1,274,35,74,61,13,2564,2189,375,39,32,7,0,100,NoArch
9633bd61e90d90f41a8af6d96b32b1a680c60488,0,0,0,0,0,0,0,0,0,0,0,0,0,0,0,275,36,0,0,0,0,0,0,0,0,0,0,100,NoArch
78ec5fbad52cfefd2ed004134640f52cdcd04224,1,11,7,4,18,0,0,0,2,118,1,1,0,86,1,276,37,6,5,1,123,108,15,6,5,1,0,100,NoArch
ce4adf7aa39413614de433d0c89cfb9d90d8a517,3,31,8,23,39,1,0,1,18,84,1,3,1.369076934,1226,1,277,38,188,184,4,5742,5602,140,48,47,1,0,100,NoArch
c12e46b496d9fdc12da0a9f845d57c3803435638,0,0,0,0,0,0,0,0,0,0,0,0,0,0,0,278,39,0,0,0,0,0,0,0,0,0,0,100,NoArch
11759b312371a494dfb43ead320acd8b2638fb65,0,0,0,0,0,0,0,0,0,0,0,0,0,0,0,279,40,0,0,0,0,0,0,0,0,0,0,100,NoArch
08afd512143bb79c37253fb6fd41548e2d4e9c6f,0,0,0,0,0,0,0,0,0,0,0,0,0,0,0,280,41,0,0,0,0,0,0,0,0,0,0,100,NoArch
d360dfbc77eef810fa83374e3d8898b066e0c109,0,0,0,0,0,0,0,0,0,0,0,0,0,0,0,281,42,0,0,0,0,0,0,0,0,0,0,100,NoArch
31bf41149559b20ec59397712eebf1f3c22cc4b6,2,2,2,0,4,0,0,0,26,12,1,2,1,1446,2,282,43,243,243,0,6505,6501,4,51,51,0,0,100,NoArch
771d7cf29ae38ebd635cc431aa2a0d0c61c4c636,1,3,2,1,5,0,0,0,92,2,1,1,0,2221,3,283,44,324,324,0,11990,11990,0,89,89,0,0,100,NoArch
257b9147034ce8b088a2b7294c43f5ba169eaa74,7,156,55,101,211,1,0,1,93,76,1,5,2.397971074,7256,2,284,45,914,893,21,30942,30465,477,332,323,9,0,100,NoArch
91b2ff031b7ec5a18be5e680dccc904e17132a55,4,270,16,254,286,3,0,3,5,109,1,1,0.71312294,494,1,285,46,93,61,32,2667,1654,1013,51,29,22,0,99.84662577,NoArch
c70f046c2079dfd675294c0e2ce97591b41d48d6,3,325,0,325,325,3,0,3,2,43,1,2,1.066972824,458,1,286,47,91,65,26,2491,1865,626,33,19,14,0,99.61832061,NoArch
79f50a10e7688279664146bb3c18837dada370a4,9,138,10,128,148,3,0,3,45,95,1,6,1.692476804,7215,2,287,48,683,664,19,22584,22127,457,341,333,8,0,100,NoArch
7038de91ca407b907c8a07c0e0b94e48ae1d4cc3,8,391,163,228,554,1,0,1,64,29,1,6,2.185894167,5853,2,288,49,687,656,31,23020,22049,971,270,261,9,1,99.543379,NoArch
9144cef718563a9022234a0d0b428a68b5747520,0,0,0,0,0,0,0,0,0,0,0,0,0,0,0,289,50,0,0,0,0,0,0,0,0,0,1,100,NoArch
075c8f4d81afe9beb8a32f0874e76b99888aa3c4,0,0,0,0,0,0,0,0,0,0,0,0,0,0,0,290,51,0,0,0,0,0,0,0,0,0,0,100,NoArch
c71200f0df8e5ccf493190beb3bc42a2a001b9e1,0,0,0,0,0,0,0,0,0,0,0,0,0,0,0,291,52,0,0,0,0,0,0,0,0,0,0,100,NoArch
5f901c7c3aa3326683a9e98cde461f0ab92844fe,0,0,0,0,0,0,0,0,0,0,0,0,0,0,0,292,53,0,0,0,0,0,0,0,0,0,0,100,NoArch
b29a552a53a420fc3107b7ebfaf0e0742779def2,1,121,0,121,121,1,0,1,1,0,1,1,0,0,1,293,54,13,0,13,363,0,363,4,0,4,0,99.84802432,NoArch
e4a95579e50d91de6b3c1d5c4a2e554c896b82e3,1,1,1,0,2,0,0,0,2,0,1,1,0,121,1,294,55,13,13,0,363,363,0,4,4,0,0,100,NoArch
7162b336611343876061a8874fd901ca1dd04d03,1,1,1,0,2,0,0,0,3,0,1,1,0,121,1,295,56,13,13,0,363,363,0,4,4,0,0,100,NoArch
9b5ed326b71da771da6b919f2e57f657fba419ec,0,0,0,0,0,0,0,0,0,0,0,0,0,0,0,296,57,0,0,0,0,0,0,0,0,0,0,100,NoArch
24a4e257ab191187b875800959dd532950d5edbd,2,63,1,62,64,1,0,1,27,2,1,2,0.200622324,483,1,297,57,72,71,1,1989,1948,41,20,19,1,0,98.9449887,NoArch
0634e1fe24df2b210c90f2155bd5f662d0860156,9,88,11,77,99,5,0,5,94,16,1,7,2.602238524,4286,1,298,58,637,640,3,20616,20541,75,191,193,2,1,99.7754491,NoArch
b91da7f6d1b4aa6dd363920ec9479656a5f0910d,0,0,0,0,0,0,0,0,0,0,0,0,0,0,0,299,59,0,0,0,0,0,0,0,0,0,0,100,NoArch
363d5fd17d530a6d21d7f741b802181fbe663877,0,0,0,0,0,0,0,0,0,0,0,0,0,0,0,300,60,0,0,0,0,0,0,0,0,0,0,100,NoArch
9944aadf95b6ff24ac7eb6f8d98cd52ab5483efd,0,0,0,0,0,0,0,0,0,0,0,0,0,0,0,301,61,0,0,0,0,0,0,0,0,0,0,100,NoArch
4aabe92afe35a8f5a087b000aa1bd7b41e7329ac,0,0,0,0,0,0,0,0,0,0,0,0,0,0,0,302,62,0,0,0,0,0,0,0,0,0,1,100,NoArch
1c28aa552661e3299e43d927c441a553a97341e7,4,45,17,28,62,2,0,2,95,2,1,3,1.270906115,5514,1,303,63,817,809,8,24983,24786,197,231,229,2,0,100,NoArch
77a56120a15aba8b45ed2b3095a7ec7591762af5,1,1,1,0,2,0,0,0,2,141,1,1,0,71,1,304,64,1,1,0,104,104,0,1,1,0,0,100,NoArch
e7d1a23e85ed71782b5b883f92fa7dd472fe6919,1,1,1,0,2,0,0,0,96,0,1,1,0,2262,3,305,65,328,328,0,12090,12097,7,89,89,0,0,100,NoArch
bb9a3f4ccdfb8b01790889e97fe588acf657de63,0,0,0,0,0,0,0,0,0,0,0,0,0,0,0,306,66,0,0,0,0,0,0,0,0,0,0,100,NoArch
981b3246d40d20f1f9da78d27f18049051f17848,2,16,0,16,16,2,0,2,29,3,1,2,0.811278124,416,2,307,67,70,67,3,1886,1794,92,45,44,1,0,100,NoArch
9f0a33bc84c495a8b7d9ac3112cd1d4b368fcae6,0,0,0,0,0,0,0,0,0,0,0,0,0,0,0,308,68,0,0,0,0,0,0,0,0,0,0,100,NoArch
93ae80a6d902ed98162146ec1038893cf5ce62a4,0,0,0,0,0,0,0,0,0,0,0,0,0,0,0,309,69,0,0,0,0,0,0,0,0,0,0,100,NoArch
4a7d4ef4f3c8066a4785ca4b40322480fa441adf,0,0,0,0,0,0,0,0,0,0,0,0,0,0,0,310,70,0,0,0,0,0,0,0,0,0,0,100,NoArch
6eaee4cf06cca1723afc948448d5b3cb6bfb7bcb,1,3,3,0,6,0,0,0,5,12,1,1,0,371,1,311,71,39,39,0,1409,1376,33,22,22,0,0,100,NoArch
ff909c53cad676c41a29bfa59df32da6dfb325b8,1,349,0,349,349,1,0,1,1,0,1,1,0,0,1,312,72,43,0,43,1246,0,1246,22,0,22,0,99.85052317,NoArch
5f93f7df0a4c334d9feb4d6094f1bc1940a219c6,0,0,0,0,0,0,0,0,0,0,0,0,0,0,0,313,73,0,0,0,0,0,0,0,0,0,0,100,NoArch
a754ef3b464490791b98a488092de3d350176f36,0,0,0,0,0,0,0,0,0,0,0,0,0,0,0,314,66,0,0,0,0,0,0,0,0,0,0,100,NoArch
9e0c233050a0866b1197ce476e057d33914a6442,2,119,52,67,171,0,0,0,48,10,1,2,0.994442325,2020,1,315,63,279,272,7,7655,7267,388,82,78,4,0,100,NoArch
9d3d688f4b1292cc4f35078cd9611d8079fa86bb,0,0,0,0,0,0,0,0,0,0,0,0,0,0,0,316,64,0,0,0,0,0,0,0,0,0,0,100,NoArch
6d71ff5d798fa90368803dc27b4363f92a1ec2b9,1,14,1,13,15,0,0,0,6,0,1,1,0,138,1,317,65,10,10,0,784,657,127,7,7,0,0,99.09977494,NoArch
17034f091ba161997df8c778cd0fb9c80c39e0fd,0,0,0,0,0,0,0,0,0,0,0,0,0,0,0,318,66,0,0,0,0,0,0,0,0,0,0,100,NoArch
7c547789a04cfde0ad46d69dc76da31ad989587a,2,37,1,36,38,1,0,1,97,17,1,2,0.998000884,3372,2,319,67,528,522,6,17214,17048,166,176,175,1,0,100,NoArch
1978cc96478f9e0046e6a48e0ea8f8893f14ed4b,0,0,0,0,0,0,0,0,0,0,0,0,0,0,0,320,68,0,0,0,0,0,0,0,0,0,0,100,NoArch
7ffad90311476c92a2751b0c58c488e69179a47f,3,96,43,53,139,0,0,0,21,68,1,3,1.372069213,506,2,17,0,44,36,8,2492,2133,359,19,19,0,0,100,NoArch
a33d645f00add6f8a5d8830be164a50f86c5101a,6,213,136,77,349,1,0,1,30,73,1,3,1.445213844,948,1,321,69,142,140,2,4005,3942,63,91,89,2,0,99.84939759,NoArch
8b99b00f9639da751707e3e981266b996486ec73,1,5,7,2,12,0,0,0,28,1,1,1,0,1130,2,322,70,198,198,0,5054,5051,3,87,87,0,0,100,NoArch
d4f81a1fce1da55b94f9dc9fb0277f35d4877c0f,0,0,0,0,0,0,0,0,0,0,0,0,0,0,0,323,71,0,0,0,0,0,0,0,0,0,0,100,NoArch
fd35ea583ef4636d97eccf6318babd7111a10e4d,6,161,78,83,239,0,0,0,98,8,1,5,2.118859635,8180,3,18,1,1085,1052,33,33132,32588,544,309,309,0,0,94.2155309,Arch
065cd4429f0f8fc72e32ba41b7717aba5286ebb9,0,0,0,0,0,0,0,0,0,0,0,0,0,0,0,19,2,0,0,0,0,0,0,0,0,0,0,100,NoArch
cfa54c7b249835858bfb99271d54a190f008468e,2,8,14,6,22,0,0,0,31,11,1,2,0.945660305,397,2,20,3,61,63,2,1626,1608,18,45,47,2,0,100,NoArch
d69794074f8f64351d462d4c9d0f210bc0336c5e,2,44,10,34,54,0,0,0,21,32,1,2,0.898653376,1352,1,324,72,229,224,5,6535,6359,176,80,78,2,0,100,NoArch
ca8bdf1f5b05e37d9bc5114dbecd0c2f5f249a38,3,24,5,19,29,1,0,1,99,5,1,3,1.073551999,4055,3,21,4,647,635,12,20209,20051,158,171,171,0,0,100,NoArch
d88947bb6ec76666bf01a7577fd76696187db4bd,0,0,0,0,0,0,0,0,0,0,0,0,0,0,0,22,5,0,0,0,0,0,0,0,0,0,0,100,NoArch
abb0b46e8d5c5b13b54afaa3c8da554ec0ec05b8,5,143,19,124,162,3,0,3,100,5,1,3,1.266661157,2689,2,325,73,374,366,8,14211,13860,351,112,106,6,0,93.78980892,Arch
5ac9a33faaf8fbe776b46f105ff83b017aab9102,2,51,53,2,104,0,0,0,101,0,1,2,0.543564443,2420,1,326,74,349,347,2,12727,12822,95,92,92,0,0,93.87917329,Arch
50ed1b25233958cdafcab4b74daec840fc85b964,1,3,0,3,3,1,0,1,6,220,1,1,0,44,1,327,72,7,6,1,160,137,23,7,6,1,0,100,NoArch
2448337ce848091a55444514c9055689c3c558aa,0,0,0,0,0,0,0,0,0,0,0,0,0,0,0,328,73,0,0,0,0,0,0,0,0,0,0,100,NoArch
5d8b2c825ee3891619957b8ce4480ae1870fe825,2,28,3,25,31,0,0,0,102,10,1,2,0.345117315,2429,3,329,74,355,354,1,12713,12684,29,99,99,0,0,100,NoArch
17b9e2560eff4a193d6209c76f203f7f4e951e7d,0,0,0,0,0,0,0,0,0,0,0,0,0,0,0,330,75,0,0,0,0,0,0,0,0,0,0,100,NoArch
90519817e9f921732cbc967f5153490461719f02,1,19,4,15,23,0,0,0,103,0,1,1,0,2335,3,331,76,345,344,1,12466,12440,26,88,88,0,0,100,NoArch
790204c8bbf849199266f062530e325dc3f1e480,0,0,0,0,0,0,0,0,0,0,0,0,0,0,0,332,77,0,0,0,0,0,0,0,0,0,0,100,NoArch
8174082962d2d29cd1dc67593b7e05a26f41faa7,4,70,25,45,95,0,0,0,104,15,1,2,1.8646463,2650,1,333,77,384,371,13,13535,13198,337,113,105,8,0,99.91638796,NoArch
fd3c17b5f60d402ba42a72a49ed71cf21d179fec,3,32,14,18,46,0,0,0,105,0,1,2,1.432211498,2576,1,334,78,371,371,0,13238,13204,34,105,103,2,0,100,NoArch
a679fefd52e988c6a12b480b0ea17d0e7deb7e53,1,5,5,0,10,0,0,0,8,0,1,1,0,84,1,335,79,5,5,0,164,164,0,5,5,0,0,100,NoArch
a065fcf293df317b10d2e8133c41c89cc2ed3bfa,0,0,0,0,0,0,0,0,0,0,0,0,0,0,0,336,80,0,0,0,0,0,0,0,0,0,0,100,NoArch
368a557eb48aca8bb82c442996f5a424926e0e23,3,61,14,47,75,1,0,1,106,9,1,3,1.506359787,2594,1,337,77,374,365,9,13752,13548,204,104,101,3,0,100,NoArch
b2c047499c964c2f1b284ae33526b8b4aac47740,10,126,16,110,142,4,0,4,107,37,1,7,2.58827247,4930,1,338,77,726,710,16,24353,23769,584,244,236,8,0,94.65153971,Arch
aef3be58ccb541c18755e7e7cbfc7878740cddd8,0,0,0,0,0,0,0,0,0,0,0,0,0,0,0,339,78,0,0,0,0,0,0,0,0,0,0,100,NoArch
f7cee8ccfa17061d7b695a767339d5c9c17cdab8,2,61,2,59,63,1,0,1,22,12,1,2,0.958711883,1386,1,340,79,244,229,15,6850,6535,315,86,80,6,0,100,NoArch
1813dc2459063d9548ee295f069d94cc95c10556,4,43,14,29,57,1,0,1,108,5,1,3,1.982943629,4080,1,341,78,458,453,5,16840,16751,89,181,177,4,0,98.42146803,NoArch
da963950cae7b838cbb83e5bb5919afd7993d0f8,0,0,0,0,0,0,0,0,0,0,0,0,0,0,0,342,79,0,0,0,0,0,0,0,0,0,0,100,NoArch
3afcde4cd4acbd0776dc2ca23e529b5548f79e59,2,10,0,10,10,2,0,2,7,24,1,2,0.970950594,238,1,343,70,25,23,2,629,579,50,22,20,2,0,100,NoArch
eaeabab9178d65eb7b9762cee8a22d62a69b495e,0,0,0,0,0,0,0,0,0,0,0,0,0,0,0,344,70,0,0,0,0,0,0,0,0,0,0,100,NoArch
a9bc5a3c070194738349267bf5fdf6721ca2195e,4,119,51,68,170,1,0,1,109,40,1,3,1.246205124,2992,1,345,71,428,427,1,15542,15308,234,124,122,2,0,97.34167318,Arch
5c5d18d3b036d83088dc8d4fd2ddd1420051442f,7,80,75,5,155,0,0,0,7,110,1,6,2.386997671,1997,1,346,70,248,247,1,8427,8240,187,91,90,1,0,100,NoArch
de27fbac946ae7def5c35a0bd06638fdd5ce5df5,3,266,1,265,267,2,0,2,3,52,1,2,1.05493065,164,1,347,71,26,11,15,1478,506,972,16,7,9,0,99.53952417,NoArch
19f478e11a1ae0cb849f3e3db3b31db15b2e5116,0,0,0,0,0,0,0,0,0,0,0,0,0,0,0,348,72,0,0,0,0,0,0,0,0,0,0,100,NoArch
de00ef804f07e9766778a067cd027c4e535809bd,2,32,6,26,38,0,0,0,69,9,1,1,0.967788463,3251,3,349,73,510,507,3,12915,12821,94,140,139,1,0,100,NoArch
8d9486a6a4cad4d82a114f9eb9b1a8e519e5ef0a,1,1,1,0,2,0,0,0,70,0,1,1,0,1293,3,350,74,226,225,1,5778,5770,8,64,64,0,0,100,NoArch
be0f73d1bb387dc332a95c34a5729ec99bb028c1,1,3,0,3,3,1,0,1,71,0,1,1,0,1293,3,351,75,224,226,2,5716,5778,62,64,64,0,0,100,NoArch
4278af862f0ae4b4ab6f0020f685f858bc1c3d32,1,10,8,2,18,0,0,0,72,0,1,1,0,1296,3,352,76,227,224,3,5797,5716,81,65,64,1,0,100,NoArch
ef6c771527fc4a3a27c4006df68631be4ab7fef8,0,0,0,0,0,0,0,0,0,0,0,0,0,0,0,353,77,0,0,0,0,0,0,0,0,0,0,100,NoArch
aa92e3fa6c120756b92ee09fead6f44c3420719e,0,0,0,0,0,0,0,0,0,0,0,0,0,0,0,354,78,0,0,0,0,0,0,0,0,0,0,100,NoArch
654476f0fc0a5f29398aeb9302e4f973b60fa3c9,0,0,0,0,0,0,0,0,0,0,0,0,0,0,0,355,79,0,0,0,0,0,0,0,0,0,0,100,NoArch
2b1e111865eb27342f7844f0e4b9a767d4190b2e,0,0,0,0,0,0,0,0,0,0,0,0,0,0,0,356,80,0,0,0,0,0,0,0,0,0,0,100,NoArch
5c5ff0f775a66886fa5f80b217c9aa6df6a08d8f,0,0,0,0,0,0,0,0,0,0,0,0,0,0,0,357,81,0,0,0,0,0,0,0,0,0,0,100,NoArch
860aa48934ac3eb2f6c0ec10fec7637e31ee73c2,2,4,2,2,6,0,0,0,4,79,1,2,0.918295834,260,1,358,82,16,16,0,772,774,2,12,12,0,1,100,NoArch
4ef737ad42e65a2bbe4f127ab4827f761431c57c,0,0,0,0,0,0,0,0,0,0,0,0,0,0,0,359,83,0,0,0,0,0,0,0,0,0,0,100,NoArch
5fb51082b192bf0b886a169bf0bff9b4778e3289,0,0,0,0,0,0,0,0,0,0,0,0,0,0,0,360,84,0,0,0,0,0,0,0,0,0,0,100,NoArch
f403714c9b8d223a684090cdd6f37199bed1a843,0,0,0,0,0,0,0,0,0,0,0,0,0,0,0,361,85,0,0,0,0,0,0,0,0,0,0,100,NoArch
2299630a68c518d281b580232536b8fbe687e645,0,0,0,0,0,0,0,0,0,0,0,0,0,0,0,362,86,0,0,0,0,0,0,0,0,0,0,100,NoArch
989f95cc40f8546205b6c1bf0ce32c4213edb983,0,0,0,0,0,0,0,0,0,0,0,0,0,0,0,363,49,0,0,0,0,0,0,0,0,0,0,100,NoArch
b6616e5fb6d537229d307cf8647ef483468175a6,1,2,2,0,4,0,0,0,29,36,1,1,0,1128,2,364,50,200,198,2,5062,5054,8,87,87,0,0,100,NoArch
fa81e63166b767850a9020a922925ad35ce226fa,1,105,0,105,105,1,0,1,1,0,1,1,0,0,1,365,51,9,0,9,177,0,177,6,0,6,0,99.6948894,NoArch
42437917f185f8efa3d947fae3bb08b584504650,1,56,20,36,76,0,0,0,30,3,1,1,0,1128,2,366,51,204,200,4,5187,5062,125,91,87,4,1,100,NoArch
b745f26831608aa141ba085ce3c68fd9c811939b,2,62,0,62,62,2,0,2,6,69,1,1,0.889034904,225,1,367,52,29,18,11,593,365,228,15,12,3,0,100,NoArch
653d75403391eb8662f9a25f82d2df1759413075,4,295,8,287,303,3,0,3,1,0,1,2,1.875532281,349,1,368,53,61,43,18,1897,1246,651,36,22,14,0,99.09228442,NoArch
6e83a01d862b3745b1332292be344e59f0c57e61,5,5,5,0,10,0,0,0,1,0,1,2,2.321928095,831,1,369,54,87,87,0,3057,3057,0,48,48,0,0,98.4962406,NoArch
30e6393c37e81cfb1926059f5af77db518ef5e55,30,132,120,12,252,0,0,0,110,48,1,14,4.565399988,8073,1,370,55,1038,1038,0,33027,33094,67,417,417,0,0,98.4962406,NoArch
6057df6f450fc2a3578ad7aec5cfdda2371d8afb,4,9,4,5,13,0,0,0,3,0,1,2,1.738149333,651,1,371,47,70,70,0,1803,1786,17,41,41,0,0,99.39849624,NoArch
5524eac9cd6ef31fe98cbb9176ba526264a0a492,1,7,0,7,7,1,0,1,24,2,1,1,0,1022,3,372,48,188,186,2,4816,4785,31,34,34,0,0,100,NoArch
badf503bbadc9c15fa3305a3a94451519473d47a,0,0,0,0,0,0,0,0,0,0,0,0,0,0,0,373,49,0,0,0,0,0,0,0,0,0,0,100,NoArch
61f1ea4ad484a133b6b4b4c16a8deb5234069650,1,1,1,0,2,0,0,0,8,7,1,1,0,162,1,374,41,17,17,0,326,324,2,8,8,0,0,100,NoArch
603fd55a0619a976837ce9f4471ec91ced66f5d9,1,68,0,68,68,1,0,1,1,0,1,1,0,0,1,375,42,1,0,1,60,0,60,1,0,1,0,99.84984985,NoArch
8337bc8edae1e08b8fd721d694680024150c4b80,0,0,0,0,0,0,0,0,0,0,0,0,0,0,0,376,43,0,0,0,0,0,0,0,0,0,0,100,NoArch
3d343749694e11ac09e4cac775a5cae666133a8b,5,15,23,8,38,0,0,0,111,71,1,5,1.858372517,3811,1,377,44,571,571,0,18347,18440,93,196,196,0,0,100,NoArch
8f7bfe04f383a290151ba4d912bfe238e280ae20,3,115,97,18,212,1,0,1,112,20,1,3,0.211792584,2514,1,378,44,362,358,4,12798,12761,37,101,99,2,0,100,NoArch
e282101870c5def7c7e6191df794f25dc1995949,4,59,9,50,68,2,0,2,25,11,1,3,1.25012749,1368,1,379,45,215,206,9,6240,6019,221,54,49,5,0,100,NoArch
fe0957d4640599defb3a9c00a2024cd4923cef4c,1,44,42,2,86,0,0,0,3,8,1,1,0,87,2,380,44,6,6,0,252,252,0,4,4,0,0,100,NoArch
0f5c73d85d5f6a7126b5083dcc4a78f5b219c44a,1,6,1,5,7,0,0,0,2,0,1,1,0,68,1,381,45,2,1,1,86,60,26,2,1,1,0,100,NoArch
38283b2538d594a5a24b7b33b8f66864928ccbd9,3,29,4,25,33,2,0,2,13,22,1,3,1.548736037,484,1,382,46,41,38,3,1639,1535,104,31,28,3,0,100,NoArch
14fbefdd3a083614c5eff9e4b2d5e7288c6cf059,3,227,111,116,338,0,0,0,4,202,1,2,1.109161121,251,1,383,47,29,14,15,1270,386,884,23,12,11,0,100,NoArch
2ac921c95f3465b9740c11f2e9d8e451ba02381c,2,34,25,9,59,0,0,0,5,0,1,2,0.474345438,279,1,384,48,24,23,1,1176,1122,54,18,17,1,0,100,NoArch
2691bde66a8e4add212e08e92fe30a047ab9f87d,8,596,241,355,837,4,0,4,73,20,1,5,1.947746031,6221,1,385,48,1052,986,66,28000,26297,1703,380,338,42,2,99.8502994,NoArch
82ab046a4e8f50cee51dd716145e0838ec5dd286,1,7,0,7,7,1,0,1,9,8,1,1,0,162,1,386,49,18,17,1,342,326,16,9,8,1,0,100,NoArch
590871b482e1d3cad39ef5680a82a711143f1f0b,0,0,0,0,0,0,0,0,0,0,0,0,0,0,0,387,49,0,0,0,0,0,0,0,0,0,0,100,NoArch
8ccf0f74826a64dc85f1ee87d45bb34899b0df57,0,0,0,0,0,0,0,0,0,0,0,0,0,0,0,388,50,0,0,0,0,0,0,0,0,0,0,100,NoArch
9c3702e2323457c05f190e8e09c24ea10f89aebe,0,0,0,0,0,0,0,0,0,0,0,0,0,0,0,389,51,0,0,0,0,0,0,0,0,0,0,100,NoArch
1445be7bda772604765e46cf91c4194aa2b84141,2,140,102,38,242,0,0,0,2,16,1,1,0.366848211,563,1,390,49,70,63,7,2380,2285,95,34,31,3,0,100,NoArch
7111204f9a91a56ba024cda78eee636ddc08437b,1,4,0,4,4,1,0,1,3,0,1,1,0,411,1,391,48,47,46,1,1583,1565,18,26,25,1,0,100,NoArch
da42c9df67e9ed94b4b47c71b301f62cec95a62c,2,418,285,133,703,0,0,0,52,0,1,2,0.234939255,3301,3,392,49,552,524,28,14052,13199,853,211,199,12,0,100,NoArch
bcd6de4f8aa10b5d9f5a3ea60d134c960d7359c1,1,2,4,2,6,0,0,0,31,17,1,1,0,504,2,393,50,82,82,0,2122,2131,9,19,19,0,0,100,NoArch
75f4be92458bd10bdc204d70bc2d5dc471279302,1,17,0,17,17,1,0,1,5,57,1,1,0,164,1,394,51,32,27,5,629,525,104,16,15,1,0,100,NoArch
c5e56026345fb723bfdfbfd627860ac39ccbd203,1,15,0,15,15,1,0,1,2,58,1,1,0,183,1,395,52,37,32,5,775,682,93,16,15,1,0,100,NoArch
7677faca7faba0eb6ecdb6852c35896fc7b32ca5,2,99,2,97,101,1,0,1,10,0,1,1,0.791066298,169,1,396,53,26,18,8,581,342,239,13,9,4,0,99.7761194,NoArch
9e2c7cb1b926a95889da43d8a18e94f5a67dab54,0,0,0,0,0,0,0,0,0,0,0,0,0,0,0,397,54,0,0,0,0,0,0,0,0,0,0,100,NoArch
047575342f452aedbdd30d19446fda52d7fb5540,3,11,2,9,13,1,0,1,32,0,1,2,1.198183948,881,2,398,55,152,151,1,3600,3526,74,51,51,0,0,99.92548435,NoArch
c190ee0bed3e4fe595631e42c4738e958c30c068,0,0,0,0,0,0,0,0,0,0,0,0,0,0,0,399,56,0,0,0,0,0,0,0,0,0,0,100,NoArch
96687fe7549a9debe237870d176a6591ccd03499,0,0,0,0,0,0,0,0,0,0,0,0,0,0,0,400,57,0,0,0,0,0,0,0,0,0,0,100,NoArch
1dfe8fa55cde15093dfdb44b88cc7e6439016ed5,0,0,0,0,0,0,0,0,0,0,0,0,0,0,0,401,58,0,0,0,0,0,0,0,0,0,0,100,NoArch
187aa768be7fb1c50a74f573c64b18fe26b65650,1,20,14,6,34,0,0,0,11,0,1,1,0,189,1,402,59,23,22,1,476,453,23,9,9,0,0,100,NoArch
d9aa7d1c39851a22163cf2d263964a46994ba9de,0,0,0,0,0,0,0,0,0,0,0,0,0,0,0,403,60,0,0,0,0,0,0,0,0,0,0,100,NoArch
937e981346501cc136cec2534d543605da3c6c97,1,13,7,6,20,0,0,0,14,1,1,1,0,233,1,404,61,17,16,1,1194,1177,17,16,16,0,0,100,NoArch
8eb3a3ac60cc9444c17aedd0b62e1620345d857f,3,212,156,56,368,0,0,0,113,23,1,2,1.539580044,2576,1,405,59,368,366,2,13332,12985,347,103,102,1,0,100,NoArch
dc50e0827c679004750469d4aec76d1d36f57be3,1,56,5,51,61,0,0,0,34,2,1,1,0,1407,2,406,60,269,262,7,6970,6755,215,137,135,2,0,100,NoArch
f7180dfb519c4f7116dd80b558324f6b7e9c79e0,0,0,0,0,0,0,0,0,0,0,0,0,0,0,0,407,60,0,0,0,0,0,0,0,0,0,0,100,NoArch
606fe0b2a46f0ec5d7ba798e5095e03f91dd581a,2,12,1,11,13,1,0,1,27,2,1,2,0.961236605,1574,1,408,59,274,273,1,7586,7520,66,94,93,1,0,100,NoArch
e8ede3636935aefdf7ed4fc7ea5b7b5769b7d197,1,5,2,3,7,0,0,0,28,0,1,1,0,1149,3,409,56,214,213,1,5375,5359,16,39,39,0,0,100,NoArch
ac3290a353784318b31ea3a24bd1343aa239ab9a,1,12,4,8,16,0,0,0,7,57,1,1,0,164,2,410,55,15,14,1,648,591,57,10,10,0,0,100,NoArch
0a0faf773fa5e422f0b0437000492df529fb73d5,1,286,236,50,522,0,0,0,35,0,1,1,0,1458,2,411,50,277,269,8,7156,6970,186,140,137,3,0,100,NoArch
a9867f71db0c2837ca9ecc90c1dd51153cc7f8e7,2,389,0,389,389,2,0,2,36,0,1,2,0.046491549,1508,2,412,51,346,277,69,8214,7156,1058,159,140,19,0,99.85119048,NoArch
b9b617b14420f034e804d7109c140c821a4b2a32,2,135,113,22,248,0,0,0,29,104,1,2,0.345117315,1240,1,413,50,223,220,3,5714,5577,137,45,44,1,0,99.85185185,NoArch
eaa35ce47f2a7048397fdec13603786c7367eaf8,1,24,8,16,32,0,0,0,30,0,1,1,0,1162,3,414,51,218,216,2,5470,5431,39,40,39,1,0,100,NoArch
99d9a28f78f54224a7f2bb16ac9bb6a2a3fabc05,8,68,105,37,173,0,0,0,74,42,1,4,2.485596298,4339,1,415,52,618,616,2,17540,17509,31,189,188,1,0,97.00690714,Arch
e0d9316c4be5e5f62211fef68fee4a71bb5cf4eb,0,0,0,0,0,0,0,0,0,0,0,0,0,0,0,416,53,0,0,0,0,0,0,0,0,0,0,100,NoArch
0a0079962d191f69e989b13cc8cd727bd72707df,1,10,0,10,10,1,0,1,33,3,1,1,0,511,2,417,54,85,83,2,2251,2196,55,19,19,0,0,100,NoArch
2ccc2dc0e8a8fa98a50c3458996b69dfd11a905b,7,100,4,96,104,4,0,4,114,15,1,5,1.796403719,6470,3,23,0,983,973,10,29806,29522,284,318,310,8,1,99.60159363,NoArch
dc383e4be9c891b4d112a5a1db3afd8903c682e1,0,0,0,0,0,0,0,0,0,0,0,0,0,0,0,24,1,0,0,0,0,0,0,0,0,0,1,100,NoArch
a20f4820ae1314842793eadfea758bbdaf478792,0,0,0,0,0,0,0,0,0,0,0,0,0,0,0,418,55,0,0,0,0,0,0,0,0,0,0,100,NoArch
9cf8162b9e68be61de858fe0b03863d23ca86e01,5,65,12,53,77,1,0,1,76,20,1,4,1.926258884,3687,1,419,56,562,551,11,15034,14724,310,166,163,3,1,99.84126984,NoArch
567cc8c30b25e20c739328aba295371b09199611,10,353,105,248,458,7,0,7,115,4,1,7,2.007754196,8745,1,420,57,1214,1170,44,37919,36859,1060,432,418,14,0,99.84177215,NoArch
9aaf4fd018b1c47359ff4fc991a5bce4700a494b,6,198,105,93,303,1,0,1,116,0,1,5,0.673463796,5033,1,421,58,799,781,18,25304,24905,399,244,243,1,3,100,NoArch
f855a6a3eb97a53ef5699c6daf2b684a23ff68aa,1,3,0,3,3,1,0,1,37,3,1,1,0,1510,2,422,59,278,277,1,7169,7156,13,140,140,0,0,100,NoArch
7a7d207761911e275c47fbca61ef1277c55b9d73,1,10,0,10,10,1,0,1,6,23,1,1,0,101,2,423,60,7,6,1,215,194,21,5,4,1,0,100,NoArch
06b386f85689023c84e07451afe28fd3988d2466,1,0,2,2,2,0,0,0,7,0,1,1,0,111,2,424,61,7,7,0,215,215,0,5,5,0,0,100,NoArch
25c3af562c3e6b898b3ccca372381216863635e0,0,0,0,0,0,0,0,0,0,0,0,0,0,0,0,425,62,0,0,0,0,0,0,0,0,0,0,100,NoArch
1f4a947d786b3858be72e2dba9d793ffedf2fb91,3,27,8,19,35,0,0,0,117,12,1,2,1.41242455,2833,3,426,63,406,400,6,14301,14265,36,117,116,1,1,99.76284585,NoArch
c84230009bb33d760c5e2f3dc3685fcca279b8eb,1,94,3,91,97,0,0,0,20,62,1,1,0,1039,3,427,64,155,143,12,3968,3464,504,10,10,0,0,100,NoArch
99c5892d1325359ad03db731940a13897fb1522d,0,0,0,0,0,0,0,0,0,0,0,0,0,0,0,428,65,0,0,0,0,0,0,0,0,0,0,100,NoArch
b5e2e640b10d4bda5b22982cc3c2b75732c0a439,1,919,1004,85,1923,0,0,0,21,0,1,1,0,1130,3,429,66,143,155,12,3464,3968,504,10,10,0,0,100,NoArch
e09d14fbd97612adf3c6662adaa21fde4c9e5939,0,0,0,0,0,0,0,0,0,0,0,0,0,0,0,76,0,0,0,0,0,0,0,0,0,0,0,100,NoArch
261e0044be5323749a67b40bdc96c7149a6f4340,0,0,0,0,0,0,0,0,0,0,0,0,0,0,0,77,1,0,0,0,0,0,0,0,0,0,0,100,NoArch
b363cde04a241bb27871cefebcabb68d24e9aa6c,0,0,0,0,0,0,0,0,0,0,0,0,0,0,0,78,2,0,0,0,0,0,0,0,0,0,0,100,NoArch
0d4c2a94e5ad96e75651d825fbf04a78ba256e86,0,0,0,0,0,0,0,0,0,0,0,0,0,0,0,430,67,0,0,0,0,0,0,0,0,0,0,100,NoArch
fdeb29cab243ec25acc8866114393c2d6bf3f439,2,14,1,13,15,1,0,1,118,46,1,1,0.970950594,2630,1,431,68,389,385,4,13612,13553,59,105,103,2,0,100,NoArch
fe400421a571860035ad5b0e2d60f76a6062d7c2,2,20,6,14,26,0,0,0,38,3,1,2,0.779349837,1694,3,25,2,311,310,1,7887,7798,89,156,156,0,0,100,NoArch
f68bc85579f1d60a764a1b2b28a22042d1d0b404,2,9,9,0,18,0,0,0,23,34,1,2,0.764204507,587,2,26,3,74,74,0,2864,2864,0,65,65,0,0,100,NoArch
6738f45ab2ebb1c5ba089749b0ff984a3313dfe7,1,1003,916,87,1919,0,0,0,22,0,1,1,0,1045,3,432,69,155,143,12,3974,3464,510,10,10,0,0,100,NoArch
123dbbafc0bc214744827cc189f89fb449ce64fe,0,0,0,0,0,0,0,0,0,0,0,0,0,0,0,433,70,0,0,0,0,0,0,0,0,0,0,100,NoArch
46d35afc16f73aa0de8a37ef391d408c4aaae230,1,27,14,13,41,0,0,0,39,1,1,1,0,1527,3,434,71,280,279,1,7291,7254,37,141,140,1,0,100,NoArch
896e2aeb29e82310db454f352ea3f63805735f51,1,1,1,0,2,0,0,0,4,47,1,1,0,463,1,435,72,67,66,1,1963,1949,14,19,19,0,0,100,NoArch
05b0dbe1d05a58f2d81cfde12f138f9c9ad7b4df,0,0,0,0,0,0,0,0,0,0,0,0,0,0,0,436,73,0,0,0,0,0,0,0,0,0,0,100,NoArch
ed476106caa2c9c966621e13a5b8b38a89b4c0e9,1,12,1,11,13,0,0,0,6,17,1,1,0,166,1,437,74,21,18,3,708,647,61,15,12,3,0,100,NoArch
b24b0fba3b368c2b7480b414e6d677ab343e63db,1,4,4,0,8,0,0,0,40,0,1,1,0,1540,3,438,75,280,280,0,7291,7291,0,141,141,0,0,100,NoArch
500c0a0a31d99091676e50b37c4c1e34d7082f5a,1,4,4,0,8,0,0,0,41,0,1,1,0,1540,3,439,76,280,280,0,7291,7291,0,141,141,0,0,100,NoArch
96bbd97d36b9000640f58f00f87607c0d3700dcb,2,35,1,34,36,1,0,1,79,2,1,2,0.964078765,1600,1,440,77,259,256,3,7781,7561,220,85,84,1,0,96.11069559,Arch
506305467ebc39e568dcc14605335be97720edc0,0,0,0,0,0,0,0,0,0,0,0,0,0,0,0,441,78,0,0,0,0,0,0,0,0,0,0,100,NoArch
6c3c8c1a033a9368cf474bb694523a26ec746a0e,10,167,338,171,505,0,0,0,42,216,1,3,2.362189449,3327,1,442,79,477,482,5,12691,13204,513,189,192,3,0,99.78708304,NoArch
5e0aa0f2138bcdfc78756a88e98cca475cbfd709,0,0,0,0,0,0,0,0,0,0,0,0,0,0,0,443,80,0,0,0,0,0,0,0,0,0,0,100,NoArch
af596e71400bfecc69d921356599183f52205a71,0,0,0,0,0,0,0,0,0,0,0,0,0,0,0,444,81,0,0,0,0,0,0,0,0,0,0,100,NoArch
cfc03a3f4018abed230f0e74acae4f0d817ad9d6,0,0,0,0,0,0,0,0,0,0,0,0,0,0,0,445,82,0,0,0,0,0,0,0,0,0,1,100,NoArch
ce38c504606b4c4a122fb45c6f44a48441481781,1,18,3,15,21,0,0,0,119,2,1,1,0,2536,3,446,83,382,380,2,13489,13438,51,97,96,1,1,100,NoArch
97e4036928039d40e6c039e9d199176b5c606efe,0,0,0,0,0,0,0,0,0,0,0,0,0,0,0,447,84,0,0,0,0,0,0,0,0,0,0,100,NoArch
599aae03ca613213cc7d5d86fac4c3ce796b1e0f,0,0,0,0,0,0,0,0,0,0,0,0,0,0,0,448,85,0,0,0,0,0,0,0,0,0,0,100,NoArch
5552d7610486e8c936d30af6af3c55d964116a0f,1,9,1,8,10,0,0,0,120,0,1,1,0,2551,3,449,86,388,382,6,13521,13489,32,97,97,0,0,100,NoArch
c346aff6bc7aa70d011f180e55400905d042933a,0,0,0,0,0,0,0,0,0,0,0,0,0,0,0,450,87,0,0,0,0,0,0,0,0,0,0,100,NoArch
8031aa37bb79cdad235d5aa6f5e503d51193ed87,1,2,7,5,9,0,0,0,121,1,1,1,0,2559,3,451,88,387,388,1,13503,13521,18,97,97,0,0,100,NoArch
50fc863251a7a3cbc1837eeebeba1c7844b846c3,2,40,0,40,40,2,0,2,122,1,1,2,0.970950594,2831,1,452,89,412,408,4,15321,15137,184,116,114,2,1,100,NoArch
9190f9365ee674f3c459b142d5396a8abeb263ee,1,1,1,0,2,0,0,0,36,5,1,1,0,615,2,27,4,113,113,0,2800,2801,1,21,21,0,0,100,NoArch
50de867c8422a1ba27a7635c887576d08949c261,0,0,0,0,0,0,0,0,0,0,0,0,0,0,0,28,5,0,0,0,0,0,0,0,0,0,0,100,NoArch
54780d2d76cefc64086c8ff3881b5ca6bd9d2523,31,276,58,218,334,16,0,16,123,153,1,3,4.317340187,5422,1,453,90,655,618,37,20946,19984,962,305,273,32,1,96.53092006,Arch
9142247569d809bcd3af8cd807113c923bccc3b0,0,0,0,0,0,0,0,0,0,0,0,0,0,0,0,454,91,0,0,0,0,0,0,0,0,0,0,100,NoArch
12d85b6faff310afaca7a9f783740956989d48b3,2,996,1277,281,2273,1,0,1,57,3,1,2,0.150097883,2373,1,455,92,335,328,7,9784,9364,420,100,94,6,1,100,NoArch
ab3071a2275229a7e4b2d8a4c195255269c5da71,2,11,3,8,14,0,0,0,31,18,1,1,0.591672779,1260,1,456,93,221,221,0,5575,5548,27,43,43,0,0,100,NoArch
89352edebef81c71d3273b15d3bc08536edae361,2,83,46,37,129,0,0,0,124,1,1,2,0.159350063,4172,3,457,94,679,677,2,21259,21129,130,243,242,1,0,100,NoArch
4c78911ab5d998fbf7256c6682ddd10aa2296967,4,53,17,36,70,1,0,1,44,13,1,2,1.77489903,2671,2,458,95,479,472,7,12481,12326,155,221,217,4,0,100,NoArch
22b03c42d10a106eb0227b59a31d2e803596c146,0,0,0,0,0,0,0,0,0,0,0,0,0,0,0,459,96,0,0,0,0,0,0,0,0,0,0,100,NoArch
03f2a591afdab09047233aaf70b8e902481ee444,0,0,0,0,0,0,0,0,0,0,0,0,0,0,0,460,97,0,0,0,0,0,0,0,0,0,0,100,NoArch
05df140e09cfa22f59c9f09ac9d50cf8b7033b62,6,765,856,91,1621,3,0,3,80,75,1,4,0.769905329,3886,1,461,98,614,596,18,17986,17304,682,194,183,11,0,100,NoArch
c3536e08b58d4fb65305952e6e276c8c16eca8b7,2,22,2,20,24,1,0,1,59,0,1,2,0.918295834,2196,1,462,99,351,349,2,10519,10388,131,109,107,2,0,100,NoArch
3d37acd34fcf44c4a51bd104ef70043af62c7d99,30,2783,3090,307,5873,8,0,8,125,44,1,18,2.703074081,16050,1,463,97,2409,2288,121,71350,68428,2922,934,884,50,6,99.44,NoArch
2377608f99790740c080b4a180832bd834165ab2,0,0,0,0,0,0,0,0,0,0,0,0,0,0,0,464,98,0,0,0,0,0,0,0,0,0,0,100,NoArch
65be7e690bb48c96611a0b4e4cf022eed154e4ea,0,0,0,0,0,0,0,0,0,0,0,0,0,0,0,465,99,0,0,0,0,0,0,0,0,0,0,100,NoArch
8cea22a0f9009afdc34275907405998bf55922c9,1,2,0,2,2,1,0,1,2,0,1,1,0,69,1,466,100,1,3,2,74,173,99,1,1,0,0,100,NoArch
2d2c04a72d464bc3792db583f188a2a175a82b8f,0,0,0,0,0,0,0,0,0,0,0,0,0,0,0,467,101,0,0,0,0,0,0,0,0,0,0,100,NoArch
2e36bf0af3c1d6160b658e412f218dea22ec6d0c,0,0,0,0,0,0,0,0,0,0,0,0,0,0,0,468,102,0,0,0,0,0,0,0,0,0,0,100,NoArch
0fa78116e88467847d59a4487168805b14791018,0,0,0,0,0,0,0,0,0,0,0,0,0,0,0,469,103,0,0,0,0,0,0,0,0,0,0,100,NoArch
5566d50e497be15932900637c6fffb7e70d80b53,0,0,0,0,0,0,0,0,0,0,0,0,0,0,0,470,104,0,0,0,0,0,0,0,0,0,0,100,NoArch
fa41d2174cb0fb4fde26d80166fd965328939b68,5,28,33,5,61,1,0,1,46,4,1,3,1.823978884,3151,1,471,105,537,538,1,13916,13933,17,256,256,0,0,100,NoArch
749f3627be6477800afc1773f810477145cf2510,2,15,0,15,15,2,0,2,47,0,1,1,0.721928095,2533,2,472,106,453,450,3,11486,11403,83,192,191,1,0,100,NoArch
ee3d2a9816e7c89cbfa90c5fca17d0ef7ed7320e,2,14,17,3,31,0,0,0,39,8,1,2,0.981152234,427,2,473,107,64,64,0,1681,1745,64,49,49,0,0,100,NoArch
126d18a68fb230b7483df6f3116f41c7a1dddacd,1,9,0,9,9,1,0,1,41,0,1,1,0,636,2,474,108,120,118,2,2926,2866,60,24,24,0,0,100,NoArch
025d1b3fe7b021be3c9bec8f6ea8f5d1ade2109f,0,0,0,0,0,0,0,0,0,0,0,0,0,0,0,475,109,0,0,0,0,0,0,0,0,0,0,100,NoArch
43c1b9f416dbe1f4780142bc6773aa775059cfa1,1,11,0,11,11,1,0,1,40,1,1,1,0,342,2,476,105,61,60,1,1625,1589,36,46,45,1,0,100,NoArch
fcb40f2ba92ea0b4eea0596376a3652a36750617,4,44,13,31,57,0,0,0,82,4,1,3,1.88940703,5435,3,477,106,807,803,4,21872,21685,187,235,234,1,0,100,NoArch
0cac42434487022be48b4bb54d7cad8b1608a71c,3,32,4,28,36,2,0,2,126,35,1,3,1.426202589,3120,1,478,107,481,474,7,15871,15768,103,145,142,3,1,100,NoArch
645d48cce2da3ee743a23f0539702f976c1bfc5c,1,1,1,0,2,0,0,0,48,1,1,1,0,1912,3,479,108,335,335,0,8620,8620,0,168,168,0,1,100,NoArch
e883c42136620628c9653bb03c7a1d42e7a50b10,0,0,0,0,0,0,0,0,0,0,0,0,0,0,0,480,109,0,0,0,0,0,0,0,0,0,0,100,NoArch
f7f421588d5418b1840952f60478f5e8a97e9d96,0,0,0,0,0,0,0,0,0,0,0,0,0,0,0,481,110,0,0,0,0,0,0,0,0,0,0,100,NoArch
7fe632efa35706ffff6fa8550a6e60d00a34c285,1,1,1,0,2,0,0,0,4,5,1,1,0,217,1,482,108,37,37,0,762,762,0,14,14,0,0,100,NoArch
5c981bf3e27f613e7a542b1d200b2db436476406,1,1,0,1,1,1,0,1,62,2,1,1,0,1838,3,483,109,328,327,1,8207,8202,5,84,84,0,0,100,NoArch
487c5c6a627b591565ca15f5173772c730530929,5,109,14,95,123,2,0,2,127,16,1,4,1.822673571,3308,2,484,110,498,492,6,16780,16583,197,157,153,4,1,98.96825397,NoArch
8c4d1c65f2c1c881c753ca2e72dd2473a0c5a421,4,46,3,43,49,2,0,2,21,65,1,3,1.040614201,646,1,485,111,76,66,10,2835,2603,232,30,26,4,1,100,NoArch
7918d3fe25ce8d2e7f40c0574e08c6b855d2399f,0,0,0,0,0,0,0,0,0,0,0,0,0,0,0,486,112,0,0,0,0,0,0,0,0,0,0,100,NoArch
f84cc03f6c647e5836aab0cd5ef86aac26ab539e,0,0,0,0,0,0,0,0,0,0,0,0,0,0,0,0,0,0,0,0,0,0,0,0,0,0,1,100,NoArch
73f4f44a6827933be4130c174f1d5183db5a82c0,2,141,14,127,155,0,0,0,49,20,1,2,0.137802666,2110,3,487,107,390,372,18,9810,9395,415,194,184,10,0,100,NoArch
9cd140ba1b1ccc87d09085fe0fddcb90bf0b736a,7,1035,1333,298,2368,1,0,1,128,8,1,6,1.514970638,8657,1,488,108,1274,1259,15,39298,38768,530,375,372,3,0,100,NoArch
765454774515102487d4d441b3b7d04a12058ca0,0,0,0,0,0,0,0,0,0,0,0,0,0,0,0,489,109,0,0,0,0,0,0,0,0,0,0,100,NoArch
8eeca28708a76447a7d7d7d315906e7bbe8f9d0d,0,0,0,0,0,0,0,0,0,0,0,0,0,0,0,490,110,0,0,0,0,0,0,0,0,0,0,100,NoArch
70516d3567a56df2fe61e7ef6e47cf357cbf2b80,7,98,143,45,241,0,0,0,24,26,1,6,2.1106996,1277,1,491,109,125,123,2,4900,4730,170,67,70,3,0,99.84152139,NoArch
44054787c6e84f9706c3d7758d017635801af3ae,0,0,0,0,0,0,0,0,0,0,0,0,0,0,0,492,107,0,0,0,0,0,0,0,0,0,0,100,NoArch
92e04777572f04a784e81dd9600d02cca26819ac,3,62,3,59,65,1,0,1,14,6,1,2,0.395060465,324,1,493,108,35,34,1,1130,1091,39,22,21,1,0,99.84152139,NoArch
f6e336918532c879e5dc0d014ed64607a2a2924a,1,10,0,10,10,1,0,1,50,0,1,1,0,2038,3,494,109,354,353,1,9065,9035,30,179,178,1,0,100,NoArch
e33de9641b28582bf7199c74ea6c9e5ea21d6bb6,0,0,0,0,0,0,0,0,0,0,0,0,0,0,0,495,110,0,0,0,0,0,0,0,0,0,0,100,NoArch
32148efa6b399312d4c59a88a65b9d22663b65fd,1,10,1,9,11,0,0,0,42,9,1,1,0,645,2,496,111,123,120,3,2961,2926,35,24,24,0,1,100,NoArch
b79ac164f4b866de5932d94ebf015e5018fbb527,1,26,18,8,44,0,0,0,43,0,1,1,0,654,2,497,112,118,123,5,2961,2961,0,24,24,0,0,100,NoArch
baa8230c9ce9e2fba72e36725d4a767f4ad82c3a,1,1,1,0,2,0,0,0,129,0,1,1,0,2689,3,498,113,410,410,0,14068,14068,0,100,100,0,0,100,NoArch
a9d7d92018655d16b2267949a8c7c68f50c32012,4,44,3,41,47,2,0,2,44,4,1,3,1.80516897,1266,2,499,114,199,195,4,5633,5488,145,84,83,1,0,100,NoArch
d2c3e8c6b4237ca981524606f25442454b30faea,1,56,0,56,56,1,0,1,5,0,1,1,0,417,1,500,115,53,48,5,1804,1591,213,29,26,3,0,100,NoArch
54ce4309a02b537afe0b283e670e130c69afb402,5,88,34,54,122,2,0,2,84,0,1,4,1.417498476,4785,1,501,116,730,723,7,22256,21891,365,277,273,4,1,100,NoArch
869419d8546c5ff966c646042af5c87ba104ac13,0,0,0,0,0,0,0,0,0,0,0,0,0,0,0,502,117,0,0,0,0,0,0,0,0,0,0,100,NoArch
31ddaad9978dc7b434e9402484ead9b9c3a2d8bf,0,0,0,0,0,0,0,0,0,0,0,0,0,0,0,503,118,0,0,0,0,0,0,0,0,0,0,100,NoArch
8daf93419f5af6c8982eadddb3ac9a8c14078c6d,1,4,1,3,5,0,0,0,6,7,1,1,0,473,1,504,113,54,53,1,1825,1804,21,29,29,0,0,100,NoArch
bca40ac7fc5222f676bc6095dd7bb696de753558,2,16,4,12,20,0,0,0,51,8,1,2,1,2247,3,505,114,393,391,2,9918,9840,78,195,195,0,0,100,NoArch
4b43cf989e80b0500b8485ee385ffebcda36b8f1,1,45,0,45,45,1,0,1,23,14,1,1,0,411,1,506,115,79,70,9,1920,1706,214,41,39,2,0,100,NoArch
5be0ed3d8efb2819e6daaee792cefd62bff5fc51,1,2,2,0,4,0,0,0,6,8,1,1,0,151,1,507,116,13,13,0,645,645,0,10,10,0,0,100,NoArch
a158598fe11f86d065700c347d63f23c4a7ce7ad,2,70,30,40,100,1,0,1,33,20,1,2,0.468995594,1614,2,508,117,285,280,5,7901,7703,198,96,95,1,1,100,NoArch
1273ba7b9ef16aa7445089087a086510e68bb29a,2,19,7,12,26,0,0,0,16,23,1,2,0.619382195,433,1,509,115,49,48,1,1743,1704,39,31,30,1,1,100,NoArch
832454fdc480c9401e1dde430ef4c00cdf33ac3f,1,5,4,1,9,0,0,0,65,8,1,1,0,1881,3,510,115,338,337,1,8457,8452,5,87,87,0,1,100,NoArch
43179a20d1fd45111158d5e4b4db1ddb3020d852,5,15,16,1,31,0,0,0,85,27,1,2,2.122762842,3511,3,511,115,655,654,1,16341,16378,37,188,188,0,0,100,NoArch
2377f44bdbad81045756971499d017046c743e1c,1,2,1,1,3,0,0,0,4,35,1,1,0,151,2,512,116,13,13,0,653,637,16,10,10,0,0,100,NoArch
03e4cdc82b9211f7a70a39864ea07cc2d18ca6ab,0,0,0,0,0,0,0,0,0,0,0,0,0,0,0,513,114,0,0,0,0,0,0,0,0,0,0,100,NoArch
cf7d5c350f279f9e65cad74ba5f4cb54dc798ad0,0,0,0,0,0,0,0,0,0,0,0,0,0,0,0,514,115,0,0,0,0,0,0,0,0,0,0,100,NoArch
0ad3b6245a913c4f893ff0fe80fbef93658ff33b,1,23,5,18,28,0,0,0,67,0,1,1,0,1876,3,515,112,339,338,1,8427,8387,40,89,87,2,0,100,NoArch
3ca347c1f726cfc905f66b680752f2203ffb5ab8,1,13,21,8,34,0,0,0,68,0,1,1,0,1894,3,516,112,338,339,1,8442,8427,15,89,89,0,0,100,NoArch
c985bff5a9cc12603c0bfe99f025f6a4a502c6d3,0,0,0,0,0,0,0,0,0,0,0,0,0,0,0,517,112,0,0,0,0,0,0,0,0,0,0,100,NoArch
1d820fd3c36dec329fd8074aab2cdd9743d6a297,1,10,3,7,13,0,0,0,42,9,1,1,0,356,2,518,113,62,61,1,1666,1635,31,46,46,0,1,100,NoArch
16d95b71afccf52a90b7c45665428c3bbbf8de9c,0,0,0,0,0,0,0,0,0,0,0,0,0,0,0,519,114,0,0,0,0,0,0,0,0,0,0,100,NoArch
c3bfbf41ec305de3317d43cc288a420a86a3fe3a,12,793,631,162,1424,1,0,1,130,49,1,7,1.145901053,7918,1,520,109,1346,1312,34,37828,37110,718,493,482,11,0,99.52494062,NoArch
f6f0a51e0aa087cdc477259b205be6c5e5cc9746,1,56,27,29,83,0,0,0,53,0,1,1,0,2066,3,521,109,362,357,5,9285,9151,134,180,179,1,0,100,NoArch
a6d73379f8328d1b7955729ae4c79033e31fa2d5,0,0,0,0,0,0,0,0,0,0,0,0,0,0,0,522,107,0,0,0,0,0,0,0,0,0,0,100,NoArch
a2ef68dd251a22174fa9794f46094e1b482fa181,1,18,0,18,18,1,0,1,1,0,1,1,0,0,1,523,105,2,0,2,77,0,77,1,0,1,0,99.60411718,NoArch
ab87526fa54691528274d5bac9637b88cb7b752d,0,0,0,0,0,0,0,0,0,0,0,0,0,0,0,524,106,0,0,0,0,0,0,0,0,0,0,100,NoArch
9dc4a62d26d0a127ccef494bfe425b115119ac86,0,0,0,0,0,0,0,0,0,0,0,0,0,0,0,525,107,0,0,0,0,0,0,0,0,0,0,100,NoArch
b7a57f42aecff983a62e0d673ecb50554c281ed5,0,0,0,0,0,0,0,0,0,0,0,0,0,0,0,526,108,0,0,0,0,0,0,0,0,0,0,100,NoArch
c33ab93f516e8ca9ed05d86077dff498762ffefd,0,0,0,0,0,0,0,0,0,0,0,0,0,0,0,527,109,0,0,0,0,0,0,0,0,0,0,100,NoArch
4a738e5f9c922492591ccb4247abcdd38e16d0c2,0,0,0,0,0,0,0,0,0,0,0,0,0,0,0,528,110,0,0,0,0,0,0,0,0,0,0,100,NoArch
93787d6d3e2bc0985caf90862a3997cbebaa4f69,0,0,0,0,0,0,0,0,0,0,0,0,0,0,0,529,109,0,0,0,0,0,0,0,0,0,0,100,NoArch
c70a5d9febdfd9b16728d57335e18c39c24021ff,1,8,7,1,15,0,0,0,54,2,1,1,0,2095,3,530,110,362,362,0,9300,9285,15,180,180,0,0,100,NoArch
b411eadf8a4fd1728975cf26948239c397ae11c7,1,98,20,78,118,0,0,0,55,0,1,1,0,2096,3,531,110,375,362,13,9607,9300,307,186,180,6,0,100,NoArch
ee76879e28c3fa97f936ca4e97ad18235ad51bf1,0,0,0,0,0,0,0,0,0,0,0,0,0,0,0,1,1,0,0,0,0,0,0,0,0,0,0,100,NoArch
497155259e696ec10ddffbb05aa6dc53fe0958b0,0,0,0,0,0,0,0,0,0,0,0,0,0,0,0,2,2,0,0,0,0,0,0,0,0,0,0,100,NoArch
e50d64ba9626942f552430c5f9d2a87e23257168,1,71,40,31,111,0,0,0,12,50,1,1,0,195,1,532,83,31,23,8,666,476,190,9,9,0,0,100,NoArch
7f80c042527f62ca6afbbdab6583bbf5d53aa876,0,0,0,0,0,0,0,0,0,0,0,0,0,0,0,533,84,0,0,0,0,0,0,0,0,0,0,100,NoArch
9bbae86af494c11bb35da91d1246db0764b011ba,2,8,4,4,12,0,0,0,13,76,1,2,0.650022422,346,1,534,84,36,36,0,1068,1058,10,15,14,1,0,100,NoArch
dfd3521065924852443966bceff940c368285d8a,1,9,1,8,10,0,0,0,56,3,1,1,0,2174,3,535,85,376,375,1,9651,9607,44,186,186,0,0,99.84177215,NoArch
29d6f13c7b601b533ed007e3a81d57236d8e4e89,0,0,0,0,0,0,0,0,0,0,0,0,0,0,0,536,86,0,0,0,0,0,0,0,0,0,0,100,NoArch
f1f301ee347a6cbefc8e95ef8f9917b22b109b82,0,0,0,0,0,0,0,0,0,0,0,0,0,0,0,537,87,0,0,0,0,0,0,0,0,0,0,100,NoArch
59dd60b9a3d5df90dc421749bd30c1702f09571f,1,1,1,0,2,0,0,0,14,0,1,1,0,230,1,538,88,32,31,1,682,676,6,10,10,0,0,100,NoArch
d06862085cf82e025a2a7a65a5086305389d9066,0,0,0,0,0,0,0,0,0,0,0,0,0,0,0,539,89,0,0,0,0,0,0,0,0,0,0,100,NoArch
4f7a6c638a6b50d7896498d2e78d4eebea24a8ac,0,0,0,0,0,0,0,0,0,0,0,0,0,0,0,540,90,0,0,0,0,0,0,0,0,0,0,100,NoArch
8f2ff5e516984f8359c9ba7d9def1dfd15b62dd6,1,8,1,7,9,0,0,0,27,18,1,1,0,1007,3,541,91,165,159,6,4053,4007,46,11,11,0,0,100,NoArch
d2f8fa929c0e360647e505f9f93ab1cbe6e7d982,0,0,0,0,0,0,0,0,0,0,0,0,0,0,0,542,92,0,0,0,0,0,0,0,0,0,0,100,NoArch
6ae53eae9581358cd0de35207da48382d05639fc,2,137,54,83,191,1,0,1,131,3,1,1,0.985536913,2700,3,543,93,419,412,7,14269,14109,160,108,101,7,0,99.84202212,NoArch
ee5a833c565567940195c1ab6c79d4f19281b9bb,2,39,6,33,45,0,0,0,87,7,1,1,0.99964375,3061,3,544,94,588,584,4,15049,14901,148,160,158,2,0,100,NoArch
107a192bd9b5bc06ca6ab37ae87c489e94e67607,1,8,9,1,17,0,0,0,28,0,1,1,0,1014,3,545,95,165,165,0,4050,4053,3,11,11,0,0,100,NoArch
d52b1b7fe423b4f8def7a8772a77452d7fc325ee,7,169,11,158,180,4,0,4,132,14,1,5,1.961932702,6612,1,546,96,1089,1076,13,34450,33878,572,342,330,12,1,99.84251969,NoArch
4f6f8ac013f630b052ac49b5db9092b473253832,6,327,109,218,436,4,0,4,57,6,1,3,1.919311565,3187,1,547,86,507,494,13,15454,14958,496,284,276,8,0,99.37156324,NoArch
e130ead629f047cc64dd749f119859f5dd28d5f1,1,32,4,28,36,0,0,0,71,1,1,1,0,1907,3,548,87,357,340,17,8667,8524,143,90,90,0,0,100,NoArch
2f0aa033f9e37595ed09992f6f8162d5238172a9,5,71,31,40,102,4,0,4,72,14,1,3,1.422068578,2648,1,549,88,408,408,0,12292,12034,258,142,137,5,1,97.36842105,Arch
679572aeccf71c08107ac4f85bf1649e0caf6aea,1,475,255,220,730,0,0,0,58,0,1,1,0,2223,3,550,87,379,381,2,9718,9820,102,187,189,2,0,99.84732824,NoArch
cac3694f90815bb429694efb9bdb460f66720813,0,0,0,0,0,0,0,0,0,0,0,0,0,0,0,551,88,0,0,0,0,0,0,0,0,0,0,100,NoArch
8a73fcdd2c8d363b38cba1f707cfe7f476758a71,1,256,476,220,732,0,0,0,59,0,1,1,0,2443,3,552,89,381,379,2,9820,9718,102,189,187,2,0,99.84732824,NoArch
aa0e7dfad9942b2dd11cceddabf22487fd7ac257,0,0,0,0,0,0,0,0,0,0,0,0,0,0,0,553,90,0,0,0,0,0,0,0,0,0,0,100,NoArch
e76b1e7e1c8e2ca43f3a4acd013b0b872841f1dd,1,35,10,25,45,0,0,0,4,63,1,1,0,104,1,554,91,8,6,2,380,325,55,7,6,1,0,100,NoArch
67b24e35f97f842bcd8b927240de06a601a0c99c,14,1471,435,1036,1906,8,0,8,133,6,1,5,2.977464339,7271,1,555,92,1250,1182,68,36317,33844,2473,467,425,42,0,97.13843774,Arch
4d7c52ba9153e6e5049902ae93362532032e9253,1,256,476,220,732,0,0,0,61,0,1,1,0,2443,3,556,93,381,379,2,9820,9718,102,189,187,2,0,99.92163009,NoArch
c64318af97c4dccb5ae3f4a9e07d68ba7136f73c,12,814,243,571,1057,3,0,3,134,0,1,5,3.066496958,5137,1,557,91,838,772,66,26166,24171,1995,271,235,36,0,99.37646142,NoArch
b8d06b2559b25cf04cb20dd76e7d58d722463eca,1,116,0,116,116,1,0,1,1,0,1,1,0,0,1,558,87,8,0,8,229,0,229,5,0,5,0,99.76780186,NoArch
11d70f172eb48d7a185104e54db5ec44cb068298,2,65,3,62,68,1,0,1,36,0,1,1,0.787126586,1645,1,559,88,301,288,13,7476,7147,329,73,69,4,0,100,NoArch
05151b92e2dfa36ee0a3f7a5c1c1a6d7a02c46f7,3,37,20,17,57,1,0,1,37,0,1,2,1.170646344,1909,1,560,89,316,313,3,8354,8283,71,80,78,2,0,100,NoArch
8d28b98ba24b4cb4fbe51cea0f88f8194167df9e,2,5,15,10,20,0,0,0,38,0,1,2,0.881290899,1720,1,561,90,283,282,1,7608,7604,4,57,57,0,0,100,NoArch
28291277b4197e791618043ec3cf4f8b07d0fb60,1,562,182,380,744,0,0,0,62,3,1,1,0,2223,4,3,3,381,381,0,9820,9820,0,189,189,0,0,100,NoArch
a265d3249b5e0152b04da090bf925ad73bebc5c7,8,48,23,25,71,1,0,1,135,4,1,5,2.435883924,7847,1,562,88,1216,1213,3,34909,34808,101,451,451,0,0,100,NoArch
716e75b5d455c796d41eae32390318d0e6c580f5,0,0,0,0,0,0,0,0,0,0,0,0,0,0,0,563,89,0,0,0,0,0,0,0,0,0,0,100,NoArch
3aae9d5a39585797d620387a60aef52f05773022,1,52,0,52,52,1,0,1,64,0,1,1,0,2614,4,564,90,387,383,4,10026,9900,126,193,189,4,0,100,NoArch
4a8732f5e1d51f43fc1f633bca7d79351aa720c5,1,15,0,15,15,1,0,1,65,0,1,1,0,2666,4,565,91,389,387,2,10067,10026,41,194,193,1,0,100,NoArch
37570e7f323b005483b9af112d40df482a828bfa,2,90,17,73,107,1,0,1,136,0,1,2,0.966408672,2599,3,566,90,385,383,2,13897,13775,122,99,97,2,0,99.84567901,NoArch
8cea794a1a05cf7a32f0eb5707ce61560bcb5318,0,0,0,0,0,0,0,0,0,0,0,0,0,0,0,567,87,0,0,0,0,0,0,0,0,0,0,100,NoArch
bedd29f3a3a3abd37960576de4a78261dc555015,1,11,7,4,18,0,0,0,46,22,1,1,0,684,2,568,88,123,122,1,3049,3019,30,24,24,0,1,100,NoArch
231e3b2e8c3b6d44c1d85e73ec8607e00895c2e4,0,0,0,0,0,0,0,0,0,0,0,0,0,0,0,569,89,0,0,0,0,0,0,0,0,0,0,100,NoArch
60b37a795f59f7dc1e339184c10ec80b8bc58989,2,126,2,124,128,1,0,1,66,0,1,1,0.337290067,2681,1,570,90,404,389,15,10315,10067,248,203,194,9,0,99.84615385,NoArch
9cc357e6df346f0fd56c23c6993c5ee2175c4c3c,1,35,7,28,42,0,0,0,47,0,1,1,0,688,2,571,91,131,123,8,3245,3049,196,24,24,0,1,100,NoArch
69043b6700bb92e33df9d981c025b1aaf7efa5a3,2,41,8,33,49,1,0,1,48,42,1,2,0.475431646,885,2,572,92,152,144,8,4076,3892,184,38,34,4,0,100,NoArch
45fa36b42a9960c715c3a288913bda7494125595,1,8,36,28,44,0,0,0,49,0,1,1,0,744,2,573,93,131,138,7,3245,3403,158,24,27,3,0,100,NoArch
9ad521421f25fa6ed488d8fc3dbcc639fafc88c7,1,2,0,2,2,1,0,1,9,0,1,1,0,174,2,574,94,13,14,1,647,673,26,10,11,1,1,100,NoArch
c33dab3d8e3bf1982e52c761b14fcfd71095694d,1,11,0,11,11,1,0,1,7,47,1,1,0,169,1,575,93,22,20,2,618,566,52,15,13,2,1,100,NoArch
692cfee2445e91a29fa22d520927efa85e4adb4f,0,0,0,0,0,0,0,0,0,0,0,0,0,0,0,576,90,0,0,0,0,0,0,0,0,0,0,100,NoArch
2246f0bfe626a497727e1048a811fd88825172da,0,0,0,0,0,0,0,0,0,0,0,0,0,0,0,577,91,0,0,0,0,0,0,0,0,0,0,100,NoArch
052e619491ea6599331fe918c1e7f95f67ada8b4,0,0,0,0,0,0,0,0,0,0,0,0,0,0,0,578,92,0,0,0,0,0,0,0,0,0,0,100,NoArch
4478a3164b313f726b801e0e57b9e2ef4dbd0736,2,104,69,35,173,0,0,0,50,0,1,2,0.09097054,892,2,579,93,155,144,11,4131,3892,239,38,34,4,1,100,NoArch
d953bd0007fd9f543344e2aa2775a91299b3bf62,1,98,29,69,127,0,0,0,2,6,1,1,0,116,1,580,93,15,8,7,365,229,136,10,5,5,0,100,NoArch
ae3abc8a35496376d5a18a667762a59e295bf1ac,0,0,0,0,0,0,0,0,0,0,0,0,0,0,0,581,94,0,0,0,0,0,0,0,0,0,1,100,NoArch
e02b39975d1b7e73046551f941672efc059d2208,7,152,102,50,254,0,0,0,26,137,1,4,1.414236688,879,2,4,4,68,64,4,3025,2833,192,49,45,4,1,100,NoArch
403ef4b99c5ef958c772725f84117cbe2173969e,0,0,0,0,0,0,0,0,0,0,0,0,0,0,0,582,95,0,0,0,0,0,0,0,0,0,0,100,NoArch
891ad59d074990a38d7ba0dca65890e80061158a,11,136,136,0,272,3,2,5,24,200,1,5,2.694734077,1807,2,583,96,227,230,3,7293,7328,35,116,121,5,0,98.21567106,NoArch
35769e1948e7d391ebae75d8aa15e568462d6020,1,8,2,6,10,0,0,0,16,2,1,1,0,257,3,584,97,27,26,1,885,875,10,20,19,1,0,100,NoArch
f8ee5a16e83f55d8a5d23a1a83aaa6e553eda3d0,1,34,12,22,46,0,0,0,9,7,1,1,0,279,1,585,98,60,54,6,1312,1178,134,22,20,2,1,100,NoArch
99f49a926003e253468eaa78d6d6a44bb91fd014,1,1,1,0,2,0,0,0,51,3,1,1,0,753,2,586,99,141,141,0,3461,3458,3,27,27,0,0,100,NoArch
f4f7c2f41730274024cc5782bda029f5647162ad,10,142,174,32,316,1,0,1,15,104,1,6,2.835576329,2431,2,587,100,238,234,4,10476,10385,91,211,209,2,0,98.83268482,NoArch
20227399a32eb79ed7392b6c2c9a3580bf14f7d2,1,8,0,8,8,1,0,1,2,0,1,1,0,26,1,588,101,8,6,2,163,124,39,4,3,1,0,100,NoArch
c3752bfd49fafcb613e34fd6c93b6e4ae6d89070,2,24,1,23,25,1,0,1,137,8,1,2,0.989587521,3078,2,589,102,471,467,4,16188,16042,146,162,160,2,0,100,NoArch
3642aee4b2b264c1ec9e3ae8ec904d3db5851817,0,0,0,0,0,0,0,0,0,0,0,0,0,0,0,590,103,0,0,0,0,0,0,0,0,0,0,100,NoArch
48b66780aa837f8650e91482bf541d311167a2a6,2,3,2,1,5,0,0,0,138,0,1,1,0.721928095,2681,3,591,104,386,386,0,13967,13956,11,100,100,0,0,99.38223938,NoArch
5a92d94e7a59713b298a234488152e591cbd595d,1,204,18,186,222,0,0,0,67,7,1,1,0,2685,4,592,100,407,390,17,10551,10080,471,212,195,17,1,100,NoArch
14e9a8783fae15ba3e7a5782e43a360a07b8cabf,0,0,0,0,0,0,0,0,0,0,0,0,0,0,0,593,101,0,0,0,0,0,0,0,0,0,0,100,NoArch
1fc892515bece739b5ec210547694b980de442cf,1,9,0,9,9,1,0,1,7,42,1,1,0,216,1,594,97,23,22,1,823,793,30,13,12,1,0,100,NoArch
25b2e1be8e0aaec97e092beb7ebb076009cb202a,3,6,2,4,8,1,0,1,8,33,1,3,1.5,455,1,595,97,35,34,1,1510,1496,14,23,22,1,0,100,NoArch
76abdd0a826c8ac2745873ccd71d5305f0bdaeb3,1,1,1,0,2,0,0,0,9,0,1,1,0,229,1,596,98,24,24,0,837,837,0,14,14,0,0,100,NoArch
7fd306783e4a748685820df5132238ae53f6075e,0,0,0,0,0,0,0,0,0,0,0,0,0,0,0,597,93,0,0,0,0,0,0,0,0,0,0,100,NoArch
956a3ad52038aacfd2e113f1a530824b722a469a,0,0,0,0,0,0,0,0,0,0,0,0,0,0,0,598,94,0,0,0,0,0,0,0,0,0,0,100,NoArch
84f2415f1454f1087af3c96a0840530002f8f754,0,0,0,0,0,0,0,0,0,0,0,0,0,0,0,599,95,0,0,0,0,0,0,0,0,0,0,100,NoArch
c61f9c1d0c9d2a587c6b1d28b4f235a7d0724fa7,1,3,3,0,6,0,0,0,3,288,1,1,0,83,1,600,96,6,6,0,136,142,6,6,6,0,0,100,NoArch
83106da6db4a7db397471c05eb305bac5b8584c2,1,93,0,93,93,1,0,1,1,0,1,1,0,0,1,601,97,4,0,4,177,0,177,3,0,3,0,99.69183359,NoArch
fc725003f59f35046ebcc44c17c0b15e96535a10,1,6,0,6,6,1,0,1,40,12,1,1,0,1514,3,602,98,270,269,1,6781,6757,24,52,52,0,1,100,NoArch
6a256422c68fed720fb4d3ec73fd7fcced9eb8bc,1,15,2,13,17,0,0,0,68,2,1,1,0,2871,4,603,99,408,407,1,10573,10551,22,213,212,1,0,100,NoArch
0e6824c1020745f239b5fecb196920c6443bd90c,0,0,0,0,0,0,0,0,0,0,0,0,0,0,0,5,4,0,0,0,0,0,0,0,0,0,1,100,NoArch
eeda002a5058b2a53cfc3e65fef3e963ff11936d,1,11,0,11,11,1,0,1,69,13,1,1,0,2884,4,6,3,409,408,1,10594,10573,21,214,213,1,1,100,NoArch
10a9a38822b5e4c09a8be8efc0b1cd7e358c013d,1,1,1,0,2,0,0,0,6,117,1,1,0,172,2,7,3,12,12,0,504,523,19,8,8,0,1,100,NoArch
67faa350a1fbad6561c8076618b0b0ac3db66653,1,5,3,2,8,0,0,0,70,17,1,1,0,2895,4,8,4,410,409,1,10604,10594,10,214,214,0,1,100,NoArch
c98e7ecb3b69b534313fe635980b3f00d11095fa,1,19,0,19,19,1,0,1,71,3,1,1,0,2897,4,9,4,413,410,3,10684,10604,80,215,214,1,1,100,NoArch
9866f58c78116a0884fb81b4752f70105d11305a,1,23,0,23,23,1,0,1,72,11,1,1,0,2916,4,10,5,415,413,2,10742,10684,58,217,215,2,1,100,NoArch
82b3ba4fa7b9886d0319ef2121c7b65b9acf8d52,1,27,24,3,51,0,0,0,17,51,1,1,0,247,3,0,0,26,26,0,1200,1187,13,11,11,0,0,100,NoArch
3d220dce0ce3cbf2464d84ce029f8887cddbd057,1,5,1,4,6,0,0,0,2,399,1,1,0,75,2,1,1,14,13,1,351,339,12,7,6,1,0,100,NoArch
dabca7451def6a1233539ae96c5760b983297ef7,0,0,0,0,0,0,0,0,0,0,0,0,0,0,0,2,2,0,0,0,0,0,0,0,0,0,0,100,NoArch
4f1ddffcc64b7053bd5b442113d2bd70b4ec7679,0,0,0,0,0,0,0,0,0,0,0,0,0,0,0,604,0,0,0,0,0,0,0,0,0,0,0,100,NoArch
47f433e30588e37f3e5c295e09ea295f31fcf540,0,0,0,0,0,0,0,0,0,0,0,0,0,0,0,605,1,0,0,0,0,0,0,0,0,0,0,100,NoArch
52db4f2d149bd3cc3618a050419dbf3323e44eb6,1,24,1,23,25,0,0,0,73,2,1,1,0,2939,4,11,5,418,415,3,10835,10742,93,218,217,1,1,100,NoArch
7629c18105f15d102ef8038625325b882a8f037d,3,179,0,179,179,3,0,3,7,35,1,2,1.516687402,82,1,606,2,16,4,12,399,92,307,13,4,9,0,99.69325153,NoArch
70c06d36df26825aebbf0d631741c63e4a9dbb87,1,71,0,71,71,1,0,1,74,2,1,1,0,2962,4,607,3,425,418,7,10982,10835,147,224,218,6,0,100,NoArch
1263f79f41ae262a5cd3799bec7036dc74e144d3,1,85,119,34,204,0,0,0,75,0,1,1,0,3033,4,608,4,421,425,4,10805,10982,177,226,224,2,0,100,NoArch
6ad34743d7a21d785071b820b3892eabc9e6b766,1,12,7,5,19,0,0,0,10,54,1,1,0,229,1,609,5,25,24,1,859,837,22,14,14,0,0,100,NoArch
0a70b383cec4c627708dc05ea5ec90a1d39e96c2,0,0,0,0,0,0,0,0,0,0,0,0,0,0,0,610,6,0,0,0,0,0,0,0,0,0,0,100,NoArch
4e8dd2fe9f217fa4378282a597d08b2d22197a4b,0,0,0,0,0,0,0,0,0,0,0,0,0,0,0,611,7,0,0,0,0,0,0,0,0,0,0,100,NoArch
6634cc104f9d6eb5349dbcd10f03c2bd6f6e4b56,0,0,0,0,0,0,0,0,0,0,0,0,0,0,0,612,8,0,0,0,0,0,0,0,0,0,0,100,NoArch
1caf6efec966dfc9feed834dfbb233ec274f7ed9,1,79,2,77,81,0,0,0,7,90,1,1,0,476,1,613,9,62,54,8,2043,1825,218,34,29,5,0,100,NoArch
ab76ababcbbe78d10ec6b05fc2eff252c571c57e,0,0,0,0,0,0,0,0,0,0,0,0,0,0,0,0,0,0,0,0,0,0,0,0,0,0,0,100,NoArch
40ed603ed2080704d6c590c0507b57120ee16496,0,0,0,0,0,0,0,0,0,0,0,0,0,0,0,614,10,0,0,0,0,0,0,0,0,0,0,100,NoArch
a8c8ff42fe6f366e893dbcddc587e0c726011c66,1,96,0,96,96,1,0,1,1,0,1,1,0,0,1,615,11,7,0,7,257,0,257,6,0,6,0,99.84732824,NoArch
a2bb1fbbe6fa55f1ddf2d99617e7714b70fc3d2c,0,0,0,0,0,0,0,0,0,0,0,0,0,0,0,616,12,0,0,0,0,0,0,0,0,0,1,100,NoArch
9f1e5759b214aae598b06f71e0172ec606295092,1,32,8,24,40,0,0,0,8,1,1,1,0,553,1,617,13,64,62,2,2120,2043,77,36,34,2,0,100,NoArch
3be6a099606d0936e82ee859b45b4e52550c07d0,1,56,24,32,80,0,0,0,76,3,1,1,0,2999,4,12,5,425,421,4,10769,10805,36,230,226,4,1,100,NoArch
27b177628d2eb46b279abddcf6f7b68ad360671c,2,39,5,34,44,0,0,0,5,125,1,1,0.684038436,317,1,618,14,41,36,5,1248,1166,82,17,14,3,0,100,NoArch
7ab7fd70f3c13931756f61e93438e2d5347974b9,2,35,6,29,41,0,0,0,9,1,1,1,0.281193796,781,1,619,15,96,92,4,3108,3014,94,49,45,4,0,100,NoArch
29c5b30ff147f8c096f2bec272d7487d0174881c,1,11,7,4,18,0,0,0,10,0,1,1,0,606,1,620,16,69,68,1,2229,2214,15,40,40,0,0,100,NoArch
1b501720b8205c785ed8a6c07c0e97c505462919,1,24,3,21,27,0,0,0,4,0,1,1,0,147,1,621,17,16,13,3,419,354,65,9,8,1,0,100,NoArch
0c0616826335c7165aa2086b46a2e5e6fa7beca5,1,1,1,0,2,0,0,0,41,57,1,1,0,1520,4,1,1,270,270,0,6781,6781,0,52,52,0,1,100,NoArch
37763a6ee3107dbab787c2013f28d24410eda8f9,0,0,0,0,0,0,0,0,0,0,0,0,0,0,0,622,18,0,0,0,0,0,0,0,0,0,0,100,NoArch
9d19bc3b3d13b0fae536f95cbbbdf2918dca1ea2,1,2,2,0,4,0,0,0,42,0,1,1,0,1520,4,623,19,272,270,2,6803,6781,22,52,52,0,0,100,NoArch
a1308c04c5c726ff5be363e5647da22f3b46b2da,1,2,3,1,5,0,0,0,43,0,1,1,0,1520,4,624,20,270,272,2,6781,6803,22,52,52,0,0,100,NoArch
c107f4ea86b926bc4116714205a44a9f81cd19fb,0,0,0,0,0,0,0,0,0,0,0,0,0,0,0,625,21,0,0,0,0,0,0,0,0,0,0,100,NoArch
7e17e2120a231d578fff89ab69392b015de55024,10,359,235,124,594,3,0,3,77,27,1,4,2.475608299,5288,1,626,22,771,761,10,20667,19967,700,346,335,11,0,99.25037481,NoArch
b40242af55371ff471a826b44eb1869422ac9bc6,2,14,5,9,19,0,0,0,45,0,1,1,0.831474388,1647,1,627,23,307,306,1,7692,7645,47,78,78,0,0,100,NoArch
9bff0fa0a32bb023249988a48127cf8943b1facc,4,336,0,336,336,4,0,4,1,0,1,2,1.901465368,0,1,628,24,31,0,31,855,0,855,17,0,17,0,99.26793558,NoArch
bcaa1b718025bd1b8182397f99ee0a4dad4eda4e,6,193,125,68,318,4,0,4,46,0,1,3,1.275309421,1970,1,629,25,317,318,1,9128,8947,181,88,85,3,0,99.19117647,NoArch
fbb30b6ba1dc4b57bc077d478ecb2e08c476631a,1,17,1,16,18,0,0,0,139,65,1,1,0,2615,3,630,26,387,384,3,13963,13886,77,98,98,0,1,100,NoArch
3056bba8e7c316249df5e0171d6d8110811dc073,1,19,0,19,19,1,0,1,47,0,1,1,0,1428,4,631,27,268,265,3,6849,6802,47,56,54,2,0,100,NoArch
551de450f62ee639a2d07cea29b3bc114632e610,1,2,2,0,4,0,0,0,48,0,1,1,0,1447,4,632,28,268,268,0,6849,6849,0,56,56,0,0,100,NoArch
2ac590c5aa2adccea6a6869b76fbed1bb2931eaf,1,5,1,4,6,0,0,0,49,0,1,1,0,1447,4,633,29,266,268,2,6819,6849,30,56,56,0,0,100,NoArch
92d49f3da2448ffae886d18b64c94fe8db6a5ada,3,90,43,47,133,0,0,0,140,44,1,2,0.857881373,3869,2,634,30,625,615,10,20026,19713,313,193,189,4,0,100,NoArch
2153421d76da3e5f9c2a6ecd74ec3767bd0cf4a9,7,128,10,118,138,4,0,4,141,108,1,5,1.962678747,3144,3,635,31,431,424,7,16079,15844,235,120,116,4,0,99.48109711,NoArch
4b73d9f5acc0011e3a62e162cf7271e5e4a3ef4c,4,24,3,21,27,2,0,2,142,240,1,3,1.875309504,2921,1,636,32,416,411,5,14712,14662,50,115,112,3,1,100,NoArch
6c4a0cfa9c4ce7f6f11473036d934db37540f2f2,3,36,6,30,42,1,0,1,143,25,1,2,1.16816092,3676,2,637,33,596,582,14,18748,18668,80,142,140,2,0,100,NoArch
b3709786f866c1f07dd3282b18cc1057cf682e6c,2,54,18,36,72,1,0,1,144,0,1,1,0.979868757,2938,3,638,34,457,451,6,15314,15185,129,116,114,2,0,100,NoArch
c39dc194054df2a90ccd5f2dd26c2611253ca051,4,89,28,61,117,1,0,1,145,28,1,2,1.643289151,3208,1,639,35,500,483,17,16310,15982,328,140,137,3,0,100,NoArch
5553f816c5a90bb990c2d89926c8455246b7c658,0,0,0,0,0,0,0,0,0,0,0,0,0,0,0,640,36,0,0,0,0,0,0,0,0,0,0,100,NoArch
13e64635c0289a6065dbe6e370eca33e7f23bee3,3,91,19,72,110,2,0,2,50,50,1,1,1.234648787,1540,1,641,37,273,270,3,7046,6944,102,62,60,2,1,99.63154016,NoArch
cdc9068921031fd19719ecd983f913d462442737,0,0,0,0,0,0,0,0,0,0,0,0,0,0,0,642,38,0,0,0,0,0,0,0,0,0,1,100,NoArch
e16ab8ed38c22a1c38c1028d3d9715208ae0498b,1,3,0,3,3,1,0,1,6,122,1,1,0,125,1,643,39,14,13,1,415,401,14,4,4,0,0,100,NoArch
74537034d67ac74913613d4df4807aef4c5fe692,0,0,0,0,0,0,0,0,0,0,0,0,0,0,0,644,40,0,0,0,0,0,0,0,0,0,1,100,NoArch
81a74c5729041b1797dc66e52debbb5b9803a022,6,111,65,46,176,0,0,0,51,30,1,3,2.168181718,2360,1,645,41,387,379,8,9964,9751,213,126,121,5,0,100,NoArch
b4a59f786744939fb038f01d7f8933ef1f449ec1,1,4,1,3,5,0,0,0,52,0,1,1,0,1448,4,646,42,268,268,0,6857,6849,8,57,57,0,0,100,NoArch
a60df6f14deada8a0c0c36aefcddbc4fec0b39ec,2,25,16,9,41,0,0,0,17,0,1,1,0.872161788,460,1,647,43,71,70,1,1527,1520,7,37,36,1,0,100,NoArch
10714b2099290af66bc5d79b6c04cb921425ddcf,0,0,0,0,0,0,0,0,0,0,0,0,0,0,0,648,44,0,0,0,0,0,0,0,0,0,0,100,NoArch
42af6d21b8ee3ef965624ab3b6220a969a1f22aa,16,260,42,218,302,3,0,3,146,128,1,10,3.197831005,11001,1,649,45,1629,1615,14,50356,49675,681,622,615,7,0,96.41407307,Arch
ba4bc1f4912eb0b47534e49dc2fb04932ac82218,3,3,3,0,6,0,0,0,29,114,1,2,1.584962501,1565,3,650,46,264,264,0,6187,6196,9,57,57,0,0,100,NoArch
24b26b6eac774c070c0fb51a2e0deb755f0e4f5f,1,6,2,4,8,0,0,0,6,11,1,1,0,331,1,651,47,80,78,2,1468,1442,26,18,18,0,1,100,NoArch
918e40a9dad1f3babe1a2f270319eb3c19761349,2,104,2,102,106,1,0,1,53,2,1,1,0.480844694,1451,1,652,48,277,268,9,7050,6857,193,64,57,7,0,99.87484355,NoArch
b58342060031f517d6ba42a64dd3ddf392e820bb,1,36,1,35,37,0,0,0,2,169,1,1,0,86,1,653,49,9,5,4,177,104,73,7,5,2,0,99.75015615,NoArch
99431abd03f92390391e2cebc83fac79a999fa48,1,4,1,3,5,0,0,0,7,0,1,1,0,335,1,654,50,82,80,2,1496,1468,28,18,18,0,0,100,NoArch
46e25e0244b119f1be2f75b9754bd5ce2bec60f9,1,2,2,0,4,0,0,0,8,0,1,1,0,338,1,655,51,82,82,0,1496,1496,0,18,18,0,0,100,NoArch
02f6ba21557840cb51204298c42575318c59adf0,1,29,6,23,35,0,0,0,147,2,1,1,0,2711,3,656,52,405,398,7,14429,14280,149,103,101,2,0,100,NoArch
d1a61ae4f6702360626076e5776e721d9636179e,0,0,0,0,0,0,0,0,0,0,0,0,0,0,0,657,53,0,0,0,0,0,0,0,0,0,1,100,NoArch
46e2727b688d1eeee85b7bf51843f6b01e98e118,1,35,0,35,35,1,0,1,79,3,1,1,0,3073,4,13,3,433,427,6,11060,10926,134,233,232,1,1,100,NoArch
3ec7b59e6fe84d453f621e97bd2c6c5c48919f64,1,13,0,13,13,1,0,1,80,0,1,1,0,3108,4,14,4,435,433,2,11112,11060,52,234,233,1,1,100,NoArch
6c9f0c855ab24ded2630bf68a1f23feca58926ed,0,0,0,0,0,0,0,0,0,0,0,0,0,0,0,658,54,0,0,0,0,0,0,0,0,0,1,100,NoArch
21d240576dab8b854e450bebbd64d3bd519e0bc1,1,40,23,17,63,0,0,0,81,0,1,1,0,3121,4,659,55,437,435,2,11133,11112,21,237,234,3,0,100,NoArch
8f66b0b64f30cc34f29c718f8b67110c4485bbd2,1,12,6,6,18,0,0,0,54,2,1,1,0,1458,4,660,56,275,270,5,6930,6891,39,57,57,0,0,100,NoArch
d89071cecf349adeaa9197e9ba3a7506b80d9bb1,1,23,20,3,43,0,0,0,82,0,1,1,0,3138,4,661,57,437,437,0,11151,11133,18,237,237,0,1,100,NoArch
7a53427f630e4d122d453795288e7fa704fb6b87,1,7,9,2,16,0,0,0,74,4,1,1,0,1960,3,662,58,355,356,1,8768,8776,8,91,91,0,0,100,NoArch
d9e87f9e6ccd257d758b1e0a7ac98c0d81afd6b0,0,0,0,0,0,0,0,0,0,0,0,0,0,0,0,663,59,0,0,0,0,0,0,0,0,0,1,100,NoArch
42e27b29d2782af84853d3719daea5299adab0b1,0,0,0,0,0,0,0,0,0,0,0,0,0,0,0,664,60,0,0,0,0,0,0,0,0,0,0,100,NoArch
2ec9989c144c2574729048ce9bffbc2afbce7588,0,0,0,0,0,0,0,0,0,0,0,0,0,0,0,665,61,0,0,0,0,0,0,0,0,0,0,100,NoArch
785ab57d7c210258dbc24ffd27b36a812bac3876,0,0,0,0,0,0,0,0,0,0,0,0,0,0,0,666,62,0,0,0,0,0,0,0,0,0,0,100,NoArch
3035d1a8df2b413f03aed7bce062415b0f519581,30,3417,947,2470,4364,6,0,6,90,92,1,9,3.221238782,7326,2,667,63,1175,1014,161,36430,32132,4298,425,349,76,0,97.09677419,Arch
9168102483d92b35cb14679a1a471a9037622bf4,5,479,109,370,588,4,0,4,6,35,1,2,2.05891176,236,1,29,0,53,22,31,1984,1095,889,20,3,17,0,99.33598938,NoArch
15f8473950d00da819d93cc9f8f82d55795afdd4,1,296,39,257,335,0,0,0,83,14,1,1,0,3141,4,15,3,461,437,24,11941,11151,790,255,237,18,1,100,NoArch
c7b9b9483f7532bb2b6dc61798644377357b700e,1,5,5,0,10,0,0,0,25,135,1,1,0,1099,4,3,0,84,84,0,3584,3583,1,74,74,0,0,100,NoArch
2865a87e7439f2410a5713badaadf56b86114e9f,3,447,4,443,451,1,0,1,84,12,1,3,1.055521958,4703,4,2,2,724,660,64,17881,16687,1194,335,278,57,0,100,NoArch
c088d1382efef7e24094ff9842170591d2a7d793,1,3,19,16,22,0,0,0,32,0,1,1,0,1083,4,3,3,165,170,5,4053,4171,118,11,11,0,0,100,NoArch
71d542cc2798410811e37e6a959985d1430adf0e,0,0,0,0,0,0,0,0,0,0,0,0,0,0,0,668,57,0,0,0,0,0,0,0,0,0,0,100,NoArch
81c1b8603bc94b7dbafb041ae3490ded24a02e2b,0,0,0,0,0,0,0,0,0,0,0,0,0,0,0,669,58,0,0,0,0,0,0,0,0,0,0,100,NoArch
ad4d5a41f5378c7166a5cda78c0edff6ebfc55bf,5,105,4,101,109,3,0,3,19,96,1,3,1.049286844,902,1,670,55,97,92,5,2573,2510,63,54,52,2,0,100,NoArch
10ec0e0f1e8af7afe863a15f790fb871620de641,1,30,5,25,35,0,0,0,20,0,1,1,0,346,2,671,56,61,52,9,1097,995,102,27,27,0,0,100,NoArch
13020522813721619b37c00f5ee7c559fe548d7b,3,145,32,113,177,1,0,1,17,67,1,1,1.306619395,477,3,672,57,56,46,10,1871,1670,201,43,34,9,0,99.73632169,NoArch
f348e309c0253d8735c8c629bbbf2bf965af8992,2,128,135,7,263,0,0,0,21,0,1,1,0.064457145,464,1,673,58,64,67,3,1179,1204,25,32,32,0,0,100,NoArch
09de3df7149b395536f73118e97ba2f004e51064,4,79,33,46,112,1,0,1,148,69,1,3,1.127230418,3363,1,674,59,471,470,1,17041,16992,49,126,126,0,0,100,NoArch
d87cdef490462d664b727ff55176705b049a0c04,2,39,0,39,39,2,0,2,7,91,1,2,0.779349837,301,1,675,57,30,20,10,1060,884,176,17,15,2,1,100,NoArch
055f6873dff169692c6f60b5ffc825fa94bb2e68,0,0,0,0,0,0,0,0,0,0,0,0,0,0,0,676,58,0,0,0,0,0,0,0,0,0,1,100,NoArch
1895c598a51e738a5943e6fae9a03e939307696d,0,0,0,0,0,0,0,0,0,0,0,0,0,0,0,677,59,0,0,0,0,0,0,0,0,0,0,100,NoArch
d4a3118db1b1e966e9edf85ad1de8b4d0b6cb9c9,0,0,0,0,0,0,0,0,0,0,0,0,0,0,0,678,60,0,0,0,0,0,0,0,0,0,0,100,NoArch
65d5e47eceeca4307eb8fce703d6ee9822052564,0,0,0,0,0,0,0,0,0,0,0,0,0,0,0,679,61,0,0,0,0,0,0,0,0,0,0,100,NoArch
ecfede06c1a9eadc048782e5b64c87a7531d5a4d,1,24,0,24,24,1,0,1,22,2,1,1,0,366,2,680,62,62,58,4,1259,1086,173,27,27,0,1,100,NoArch
e58c00e05f764fd4e4a2b3308a5f7b2c5a141025,1,47,34,13,81,0,0,0,23,0,1,1,0,390,2,4,2,60,62,2,1307,1259,48,29,27,2,0,100,NoArch
be04baaf928c37ee6b436a630aa392d20a85d236,15,191,41,150,232,1,0,1,149,71,1,6,3.2152044,7032,1,681,56,995,983,12,32282,31949,333,327,315,12,1,99.40906106,NoArch
6b11569c1d12aa288f1c7df3a3bbaa8b26d096c1,1,263,145,118,408,0,0,0,24,0,1,1,0,403,2,5,3,77,60,17,1620,1307,313,46,29,17,0,100,NoArch
b2ffebd298bbbc183595c6130a304e6d196f33b2,9,379,331,48,710,0,0,0,150,0,1,6,1.169036566,9300,1,682,57,1355,1337,18,39185,38936,249,546,540,6,0,99.8034076,NoArch
b107a60ccf960fe2789d108bf9f6c9c2e69e6d96,2,234,80,154,314,0,0,0,27,0,1,2,0.999268257,948,1,683,57,170,150,20,4930,4509,421,69,62,7,0,100,NoArch
bbc3ba850ac6dfd3711ce531b4f541f45b55a44b,13,1948,943,1005,2891,4,0,4,91,42,1,8,1.478756871,10082,2,684,58,1339,1260,79,42315,40503,1812,566,540,26,0,99.60707269,NoArch
5ffd95b3c20f62b59648d7c1c5d40fe55cbcbcdc,2,7,3,4,10,0,0,0,28,3,1,2,0.721928095,778,1,685,58,112,112,0,2635,2633,2,53,53,0,1,100,NoArch
4f46086e7ca1f262a8e09b5d669d69952f1a9248,1,70,32,38,102,0,0,0,151,2,1,1,0,2728,3,686,57,405,396,9,14481,14281,200,104,103,1,1,100,NoArch
7d0eb989ccf2bd08b3d20cda1782a1a98cb00fd0,5,104,37,67,141,2,0,2,152,35,1,4,1.879513948,4900,1,687,58,754,751,3,24155,24070,85,191,188,3,1,100,NoArch
b0bb03f33809a2cc6b7ba3da573459351da3e0ab,1,56,14,42,70,0,0,0,27,0,1,1,0,466,1,688,59,68,60,8,2735,2371,364,19,18,1,0,100,NoArch
6e7dc313218a6f6640826856bb2d2fde2c4a1306,0,0,0,0,0,0,0,0,0,0,0,0,0,0,0,689,60,0,0,0,0,0,0,0,0,0,0,100,NoArch
ff06eb8b5ec01f5ffaf72f692e1b871c21e56e49,0,0,0,0,0,0,0,0,0,0,0,0,0,0,0,690,49,0,0,0,0,0,0,0,0,0,0,100,NoArch
6e183593ea21e5221294272d56aa15256d109a04,0,0,0,0,0,0,0,0,0,0,0,0,0,0,0,691,50,0,0,0,0,0,0,0,0,0,0,100,NoArch
848a3ddee9d678849cc54308d48232fde2b3f425,1,2,1,1,3,0,0,0,7,26,1,1,0,77,2,692,51,13,13,0,380,359,21,6,6,0,0,100,NoArch
39572bda223652ed67eca739359947e16cf4dd7b,0,0,0,0,0,0,0,0,0,0,0,0,0,0,0,693,52,0,0,0,0,0,0,0,0,0,0,100,NoArch
92aea027245806a5869380c7644e22a680e18522,2,11,16,5,27,0,0,0,54,37,1,2,0.975119065,942,2,694,53,158,159,1,4220,4233,13,39,39,0,1,100,NoArch
47ff48a1800506eeffd0a62bc7d0907586476f79,2,32,17,15,49,1,0,1,153,5,1,2,0.40790598,2922,1,695,54,427,425,2,15047,14968,79,120,119,1,1,100,NoArch
980af39ef22343dc09cd8aa324931d3270554359,1,5,8,3,13,0,0,0,2,25,1,1,0,251,1,30,1,32,32,0,1176,1190,14,8,8,0,1,100,NoArch
85c4c250f3e154f27a7b9f1dbeb308d3e29d12b9,12,616,92,524,708,5,0,5,92,53,1,7,1.879491593,8626,1,696,51,1142,1086,56,31582,30115,1467,353,338,15,0,99.93455497,NoArch
3278cf3afab63fc7bc80ed0394422cc4ed29e8b0,1,17,5,12,22,0,0,0,25,8,1,1,0,521,2,6,4,78,77,1,1718,1620,98,47,46,1,0,100,NoArch
01ceb7248835fad5c15e778d30b850c825285983,2,12,9,3,21,0,0,0,86,6,1,2,0.702466551,3864,1,697,52,517,517,0,12961,12961,0,300,300,0,1,100,NoArch
2b2bbe46954f0f32d7165555683375fb3135ca62,1,14,9,5,23,0,0,0,26,0,1,1,0,533,2,7,5,79,78,1,1761,1718,43,47,47,0,0,100,NoArch
57c4b4ca760d3b47f6f334ccac2d3c0eed70bcc9,1,15,1,14,16,0,0,0,27,0,1,1,0,538,2,8,6,81,79,2,1827,1761,66,49,47,2,1,100,NoArch
40915009f28775d0a540c61183c451b9a9b36623,1,12,11,1,23,0,0,0,93,1,1,1,0,1330,4,4,1,259,259,0,7460,7421,39,71,71,0,0,100,NoArch
e08a678148b2421b0a57a100ebde1c3b4ea852e1,0,0,0,0,0,0,0,0,0,0,0,0,0,0,0,698,53,0,0,0,0,0,0,0,0,0,0,100,NoArch
cbf8812386bf2d884169d90654f87db62da284eb,0,0,0,0,0,0,0,0,0,0,0,0,0,0,0,699,54,0,0,0,0,0,0,0,0,0,0,100,NoArch
c9588ffa98edf09c1f2b683424427973d8c84a88,3,302,0,302,302,3,0,3,1,0,1,1,1.330184828,0,1,31,2,25,0,25,867,0,867,12,0,12,0,99.47882736,NoArch
25401f6fac9346ead6f11c7482b72b3926aef816,1,65,0,65,65,1,0,1,1,0,1,1,0,0,1,32,3,2,0,2,143,0,143,2,0,2,0,99.5463383,NoArch
88f9e0bd8f4fd0ed9772b582b0238169b19f0931,0,0,0,0,0,0,0,0,0,0,0,0,0,0,0,700,51,0,0,0,0,0,0,0,0,0,0,100,NoArch
65e0d00e4f33fc9f78999fa4fb53517bc4871995,1,7,12,5,19,0,0,0,10,135,1,1,0,206,2,9,7,24,25,1,807,823,16,17,17,0,0,100,NoArch
1749a5d4265554d37c03e20547176268f273b622,3,9,7,2,16,1,0,1,2,0,1,1,1.477217001,302,2,701,52,25,25,0,867,867,0,12,12,0,0,100,NoArch
8ffa6a9e69eabde7a0405f65fd8e725dd65a9125,0,0,0,0,0,0,0,0,0,0,0,0,0,0,0,702,53,0,0,0,0,0,0,0,0,0,0,100,NoArch
ba222284277169eeb9015abc790de1b7f4e57527,0,0,0,0,0,0,0,0,0,0,0,0,0,0,0,0,0,0,0,0,0,0,0,0,0,0,0,100,NoArch
4fae3df471128dd4a27289641d43b4a7ba2e7e4d,0,0,0,0,0,0,0,0,0,0,0,0,0,0,0,703,54,0,0,0,0,0,0,0,0,0,0,100,NoArch
357c327755acf83dc4b16c3157ef0195822596ed,3,24,8,16,32,0,0,0,3,12,1,2,1.527103627,359,2,33,4,32,31,1,905,868,37,17,16,1,0,99.6763754,NoArch
174d26d18d57f524889f908efd5c3e54d5c79367,14,445,85,360,530,8,0,8,154,109,1,7,2.605998599,5422,3,704,55,781,756,25,24558,23771,787,336,319,17,2,99.03163331,NoArch
2ac7860c02b2d84a2d8d8b6b8680046ec39801a5,1,1,1,0,2,0,0,0,2,2,1,1,0,65,2,705,56,2,2,0,147,143,4,2,2,0,0,100,NoArch
2edb224f0ee2b298c4a31a6cec9df07569588b68,2,0,12,12,12,0,0,0,4,0,1,1,0.979868757,248,2,706,57,22,22,0,701,708,7,9,9,0,0,100,NoArch
abe4de381a26b84a43c5107e5126fb81ff9c4e08,1,6,1,5,7,0,0,0,58,10,1,1,0,1475,4,707,58,276,275,1,6950,6942,8,57,57,0,0,100,NoArch
0b89ca93277e53e23f6a12d06f20ce0d9f1b743c,1,9,0,9,9,1,0,1,59,0,1,1,0,1480,4,708,59,277,276,1,6962,6950,12,58,57,1,0,100,NoArch
397ea2aedd8918a3826742997a0b7b473509e19d,1,4,7,3,11,0,0,0,3,0,1,1,0,65,2,34,5,2,2,0,154,147,7,2,2,0,0,100,NoArch
be3202d9796cc1998c1de3c7d4348e149ebf6951,0,0,0,0,0,0,0,0,0,0,0,0,0,0,0,709,60,0,0,0,0,0,0,0,0,0,0,100,NoArch
16678869ef5e1b6cf0ea6f865f889786582926ec,1,1,1,0,2,0,0,0,4,0,1,1,0,62,2,35,6,2,2,0,150,154,4,2,2,0,0,100,NoArch
eeb11d5a58e2dc7ebbea9fe66ce6628d2f0c8d9b,1,15,0,15,15,1,0,1,9,14,1,1,0,127,2,710,61,12,12,0,302,302,0,7,7,0,0,100,NoArch
e18652cce8e86b8715268f0ddccbe2461423d54a,2,62,34,28,96,0,0,0,5,0,1,2,0.249882293,250,2,36,7,26,24,2,872,818,54,11,11,0,0,100,NoArch
a447cee8f2bca63ab5cc5e00272890231a354a91,0,0,0,0,0,0,0,0,0,0,0,0,0,0,0,37,8,0,0,0,0,0,0,0,0,0,0,100,NoArch
d977a32a90ef3841dfc0091556b40ef8b37f1285,1,1,0,1,1,1,0,1,19,14,1,1,0,324,3,38,9,34,34,0,1091,1084,7,27,27,0,0,100,NoArch
eac424e06c6dda01242169190cc8ddada84fe10a,2,54,67,13,121,0,0,0,155,0,1,2,0.121480478,2996,1,711,62,417,415,2,14908,14895,13,105,105,0,1,100,NoArch
79b4b80f4a729b8a364156f0d56ea8f1d63014f6,0,0,0,0,0,0,0,0,0,0,0,0,0,0,0,712,63,0,0,0,0,0,0,0,0,0,0,100,NoArch
bfbdcaeea273f8d1662cc7886df0c93bbe3eed8b,0,0,0,0,0,0,0,0,0,0,0,0,0,0,0,713,64,0,0,0,0,0,0,0,0,0,1,100,NoArch
071fc3ccf9f835192a909379f5ab7810373f570d,0,0,0,0,0,0,0,0,0,0,0,0,0,0,0,714,65,0,0,0,0,0,0,0,0,0,1,100,NoArch
37de414a6d8cae6bb798a2550738c780a7c9078f,0,0,0,0,0,0,0,0,0,0,0,0,0,0,0,715,66,0,0,0,0,0,0,0,0,0,1,100,NoArch
51ba11afe3c874f3405780549db5e71e3c8dc690,0,0,0,0,0,0,0,0,0,0,0,0,0,0,0,716,67,0,0,0,0,0,0,0,0,0,1,100,NoArch
a3d41f7c43a65340228ac4ecde80019a8270fa1d,0,0,0,0,0,0,0,0,0,0,0,0,0,0,0,717,68,0,0,0,0,0,0,0,0,0,0,100,NoArch
a2ca6a706c65b2ef744161a0658dd21b1ab44b79,1,3,1,2,4,0,0,0,4,7,1,1,0,588,2,1,1,62,61,1,1477,1445,32,27,27,0,0,100,NoArch
fe1da76aff5267df83fa4b32f72c8d49ba875765,1,20,4,16,24,0,0,0,8,7,1,1,0,506,2,2,2,49,48,1,1477,1431,46,15,15,0,0,100,NoArch
96af7561d048b526c1ec1cafa07e1896c919ea4f,1,108,1,107,109,0,0,0,14,15,1,1,0,222,3,39,10,39,21,18,1425,839,586,19,16,3,0,100,NoArch
847d5e8c469a64e01135e5ad730f0a2216cfbde3,1,6,6,0,12,0,0,0,9,40,1,1,0,338,2,40,11,82,82,0,1502,1496,6,18,18,0,0,100,NoArch
4bb39289ca4342361555641bbe1f5273d055bae7,1,4,6,2,10,0,0,0,2,130,1,1,0,74,2,41,12,2,2,0,138,147,9,2,2,0,0,100,NoArch
e537688685986dbc507f5146bc35d347f1c59e7d,1,1,1,0,2,0,0,0,5,15,1,1,0,109,2,42,13,6,6,0,328,333,5,4,4,0,0,100,NoArch
9411e347dd46bbc42695d463bec72ecaed0a490a,5,398,315,83,713,2,0,2,156,0,1,4,0.813155712,3730,3,718,64,516,511,5,17711,17579,132,166,164,2,0,99.67824968,NoArch
41f4eb0f1ec09977dbd7008ce9c1865cb66f0735,1,6,0,6,6,1,0,1,11,43,1,1,0,301,1,719,63,62,60,2,1339,1309,30,22,22,0,0,100,NoArch
b70f36d56a9825f3fe973863205f67f8ef09d4ac,1,15,13,2,28,0,0,0,157,0,1,1,0,2860,3,720,64,419,419,0,14862,14886,24,105,104,1,0,100,NoArch
eaf45abc4b36423cce83248d9aca120cd1d3e61d,0,0,0,0,0,0,0,0,0,0,0,0,0,0,0,721,65,0,0,0,0,0,0,0,0,0,0,100,NoArch
ea18d58d7fc55b4a8b357ade88b8de1e5011b1f8,1,9,0,9,9,1,0,1,19,17,1,1,0,275,1,722,66,38,36,2,1167,1132,35,23,21,2,0,100,NoArch
ba13268c92950bb9f4a062a62dfd6a605d039fac,1,97,4,93,101,0,0,0,11,60,1,1,0,610,1,723,67,84,69,15,2601,2229,372,42,40,2,0,100,NoArch
dce1ae493486d8d76c2cca36f9cdcdb66712cbf9,10,500,123,377,623,7,0,7,158,15,1,4,2.922772738,7049,2,724,68,1039,997,42,31299,30074,1225,510,460,50,1,98.9821883,NoArch
e311cb9b9fd0aad831dbe3fc5819c5b27d6b1bc1,4,110,82,28,192,0,0,0,94,8,1,3,1.628769122,6086,3,3,3,774,765,9,24749,24758,9,257,257,0,0,100,NoArch
be6693256a442ff201eda4213b605e7764baf4f4,0,0,0,0,0,0,0,0,0,0,0,0,0,0,0,725,62,0,0,0,0,0,0,0,0,0,0,100,NoArch
055f57bf262dc102a003314e2b7d12a1901b55eb,0,0,0,0,0,0,0,0,0,0,0,0,0,0,0,726,63,0,0,0,0,0,0,0,0,0,0,100,NoArch
5cb0456891cbc989c26974ddcd234bfb0ca6683b,0,0,0,0,0,0,0,0,0,0,0,0,0,0,0,727,60,0,0,0,0,0,0,0,0,0,0,100,NoArch
58525510aaa8d78b27cf9f489c781dbccd14fe7a,1,5,1,4,6,0,0,0,30,3,1,1,0,562,2,728,60,82,81,1,1833,1820,13,50,49,1,0,100,NoArch
b08550049b3b125057ee13504c8719b76eb6576c,3,36,7,29,43,1,0,1,159,118,1,3,1.254136555,4305,5,729,61,695,688,7,22759,22600,159,184,183,1,0,100,NoArch
f3645c2eaa2253605d0496524bec63bf9f8faa5b,1,0,20,20,20,0,0,0,3,275,1,1,0,20,2,4,4,0,2,2,0,62,62,0,2,2,0,99.8738966,NoArch
150576b3b10245ad7230b070ed74cec39aa02f2c,1,1,1,0,2,0,0,0,7,0,1,1,0,110,2,730,62,13,13,0,278,289,11,7,7,0,0,100,NoArch
5664847166ac465e31ee7480564d879835baf20e,1,12,7,5,19,0,0,0,9,5,1,1,0,522,2,5,5,50,49,1,1523,1477,46,15,15,0,0,100,NoArch
af85cf894ea97235988d361fca44082939ec6346,1,8,0,8,8,1,0,1,79,1,1,1,0,3380,4,6,6,401,399,2,10380,10352,28,100,100,0,0,100,NoArch
176e05c6fa58f252b34dad3af0af0c9df4c85638,0,0,0,0,0,0,0,0,0,0,0,0,0,0,0,16,1,0,0,0,0,0,0,0,0,0,0,100,NoArch
95a4a2fd207d14d4f975dcef7ad4b018d591c5d4,3,192,35,157,227,1,0,1,160,1,1,3,1.20425869,3002,1,731,63,435,420,15,15458,14944,514,114,106,8,0,99.74795211,NoArch
6aa5ee3a9ed1263cc3356bdb9f48551d769a8122,1,4,6,2,10,0,0,0,2,0,1,1,0,140,1,732,64,14,14,0,452,475,23,6,6,0,0,100,NoArch
879123a5f42d27565f411c02bd873e46c92ee263,3,49,20,29,69,1,0,1,161,49,1,2,0.741970504,3107,1,733,65,445,439,6,15673,15479,194,121,118,3,0,99.81120201,NoArch
e3c45697f48850c3514511a5de213cad05b572dd,1,20,17,3,37,0,0,0,162,0,1,1,0,2909,3,734,66,424,424,0,15103,15095,8,108,108,0,0,100,NoArch
c4cf3a342bbbbc243e56654e59342ccd58726941,0,0,0,0,0,0,0,0,0,0,0,0,0,0,0,10,8,0,0,0,0,0,0,0,0,0,0,100,NoArch
538c59870c728801ab61a03760f9754640a624f0,1,1,1,0,2,0,0,0,60,9,1,1,0,1489,4,735,67,277,277,0,6953,6962,9,58,58,0,0,100,NoArch
1b6089b695db8976b52f7200d8ab32632eb9557f,0,0,0,0,0,0,0,0,0,0,0,0,0,0,0,736,68,0,0,0,0,0,0,0,0,0,0,100,NoArch
d266592fa6ef4bc4abccd20e1c107da3b71e1378,0,0,0,0,0,0,0,0,0,0,0,0,0,0,0,737,69,0,0,0,0,0,0,0,0,0,0,100,NoArch
8f153cfa09fd102c0a727ce728a1785a12c91d8c,0,0,0,0,0,0,0,0,0,0,0,0,0,0,0,738,70,0,0,0,0,0,0,0,0,0,0,100,NoArch
754fccc0c08dda2ac16b14004a878cf162e94554,0,0,0,0,0,0,0,0,0,0,0,0,0,0,0,739,71,0,0,0,0,0,0,0,0,0,0,100,NoArch
4ad900573a9e8dc10a5f4bf0d5720745174b99a0,0,0,0,0,0,0,0,0,0,0,0,0,0,0,0,740,72,0,0,0,0,0,0,0,0,0,0,100,NoArch
6d51e7f59e70098137d2ec81ebbc2f08189b2714,0,0,0,0,0,0,0,0,0,0,0,0,0,0,0,741,73,0,0,0,0,0,0,0,0,0,0,100,NoArch
4590d6e7b170d3653af8eed6ad9f319e6ed33985,1,2,0,2,2,1,0,1,163,0,1,1,0,2912,3,742,74,421,424,3,14972,15103,131,108,108,0,0,100,NoArch
5005ace46b34b0452b374ac5ce65f2731223e4b0,0,0,0,0,0,0,0,0,0,0,0,0,0,0,0,743,75,0,0,0,0,0,0,0,0,0,0,100,NoArch
1d6029cf16fd7c16133377e2ec9a6919bb0f853c,1,11,12,1,23,0,0,0,164,0,1,1,0,2914,3,744,76,424,421,3,15106,14972,134,108,108,0,0,100,NoArch
4e447b054f64c7f1a1b815f1f5fd68f3c92b2fed,2,44,19,25,63,1,0,1,165,5,1,2,0.276195428,3580,3,745,77,541,536,5,17812,17701,111,162,161,1,0,100,NoArch
1ae3ad90858c74e009d2d60099471bb1e246a0cc,1,1,1,0,2,0,0,0,31,0,1,1,0,689,1,746,78,118,117,1,2693,2684,9,54,54,0,0,100,NoArch
56906240e7a47659fd5d73700b99a6fc6f2c7b85,0,0,0,0,0,0,0,0,0,0,0,0,0,0,0,747,79,0,0,0,0,0,0,0,0,0,0,100,NoArch
4aff6786e2e63607e8a907e5b69b895f1f1c8f1a,1,1,1,0,2,0,0,0,166,0,1,1,0,2916,3,748,80,424,424,0,15117,15128,11,108,108,0,0,100,NoArch
943eb3a31d8d80f473ebdc13e2f3327418c0c082,0,0,0,0,0,0,0,0,0,0,0,0,0,0,0,749,81,0,0,0,0,0,0,0,0,0,0,100,NoArch
b168f9f232bb6045f7b2837415df726839599a0f,0,0,0,0,0,0,0,0,0,0,0,0,0,0,0,750,82,0,0,0,0,0,0,0,0,0,0,100,NoArch
45e5c28d1e27961fc4bb6349080d431732dd969a,2,55,3,52,58,1,0,1,96,14,1,2,0.91244118,2441,6,11,9,462,433,29,12015,11757,258,83,83,0,0,100,NoArch
391c76a72c42bbaeee695645eb434604c6c2aee0,9,349,88,261,437,2,0,2,167,17,1,7,2.106735456,5401,1,751,83,723,686,37,25988,24913,1075,249,239,10,1,99.87421384,NoArch
cb8da7a38318521bb6cf2d25483f46273d2c1b39,4,36,12,24,48,0,0,0,168,10,1,2,1.269659458,4631,1,752,84,730,726,4,23155,23029,126,209,207,2,0,100,NoArch
2212ba73b46b1541eeb42239943786924dcaef69,0,0,0,0,0,0,0,0,0,0,0,0,0,0,0,753,85,0,0,0,0,0,0,0,0,0,1,100,NoArch
34c3207e037de4af179d87d62fa2e6ed4f2824a9,2,7,42,35,49,0,0,0,34,0,1,2,0.591672779,1286,1,754,86,203,202,1,5971,5947,24,78,78,0,0,100,NoArch
a0a22bfed288a12fb6a2c8ade94966ae501c9ad0,0,0,0,0,0,0,0,0,0,0,0,0,0,0,0,755,87,0,0,0,0,0,0,0,0,0,0,100,NoArch
6ea75b76fffe8d055b79850f42acd62509e2fdf4,2,19,13,6,32,0,0,0,169,1,1,2,0.811278124,3172,1,756,88,452,446,6,15789,15745,44,114,114,0,1,100,NoArch
5f6238bbbb40993ba6ddda28d909aaaf7d1a9f3d,2,12,3,9,15,0,0,0,170,0,1,2,0.996791632,3178,1,757,89,453,452,1,15812,15789,23,114,114,0,1,100,NoArch
70380ce1fd7d7f088a7b1a3a573f0ddccaf4123d,3,63,11,52,74,0,0,0,171,26,1,3,1.364687837,5017,2,758,90,829,818,11,25385,25051,334,237,237,0,1,100,NoArch
09de6e1af1964e07eef889cee94e990e400131f2,0,0,0,0,0,0,0,0,0,0,0,0,0,0,0,759,91,0,0,0,0,0,0,0,0,0,0,100,NoArch
9e72220babe2fc342a2971e026106235fec2ae44,0,0,0,0,0,0,0,0,0,0,0,0,0,0,0,760,92,0,0,0,0,0,0,0,0,0,0,100,NoArch
1d7e818612a7ffe89a01f302abf2367104ce0edb,1,4,0,4,4,1,0,1,6,290,1,1,0,255,1,761,91,40,39,1,966,950,16,18,17,1,0,100,NoArch
e1d24748cdf10c16076cb7f6ca49fc62fe775852,0,0,0,0,0,0,0,0,0,0,0,0,0,0,0,762,87,0,0,0,0,0,0,0,0,0,0,100,NoArch
e97e624194b70d2bc7fe30b4acdb9487b1d4fa8a,2,12,4,8,16,1,0,1,172,6,1,2,0.811278124,3576,2,763,82,551,549,2,18415,18363,52,180,179,1,0,100,NoArch
df1c4c57fb7e03e5fe4cf1df59818717b7121489,2,48,3,45,51,0,0,0,62,83,1,2,0.997502546,1586,2,0,0,290,285,5,7514,7294,220,64,63,1,0,100,NoArch
e10f663b8c8c94e63777389f88d022f09a43eb5a,1,1,1,0,2,0,0,0,63,0,1,1,0,1516,5,1,1,284,284,0,7116,7125,9,58,58,0,0,100,NoArch
9ead0b3f69dca62cbfebc9da49f3cc4819c93196,6,55,8,47,63,4,0,4,173,18,1,5,2.125872786,5751,3,764,74,921,917,4,29247,29092,155,286,284,2,1,97.55952381,Arch
3ae5b650007dd57fe7829aaa1867713f440ac935,1,12,13,1,25,0,0,0,15,29,1,1,0,329,4,5,1,39,39,0,1416,1425,9,19,19,0,0,100,NoArch
bd8a0514d7c2314936b32abd2f76304d45d8a7a0,0,0,0,0,0,0,0,0,0,0,0,0,0,0,0,765,65,0,0,0,0,0,0,0,0,0,0,100,NoArch
4b149f9313d533870ec9292c62295a4c3d38f9d4,3,440,0,440,440,3,0,3,1,0,1,1,1.544075924,0,1,12,2,35,0,35,1422,0,1422,19,0,19,0,99.54929577,NoArch
2259f17efe251d733736b69c4e49c3d11ba4f1d6,0,0,0,0,0,0,0,0,0,0,0,0,0,0,0,13,3,0,0,0,0,0,0,0,0,0,0,100,NoArch
0c2e312055c62c08c393adfbe701c867c230e2ed,1,10,6,4,16,0,0,0,6,41,1,1,0,216,2,43,4,24,24,0,742,722,20,9,9,0,0,100,NoArch
d204cd4f5b632db583eea7fb459a93ae14d864f5,0,0,0,0,0,0,0,0,0,0,0,0,0,0,0,14,4,0,0,0,0,0,0,0,0,0,0,100,NoArch
8cc0f1046ec653f395d4614f6fce7961310541e1,9,114,35,79,149,3,0,3,174,49,1,4,2.465271362,6182,1,766,54,972,955,17,29850,29390,460,322,316,6,1,100,NoArch
faa1d011b6a42c7d8819586b08485cdcf73d0ecb,0,0,0,0,0,0,0,0,0,0,0,0,0,0,0,15,5,0,0,0,0,0,0,0,0,0,0,100,NoArch
95a41a10544b7c0ca7a2ce00c42926c00fa163d4,1,1,1,0,2,0,0,0,2,3,1,1,0,139,1,16,6,12,12,0,479,479,0,7,7,0,0,100,NoArch
28e06fb046af95087a42a92310b130ee5486b354,2,21,1,20,22,1,0,1,64,35,1,2,0.994030211,1654,1,767,51,296,293,3,7613,7520,93,68,66,2,1,99.94388328,NoArch
ae74826eb4e8ba411babe433218dc34194f4c3c4,0,0,0,0,0,0,0,0,0,0,0,0,0,0,0,768,50,0,0,0,0,0,0,0,0,0,0,100,NoArch
e568a2e6bafb1bc01d55c8c5519568cb78b17fef,0,0,0,0,0,0,0,0,0,0,0,0,0,0,0,769,51,0,0,0,0,0,0,0,0,0,0,100,NoArch
e51b662f2f9fe8208d6dd0f57a1ccd80f9e3d87e,2,63,27,36,90,0,0,0,3,1,1,1,0.994292935,247,1,17,7,24,19,5,1176,843,333,11,10,1,0,100,NoArch
51df4f8fb44d67437e7a9ef54cc2fd98c59932c9,5,34,74,40,108,0,0,0,88,60,1,3,0.799786557,4707,5,770,52,614,610,4,15864,15746,118,375,371,4,1,100,NoArch
a10a0b5f0ed0f2a085c3ae7f76f3a87ebbdc2e11,2,9,9,0,18,0,0,0,4,0,1,1,0.99107606,283,1,18,8,24,24,0,1198,1176,22,11,11,0,0,100,NoArch
5e943e217a093bd378dc6bb00fbafe656cc8f8cb,0,0,0,0,0,0,0,0,0,0,0,0,0,0,0,19,9,0,0,0,0,0,0,0,0,0,0,100,NoArch
44571e8536e6044c9f00dde68c6515a4c85485d0,0,0,0,0,0,0,0,0,0,0,0,0,0,0,0,17,1,0,0,0,0,0,0,0,0,0,0,100,NoArch
06d2985c721ccadcc72207b63629b8da5cf8c768,6,169,23,146,192,2,0,2,65,47,1,3,1.911838181,1885,2,18,2,327,312,15,8606,8145,461,91,79,12,1,99.60828204,NoArch
c785d8266e6c426cfbc61257eb43f8c081a090a5,1,63,2,61,65,0,0,0,2,0,1,1,0,17,1,19,3,3,1,2,114,38,76,3,1,2,1,100,NoArch
67f93f70cab75e498bde7deb5ddbdb997a88f7f2,1,5,1,4,6,0,0,0,66,0,1,1,0,1552,6,771,46,292,291,1,7273,7249,24,62,62,0,1,100,NoArch
dea75c6129e25b941c01c903fb325412a2c0624e,0,0,0,0,0,0,0,0,0,0,0,0,0,0,0,772,47,0,0,0,0,0,0,0,0,0,0,100,NoArch
0a05e0ca44ce1bb0df8eac348268667636c5ec27,1,17,5,12,22,0,0,0,3,218,1,1,0,261,1,773,48,34,33,1,1033,1003,30,25,24,1,0,100,NoArch
3ce6bc3e6b9b7af0ddfa640eac517c06acb98596,0,0,0,0,0,0,0,0,0,0,0,0,0,0,0,774,49,0,0,0,0,0,0,0,0,0,0,100,NoArch
cc907770c7872e2a8e087c0cb788d298e1525ccd,0,0,0,0,0,0,0,0,0,0,0,0,0,0,0,775,48,0,0,0,0,0,0,0,0,0,0,100,NoArch
fc5ae197b170d08192cc6ac64146848cc839e528,1,0,2,2,2,0,0,0,4,1,1,1,0,100,2,776,48,8,8,0,269,278,9,7,7,0,0,100,NoArch
f5aab714d7bf2976d2ebe6f3a1f9d1350c1fc9a3,0,0,0,0,0,0,0,0,0,0,0,0,0,0,0,777,44,0,0,0,0,0,0,0,0,0,0,100,NoArch
88b8f009374c3c1bb3c8e5b363f7cb34da27c1ac,1,1,1,0,2,0,0,0,6,89,1,1,0,463,1,778,45,67,67,0,1960,1960,0,19,19,0,0,100,NoArch
ef816c07f9ea7b83271f4d884e550873380a3231,0,0,0,0,0,0,0,0,0,0,0,0,0,0,0,779,46,0,0,0,0,0,0,0,0,0,0,100,NoArch
504f52d02977f3da15623d2e1547ebedb5e7e59a,9,144,18,126,162,7,0,7,175,86,1,3,2.835030466,7128,1,780,47,1053,1024,29,31112,30416,696,492,465,27,0,99.88826816,NoArch
ca215d2c62392e64db6f8798549f2b448b400653,0,0,0,0,0,0,0,0,0,0,0,0,0,0,0,781,47,0,0,0,0,0,0,0,0,0,0,100,NoArch
0d949a30d31d8a8ea7f694bf15775b509d40103b,0,0,0,0,0,0,0,0,0,0,0,0,0,0,0,782,47,0,0,0,0,0,0,0,0,0,0,100,NoArch
178a484a7233e6025b1970f1aa373801bf3c23f7,0,0,0,0,0,0,0,0,0,0,0,0,0,0,0,783,48,0,0,0,0,0,0,0,0,0,0,100,NoArch
eada6c4df440a0a4e007e12f87abdc0cafa9f0a4,1,55,27,28,82,0,0,0,6,8,1,1,0,163,1,784,48,23,17,6,566,438,128,10,10,0,1,100,NoArch
92bf887a7bb49ae6c3d158735b4d3e9a02ae9aa2,0,0,0,0,0,0,0,0,0,0,0,0,0,0,0,785,45,0,0,0,0,0,0,0,0,0,0,100,NoArch
f3d7bb48ad3c843f091591641285842ba530078a,2,177,3,174,180,0,0,0,67,12,1,2,0.987137774,1671,2,2,2,324,298,26,8689,7662,1027,81,68,13,0,100,NoArch
f1d8b32459aabe3d4a2c006b29721c071c8a0075,0,0,0,0,0,0,0,0,0,0,0,0,0,0,0,786,35,0,0,0,0,0,0,0,0,0,0,100,NoArch
51ed8475d71f915e09120723c0301a26fcf4b7fc,0,0,0,0,0,0,0,0,0,0,0,0,0,0,0,787,36,0,0,0,0,0,0,0,0,0,0,100,NoArch
c91f621eb11a62ac07902cd0b3aded91dec148d2,1,2458,26,2432,2484,0,0,0,5,108,1,1,0,168,1,788,37,153,16,137,3432,419,3013,146,9,137,0,100,NoArch
d93edcd0d5616058d0e03939ef80b3c6ca10c56f,0,0,0,0,0,0,0,0,0,0,0,0,0,0,0,789,38,0,0,0,0,0,0,0,0,0,0,100,NoArch
dfafbc4df63c168d47a9f70a4f2cd5937741a2c0,0,0,0,0,0,0,0,0,0,0,0,0,0,0,0,790,39,0,0,0,0,0,0,0,0,0,0,100,NoArch
fe5424fdb08cd33fc6909e126545d15220d61326,1,1,1,0,2,0,0,0,4,9,1,1,0,121,1,20,9,8,8,0,512,507,5,4,4,0,0,100,NoArch
28aa026e4bff36b86f5e68cd954d0f9543cef115,1,24,1,23,25,0,0,0,5,9,1,1,0,162,1,21,10,16,16,0,658,691,33,7,7,0,0,100,NoArch
ea49c43e4ab61e16e8064e4aca1d6d411b8643d4,2,15,65,50,80,0,0,0,6,2,1,1,0.848548178,306,1,22,10,20,24,4,973,1170,197,9,11,2,0,100,NoArch
f07dc9853a376457a771998591158e3a330cf47f,1,59,37,22,96,0,0,0,99,17,1,1,0,1387,6,791,37,274,268,6,7778,7665,113,72,72,0,0,100,NoArch
e9e31bb0eea36b9ff64fe2466ab523f727033d65,1,4,0,4,4,1,0,1,4,471,1,1,0,167,1,792,36,17,16,1,482,467,15,9,8,1,0,100,NoArch
4e1022e309b5db61188373daf0ae5498a24efd9d,2,36,6,30,42,1,0,1,176,22,1,2,0.918295834,3633,2,793,35,567,561,6,18902,18771,131,185,182,3,0,100,NoArch
8f46d18507d53ef83d6040f375f76c4c25baf8d0,0,0,0,0,0,0,0,0,0,0,0,0,0,0,0,23,11,0,0,0,0,0,0,0,0,0,0,100,NoArch
53b8d6b86e8229ad16c3efcbddab0f41e0fed559,0,0,0,0,0,0,0,0,0,0,0,0,0,0,0,24,12,0,0,0,0,0,0,0,0,0,0,100,NoArch
64e65829fa69dec52d9653087f9d6e65e59b9028,49,11877,6007,5870,17884,20,1,21,177,100,1,17,3.687871899,17415,2,7,0,2368,2146,222,68232,71669,3437,656,855,199,0,96.74033149,Arch
7f121aecb42afbf93edc877f606c5db61731a144,0,0,0,0,0,0,0,0,0,0,0,0,0,0,0,8,1,0,0,0,0,0,0,0,0,0,0,100,NoArch
8d1ec82ba968b6be683acb4b07b59227e88910a5,1,170,0,170,170,1,0,1,1,0,1,1,0,0,1,794,31,12,0,12,600,0,600,2,0,2,0,99.78201635,NoArch
178ed499c60256b45eefec67fffa07df6cd8a930,1,463,131,332,594,0,0,0,2,3,1,1,0,170,1,795,31,26,12,14,901,600,301,15,2,13,0,100,NoArch
07a496501aec68bdd3a58048fd00b72323142ed3,1,33,6,27,39,0,0,0,32,27,1,1,0,568,2,25,13,85,82,3,1996,1839,157,50,50,0,0,100,NoArch
8a0db92bc808bfde10fa0ffa78d732083dd01171,1,19,8,11,27,0,0,0,33,0,1,1,0,595,2,26,14,89,85,4,2059,1996,63,50,50,0,0,100,NoArch
89a130107fcee4596e0df33fea61241cfcd326e9,2,13,5,8,18,1,0,1,81,64,1,2,0.964078765,4308,4,9,2,403,402,1,10860,10838,22,100,99,1,3,100,NoArch
1f1dea53ee57d63f0bce43c8a78fe2f43ca1603f,4,274,190,84,464,0,0,0,101,12,1,4,1.75950619,3965,2,10,3,444,422,22,14662,14140,522,112,105,7,1,98.06927882,NoArch
b5389c09a13e70e03cb07470066a9c43534cd73c,0,0,0,0,0,0,0,0,0,0,0,0,0,0,0,11,4,0,0,0,0,0,0,0,0,0,1,100,NoArch
b57c6b98f8f7e5e904919d8cb28394044d7675b3,1,334,287,47,621,0,0,0,3,14,1,1,0,502,1,796,25,30,26,4,1017,901,116,15,15,0,0,100,NoArch
9e709886f36c2d2eac483e9a02350eb6f509d2fe,1,1,0,1,1,1,0,1,4,0,1,1,0,549,2,27,7,30,30,0,1022,1017,5,15,15,0,0,100,NoArch
2671c6826362ea0a2ff7154ffcff1a623916a37f,1,1,3,2,4,0,0,0,3,4,1,1,0,327,1,12,5,48,48,0,824,841,17,6,6,0,1,99.76261128,NoArch
e7b1ed119681f0f70b190c88032e08cb8a61e0f9,1,1,4,3,5,0,0,0,178,20,1,1,0,3136,4,13,6,471,471,0,16376,16382,6,116,116,0,1,100,NoArch
d6bf9986346a7744a3d85110adcf6949c394262d,2,30,0,30,30,2,0,2,90,34,1,1,0.970950594,4181,2,44,0,591,584,7,15270,15069,201,373,372,1,0,100,NoArch
da4b716b8c1dc297e2f67088e42cb0522b8484e1,1,5,2,3,7,0,0,0,7,120,1,1,0,162,2,45,1,13,13,0,649,635,14,4,4,0,0,100,NoArch
4af15e21d9305a10e2902ddcd0bcae695e56d3bf,1,27,14,13,41,0,0,0,5,1,1,1,0,550,3,46,2,34,30,4,1115,1022,93,15,15,0,0,100,NoArch
a0218054fd4012ae87937e0a2818ad33bf5c7b2b,0,0,0,0,0,0,0,0,0,0,0,0,0,0,0,797,20,0,0,0,0,0,0,0,0,0,0,100,NoArch
c38dc7208744f1a7388f7471b277add7929e17b3,5,348,205,143,553,3,0,3,179,102,1,3,0.613956963,3620,2,14,7,526,516,10,17632,17411,221,160,155,5,4,98.95227008,NoArch
1e1da45e27eb6799657de1f854fb05caf8b5387e,1,1,1,0,2,0,0,0,2,26,1,1,0,271,1,15,8,44,44,0,748,744,4,7,7,0,0,100,NoArch
a2000747487e63c915b968a016df1088c211faae,1,3,10,7,13,0,0,0,82,23,1,1,0,4069,4,16,9,378,377,1,9990,9984,6,85,85,0,1,100,NoArch
90be14065379ef971c2d6c7b7e9339e5810d9ccf,0,0,0,0,0,0,0,0,0,0,0,0,0,0,0,798,4,0,0,0,0,0,0,0,0,0,0,100,NoArch
69d0de98ba22a4fd29fd9373c34971964f34c788,1,27,0,27,27,1,0,1,6,336,1,1,0,543,1,799,5,73,70,3,3081,2940,141,13,12,1,0,100,NoArch
fc32d52a7aca726cb3112c6451f398723f0a2f62,0,0,0,0,0,0,0,0,0,0,0,0,0,0,0,800,6,0,0,0,0,0,0,0,0,0,0,100,NoArch
de790eb0429cf1171763daa02dc07502a021d213,1,3,1,2,4,0,0,0,180,16,1,1,0,3239,5,6,0,478,478,0,16486,16474,12,119,119,0,1,100,NoArch
6332adbbade14aa8d733c4be5c52a40f219b3dde,0,0,0,0,0,0,0,0,0,0,0,0,0,0,0,801,6,0,0,0,0,0,0,0,0,0,0,100,NoArch
ad4c491c668aa2b6a3a65746b6fc1f9da091b420,1,21,0,21,21,1,0,1,91,21,1,1,0,3665,5,802,7,493,491,2,12659,12609,50,305,304,1,0,100,NoArch
c9a38bcf81f36b307b8057b6db2378dbbeb65538,1,3,0,3,3,1,0,1,3,521,1,1,0,164,1,803,8,16,16,0,618,606,12,8,8,0,0,100,NoArch
a3e6ae2266906e3c436981835a487c799fb71a79,0,0,0,0,0,0,0,0,0,0,0,0,0,0,0,28,3,0,0,0,0,0,0,0,0,0,0,100,NoArch
fd25873209a08f7764c8d6e4bbb4394b3f23a88a,0,0,0,0,0,0,0,0,0,0,0,0,0,0,0,29,4,0,0,0,0,0,0,0,0,0,0,100,NoArch
885df128e2616f9758911b63cf3d5a3caac44474,25,1182,190,992,1372,11,0,11,181,81,1,12,3.719774026,12862,3,804,9,1928,1805,123,57881,53570,4311,825,761,64,1,98.15242494,NoArch
3d8fed2fad4769ff34b596d5b12b5864060edc61,1,17,9,8,26,0,0,0,17,0,1,1,0,447,4,805,10,56,54,2,2074,1981,93,24,24,0,1,100,NoArch
815167578c623345ed834a18f0bb25895fd92d8c,1,1,1,0,2,0,0,0,9,43,1,1,0,219,3,47,3,23,23,0,741,741,0,9,9,0,0,100,NoArch
ef50efb61fa3de82667a8699a9c53c4fe32583a4,1,10,25,15,35,0,0,0,6,23,1,1,0,563,3,48,4,33,34,1,1079,1115,36,15,15,0,0,100,NoArch
f879a4dbc5e56da7e8cb4c2f994a082cad89da81,1,9,3,6,12,0,0,0,34,40,1,1,0,606,3,49,5,90,89,1,2084,2059,25,50,50,0,0,100,NoArch
5f316f598c1b10289da642b24629eab6e878e366,0,0,0,0,0,0,0,0,0,0,0,0,0,0,0,30,3,0,0,0,0,0,0,0,0,0,0,100,NoArch
44fd5c6b4353fd6ba5946acca589b5881dd81f60,1,26,0,26,26,1,0,1,10,114,1,1,0,142,2,806,10,14,12,2,387,302,85,9,7,2,0,100,NoArch
73db4c06b239b95f0f7db44e703c7f73adf91b2a,1,8,0,8,8,1,0,1,11,0,1,1,0,168,2,807,11,15,14,1,423,387,36,10,9,1,0,100,NoArch
9ffe8af10c0fc460976e9db71d85622349856ab4,1,65,5,60,70,0,0,0,93,3,1,1,0,3693,5,20,0,499,493,6,12804,12696,108,311,305,6,1,100,NoArch
77f3dbea98222de3104b58a053880296d07c58e0,0,0,0,0,0,0,0,0,0,0,0,0,0,0,0,808,12,0,0,0,0,0,0,0,0,0,0,100,NoArch
67813dcec2eb492efe07029cda1d0e8cf6a945c5,0,0,0,0,0,0,0,0,0,0,0,0,0,0,0,31,4,0,0,0,0,0,0,0,0,0,0,100,NoArch
17265d49fc1714a75a42f5321ff53452921b4af9,1,19,0,19,19,1,0,1,94,5,1,1,0,3753,5,21,1,502,499,3,12892,12804,88,312,311,1,1,100,NoArch
52a25d615979d962acd69493f26c75659d89da74,3,298,259,39,557,2,0,2,95,0,1,1,1.30083854,3772,1,22,2,502,502,0,12964,12892,72,312,312,0,0,99.70896391,NoArch
a0a831f4e3eec5ec04b561a02846c07031f63780,58,4392,2185,2207,6577,17,2,19,102,54,1,19,4.783718138,15590,3,17,7,1725,1611,114,53293,49309,3984,654,590,64,0,95.50625711,Arch
662a3102da84db0c64763cdaf685f44ed374ecb8,1,0,23,23,23,0,1,1,2,662,1,1,0,23,2,18,8,0,2,2,0,93,93,0,2,2,0,99.88839286,NoArch
b6f06c8c3a3d2dbedc392225b8898f30048bb38b,1,20,1,19,21,0,0,0,2,0,1,1,0,901,1,19,9,87,86,1,2485,2407,78,33,32,1,0,100,NoArch
ccbc057fde314c6d3e516cb9a8b9d1a057ea5dad,0,0,0,0,0,0,0,0,0,0,0,0,0,0,0,32,5,0,0,0,0,0,0,0,0,0,0,100,NoArch
4699a75ea5066209398fefca184c879f58c39747,0,0,0,0,0,0,0,0,0,0,0,0,0,0,0,33,6,0,0,0,0,0,0,0,0,0,0,100,NoArch
1e9996c1252fc6c5d6d09f9c7f2ec4dd2d89aeeb,0,0,0,0,0,0,0,0,0,0,0,0,0,0,0,34,7,0,0,0,0,0,0,0,0,0,0,100,NoArch
62be3d14e053041d538acea85a9d904a2dfc11e8,0,0,0,0,0,0,0,0,0,0,0,0,0,0,0,35,8,0,0,0,0,0,0,0,0,0,0,100,NoArch
1e0432cd704af92b6e5fdfc101e1be87b53e3b4a,0,0,0,0,0,0,0,0,0,0,0,0,0,0,0,23,3,0,0,0,0,0,0,0,0,0,0,100,NoArch
585584f852ee248a445599f64e0c3cf81efc735e,0,0,0,0,0,0,0,0,0,0,0,0,0,0,0,24,4,0,0,0,0,0,0,0,0,0,0,100,NoArch
80cfe0c31dcb5b714929b2635ca6a8f237ec576e,3,71,40,31,111,0,0,0,19,0,1,2,0.501809022,1866,1,20,10,186,186,0,5419,5578,159,77,78,1,0,100,NoArch
0885117cb58b4828e8ab2702ae44f9bc65a2be71,1,69,0,69,69,1,0,1,1,0,1,1,0,0,1,21,11,3,0,3,67,0,67,3,0,3,0,99.77691021,NoArch
a0692c4a27d768b3239ba269a71e459f5f1a6fec,0,0,0,0,0,0,0,0,0,0,0,0,0,0,0,809,13,0,0,0,0,0,0,0,0,0,0,100,NoArch
351809ae898c80ca18d59fecf68a37c1b97a2058,6,81,37,44,118,1,0,1,22,7,1,2,2.1705981,1297,1,810,13,162,156,6,5148,5004,144,96,92,4,1,99.61046188,NoArch
305bcc5110c98101208d14692be0bd63c07a3047,0,0,0,0,0,0,0,0,0,0,0,0,0,0,0,811,13,0,0,0,0,0,0,0,0,0,0,100,NoArch
ec4ceae429964ad84c6406df5c2d11109ec28eda,1,61,0,61,61,1,0,1,96,12,1,1,0,3513,5,25,5,461,456,5,12214,12033,181,270,268,2,1,100,NoArch
1300afeba973a2abe2281de17def76e909030baf,1,1,1,0,2,0,0,0,97,0,1,1,0,3574,5,26,6,461,461,0,12213,12214,1,270,270,0,0,100,NoArch
22fdab732e327cc29f04534ca64b0b5c470b6305,0,0,0,0,0,0,0,0,0,0,0,0,0,0,0,812,14,0,0,0,0,0,0,0,0,0,0,100,NoArch
65a95ffffcc94b2fa72d73f138c46e0660ab7ff6,0,0,0,0,0,0,0,0,0,0,0,0,0,0,0,813,15,0,0,0,0,0,0,0,0,0,0,100,NoArch
552a38d5976b3d003bd4af2c01ab0bf8c2dd8937,14,512,62,450,574,8,0,8,98,113,1,6,3.077565413,8195,2,50,3,1254,1194,60,34532,32542,1990,495,470,25,0,99.77802442,NoArch
66f3e054707ed3055265fa87d1d9c550002ce48d,2,2,3,1,5,0,0,0,7,62,1,1,0.721928095,458,2,51,4,62,62,0,1610,1617,7,27,27,0,0,100,NoArch
570ef451fc9e21c051f0ffcd339287002b3f2c50,0,0,0,0,0,0,0,0,0,0,0,0,0,0,0,52,5,0,0,0,0,0,0,0,0,0,0,100,NoArch
eef5cd77202525d53d3a707c8b4c505aab1e6f35,3,79,11,68,90,0,0,0,99,12,1,2,1.314501995,4032,1,53,6,521,512,9,14228,13897,331,304,298,6,0,100,NoArch
f114b78d043a32938b40b304ee234313ce98c116,2,41,24,17,65,1,0,1,100,0,1,2,0.950079625,3615,5,54,7,467,467,0,12389,12379,10,276,276,0,0,99.88938053,NoArch
c6b9a37642fca102d5504e61bdb48fb119f9bfdb,3,36,5,31,41,0,0,0,11,30,1,3,1.12824682,747,4,27,7,78,70,8,2244,2078,166,40,37,3,0,100,NoArch
e196e7a2d7eb4a371bad5d9cdfbb7b6db966bcf2,1,98,0,98,98,1,0,1,101,6,1,1,0,3591,5,28,8,476,463,13,12630,12263,367,279,272,7,1,100,NoArch
1544d9543eb7367ae766df0ab383dcf474dc9a33,4,72,72,0,144,0,0,0,103,45,1,2,1.291754474,7055,4,22,5,671,671,0,18389,18389,0,181,181,0,0,100,NoArch
e5cfb69fc14f963693e839e1c6197b53318590c9,1,0,1,1,1,0,0,0,71,12,1,1,0,1688,7,29,8,314,314,0,8121,8127,6,63,63,0,2,100,NoArch
7b010f3c08a85f740413d02ea0b17e0bb867b426,0,0,0,0,0,0,0,0,0,0,0,0,0,0,0,30,9,0,0,0,0,0,0,0,0,0,1,100,NoArch
3a78e996507a954040e8e6c32b25801250c2a201,0,0,0,0,0,0,0,0,0,0,0,0,0,0,0,31,8,0,0,0,0,0,0,0,0,0,1,100,NoArch
e2ef7fe879797c8f2c4f3057d66adc3c51950ffe,1,1,2,1,3,0,0,0,3,17,1,1,0,226,1,55,5,25,25,0,894,908,14,12,12,0,0,100,NoArch
99174ae28f654dfa81117437f410522def61eeca,0,0,0,0,0,0,0,0,0,0,0,0,0,0,0,32,7,0,0,0,0,0,0,0,0,0,0,100,NoArch
de0c0f935d6cbd6c620815bd964be62fdd42fb50,1,11,14,3,25,0,0,0,12,122,1,1,0,202,3,56,6,23,24,1,796,810,14,17,17,0,1,100,NoArch
243e433b2575f01aa5d4a77ff311cffaab964f65,1,1,0,1,1,1,0,1,10,167,1,1,0,296,3,23,1,45,45,0,1669,1658,11,41,41,0,0,100,NoArch
43139899afcf0ed7d4d0a0566dc402f0106c8e11,0,0,0,0,0,0,0,0,0,0,0,0,0,0,0,24,2,0,0,0,0,0,0,0,0,0,1,100,NoArch
57cc66d2822081a8d2dc1a82b4deffb72ceed1cb,0,0,0,0,0,0,0,0,0,0,0,0,0,0,0,57,7,0,0,0,0,0,0,0,0,0,1,100,NoArch
bfab82e4fb499c11ed76b39d5afc5df68c11bb09,1,59,2,57,61,0,0,0,4,42,1,1,0,920,1,25,3,93,88,5,2647,2489,158,34,33,1,0,100,NoArch
06257a79858e55ea2e388aa54ee1b4208844a270,0,0,0,0,0,0,0,0,0,0,0,0,0,0,0,814,4,0,0,0,0,0,0,0,0,0,0,100,NoArch
5e318dc5321bfd37f64492f293d5d09087c7406b,0,0,0,0,0,0,0,0,0,0,0,0,0,0,0,815,5,0,0,0,0,0,0,0,0,0,0,100,NoArch
09ee41313e7c74f6ddf8a35ed3116714e54ff039,0,0,0,0,0,0,0,0,0,0,0,0,0,0,0,816,6,0,0,0,0,0,0,0,0,0,0,100,NoArch
190d7e4d09b24689749283b162b73cb9b201f4bc,0,0,0,0,0,0,0,0,0,0,0,0,0,0,0,0,0,0,0,0,0,0,0,0,0,0,0,100,NoArch
bd0443d6cd26693b7f2d4b756e0551e40e25f5a0,0,0,0,0,0,0,0,0,0,0,0,0,0,0,0,36,0,0,0,0,0,0,0,0,0,0,0,100,NoArch
6e0aa54ebe4fa7502cb2904e5c0f0630604ccc0e,0,0,0,0,0,0,0,0,0,0,0,0,0,0,0,37,1,0,0,0,0,0,0,0,0,0,0,100,NoArch
9b18dbcca47f2621443b135bd5eb348638ab9665,0,0,0,0,0,0,0,0,0,0,0,0,0,0,0,58,8,0,0,0,0,0,0,0,0,0,0,100,NoArch
eb4fd5f374ac809ddef67c9da6ae8404c38ced7d,1,1,1,0,2,0,0,0,11,52,1,1,0,219,3,817,5,23,23,0,730,741,11,9,9,0,0,100,NoArch
074f59e21783371cef3e59e1d0c2c6dc215e08a2,1,142,1,141,143,0,0,0,102,20,1,1,0,3689,5,38,2,493,476,17,13266,12630,636,281,279,2,0,100,NoArch
0ccaaa48f715175f3606e4c45bccc1209cd9b8f3,5,65,19,46,84,2,0,2,72,131,1,3,2.062582091,3581,3,1,1,638,627,11,17259,16996,263,222,219,3,0,100,NoArch
f2760e588101b974844fc490a16209c4ca3ae0ea,0,0,0,0,0,0,0,0,0,0,0,0,0,0,0,33,6,0,0,0,0,0,0,0,0,0,1,100,NoArch
9fdb933f3bfb1c842e1e51da89a2876d31b9b841,0,0,0,0,0,0,0,0,0,0,0,0,0,0,0,34,7,0,0,0,0,0,0,0,0,0,0,100,NoArch
cc848b62596cda33f283c68f8101f601d2ab8ef7,0,0,0,0,0,0,0,0,0,0,0,0,0,0,0,35,8,0,0,0,0,0,0,0,0,0,0,100,NoArch
1e8892a0f5d1415a2ecffafecb6dd19cf18f8da7,1,3,6,3,9,0,0,0,103,3,1,1,0,3830,5,36,9,493,493,0,13243,13266,23,281,281,0,0,100,NoArch
856a4417732541272db9c5bc3d79c3f585578a64,0,0,0,0,0,0,0,0,0,0,0,0,0,0,0,37,10,0,0,0,0,0,0,0,0,0,0,100,NoArch
615048528f0d502892ff4470386e3513dda65fe1,1,1,0,1,1,1,0,1,104,0,1,1,0,3827,5,38,11,493,493,0,13243,13243,0,281,281,0,0,100,NoArch
8ea532994756c2178365a8aab62f70e4dee87eba,1,35,30,5,65,0,0,0,21,54,1,1,0,496,5,39,12,55,52,3,1958,1896,62,23,23,0,1,100,NoArch
d2c35c04b0a58118377cfda21df3552ae01e1095,0,0,0,0,0,0,0,0,0,0,0,0,0,0,0,40,13,0,0,0,0,0,0,0,0,0,0,100,NoArch
d4c64af789dadec493c24a493c6cb0389f7bdc5d,0,0,0,0,0,0,0,0,0,0,0,0,0,0,0,41,14,0,0,0,0,0,0,0,0,0,0,100,NoArch
e0f2296de78c2e156bdfbbdfec8aca7b3732d3bd,0,0,0,0,0,0,0,0,0,0,0,0,0,0,0,42,15,0,0,0,0,0,0,0,0,0,0,100,NoArch
36b130e72c008688bd24038aeb653e47d400be62,0,0,0,0,0,0,0,0,0,0,0,0,0,0,0,43,16,0,0,0,0,0,0,0,0,0,0,100,NoArch
58bfb33ebde0705dddf33fe031cdd855d56ec1ed,0,0,0,0,0,0,0,0,0,0,0,0,0,0,0,44,17,0,0,0,0,0,0,0,0,0,0,100,NoArch
9d97588e9b55cc43ccda04db0743764fef522b9d,0,0,0,0,0,0,0,0,0,0,0,0,0,0,0,45,18,0,0,0,0,0,0,0,0,0,0,100,NoArch
176646eb552fb94eff2bd9384b53e61a98763d2d,0,0,0,0,0,0,0,0,0,0,0,0,0,0,0,46,19,0,0,0,0,0,0,0,0,0,0,100,NoArch
12c0c63f9d5546c6989c6b65ee97d1c9423d0151,0,0,0,0,0,0,0,0,0,0,0,0,0,0,0,47,20,0,0,0,0,0,0,0,0,0,0,100,NoArch
e010b85525de1c3abfad3a8fc6236e8366f85266,2,279,7,272,286,1,0,1,7,32,1,2,0.403655885,63,4,39,3,34,2,32,1145,150,995,10,2,8,0,99.83443709,NoArch
ebfb964b92db127b36ed3b801f203fe9f674c567,0,0,0,0,0,0,0,0,0,0,0,0,0,0,0,48,21,0,0,0,0,0,0,0,0,0,0,100,NoArch
874bf94bec3d7fbc7b7c2bd4ea705473193cdfc5,0,0,0,0,0,0,0,0,0,0,0,0,0,0,0,49,22,0,0,0,0,0,0,0,0,0,0,100,NoArch
e75d696f3874e7ea85ef5dc865ecec85e4e00395,7,119,10,109,129,4,0,4,182,98,1,4,2.318871771,9644,2,2,2,1507,1482,25,39513,38950,563,475,460,15,0,100,NoArch
055bee37dcfa00eca0444781053bfb3f0a324504,0,0,0,0,0,0,0,0,0,0,0,0,0,0,0,50,23,0,0,0,0,0,0,0,0,0,0,100,NoArch
83017f3b620b5ce0dff5dbc716bba3dee9bba588,0,0,0,0,0,0,0,0,0,0,0,0,0,0,0,51,24,0,0,0,0,0,0,0,0,0,0,100,NoArch
9b9972fb6a6919b1e9e810885bacda5255d81c89,0,0,0,0,0,0,0,0,0,0,0,0,0,0,0,40,4,0,0,0,0,0,0,0,0,0,0,100,NoArch
27be41a5a66bb49a063fffe50a21a1bcfa5615a7,0,0,0,0,0,0,0,0,0,0,0,0,0,0,0,41,5,0,0,0,0,0,0,0,0,0,0,100,NoArch
e0d7dfffcdc64c01d91d43c3223dd58e7cb3bffb,0,0,0,0,0,0,0,0,0,0,0,0,0,0,0,818,4,0,0,0,0,0,0,0,0,0,0,100,NoArch
c9931c0dde40871da7e6268d1094a2a674a10d85,1,1,0,1,1,1,0,1,3,1,1,1,0,1401,2,26,4,330,329,1,4978,4975,3,14,14,0,0,100,NoArch
f3b191299b1108f9f57365a933e0a1aa3ff9c40c,5,205,137,68,342,0,0,0,183,179,1,2,1.552554375,4728,1,819,5,751,745,6,23103,22667,436,229,225,4,11,100,NoArch
35345b4988ca122a9c837397fb875a0bd4d79ff0,4,37,17,20,54,1,0,1,184,88,1,3,1.551288781,7621,6,820,6,1079,1075,4,32194,32058,136,433,433,0,1,100,NoArch
29772a3ffaeb525eefb9320c94f3a788ec01469b,0,0,0,0,0,0,0,0,0,0,0,0,0,0,0,821,7,0,0,0,0,0,0,0,0,0,0,100,NoArch
5e1e28e098a40f6286423b7352e2f5816615384e,0,0,0,0,0,0,0,0,0,0,0,0,0,0,0,822,8,0,0,0,0,0,0,0,0,0,0,100,NoArch
468e80e4bcb23e4bc039b30f662c45921b9e19b9,0,0,0,0,0,0,0,0,0,0,0,0,0,0,0,823,9,0,0,0,0,0,0,0,0,0,0,100,NoArch
84b9a65c82d3f98c6a890fe8193afa82940515a6,4,16,11,5,27,0,0,0,185,89,1,3,1.641633561,6143,7,3,3,772,772,0,26876,26868,8,206,206,0,0,100,NoArch
2f60c0f4c6d1d534420bc3c1c87a7f74cee6f0b4,0,0,0,0,0,0,0,0,0,0,0,0,0,0,0,824,10,0,0,0,0,0,0,0,0,0,0,100,NoArch
57087785d5fc9523eff1bc682a4188536e298786,4,3277,3141,136,6418,1,0,1,186,23,1,3,1.012024221,4366,3,825,11,573,572,1,20716,19733,983,158,157,1,0,97.93871866,Arch
fa61e99ff1a7fada6273dac5e1eb85af28d9ddf5,5,90,85,5,175,0,0,0,12,59,1,3,1.59068258,1150,4,59,4,89,90,1,3042,2987,55,32,34,2,0,100,NoArch
4c353e83109eb658fd7297d1a7d098dbc431d917,1,16,0,16,16,1,0,1,2,44,1,1,0,41,1,60,5,8,4,4,226,126,100,8,4,4,0,100,NoArch
27d978aa50e324cf60e71357827bc3ffc3f69ae1,2,55,2,53,57,1,0,1,2,0,1,2,0.58515699,3267,1,4,4,477,471,6,16906,16713,193,120,117,3,0,99.77515458,NoArch
1029cbc04c110f25069665daa671cec924b82c2c,1,47,5,42,52,0,0,0,3,1,1,1,0,269,2,42,6,32,32,0,955,952,3,7,7,0,0,100,NoArch
d05b2b47c5965d41c7500d98dcec5c8829fb6c27,0,0,0,0,0,0,0,0,0,0,0,0,0,0,0,826,12,0,0,0,0,0,0,0,0,0,0,100,NoArch
d045b17631f93c74c6771195f4bc610fd1b2c12e,0,0,0,0,0,0,0,0,0,0,0,0,0,0,0,0,0,0,0,0,0,0,0,0,0,0,0,100,NoArch
338b3e0eaa41194d2e15d0581a8f1c8e8cd8ab63,1,33,6,27,39,0,0,0,4,5,1,1,0,79,2,1,1,9,4,5,268,114,154,4,4,0,0,100,NoArch
c01c490dc84337b79da70e0ab7a8732f30aeabee,1,33,4,29,37,0,0,0,13,88,1,1,0,722,2,2,2,91,86,5,2839,2698,141,45,42,3,0,100,NoArch
02bd0b6b08d58468fd7af9dab7a83befaf54b5c0,1,9,4,5,13,0,0,0,22,16,1,1,0,501,6,3,3,56,55,1,1988,1958,30,24,23,1,0,100,NoArch
ab51cb35a2b8fef16cfb08b6ba27bf61055b8dee,1,6,0,6,6,1,0,1,9,157,1,1,0,133,2,4,4,15,14,1,356,341,15,14,13,1,0,100,NoArch
cc16088c001986efcbe6603f7a087f749b661e81,1,6,0,6,6,1,0,1,10,157,1,1,0,139,2,5,5,18,17,1,353,338,15,17,16,1,0,100,NoArch
4abf68f212179b9041ae0b4c2d64371c0c8cad38,1,3,0,3,3,1,0,1,4,365,1,1,0,85,2,6,6,7,6,1,150,136,14,6,5,1,0,100,NoArch
4a784e0c702e8f23afe34ae0ac04dd6a040948a8,1,7,0,7,7,1,0,1,13,77,1,1,0,176,4,7,7,17,15,2,443,423,20,12,10,2,0,100,NoArch
647ab88d37f89142e2c1c6d1cfd492660c1bd346,1,6,0,6,6,1,0,1,8,183,1,1,0,207,2,8,8,30,29,1,936,918,18,10,9,1,0,100,NoArch
8031146ac11dc920f388e60427a2772f51f8436b,1,2,1,1,3,0,0,0,2,407,1,1,0,127,2,9,9,12,12,0,266,268,2,7,7,0,0,100,NoArch
ab37bcca98f8eb25db4318712e2e81a803a7261c,1,3,83,80,86,0,0,0,187,7,1,1,0,145,7,10,10,3,3,0,106,1003,897,3,3,0,0,98.0587909,NoArch
13f27bf78c3d4d3bc406c8202e33259683374dca,1,2,2,0,4,0,0,0,13,7,1,1,0,364,3,11,11,92,92,0,1660,1660,0,19,19,0,0,100,NoArch
f8456eff6db88ea646bdaa753ad35f5893d5faa0,2,22,4,18,26,0,0,0,3,98,1,1,0.995727452,3362,2,12,12,484,479,5,16947,16868,79,126,124,2,0,100,NoArch
0e0cca2df2bbd702cf0e74a2018f14c9ec678a37,1,8,8,0,16,0,0,0,4,3,1,1,0,3281,3,13,13,475,476,1,16712,16805,93,118,118,0,0,100,NoArch
b7d64e7b137f1685148e13bbf7a9bf4c53b41eef,0,0,0,0,0,0,0,0,0,0,0,0,0,0,0,52,20,0,0,0,0,0,0,0,0,0,0,100,NoArch
36821e0075315eae59df5fc41302c089e3b3372f,4,393,480,87,873,0,0,0,35,214,1,4,0.471301978,1070,1,43,7,126,134,8,3404,3568,164,51,65,14,0,99.94517544,NoArch
e2a6f9a90121278cf588828b0d82eaa3fc5abc9b,0,0,0,0,0,0,0,0,0,0,0,0,0,0,0,827,13,0,0,0,0,0,0,0,0,0,0,100,NoArch
969d2215370e896496559e06b95292491a58dba8,2,24,3,21,27,1,0,1,3,510,1,2,0.99107606,298,1,828,14,25,23,2,1330,1251,79,13,12,1,0,99.83561644,NoArch
c034cbd7901aee54632e935ee0a91bdf7d1a990a,0,0,0,0,0,0,0,0,0,0,0,0,0,0,0,829,15,0,0,0,0,0,0,0,0,0,0,100,NoArch
845c693808ea082c483e0da7cbd228e7bd4caaf0,6,383,5,378,388,5,0,5,39,5,1,4,2.349477366,1905,1,830,16,306,254,52,7867,6429,1438,135,113,22,1,98.2869379,NoArch
4f5d3633b260e8d25d4a035af4786d186ed30c9f,3,27,52,25,79,1,0,1,73,44,1,2,0.457487168,2147,1,61,5,371,374,3,9763,9829,66,99,100,1,0,100,NoArch
2343aba28a0c07cd864ce043f2c0ac2139f77cc1,3,11,4,7,15,1,0,1,23,133,1,2,1.338268928,747,2,53,20,73,72,1,2735,2681,54,44,43,1,1,100,NoArch
cb3759fe4f0ac665050c979cf1e10fe8e858f31a,1,0,5,5,5,0,0,0,5,0,1,1,0,196,1,62,6,20,20,0,755,812,57,10,10,0,0,100,NoArch
1436602afbe3f1e4e5fd5d48069d6d90fcd801e3,5,48,10,38,58,1,0,1,107,73,1,1,2.031512629,4876,1,63,5,670,667,3,17863,17764,99,325,323,2,0,98.85892116,NoArch
b6dc3898fb26c4af6eb76681a8dc22459514714a,3,79,13,66,92,1,0,1,74,45,1,2,1.550423466,1908,1,64,6,348,334,14,9367,8955,412,83,75,8,1,100,NoArch
18213d78130fb1679faf531220d12382d64f2a9b,0,0,0,0,0,0,0,0,0,0,0,0,0,0,0,65,7,0,0,0,0,0,0,0,0,0,0,100,NoArch
7b4d09cd52d67ca960597e4c5db89d6dcf08843c,1,29,14,15,43,0,0,0,36,5,1,1,0,534,3,44,8,89,84,5,2026,1955,71,37,36,1,0,100,NoArch
ccaaaaf43aa028a9f6e6b549bddc2bb0c2ee2fa8,1,8,6,2,14,0,0,0,37,0,1,1,0,549,3,45,9,90,89,1,2046,2026,20,37,37,0,0,100,NoArch
add3d59063a18d10cf2e6a3ff443f900137c4da4,1,11,0,11,11,1,0,1,38,1,1,1,0,551,3,46,10,92,90,2,2073,2046,27,38,37,1,0,100,NoArch
03c950ecd39160f51681679ef321563319dea67f,2,3,3,0,6,0,0,0,58,26,1,1,0.918295834,1392,3,66,7,259,259,0,6710,6706,4,99,99,0,1,100,NoArch
92882dea6dd716c720e660614df19d51444f3fbb,1,9,1,8,10,0,0,0,8,28,1,1,0,549,3,67,8,34,33,1,1116,1091,25,15,15,0,1,100,NoArch
854e9043c564539ad1972f1eff6db863d5917d7d,1,5,0,5,5,1,0,1,5,18,1,1,0,3281,3,14,14,477,475,2,16745,16712,33,118,118,0,0,100,NoArch
3a75c93c25390e3cf32e4e611bac714cace5d361,1,6,5,1,11,0,0,0,23,22,1,1,0,506,6,68,9,57,56,1,1996,1988,8,24,24,0,1,100,NoArch
b48a9160c64c5eb3097a98e157c3a375026f041f,1,1,1,0,2,0,0,0,6,80,1,1,0,213,2,69,10,25,25,0,949,944,5,11,11,0,1,100,NoArch
903d4b5cc93e1b9e158887d7478b96d5cd482c95,1,46,15,31,61,0,0,0,24,3,1,1,0,507,6,70,11,62,57,5,2135,1996,139,24,24,0,1,100,NoArch
fe7cf9a1aee391d18c32098167b76dca86a35513,1,12,1,11,13,0,0,0,108,16,1,1,0,3867,6,71,12,500,499,1,13427,13401,26,284,284,0,1,100,NoArch
acd6d180223d89c7f32d630068e525af664fd7c6,2,7,2,5,9,0,0,0,75,17,1,1,0.918295834,1938,2,72,13,354,354,0,9062,9049,13,90,89,1,1,100,NoArch
a940bfc676108498b99aecfd295161f6aafd106f,2,17,12,5,29,0,0,0,12,107,1,1,0.362051252,324,2,54,2,49,46,3,909,882,27,31,31,0,1,100,NoArch
598211d7f1cc3b583508ab9a1659a85829269b9f,1,13,0,13,13,1,0,1,14,34,1,1,0,751,2,831,8,92,91,1,2849,2839,10,46,45,1,0,100,NoArch
b3b6e64f8a9309a84e33fb0fe8335231c4066a68,1,5,0,5,5,1,0,1,7,88,1,1,0,224,2,832,9,37,36,1,771,743,28,15,14,1,0,100,NoArch
1d3200132ff08c00cbfed60bd5b705b0a64612bb,0,0,0,0,0,0,0,0,0,0,0,0,0,0,0,833,9,0,0,0,0,0,0,0,0,0,0,100,NoArch
5239d055bf9bf2061f09c91aa7d144b381e8f1dc,0,0,0,0,0,0,0,0,0,0,0,0,0,0,0,834,10,0,0,0,0,0,0,0,0,0,0,100,NoArch
cd706a4fd690360bcbb762fbdb8e319eb2f36bec,1,17,2,15,19,0,0,0,8,105,1,1,0,259,3,47,1,42,40,2,1034,966,68,20,18,2,1,100,NoArch
090a7312a59c731bd493bcfa9cfec96b7c5cfb35,0,0,0,0,0,0,0,0,0,0,0,0,0,0,0,15,1,0,0,0,0,0,0,0,0,0,0,100,NoArch
b874fd4f5afcb6e71666f18b98d372bec14d0c82,1,13,3,10,16,0,0,0,59,61,1,1,0,842,4,48,1,158,158,0,4071,4027,44,29,29,0,0,100,NoArch
33cbd697a0e1f2d3ef5b8c796a84e5f1967b9fea,0,0,0,0,0,0,0,0,0,0,0,0,0,0,0,49,2,0,0,0,0,0,0,0,0,0,1,100,NoArch
edb77ba4cc0bddf2824fa13ee3e0e53ba52c58a6,0,0,0,0,0,0,0,0,0,0,0,0,0,0,0,835,0,0,0,0,0,0,0,0,0,0,0,100,NoArch
89a756b645560d42d67dae759c2847bb8f8a36e5,1,561,0,561,561,1,0,1,1,0,1,1,0,0,1,50,3,69,0,69,2808,0,2808,31,0,31,0,99.8973306,NoArch
d58401250617588f4f4f54d5785c00922a33cc78,0,0,0,0,0,0,0,0,0,0,0,0,0,0,0,836,1,0,0,0,0,0,0,0,0,0,0,100,NoArch
f7623b59e4af61e201e71f8c1885747cfca87de5,1,121,147,26,268,0,0,0,5,109,1,1,0,306,2,51,3,28,31,3,839,941,102,7,7,0,0,100,NoArch
74572eda7bb1a1e2774f182456e844eb308c5f91,2,34,7,27,41,1,0,1,3,198,1,2,0.978869851,213,2,5,0,29,27,2,1043,868,175,24,23,1,0,100,NoArch
b679b927a5c8bf4d38ebe0acccf08e665c5a2145,0,0,0,0,0,0,0,0,0,0,0,0,0,0,0,55,0,0,0,0,0,0,0,0,0,0,0,100,NoArch
bc85237350570fd5e27ec462aca6c8f032a210d5,0,0,0,0,0,0,0,0,0,0,0,0,0,0,0,56,1,0,0,0,0,0,0,0,0,0,0,100,NoArch
aba36b6f20dd64b55952dcfa21ec6fca33763a78,1,65,1,64,66,0,0,0,24,126,1,1,0,403,4,57,2,52,43,9,1617,1447,170,35,32,3,0,100,NoArch
ec89a360d1ecf00b6c5224c53d2c15134b7a448e,1,7,1,6,8,0,0,0,25,2,1,1,0,467,4,58,3,53,52,1,1637,1617,20,35,35,0,1,100,NoArch
cbaffa8c4f7342f878d04095139d45dbd3545fb6,9,141,3,138,144,7,0,7,109,137,1,5,2.660604841,9873,1,6,1,1540,1521,19,40598,40145,453,496,485,11,0,97.82146652,Arch
87b8129c1ed56c2f57072f8c9de0420c84435ee6,0,0,0,0,0,0,0,0,0,0,0,0,0,0,0,59,4,0,0,0,0,0,0,0,0,0,0,100,NoArch
d21d71d898ec3d3b77521d48f339038ba7e7ce69,1,3,2,1,5,0,0,0,60,69,1,1,0,852,5,60,5,159,158,1,4080,4071,9,29,29,0,1,100,NoArch
cac4976bb95c9744199288d6ea1960b983807e57,1,78,28,50,106,0,0,0,26,18,1,1,0,473,4,61,6,59,53,6,1807,1637,170,35,35,0,0,100,NoArch
db47f71cc575fa251bcbc1a4927a8ac6f5e57430,1,407,457,50,864,0,0,0,27,0,1,1,0,523,5,52,0,53,59,6,1637,1807,170,35,35,0,0,100,NoArch
721e725ba497e8a9562e694090c53a093ea6ab9a,1,456,407,49,863,0,0,0,28,1,1,1,0,473,5,62,7,59,53,6,1816,1637,179,35,35,0,0,100,NoArch
8b2a79f33f41fc19851a20c959384c474d2939cc,0,0,0,0,0,0,0,0,0,0,0,0,0,0,0,0,0,0,0,0,0,0,0,0,0,0,0,100,NoArch
55ba1cc4b961b16437908f1254739e7ff7f07133,0,0,0,0,0,0,0,0,0,0,0,0,0,0,0,1,1,0,0,0,0,0,0,0,0,0,0,100,NoArch
a3112f6c9805ad30d6970c23b75faebde463958c,0,0,0,0,0,0,0,0,0,0,0,0,0,0,0,2,2,0,0,0,0,0,0,0,0,0,0,100,NoArch
b6761aa4e3758cf34094ef3b19139b599d851c0e,0,0,0,0,0,0,0,0,0,0,0,0,0,0,0,3,3,0,0,0,0,0,0,0,0,0,0,100,NoArch
4b0b49d25077a3a1ab4efc796097838ef7892ad9,0,0,0,0,0,0,0,0,0,0,0,0,0,0,0,837,0,0,0,0,0,0,0,0,0,0,0,100,NoArch
f6f2ab667ea23426a8532fd38be2250d93485e2f,3,7,21,14,28,0,0,0,5,117,1,1,1.577406283,208,2,7,2,43,45,2,1145,1174,29,39,39,0,1,100,NoArch
af3587e8d36eca58e45d3e304cd462425ad8b30a,0,0,0,0,0,0,0,0,0,0,0,0,0,0,0,838,1,0,0,0,0,0,0,0,0,0,0,100,NoArch
814fb33f88a5439206c1388cd1e97339afb2000a,70,8834,377,8457,9211,14,0,14,110,282,1,14,2.81176606,29269,4,16,0,5424,3777,1647,146395,102103,44292,1764,1431,333,0,94.61956522,Arch
6aa19d8bd3b1a61b98b2e07aec2dc949bc0f0d10,1,1,0,1,1,1,0,1,26,0,1,1,0,636,6,17,1,81,81,0,2659,2659,0,27,27,0,0,100,NoArch
7be79de2156d752ffd4ebd9a58316d01919d3584,1,28,25,3,53,0,0,0,27,0,1,1,0,637,6,18,2,82,81,1,2670,2659,11,27,27,0,0,100,NoArch
0d966a32e3f43db5ae7f4191baadd51dda0c25f7,1,1,1,0,2,0,0,0,2,1,1,1,0,5583,1,19,3,946,946,0,28927,28927,0,150,150,0,0,100,NoArch
0b39709ea3c75983a7a5a2c1b7c6863892fc5f7a,1,10,2,8,12,0,0,0,3,0,1,1,0,5583,1,20,4,947,946,1,28947,28927,20,150,150,0,0,100,NoArch
72c295d75d6781700d2a6a423893344b05bfb495,1,1,1,0,2,0,0,0,4,0,1,1,0,5591,2,53,1,947,947,0,28947,28947,0,150,150,0,0,100,NoArch
da70e0d338b0d4c7cc0e6984be0748af2323a230,1,5,0,5,5,1,0,1,30,3,1,1,0,540,6,63,6,64,63,1,1946,1929,17,35,35,0,1,100,NoArch
6c6b9a5336ebd529f61010212afc173443d73026,1,203,3,200,206,0,0,0,111,5,1,1,0,3983,7,64,7,536,516,20,14445,13842,603,305,292,13,2,100,NoArch
d140963621e5a96e61c12ef7cd481b349c653675,2,72,9,63,81,1,0,1,2,406,1,2,0.98665549,645,1,65,8,111,111,0,1851,1851,0,59,59,0,0,100,NoArch
fc14caceb5f4cb20b9f4268be3fc61f0cc65490e,1,13,0,13,13,1,0,1,112,0,1,1,0,4183,7,66,9,538,536,2,14508,14445,63,306,305,1,0,100,NoArch
e250063741675d01d565c62b0caeea48a97eb597,1,812,0,812,812,1,0,1,1,0,1,1,0,0,1,839,2,1,0,1,1116,0,1116,1,0,1,0,99.24852389,NoArch
40a77e4fa06b0e5361ea21cd678f51332f2cfee8,2,79,12,67,91,1,0,1,8,249,1,2,0.944850644,105,1,840,3,14,7,7,448,243,205,8,4,4,0,96.90721649,Arch
7a477ecd185e81b9c7a8449c0f51200e9aaeb0f5,1,2,3,1,5,0,0,0,8,232,1,1,0,469,2,841,4,68,68,0,1999,1999,0,20,20,0,0,100,NoArch
4497e6d42818c00179f379373cdf683c7b8626d3,2,86,1,85,87,1,0,1,9,196,1,2,0.918295834,84,1,842,5,14,2,12,476,84,392,8,2,6,0,99.80276134,NoArch
9947bd38ea56d62330da80dc773c75b361a6673e,4,43,9,34,52,1,0,1,30,120,1,4,1.391704514,1020,2,843,6,100,95,5,5590,5319,271,70,65,5,0,99.70544919,NoArch
4245e081076dbafb6c13a6da04e83a7743895817,2,352,31,321,383,1,0,1,31,3,1,2,0.514469649,545,1,844,7,88,64,24,3059,1946,1113,45,35,10,0,99.90196078,NoArch
83a0c26f9e7c3dc2ec1103463004174e65138639,0,0,0,0,0,0,0,0,0,0,0,0,0,0,0,845,8,0,0,0,0,0,0,0,0,0,0,100,NoArch
630eef32717f539c53b4cad3420f3f2b33c76c90,0,0,0,0,0,0,0,0,0,0,0,0,0,0,0,0,0,0,0,0,0,0,0,0,0,0,0,100,NoArch
f98ac8e2bb33988cbc434bd910d1f35e6f4e349c,6,620,82,538,702,3,0,3,113,70,1,2,2.039922041,6307,7,846,9,1019,975,44,26056,24904,1152,401,385,16,1,97.35064935,Arch
5f4ba80bb75f38f32b78123ecb40ad8b75073654,0,0,0,0,0,0,0,0,0,0,0,0,0,0,0,1,1,0,0,0,0,0,0,0,0,0,0,100,NoArch
0aa7c01336f3503bba3a96e68c188494b70be928,1,271,249,22,520,0,0,0,28,11,1,1,0,640,6,847,10,82,82,0,2670,2670,0,27,27,0,0,100,NoArch
3dfe4adf0ff536081a2a3f39c1a3a72dcadb8f95,0,0,0,0,0,0,0,0,0,0,0,0,0,0,0,848,11,0,0,0,0,0,0,0,0,0,0,100,NoArch
efe928cd8c066d1f98e8039fa69759fbf8a7fe68,1,163,25,138,188,0,0,0,8,236,1,1,0,578,3,67,8,105,75,30,4099,3132,967,15,14,1,1,100,NoArch
1ce8bf79447f0f0fb500a9a74e1b5bc26e417d6e,1,198,174,24,372,0,0,0,15,147,1,1,0,764,2,849,12,100,92,8,3002,2849,153,46,46,0,0,100,NoArch
33ed8887eef3b47b350bac5fe9f50f591033aa4d,1,25,0,25,25,1,0,1,114,2,1,1,0,4230,7,68,9,545,543,2,14795,14728,67,311,309,2,1,100,NoArch
a2d1ea4d60ba8a0169730377fd91f29dbcf89d58,0,0,0,0,0,0,0,0,0,0,0,0,0,0,0,69,10,0,0,0,0,0,0,0,0,0,0,100,NoArch
0ae99ae0d786d8fc77f074997f3ec6e2f3fd3511,0,0,0,0,0,0,0,0,0,0,0,0,0,0,0,850,13,0,0,0,0,0,0,0,0,0,0,100,NoArch
5776f4721111fb1dc7f7a7de1f0c914c208e041e,0,0,0,0,0,0,0,0,0,0,0,0,0,0,0,2,2,0,0,0,0,0,0,0,0,0,1,100,NoArch
4c14b2c0854d162f95c723f419ddfc86b8fd2070,0,0,0,0,0,0,0,0,0,0,0,0,0,0,0,851,14,0,0,0,0,0,0,0,0,0,0,100,NoArch
6194c59e50fbd430502dbfabe5f32a2aa8c0e5f5,1,604,700,96,1304,0,0,0,8,15,1,1,0,998,3,852,15,93,93,0,2696,2703,7,35,34,1,1,99.83351831,NoArch
836f141bbcf9b868848610032455609e24f91220,1,5,0,5,5,1,0,1,32,5,1,1,0,527,6,853,16,60,59,1,1834,1808,26,36,35,1,0,100,NoArch
e5a18e0634a93dc30ca5186b164c4ad82181883a,0,0,0,0,0,0,0,0,0,0,0,0,0,0,0,854,17,0,0,0,0,0,0,0,0,0,0,100,NoArch
b9be9d24b5427275c231b262a0c586d2706e6a70,0,0,0,0,0,0,0,0,0,0,0,0,0,0,0,855,18,0,0,0,0,0,0,0,0,0,0,100,NoArch
be7f783fcff3108fec95289aebaf3a8f7436b5e1,2,6,6,0,12,0,0,0,9,257,1,1,1,228,1,856,19,10,10,0,721,721,0,8,8,0,0,100,NoArch
ea738f7e0ec784718e5426c3215c616bb4af5b1a,1,2,1,1,3,0,0,0,2,5,1,1,0,339,2,3,3,29,29,0,1259,1251,8,10,10,0,0,100,NoArch
82f9caf6eaf66c19ed1b624591ceab0820db8683,0,0,0,0,0,0,0,0,0,0,0,0,0,0,0,4,4,0,0,0,0,0,0,0,0,0,0,100,NoArch
bd6395d3459f768914828038904b6066b72680e9,0,0,0,0,0,0,0,0,0,0,0,0,0,0,0,857,20,0,0,0,0,0,0,0,0,0,0,100,NoArch
ad145acb27f5e7cd7f0375b05e87ddc7ac87449e,0,0,0,0,0,0,0,0,0,0,0,0,0,0,0,858,21,0,0,0,0,0,0,0,0,0,0,100,NoArch
44ea59c71fa95632f9341105b112ca22579d7cd6,0,0,0,0,0,0,0,0,0,0,0,0,0,0,0,859,22,0,0,0,0,0,0,0,0,0,0,100,NoArch
3ec9737248ad6ba4a7e6da8fd1a8adab7b4bd5d3,0,0,0,0,0,0,0,0,0,0,0,0,0,0,0,860,23,0,0,0,0,0,0,0,0,0,0,100,NoArch
fb29e7821b58a3e5dd0cea6edb3bea72c45a5fa8,0,0,0,0,0,0,0,0,0,0,0,0,0,0,0,0,0,0,0,0,0,0,0,0,0,0,0,100,NoArch
c19d6bd8fa3870d065fdec6f21633ea106f531f1,0,0,0,0,0,0,0,0,0,0,0,0,0,0,0,1,1,0,0,0,0,0,0,0,0,0,0,100,NoArch
ef2a9779d0bc4e71fed63892bff4ff6752a4489b,2,82,2,80,84,1,0,1,78,4,1,1,0.67694187,2271,10,2,2,459,454,5,10916,10797,119,77,74,3,0,99.77753059,NoArch
1e04f93cb556e93ed65aae31d4a8110db2eaed08,1,14,0,14,14,1,0,1,1,0,1,1,0,0,1,5,5,2,0,2,44,0,44,2,0,2,1,99.88901221,NoArch
a5cf333a226aa4b370fcecc8ab1791e93025b185,0,0,0,0,0,0,0,0,0,0,0,0,0,0,0,6,6,0,0,0,0,0,0,0,0,0,0,100,NoArch
f6dafee96aeb8b02bc5948750fab3f9237439dc0,2,45,31,14,76,0,0,0,14,293,1,1,0.485460761,310,5,54,2,28,27,1,668,640,28,20,20,0,1,100,NoArch
0eb9fe51f830a4274303f6a8eecc55e559afe07f,1,2,2,0,4,0,0,0,79,5,1,1,0,2282,10,55,3,456,456,0,10853,10835,18,74,74,0,1,100,NoArch
d7f85466c39816871bc630cd7b2b48fbd47812c4,2,25,12,13,37,0,0,0,33,8,1,2,0.98678672,872,3,70,9,90,89,1,3202,3093,109,47,46,1,0,100,NoArch
4b510b24c849d203ccf4dfb68fc8f44c19c1a48e,1,288,122,166,410,0,0,0,9,12,1,1,0,716,3,71,10,126,105,21,4948,4099,849,18,15,3,0,100,NoArch
1efddb9d3becbe323bf187c391c079f4aa64c192,0,0,0,0,0,0,0,0,0,0,0,0,0,0,0,72,11,0,0,0,0,0,0,0,0,0,0,100,NoArch
cc60573fd2f2b79ccef6058636a5412a987d55dd,0,0,0,0,0,0,0,0,0,0,0,0,0,0,0,7,7,0,0,0,0,0,0,0,0,0,0,100,NoArch
455df5c52902f301d76252f18689274b2fe02f28,1,30,1,29,31,0,0,0,115,13,1,1,0,4255,8,8,8,548,545,3,14867,14795,72,313,311,2,0,100,NoArch
9d66545a2edea0cd1bedabef84da7b3716cb4201,0,0,0,0,0,0,0,0,0,0,0,0,0,0,0,9,9,0,0,0,0,0,0,0,0,0,0,100,NoArch
cc466ebe92577e109f9fd0c51f07c86497a87cad,0,0,0,0,0,0,0,0,0,0,0,0,0,0,0,10,10,0,0,0,0,0,0,0,0,0,0,100,NoArch
9af2fdca57e0af9d2b95e55cfbe16fcf2601e348,1,5,1,4,6,0,0,0,14,31,1,1,0,236,5,11,11,25,25,0,834,805,29,13,13,0,0,100,NoArch
4e9fdc547cde4277b9a0ab068ed01cf505d3ce01,4,119,7,112,126,3,0,3,116,52,1,3,1.598110751,6694,9,3,3,1022,1016,6,26218,25986,232,398,394,4,0,99.77863863,NoArch
ee5eb16b4b3097fea2b72ad3caf4d7e2932576d9,0,0,0,0,0,0,0,0,0,0,0,0,0,0,0,4,4,0,0,0,0,0,0,0,0,0,0,100,NoArch
3f20b4a418bc8fd926f8ab89f4b37cbb0f36ab0c,1,30,1,29,31,0,0,0,117,2,1,1,0,4292,9,5,5,549,549,0,14901,14901,0,313,313,0,0,100,NoArch
48562a1188ebae3f09ba6dbb197195f72288d9da,0,0,0,0,0,0,0,0,0,0,0,0,0,0,0,6,6,0,0,0,0,0,0,0,0,0,0,100,NoArch
52cc8f17042194114865b311dcc76495b0988695,1,1,1,0,2,0,0,0,34,9,1,1,0,533,7,7,7,60,60,0,1854,1854,0,37,37,0,0,100,NoArch
e8678eae54b0af2260c454a9a5abc485f7b8634d,0,0,0,0,0,0,0,0,0,0,0,0,0,0,0,12,12,0,0,0,0,0,0,0,0,0,1,100,NoArch
11dc5849f44e3f2f976691cbea5770502c5fb517,1,4,0,4,4,1,0,1,2,29,1,1,0,108,2,8,8,12,10,2,242,217,25,7,7,0,0,100,NoArch
0517c14065a7587a1d6d0368695b2bd941520bc5,0,0,0,0,0,0,0,0,0,0,0,0,0,0,0,9,9,0,0,0,0,0,0,0,0,0,0,100,NoArch
d26327e6746ea6e3fa41784324f944c4763afcf1,1,20,1,19,21,0,0,0,81,17,1,1,0,2294,10,73,6,459,456,3,10942,10853,89,75,74,1,1,100,NoArch
d8cee2e427c77b5940ae90801e263693bf0d9161,1,1,1,0,2,0,0,0,6,105,1,1,0,280,2,56,2,28,28,0,839,839,0,7,7,0,0,100,NoArch
3d75f351b8d839dcb33ca83cd1960c8c28e73a81,0,0,0,0,0,0,0,0,0,0,0,0,0,0,0,74,7,0,0,0,0,0,0,0,0,0,1,100,NoArch
3ce479a7de187e5e5d408539a1d0943c22146ff0,1,55,30,25,85,0,0,0,41,53,1,1,0,849,3,75,8,164,161,3,3975,3875,100,67,66,1,0,100,NoArch
c67860f06218a2036a71e8faf9cc77bd31ca6046,1,7,0,7,7,1,0,1,4,27,1,1,0,352,3,76,9,31,30,1,1427,1348,79,10,10,0,0,100,NoArch
1388a0f607af517d5002f7a07f4ae350607570ca,1,52,0,52,52,1,0,1,1,0,1,1,0,0,1,77,7,8,0,8,130,0,130,8,0,8,0,99.88962472,NoArch
310b7182b7cf970df80e9868340e80dc289f8d83,0,0,0,0,0,0,0,0,0,0,0,0,0,0,0,78,8,0,0,0,0,0,0,0,0,0,0,100,NoArch
ad310ba9358125a981e11e64259c145e991dbebb,1,16,1,15,17,0,0,0,7,284,1,1,0,198,2,861,0,23,22,1,663,644,19,10,9,1,0,100,NoArch
1729556753b26c3fea406769dfe29181477b6548,1,5,3,2,8,0,0,0,3,639,1,1,0,162,1,862,1,18,18,0,624,608,16,8,8,0,0,100,NoArch
1922464cd11e370cfb624e6057e0ff270097d1ab,2,31,9,22,40,1,0,1,42,7,1,2,0.992774454,926,1,79,9,176,172,4,4169,4105,64,79,75,4,0,100,NoArch
af7b8e46e41d90728674abe9c166d1724789c0fb,1,5,2,3,7,0,0,0,2,49,1,1,0,14,1,13,4,2,2,0,44,44,0,2,2,0,0,100,NoArch
cf4237523c7a972e13931f7331662de27212bd5d,1,1,5,4,6,0,0,0,15,45,1,1,0,240,5,14,2,25,25,0,805,834,29,13,13,0,0,100,NoArch
023e4c7facf785789204e746d4392a9a9a997ab1,0,0,0,0,0,0,0,0,0,0,0,0,0,0,0,15,2,0,0,0,0,0,0,0,0,0,0,100,NoArch
cc67fc046705655c7ecea3dc356de714471e08d1,2,109,4,105,113,1,0,1,5,25,1,1,0.912282807,359,1,16,3,45,31,14,1978,1427,551,15,10,5,0,99.77985691,NoArch
8338eceadc85dd2b0db05d7c71c345b5cdc8b01f,1,1,0,1,1,1,0,1,6,0,1,1,0,388,3,17,4,35,35,0,1581,1581,0,11,11,0,0,100,NoArch
33cc90689ceb0c3bb1eaaaae9909032b5ea36814,2,28,8,20,36,0,0,0,7,6,1,1,0.309543429,465,1,18,5,48,45,3,2087,1978,109,15,15,0,0,100,NoArch
c12e2f3ac28732f70a1d01f746d485ac52dfbf41,2,15,9,6,24,0,0,0,8,6,1,1,0.918295834,485,1,19,5,49,48,1,2123,2087,36,15,15,0,0,100,NoArch
74e54db888ac6fc0729c683b60314e4cbc89907a,1,1,1,0,2,0,0,0,9,0,1,1,0,389,3,20,6,35,35,0,1589,1587,2,11,11,0,0,100,NoArch
b83e062fb000b1b2133a83ebdf8ff1776f5856d1,0,0,0,0,0,0,0,0,0,0,0,0,0,0,0,21,6,0,0,0,0,0,0,0,0,0,0,100,NoArch
49a64c83fa2c222944ebeb9e568871dabecd8907,0,0,0,0,0,0,0,0,0,0,0,0,0,0,0,8,0,0,0,0,0,0,0,0,0,0,0,100,NoArch
a242ef781008a646535318c6baea9b91182896a0,1,1,0,1,1,1,0,1,4,19,1,1,0,102,1,22,7,14,14,0,545,536,9,4,4,0,0,100,NoArch
3ed8a9c82f66f64e5c72752fbb4dcb4289deadb5,2,185,16,169,201,1,0,1,13,194,1,1,0.932503311,509,1,0,0,68,46,22,1988,1410,578,24,15,9,0,99.89023052,NoArch
cf377ecb67bcd5242fe1c4bd192cf64e503bcf33,1,10,6,4,16,0,0,0,4,401,1,1,0,65,2,9,1,3,2,1,138,124,14,2,2,0,1,100,NoArch
00a8dcce9474bdf43210fa4b82358be46abf9868,1,70,1,69,71,0,0,0,118,123,1,1,0,4321,9,23,2,555,549,6,15067,14901,166,319,313,6,3,100,NoArch
b17999c72f741e05f0c64a4ed939119bd0316436,3,100,5,95,105,1,0,1,7,237,1,2,1.194782206,710,1,57,0,89,82,7,3655,3380,275,39,37,2,0,99.78106185,NoArch
6cb4716ab6ce88d9be05ff9a58ac3910fe752237,2,35,3,32,38,1,0,1,6,437,1,2,0.561752608,515,2,27,0,64,58,6,1532,1442,90,16,13,3,0,100,NoArch
30d3b2a6c2699ef1ae51519c51609021e7753e31,1,22,12,10,34,0,0,0,3,1,1,1,0,604,1,58,1,78,76,2,3090,3049,41,34,33,1,0,100,NoArch
1cb00ff7309b5f48479ffcc2081f8fa25131f181,1,10,1,9,11,0,0,0,40,165,1,1,0,578,4,59,2,95,94,1,2150,2118,32,40,40,0,0,100,NoArch
e9101d864748c0f608be70125edc4c59eafafe5e,1,19,11,8,30,0,0,0,4,57,1,1,0,614,1,60,0,80,78,2,3114,3090,24,36,34,2,0,100,NoArch
b21b90590f7c1ad81720c2603cfdf0ad0552f249,1,2,0,2,2,1,0,1,5,0,1,1,0,622,1,61,1,80,80,0,3133,3114,19,36,36,0,0,100,NoArch
45f62ff7437c06b4ad4f4b4e6942bbe5d3581467,1,21,1,20,22,0,0,0,6,0,1,1,0,624,1,62,2,83,80,3,3227,3133,94,37,36,1,0,100,NoArch
f0be9ea7f3d67a62ff48e1c64a9c72a38e7fa66a,1,25,0,25,25,1,0,1,119,81,1,1,0,4390,9,24,0,557,555,2,15121,15067,54,321,319,2,0,100,NoArch
c6b0c8af32e1d07a84e48b0c807a51212376ff60,0,0,0,0,0,0,0,0,0,0,0,0,0,0,0,25,1,0,0,0,0,0,0,0,0,0,0,100,NoArch
44a1f3b5e39ac545840a0c071dd2d49385120dea,6,106,70,36,176,4,0,4,14,32,1,2,2.32929256,678,1,1,0,67,68,1,2074,1988,86,27,24,3,0,99.40184883,NoArch
dd4cbd8950aa2922ae0bf0991a480de11cdeff5e,1,37,0,37,37,1,0,1,120,3,1,1,0,4415,9,26,2,560,557,3,15212,15121,91,324,321,3,0,100,NoArch
4eed11639d2d5d21af5e1364c35c429edf2c86a3,0,0,0,0,0,0,0,0,0,0,0,0,0,0,0,27,3,0,0,0,0,0,0,0,0,0,0,100,NoArch
40e39f398b4a89bba466ce60df829bd92049958c,0,0,0,0,0,0,0,0,0,0,0,0,0,0,0,863,0,0,0,0,0,0,0,0,0,0,0,100,NoArch
cc737be03c278d110b3722492cdd5f88253335b8,0,0,0,0,0,0,0,0,0,0,0,0,0,0,0,864,1,0,0,0,0,0,0,0,0,0,0,100,NoArch
5b767e8faf591a7557208fa62cf2f8239c8dbc6c,0,0,0,0,0,0,0,0,0,0,0,0,0,0,0,28,4,0,0,0,0,0,0,0,0,0,0,100,NoArch
5108cf86039bfefe081ee7b394f472b21c03d67e,1,49,13,36,62,0,0,0,121,4,1,1,0,4452,9,63,3,563,560,3,15284,15212,72,327,324,3,0,100,NoArch
3a5bb7559da7532e3ec4bda3017a2380dfd5c547,0,0,0,0,0,0,0,0,0,0,0,0,0,0,0,64,4,0,0,0,0,0,0,0,0,0,0,100,NoArch
b9798fa860fcada8f390346509d1a70f7962b61d,0,0,0,0,0,0,0,0,0,0,0,0,0,0,0,65,5,0,0,0,0,0,0,0,0,0,0,100,NoArch
e2793c5832d9898c0d38343a89a6a6d72de83ac1,0,0,0,0,0,0,0,0,0,0,0,0,0,0,0,66,6,0,0,0,0,0,0,0,0,0,0,100,NoArch
629d807656a2d14d30be85af35102cfb211fc896,0,0,0,0,0,0,0,0,0,0,0,0,0,0,0,67,7,0,0,0,0,0,0,0,0,0,0,100,NoArch
b0b106a9fefdfda90a55b676aa630ded2a474cd3,0,0,0,0,0,0,0,0,0,0,0,0,0,0,0,68,8,0,0,0,0,0,0,0,0,0,0,100,NoArch
4b90819753b17528ce182655d73fbc8b42a18101,0,0,0,0,0,0,0,0,0,0,0,0,0,0,0,69,9,0,0,0,0,0,0,0,0,0,0,100,NoArch
8b562686418190a3b797085f510c62ed5a9a46ca,2,9,2,7,11,1,0,1,62,436,1,2,0.945660305,1023,3,80,0,173,173,0,4844,4759,85,41,41,0,0,100,NoArch
30c9c395652229dc910d961a94ad417016fabf9c,0,0,0,0,0,0,0,0,0,0,0,0,0,0,0,29,5,0,0,0,0,0,0,0,0,0,1,100,NoArch
90d2f6aa3be9f7773ba82a5fbc9819983e1f8fd7,1,13,1,12,14,0,0,0,122,14,1,1,0,4488,9,30,6,564,563,1,15311,15284,27,328,327,1,1,100,NoArch
4a055c8f44a5cae92ecd6580007f9a61a4d3711a,3,388,308,80,696,0,0,0,15,33,1,2,0.813345887,575,2,81,1,64,57,7,2054,1681,373,27,23,4,2,99.94588745,NoArch
607466324bdb647a4b78f5895af55326e5643d4f,2,50,0,50,50,2,0,2,15,128,1,2,0.942683189,191,1,82,2,22,16,6,714,439,275,15,12,3,1,97.72151899,Arch
c1f228b1ac4d427929eb470d52ae9df77208a358,2,71,0,71,71,2,0,2,16,0,1,2,0.655444445,241,1,83,3,22,22,0,714,714,0,15,15,0,1,100,NoArch
6eaf2dfba225f023633a3fc1f7b1d1d6f7c72f05,0,0,0,0,0,0,0,0,0,0,0,0,0,0,0,84,0,0,0,0,0,0,0,0,0,0,1,100,NoArch
dd2e06a0b955321d18e6f2563151de0c8832a3ba,0,0,0,0,0,0,0,0,0,0,0,0,0,0,0,31,0,0,0,0,0,0,0,0,0,0,0,100,NoArch
ab6686d7524d6f48a7cc0cbeb4d79865fb97f22a,0,0,0,0,0,0,0,0,0,0,0,0,0,0,0,85,1,0,0,0,0,0,0,0,0,0,2,100,NoArch
2d4266e92ec9d78701b7b2690213c6b14d5fd738,0,0,0,0,0,0,0,0,0,0,0,0,0,0,0,86,1,0,0,0,0,0,0,0,0,0,0,100,NoArch
23204cf8e0e99708486e2993c5aadb19f3fd03be,1,1,1,0,2,0,0,0,4,449,1,1,0,129,4,87,2,13,13,0,601,596,5,8,8,0,1,100,NoArch
ddebc21b8ec44a21ce8a7e285b0456e7180734df,1,4,10,6,14,0,0,0,5,449,1,1,0,87,3,88,3,4,5,1,166,185,19,3,3,0,1,100,NoArch
aa8f5def882534d1249db9602f0876239ff0dead,2,3,1,2,4,1,0,1,82,406,1,1,1,2846,10,89,4,520,519,1,12808,12796,12,112,112,0,0,100,NoArch
3de55b1c9a3b2ce16ab9eed5fc232ec1ae6ed0b1,1,7,4,3,11,0,0,0,6,2,1,1,0,81,3,90,5,4,4,0,166,166,0,3,3,0,0,100,NoArch
d41fcf247fa2bf2ce98e7adaaabbc92e51fa0452,2,104,132,28,236,0,0,0,10,515,1,2,0.892389312,456,2,73,0,42,39,3,1814,1810,4,13,14,1,0,100,NoArch
5da9891820c9dada33a90a5f3c7cee6008db3eb1,0,0,0,0,0,0,0,0,0,0,0,0,0,0,0,74,1,0,0,0,0,0,0,0,0,0,0,100,NoArch
5724870025c25622015ba13c0310def5742d0b2f,5,477,619,142,1096,0,0,0,63,292,1,2,2.163254224,3126,4,75,2,497,490,7,13893,14083,190,194,189,5,1,100,NoArch
9d1fb3e6b8d06d9e50e330adaf9645cd70b8d8fa,1,3,0,3,3,1,0,1,3,289,1,1,0,401,2,0,0,52,52,0,1145,1134,11,8,8,0,0,100,NoArch
03e2d2accb7295c42d9a4b8011009339c68859d4,1,1,0,1,1,1,0,1,83,5,1,1,0,2315,11,1,1,461,460,1,10959,10950,9,75,75,0,0,100,NoArch
4747d7a5c678d91bc6929a49a7652b2b5e39da5a,1,3,0,3,3,1,0,1,13,630,1,1,0,217,3,76,3,22,22,0,763,748,15,8,8,0,0,100,NoArch
665b320c226c4ad676c995e4e9031184e268c85b,0,0,0,0,0,0,0,0,0,0,0,0,0,0,0,91,6,0,0,0,0,0,0,0,0,0,1,100,NoArch
16b05b055d89316422f10c825ac7becf744b6ea5,1,1,0,1,1,1,0,1,16,180,1,1,0,560,4,92,7,53,53,0,1730,1723,7,19,19,0,0,100,NoArch
179164d68ef8d2b3449ef601ce8d7cf2cd31fef6,1,70,63,7,133,0,0,0,8,592,1,1,0,229,3,93,8,39,37,2,810,771,39,15,15,0,1,100,NoArch
c654d8f2999f923b5e582b78a819bbbcd420fb68,0,0,0,0,0,0,0,0,0,0,0,0,0,0,0,94,9,0,0,0,0,0,0,0,0,0,0,100,NoArch
6093b4414bb52bab712f2b096bb0ed6623bea5f9,0,0,0,0,0,0,0,0,0,0,0,0,0,0,0,2,2,0,0,0,0,0,0,0,0,0,0,100,NoArch
f96c02055ff8753ae5eb960f3360bfc184eff256,0,0,0,0,0,0,0,0,0,0,0,0,0,0,0,3,3,0,0,0,0,0,0,0,0,0,0,100,NoArch
3a54fc72269b11906d2cf13cb693c409f98912bb,1,12,0,12,12,1,0,1,123,198,1,1,0,4500,10,4,4,565,564,1,15329,15311,18,329,328,1,0,100,NoArch
3de9a03468b04cae863e9208e59f2d070d4c9604,0,0,0,0,0,0,0,0,0,0,0,0,0,0,0,5,5,0,0,0,0,0,0,0,0,0,0,100,NoArch
90b803ba200749826df044fa0513227b3395b5c1,1,10,4,6,14,0,0,0,84,9,1,1,0,2316,11,6,6,464,461,3,11022,10959,63,75,75,0,0,100,NoArch
498ea95e37f0312c1f63b6da120f67e696ddbc80,1,35,12,23,47,0,0,0,64,14,1,1,0,789,6,95,10,163,161,2,4076,4018,58,31,31,0,1,100,NoArch
31296e8748008a54538084e657593da3e1f38783,1,19,0,19,19,1,0,1,10,441,1,1,0,882,3,77,4,131,126,5,5059,4948,111,19,18,1,0,100,NoArch
8054a5ed8bdc33f6eb056339547b75e9798d942e,0,0,0,0,0,0,0,0,0,0,0,0,0,0,0,78,5,0,0,0,0,0,0,0,0,0,0,100,NoArch
abf75d4edbabf18b90caa317363ef986040edcee,0,0,0,0,0,0,0,0,0,0,0,0,0,0,0,79,6,0,0,0,0,0,0,0,0,0,0,100,NoArch
8f30bd0bdfe873ac8de2a533e0e54faf9a22adfe,0,0,0,0,0,0,0,0,0,0,0,0,0,0,0,96,11,0,0,0,0,0,0,0,0,0,2,100,NoArch
7ccd6dc113258ac0d4c7ac1ba583040065534e94,0,0,0,0,0,0,0,0,0,0,0,0,0,0,0,80,7,0,0,0,0,0,0,0,0,0,0,100,NoArch
c2c39fffaa1057bcf50a62b3c90ff30627492654,3,97,10,87,107,2,0,2,9,153,1,2,1.479256181,468,1,97,12,80,68,12,2311,1999,312,28,20,8,1,99.76269578,NoArch
c49a275d26a726680e94a28dac7eedf51f3b0f67,9,195,286,91,481,0,0,0,43,478,1,8,2.109653233,3484,2,81,8,436,435,1,13081,13333,252,164,164,0,0,100,NoArch
d6855b870b17cc7e18e6a4c706909d26e90a056c,3,299,307,8,606,0,0,0,41,170,1,1,0.742166134,1342,6,82,9,175,176,1,4532,4559,27,90,90,0,0,100,NoArch
567e06a09a2e61a09742b5a39d987caa2a794092,0,0,0,0,0,0,0,0,0,0,0,0,0,0,0,0,0,0,0,0,0,0,0,0,0,0,0,100,NoArch
65faaf2360fda7ba349fc4d4cd662c1107033378,5,19,1,18,20,4,0,4,188,574,1,1,1.291760148,9552,2,1,1,1490,1490,0,48212,48194,18,289,289,0,0,98.67191343,NoArch
17c926ba65c3577e2d978ef1779a5bb118de992a,0,0,0,0,0,0,0,0,0,0,0,0,0,0,0,2,2,0,0,0,0,0,0,0,0,0,0,100,NoArch
90e572bed1f2ec6e05f53c853291e1a21b2ffb98,0,0,0,0,0,0,0,0,0,0,0,0,0,0,0,3,3,0,0,0,0,0,0,0,0,0,0,100,NoArch
8b5a6e3bd16d3a9f45c666ea66dee889367100ac,0,0,0,0,0,0,0,0,0,0,0,0,0,0,0,4,4,0,0,0,0,0,0,0,0,0,0,100,NoArch
86f19da4eadc39f24a37548a5f5da64af365b6b7,0,0,0,0,0,0,0,0,0,0,0,0,0,0,0,5,5,0,0,0,0,0,0,0,0,0,0,100,NoArch
2472ff8ed0666e750165ed1a68693d03854d78ff,2,132,131,1,263,0,0,0,10,237,1,1,0.26752362,1387,3,7,0,142,142,0,3662,3669,7,59,59,0,0,100,NoArch
0b428e5d490ded45c854d406ad40d163bbebb0d2,0,0,0,0,0,0,0,0,0,0,0,0,0,0,0,10,0,0,0,0,0,0,0,0,0,0,0,100,NoArch
700dfcb0511d3e29d837f789f5804ecac46c65e9,0,0,0,0,0,0,0,0,0,0,0,0,0,0,0,11,1,0,0,0,0,0,0,0,0,0,0,100,NoArch
f8d17c7f44e6302bc3479328d34d154095c51cdf,1,1,7,6,8,0,0,0,11,6,1,1,0,901,3,83,10,129,131,2,5025,5059,34,19,19,0,0,100,NoArch
80eec18dea97ba3353e6c90597c6a7250827fa1d,4,492,0,492,492,4,0,4,1,0,1,1,1.661854743,0,1,32,1,4,0,4,3614,0,3614,4,0,4,0,96.77754678,Arch
9e620781fb8962388e75763e693ef75491c1e624,0,0,0,0,0,0,0,0,0,0,0,0,0,0,0,98,13,0,0,0,0,0,0,0,0,0,1,100,NoArch
2f4fac0e839017a1e6ec25b83b996df5130eef9e,0,0,0,0,0,0,0,0,0,0,0,0,0,0,0,99,14,0,0,0,0,0,0,0,0,0,0,100,NoArch
a1f69a7661c6d5f45c9be37d778de6c15a3ae797,0,0,0,0,0,0,0,0,0,0,0,0,0,0,0,100,15,0,0,0,0,0,0,0,0,0,0,100,NoArch
4da304e10aff8569b135ffe40cf0b547f8ca1b8e,1,1,1,0,2,0,0,0,189,8,1,1,0,80,8,6,6,3,3,0,114,114,0,3,3,0,0,100,NoArch
b1216087431f45cb7f9dfb936168ce7f6acefa72,0,0,0,0,0,0,0,0,0,0,0,0,0,0,0,865,0,0,0,0,0,0,0,0,0,0,0,100,NoArch
eb92ae7d74a5c13e41870f9665baf3c60d787e3e,0,0,0,0,0,0,0,0,0,0,0,0,0,0,0,866,1,0,0,0,0,0,0,0,0,0,0,100,NoArch
63b28612b8d4cd89e83282b8f94781de3dae34f0,0,0,0,0,0,0,0,0,0,0,0,0,0,0,0,867,2,0,0,0,0,0,0,0,0,0,0,100,NoArch
112a6d2954f7568efb186ad121b5e419bcea1aba,0,0,0,0,0,0,0,0,0,0,0,0,0,0,0,868,3,0,0,0,0,0,0,0,0,0,0,100,NoArch
bfa9a7437e62365e9a12901b91754a82ffc1dcab,2,3,23,20,26,0,0,0,31,17,1,2,0.391243564,6224,3,7,7,1032,1032,0,31555,31555,0,179,179,0,0,100,NoArch
f8e7058e4da417dc2b5f0c3c1fab691b7c1e11d4,7,758,898,140,1656,0,0,0,124,284,1,5,1.108613881,6367,2,84,6,791,789,2,21316,21584,268,434,434,0,0,100,NoArch
e776ad43a1b170cf34812083d0ba8ebcb68e9463,1,6,2,4,8,0,0,0,65,44,1,1,0,812,6,85,3,165,163,2,4109,4076,33,31,31,0,0,100,NoArch
b3eec4507a6af69d4e64464625e7fdc4615f5c59,0,0,0,0,0,0,0,0,0,0,0,0,0,0,0,86,4,0,0,0,0,0,0,0,0,0,0,100,NoArch
7854d2aed99a96be8ef6fae04d3974d5bd488827,0,0,0,0,0,0,0,0,0,0,0,0,0,0,0,87,5,0,0,0,0,0,0,0,0,0,0,100,NoArch
cf4401840a9f352a962721ad717b79b3da756e74,1,9,9,0,18,0,0,0,16,498,1,1,0,788,3,88,6,100,100,0,3002,3002,0,46,46,0,0,100,NoArch
87fbe47d7fc95cf8b554d4cb41b768ca57ebfe69,1,12,10,2,22,0,0,0,17,77,1,1,0,232,5,89,5,26,26,0,792,786,6,14,14,0,1,100,NoArch
f4b3bf88b8825348c7caca6573f0737e2b4a76fb,1,1,1,0,2,0,0,0,9,691,1,1,0,187,3,101,0,16,16,0,782,779,3,4,4,0,1,100,NoArch
5dc5133d1e04352a186dea0d2b422fbb1febe2dc,1,9,9,0,18,0,0,0,125,22,1,1,0,4441,10,90,6,565,565,0,15020,15044,24,330,329,1,1,100,NoArch
ee4999089dc1db989c4337347c38f5d5f1d7e743,2,61,12,49,73,0,0,0,12,234,1,1,0.40985537,473,1,33,0,52,52,0,2128,2139,11,14,14,0,1,100,NoArch
ff2f11e01a0ec36cab078fa5ef0103b21037980b,1,2,1,1,3,0,0,0,5,513,1,1,0,133,4,102,1,12,12,0,235,229,6,8,8,0,0,100,NoArch
ba4293e029c1586b359e2906bfd4dd5a6fe9793f,1,46,2,44,48,0,0,0,16,528,1,1,0,261,4,103,2,29,29,0,963,963,0,16,16,0,0,100,NoArch
911c78d6f8f41abd6fb7b51074da1b27bc2db3f8,3,302,180,122,482,1,0,1,10,240,1,1,1.433956706,744,4,104,3,56,50,6,2033,1898,135,23,19,4,4,99.16186485,NoArch
07d364e220ede2052f3b7805122d0a8fae166c5d,2,50,0,50,50,2,0,2,3,295,1,2,0.141440543,226,2,105,4,36,13,23,1619,955,664,8,8,0,1,100,NoArch
ec626f6e41e9035f78334066a5feaf43a45d24b1,2,4,8,4,12,1,0,1,7,34,1,2,0.41381685,5707,2,106,5,948,948,0,29676,29675,1,151,151,0,2,100,NoArch
4be7ee0bb7dddee272c3398abb35af2364adf642,0,0,0,0,0,0,0,0,0,0,0,0,0,0,0,107,6,0,0,0,0,0,0,0,0,0,1,100,NoArch
48d02e793c35de638fe040ae0734367031a304d5,0,0,0,0,0,0,0,0,0,0,0,0,0,0,0,0,0,0,0,0,0,0,0,0,0,0,1,100,NoArch
c85a58ce4f95987a656b410af4f4c50f505c3d4d,0,0,0,0,0,0,0,0,0,0,0,0,0,0,0,869,0,0,0,0,0,0,0,0,0,0,0,100,NoArch
fa08fc1d7c556b942b3d3eaa9826a7e4e0e01ff0,0,0,0,0,0,0,0,0,0,0,0,0,0,0,0,7,0,0,0,0,0,0,0,0,0,0,1,100,NoArch
09c8ff5b8694c28a4503fc74c78d5441309b0939,1,238,77,161,315,0,0,0,126,26,1,1,0,4441,10,8,1,586,565,21,15473,15020,453,332,330,2,1,100,NoArch
94198d211d59895c265727ab7d11be8173136598,1,1,0,1,1,1,0,1,2,84,1,1,0,262,1,34,1,1,1,0,1869,1860,9,1,1,0,0,100,NoArch
3938c620c294895bc8ba91ba2fe29959e1cf5b96,0,0,0,0,0,0,0,0,0,0,0,0,0,0,0,9,2,0,0,0,0,0,0,0,0,0,0,100,NoArch
3bc315cc72b00a51e73e717663ee098ee9663d29,1,2,2,0,4,0,0,0,13,51,1,1,0,299,3,10,3,62,62,0,1311,1311,0,22,22,0,0,100,NoArch
9bed55c129b93dbebeb95e4cf9ce2de4e8d2fc2a,1,72,34,38,106,0,0,0,17,49,1,1,0,788,3,870,1,103,100,3,3090,3002,88,48,46,2,0,100,NoArch
4533061e3c4cdf7743efb78e90d26e581b7cf8bb,0,0,0,0,0,0,0,0,0,0,0,0,0,0,0,871,2,0,0,0,0,0,0,0,0,0,0,100,NoArch
328995714ba82e59fedd7ef8c70dc361fdc8031b,0,0,0,0,0,0,0,0,0,0,0,0,0,0,0,872,3,0,0,0,0,0,0,0,0,0,0,100,NoArch
59b64e5ae18a1630841838a91a060da1a626e8fd,1,0,1,1,1,0,0,0,3,1,1,1,0,263,2,11,4,1,1,0,1860,1869,9,1,1,0,0,100,NoArch
4b4da3f891eebf2667d17a56af79d9d33ed56c25,1,2,2,0,4,0,0,0,14,0,1,1,0,299,3,12,5,62,62,0,1311,1311,0,22,22,0,0,100,NoArch
902fd5405d36f09e94347f900b6714d87caf0c30,1,28,231,203,259,0,0,0,127,1,1,1,0,4602,10,13,6,555,586,31,14886,15473,587,326,332,6,0,100,NoArch
d3efc4755f8de8d9c84165e699eb04c8161511a6,0,0,0,0,0,0,0,0,0,0,0,0,0,0,0,14,7,0,0,0,0,0,0,0,0,0,0,100,NoArch
fba37747f6d0fb9300c2f90a41c46ef016e80e88,1,2,1,1,3,0,0,0,58,112,1,1,0,792,5,108,7,165,164,1,4582,4573,9,83,83,0,1,100,NoArch
f168cac9d4bca2be60e8286797dd75d424a46978,3,13,0,13,13,3,0,3,42,408,1,3,1.52623491,1023,2,15,8,136,133,3,3879,3784,95,52,51,1,1,100,NoArch
c3d44401b7b6e8a164cf87abcc2faf0906efe5a7,1,7,6,1,13,0,0,0,2,1294,1,1,0,79,2,1,1,12,11,1,367,338,29,8,8,0,1,100,NoArch
94a577a19132e89ced3582d3b5033f3629676a14,1,42,0,42,42,1,0,1,128,6,1,1,0,4399,10,109,8,563,555,8,15066,14886,180,328,326,2,1,100,NoArch
10ac2c8a14d05be39041b533676b90ad098ce762,1,1,0,1,1,1,0,1,4,28,1,1,0,116,3,2,2,1,1,0,752,739,13,1,1,0,0,100,NoArch
59f59fe5046eddc3f3d6899359a2b27c439d9763,0,0,0,0,0,0,0,0,0,0,0,0,0,0,0,110,6,0,0,0,0,0,0,0,0,0,0,100,NoArch
2c260d0ac508f9226cf21a5738cccb7973a11c22,1,2,2,0,4,0,0,0,5,834,1,1,0,256,4,8,0,32,32,0,1208,1213,5,8,8,0,0,100,NoArch
d3c9953d453244f2f421160f98b8bf30ca0ec160,1,1,1,0,2,0,0,0,18,83,1,1,0,497,6,0,0,53,53,0,1733,1733,0,19,19,0,0,100,NoArch
7e96085cdc7dd5d08ce6de697a31b1aa55669ccb,1,4,6,2,10,0,0,0,19,0,1,1,0,497,6,1,1,53,53,0,1702,1733,31,19,19,0,0,100,NoArch
059c97c290baa8ccbe185e8a72a05293583cbeff,0,0,0,0,0,0,0,0,0,0,0,0,0,0,0,3,3,0,0,0,0,0,0,0,0,0,0,100,NoArch
49519b4e53f2b11739f90d9130f71d451c999388,6,61,61,0,122,0,0,0,85,236,1,3,1.119260444,10288,5,16,9,1815,1819,4,50784,50884,100,335,335,0,0,100,NoArch
564ee29632cb5fda0a397dbc01cc4d9b92321c57,1,736,0,736,736,1,0,1,1,0,1,1,0,0,1,17,10,91,0,91,2044,0,2044,62,0,62,0,99.68847352,NoArch
4d9306c7b50c1c48750ac01cf5144939006b4c64,1,0,3297,3297,3297,0,0,0,9,125,1,1,0,3297,4,873,4,0,480,480,0,16780,16780,0,118,118,0,97.57185332,Arch
5094b18dd2b09a756388af3798b3c9ed7eafcac9,2,11,0,11,11,2,0,2,9,6,1,2,0.439496987,5703,4,874,5,951,948,3,29749,29678,71,152,151,1,1,100,NoArch
3982b2c04d14d15b649bc2ada5983496c5ee8558,3,119,24,95,143,2,0,2,3,199,1,1,1.575703743,520,3,875,6,55,50,5,2058,1735,323,27,23,4,0,99.10588235,NoArch
d2bd6c590c517d786109de215258bf0ada41f7a9,1,5,2,3,7,0,0,0,4,0,1,1,0,514,3,876,7,52,52,0,1734,1732,2,24,24,0,0,100,NoArch
3922dbe0ac6530c9f0a8d9ab032a6facd636deac,1,6,2,4,8,0,0,0,44,2,1,1,0,592,5,18,11,96,95,1,2182,2161,21,40,40,0,0,100,NoArch
c8452ef576eeffa7c00cee19e39b9095d43665ff,4,81,21,60,102,2,0,2,5,0,1,1,1.786368841,563,3,877,7,54,53,1,1935,1836,99,25,25,0,0,99.76711691,NoArch
36467c9992a365c16601fa63ac0bf9087e07de96,1,13,10,3,23,0,0,0,2,0,1,1,0,47,1,878,8,4,3,1,101,98,3,1,1,0,0,100,NoArch
907b5099c2bf2c4cad3efa722b540a4e5e14c9b1,0,0,0,0,0,0,0,0,0,0,0,0,0,0,0,879,9,0,0,0,0,0,0,0,0,0,0,100,NoArch
6fe22928fcab7f09b234e05fbc32a7957b8b2574,1,70,59,11,129,0,0,0,10,3,1,1,0,5596,6,19,12,950,950,0,28988,28984,4,151,151,0,0,100,NoArch
4783d7a74b2dc1ef8816aa3d5a3b75fa2f9d2355,2,8,2,6,10,0,0,0,4,364,1,2,0.721928095,577,3,880,10,53,52,1,1248,1227,21,27,27,0,0,100,NoArch
54a69df70b187020cd5a3ea1c0e303d9f54822d5,1,1,1,0,2,0,0,0,86,5,1,1,0,2322,11,20,11,461,460,1,10932,10928,4,75,75,0,1,100,NoArch
fda9290a1bd17f7ded81106d6544346626c72d7a,1,19,5,14,24,0,0,0,3,2,1,1,0,50,1,881,11,7,4,3,170,101,69,1,1,0,0,100,NoArch
71240585fd9487fd485dd4cf88ce3a20e93d811b,5,315,255,60,570,1,0,1,106,121,1,2,1.251525109,2462,1,882,9,252,241,11,8090,7868,222,78,68,10,0,98.81006865,NoArch
f0e3cde6d663ed3cc01db999134424b1b601eda7,2,170,170,0,340,0,0,0,107,0,1,1,0.450066658,2364,1,883,10,244,242,2,7628,7598,30,77,75,2,0,100,NoArch
10a47a73728d46ccee479b5c950a34ede1f04796,3,79,70,9,149,0,0,0,8,566,1,2,1.316923724,715,4,884,11,63,57,6,1486,1335,151,35,33,2,0,100,NoArch
64b240f70556f84dd2233518398f7ed4df3ae8e5,1,2,2,0,4,0,0,0,4,1281,1,1,0,124,2,4,3,8,8,0,329,329,0,6,6,0,0,100,NoArch
323fea41d17f649715bc9f611fee1ab75fef98d9,8,61,49,12,110,0,0,0,44,563,1,1,1.669805081,1715,2,885,12,262,252,10,6133,5840,293,137,130,7,0,99.72972973,NoArch
1e2d41093f9408d3ece230166a511b3cc45db2a3,0,0,0,0,0,0,0,0,0,0,0,0,0,0,0,5,3,0,0,0,0,0,0,0,0,0,0,100,NoArch
d592f7cce2fc6b77e1a2b7fd993f1634f2af5e20,1,7,1,6,8,0,0,0,4,1278,1,1,0,109,1,886,13,12,11,1,261,229,32,10,9,1,0,100,NoArch
a95811668eb8564a2e7afc0301f2417d607f254c,1,4,0,4,4,1,0,1,12,10,1,1,0,160,2,887,14,20,19,1,495,458,37,15,14,1,0,100,NoArch
b7f05b67134245891be5256707d995e8c7f01b73,5,70,57,13,127,1,0,1,129,20,1,2,1.214813298,12197,1,9,1,1880,1878,2,53301,53244,57,602,601,1,0,99.819982,NoArch
47d15fea0134d511bc1d66abd76e8d258cd97b67,30,65,69,4,134,0,0,0,17,544,1,4,4.813609385,10889,5,10,2,1726,1726,0,45795,45795,0,513,513,0,0,99.819982,NoArch
61808f99075419c0e193b0ae4d5bedddb46cac93,1,0,13,13,13,0,0,0,130,0,1,1,0,4454,11,11,3,563,565,2,15066,15123,57,328,329,1,0,100,NoArch
5b276f93b50a90be0bdef587a46c747a7392e3bc,1,36,0,36,36,1,0,1,131,0,1,1,0,4441,11,12,4,568,563,5,15212,15066,146,329,328,1,0,100,NoArch
af6b47e9dec49982fea130c87d9d049a33ec73fe,4,21,2,19,23,3,0,3,11,689,1,3,1.913166303,692,1,888,15,73,69,4,1661,1545,116,41,37,4,0,100,NoArch
17d6e064e3217bceca7ae1f2b93e4ddc3dd89400,2,447,427,20,874,0,0,0,39,120,1,1,0.215637715,1147,8,2,2,145,146,1,4423,4488,65,66,66,0,1,100,NoArch
1c62d56c316f75ad7c6816339d5d0cd58818992f,1,410,431,21,841,0,0,0,33,0,1,1,0,632,8,3,3,84,84,0,2576,2573,3,29,29,0,0,100,NoArch
631660ece1134d9bc7d31a097ea01d44a35496e6,1,7,0,7,7,1,0,1,7,1,1,1,0,535,4,889,16,55,53,2,1226,1192,34,25,25,0,0,100,NoArch
7fcc697a455c6a5e6916894ea9af65b9d068672c,1,1,0,1,1,1,0,1,8,3,1,1,0,126,4,890,17,15,15,0,314,300,14,11,11,0,0,100,NoArch
ecc208c3a556b7d25ca2b0d45df738e418ca9c34,2,70,21,49,91,0,0,0,45,8,1,2,0.152406999,6449,4,891,18,1121,1114,7,33132,32940,192,219,218,1,0,100,NoArch
d40307d5fb24fe01c4c5db0cff3abaf37ecdac18,49,4231,0,4231,4231,49,0,49,1,0,1,12,5.359534334,0,1,892,19,273,0,273,14300,0,14300,212,0,212,0,89.87908643,Arch
f9bce8c9a99460cf026cf6b4aac9ebb9a202b2d9,0,0,0,0,0,0,0,0,0,0,0,0,0,0,0,893,20,0,0,0,0,0,0,0,0,0,0,100,NoArch
7bd910fd508e0b966187f6cb33c9ec149ce6876e,0,0,0,0,0,0,0,0,0,0,0,0,0,0,0,894,21,0,0,0,0,0,0,0,0,0,0,100,NoArch
392994cb2f137fd004729a04b66ea0d8e55b54da,0,0,0,0,0,0,0,0,0,0,0,0,0,0,0,895,22,0,0,0,0,0,0,0,0,0,0,100,NoArch
e7bc96e2200602042286f5ed1d14e0079c056312,0,0,0,0,0,0,0,0,0,0,0,0,0,0,0,896,23,0,0,0,0,0,0,0,0,0,0,100,NoArch
7ae124bd0a9c34dd5b38b3f97b39974234da3ffd,0,0,0,0,0,0,0,0,0,0,0,0,0,0,0,897,24,0,0,0,0,0,0,0,0,0,0,100,NoArch
03b946249caa06525cd1fc05b3b1e720890cfccc,0,0,0,0,0,0,0,0,0,0,0,0,0,0,0,898,25,0,0,0,0,0,0,0,0,0,0,100,NoArch
71f1b8ce14409d3282ff3e093c3f7301466af3be,0,0,0,0,0,0,0,0,0,0,0,0,0,0,0,899,26,0,0,0,0,0,0,0,0,0,0,100,NoArch
1865b3c65f8c6cd5211c0ee7b6749d1bd1c948e2,0,0,0,0,0,0,0,0,0,0,0,0,0,0,0,900,27,0,0,0,0,0,0,0,0,0,0,100,NoArch
13668abbc958194ffdae56374718f6c3eec5abd1,0,0,0,0,0,0,0,0,0,0,0,0,0,0,0,901,28,0,0,0,0,0,0,0,0,0,0,100,NoArch
bf0e7050c2dcec5662705845d27df41e04ba691f,1,31,3,28,34,0,0,0,9,165,1,1,0,236,4,4,4,43,39,4,901,810,91,15,15,0,1,100,NoArch
4d63830a247350e6f7db5a0c720fab91493cc26f,1,40,52,12,92,0,0,0,132,4,1,1,0,4477,12,0,0,568,568,0,15234,15212,22,327,329,2,0,100,NoArch
d8a5a8f8412135a164341f6959cb0f65729823d2,0,0,0,0,0,0,0,0,0,0,0,0,0,0,0,1,1,0,0,0,0,0,0,0,0,0,0,100,NoArch
6525f96187ee788909ba646e204b4a032442f385,1,57,21,36,78,0,0,0,4,170,1,1,0,404,3,0,0,61,52,9,1294,1145,149,9,8,1,2,100,NoArch
f16ab923aa3a8e0ad5fb73765723013952cdbf2a,1,2,2,0,4,0,0,0,15,28,1,1,0,375,5,21,5,39,39,0,1620,1623,3,10,10,0,0,100,NoArch
3469da8c35e62accf270855418c55c931b95e1f0,1,0,1,1,1,0,0,0,2,924,1,1,0,319,2,1,1,28,29,1,761,764,3,7,7,0,2,100,NoArch
89802e1c91a4c5e6247ad6059e447bdb602f4a3e,0,0,0,0,0,0,0,0,0,0,0,0,0,0,0,2,2,0,0,0,0,0,0,0,0,0,1,100,NoArch
bbf31243d7f2815fc1ee9918e7668f0546b444bf,1,1,0,1,1,1,0,1,6,27,1,1,0,118,5,3,3,1,1,0,778,765,13,1,1,0,0,100,NoArch
5ef0ecac33a1ed6c8af5c70a03162711bb2709e3,8,107,41,66,148,2,0,2,133,7,1,4,2.031669462,11555,2,22,6,1816,1787,29,50572,49990,582,569,568,1,0,100,NoArch
15a6ca121f45a872970377ff612c308eeb6cdc3f,0,0,0,0,0,0,0,0,0,0,0,0,0,0,0,35,0,0,0,0,0,0,0,0,0,0,0,100,NoArch
cea82ae958ee5a3f7990f10af5a7fba5bb47de89,0,0,0,0,0,0,0,0,0,0,0,0,0,0,0,902,29,0,0,0,0,0,0,0,0,0,0,100,NoArch
3d63125e06bfd18ee54ceb190fe09a9da6a47aa9,1,3,1,2,4,0,0,0,17,88,1,1,0,305,4,903,30,29,29,0,978,963,15,16,16,0,0,100,NoArch
2ffc31d55c2f01ebdbf4a7cdfe79bf7af8830ad8,0,0,0,0,0,0,0,0,0,0,0,0,0,0,0,904,31,0,0,0,0,0,0,0,0,0,0,100,NoArch
9354b2164cf0603fbc8226c7e4ea0f66e1895e5a,5,215,496,281,711,1,4,5,2,4,1,2,2.045930104,496,1,905,32,14,4,10,1027,3666,2639,11,4,7,0,95.27057754,Arch
4a9d2942059948cb7f0246a9816615516195b7fb,0,0,0,0,0,0,0,0,0,0,0,0,0,0,0,906,33,0,0,0,0,0,0,0,0,0,0,100,NoArch
0f8daeb5160e7ee5c9191d726d6f5a6f7e809b32,0,0,0,0,0,0,0,0,0,0,0,0,0,0,0,907,34,0,0,0,0,0,0,0,0,0,0,100,NoArch
adc13b0f281fdb6fc7ba95bbb8db7d40b4cdf5de,0,0,0,0,0,0,0,0,0,0,0,0,0,0,0,908,35,0,0,0,0,0,0,0,0,0,0,100,NoArch
abc2fbd86e8f167d3259e4a4e568da1b94f44db8,0,0,0,0,0,0,0,0,0,0,0,0,0,0,0,909,36,0,0,0,0,0,0,0,0,0,0,100,NoArch
10c97812ecc0143f48788f61bf8c7bfafc7e6e9b,1,1,0,1,1,1,0,1,7,2,1,1,0,119,5,6,3,1,1,0,791,778,13,1,1,0,0,100,NoArch
a1a4399e4fdddc378174d6dabf51b97d7d6cb0f2,0,0,0,0,0,0,0,0,0,0,0,0,0,0,0,23,7,0,0,0,0,0,0,0,0,0,0,100,NoArch
d4fe919e0b3e4bb3c6adf89d8af6a3fe27021e54,0,0,0,0,0,0,0,0,0,0,0,0,0,0,0,910,37,0,0,0,0,0,0,0,0,0,0,100,NoArch
2d8979d324b65c84792df01612adb8f6971520a3,1,1,0,1,1,1,0,1,4,65,1,1,0,262,2,24,8,1,1,0,1869,1860,9,1,1,0,0,100,NoArch
6f5170c1954bdea83e5f792746bb6f7ce924b4b5,0,0,0,0,0,0,0,0,0,0,0,0,0,0,0,911,38,0,0,0,0,0,0,0,0,0,0,100,NoArch
60e39290c174ee312634c39af637904d681f36d7,0,0,0,0,0,0,0,0,0,0,0,0,0,0,0,912,39,0,0,0,0,0,0,0,0,0,0,100,NoArch
57f41256f2610fbdf847bc478cdcc9b82e981021,0,0,0,0,0,0,0,0,0,0,0,0,0,0,0,913,40,0,0,0,0,0,0,0,0,0,0,100,NoArch
e778f3ab5d767882ab23cad003486eae6e356220,0,0,0,0,0,0,0,0,0,0,0,0,0,0,0,914,41,0,0,0,0,0,0,0,0,0,0,100,NoArch
87b49de0f3b9e7e1b0da78dfc8bb33db39ebb3fc,0,0,0,0,0,0,0,0,0,0,0,0,0,0,0,915,42,0,0,0,0,0,0,0,0,0,0,100,NoArch
f50097ee5115eb0aa8da29b724d599d5556b3484,0,0,0,0,0,0,0,0,0,0,0,0,0,0,0,916,43,0,0,0,0,0,0,0,0,0,0,100,NoArch
27fed8a7ca8f5b9cc6bdcef5251b00d14aa7dafe,0,0,0,0,0,0,0,0,0,0,0,0,0,0,0,917,44,0,0,0,0,0,0,0,0,0,0,100,NoArch
b2b33423d9c6a86effac860454d1c41e22c3fb6d,2,12,1,11,13,1,0,1,2,497,1,2,0.619382195,60,1,918,45,1,1,0,66,37,29,1,1,0,0,99.90723562,NoArch
f4105082a92c6351991c5376e32e855bfbceca4c,0,0,0,0,0,0,0,0,0,0,0,0,0,0,0,919,46,0,0,0,0,0,0,0,0,0,0,100,NoArch
088bcfab1cecdacbb640e4335c173e77370bfc73,0,0,0,0,0,0,0,0,0,0,0,0,0,0,0,920,47,0,0,0,0,0,0,0,0,0,0,100,NoArch
cfd9926ea0608388f551327ad224d4235fcf27c8,1,1,4,3,5,0,0,0,8,2,1,1,0,120,6,5,5,1,1,0,752,791,39,1,1,0,0,100,NoArch
924fdb8c251885e14b5763e12ccd1db01b1b02f5,1,1,1,0,2,0,0,0,3,1,1,1,0,60,1,921,48,1,1,0,37,37,0,1,1,0,0,100,NoArch
d8483890f3d6b47982f8b85c626daf2cdd6c6e38,0,0,0,0,0,0,0,0,0,0,0,0,0,0,0,922,49,0,0,0,0,0,0,0,0,0,0,100,NoArch
a3fe0031e133a180bb62a61268e32739196f1cab,0,0,0,0,0,0,0,0,0,0,0,0,0,0,0,923,50,0,0,0,0,0,0,0,0,0,0,100,NoArch
124ced4e3d8e76f9653ad88153d513087eacbf0a,1,31,16,15,47,0,0,0,8,568,1,1,0,213,3,2,2,27,23,4,813,663,150,10,10,0,0,100,NoArch
e94de9715258f6e3a8246d96a2c46e444d9a4bf7,1,10,7,3,17,0,0,0,13,5,1,1,0,5656,6,3,3,972,971,1,29407,29373,34,151,151,0,0,100,NoArch
508abf234b0a7a4781fb071af8963a3d2227d2b2,1,6,0,6,6,1,0,1,59,67,1,1,0,793,6,25,9,171,165,6,4648,4582,66,83,83,0,0,100,NoArch
7ffbd2a0532e74671403b971518669e0eef27a43,3,56,74,18,130,1,0,1,14,6,1,3,0.397887415,6088,2,26,10,987,995,8,31686,31807,121,166,166,0,1,100,NoArch
85798ec6e68cc8a48b09273bead3e45474fa1ed6,0,0,0,0,0,0,0,0,0,0,0,0,0,0,0,4,4,0,0,0,0,0,0,0,0,0,0,100,NoArch
102707343fb1662cb5eaf0276a0b3838e9f535cd,0,0,0,0,0,0,0,0,0,0,0,0,0,0,0,5,5,0,0,0,0,0,0,0,0,0,0,100,NoArch
1e69405212bd3830441a4dc34c896827c99fec28,0,0,0,0,0,0,0,0,0,0,0,0,0,0,0,6,6,0,0,0,0,0,0,0,0,0,0,100,NoArch
4d88c7081a1d0631cb24df5ba5909de23e6f3ead,1,2,5,3,7,0,0,0,87,35,1,1,0,2322,11,27,11,462,461,1,10936,10932,4,75,75,0,0,100,NoArch
7c509593f7447caef70bb4c019bdffeee05c9803,1,16,0,16,16,1,0,1,134,11,1,1,0,4495,12,28,12,580,576,4,15567,15471,96,331,327,4,0,100,NoArch
242febb1dcaae524e236671e839d5681b013d57b,0,0,0,0,0,0,0,0,0,0,0,0,0,0,0,924,37,0,0,0,0,0,0,0,0,0,0,100,NoArch
88efbb5763e6dc3b1c241621b03389446b0baf91,0,0,0,0,0,0,0,0,0,0,0,0,0,0,0,925,38,0,0,0,0,0,0,0,0,0,0,100,NoArch
f875ab58a8b1b9abf59eb64ee0bba793c5b23ccf,1,2,1,1,3,0,0,0,15,21,1,1,0,5644,6,926,39,964,964,0,29302,29297,5,151,151,0,0,100,NoArch
8a91bbdec6553a97a4d0b69a425903845a0aba67,0,0,0,0,0,0,0,0,0,0,0,0,0,0,0,927,40,0,0,0,0,0,0,0,0,0,0,100,NoArch
1d1e4738552c66832b5d471c272c89c10a7d8ce1,0,0,0,0,0,0,0,0,0,0,0,0,0,0,0,928,41,0,0,0,0,0,0,0,0,0,0,100,NoArch
e459494ad08085e0bf829a5de3f1b4d1818deda4,0,0,0,0,0,0,0,0,0,0,0,0,0,0,0,929,42,0,0,0,0,0,0,0,0,0,0,100,NoArch
7b34618bfd779233e9b1fcd81222ae45d18fedd7,1,136,0,136,136,1,0,1,1,0,1,1,0,0,1,930,43,18,0,18,362,0,362,16,0,16,0,99.86111111,NoArch
4806da19a2e7ae719620902186ce608164c67d1b,1,3,0,3,3,1,0,1,6,658,1,1,0,1412,4,931,44,334,334,0,5035,5027,8,14,14,0,0,100,NoArch
d0af94fe7b555f839941b323936badd46500186b,1,1,1,0,2,0,0,0,18,31,1,1,0,307,5,29,8,29,29,0,978,978,0,16,16,0,0,100,NoArch
9d6c4d40267d64116e9852497cc93f5c4c6fc529,0,0,0,0,0,0,0,0,0,0,0,0,0,0,0,932,43,0,0,0,0,0,0,0,0,0,0,100,NoArch
7bc3adbf0948078287d6e8b490dc87d2480f5eed,0,0,0,0,0,0,0,0,0,0,0,0,0,0,0,933,44,0,0,0,0,0,0,0,0,0,0,100,NoArch
f38f925da1ac29051d149605b1e31430c4c7ec90,1,2,0,2,2,1,0,1,45,63,1,1,0,596,5,30,9,97,96,1,2196,2182,14,40,40,0,1,100,NoArch
9ae2955c0a38353d47713579ba5cb02b14aae7d7,1,10,1,9,11,0,0,0,16,5,1,1,0,5645,6,934,44,966,964,2,29337,29302,35,151,151,0,0,100,NoArch
8ee664dae84055646a6c22012db8571a240173e4,0,0,0,0,0,0,0,0,0,0,0,0,0,0,0,935,45,0,0,0,0,0,0,0,0,0,0,100,NoArch
d19f9ab081ad3fdc96782927fe34af65b6a1929a,0,0,0,0,0,0,0,0,0,0,0,0,0,0,0,936,46,0,0,0,0,0,0,0,0,0,0,100,NoArch
1ce2a654f178b1e43de99706891e71f4cc983bb3,0,0,0,0,0,0,0,0,0,0,0,0,0,0,0,937,45,0,0,0,0,0,0,0,0,0,0,100,NoArch
004e8ca50572d90b7515bd79aa2b725e477f6e92,0,0,0,0,0,0,0,0,0,0,0,0,0,0,0,938,46,0,0,0,0,0,0,0,0,0,0,100,NoArch
128e236e392701b264265591a84effdd2a55c8bd,0,0,0,0,0,0,0,0,0,0,0,0,0,0,0,939,47,0,0,0,0,0,0,0,0,0,0,100,NoArch
b451c1d13e76d5e34046cc3e5f94a5428e17ca97,0,0,0,0,0,0,0,0,0,0,0,0,0,0,0,940,48,0,0,0,0,0,0,0,0,0,0,100,NoArch
13760fc70212249bbb14e275e4c1b69664b040de,0,0,0,0,0,0,0,0,0,0,0,0,0,0,0,941,39,0,0,0,0,0,0,0,0,0,0,100,NoArch
58f03e2c48e7fd5de4febf2b7ad2c47b04bf25d0,0,0,0,0,0,0,0,0,0,0,0,0,0,0,0,942,40,0,0,0,0,0,0,0,0,0,0,100,NoArch
cc04a4c572d84cc85121ab1bc25f9f668a9fcef4,1,4,2,2,6,0,0,0,3,910,1,1,0,487,2,943,41,45,45,0,995,991,4,21,21,0,0,100,NoArch
c509c91ee9b93d00753ad08ebd43e4e0a09a4101,4,836,900,64,1736,0,0,0,8,42,1,1,1.600749118,1610,3,944,42,166,158,8,4153,4124,29,76,70,6,0,98.84341637,NoArch
fcba1440d8889ee307c49e09b0548e15a95e0740,10,605,166,439,771,3,0,3,190,245,1,5,2.728619833,10807,2,945,43,1990,1903,87,54624,53217,1407,486,446,40,0,99.78632479,NoArch
0b5704ed92da44fd0589bc4b2a55fda63299b157,1,9,4,5,13,0,0,0,5,44,1,1,0,440,3,7,3,62,61,1,1308,1294,14,9,9,0,1,100,NoArch
914288fbadc8c980b673b4ce491a801fdbb83e65,0,0,0,0,0,0,0,0,0,0,0,0,0,0,0,946,35,0,0,0,0,0,0,0,0,0,0,100,NoArch
9e3667525e69383e5fb99e1d7d52d1a6e4160e22,0,0,0,0,0,0,0,0,0,0,0,0,0,0,0,947,36,0,0,0,0,0,0,0,0,0,0,100,NoArch
2874182f791821e7852c234410b0c29413de34a4,0,0,0,0,0,0,0,0,0,0,0,0,0,0,0,948,37,0,0,0,0,0,0,0,0,0,0,100,NoArch
c02d5a3d3c4d3461581b73346618937be4d76a63,1,3,0,3,3,1,0,1,7,11,1,1,0,1415,4,949,38,334,334,0,5051,5035,16,14,14,0,0,100,NoArch
eb9b3cc43138ac132e7a624cfa88cc6b4ca8c1c2,0,0,0,0,0,0,0,0,0,0,0,0,0,0,0,950,39,0,0,0,0,0,0,0,0,0,0,100,NoArch
34869a9334114a2a45eaaf8596af3f251833b81f,0,0,0,0,0,0,0,0,0,0,0,0,0,0,0,951,40,0,0,0,0,0,0,0,0,0,0,100,NoArch
68be70400b0d214fd71ce3cfc79c4efddaf2b184,0,0,0,0,0,0,0,0,0,0,0,0,0,0,0,952,41,0,0,0,0,0,0,0,0,0,0,100,NoArch
a9f39941e9785845b6e6cbecedb7bef832be8192,0,0,0,0,0,0,0,0,0,0,0,0,0,0,0,953,29,0,0,0,0,0,0,0,0,0,0,100,NoArch
5203d9ea83d23c55090a9c9a2d838d896b2f7fe6,0,0,0,0,0,0,0,0,0,0,0,0,0,0,0,954,30,0,0,0,0,0,0,0,0,0,0,100,NoArch
bf31412762dc57a360f6731eaa9e9fe55f9db4e3,0,0,0,0,0,0,0,0,0,0,0,0,0,0,0,955,31,0,0,0,0,0,0,0,0,0,0,100,NoArch
c1017a19fb71827b1990d4e737eba0986b7c8701,1,39,0,39,39,1,0,1,135,35,1,1,0,4511,12,956,32,584,580,4,15751,15567,184,334,331,3,0,100,NoArch
73b209f3f60a53179c3bbd7076f0ee43440b53af,1,6,2,4,8,0,0,0,12,202,1,1,0,895,4,4,0,129,129,0,5059,5025,34,19,19,0,0,100,NoArch
58cd104379dc7b3f008cf5e6e007238bcd07e1f3,1,8,6,2,14,0,0,0,19,17,1,1,0,307,6,5,1,29,29,0,1001,978,23,16,16,0,0,100,NoArch
3596b6225c9e6422be2017c202acb5eaefa67e28,0,0,0,0,0,0,0,0,0,0,0,0,0,0,0,6,2,0,0,0,0,0,0,0,0,0,0,100,NoArch
5331beff6051bb32cd8ebda7f109b5bafc7b3ec6,1,5,0,5,5,1,0,1,9,45,1,1,0,117,7,7,3,1,1,0,804,752,52,1,1,0,0,100,NoArch
33d42498c75d9cfe641b3d5739f14476812be97c,1,8,0,8,8,1,0,1,18,11,1,1,0,5786,6,957,33,1002,1000,2,29896,29868,28,153,153,0,0,100,NoArch
9c1e72e5b28f0bf52f69b4f542fcbe9dcda44e8f,13,297,53,244,350,3,0,3,136,271,1,6,3.36047147,17144,9,8,1,2729,2664,65,72424,71203,1221,843,829,14,0,100,NoArch
263f2c9556f3160278cf1f347d7460e914971844,2,134,0,134,134,2,0,2,1,0,1,2,0.963535984,0,1,9,2,10,0,10,207,0,207,10,0,10,0,99.82993197,NoArch
e6db818a1eedfc7c64b7c3ba8085051bf77f5027,1,3,0,3,3,1,0,1,5,0,1,1,0,65,3,10,3,15,14,1,373,347,26,15,14,1,0,100,NoArch
664db0114c53c31a095c773003b2fc5acc05fbc6,1,0,4,4,4,0,0,0,6,0,1,1,0,68,3,11,4,14,15,1,347,373,26,14,15,1,0,100,NoArch
d7938cf405f56b2d46e1036a1e14b95440b0a163,1,0,1,1,1,0,0,0,6,0,1,1,0,952,3,12,5,129,130,1,3086,3094,8,1,1,0,0,100,NoArch
6ee3d04a560b099c0f284dec5836158d510159c9,1,1,0,1,1,1,0,1,7,0,1,1,0,951,3,13,6,129,129,0,3090,3086,4,1,1,0,0,100,NoArch
c22d61f351e5f696a062e192243be6b0e6349fe9,1,1,0,1,1,1,0,1,6,44,1,1,0,264,3,14,7,1,1,0,1887,1878,9,1,1,0,0,100,NoArch
ecb0dfc198157ebf96c24b24b691ff2e92735e62,1,1,0,1,1,1,0,1,7,0,1,1,0,265,3,15,8,1,1,0,1896,1887,9,1,1,0,0,100,NoArch
cf4b8153ada2cc1f5c3fd3f97c86c773837f007b,2,173,71,102,244,1,0,1,137,2,1,1,0.423199044,5401,7,958,34,770,767,3,20882,20724,158,423,421,2,0,99.95759118,NoArch
77c3f4dcb801cdfe953e1a71d2fdc9c6b3c0e7ce,1,1,1,0,2,0,0,0,138,0,1,1,0,4582,13,16,9,587,587,0,15814,15814,0,337,337,0,0,100,NoArch
9424e063e6e0a486fc979a7370042f2ee0b1f4b1,0,0,0,0,0,0,0,0,0,0,0,0,0,0,0,959,35,0,0,0,0,0,0,0,0,0,0,100,NoArch
6dbbcc9c95a4b3f76b23b15d41ed77b69f0bb1d3,2,26,6,20,32,1,0,1,89,14,1,2,1,2766,2,960,36,522,519,3,12237,12185,52,104,102,2,0,100,NoArch
142680822258db1e06625b25e2833bad733c6308,0,0,0,0,0,0,0,0,0,0,0,0,0,0,0,961,37,0,0,0,0,0,0,0,0,0,0,100,NoArch
1a19afe6d54a59f6ef7c3f1999b777d5d5fbcb20,0,0,0,0,0,0,0,0,0,0,0,0,0,0,0,962,38,0,0,0,0,0,0,0,0,0,0,100,NoArch
cee2deefbf55985633e637b0e761c589ebabf496,2,6,5,1,11,0,0,0,46,33,1,2,0.945660305,6718,7,31,2,1179,1180,1,34164,34174,10,222,222,0,0,100,NoArch
4dbce03811b3003506c059787455e02879b13e81,4,53,9,44,62,2,0,2,21,18,1,4,1.86671432,8652,3,17,10,1656,1645,11,40755,40569,186,193,193,0,0,100,NoArch
5da3a70e37574f91d2161c80053dc109d9c2efdb,1,16,3,13,19,0,0,0,139,3,1,1,0,4582,13,32,3,593,587,6,15922,15814,108,337,337,0,0,100,NoArch
65ed9004dbf91e508f335650669336544a47f3ed,2,16,21,5,37,0,0,0,140,0,1,2,0.639457132,6066,5,18,11,945,955,10,21163,21257,94,351,351,0,0,100,NoArch
9be8f1c70a8a6fc1d654d659d1421f63564aae7f,1,31,5,26,36,0,0,0,16,60,1,1,0,375,5,36,0,43,39,4,1714,1620,94,11,10,1,1,100,NoArch
0dec79214887120297fe807aef9ad208d9f94aa5,3,218,10,208,228,2,0,2,18,44,1,2,1.031245212,948,7,111,0,126,104,22,4662,3894,768,57,49,8,1,99.83050847,NoArch
91afebfe1be8fee20662ef4663a674eb8247ad59,2,2,2,0,4,0,0,0,22,343,1,2,1,5879,3,33,4,1014,1014,0,30195,30179,16,156,156,0,0,100,NoArch
5d9744221b0a9bbbe62ec10bc75ad6e96f7abf28,2,4,4,0,8,0,0,0,3,800,1,2,0.811278124,582,1,963,39,65,65,0,1503,1491,12,29,29,0,1,100,NoArch
fd381528ca91a59455b431a77101f06ae494aa63,1,2,1,1,3,0,0,0,23,1,1,1,0,5838,7,964,40,1010,1012,2,30066,30084,18,154,154,0,1,100,NoArch
6856381918bc4f41307177648f417ea2b02b48c4,2,62,15,47,77,0,0,0,90,80,1,1,0.294615206,2507,5,965,41,502,495,7,12149,11902,247,94,91,3,1,100,NoArch
1d76ef034b6e74142e6ded359d4b126595dbe3be,1,1,0,1,1,1,0,1,91,0,1,1,0,2273,11,966,42,469,469,0,11121,11114,7,77,77,0,0,100,NoArch
82784bcbf5c3313b2ac8a1b3e083a1545deb4a55,1,17,1,16,18,0,0,0,6,4,1,1,0,513,2,967,43,56,53,3,1180,1127,53,28,27,1,0,100,NoArch
4dabed4a3346968ff73e93302ff10b4d5910a102,0,0,0,0,0,0,0,0,0,0,0,0,0,0,0,968,44,0,0,0,0,0,0,0,0,0,0,100,NoArch
23e598175f0d8f84840cb27083668dab35b8b73d,2,82,3,79,85,1,0,1,92,0,1,1,0.450066658,2274,11,34,5,476,469,7,11333,11121,212,80,77,3,0,99.32885906,NoArch
e8c0b6b47ff82149f1f40755b9d69997a4bb4eba,2,320,108,212,428,0,0,0,67,41,1,2,0.272335908,946,6,969,45,210,178,32,5463,4434,1029,52,42,10,0,100,NoArch
8a15a54f6af12b3f47f548e5540cea1211b3c01b,1,6,6,0,12,0,0,0,93,0,1,1,0,2276,11,35,6,471,470,1,11154,11146,8,77,77,0,0,100,NoArch
ff77245c0152e9cac689e4ab51b414bae718c443,0,0,0,0,0,0,0,0,0,0,0,0,0,0,0,970,46,0,0,0,0,0,0,0,0,0,0,100,NoArch
4625aae16378062025e54ae4349ded186ad63745,1,15,2,13,17,0,0,0,19,1,1,1,0,281,6,36,7,36,33,3,1088,1035,53,17,17,0,1,100,NoArch
b929cd22d57d64bd9b9b0d2dc684e109466e0d3c,0,0,0,0,0,0,0,0,0,0,0,0,0,0,0,971,47,0,0,0,0,0,0,0,0,0,0,100,NoArch
cae8d49db0a7aa70a4978b4a26d6dbfbec8a4fc5,0,0,0,0,0,0,0,0,0,0,0,0,0,0,0,972,48,0,0,0,0,0,0,0,0,0,0,100,NoArch
e48f5bb46dc7c6d648d6e63ac10cc6267690f90c,0,0,0,0,0,0,0,0,0,0,0,0,0,0,0,973,49,0,0,0,0,0,0,0,0,0,0,100,NoArch
7685dd5947c838539ed93350fa15e8c4a60a4cf8,1,3,5,2,8,0,0,0,94,2,1,1,0,2276,11,37,8,471,471,0,11150,11154,4,77,77,0,0,100,NoArch
b02de7f6ecfc681260ce2ae4d58b8db84dc2ef43,0,0,0,0,0,0,0,0,0,0,0,0,0,0,0,974,50,0,0,0,0,0,0,0,0,0,0,100,NoArch
adb3c621ff22b56c02250ab4ce7ce60e994795af,0,0,0,0,0,0,0,0,0,0,0,0,0,0,0,975,51,0,0,0,0,0,0,0,0,0,0,100,NoArch
12706dabf4b169b35ef4f76ddd9adcd5f1e9bfb0,0,0,0,0,0,0,0,0,0,0,0,0,0,0,0,976,52,0,0,0,0,0,0,0,0,0,0,100,NoArch
24321293d2e9328055357ae840d3c194268cc08f,0,0,0,0,0,0,0,0,0,0,0,0,0,0,0,19,12,0,0,0,0,0,0,0,0,0,0,100,NoArch
ff4b70565a862b361b297451f7f493583636e09a,1,1,0,1,1,1,0,1,8,15,1,1,0,266,3,20,13,1,1,0,1905,1896,9,1,1,0,0,100,NoArch
7e66a27799545420e5fb3acd85bf15a14cffc4ab,0,0,0,0,0,0,0,0,0,0,0,0,0,0,0,21,14,0,0,0,0,0,0,0,0,0,0,100,NoArch
c7a4e110f3f5011ed19cb90569dd51acf8d7a30b,0,0,0,0,0,0,0,0,0,0,0,0,0,0,0,22,15,0,0,0,0,0,0,0,0,0,0,100,NoArch
b521241f9c5bfcbe736169a2b9d04fd1d8bcc702,1,4,1,3,5,0,0,0,7,12,1,1,0,529,2,977,50,56,56,0,1188,1180,8,28,28,0,0,100,NoArch
c9b7832547133fefc0599949c98c2272c7258aae,0,0,0,0,0,0,0,0,0,0,0,0,0,0,0,978,51,0,0,0,0,0,0,0,0,0,0,100,NoArch
ad67f1392eb103062866d5079aee432790a18552,0,0,0,0,0,0,0,0,0,0,0,0,0,0,0,38,9,0,0,0,0,0,0,0,0,0,0,100,NoArch
32dd11ff78f5ea58e95177eca1fa1d0efff36236,0,0,0,0,0,0,0,0,0,0,0,0,0,0,0,979,49,0,0,0,0,0,0,0,0,0,0,100,NoArch
079fa6b9e75ec1d474fc64b9d9075f1732dd9d6e,1,1,1,0,2,0,0,0,8,0,1,1,0,532,2,980,50,56,56,0,1188,1188,0,28,28,0,0,100,NoArch
f02d458013a1db083830c0c6663dd4abfe22076c,0,0,0,0,0,0,0,0,0,0,0,0,0,0,0,23,16,0,0,0,0,0,0,0,0,0,0,100,NoArch
263c13ac41a3cbab65e867b18cb6a6b6fbfa1ec5,0,0,0,0,0,0,0,0,0,0,0,0,0,0,0,37,1,0,0,0,0,0,0,0,0,0,0,100,NoArch
4e4d6e8507920c0424a83c5fc9ec188bf59557ae,7,2224,0,2224,2224,7,0,7,1,0,1,1,1.288094589,0,1,38,2,395,0,395,10484,0,10484,112,0,112,0,94.47827852,Arch
eb9a25d4f86494617fa076ad22dd150c5b827c6b,0,0,0,0,0,0,0,0,0,0,0,0,0,0,0,39,3,0,0,0,0,0,0,0,0,0,0,100,NoArch
4a8f2dfb48db903773cd386974adc06e59b78933,6,16134,0,16134,16134,6,0,6,2,0,1,2,0.778808859,2053,1,981,47,5259,377,4882,92132,10007,82125,505,97,408,0,99.68341907,NoArch
4df5ec2f8c40dc8899c55d39a950aeed7799a6d3,0,0,0,0,0,0,0,0,0,0,0,0,0,0,0,40,4,0,0,0,0,0,0,0,0,0,0,100,NoArch
16a1c6abeeb4b901fb0561208f25348ed619ba29,0,0,0,0,0,0,0,0,0,0,0,0,0,0,0,982,48,0,0,0,0,0,0,0,0,0,0,100,NoArch
1da3d2addb61ec6d56e4fcf6f520b22072098c42,115,14229,0,14229,14229,115,0,115,1,0,1,23,6.294479925,0,1,983,49,741,0,741,39160,0,39160,588,0,588,0,14.20678769,Arch
35b7f77eb1069b120879e7a3a794cf84e9554971,0,0,0,0,0,0,0,0,0,0,0,0,0,0,0,984,50,0,0,0,0,0,0,0,0,0,0,12.47511612,Arch
2e72382689fe6846091f2ceffd02b3b5ebd7ca50,0,0,0,0,0,0,0,0,0,0,0,0,0,0,0,985,51,0,0,0,0,0,0,0,0,0,0,100,NoArch
1d7ebd6723636eb1ae2f05368fb1e1bc1638731f,1,3,6,3,9,0,0,0,33,951,1,1,0,218,4,986,50,14,14,0,1027,1037,10,11,11,0,0,100,NoArch
f335313931302551e6c0f8ac1fdaf7a2371da6a3,0,0,0,0,0,0,0,0,0,0,0,0,0,0,0,41,5,0,0,0,0,0,0,0,0,0,0,100,NoArch
8d81c170893aed9ae5cd573b53e0c59d1bd28f7c,7,319,278,41,597,1,0,1,12,168,1,3,0.840573535,16988,2,987,43,4944,4942,2,86318,86348,30,441,441,0,0,100,NoArch
738137ec7dd3c791679390fe696395ecd05c0e17,3,15,8,7,23,0,0,0,10,694,1,3,1.409844941,412,1,988,42,4,4,0,1925,1950,25,3,3,0,0,99.39250759,NoArch
7a2979933468fec0062df0c04987905ebf6e41ba,0,0,0,0,0,0,0,0,0,0,0,0,0,0,0,989,43,0,0,0,0,0,0,0,0,0,0,100,NoArch
36f9ed494f359ee6abcbe33e5c019049f19bf0d1,2,24,11,13,35,0,0,0,20,68,1,1,0.315997133,896,7,39,8,99,96,3,3495,3416,79,31,30,1,0,100,NoArch
1fd4bac03cee3d78c33e6c3cc4bb8bc22ec5b41a,1,0,2,2,2,0,0,0,21,0,1,1,0,508,7,40,9,56,56,0,1776,1781,5,20,20,0,0,100,NoArch
0ebd9da57800993fcd88df72db1f1abf82b2cdab,1,2,1,1,3,0,0,0,22,4,1,1,0,506,8,24,16,56,56,0,1770,1776,6,20,20,0,1,100,NoArch
0116bf864ced52bd188b9d77a4ac03fe93680645,3,649,639,10,1288,0,0,0,3,3,1,1,0.625815078,16122,2,25,17,4883,4882,1,82131,82055,76,408,407,1,1,100,NoArch
16b3b2b9600e37160b8fb64917f9cf878b38e3fb,1,3,1,2,4,0,0,0,23,0,1,1,0,507,8,26,18,56,56,0,1780,1770,10,20,20,0,1,100,NoArch
4ba7b660ea35d6e49efd2645d69b4799b372bfc9,3,666,658,8,1324,0,0,0,4,0,1,1,0.693793736,16132,2,27,19,4902,4883,19,82229,82131,98,407,408,1,1,100,NoArch
20e04df4304c59a1594cf8a3b73c3ee976b38a6c,1,62,20,42,82,0,0,0,40,94,1,1,0,535,9,41,10,71,61,10,2088,1850,238,44,37,7,0,99.79395604,NoArch
b18d43cadf3cfc25e395c4a0b6c47c87838f7ba3,1,2,5,3,7,0,0,0,24,1,1,1,0,509,8,42,11,56,56,0,1776,1780,4,20,20,0,0,100,NoArch
b33b7f9f7e28cfa85e964ef9530b20e88d440765,1,7,0,7,7,1,0,1,3,1039,1,1,0,65,2,43,12,12,11,1,324,304,20,9,9,0,0,100,NoArch
d9e2bc04337fde61f1e4245b507d81ba7f984cca,0,0,0,0,0,0,0,0,0,0,0,0,0,0,0,0,0,0,0,0,0,0,0,0,0,0,0,100,NoArch
1bc96b7fb8f38778ee9f28a970b147ae8665fd37,3,513,530,17,1043,0,0,0,5,6,1,1,1.043921424,16140,2,28,11,4882,4902,20,82062,82229,167,407,407,0,1,100,NoArch
f21e5d5c87baf6ae87b5ccf5443851e3cee75659,4,4267,4239,28,8506,0,0,0,6,5,1,2,0.461960508,17843,3,1,1,5076,5216,140,90544,90165,379,493,490,3,0,100,NoArch
2dced48ff5e1521bb1e21542ced2b4952033f86c,1,51,22,29,73,0,0,0,95,39,1,1,0,2274,11,44,8,477,471,6,11365,11150,215,78,77,1,0,100,NoArch
d36de2300310a1b4ef5783148e3d49b8717b8cc8,1,61,5,56,66,0,0,0,2,976,1,1,0,23,2,45,9,12,2,10,375,93,282,10,2,8,0,100,NoArch
1b366adcc8f8cd588e9a4ac838f1b9ec86494da8,0,0,0,0,0,0,0,0,0,0,0,0,0,0,0,42,5,0,0,0,0,0,0,0,0,0,0,100,NoArch
ce32775818cb5e25acdc095540005a88e36b53a8,0,0,0,0,0,0,0,0,0,0,0,0,0,0,0,112,0,0,0,0,0,0,0,0,0,0,0,100,NoArch
e7f4c2d3e1eff73ca49393aed4649d1e7dc9ceaa,3,3,1,2,4,2,0,2,141,32,1,3,1.5,4844,7,29,10,586,585,1,17445,17408,37,339,339,0,1,100,NoArch
3cd3e17991ea95094ab482e34b851b8fe020dd0a,1,2,2,0,4,0,0,0,7,5,1,1,0,2904,4,0,0,1117,1117,0,19341,19351,10,102,102,0,0,100,NoArch
f88a55105526e3278ee519cfbc0dff06b3468a98,0,0,0,0,0,0,0,0,0,0,0,0,0,0,0,113,1,0,0,0,0,0,0,0,0,0,0,100,NoArch
402b6bb60ff460172ee2d793373e0aa52b284687,3,394,434,40,828,0,0,0,8,4,1,1,0.800653473,16151,4,43,6,4729,4740,11,81950,82307,357,405,409,4,0,99.86268452,NoArch
fa3ec0464453ffd5929517a4fea0eb1cbacc6a9e,4,916,811,105,1727,0,0,0,9,8,1,2,0.738962707,16261,4,2,2,4798,4748,50,83157,82610,547,414,409,5,0,100,NoArch
aa68338e94509b3e0d66f431298e47b64607328a,12,442,11,431,453,9,0,9,68,26,1,7,2.869870502,10995,4,30,11,1925,1876,49,55648,54357,1291,498,476,22,0,99.62380301,NoArch
d9f4a6cfc2bc3b1756646b5be9b264c1b1c6e815,0,0,0,0,0,0,0,0,0,0,0,0,0,0,0,31,12,0,0,0,0,0,0,0,0,0,0,100,NoArch
83534a50e8daf5a12a4ceb1a566bc2dccdfa4bc7,1,3,3,0,6,0,0,0,64,0,1,1,0,950,7,114,2,189,189,0,5261,5261,0,87,87,0,0,100,NoArch
5a8268a75c8af9f2515974d6c004683f76dfc140,1,82,20,62,102,0,0,0,96,6,1,1,0,2303,11,46,8,498,477,21,11804,11365,439,80,78,2,1,100,NoArch
f223c9b3322fef890c6db261720f703394c7cf27,1,1,3,2,4,0,0,0,5,5,1,1,0,1730,4,32,9,338,338,0,8276,8278,2,85,85,0,0,100,NoArch
5cbfe8441c5b3591dab4383a40632b370f294115,1,4,3,1,7,0,0,0,6,1,1,1,0,1728,5,47,8,337,338,1,8256,8276,20,85,85,0,0,100,NoArch
ae4508a57bc22bbc32872b8bab41fd4458ae5988,1,1,0,1,1,1,0,1,11,106,1,1,0,162,4,48,9,22,22,0,516,511,5,14,14,0,0,100,NoArch
46433e459e86b5b2100b4e178afd320477c100c7,1,5,0,5,5,1,0,1,25,6,1,1,0,5846,7,49,10,1012,1011,1,30145,30112,33,155,155,0,0,100,NoArch
2413cc6824508420406834ede9271b8ee660a2ab,0,0,0,0,0,0,0,0,0,0,0,0,0,0,0,50,11,0,0,0,0,0,0,0,0,0,0,100,NoArch
98ff5d884733d56c90cbaf46b7b3f469f47d5cd9,1,114,0,114,114,1,0,1,1,0,1,1,0,0,1,51,12,10,0,10,398,0,398,2,0,2,0,99.82975826,NoArch
a5808b4f9c3461ec44bd788294925bb592dffaa1,0,0,0,0,0,0,0,0,0,0,0,0,0,0,0,52,13,0,0,0,0,0,0,0,0,0,0,100,NoArch
ea67f11b8d41b89d7f5c04d99e191d1e405b6f28,1,4,1,3,5,0,0,0,97,7,1,1,0,2365,11,53,14,498,498,0,11808,11804,4,80,80,0,0,100,NoArch
2c02bf84d7233384cbfbbd1e8b7e1f94527d0f9b,1,13,2,11,15,0,0,0,46,83,1,1,0,598,5,54,15,98,97,1,2211,2196,15,41,40,1,0,100,NoArch
9dd5ce0479e6f04d8b94f39da24a05b1f250bc12,1,2,2,0,4,0,0,0,7,1572,1,1,0,94,2,55,16,5,5,0,162,159,3,5,5,0,0,100,NoArch
db523245322fe536a74704ed4d6f000b16a6c106,0,0,0,0,0,0,0,0,0,0,0,0,0,0,0,56,17,0,0,0,0,0,0,0,0,0,0,100,NoArch
8b8b60d8f7fd1c5bd9f6e0eeb93b1d8a813a645f,0,0,0,0,0,0,0,0,0,0,0,0,0,0,0,57,18,0,0,0,0,0,0,0,0,0,0,100,NoArch
21434767b3271ae5e976bccb869feaa61389ae3f,7,28,28,0,56,0,0,0,13,49,1,2,2.36287378,16739,2,44,3,4778,4778,0,85694,86019,325,414,414,0,0,95.82318134,Arch
9a11782471698755c30b633bccc1e604aeb77ee9,3,20,2,18,22,1,0,1,47,300,1,2,0.865856617,1676,4,45,3,262,259,3,7077,6959,118,117,116,1,0,100,NoArch
021dd63d2063952704509b27c7f87e3f5b55fd8e,1,3,0,3,3,1,0,1,7,8,1,1,0,1729,5,58,19,338,337,1,8286,8256,30,85,85,0,0,100,NoArch
7e1aac4e3356afafb30bd38a2fb271bf05bc8b6d,4,8,71,63,79,0,1,1,69,12,1,2,1.21223731,2204,7,115,3,409,413,4,11030,11103,73,134,134,0,0,99.85729575,NoArch
93d5805f24a4889e0fed335039f9ab1e06d4b87f,1,20,2,18,22,0,0,0,8,3,1,1,0,1732,5,46,4,343,338,5,8420,8286,134,86,85,1,0,100,NoArch
bb8c67621323232ca140b59caa4449dc71b0e6cf,0,0,0,0,0,0,0,0,0,0,0,0,0,0,0,59,15,0,0,0,0,0,0,0,0,0,0,100,NoArch
8d6fc28ce771a645d49f60f455631609a21d98b1,0,0,0,0,0,0,0,0,0,0,0,0,0,0,0,60,16,0,0,0,0,0,0,0,0,0,0,100,NoArch
d592e9777f6e8983797baaa7a9c4e92af45a7750,0,0,0,0,0,0,0,0,0,0,0,0,0,0,0,61,17,0,0,0,0,0,0,0,0,0,0,100,NoArch
6c9a3a2566acfdf43697839e89045688780089aa,0,0,0,0,0,0,0,0,0,0,0,0,0,0,0,62,18,0,0,0,0,0,0,0,0,0,0,100,NoArch
8e4b0acc703497c8a087392e00a691288ece83c9,0,0,0,0,0,0,0,0,0,0,0,0,0,0,0,63,19,0,0,0,0,0,0,0,0,0,0,100,NoArch
7bc2a762a09286351eca8a92d26529d53acae463,0,0,0,0,0,0,0,0,0,0,0,0,0,0,0,64,20,0,0,0,0,0,0,0,0,0,0,100,NoArch
e2707c94b6086e38526c9cb345b45af0ec720201,0,0,0,0,0,0,0,0,0,0,0,0,0,0,0,47,5,0,0,0,0,0,0,0,0,0,0,100,NoArch
66167153b3b638ff9fe321f03a75d455f0fe2e6e,5,135,13,122,148,1,0,1,98,200,1,2,1.918899046,2741,7,33,4,553,538,15,13892,13501,391,97,91,6,1,99.85729575,NoArch
768cf25ac7d3005fa59f124235f20dbd8ab6bfc7,0,0,0,0,0,0,0,0,0,0,0,0,0,0,0,34,5,0,0,0,0,0,0,0,0,0,0,100,NoArch
24c35a84582f980c99c0624da1eaa8c5bcfe5807,2,2,2,0,4,0,0,0,99,0,1,1,1,2472,2,35,6,508,508,0,12080,12080,0,84,84,0,1,99.92872416,NoArch
efb6f0741a7c816426a82ff1f78f77e127434618,1,3,1,2,4,0,0,0,15,0,1,1,0,135,7,36,7,1,1,0,685,698,13,1,1,0,0,100,NoArch
5bb7d9b00e3b1b18523223dcdc36d8c1f491ff6f,0,0,0,0,0,0,0,0,0,0,0,0,0,0,0,116,4,0,0,0,0,0,0,0,0,0,0,100,NoArch
3f4fcac9108161540ee9d7a74041582336fff058,0,0,0,0,0,0,0,0,0,0,0,0,0,0,0,48,6,0,0,0,0,0,0,0,0,0,0,100,NoArch
6cb0f85ae175e30235abea09711a16f4736ddf43,1,1,3,2,4,0,0,0,16,0,1,1,0,137,7,37,8,1,1,0,698,685,13,1,1,0,0,100,NoArch
adcb1230ff931cb50c0299c835450a6a03990934,1,1,1,0,2,0,0,0,17,0,1,1,0,135,7,38,9,1,1,0,685,698,13,1,1,0,0,100,NoArch
e9d01708b52f530c2d99ef394663f9f7b67d764f,0,0,0,0,0,0,0,0,0,0,0,0,0,0,0,117,5,0,0,0,0,0,0,0,0,0,0,100,NoArch
47d84673539aec3a85f2dc023a74da82565dfccd,2,18,4,14,22,0,0,0,18,4,1,2,0.439496987,319,7,39,10,43,41,2,1831,1725,106,9,9,0,1,100,NoArch
c61788704f9c647f02a4165dcf038a3252156973,1,151,49,102,200,0,0,0,9,18,1,1,0,1750,5,49,6,343,343,0,9031,8420,611,86,86,0,0,100,NoArch
24f8ba11965544e757418bf18d533d65f1b790e4,1,1,1,0,2,0,0,0,10,1,1,1,0,1852,5,50,7,343,343,0,9031,9031,0,86,86,0,0,100,NoArch
27957314a380e54096257a6753ad9d316ee78892,5,3388,1775,1613,5163,0,0,0,19,35,1,2,0.267083388,16624,7,51,7,5574,4776,798,93031,84838,8193,412,412,0,0,100,NoArch
5c53aea8416ae7d318cf0157b4690ba71badb0f9,6,1176,2818,1642,3994,1,0,1,13,29,1,3,0.271048728,20166,4,990,0,5146,5976,830,92935,101105,8170,531,529,2,0,100,NoArch
f537987f4d953d74b335eb13b33619509501a812,1,5,1,4,6,0,0,0,12,0,1,1,0,1867,5,991,1,347,346,1,9154,9132,22,87,87,0,0,100,NoArch
405566e5343dc570cc6cdd7dd560a4491dd31f59,0,0,0,0,0,0,0,0,0,0,0,0,0,0,0,992,2,0,0,0,0,0,0,0,0,0,0,100,NoArch
43489c1ba41efaa8d8feda0cb7b4555d11168736,3,0,16141,16141,16141,0,0,0,13,0,1,1,0.782041157,16141,4,52,7,0,4736,4736,0,82177,82177,0,410,410,0,99.64260186,NoArch
e1c4dfdde798f3a109599135cdb18a8fd685c223,1,5,1,4,6,0,0,0,13,0,1,1,0,1871,5,993,3,348,347,1,9177,9154,23,87,87,0,0,100,NoArch
0b5f88bce08acdfd67f320910a82765f150f9aa2,2,158,115,43,273,0,0,0,70,30,1,2,0.488429818,1277,7,994,4,252,248,4,6725,6604,121,48,48,0,0,100,NoArch
7e5d6934e0281bf2b9cee6b2c4b47bdafd587805,0,0,0,0,0,0,0,0,0,0,0,0,0,0,0,995,5,0,0,0,0,0,0,0,0,0,0,100,NoArch
14bd8f58f3b6e81e315cd9c70ecafdcaca1adc0f,0,0,0,0,0,0,0,0,0,0,0,0,0,0,0,996,6,0,0,0,0,0,0,0,0,0,0,100,NoArch
82067915d07858e2ea4bd55751b2468072f04eb8,0,0,0,0,0,0,0,0,0,0,0,0,0,0,0,997,7,0,0,0,0,0,0,0,0,0,0,100,NoArch
b38f53727fd3872ae7b49f10a5a41b7e80224367,1,1,1,0,2,0,0,0,4,105,1,1,0,302,1,998,8,39,39,0,973,967,6,17,17,0,0,100,NoArch
a10997b14a6de58450d495646417e19fb56eb1dd,10,173,3,170,176,8,0,8,100,30,1,6,2.023851254,13448,3,999,9,2437,2418,19,66747,66240,507,588,571,17,0,99.92836676,NoArch
248e9547b53f11454a9934cb93aea6b20b4467fe,0,0,0,0,0,0,0,0,0,0,0,0,0,0,0,1000,10,0,0,0,0,0,0,0,0,0,0,100,NoArch
0915ef24e9318c6aa78ff62deb8cd444200647d2,3,50,3,47,53,2,0,2,18,377,1,3,1.111976344,3495,3,1001,11,409,404,5,11247,11021,226,114,113,1,0,100,NoArch
84caa4f965d4ec748f0aa1f72fd8910dbd2c77b2,6,29,38,9,67,0,0,0,101,18,1,3,2.091782572,4892,2,53,7,877,877,0,24614,24457,157,176,176,0,0,100,NoArch
ac1a96c3c1bd25af5a4150a070981f8acf85ebe3,1,144,0,144,144,1,0,1,1,0,1,1,0,0,1,54,8,21,0,21,432,0,432,6,0,6,0,99.85678482,NoArch
8d097a9a382f79219b91bdbf5f5a66f832e3e369,48,0,4097,4097,4097,0,48,48,2,143,1,14,5.325645779,4097,1,1002,12,0,301,301,0,12052,12052,0,235,235,0,93.31806033,Arch
09f68032d573bc834ff0391a77c7a17638351a3f,1,2,2,0,4,0,0,0,15,0,1,1,0,278,4,1003,13,1,1,0,1880,1860,20,1,1,0,0,100,NoArch
a3553feaabb48eef0afd61214626bfecd241e4a2,2,9,7,2,16,0,0,0,17,0,1,2,0.811278124,2169,4,1004,14,351,351,0,11192,11146,46,89,89,0,0,100,NoArch
ce75db1c82020fe04e1c51b39854c92f358a5147,2,2,2,0,4,0,0,0,21,43,1,2,1,198,2,1005,15,3,3,0,841,828,13,2,2,0,0,99.95904996,NoArch
6bc124b9db21e1d47338045bb8c1f000e92855e8,2,3,1,2,4,1,0,1,41,39,1,2,0.811278124,708,7,1006,16,73,72,1,2861,2851,10,45,45,0,0,100,NoArch
6a660da5d5fbf407368d05ec5ba3cf1776b20d71,3,16,4,12,20,1,0,1,67,248,1,3,1.360964047,1362,7,1007,17,219,218,1,6929,6864,65,96,96,0,0,99.95904996,NoArch
9703673b5c325a70625e0fc360140ffdc98ea2d1,1,1,4,3,5,0,0,0,24,0,1,1,0,134,8,65,6,1,1,0,815,802,13,1,1,0,0,100,NoArch
945a9e5788411001674ac89ca084b045a368c061,0,0,0,0,0,0,0,0,0,0,0,0,0,0,0,66,7,0,0,0,0,0,0,0,0,0,0,100,NoArch
20d3969d0bf4a173c4fd6d551f961808fab16f9d,0,0,0,0,0,0,0,0,0,0,0,0,0,0,0,67,8,0,0,0,0,0,0,0,0,0,0,100,NoArch
d6caa2db0c5a8b516dda0d85e97a6467f4cc79c0,1,0,1,1,1,0,0,0,25,0,1,1,0,131,8,68,9,1,1,0,815,815,0,1,1,0,0,100,NoArch
13b622472daad530d8adcf4719ca4a13335ebfae,1,30,28,2,58,0,0,0,18,2,1,1,0,1893,5,3,0,355,350,5,9300,9278,22,88,88,0,0,100,NoArch
ddab5bf934c9f0f94e6a7295d8c3194e1eb7787b,3,5,3,2,8,0,0,0,19,341,1,3,1.5,2114,2,55,8,366,366,0,10431,10413,18,97,97,0,0,99.23139159,NoArch
1f29b2cc1ae82b346ec6046d4723153305966526,0,0,0,0,0,0,0,0,0,0,0,0,0,0,0,56,9,0,0,0,0,0,0,0,0,0,0,100,NoArch
a88da44ff3096632166974a651f188c7f364e811,1,2,0,2,2,1,0,1,17,9,1,1,0,278,4,1008,18,1,1,0,1932,1914,18,1,1,0,0,100,NoArch
a14f36db301ca2d6e2ef538a9f8f5b49e1f11ef0,1,1,0,1,1,1,0,1,18,0,1,1,0,280,4,1009,19,1,1,0,1941,1932,9,1,1,0,0,100,NoArch
a63258677d5099fe8bbb5d147ae0cc559c0b0d60,1,1,1,0,2,0,0,0,4,0,1,1,0,87,2,1010,20,1,1,0,782,765,17,1,1,0,0,100,NoArch
af7e15327eb4084217522ebff8b18330fdbd5848,1,29,24,5,53,0,0,0,20,1,1,1,0,1895,5,4,1,359,355,4,9361,9299,62,89,88,1,0,100,NoArch
127104060d608c13a06d3602c5f99f3745b42a47,0,0,0,0,0,0,0,0,0,0,0,0,0,0,0,69,5,0,0,0,0,0,0,0,0,0,0,100,NoArch
7f4d6d22b153f4edbd9d7fe15d05cfa569adbf86,1,0,71,71,71,0,1,1,2,1345,1,1,0,71,2,118,2,0,3,3,0,196,196,0,1,1,0,99.92,NoArch
3547757b7448f31eae731ebc293c6411bceba640,5,82,60,22,142,1,0,1,31,515,1,3,1.177202485,1016,3,119,3,73,78,5,5564,5757,193,61,62,1,0,99.75980785,NoArch
32c322d429bbbe42cc4d60bbb95ce3cf83bd9cc9,0,0,0,0,0,0,0,0,0,0,0,0,0,0,0,70,5,0,0,0,0,0,0,0,0,0,0,100,NoArch
c105d94502213fabd7a3bf83e5f38a941f11c7df,1,5,0,5,5,1,0,1,17,1225,1,1,0,255,2,71,6,17,19,2,1135,1285,150,15,17,2,0,100,NoArch
54930fee08776b188ed92718fdefed8fd2c22e0b,1,2,2,0,4,0,0,0,6,0,1,1,0,31,4,72,7,1,1,0,223,197,26,1,1,0,0,99.75980785,NoArch
dc80e0d9207a4f40a69f62a7e6e126b62775ad96,2,7,1,6,8,1,0,1,6,490,1,2,0.811278124,137,2,73,8,5,6,1,947,953,6,4,4,0,0,96.49122807,Arch
abdff77ea722c42e00a87028b1256c17da6fcb21,0,0,0,0,0,0,0,0,0,0,0,0,0,0,0,5,2,0,0,0,0,0,0,0,0,0,0,100,NoArch
cfd8225aa6fe4ad2dd5b720bc5f4a7c2230dd0a9,2,11,15,4,26,0,0,0,21,0,1,2,0.98285869,1955,3,57,9,363,363,0,9503,9507,4,92,92,0,0,99.96358339,NoArch
e3db3bd01fa588049857603481d4d183a4fcd1c0,2,4,23,19,27,0,0,0,26,423,1,2,0.605186577,166,2,58,10,2,4,2,876,894,18,2,3,1,0,99.48979592,NoArch
f26733cbb291b715da3c72389ddb8f15a359e4aa,0,0,0,0,0,0,0,0,0,0,0,0,0,0,0,59,11,0,0,0,0,0,0,0,0,0,0,100,NoArch
1eb4f82c9a48dc7a1f42b224184459b7de667415,2,4,3,1,7,0,0,0,18,182,1,1,0.985228136,553,1,60,12,57,57,0,2273,2257,16,15,15,0,0,100,NoArch
7e705c5374ed144d582e74dd04e43b5da0d89344,1,11,7,4,18,0,0,0,22,0,1,1,0,1903,5,74,9,358,358,0,9398,9345,53,89,89,0,0,100,NoArch
f1761872449b907b75f65b4f48da7ed1a678fe8a,1,17,8,9,25,0,0,0,23,0,1,1,0,1907,5,75,10,363,358,5,9444,9398,46,91,89,2,0,100,NoArch
4f6c3a80d2aa90a3a719d18bfb44fc68ae655f82,1,2,2,0,4,0,0,0,24,0,1,1,0,1916,5,76,11,363,363,0,9442,9444,2,91,91,0,0,100,NoArch
1f4ad90de6e76186eec366e076b92540957b1630,0,0,0,0,0,0,0,0,0,0,0,0,0,0,0,77,12,0,0,0,0,0,0,0,0,0,0,100,NoArch
35f642e05815d2c8036b7b33ea0fbdaab4075b31,0,0,0,0,0,0,0,0,0,0,0,0,0,0,0,1011,21,0,0,0,0,0,0,0,0,0,0,100,NoArch
0d9351d5e3bfa4affb02815e1f0c753ec587a2fb,0,0,0,0,0,0,0,0,0,0,0,0,0,0,0,1012,22,0,0,0,0,0,0,0,0,0,0,100,NoArch
52f19ac00954acd611fa8f59d275c10a024fc422,0,0,0,0,0,0,0,0,0,0,0,0,0,0,0,61,12,0,0,0,0,0,0,0,0,0,0,100,NoArch
b425d11c2bf031e99d8e37f59186756e93737a0f,0,0,0,0,0,0,0,0,0,0,0,0,0,0,0,78,13,0,0,0,0,0,0,0,0,0,0,100,NoArch
f656b9c18352fb003831acb494aa0d0fd6371ba2,0,0,0,0,0,0,0,0,0,0,0,0,0,0,0,1013,23,0,0,0,0,0,0,0,0,0,0,100,NoArch
663820454f335ceeeee8e6c83b524d63080d0b41,0,0,0,0,0,0,0,0,0,0,0,0,0,0,0,1014,24,0,0,0,0,0,0,0,0,0,0,100,NoArch
d6f6a1d822b3378b23e3b392e49939b127e7e532,0,0,0,0,0,0,0,0,0,0,0,0,0,0,0,79,14,0,0,0,0,0,0,0,0,0,0,100,NoArch
c5be77cfd3c569accfb451385c29921012c1a1e3,0,0,0,0,0,0,0,0,0,0,0,0,0,0,0,80,15,0,0,0,0,0,0,0,0,0,0,100,NoArch
8872d56dcd386bd28e3598527a12dd3463904d39,1,3,0,3,3,1,0,1,25,3,1,1,0,1916,5,1015,25,364,363,1,9459,9442,17,91,91,0,0,100,NoArch
bde5a5b53644b73d6280c16f872f0ab8819ce49c,0,0,0,0,0,0,0,0,0,0,0,0,0,0,0,1016,26,0,0,0,0,0,0,0,0,0,0,100,NoArch
8cea49dcf655c5bba28c49f39a7c13e5f224ea48,0,0,0,0,0,0,0,0,0,0,0,0,0,0,0,62,13,0,0,0,0,0,0,0,0,0,0,100,NoArch
e5127e085fcee4cdd48c26f64bfc4ca243a508fd,2,32,21,11,53,1,0,1,26,9,1,2,0.135036203,2221,2,81,16,405,403,2,10442,10432,10,108,108,0,0,100,NoArch
df84d5ea4a67656fb86864ccd21658e36f799b6f,6,77,5,72,82,2,0,2,27,68,1,5,2.166912966,9266,4,40,0,1553,1537,16,45370,44980,390,366,360,6,0,100,NoArch
8cfce5421e1391fa7882977f1fbc972512e0640d,4,61,5,56,66,1,0,1,28,49,1,4,1.606310933,8812,3,41,1,1526,1511,15,43064,42710,354,340,335,5,0,100,NoArch
77eddb15a96e44aaaedd1f788276ac20951cddb2,1,1,1,0,2,0,0,0,29,0,1,1,0,1937,5,42,2,368,368,0,9524,9524,0,91,91,0,0,100,NoArch
23e738fe6e1637a508c66ef6e60fe6217692e568,1,25,1,24,26,0,0,0,35,208,1,1,0,545,6,82,17,78,71,7,3167,2968,199,19,19,0,0,100,NoArch
2f2701676f7b1efac14ee32e0fdfd8bcce4ad175,6,2015,5,2010,2020,4,0,4,30,184,1,3,0.282258665,2678,5,83,18,459,453,6,12345,12198,147,166,160,6,0,99.85417426,NoArch
ebeff74b1830d3da8abdcbd688aeb736f9a07fce,182,519,31175,30656,31694,5,121,126,109,217,1,37,6.17697136,42805,2,1017,27,1783,3745,1962,54883,129419,74536,435,1408,973,0,79.82721382,Arch
dffa3c8dd0f2ac55dfade659fb086ff5f09f5f94,5,79,79,0,158,0,0,0,30,657,1,4,1.252724618,6459,1,1018,28,1088,1089,1,32027,32020,7,193,194,1,0,99.35965848,NoArch
4ee196de04dcf3540254550921ba602aaf4e0f5f,1,407,0,407,407,1,0,1,1,0,1,1,0,0,1,63,11,40,0,40,1076,0,1076,20,0,20,0,99.89270386,NoArch
f458b9e9505efa79bddfe7892fe5fc1f471bb857,6,95,65,30,160,1,0,1,48,312,1,2,1.941840713,7370,2,1019,29,1263,1260,3,36259,36183,76,275,273,2,0,98.17889663,NoArch
3e3e30485d053f29a10f54f09f358453b2703103,1,13,13,0,26,0,0,0,20,142,1,1,0,294,6,1020,30,34,36,2,1077,1088,11,17,17,0,1,100,NoArch
ba9cf4203fb1c31496f13075f8a2dfa148b558ed,1,4,0,4,4,1,0,1,72,40,1,1,0,1111,8,1,0,213,212,1,5624,5598,26,41,41,0,0,100,NoArch
84065f53daec1ff38ca3a79184e88890bfddac3c,1,20,23,3,43,0,0,0,32,3,1,1,0,1938,5,6,3,367,368,1,9517,9531,14,91,91,0,0,100,NoArch
00b4db565174f1d97e946243c44bae9b30f1db22,1,58,0,58,58,1,0,1,5,5,1,1,0,0,2,1021,20,1,0,1,93,0,93,1,0,1,0,99.35828877,NoArch
b25c8875f0b3052d0ab1af49faf5cbb131d7e98c,4,712,9,703,721,3,0,3,26,55,1,3,1.70857685,1285,7,84,19,197,145,52,6393,4462,1931,99,81,18,0,95.78252033,Arch
add0b7c331beae2ef586f9e17e762b486bba0040,1,1,1,0,2,0,0,0,2,1668,1,1,0,84,2,85,20,5,5,0,119,119,0,5,5,0,0,100,NoArch
743f7ae896a3e1ca6896390a688563a9442e5674,0,0,0,0,0,0,0,0,0,0,0,0,0,0,0,86,21,0,0,0,0,0,0,0,0,0,0,100,NoArch
52d506c4a497d18e0cecb99cd707e96220fa62b1,1,184,0,184,184,1,0,1,1,0,1,1,0,0,1,87,22,25,0,25,838,0,838,6,0,6,0,99.90319458,NoArch
e7f2eba178186c183f6e1b0614d33afd20d561eb,1,2,216,214,218,0,0,0,13,0,1,1,0,893,7,88,23,97,97,0,2762,2762,0,35,35,0,0,100,NoArch
28215792424ebafbf3edd0b9527fc6d8309b917a,1,32,5,27,37,0,0,0,2,0,1,1,0,265,1,89,24,48,48,0,1702,1728,26,17,17,0,0,100,NoArch
e46943a8ab97284247c7331ea0111b98df5ea2c8,1,65,47,18,112,0,0,0,3,0,1,1,0,292,1,90,25,49,48,1,1796,1702,94,19,17,2,0,98.01740812,NoArch
b23d703f8245112e0cb98e3dc3f5905bba1d7e59,1,4,4,0,8,0,0,0,14,0,1,1,0,679,7,91,26,97,97,0,2758,2762,4,35,35,0,0,100,NoArch
8d0508548ef98dd93acd68ed14d7cd42b448d53b,1,13,6,7,19,0,0,0,9,168,1,1,0,507,5,92,27,59,57,2,1273,1251,22,28,27,1,0,100,NoArch
0554f54652109d9292eb6bef10a4dbefe82e3109,1,2,2,0,4,0,0,0,10,0,1,1,0,514,5,93,28,59,59,0,1273,1273,0,28,28,0,0,100,NoArch
ad7fabb7412507057d99c919390bee1b21c2fffe,0,0,0,0,0,0,0,0,0,0,0,0,0,0,0,94,29,0,0,0,0,0,0,0,0,0,0,100,NoArch
ea65bb9f9347c7223330cabae98a8c4e3a2e5bed,1,102,45,57,147,0,0,0,4,0,1,1,0,310,1,95,30,69,49,20,2183,1796,387,22,19,3,0,100,NoArch
1cc1536f1462aa68217439e0727c68ec54997289,0,0,0,0,0,0,0,0,0,0,0,0,0,0,0,96,31,0,0,0,0,0,0,0,0,0,0,100,NoArch
6eca024351eb5d1a10f453d0ea5e99ac902f85a2,0,0,0,0,0,0,0,0,0,0,0,0,0,0,0,97,32,0,0,0,0,0,0,0,0,0,0,100,NoArch
01ab14183eff6384dbdf8476f5ede7567b5d7be8,1,2,1,1,3,0,0,0,5,0,1,1,0,367,1,98,33,70,69,1,2182,2183,1,22,22,0,0,100,NoArch
5c4702854fdde8d4399d1e66fb9da7d762550a6b,1,7,0,7,7,1,0,1,2,5,1,1,0,407,1,64,11,40,40,0,1144,1076,68,20,20,0,0,99.9516441,NoArch
6b8e2166b3ff7893e28f5bcd021e4dcc4ad1cc3b,0,0,0,0,0,0,0,0,0,0,0,0,0,0,0,65,10,0,0,0,0,0,0,0,0,0,0,100,NoArch
075acf55df585619d248095f5177fb585f8a15b0,1,5,2,3,7,0,0,0,3,7,1,1,0,414,1,66,11,41,40,1,1156,1144,12,20,20,0,0,100,NoArch
17645c53aaea630ac37a1f239bd931e36077015d,1,4,0,4,4,1,0,1,32,13,1,1,0,5850,8,2,1,1013,1012,1,30166,30140,26,155,155,0,0,100,NoArch
f9ee4a818a886204a5959cad7543966fd5c81255,2,174,2,172,176,1,0,1,142,66,1,2,0.050556934,4871,4,43,3,645,585,60,19378,17780,1598,353,338,15,0,100,NoArch
01821ae899951555c84a732003366e1572474917,0,0,0,0,0,0,0,0,0,0,0,0,0,0,0,44,4,0,0,0,0,0,0,0,0,0,0,100,NoArch
1086b89536cb2e098c7b0f31010bce44b23a4b8e,1,5,0,5,5,1,0,1,34,228,1,1,0,611,9,99,23,85,84,1,2605,2576,29,29,29,0,0,100,NoArch
04dda96a7881649f3d0250455948c58736899423,0,0,0,0,0,0,0,0,0,0,0,0,0,0,0,1022,5,0,0,0,0,0,0,0,0,0,0,100,NoArch
6a92689622ee60d867447c05231a26dd04a921ba,0,0,0,0,0,0,0,0,0,0,0,0,0,0,0,67,4,0,0,0,0,0,0,0,0,0,0,100,NoArch
674b6b6228a1c0e2f4f6b501c6299cbe24d2907e,5,55,21,34,76,0,0,0,102,194,1,3,1.543308357,3645,4,91,0,649,645,4,16989,16810,179,128,127,1,0,100,NoArch
a4a41cd1d2d9f6c0af1d3dafbcfbc77c0967aebe,1,2,3,1,5,0,0,0,103,0,1,1,0,2374,13,92,1,500,500,0,11784,11787,3,81,81,0,0,100,NoArch
104204bcf02ee751c2db68c9ed7bbd5e7218d0c2,1,243,71,172,314,0,0,0,143,25,1,1,0,4761,13,45,2,686,644,42,18501,17428,1073,353,352,1,1,99.9516441,NoArch
2628526797f3dfc867cb08eee75b6be5e5af5493,0,0,0,0,0,0,0,0,0,0,0,0,0,0,0,46,3,0,0,0,0,0,0,0,0,0,0,100,NoArch
3e9edcea9c7a56117040a51e684563c28f2ac72b,3,28,5,23,33,2,0,2,33,66,1,3,1.096139159,2174,8,47,4,384,378,6,10698,10578,120,103,102,1,1,100,NoArch
8ddd06ad5731f9cd508b0f6dbf3ce2e1bd7397b4,0,0,0,0,0,0,0,0,0,0,0,0,0,0,0,48,5,0,0,0,0,0,0,0,0,0,1,100,NoArch
6cbf794385291d57f1402802603e88c7b0141254,2,12,0,12,12,2,0,2,144,20,1,2,0.41381685,5215,4,68,3,688,687,1,20481,20451,30,355,354,1,0,100,NoArch
e0f55f51a6526f6a53f58ca824780a1940dfc0ec,1,9,11,2,20,0,0,0,2,85,1,1,0,144,2,0,0,21,21,0,424,432,8,6,6,0,1,100,NoArch
c4ea0da1f8c77f98f521748370f8d57ff392a58c,1,22,3,19,25,0,0,0,4,43,1,1,0,417,2,120,0,43,41,2,1321,1156,165,20,20,0,0,100,NoArch
3355f9c0d8e5f478f495a08267b787411f53ac0a,1,1,0,1,1,1,0,1,145,9,1,1,0,4944,13,121,1,687,687,0,18529,18522,7,354,354,0,0,100,NoArch
7020ef000cf902c98c7893b04e1728c0b4f9e9a1,0,0,0,0,0,0,0,0,0,0,0,0,0,0,0,0,0,0,0,0,0,0,0,0,0,0,0,100,NoArch
db81fd9f5db23bb2fa0ccbcabef304cbf29708fd,1,2,1,1,3,0,0,0,10,340,1,1,0,475,5,1,1,28,28,0,888,879,9,14,14,0,1,100,NoArch
2ba11e3d5161dbc3d73ce178490cc533d387243f,0,0,0,0,0,0,0,0,0,0,0,0,0,0,0,2,2,0,0,0,0,0,0,0,0,0,0,100,NoArch
eecdae5a81d1b2e4e5001019b4f13968935e76e3,1,481,378,103,859,0,0,0,11,0,1,1,0,476,5,3,3,45,28,17,1374,888,486,10,14,4,1,99.80648283,NoArch
542cb3e0fea2c1163cbf2c61c0c05847d36f1d6a,1,10,7,3,17,0,0,0,12,29,1,1,0,272,4,4,4,17,16,1,789,780,9,5,5,0,1,100,NoArch
6b7aa9f15c495fe111f2e85063590880fccf9c0a,1,35,8,27,43,0,0,0,2,1143,1,1,0,40,1,122,2,4,4,0,138,138,0,4,4,0,0,100,NoArch
b92cc49ae3f71bf963aa28ad2898be029fc2ffa2,0,0,0,0,0,0,0,0,0,0,0,0,0,0,0,5,5,0,0,0,0,0,0,0,0,0,1,100,NoArch
dd441dcf109165f852f10e67a842a6aa6db5ade2,3,177,85,92,262,1,0,1,13,2,1,1,1.432053223,854,5,6,6,60,62,2,2257,2163,94,15,15,0,2,99.46962392,NoArch
482a5161ab80113eb8f47a9974933e517042384c,1,31,19,12,50,0,0,0,2,0,1,1,0,142,1,7,7,5,5,0,212,299,87,2,2,0,0,100,NoArch
cc1a51d4edf48be0747c2cfa454055a4dfa12bb0,2,8,0,8,8,2,0,2,33,37,1,2,0.543564443,5983,8,49,4,1016,1014,2,31058,31007,51,156,156,0,1,100,NoArch
f3faba3009af2ba4fd84d0d42c6e476b90dd3d5b,1,2,0,2,2,1,0,1,13,2,1,1,0,520,6,50,5,40,40,0,1158,1203,45,9,9,0,0,100,NoArch
cf81811ab5dff9e867dbd44c331479fd97ba31eb,3,11,2,9,13,2,0,2,73,22,1,3,1.238901257,7106,8,51,6,1226,1229,3,36603,36682,79,197,197,0,2,100,NoArch
c621df1372516ff359b734465786872b73e4a242,1,7,7,0,14,0,0,0,14,0,1,1,0,522,6,8,8,40,40,0,1223,1158,65,9,9,0,0,100,NoArch
d516b7b8586e3be0b12a3cee89028e3858e4840c,0,0,0,0,0,0,0,0,0,0,0,0,0,0,0,123,3,0,0,0,0,0,0,0,0,0,0,100,NoArch
ab47061d4006ff42c4dd75c859c375adc84880a8,1,2,2,0,4,0,0,0,35,12,1,1,0,5865,8,3,0,1016,1017,1,30229,30232,3,155,155,0,1,100,NoArch
9e37c49f28893fc77694f21fc5cd532f29bdc5ca,9,333,12,321,345,7,0,7,68,45,1,7,2.131761703,10767,4,52,5,1797,1750,47,52899,51705,1194,482,458,24,0,99.80842912,NoArch
99b3bf8b1070df32a507e0332d50aaffe80dc00d,1,52,0,52,52,1,0,1,1,0,1,1,0,0,1,53,6,1,0,1,25,0,25,1,0,1,0,99.85687023,NoArch
0e7b73e20e370a8454c6b7d11dfef7b78a053774,1,176,176,0,352,0,0,0,8,121,1,1,0,280,4,124,4,28,28,0,839,839,0,7,7,0,1,100,NoArch
9a90b72de41dfdfd63381af168a79a6bb9d27556,1,34,16,18,50,0,0,0,36,52,1,1,0,623,9,125,5,89,86,3,2726,2635,91,30,30,0,1,100,NoArch
dc6e962848f98b442e12224c9aa92d08d788563a,0,0,0,0,0,0,0,0,0,0,0,0,0,0,0,4,1,0,0,0,0,0,0,0,0,0,0,100,NoArch
2c5e4f123981a08a7105a0f34b4fd3ba0d143d65,1,24,0,24,24,1,0,1,146,27,1,1,0,4945,13,126,6,690,687,3,18655,18529,126,355,354,1,1,100,NoArch
9739394bdd4ca77c3b4c4742aeabd6294fcbc694,2,5,7,2,12,0,0,0,14,777,1,1,0.41381685,270,3,9,9,22,22,0,793,806,13,8,8,0,1,100,NoArch
544fc75d8fb9dc5f4339007474537ae4b98bc989,2,3,2,1,5,0,0,0,30,59,1,2,0.970950594,266,8,54,5,14,14,0,1346,1346,0,9,9,0,0,99.90467112,NoArch
529ac71f4437208e5ed98f22f4b51cb4f6306d45,1,1,1,0,2,0,0,0,31,0,1,1,0,132,8,55,6,1,1,0,880,880,0,1,1,0,0,100,NoArch
596b97d235a58eb2f14502e8ecbbae9ad974c369,0,0,0,0,0,0,0,0,0,0,0,0,0,0,0,56,7,0,0,0,0,0,0,0,0,0,0,100,NoArch
8833e02b5650464ec814ed4a128e3e98e765a367,0,0,0,0,0,0,0,0,0,0,0,0,0,0,0,57,8,0,0,0,0,0,0,0,0,0,0,100,NoArch
5ec40fea3e2b3be84b0ae2565ab7c04ef4e10456,1,2,0,2,2,1,0,1,3,203,1,1,0,79,2,100,0,13,12,1,393,375,18,10,10,0,0,100,NoArch
0ce8964cb4a326e51364a60b19b755f5404db585,1,1,1,0,2,0,0,0,35,22,1,1,0,1977,6,13,0,373,373,0,9750,9750,0,93,93,0,0,100,NoArch
38e120edb3cc2bc05d91a511988dae273e27ab4a,3,70,8,62,78,2,0,2,36,218,1,2,1.108242604,2227,4,58,6,420,401,19,10953,10450,503,118,116,2,0,100,NoArch
e7321c087b7c0c500269e757fe8873ccef4be01f,1,9,46,37,55,0,0,0,37,0,1,1,0,2014,6,59,7,373,386,13,9750,10061,311,93,93,0,1,100,NoArch
27ca66a55dec7811f36d95ccfb985a5840b4f422,1,46,9,37,55,0,0,0,38,1,1,1,0,1977,6,60,8,386,373,13,10061,9750,311,93,93,0,1,100,NoArch
e0d068e0fc0c37bbabc7da5190c7da7d56ef43a8,1,123,15,108,138,0,0,0,47,203,1,1,0,609,6,61,9,118,98,20,2913,2211,702,43,41,2,0,100,NoArch
58202923ed1f9a99ded60db68913c2edca69d2f8,0,0,0,0,0,0,0,0,0,0,0,0,0,0,0,101,1,0,0,0,0,0,0,0,0,0,0,100,NoArch
5aad06473f85550af4bbf1693e785d8771bd6161,0,0,0,0,0,0,0,0,0,0,0,0,0,0,0,62,10,0,0,0,0,0,0,0,0,0,0,100,NoArch
a6bdbff9b9ea1730df0d31128e56cdc4095d9ff0,1,0,87,87,87,0,0,0,48,1,1,1,0,717,6,63,11,104,118,14,2375,2913,538,41,43,2,0,100,NoArch
d35026714e5fb40a9b3e5862be27727573225264,0,0,0,0,0,0,0,0,0,0,0,0,0,0,0,93,0,0,0,0,0,0,0,0,0,0,0,100,NoArch
71a59e323ae0716fecad777cd74879f5a6568494,5,139,8,131,147,1,0,1,39,102,1,1,1.572957441,2368,2,69,0,462,437,25,11966,11400,566,118,109,9,0,99.9047619,NoArch
eada769803feab3fb5cf51f51f769163b0882aec,25,156,124,32,280,0,0,0,191,560,1,9,4.10474738,14601,2,14,1,2251,2246,5,65503,65341,162,593,594,1,0,100,NoArch
f620e1b30c24cf357e921ed228e0094248df6fd4,1,4,0,4,4,1,0,1,4,0,1,1,0,282,2,15,2,42,41,1,793,776,17,40,39,1,0,100,NoArch
5a8951b1138ea3fc3cf5ffd62276edbee2a8c181,0,0,0,0,0,0,0,0,0,0,0,0,0,0,0,16,3,0,0,0,0,0,0,0,0,0,0,100,NoArch
9bd4282d7b52d6da3319e844fcbf1007968ec8b9,2,141,47,94,188,0,0,0,74,43,1,2,0.550984443,1749,8,64,6,336,312,24,8511,7879,632,83,82,1,0,100,NoArch
5f50b124e7fcc4d38789d1f50481f3f272324f84,1,1,36,35,37,0,0,0,38,5,1,1,0,676,9,17,4,89,96,7,2726,2994,268,30,30,0,0,100,NoArch
e4fc58bbddf306a97facfa1e786945154c839871,1,1,1,0,2,0,0,0,2,9,1,1,0,93,2,65,7,18,18,0,381,383,2,3,3,0,0,100,NoArch
3521e8b57d56f1492086e7dc167504ef74f34304,1,265,0,265,265,1,0,1,15,135,1,1,0,679,7,102,2,97,97,0,2758,2758,0,35,35,0,0,100,NoArch
ba30cfce3ff177ecdd3cb7cefafc791b707d7746,1,2,2,0,4,0,0,0,3,0,1,1,0,93,3,103,3,18,18,0,385,381,4,3,3,0,0,100,NoArch
a420c60ae89f5e2d78a1025affcdfdf0be35374e,1,1,21,20,22,0,0,0,20,294,1,1,0,309,6,127,0,29,29,0,921,1001,80,16,16,0,0,100,NoArch
3ef8ab03e176ee49f64499bb05eb6d3f14def7a4,4,165,193,28,358,0,0,0,15,79,1,1,1.111402203,1111,6,10,0,74,75,1,2693,2769,76,19,19,0,1,99.76156414,NoArch
ac7b9f53cacafa138f26958b68a8a72cdefb0544,1,494,181,313,675,0,0,0,6,141,1,1,0,368,1,104,3,126,70,56,3767,2182,1585,41,22,19,0,98.83612663,NoArch
85a0309b7d3cc06b42da1449b1a5bd02a0445b55,1,1,2,1,3,0,0,0,7,1,1,1,0,681,1,105,4,126,126,0,3767,3767,0,41,41,0,0,100,NoArch
9eb637e484565eec069a08a1bcb8915fc3ceb9f8,6,83,65,18,148,1,0,1,41,31,1,3,1.916984482,10603,5,106,5,1769,1761,8,52034,51911,123,370,369,1,0,100,NoArch
dfa6f5bf3465cd5cfe6a781ed792290cd2fb21c1,5,27,3,24,30,2,0,2,39,169,1,3,2.066052868,2618,5,107,6,306,301,5,9171,9043,128,113,112,1,0,100,NoArch
b9010fb135ffcf5b2ec84ea88e8f38f3ac6f2216,1,4,2,2,6,0,0,0,42,0,1,1,0,2021,6,108,7,388,388,0,10142,10102,40,93,93,0,0,100,NoArch
c876e0d3fc6061edec2b0be8dfe0bb1c71acdee6,4,151,4,147,155,3,0,3,75,18,1,3,1.413021715,1403,5,128,1,215,211,4,7688,7504,184,43,42,1,0,99.81884058,NoArch
0cf59b73e7473b09ced40c9f2731566bc4f87681,2,46,3,43,49,1,0,1,43,0,1,2,0.688047624,2593,6,109,8,475,468,7,13576,13313,263,113,112,1,0,100,NoArch
256bc9dd79719c4e5bd6a700c2e91aa0a47f6e3f,1,12,34,22,46,0,0,0,15,8,1,1,0,210,4,11,1,8,10,2,474,551,77,2,2,0,0,100,NoArch
d8592f1b049b0b41a453911646c34cd4407cfaee,0,0,0,0,0,0,0,0,0,0,0,0,0,0,0,12,2,0,0,0,0,0,0,0,0,0,0,100,NoArch
ee37a7bea492957731646eeaf47ba3553db12fef,0,0,0,0,0,0,0,0,0,0,0,0,0,0,0,13,3,0,0,0,0,0,0,0,0,0,0,100,NoArch
7808fd21e3cd8bb2575c931ef1afde7f269dc3e6,1,113,0,113,113,1,0,1,147,68,1,1,0,4969,13,129,2,706,690,16,19025,18655,370,361,355,6,1,100,NoArch
3ee65af1c731da7f06b29422f39b95b93fd132ec,1,1,0,1,1,1,0,1,25,5,1,1,0,285,5,130,3,1,1,0,1986,1977,9,1,1,0,1,100,NoArch
f32d73a26425027c1744a708324a88265f26040f,0,0,0,0,0,0,0,0,0,0,0,0,0,0,0,66,5,0,0,0,0,0,0,0,0,0,1,100,NoArch
8817000c9ee364df3995a9a00fd2644d09968c2c,0,0,0,0,0,0,0,0,0,0,0,0,0,0,0,7,0,0,0,0,0,0,0,0,0,0,0,100,NoArch
ca10f244710ea65163645c47a19815a111d847b1,0,0,0,0,0,0,0,0,0,0,0,0,0,0,0,8,1,0,0,0,0,0,0,0,0,0,0,100,NoArch
abe46aaa233c9aebd0ecae2a4df3c0b7f66d3eb1,8,373,27,346,400,6,0,6,44,24,1,3,2.480233772,2300,1,70,1,466,424,42,13085,11586,1499,126,109,17,0,99.54975236,NoArch
6d4df659a9e70d7e0d108311097068e7513352fb,2,17,122,105,139,1,0,1,32,771,1,2,0.06155708,317,8,9,2,6,16,10,1027,1245,218,5,11,6,0,99.86553115,NoArch
79771c332dd1a7388725a406a0758f60a6549d40,3,63,18,45,81,0,0,0,16,15,1,1,1.016221373,893,6,14,4,60,57,3,2139,2037,102,16,15,1,1,99.8655914,NoArch
6fc5b890868899b631b5d8fd0be27ce0e80d04bf,5,214,2,212,216,4,0,4,104,25,1,2,1.54553589,2506,8,10,3,527,501,26,13529,12677,852,98,82,16,0,99.68736043,NoArch
b1779b32819ddc605c5806fe5419a9b60d9dd6b1,3,36,37,1,73,0,0,0,21,8,1,2,0.550305389,466,7,11,4,53,55,2,1683,1712,29,33,32,1,0,99.51024043,NoArch
0ecdb6c5b9ebab095ad6680a29f9b5264b562322,4,11,9,2,20,0,0,0,76,363,1,4,1.846439345,2416,3,131,4,347,346,1,9104,9092,12,101,101,0,0,100,NoArch
a3bffec7459156be4b4298b5076ce2dbd669438e,1,2,0,2,2,1,0,1,26,17,1,1,0,286,6,12,5,1,1,0,1995,1986,9,1,1,0,0,100,NoArch
6ea54e627852f4f2256061b868c5a907f7675e80,17,554,525,29,1079,3,0,3,45,384,1,6,2.640311491,6349,5,110,8,863,873,10,25406,25257,149,293,287,6,0,99.64381122,NoArch
d4c4057e4dc6b60219d2ab6b35deb977971aefe5,2,2,1,1,3,1,0,1,34,13,1,1,0.918295834,211,4,111,9,2,2,0,1521,1521,0,2,2,0,0,100,NoArch
1b3858a415a513851df8da5fb0ca2aabd82bf80c,1,0,3,3,3,0,0,0,22,9,1,1,0,285,7,132,5,29,29,0,850,889,39,16,16,0,0,100,NoArch
7024d1e52181424191b81ebcae036af8216bcc5a,1,1,0,1,1,1,0,1,23,0,1,1,0,282,7,133,6,29,29,0,867,850,17,16,16,0,0,100,NoArch
b9b5745686cfed77881770e6d41902ac949ad0b2,1,17,10,7,27,0,0,0,28,0,1,1,0,507,8,112,10,60,56,4,1795,1697,98,20,20,0,0,100,NoArch
618c5227af664bd3aec2e213fe9c3734df3264cd,1,108,51,57,159,0,0,0,4,33,1,1,0,168,3,15,5,20,15,5,662,579,83,4,4,0,0,100,NoArch
b44ab8c65fe15fb463a612ea3e58df0e966a3db9,1,14,11,3,25,0,0,0,10,1,1,1,0,695,1,113,11,131,129,2,3883,3849,34,43,42,1,0,100,NoArch
64cced9e6e7670aaaf4186672bac75c40bf6c2f2,21,72,83,11,155,0,0,0,42,176,1,10,3.384673893,6737,4,16,6,780,780,0,25768,25881,113,305,305,0,0,100,NoArch
4f6e80586be9c069aa81b82dfc56cbaad550b997,1,6,3,3,9,0,0,0,2,1,1,1,0,351,1,114,12,49,47,2,1150,1104,46,24,24,0,0,100,NoArch
8fb6f06cfd12b77e4898f2c9da0948dfa0228453,1,1,1,0,2,0,0,0,3,0,1,1,0,354,1,115,13,49,49,0,1150,1150,0,24,24,0,0,100,NoArch
1e86efdcb9380afe732f15fbd87151c09d169e4b,1,34,16,18,50,0,0,0,11,0,1,1,0,698,1,116,14,130,131,1,3975,3883,92,44,43,1,0,100,NoArch
1a9080ec0e72843208fbab99915d7f7d6eb3432e,2,60,23,37,83,0,0,0,5,582,1,1,0.896892883,314,2,17,7,36,36,0,1072,1072,0,20,20,0,0,100,NoArch
5df9404e91bbd649b5830dab46c6fffe02259b8c,0,0,0,0,0,0,0,0,0,0,0,0,0,0,0,13,6,0,0,0,0,0,0,0,0,0,0,100,NoArch
4c7f7a27f2d95d3d5c99e1405641f7f8e96e773a,1,100,1,99,101,0,0,0,12,0,1,1,0,716,1,117,15,156,130,26,4682,3975,707,48,44,4,0,100,NoArch
ced90677c153a672c85246be7825da080db9ff64,1,1,2,1,3,0,0,0,13,0,1,1,0,815,1,118,16,156,156,0,4676,4682,6,48,48,0,0,100,NoArch
9ade08f8df7c6f8cebdde57025f7eebeac4da5ac,9,78,11,67,89,2,0,2,35,436,1,7,1.727702284,1636,4,18,8,86,82,4,4107,3935,172,60,56,4,0,98.45173042,NoArch
213865fd2b05d86c7a89dc5b68ff8ad69934851c,1,16,7,9,23,0,0,0,7,198,1,1,0,153,2,19,9,14,14,0,612,556,56,4,4,0,0,100,NoArch
b2d7375c7406f10fca82b7222813b7369c1fc05e,0,0,0,0,0,0,0,0,0,0,0,0,0,0,0,119,17,0,0,0,0,0,0,0,0,0,0,100,NoArch
b31711d5851cbe4d9076ffa7738e9411d24f9308,0,0,0,0,0,0,0,0,0,0,0,0,0,0,0,20,10,0,0,0,0,0,0,0,0,0,0,100,NoArch
486da8d7b41e72315cdeaddf2d06e859336eab4f,1,90,83,7,173,0,0,0,17,16,1,1,0,184,4,21,11,7,8,1,475,460,15,2,2,0,0,100,NoArch
0c4e368d8a56a2545d36ce0f77aed891843d3252,0,0,0,0,0,0,0,0,0,0,0,0,0,0,0,22,12,0,0,0,0,0,0,0,0,0,0,100,NoArch
3fd688c31f0a7b18725d13ae1862f5e3b2c250fc,0,0,0,0,0,0,0,0,0,0,0,0,0,0,0,23,13,0,0,0,0,0,0,0,0,0,0,100,NoArch
e52ef6385f2185caac5365b5069eada7d3bd3e8b,1,15,3,12,18,0,0,0,6,28,1,1,0,140,6,67,3,19,16,3,724,640,84,9,9,0,0,100,NoArch
e0d645d05763b35a92a72e973ad81bbe8f3bf88a,0,0,0,0,0,0,0,0,0,0,0,0,0,0,0,134,7,0,0,0,0,0,0,0,0,0,0,100,NoArch
a5a559c28d772ab3f5dea734db6131731dd6fc41,0,0,0,0,0,0,0,0,0,0,0,0,0,0,0,135,8,0,0,0,0,0,0,0,0,0,0,100,NoArch
f9435fd2caea55f615a15c5796ef236ac052e18b,0,0,0,0,0,0,0,0,0,0,0,0,0,0,0,136,9,0,0,0,0,0,0,0,0,0,0,100,NoArch
dd43bdb2c6f4730430a3c63c7f148e52b7c817f0,0,0,0,0,0,0,0,0,0,0,0,0,0,0,0,137,10,0,0,0,0,0,0,0,0,0,0,100,NoArch
0671934b27c51d06aaee272c173e2e07c2464334,0,0,0,0,0,0,0,0,0,0,0,0,0,0,0,138,10,0,0,0,0,0,0,0,0,0,0,100,NoArch
6831f680bebdd93dc5506ca7c4652ea482ddacb5,0,0,0,0,0,0,0,0,0,0,0,0,0,0,0,139,11,0,0,0,0,0,0,0,0,0,0,100,NoArch
d8266478a98e1b359d5e7c7411c15527b8daa348,0,0,0,0,0,0,0,0,0,0,0,0,0,0,0,140,12,0,0,0,0,0,0,0,0,0,0,100,NoArch
48c539578ab46dfd12121d5a96a3626305e850fc,0,0,0,0,0,0,0,0,0,0,0,0,0,0,0,141,13,0,0,0,0,0,0,0,0,0,0,100,NoArch
ecf8e36a9f9ca6d08b081058a4087b3e439be4db,1,8,6,2,14,0,0,0,14,6,1,1,0,814,1,120,16,156,156,0,4687,4676,11,48,48,0,0,100,NoArch
b9d700a90aec95eb7811567458b485d0bd1c52f4,0,0,0,0,0,0,0,0,0,0,0,0,0,0,0,121,17,0,0,0,0,0,0,0,0,0,0,100,NoArch
1bb515916b9fc90907a77e409049d39091afa49e,1,4,0,4,4,1,0,1,50,43,1,1,0,724,7,14,7,127,126,1,2995,2975,20,43,42,1,1,100,NoArch
0d28b0a459bb2a795e0fc99f3b063d192d6ae282,0,0,0,0,0,0,0,0,0,0,0,0,0,0,0,122,18,0,0,0,0,0,0,0,0,0,0,100,NoArch
3cb0bec25b9c5bda0557de2c33b6a12eae8f432b,0,0,0,0,0,0,0,0,0,0,0,0,0,0,0,123,19,0,0,0,0,0,0,0,0,0,0,100,NoArch
7e87afeb23bba7e7f0566a41d7f9d8c79d44b98a,1,11,4,7,15,0,0,0,15,0,1,1,0,816,1,124,20,157,156,1,4707,4687,20,48,48,0,0,100,NoArch
0815c5996a01b572516214e7a12512071d6ac7b2,0,0,0,0,0,0,0,0,0,0,0,0,0,0,0,125,21,0,0,0,0,0,0,0,0,0,0,100,NoArch
eeb3610dc8edcb00a150c279617645789a032da6,0,0,0,0,0,0,0,0,0,0,0,0,0,0,0,142,14,0,0,0,0,0,0,0,0,0,0,100,NoArch
d81152402434a9aebcdd748788033e48e3262dd8,1,1,1,0,2,0,0,0,4,7,1,1,0,354,1,126,22,50,49,1,1154,1150,4,24,24,0,0,100,NoArch
7e23ba3f77df28ddfa7aa1f67c3a79347c363f7d,2,4,4,0,8,0,0,0,20,6,1,1,0.954434003,1085,7,127,23,101,100,1,2816,2804,12,45,45,0,0,100,NoArch
7a1273342356ef2c93c617fe381e1757fcb94c2b,0,0,0,0,0,0,0,0,0,0,0,0,0,0,0,143,15,0,0,0,0,0,0,0,0,0,0,100,NoArch
bce5a3b7d22f11dcdc9bd9563508315a5219d7ef,0,0,0,0,0,0,0,0,0,0,0,0,0,0,0,144,16,0,0,0,0,0,0,0,0,0,0,100,NoArch
529ab704227d5f732b9b75f474756227bca398ae,0,0,0,0,0,0,0,0,0,0,0,0,0,0,0,94,0,0,0,0,0,0,0,0,0,0,0,100,NoArch
85909b328c9cec671a3d0eaca5432b35a26f4f37,0,0,0,0,0,0,0,0,0,0,0,0,0,0,0,95,1,0,0,0,0,0,0,0,0,0,0,100,NoArch
b47eb7edcd95d430e5b192e39a3111cad8fd16c3,1,4,0,4,4,1,0,1,4,982,1,1,0,145,4,145,17,15,14,1,383,369,14,9,8,1,1,100,NoArch
a9db9f0e77479991e75290ae4ee23369972d9490,6,117,43,74,160,0,0,0,50,208,1,4,2.34935234,3300,2,128,24,487,462,25,12755,12258,497,185,184,1,0,99.39337378,NoArch
167a91902fa1c9b51ef0dc9746d8c97e3db907c6,3,15,3,12,18,0,0,0,42,0,1,3,1.224394445,1201,2,129,25,179,173,6,4796,4752,44,59,59,0,0,100,NoArch
ce0fa8d450be537f6cbe5a5c74ece172d00e248c,0,0,0,0,0,0,0,0,0,0,0,0,0,0,0,130,26,0,0,0,0,0,0,0,0,0,0,100,NoArch
d93ec8cc7177a3f448b48b7e78a99dd8221eeed2,0,0,0,0,0,0,0,0,0,0,0,0,0,0,0,131,27,0,0,0,0,0,0,0,0,0,0,100,NoArch
54eab0ae5358af8c66c60393ff8ad9f281f1c925,1,1,1,0,2,0,0,0,22,0,1,1,0,905,8,132,28,90,89,1,2612,2608,4,33,33,0,0,100,NoArch
8d279e0cddadea4cf3399d6aa5a8d25b28e243cc,1,2,0,2,2,1,0,1,4,0,1,1,0,319,2,133,29,47,46,1,1103,1096,7,17,17,0,0,100,NoArch
888c81ee5523e1550dab85e9ec0c352691347424,1,2,0,2,2,1,0,1,5,0,1,1,0,321,2,134,30,48,47,1,1110,1103,7,17,17,0,0,100,NoArch
8af56f3f749e1c3e8d7a924ecf9f01dcf980a984,1,2,0,2,2,1,0,1,6,0,1,1,0,323,2,135,31,49,48,1,1117,1110,7,17,17,0,0,100,NoArch
7c34c99e1286768f578657ecd6a3454308a1cd3f,1,2,2,0,4,0,0,0,9,98,1,1,0,280,5,136,32,28,28,0,839,839,0,7,7,0,0,100,NoArch
3cbc26d8a7e5859d555fd301646eed02efb66c84,1,1,1,0,2,0,0,0,23,0,1,1,0,905,8,137,33,90,90,0,2613,2612,1,33,33,0,0,100,NoArch
748362bc5ca08b499643a7b754d2b0a4b88773c6,3,387,0,387,387,3,0,3,36,3,1,3,0.937491302,135,1,15,8,57,1,56,3883,910,2973,27,1,26,0,99.67350746,NoArch
07a82af4880ddf61834e9a6ba9162e08c1010cf9,2,8,0,8,8,2,0,2,27,6,1,2,0.543564443,288,1,16,9,2,1,1,2027,1995,32,2,1,1,0,99.90697674,NoArch
0b18f8029ac4de0a44688ed268d9a500bedffa18,1,6,4,2,10,0,0,0,46,11,1,1,0,2073,6,71,1,393,395,2,10399,10456,57,93,94,1,0,100,NoArch
bfbe079a15b7baaeb1216d9b002f52182cc996f0,2,10,1,9,11,1,0,1,28,0,1,2,0.684038436,296,1,17,10,3,2,1,2062,2027,35,3,2,1,0,100,NoArch
dffb91b9db3ef9c0c4af466b6ebf898701e38957,0,0,0,0,0,0,0,0,0,0,0,0,0,0,0,138,34,0,0,0,0,0,0,0,0,0,0,100,NoArch
81a008546a59a94b1cf68a64058f9046b2bdfc87,0,0,0,0,0,0,0,0,0,0,0,0,0,0,0,139,35,0,0,0,0,0,0,0,0,0,0,100,NoArch
d99c38c2efe84c7dd02aea8e73698a9d2f039515,1,1,1,0,2,0,0,0,16,3,1,1,0,823,1,140,36,157,157,0,4706,4707,1,48,48,0,0,100,NoArch
81a79d55f70bb03d2415741e94a72d4334415cd2,1,1,1,0,2,0,0,0,3,1,1,1,0,16,1,18,11,2,2,0,58,56,2,2,2,0,1,100,NoArch
02d1440b40a74266555dbbf04be564410f26fee5,0,0,0,0,0,0,0,0,0,0,0,0,0,0,0,141,37,0,0,0,0,0,0,0,0,0,0,100,NoArch
5835d302ae2e9934160274d016bec495898d0c5d,2,88,30,58,118,0,0,0,2,2,1,2,0.95285881,386,1,19,12,73,56,17,3441,2960,481,31,26,5,0,100,NoArch
f5ff44a4a528ca61d9293abf05a9802e63a5b60c,1,23,22,1,45,0,0,0,43,3,1,1,0,657,10,142,38,94,93,1,2811,2803,8,30,30,0,0,100,NoArch
5f36020977175cd8ad83a977c1cd102ecd0c29c4,1,2,2,0,4,0,0,0,3,0,1,1,0,143,1,20,13,23,23,0,1147,1147,0,13,13,0,0,100,NoArch
04486382bbcd7b391251d616181ebc46230de598,0,0,0,0,0,0,0,0,0,0,0,0,0,0,0,21,14,0,0,0,0,0,0,0,0,0,0,100,NoArch
45a68b6e98f1e8d7d1e8631b40687bf5020056c1,1,17,7,10,24,0,0,0,44,0,1,1,0,658,10,143,38,92,94,2,2749,2811,62,29,30,1,0,100,NoArch
8f9b840dc6439f6e8e4c55ce95f8bd505f41391f,1,2,1,1,3,0,0,0,22,13,1,1,0,420,6,144,39,45,44,1,1878,1869,9,11,11,0,0,100,NoArch
9d2198c8e9dc3e02ada610a6a30ee078a111f262,0,0,0,0,0,0,0,0,0,0,0,0,0,0,0,22,15,0,0,0,0,0,0,0,0,0,0,100,NoArch
5c7f11609558dab7b253b588765f29d66aadd51d,3,93,27,66,120,2,0,2,10,15,1,3,0.850096845,150,1,72,2,27,14,13,1178,853,325,21,14,7,0,99.76798144,NoArch
0b6d533f37f55d64d97bffa2f3c71934dfd6bad4,0,0,0,0,0,0,0,0,0,0,0,0,0,0,0,23,16,0,0,0,0,0,0,0,0,0,0,100,NoArch
4ec9f274e49bb5efbf23340e3a752b515ff48e28,1,3,1,2,4,0,0,0,45,0,1,1,0,668,10,145,40,94,92,2,2774,2749,25,29,29,0,0,100,NoArch
907af26a08234bf6f1519217bba5eb2fdbfb86b2,1,5,1,4,6,0,0,0,2,1596,1,1,0,104,2,1,0,12,11,1,235,221,14,9,8,1,1,100,NoArch
d1206c7c09a3f29b59e456a897ffc4c3a7bb3415,0,0,0,0,0,0,0,0,0,0,0,0,0,0,0,1023,0,0,0,0,0,0,0,0,0,0,0,100,NoArch
fc294405f6abc440ff772e2b43e5a4b46db7752a,2,470,0,470,470,2,0,2,1,0,1,1,0.784992089,0,1,24,17,66,0,66,1703,0,1703,27,0,27,0,99.76883957,NoArch
5975bacb4ce369e77c70d92b20bae7a2b58fbdab,0,0,0,0,0,0,0,0,0,0,0,0,0,0,0,1024,1,0,0,0,0,0,0,0,0,0,0,100,NoArch
dc3ca06545ef57ed3d70122a9bb503253f47027b,1,30,4,26,34,0,0,0,29,16,1,1,0,514,9,25,18,64,60,4,1942,1795,147,21,20,1,0,100,NoArch
51dd3d419c97440afbfb30dd123d34f773aff85b,0,0,0,0,0,0,0,0,0,0,0,0,0,0,0,26,19,0,0,0,0,0,0,0,0,0,0,100,NoArch
a0b356606c6893ec1c58a386aedc73947563e6f5,0,0,0,0,0,0,0,0,0,0,0,0,0,0,0,27,20,0,0,0,0,0,0,0,0,0,0,100,NoArch
dbc4fe1115575e0609b952d6691f43c110e0337c,1,1,0,1,1,1,0,1,3,5,1,1,0,301,1,28,21,50,50,0,2294,2294,0,18,18,0,0,100,NoArch
ab518dd15ad7e934572f28f4125f850c22a96e48,0,0,0,0,0,0,0,0,0,0,0,0,0,0,0,24,10,0,0,0,0,0,0,0,0,0,0,100,NoArch
e91af784134ecfe961e3a83926c001c88ae157be,1,5,1,4,6,0,0,0,4,1190,1,1,0,166,2,25,11,20,19,1,620,604,16,7,7,0,0,100,NoArch
091a05fe633eed7d97cdd54282e282812ff08ee2,2,11,17,6,28,0,0,0,17,30,1,1,0.591672779,738,6,26,12,59,59,0,1827,1827,0,13,13,0,0,100,NoArch
aa782ab79a4d4c3625fb66b84543636e9cf39841,1,265,0,265,265,1,0,1,1,0,1,1,0,0,1,27,13,42,0,42,1401,0,1401,17,0,17,1,99.49355433,NoArch
5869f7d67d47baa3d94658a742cd31fd16768ae0,1,10,4,6,14,0,0,0,43,27,1,1,0,579,10,28,13,74,72,2,2129,2097,32,44,44,0,1,100,NoArch
d48c264d476ac4757c688fb159e791995250d0c0,1,5,0,5,5,1,0,1,2,1279,1,1,0,177,2,29,14,15,14,1,285,270,15,4,4,0,0,100,NoArch
b021968a43a0fbaebac50e0441d34bcf1bf763f6,1,41,4,37,45,0,0,0,7,1033,1,1,0,190,2,96,2,28,20,8,900,748,152,13,10,3,0,100,NoArch
46b1fface0b17cf41f9681894bcb8d78fc831258,1,5,2,3,7,0,0,0,16,20,1,1,0,194,8,97,3,17,16,1,328,289,39,12,12,0,0,99.12603496,NoArch
3fc3d11d73c38d108202d00aabc73646b56395f6,1,9,4,5,13,0,0,0,46,14,1,1,0,670,10,98,4,95,94,1,2803,2774,29,29,29,0,0,100,NoArch
dc32270ab6d291ab15b3cd862ad07d45b4beebe2,1,138,69,69,207,0,0,0,2,6,1,1,0,265,1,30,15,53,42,11,1608,1401,207,23,17,6,0,100,NoArch
6f5a910392dc497dd3439dbecd3c52e1d78adab8,1,36,18,18,54,0,0,0,15,116,1,1,0,219,4,31,16,30,22,8,839,757,82,8,8,0,0,100,NoArch
4be41938bd1d02a65659b5871492f8181407e6be,1,5,8,3,13,0,0,0,18,6,1,1,0,503,6,32,17,39,39,0,1158,1165,7,9,9,0,0,100,NoArch
e576e936de31b88f7906a1c687862fcffb2d98f2,2,155,0,155,155,2,0,2,69,61,1,2,0.137802666,988,8,29,17,229,196,33,6049,5530,519,120,89,31,1,99.90800368,NoArch
e0193adac483cd715bc8a9f3084be20d0752cffc,1,4,7,3,11,0,0,0,105,46,1,1,0,2373,14,146,36,500,500,0,11788,11784,4,81,81,0,0,100,NoArch
aa16de99836cd50326e99e40302dde49a1ea06ee,1,2,1,1,3,0,0,0,47,9,1,1,0,675,10,147,37,96,95,1,2812,2803,9,29,29,0,0,100,NoArch
0a5d9c78a0c0fb90dc09b0315f1bcb035d3353b0,3,16,2,14,18,2,0,2,37,18,1,2,0.944488534,425,1,18,0,3,2,1,2967,2929,38,3,2,1,1,99.90817264,NoArch
15b432f3462a244efd2ad4ad17aa088794888bb7,1,1,0,1,1,1,0,1,38,0,1,1,0,135,10,19,1,1,1,0,936,923,13,1,1,0,1,100,NoArch
9f8c26b75a3cc454f7ff18d78b32576ee14bae67,3,39,21,18,60,1,0,1,106,465,1,3,1.360964047,2726,3,30,17,545,541,4,13967,13824,143,111,112,1,1,100,NoArch
dbfe7ec049541a5951e9f846f6944a6540149cdc,1,9,12,3,21,0,0,0,48,5,1,1,0,676,11,2,1,96,96,0,2806,2812,6,29,29,0,1,100,NoArch
a33552697fc96f3419620a432a6ed95227fbddbb,6,146,137,9,283,2,0,2,49,31,1,4,2.315542737,1856,1,3,2,207,216,9,6260,6140,120,78,84,6,2,98.99313501,NoArch
272888046fd45d48d790259e387f0651ceeb5bc4,15,3399,6,3393,3405,13,0,13,47,14,1,4,3.077486018,2294,1,73,0,1759,416,1343,38442,11452,26990,687,110,577,0,98.7804878,NoArch
6b94328e8d2bd7e6e98057cf8644693dec498c01,1,1,1,0,2,0,0,0,28,1256,1,1,0,460,4,148,2,64,64,0,2387,2386,1,57,57,0,0,100,NoArch
9b1141d206088d15d0966120db0b96a9ad6903f7,2,55,35,20,90,1,0,1,107,543,1,1,0.26231122,2612,4,149,3,549,540,9,12845,12677,168,108,106,2,0,100,NoArch
3d170d570eb7aabd4b9a926afed557e62de81068,5,93,14,79,107,2,0,2,2,0,1,2,2.06315234,1225,1,74,1,462,436,26,8220,7809,411,130,121,9,0,100,NoArch
1aa59e128b0d06701fd90116daeb28b3fe008fad,3,49,1,48,50,2,0,2,12,21,1,3,0.721279866,136,1,4,2,7,5,2,1067,842,225,6,4,2,1,99.77688532,NoArch
ac466888c1488dbfb3ef8d047dbc0de88a481295,2,52,11,41,63,0,0,0,9,637,1,2,0.918295834,404,5,33,9,60,55,5,2017,1816,201,29,25,4,0,100,NoArch
49ab20ce18425fc83662c097edf1502c1fc9c0ac,2,509,555,46,1064,0,0,0,19,54,1,1,0.898692427,745,6,34,10,49,52,3,1614,1672,58,13,14,1,0,100,NoArch
b949af32b0f5a590cf6d9ff91d14f84c88942c6e,1,31,4,27,35,0,0,0,148,82,1,1,0,5082,14,35,11,709,706,3,19117,19025,92,362,361,1,1,100,NoArch
af94de488ab6e98b19bd1d5623f699d00174c28b,1,6,0,6,6,1,0,1,3,1,1,1,0,393,2,150,4,114,112,2,1978,1945,33,53,52,1,0,100,NoArch
ef824384cf60dc6ba6840f088cbf552d35fa4e40,1,1,0,1,1,1,0,1,3,1,1,1,0,152,2,151,5,39,39,0,498,491,7,4,4,0,0,100,NoArch
bf7ea81f922479b5f66ad49393f89ebfde8497b2,1,1,1,0,2,0,0,0,4,0,1,1,0,153,2,152,6,39,39,0,491,498,7,4,4,0,0,100,NoArch
e27fdd6be98253c514a41d15bde980063ce9831e,1,2,2,0,4,0,0,0,17,52,1,1,0,823,1,153,7,157,157,0,4708,4706,2,48,48,0,1,100,NoArch
ff46eeaeeaadfb92bf0f238757412c0e2afb1806,5,71,36,35,107,1,0,1,5,0,1,2,2.176664993,1255,1,75,2,460,449,11,8077,7916,161,133,127,6,0,100,NoArch
9f5e03478aa8a3f993070bb8a92b8312f61f6c7f,3,19,23,4,42,0,0,0,6,0,1,1,1.568218979,612,2,154,8,289,289,0,4909,4921,12,27,27,0,0,100,NoArch
44989254c789b45b70548908850433757bc74ef6,4,302,19,283,321,1,0,1,7,0,1,2,1.133867845,945,1,76,3,465,233,232,5505,4139,1366,126,118,8,0,100,NoArch
173ed6bba6dc1c00bcfc14bcbd3459345ab7cf55,1,9,0,9,9,1,0,1,50,12,1,1,0,687,11,146,0,97,96,1,2936,2903,33,30,29,1,0,100,NoArch
1ec9f814c0d398e562f86b2220a6c69af33852f9,4,66,10,56,76,1,0,1,8,5,1,2,1.811374753,1283,1,77,4,488,472,16,8492,8211,281,146,139,7,0,100,NoArch
b3f1d622fe8c77a9c1d990f7717a6999081051e0,1,9,0,9,9,1,0,1,2,335,1,1,0,114,1,155,9,11,10,1,456,398,58,2,2,0,0,100,NoArch
df6c199dbcb209a459d9a79cf0810745d23026a7,2,26,8,18,34,0,0,0,3,84,1,1,0.977417818,180,1,31,1,26,24,2,886,794,92,18,17,1,0,100,NoArch
41863e778edf076579f4606f49a79d65a94d2a5d,1,31,13,18,44,0,0,0,51,9,1,1,0,696,11,147,1,98,97,1,3035,2936,99,31,30,1,0,100,NoArch
86a10abcf7a1d6241eb9adc3a1e93647dd7bb012,1,1,0,1,1,1,0,1,39,35,1,1,0,136,10,32,2,1,1,0,949,936,13,1,1,0,1,100,NoArch
fa6643cfa69c03e90648c8c20493541a7dab840d,2,11,0,11,11,2,0,2,149,24,1,2,0.439496987,5399,7,33,3,711,710,1,21158,21132,26,364,363,1,1,100,NoArch
e7385e98ef7e483051d00068aae98fafbbae75a6,2,113,0,113,113,2,0,2,1,0,1,2,0.921217482,0,1,34,4,10,0,10,503,0,503,10,0,10,0,99.73392461,NoArch
ef811957ea520884a552dda1d68cf088e8a95c84,1,24,17,7,41,0,0,0,150,0,1,1,0,5119,15,35,5,710,710,0,19144,19134,10,364,363,1,1,100,NoArch
b4be46523157e38ab904dac0806e1816a16e671e,3,124,18,106,142,1,0,1,9,3,1,2,0.955416074,911,1,78,5,279,241,38,4492,4060,432,140,123,17,0,100,NoArch
be108cb06dc44a4bd10c7c1fb172a85d001e1b5d,1,4,0,4,4,1,0,1,10,458,1,1,0,264,4,148,2,44,43,1,913,901,12,16,15,1,0,100,NoArch
5c1205d7d77fd9c6c1c2ce446e1d2b6f46ea386f,2,14,2,12,16,1,0,1,151,18,1,2,0.811278124,5265,1,36,6,733,732,1,20304,20274,30,378,377,1,1,100,NoArch
c9d43407ae78beb1ba1fbf54fa6c9bb40ada9f4c,1,1,0,1,1,1,0,1,51,67,1,1,0,895,7,156,9,170,170,0,4171,4164,7,68,68,0,0,100,NoArch
4608582bbaeb91166b2f91879b6e55cc6fead451,3,81,216,135,297,1,0,1,10,0,1,2,0.211159523,1017,1,79,6,220,279,59,4132,4492,360,144,140,4,0,100,NoArch
4c875d50028d3d12a44ffc150cb205fd1447af70,0,0,0,0,0,0,0,0,0,0,0,0,0,0,0,157,10,0,0,0,0,0,0,0,0,0,0,100,NoArch
81a2622617e7cc39ff471cb6cf7ca685f4c2cb22,0,0,0,0,0,0,0,0,0,0,0,0,0,0,0,158,11,0,0,0,0,0,0,0,0,0,0,100,NoArch
dc4fe20584750c75074853d28ae31690e121109e,1,1,0,1,1,1,0,1,31,2,1,1,0,291,7,159,12,1,1,0,2033,2024,9,1,1,0,0,100,NoArch
215d9653a2d880a6455100118e94c57e758d9afa,0,0,0,0,0,0,0,0,0,0,0,0,0,0,0,160,13,0,0,0,0,0,0,0,0,0,0,100,NoArch
0e84e3b757a056d6b3bd089d5932510706a8462c,0,0,0,0,0,0,0,0,0,0,0,0,0,0,0,161,14,0,0,0,0,0,0,0,0,0,0,100,NoArch
cb7cad81386cd1226a403d7789f2862780075380,1,1,1,0,2,0,0,0,48,19,1,1,0,2122,6,162,15,400,400,0,10716,10718,2,94,94,0,0,100,NoArch
c416751da09fa5b54216ff216ff7a00e8f17d25b,0,0,0,0,0,0,0,0,0,0,0,0,0,0,0,163,16,0,0,0,0,0,0,0,0,0,0,100,NoArch
37af776e0440234559c3fb7a36061dba4b096efc,0,0,0,0,0,0,0,0,0,0,0,0,0,0,0,164,17,0,0,0,0,0,0,0,0,0,0,100,NoArch
754d9966286ba423a8890d7d86e0c91861e0025b,1,1,0,1,1,1,0,1,32,0,1,1,0,292,7,165,18,1,1,0,2042,2033,9,1,1,0,0,100,NoArch
c9b6a87f80697bacaaf10ca915bce5c44aa655d4,1,15,17,2,32,0,0,0,152,2,1,1,0,5138,15,37,7,710,711,1,19161,19172,11,365,365,0,1,100,NoArch
fd7a05e93b3f9df496188f8dbddcb4eab49cadc4,1,4,0,4,4,1,0,1,52,1,1,1,0,896,7,166,19,171,170,1,4191,4171,20,69,68,1,0,100,NoArch
93d027fd28aa4e6212f28a439d4b5c83b52d0cb1,1,13,0,13,13,1,0,1,18,15,1,1,0,823,1,167,20,161,157,4,4819,4708,111,49,48,1,0,100,NoArch
c0f127edf994991724a1e342cc9589d5320b91cc,1,29,1,28,30,0,0,0,153,0,1,1,0,5136,15,38,8,713,710,3,19288,19161,127,367,365,2,1,100,NoArch
dd2eed742fb48494451878c28b3776a50f512075,1,64,26,38,90,0,0,0,154,0,1,1,0,5164,15,39,9,719,713,6,19482,19288,194,370,367,3,1,99.95586937,NoArch
6e6fc299d6110bb39b38e7734ea5af6fafa80507,1,30,7,23,37,0,0,0,155,0,1,1,0,5202,15,40,10,721,719,2,19579,19482,97,372,370,2,1,100,NoArch
f212aa57bfb08513dfeb787988a8c1705687f5c2,1,8,19,11,27,0,0,0,156,1,1,1,0,5225,15,41,11,719,721,2,19531,19579,48,372,372,0,1,100,NoArch
db47c2cfae75f82ad0791f96cebb22f7128f3b6c,2,25,0,25,25,2,0,2,157,1,1,2,0.242292189,5507,7,42,12,725,720,5,21696,21573,123,374,373,1,1,100,NoArch
51a0144cad41ab16939370245a0e9b9c2b54ba01,2,39,3,36,42,0,0,0,6,628,1,2,0.453716339,224,1,43,12,31,25,6,1391,1248,143,19,16,3,1,100,NoArch
8355b00830b4ef84b71039759acfbf4f51d55fdb,0,0,0,0,0,0,0,0,0,0,0,0,0,0,0,44,13,0,0,0,0,0,0,0,0,0,2,100,NoArch
3317ac6039d72ebee030ce809dbe0a9c97ceae0d,1,18,0,18,18,1,0,1,1,0,1,1,0,0,1,45,14,3,0,3,62,0,62,2,0,2,1,99.91181658,NoArch
d80c29130d1bc1c2a1093d3e652c89af77a3be75,4,104,21,83,125,1,0,1,11,13,1,2,1.75521069,1310,1,80,7,486,467,19,9055,8564,491,171,167,4,0,100,NoArch
dddac8912ae13642736dadac183b1197de8b28a7,3,51,8,43,59,0,0,0,12,3,1,2,1.262770142,932,1,81,8,244,232,12,4724,4429,295,153,145,8,0,99.64773228,NoArch
f7ce7a57eb83215f505d7fa4ee16bbf26683baeb,2,47,35,12,82,0,0,0,11,2,1,2,0.659375881,785,1,82,9,193,182,11,4111,4020,91,149,149,0,0,100,NoArch
c7ee60640f6a5aadf30f64c5b01e2e10298529aa,2,273,160,113,433,1,0,1,4,18,1,2,0.980517334,351,1,36,3,67,57,10,1941,1682,259,34,26,8,0,99.86807388,NoArch
3230311443c49ca3903c54cb5743a52c35f59c6b,1,1,1,0,2,0,0,0,5,0,1,1,0,212,1,37,4,31,31,0,1005,1015,10,19,19,0,0,100,NoArch
fb8233fe250b4d7a97606f116560337e4cacbfcc,3,18,20,2,38,0,0,0,30,57,1,3,1.401771758,1090,3,38,5,180,180,0,4097,4108,11,42,42,0,0,100,NoArch
28bba6d0374ae13c569765aa7a876da980f19170,3,15,6,9,21,1,0,1,52,70,1,3,1.493709546,1276,2,168,18,173,187,14,4692,5049,357,59,60,1,0,100,NoArch
4ef6328facf58c73897cfdfdcab277b98ab67825,3,54,17,37,71,1,0,1,9,1191,1,3,1.006398488,618,2,83,8,77,69,8,1895,1626,269,34,33,1,1,100,NoArch
1fa3b8d3203f94c63c0cb6b6010f3a9fd330062c,0,0,0,0,0,0,0,0,0,0,0,0,0,0,0,169,19,0,0,0,0,0,0,0,0,0,0,100,NoArch
f6536f486c31f11c17ed5ff8c9999c6eb6f16d4e,2,200,7,193,207,0,0,0,158,32,1,2,0.999579093,7622,15,170,20,1263,1233,30,32229,31586,643,475,453,22,0,100,NoArch
35585132b15f7d952fa871908105f327b6842363,3,117,26,91,143,0,0,0,109,128,1,1,0.588881935,3506,6,149,2,686,678,8,16655,16113,542,143,143,0,1,100,NoArch
25be5a0233b30d961204136493e685848a396099,1,57,4,53,61,0,0,0,5,100,1,1,0,149,5,68,0,23,15,8,590,383,207,11,9,2,1,100,NoArch
2e3549665d97d6a096117f15fe9800dfb3e6ae19,15,358,111,247,469,2,0,2,159,461,1,10,3.08070142,18386,3,69,1,3044,3020,24,84694,83468,1226,857,847,10,6,99.86830553,NoArch
9d31887afa088bd0c1bad04b5a486c60f5343e53,1,20,48,28,68,0,0,0,53,0,1,1,0,722,8,171,16,111,116,5,2750,2907,157,44,43,1,0,100,NoArch
eec8aa0c6effec55cd4e58bdb16780aa40a1337b,2,9,1,8,10,1,0,1,40,881,1,2,0.468995594,184,10,70,2,12,8,4,1209,1109,100,8,8,0,0,100,NoArch
cde74e8476aaaccc4f6582a4c5e7f35719ea8f26,1,7,1,6,8,0,0,0,23,101,1,1,0,421,7,46,15,45,45,0,1896,1878,18,11,11,0,1,100,NoArch
3a2e03e6c7206852e3885d07ce8d33f30727e617,0,0,0,0,0,0,0,0,0,0,0,0,0,0,0,47,15,0,0,0,0,0,0,0,0,0,1,100,NoArch
9df9470b9b10052dc01eed731450b7c9c63b0336,0,0,0,0,0,0,0,0,0,0,0,0,0,0,0,48,16,0,0,0,0,0,0,0,0,0,1,100,NoArch
d07600381838d65772692a946b65094971f5bb4a,1,45,18,27,63,0,0,0,24,0,1,1,0,427,7,49,17,45,45,0,1896,1896,0,11,11,0,1,100,NoArch
4375ce430f8397cc614ee878f20021b6b989a3ca,2,170,5,165,175,1,0,1,6,57,1,1,0.315997133,449,3,150,2,66,43,23,1978,1427,551,41,20,21,1,99.82479194,NoArch
cb60cec2fc8a230429a3d0fc27d89100a2a346c3,1,115,112,3,227,0,0,0,111,6,1,1,0,2569,14,151,3,526,525,1,12562,12535,27,83,83,0,0,100,NoArch
cb523b29a7233864a9dce6b671823585b2c1d6a8,3,146,6,140,152,0,0,0,160,110,1,3,1.059241892,5749,7,71,3,772,764,8,22741,22610,131,406,401,5,0,99.95625547,NoArch
cbaa4947f81b964c9ef4e79abc660133b20f80f7,1,1,1,0,2,0,0,0,161,0,1,1,0,5422,15,72,4,755,755,0,20352,20350,2,397,397,0,0,100,NoArch
c968140a165073ffabbb3d91a1bb5ce206c3cd9e,0,0,0,0,0,0,0,0,0,0,0,0,0,0,0,73,5,0,0,0,0,0,0,0,0,0,0,100,NoArch
2b42139a2149b97a461641c72c18a399753f7d28,0,0,0,0,0,0,0,0,0,0,0,0,0,0,0,74,6,0,0,0,0,0,0,0,0,0,0,100,NoArch
9dbc8a3e3465d4b2ee02f99db2b66887ac47e750,1,20,0,20,20,1,0,1,162,0,1,1,0,5422,15,75,7,757,755,2,20432,20352,80,398,397,1,0,100,NoArch
a79c89cdd622f226c30b7c54ee3bb1e2eb04ab6d,0,0,0,0,0,0,0,0,0,0,0,0,0,0,0,76,8,0,0,0,0,0,0,0,0,0,0,100,NoArch
eea927c7f36f403b2a9bcd06867769f56d10ac7e,1,4,0,4,4,1,0,1,163,0,1,1,0,5442,15,172,16,758,757,1,20456,20432,24,399,398,1,0,100,NoArch
b715e688f08aafd6fc2287a7123b1d617f08453d,1,8,0,8,8,1,0,1,6,57,1,1,0,250,2,50,11,16,14,2,629,569,60,5,5,0,1,100,NoArch
4712cc77a6fcfea85a4a4c7b510b4c4afe307dd8,1,5,4,1,9,0,0,0,7,0,1,1,0,258,2,51,10,17,16,1,642,629,13,5,5,0,0,100,NoArch
0cb08b8771b9c06020287a2654a21a9cb0781f8e,1,2,1,1,3,0,0,0,2,122,1,1,0,27,2,52,9,1,1,0,87,74,13,1,1,0,1,100,NoArch
086984c625c60daa0fcacf906eb7e88f51d25331,1,15,0,15,15,1,0,1,16,93,1,1,0,237,4,39,3,33,30,3,902,839,63,10,8,2,1,100,NoArch
de59026382de355d7ff085b9023d73bdf7984202,1,1,1,0,2,0,0,0,164,7,1,1,0,5446,15,173,5,758,758,0,20460,20456,4,399,399,0,0,100,NoArch
9bd313bcf838a3883234ea7d0bb2fc90c4699d7a,1,8,6,2,14,0,0,0,17,2,1,1,0,252,4,40,4,31,33,2,890,902,12,10,10,0,0,100,NoArch
2b8daf20522531693f0ec875b581b31c091b7561,1,32,24,8,56,0,0,0,112,10,1,1,0,2572,15,41,5,526,526,0,12620,12562,58,83,83,0,0,100,NoArch
c99d4ce4d7abd35aa03c8a346f72e510f9da3610,6,44,35,9,79,1,0,1,35,29,1,4,2.022230607,754,2,42,6,74,74,0,4009,3991,18,74,74,0,0,99.47529515,NoArch
43bca3d64e30a2df88e2f6e9eaf8ca99ac1206a7,0,0,0,0,0,0,0,0,0,0,0,0,0,0,0,43,7,0,0,0,0,0,0,0,0,0,0,100,NoArch
a4f04e6ab09db47f1a7586d9c3c2abde468f2e0e,0,0,0,0,0,0,0,0,0,0,0,0,0,0,0,77,9,0,0,0,0,0,0,0,0,0,0,100,NoArch
d9ce219364c026eb7334faa1b688f1d1519eef9a,1,1,1,0,2,0,0,0,3,428,1,1,0,189,3,44,8,23,23,0,1279,1278,1,10,10,0,0,100,NoArch
3dab38d031e7ef82effaa49687a242d3e0b4ab90,4,297,35,262,332,0,0,0,165,112,1,2,1.559721339,7708,8,78,10,1238,1190,48,33154,32051,1103,555,539,16,1,99.95629371,NoArch
221a38f2946736dfd8c48d0646717e4cc4896144,1,5,5,0,10,0,0,0,12,35,1,1,0,473,2,84,3,125,125,0,2624,2624,0,81,81,0,0,100,NoArch
d35713d4249ee3ce79e0b687ae83ca3b4e9c8403,4,509,0,509,509,4,0,4,1,0,1,2,1.028269686,0,1,85,4,67,0,67,1817,0,1817,35,0,35,0,99.60818459,NoArch
0b67bb2cda55ec0cb8468b0b7ca149ad009bcdad,2,103,10,93,113,1,0,1,15,1063,1,2,0.983611636,448,2,79,11,89,75,14,2693,1947,746,33,32,1,1,100,NoArch
ab206c524dace67063db2a83f444b265df5e3728,0,0,0,0,0,0,0,0,0,0,0,0,0,0,0,80,12,0,0,0,0,0,0,0,0,0,0,100,NoArch
4be21e3796ca8c51f598ca8092f321cb599eba3b,0,0,0,0,0,0,0,0,0,0,0,0,0,0,0,86,4,0,0,0,0,0,0,0,0,0,0,100,NoArch
3ca12621865d127c779e1d6e8bb658477db05f19,2,228,93,135,321,0,0,0,166,32,1,2,0.184451863,5712,2,81,13,816,798,18,22519,21875,644,422,421,1,0,100,NoArch
00b4bed7ec9e455b9eaaf6db6d4cc73f7f57bda0,3,24,25,1,49,0,0,0,44,41,1,2,0.921841058,687,1,87,4,84,84,0,2722,2689,33,48,48,0,0,100,NoArch
3812a4594df94f5a5899adb410c9b1fa14926829,1,10,4,6,14,0,0,0,18,140,1,1,0,191,5,53,7,7,7,0,557,475,82,2,2,0,0,100,NoArch
60513fce2058ec4a1adc935944b85476dd0b3bdf,1,2,0,2,2,1,0,1,167,0,1,1,0,5707,15,82,14,794,794,0,21404,21381,23,409,409,0,1,100,NoArch
78923dad5ab083a493296eeee0f39faf3d5dd7c7,1,5,0,5,5,1,0,1,2,9,1,1,0,20,1,88,5,1,1,0,92,77,15,1,1,0,0,100,NoArch
cf5a00dcb96207b5490bffe08bb1a5aed1094fad,0,0,0,0,0,0,0,0,0,0,0,0,0,0,0,45,6,0,0,0,0,0,0,0,0,0,0,100,NoArch
e4c493ef5c9741ebf91950b36f41b69a2dab6b5b,0,0,0,0,0,0,0,0,0,0,0,0,0,0,0,46,7,0,0,0,0,0,0,0,0,0,0,100,NoArch
f95e100f780c917f81e8b8c6fd7759721e53f7d2,2,16,1,15,17,1,0,1,168,19,1,2,0.672294817,5847,10,20,0,796,795,1,22406,22366,40,411,410,1,0,98.14395654,NoArch
f01cf924d86b33f2c7bf5ce5fd6647571ceff192,1,1,1,0,2,0,0,0,42,0,1,1,0,139,10,21,1,1,1,0,975,975,0,1,1,0,0,98.14395654,NoArch
e397f2c027062ddb0a0a3a7391a98845be2afa52,2,287,96,191,383,0,0,0,20,55,1,1,0.931595791,708,6,47,8,67,52,15,2134,1687,447,15,13,2,0,100,NoArch
326c3c5dbe5c58956c8b27d550cf613a13ca6b32,3,30,3,27,33,1,0,1,169,7,1,2,1.027083513,6156,10,22,2,801,797,4,24576,24463,113,413,412,1,0,100,NoArch
8575c5aa882b747f96510695c4c8bfde0d369d4a,1,3,1,2,4,0,0,0,3,22,1,1,0,25,1,89,5,1,1,0,107,92,15,1,1,0,0,100,NoArch
00fe3b8368a39803229a974c5ddd0a8e7d3cace5,2,12,3,9,15,1,0,1,50,37,1,2,0.353359335,2261,10,83,6,404,401,3,11744,11689,55,95,95,0,3,100,NoArch
3a89fa25602fc0119285aa45aacef69760c815e9,1,204,72,132,276,0,0,0,7,379,1,1,0,220,4,84,7,80,42,38,2122,1177,945,9,8,1,0,100,NoArch
00b1dbbec9dcaf629b6a26b13a21e7e725140920,0,0,0,0,0,0,0,0,0,0,0,0,0,0,0,1025,0,0,0,0,0,0,0,0,0,0,0,100,NoArch
eb7bf8bf56711bab1963d2b1bb3883938006681e,0,0,0,0,0,0,0,0,0,0,0,0,0,0,0,1026,1,0,0,0,0,0,0,0,0,0,0,100,NoArch
54485e91265f4f18fe112f8712d23f7418d03c06,0,0,0,0,0,0,0,0,0,0,0,0,0,0,0,1027,2,0,0,0,0,0,0,0,0,0,0,100,NoArch
f9c3f9b5ff3ffd53c6fe3ec789e186058b9c3b4d,1,50,4,46,54,0,0,0,15,182,1,1,0,471,6,0,0,68,61,7,1686,1484,202,33,31,2,0,99.86984816,NoArch
b157dfbc0d8c78c615589da2882ae39a06abf30f,1,1,1,0,2,0,0,0,10,79,1,1,0,275,5,1,1,43,43,0,1049,1043,6,20,20,0,0,100,NoArch
d380ff3d0e3430afb3041a157500bc277e89ab5e,1,10,2,8,12,0,0,0,13,80,1,1,0,241,5,2,2,42,41,1,961,917,44,12,12,0,0,100,NoArch
5363a823eed9bce655835f59ea71ae215d04e345,1,9,0,9,9,1,0,1,170,36,1,1,0,5742,15,174,0,799,797,2,21577,21508,69,411,411,0,0,100,NoArch
582be0c83395896d6207c835fae599c1aeba83af,1,1,1,0,2,0,0,0,171,13,1,1,0,5751,15,85,2,799,799,0,21577,21577,0,411,411,0,1,100,NoArch
1bbfe2c5688fe4ab1aa047e32cd7d8812bc4e935,1,2,10,8,12,0,0,0,14,14,1,1,0,249,6,90,1,41,42,1,917,961,44,12,12,0,0,100,NoArch
2ceeb1a8827760146d151f3b7458aaf3a40d0e17,0,0,0,0,0,0,0,0,0,0,0,0,0,0,0,152,0,0,0,0,0,0,0,0,0,0,0,100,NoArch
a8410357a9c4c852cff104392591501488071dfe,0,0,0,0,0,0,0,0,0,0,0,0,0,0,0,153,1,0,0,0,0,0,0,0,0,0,0,100,NoArch
6abb38b8d98f10ff64fa67e36d4857072995ccc7,2,108,14,94,122,1,0,1,172,27,1,2,0.068586094,6054,8,86,3,817,802,15,23996,23683,313,415,412,3,1,100,NoArch
4979dce3b48db20bd984e67bb68d6c81b1999fc1,0,0,0,0,0,0,0,0,0,0,0,0,0,0,0,154,2,0,0,0,0,0,0,0,0,0,0,100,NoArch
98eeb712bfcf0c8ed0a98b223fb888b1b660a5b5,0,0,0,0,0,0,0,0,0,0,0,0,0,0,0,155,3,0,0,0,0,0,0,0,0,0,0,100,NoArch
b95601c9c82150ebcc7d68ba13220b165499356d,2,248,30,218,278,1,0,1,173,38,1,1,0.108650459,7060,8,87,4,1085,1042,43,28819,27968,851,463,458,5,1,100,NoArch
3bdaaf4c1ad2d66a8a6144fdc66b20e0147141a5,1,56,8,48,64,0,0,0,174,3,1,1,0,6058,15,88,5,858,855,3,22827,22703,124,421,419,2,1,100,NoArch
0b3c036a13767dd519065637e476c8c161df3044,2,11,4,7,15,1,0,1,79,25,1,2,0.353359335,1359,10,89,4,233,231,2,7155,7091,64,45,45,0,1,100,NoArch
096a6a1df017a03df64dbf9b32922c53f2f44aa9,1,57,39,18,96,0,0,0,7,95,1,1,0,449,3,156,4,43,43,0,1515,1427,88,21,20,1,1,99.95659722,NoArch
14d6f948ede6cbe3f6b1582f3281f85b3fd110cc,2,12,7,5,19,0,0,0,113,43,1,2,0.998000884,3806,8,90,5,761,758,3,18844,18787,57,127,127,0,2,100,NoArch
9d95da9c9848a4a6cf29239ebb9978654af73ac1,18,971,642,329,1613,3,0,3,175,229,1,9,2.894999831,12296,2,175,1,1961,1887,74,51309,49789,1520,683,667,16,0,99.6105582,NoArch
bb908d650b24994b16c960d3563ff4d18377224a,1,4,3,1,7,0,0,0,2,0,1,1,0,66,1,176,2,10,10,0,302,302,0,6,6,0,0,100,NoArch
7f1e4dc1ddd349abba52b3983b610f218b8291c6,1,8,9,1,17,0,0,0,5,129,1,1,0,121,3,157,5,9,9,0,246,255,9,6,6,0,0,100,NoArch
28d8ca88ee3dedc3b10ddb0fd78d7c16537a4a0e,1,0,1,1,1,0,0,0,14,256,1,1,0,134,4,158,6,13,13,0,442,455,13,8,8,0,1,100,NoArch
e476911f7736e8b86ba1495eaae1850fb05972c2,1,106,6,100,112,0,0,0,3,2,1,1,0,67,1,177,3,10,10,0,302,302,0,6,6,0,0,100,NoArch
9b51ba9a17f26103aaa19711a7e57045df4207e0,1,1,0,1,1,1,0,1,38,16,1,1,0,304,8,54,0,3,3,0,2124,2115,9,1,1,0,1,100,NoArch
993fc120632793ab27c35f080fce8c0d7c8c64f6,0,0,0,0,0,0,0,0,0,0,0,0,0,0,0,91,6,0,0,0,0,0,0,0,0,0,1,100,NoArch
688f165f7f6042a80a2ec8d26bb7d35b8b8d4d5e,2,2,0,2,2,2,0,2,51,30,1,2,1,2271,10,92,7,405,404,1,11774,11757,17,95,95,0,1,100,NoArch
751c2a578f5ea0e5b8c872bcce7b513f670c4230,1,2,0,2,2,1,0,1,47,0,1,1,0,141,11,3,3,1,1,0,1027,1001,26,1,1,0,1,100,NoArch
7bb0cfabde8cdc82831ea0094f25a719b29efcfb,0,0,0,0,0,0,0,0,0,0,0,0,0,0,0,178,4,0,0,0,0,0,0,0,0,0,0,100,NoArch
c720f22b3551f9ecdfc10dfad7495753c4f802a6,1,36,8,28,44,0,0,0,4,3,1,1,0,167,1,179,5,14,10,4,369,302,67,10,6,4,0,100,NoArch
da13bf337444f37063f5b0fb393a0ff91476b719,1,5,1,4,6,0,0,0,115,5,1,1,0,2700,15,93,8,572,571,1,13605,13579,26,84,84,0,1,100,NoArch
ab0a3e969d36c30c17fd118fb410a8a7c3898b41,1,14,2,12,16,0,0,0,116,0,1,1,0,2704,15,180,6,574,572,2,13662,13605,57,84,84,0,0,100,NoArch
f89871c324a6e57f446bb0881e7aaf623626fd01,1,4,4,0,8,0,0,0,117,0,1,1,0,2716,15,181,7,574,574,0,13662,13662,0,84,84,0,0,100,NoArch
2608db51d77c5bc7449730678c66f8670bc652a6,1,4,4,0,8,0,0,0,118,0,1,1,0,2716,15,182,8,574,574,0,13680,13662,18,84,84,0,0,100,NoArch
2411623f2fc9bdbf9c5144bb3a8eec8184d47d55,1,2,14,12,16,0,0,0,119,0,1,1,0,2716,15,94,9,572,574,2,13605,13680,75,84,84,0,1,100,NoArch
4f4a75891b937550c67ca3befb8890d3aff22812,1,19,3,16,22,0,0,0,120,0,1,1,0,2704,15,95,10,576,572,4,13709,13605,104,84,84,0,1,100,NoArch
07d063df1430c715a3eee797346324f3a5ae0a46,2,50,3,47,53,1,0,1,53,60,1,1,0.941423108,716,1,159,7,86,83,3,2722,2639,83,32,30,2,0,99.87068966,NoArch
6421755a9e4b32ba47c72448bfe9832148b340a0,1,48,51,3,99,0,0,0,40,118,1,1,0,5879,8,183,8,1018,1018,0,30315,30306,9,156,156,0,1,100,NoArch
420783bcada20c6606cd7e7e0d4ab4e6b5c92baa,1,1,1,0,2,0,0,0,121,6,1,1,0,2720,15,96,11,575,576,1,13695,13709,14,84,84,0,1,100,NoArch
e62354cfa57e906cef71a60641130f9bb62c5a3f,3,70,35,35,105,1,0,1,122,159,1,2,1.055109049,2963,11,97,12,587,585,2,15197,14984,213,89,89,0,1,100,NoArch
dc27ac9ff13147f56af325ddf046e6d50e132cc9,1,18,0,18,18,1,0,1,16,96,1,1,0,327,4,184,9,76,70,6,1658,1530,128,22,22,0,0,100,NoArch
441fdf7ba6c8d3ec15ebaf2593e97943071fe817,1,6,2,4,8,0,0,0,176,16,1,1,0,6115,15,185,10,861,860,1,22866,22803,63,421,421,0,0,100,NoArch
5f2654985be844a71bf6727ee6bc94943b834cf9,0,0,0,0,0,0,0,0,0,0,0,0,0,0,0,186,11,0,0,0,0,0,0,0,0,0,0,100,NoArch
86281f654a07c0cf1b2cdbfff24811d9fc0715d3,2,78,40,38,118,0,0,0,5,22,1,1,0.866300675,397,1,187,12,48,43,5,1082,1307,225,17,15,2,0,99.78457561,NoArch
920ffdad9616b376b44f352ae7cf5a8cfe586481,1,1,1,0,2,0,0,0,14,240,1,1,0,897,6,55,1,129,129,0,5045,5045,0,19,19,0,0,100,NoArch
2cf78829818c8231c6a27110c640c19bb6cec755,0,0,0,0,0,0,0,0,0,0,0,0,0,0,0,188,13,0,0,0,0,0,0,0,0,0,0,100,NoArch
8dc893665e3e2064148281c862fd94a87f77d35f,0,0,0,0,0,0,0,0,0,0,0,0,0,0,0,160,5,0,0,0,0,0,0,0,0,0,0,100,NoArch
0decb5610886d835d5a8e1904abedbc8bb53c2bb,0,0,0,0,0,0,0,0,0,0,0,0,0,0,0,189,14,0,0,0,0,0,0,0,0,0,0,100,NoArch
f040fb5ecb095be3519260e26595cfe37b7af63b,0,0,0,0,0,0,0,0,0,0,0,0,0,0,0,8,0,0,0,0,0,0,0,0,0,0,0,100,NoArch
00bc6a2d75bd7100382a930b0a96dfb4b28fbfa2,7,359,89,270,448,4,0,4,49,722,1,4,2.300622508,743,1,1028,0,97,61,36,4113,3082,1031,54,38,16,1,99.61290323,NoArch
e6fbda8189574a366bfaa2523118a4bd37c5cdc5,0,0,0,0,0,0,0,0,0,0,0,0,0,0,0,1029,1,0,0,0,0,0,0,0,0,0,0,100,NoArch
f00370ab57dc89bc67c1b2353d7895990abcb7fe,0,0,0,0,0,0,0,0,0,0,0,0,0,0,0,1030,2,0,0,0,0,0,0,0,0,0,1,100,NoArch
2db23110c211c31ec22b8c7abd70d0c0d9495c07,1,2467,2475,8,4942,0,0,0,123,28,1,1,0,2727,15,70,0,574,575,1,13683,13745,62,84,84,0,0,100,NoArch
c1ed2d2f0cf8255087c4632fe0920af67f159831,0,0,0,0,0,0,0,0,0,0,0,0,0,0,0,161,2,0,0,0,0,0,0,0,0,0,0,100,NoArch
854bfe3b41e15f483c25b5e1c0e4c1403546d396,1,4,4,0,8,0,0,0,15,21,1,1,0,897,6,56,1,129,129,0,5045,5045,0,19,19,0,0,100,NoArch
0bb5436401778ebad1943003544eb45e86760ee0,4,53,49,4,102,0,0,0,177,108,1,4,1.159167832,6764,2,57,2,954,956,2,26858,26893,35,462,463,1,1,99.91416309,NoArch
f264aadcb67c9ac4c5e272ca08f726d05a21f11b,2,15,9,6,24,0,0,0,178,11,1,2,0.979868757,6336,2,4,0,878,877,1,23363,23295,68,432,432,0,1,100,NoArch
eb0601d28d983ea3331353ba8ac8e6ed3935d846,2,51,8,43,59,1,0,1,50,22,1,2,0.123949868,6021,11,98,2,1034,1019,15,31589,31368,221,158,157,1,1,100,NoArch
e1e779e3124039974e063e74711dc26e2188c607,0,0,0,0,0,0,0,0,0,0,0,0,0,0,0,190,7,0,0,0,0,0,0,0,0,0,0,100,NoArch
18d5719b99af6840dfdf148dfdce0dd4ad1ed67d,0,0,0,0,0,0,0,0,0,0,0,0,0,0,0,191,8,0,0,0,0,0,0,0,0,0,0,100,NoArch
1733f32df21b9ccf2b03d66f1003dfa48d1d901d,0,0,0,0,0,0,0,0,0,0,0,0,0,0,0,58,3,0,0,0,0,0,0,0,0,0,0,100,NoArch
99676375bba2c6211b6ecbf90606afb3b0ac99f8,1,22,4,18,26,0,0,0,7,1065,1,1,0,644,1,71,1,87,83,4,3319,3227,92,38,37,1,0,100,NoArch
a0ff2c553c412480a6baf69696af69bce1972d93,1,1,5,4,6,0,0,0,8,0,1,1,0,662,1,72,2,86,87,1,3302,3319,17,37,38,1,0,100,NoArch
0e621fdecf3e8ab9db2fe9eea10bae5d2dc4b695,69,1328,3818,2490,5146,1,0,1,124,536,1,11,3.585891757,24142,3,192,4,3176,3783,607,92676,104456,11780,1094,1162,68,0,96.40957447,Arch
e264719204ee86ae0ed217337c48bceed4e3d69a,1,37,38,1,75,0,0,0,125,1,1,1,0,2641,15,193,5,572,574,2,13659,13687,28,84,84,0,0,100,NoArch
edba11cc10bb03bc8e2ae6e5f4905533687313aa,1,41,21,20,62,0,0,0,126,0,1,1,0,2640,15,194,6,572,572,0,13723,13659,64,84,84,0,0,100,NoArch
50de122d30609b96fc5e40609a1a3f07e9011543,1,7,1,6,8,0,0,0,10,820,1,1,0,488,4,59,3,72,71,1,2020,1987,33,21,21,0,0,100,NoArch
cbcd91108e613b2302705aacaaff0ae910a1c6e9,1,46,0,46,46,1,0,1,127,0,1,1,0,2660,15,60,4,588,572,16,14095,13723,372,87,84,3,0,100,NoArch
cbf4a843e9f9f7653e37f2d8ab8e7db8c347ac7d,2,20,18,2,38,0,0,0,9,22,1,2,0.868040399,442,2,61,5,74,72,2,3437,3430,7,31,31,0,0,100,NoArch
f550a0036ea3e57c4f7be3a58c6ad89c996ce90d,1,4,0,4,4,1,0,1,43,2,1,1,0,642,8,195,7,96,96,0,3722,3704,18,20,20,0,0,100,NoArch
36111d8073cdc5d6b6a79bbba0a3b155243ccc87,1,92,88,4,180,0,0,0,128,0,1,1,0,2706,15,62,6,592,588,4,14171,14095,76,88,87,1,0,100,NoArch
a540320cd8b2c17c72923e46223cc6b87c4cef96,1,2,1,1,3,0,0,0,10,71,1,1,0,149,3,73,3,13,13,0,585,576,9,6,6,0,0,99.22515953,NoArch
e43445f3e76d70e8719cc2b9754892544e3c6554,1,1,1,0,2,0,0,0,2,311,1,1,0,55,2,74,4,0,0,0,12,10,2,0,0,0,0,99.27073838,NoArch
d262cc05c4798509d5b932aa5b4b48e22857e7d6,1,9,51,42,60,0,0,0,129,0,1,1,0,2710,15,196,6,584,592,8,13943,14171,228,88,88,0,0,100,NoArch
635f7de40bb88a6681c37559bcd587d6e49074bd,1,3,8,5,11,0,0,0,130,0,1,1,0,2668,15,197,7,583,584,1,13908,13943,35,88,88,0,0,99.81668194,NoArch
cef0044e5d0268cedc18c98a839afcefca34b1f5,1,1,1,0,2,0,0,0,131,0,1,1,0,2663,15,198,8,583,583,0,13904,13908,4,88,88,0,0,100,NoArch
28d55103abf93c29f5c0610e4c2e209cc18da559,0,0,0,0,0,0,0,0,0,0,0,0,0,0,0,199,9,0,0,0,0,0,0,0,0,0,0,100,NoArch
58ecd1e408c271b5ee7e1424eeaec295f22c63ea,1,155,0,155,155,1,0,1,1,0,1,1,0,0,1,200,10,13,0,13,366,0,366,6,0,6,0,99.90842491,NoArch
027ab1892cfaa0819051c5d5f6af9331290afeaa,8,104,99,5,203,3,0,3,43,0,1,3,1.09761529,5606,1,201,11,882,877,5,27370,27449,79,258,253,5,0,100,NoArch
fcaf7de38d217871170dc12590ec3ec6308317f6,0,0,0,0,0,0,0,0,0,0,0,0,0,0,0,202,12,0,0,0,0,0,0,0,0,0,0,100,NoArch
a032d22170b0262d5e23d8f25d8e2d235a6a8f49,1,2,2,0,4,0,0,0,44,0,1,1,0,4123,8,203,13,655,655,0,21063,21047,16,142,142,0,0,100,NoArch
2f2abd596461061b2d0860a460f6c87a22504386,0,0,0,0,0,0,0,0,0,0,0,0,0,0,0,91,0,0,0,0,0,0,0,0,0,0,0,100,NoArch
5915049ea639daaee00054c22d3815617dfc4f34,0,0,0,0,0,0,0,0,0,0,0,0,0,0,0,75,5,0,0,0,0,0,0,0,0,0,0,100,NoArch
f8d8704e1afe6e02ef1c0980bdae62a7a1346d56,0,0,0,0,0,0,0,0,0,0,0,0,0,0,0,76,6,0,0,0,0,0,0,0,0,0,0,100,NoArch
9f3931d730f2dc48f09e530c2c03e76e6017f187,1,23,14,9,37,0,0,0,9,9,1,1,0,658,1,77,7,88,86,2,3348,3302,46,38,37,1,0,100,NoArch
ec3128493432b0dcef7831990b896e3ae165d699,1,4,1,3,5,0,0,0,11,1797,1,1,0,240,3,204,14,48,46,2,926,896,30,20,20,0,0,100,NoArch
9ef0a12a572a1267c2c97409f584c8541104e35f,1,1,0,1,1,1,0,1,21,1,1,1,0,737,1,205,15,145,145,0,4406,4394,12,47,47,0,0,100,NoArch
93b0115a4fd2d7ba1240ed94e82fa1878d5240f9,1,103,26,77,129,0,0,0,10,2,1,1,0,667,1,78,8,101,88,13,3729,3348,381,46,38,8,0,100,NoArch
c0e40e8e1fe8751652b9e9d5cfbaecd1a7030bce,8,600,0,600,600,8,0,8,4,21,1,3,2.36038732,29,1,79,9,37,1,36,3127,100,3027,35,1,34,0,99.04675443,NoArch
9b1497ae86b951dae07e4b6285dc7814a5848494,4,13,3,10,16,1,0,1,54,473,1,4,1.882856064,5975,9,206,16,918,913,5,28129,28048,81,248,246,2,0,100,NoArch
2de3643b022c82f52b0b7b88d6ca6490d93a0d75,1,64,17,47,81,0,0,0,11,0,1,1,0,744,1,80,10,111,101,10,4041,3729,312,47,46,1,0,100,NoArch
ac682db99d671941028c87ad8007c05157644c71,1,19,10,9,29,0,0,0,12,0,1,1,0,791,1,81,11,111,111,0,4110,4041,69,47,47,0,0,100,NoArch
92cb3220de277764a90691f2c61e6fc76be586fa,2,10,1,9,11,1,0,1,53,14,1,2,0.439496987,2273,11,99,1,406,405,1,11956,11862,94,95,95,0,0,100,NoArch
8ce25a3347ee04eca0f317cae725c883cddf3332,0,0,0,0,0,0,0,0,0,0,0,0,0,0,0,100,2,0,0,0,0,0,0,0,0,0,0,100,NoArch
7e60446683f7d318bd910c91ec18add206c77c0a,0,0,0,0,0,0,0,0,0,0,0,0,0,0,0,82,12,0,0,0,0,0,0,0,0,0,1,100,NoArch
47307cba07cdf8a062b427180a11e16ded82a8d2,3,56,14,42,70,2,0,2,54,34,1,3,1.059864527,3226,8,101,3,595,582,13,17086,16758,328,136,136,0,0,100,NoArch
3a30e2017f21d16ed412efaf28407abdbc54d5f9,0,0,0,0,0,0,0,0,0,0,0,0,0,0,0,83,12,0,0,0,0,0,0,0,0,0,0,100,NoArch
15b4ecf87e8ba6cdbf450c05868fb4da29bf61ae,1,49,28,21,77,0,0,0,13,8,1,1,0,800,1,84,13,116,111,5,4306,4110,196,48,47,1,0,100,NoArch
8cfafe122de329dfd7c220cdc0bbf9e3f54da41f,1,1,1,0,2,0,0,0,46,8,1,1,0,4123,9,85,14,655,655,0,21070,21065,5,142,142,0,0,100,NoArch
3ec1aac297cfb379f44a260973817a43a05cdfba,7,41,7,34,48,5,0,5,55,365,1,2,2.419285355,6721,8,207,17,1103,1093,10,34724,34507,217,299,294,5,0,98.7854251,NoArch
f86515d70e9ae42ff1215370c076ca209059a522,1,17,0,17,17,1,0,1,48,0,1,1,0,4128,9,208,18,658,656,2,21250,21090,160,143,143,0,0,100,NoArch
79adf526dd540c371758f633b49b3ffced318a82,0,0,0,0,0,0,0,0,0,0,0,0,0,0,0,7,0,0,0,0,0,0,0,0,0,0,1,100,NoArch
78b4529885376dd306ffa52e22de4867692d3202,1,33,0,33,33,1,0,1,14,6,1,1,0,821,1,86,15,122,116,6,4453,4306,147,51,48,3,0,100,NoArch
a4ffd7700b4f121d571a970da5a8ef9638be2b31,1,2,2,0,4,0,0,0,2,18,1,1,0,155,2,162,0,13,13,0,366,366,0,6,6,0,0,100,NoArch
7f806e74c7a5deb4099e13c68f5609ee39161e6b,6,7,19,12,26,0,0,0,56,5,1,2,2.156633353,6573,8,209,17,1078,1085,7,34015,34120,105,285,288,3,0,100,NoArch
73eb11d746e13cf3946ce778a3f5547919c43764,1,6,1,5,7,0,0,0,50,0,1,1,0,4150,9,210,18,660,659,1,21312,21280,32,143,143,0,0,100,NoArch
403f531618997df69b55e7dcd2779838a89a4f41,1,37,20,17,57,0,0,0,15,2,1,1,0,854,1,87,16,122,122,0,4517,4453,64,51,51,0,0,100,NoArch
c77cd63ae171afbb1bf854ec5172659f4d8a5c6d,0,0,0,0,0,0,0,0,0,0,0,0,0,0,0,5,0,0,0,0,0,0,0,0,0,0,0,100,NoArch
1062d915750d52e4268778d65f0aabe438c41c44,10,671,241,430,912,6,0,6,55,103,1,5,2.434485087,4024,1,92,1,843,813,30,21066,20333,733,196,177,19,0,99.1510277,NoArch
2d9ca431aba4a9e1e195e6b7f108946e9a28dea1,0,0,0,0,0,0,0,0,0,0,0,0,0,0,0,88,17,0,0,0,0,0,0,0,0,0,0,100,NoArch
87cb3a30a2c94e00c7baf2c1c3936a3cff77c4a4,13,265,19,246,284,3,0,3,132,700,1,7,2.213567765,11522,2,102,3,1986,1939,47,57429,56046,1383,542,530,12,1,100,NoArch
9e909f9c83d291a00f725e0bbc5c07cf33397a5f,0,0,0,0,0,0,0,0,0,0,0,0,0,0,0,89,16,0,0,0,0,0,0,0,0,0,0,100,NoArch
55ae4ed25f7ebee1ef19e02cbbfdb596f630d1ef,2,4,1,3,5,1,0,1,57,12,1,2,0.721928095,5069,9,211,15,833,832,1,25881,25852,29,213,213,0,0,100,NoArch
ad3578f4044d908fd8c1339b4ac1d8af863f8f7b,2,4,7,3,11,1,0,1,179,68,1,2,0.439496987,6427,16,5,0,908,908,0,24035,24048,13,441,441,0,0,100,NoArch
91f361863d9873f5c67c7a5d4d163b49ddebd72c,0,0,0,0,0,0,0,0,0,0,0,0,0,0,0,6,1,0,0,0,0,0,0,0,0,0,0,100,NoArch
095042d95a531304214d3fa0b3c46433c4d461fd,1,5,1,4,6,0,0,0,55,44,1,1,0,729,11,212,16,86,86,0,2721,2701,20,32,32,0,0,100,NoArch
5c671238bdeff35a5787d4bc1f0339241c41c197,1,48,5,43,53,0,0,0,16,27,1,1,0,871,1,90,7,125,122,3,4701,4517,184,52,51,1,0,100,NoArch
20508d1670f944f779a0a4f711a7a219e470b543,8,1141,865,276,2006,7,0,7,17,0,1,2,2.129653535,914,1,91,8,132,125,7,4331,4701,370,68,52,16,0,99.68985379,NoArch
7832a98f0374e3eaae329db08246b6a5d07448a3,0,0,0,0,0,0,0,0,0,0,0,0,0,0,0,92,9,0,0,0,0,0,0,0,0,0,0,100,NoArch
819d0708406bcdd53daad9049575075a1b607467,1,13,0,13,13,1,0,1,2,0,1,1,0,96,1,93,10,13,11,2,382,320,62,8,7,1,0,100,NoArch
1673220f60315b8bc9987b44f570b233740a2f1b,0,0,0,0,0,0,0,0,0,0,0,0,0,0,0,94,11,0,0,0,0,0,0,0,0,0,0,100,NoArch
affd4994137b493ad17839ff866b2979f4a78a99,1,19,0,19,19,1,0,1,180,17,1,1,0,6125,16,23,0,863,860,3,22973,22880,93,423,420,3,0,100,NoArch
860ef6a65d30982bc2e0ba4ace5fbd18013fda30,34,1131,117,1014,1248,20,0,20,181,368,1,11,3.839629472,21783,2,103,1,3523,3305,218,101941,95814,6127,1216,1173,43,0,99.95583039,NoArch
e4ab1d6f057485ad99a27fa1e2051aa5c1e807ac,34,149,1145,996,1294,0,0,0,182,0,1,11,3.912223734,22797,3,95,9,3309,3523,214,95901,101941,6040,1176,1216,40,0,99.95583039,NoArch
98632b23cdc5edbf5765ad024ea806a4092e8ce0,0,0,0,0,0,0,0,0,0,0,0,0,0,0,0,96,10,0,0,0,0,0,0,0,0,0,0,100,NoArch
e0b96b8f8abb79ca2ac5cfe5622707022e043206,2,55,8,47,63,0,0,0,3,3,1,1,0.985228136,354,1,97,11,56,44,12,1531,1194,337,22,20,2,0,100,NoArch
199e0025d900877cf7a7243fe241ec09d2cca607,1,2,2,0,4,0,0,0,4,0,1,1,0,137,1,98,12,16,16,0,571,565,6,9,9,0,0,100,NoArch
b56604ae9d25a73bb99179612bf06570c0311e5e,9,401,118,283,519,2,0,2,18,0,1,2,2.299989453,1215,1,99,13,172,146,26,5465,4696,769,91,70,21,0,99.34152766,NoArch
b455049e0830456d6bad8ec3ebf167156d7e5406,1,1,1,0,2,0,0,0,4,0,1,1,0,266,1,100,14,38,38,0,994,992,2,13,13,0,0,100,NoArch
36273b4b0aa1800df9cbed0e8e0145c9d239687d,3,3,3,0,6,0,0,0,1,0,1,1,1.584962501,445,1,101,15,35,35,0,1547,1541,6,18,18,0,0,99.47643979,NoArch
c1fd022098c0447fd7ad44007c89ae9569cc2805,9,65,42,23,107,0,0,0,19,0,1,2,2.97196861,1498,1,102,15,174,172,2,5717,5467,250,92,91,1,0,100,NoArch
c66f81a9391ece80dddebecc5c222cf98ba273b6,1,27,15,12,42,0,0,0,2,1,1,1,0,193,1,103,16,17,16,1,665,581,84,9,9,0,0,100,NoArch
ce700d26016707727fd5c65c1dcf751619d7e96f,1,2,2,0,4,0,0,0,6,5,1,1,0,272,2,104,16,42,40,2,1384,1368,16,14,14,0,0,100,NoArch
3daf75868570f29f7e6bd3cfc1f700c979f5493b,16,22,22,0,44,0,0,0,13,51,1,5,3.793881334,2195,5,105,17,218,218,0,8270,8403,133,116,116,0,0,97.55671902,Arch
a63f2f1bcf6cccad8688db313f93665adea9d57f,0,0,0,0,0,0,0,0,0,0,0,0,0,0,0,106,18,0,0,0,0,0,0,0,0,0,0,100,NoArch
5f07595c494b2828466f3b6534c12fae5d8d9730,1,13,7,6,20,0,0,0,2,0,1,1,0,205,1,107,19,19,17,2,696,659,37,10,9,1,0,100,NoArch
8d6785b85399785e42b32b3b7f3ed2b89f06b900,1,5,3,2,8,0,0,0,183,12,1,1,0,6144,17,6,0,863,863,0,22979,22973,6,423,423,0,1,100,NoArch
c5d72d43aa616ad1de5aea6f8bfdefce3f741e61,0,0,0,0,0,0,0,0,0,0,0,0,0,0,0,213,2,0,0,0,0,0,0,0,0,0,0,100,NoArch
045f3b781cb78b3c73ea16fd7d63a6926db90ada,1,4,0,4,4,1,0,1,57,17,1,1,0,435,8,214,3,65,64,1,1362,1335,27,37,36,1,0,100,NoArch
8c748baf690b847e83a9cfdb1084aa1598a0a8cc,1,43,0,43,43,1,0,1,184,4,1,1,0,6146,17,7,1,867,863,4,23191,22979,212,425,423,2,0,100,NoArch
86576fc19e8bb073aeb1e596f618ec9c223e9de5,1,1,4,3,5,0,0,0,2,149,1,1,0,32,1,215,4,2,3,1,133,149,16,2,3,1,0,100,NoArch
698b33157294f117d73d0a4761a4a3bf36160f13,1,2,2,0,4,0,0,0,185,0,1,1,0,6189,17,216,5,867,867,0,23189,23191,2,425,425,0,0,100,NoArch
80c2df2bddf825863b4660c65a1f0bb4e2bb8a3f,1,0,4,4,4,0,0,0,11,20,1,1,0,68,4,108,19,11,12,1,346,362,16,4,5,1,0,100,NoArch
dbf7187da9d144b7723b2fa9e96e58954f4ca46e,1,1,2,1,3,0,0,0,135,20,1,1,0,2818,15,109,19,618,619,1,14718,14729,11,91,91,0,0,100,NoArch
7a19c4ad8737866a5a5ad5fcfc473d852086dbfb,1,1,1,0,2,0,0,0,2,15,1,1,0,150,1,110,20,13,13,0,582,581,1,6,6,0,0,100,NoArch
68efc006a198a56b887e1cc9dfa7bbf13e1d8713,4,2789,2718,71,5507,1,0,1,136,82,1,1,0.940293639,3252,3,111,16,667,666,1,16816,16340,476,120,119,1,0,99.60750109,NoArch
23c5bcd241c7bf63c08f09609122c825ebc7333e,8,1103,1064,39,2167,1,0,1,137,216,1,3,1.306001797,8982,3,112,17,1642,1642,0,46399,46199,200,322,322,0,0,99.73878973,NoArch
239aa69d5509b6a6f70f591e3d694f74ae3d8815,1,13,17,4,30,0,0,0,23,1,1,1,0,298,7,113,18,35,34,1,1099,1121,22,18,17,1,0,100,NoArch
15cd4c3f09428607d1b6a82f1d5885a45e5cffb9,3,24,30,6,54,0,0,0,138,0,1,1,1.114269072,2193,7,114,19,352,354,2,10620,10645,25,75,77,2,0,99.82616254,NoArch
348b127b2544887617daff8d223d86a8714f8b84,2,31,30,1,61,0,0,0,139,0,1,1,0.409073139,1871,1,115,20,312,312,0,9398,9381,17,56,56,0,0,100,NoArch
5304dded305f9ff8e84d92a9536f27bd6aeafd33,1,12,4,8,16,0,0,0,8,2,1,1,0,137,3,116,21,14,14,0,533,521,12,11,11,0,0,100,NoArch
e5f7cbb20d36b452cda5daf028a4d80087873c47,1,15,16,1,31,0,0,0,140,3,1,1,0,90,15,117,16,3,3,0,434,434,0,3,3,0,0,100,NoArch
ba16abf5a51b73bcd13a8f9697145b18540a1fc5,2,12,16,4,28,0,0,0,25,2,1,1,0.371232327,2098,7,118,17,349,349,0,10187,10203,16,73,72,1,0,100,NoArch
253bf8e2cb326e0ad4460895be5c431d973e1b99,2,5,5,0,10,0,0,0,58,15,1,1,0.970950594,2221,1,119,16,374,374,0,10326,10326,0,90,90,0,1,100,NoArch
9370456da693423cb687e55da309df132bd17431,1,2,2,0,4,0,0,0,7,0,1,1,0,1782,1,120,17,309,309,0,8964,8964,0,53,53,0,1,100,NoArch
bd2ae6a68c850008b8035e59f9900866da8dd538,1,9,32,23,41,0,0,0,14,47,1,1,0,280,6,121,18,27,28,1,773,833,60,7,7,0,0,100,NoArch
7c7595ce20d3e5ef9e972fa8a6653a40f923f869,1,2,3,1,5,0,0,0,15,0,1,1,0,257,6,122,19,27,27,0,762,773,11,7,7,0,0,100,NoArch
e691549e7a81ebf167f7d470616a2eef1687418f,1,14,7,7,21,0,0,0,16,2,1,1,0,256,6,123,19,27,27,0,792,762,30,7,7,0,0,100,NoArch
f3cf7fab35ed7cb971948da7db9a02b9c9954a0c,1,4,7,3,11,0,0,0,5,795,1,1,0,124,3,8,2,8,8,0,320,329,9,6,6,0,0,100,NoArch
d9b52efa5da542decba1ad4a517ea848dcfbd609,1,5,1,4,6,0,0,0,16,134,1,1,0,897,7,9,3,130,129,1,5069,5045,24,19,19,0,0,100,NoArch
96f6d4d45f7736e41b60ec19f7564bd5fc8c1bdb,0,0,0,0,0,0,0,0,0,0,0,0,0,0,0,10,4,0,0,0,0,0,0,0,0,0,0,100,NoArch
2675a65c6a727abc34c66589ba70b279236625dc,0,0,0,0,0,0,0,0,0,0,0,0,0,0,0,11,5,0,0,0,0,0,0,0,0,0,0,100,NoArch
c7f54b77305592873462e4e6cbcdb8813d322a33,4,50,41,9,91,0,0,0,141,8,1,2,1.864889924,3209,1,124,18,653,652,1,16524,16432,92,108,109,1,0,100,NoArch
2423dcbdd14874637c32033cf0d7d487f196444e,2,59,0,59,59,2,0,2,55,29,1,2,0.123949868,146,12,63,0,10,1,9,1437,1066,371,7,1,6,0,99.91319444,NoArch
1e25311ade43d88a71b57efb80b73932fa133307,1,7,0,7,7,1,0,1,6,126,1,1,0,303,2,12,4,52,51,1,2317,2307,10,19,18,1,0,100,NoArch
3d2c8cd13d48fd5690fae4e6397a34cda0a071dd,1,7,2,5,9,0,0,0,17,15,1,1,0,901,7,13,5,131,130,1,5097,5069,28,19,19,0,0,100,NoArch
edae2020fc901296074cc49ec48ea69f870b6059,2,77,14,63,91,1,0,1,6,7,1,1,0.89049164,121,1,14,6,15,8,7,528,320,208,11,6,5,0,99.91334489,NoArch
aef675a2b893a74cd172635696f42929c366d762,0,0,0,0,0,0,0,0,0,0,0,0,0,0,0,64,1,0,0,0,0,0,0,0,0,0,0,100,NoArch
c642b66215d1c97294013affbc407c43095dc3e9,1,16,0,16,16,1,0,1,186,66,1,1,0,6189,17,217,0,871,867,4,23259,23189,70,426,425,1,0,100,NoArch
ae595b7667e4ed282114ec9bf35d00aa15c0a667,11,1094,1,1093,1095,10,0,10,142,2,2,4,2.834992006,103,15,125,8,155,7,148,5910,539,5371,57,4,53,0,99.05660377,NoArch
d01d945a5707a9bb5b95983e7c192dad68fb3206,1,5,4,1,9,0,0,0,2,0,1,1,0,343,1,126,9,49,49,0,2031,2024,7,16,16,0,0,100,NoArch
fc311ef15e463223bcdd0432278b367a9866e66c,2,103,23,80,126,0,0,0,3,2,1,2,0.946818832,382,1,127,10,57,50,7,2769,2112,657,18,17,1,0,100,NoArch
ed64aa71e348b8cfad9e2b2ff7699033a3e0a482,1,2,0,2,2,1,0,1,2,2,1,1,0,196,1,128,11,29,29,0,950,936,14,9,9,0,0,100,NoArch
95fbf0e7c2ad9aae05ec26de9565f6c740163c03,1,1,5,4,6,0,0,0,2,79,1,1,0,272,1,129,6,41,42,1,1360,1372,12,13,14,1,0,100,NoArch
8205e82a7de320518efe1a3c83e5a9f5379db18b,1,8,1,7,9,0,0,0,2,81,1,1,0,267,1,130,6,39,38,1,1067,1031,36,13,13,0,0,100,NoArch
769c64cff26edb3fb55fda441fa822160cffdfc9,1,24,1,23,25,0,0,0,13,1645,1,1,0,199,3,131,7,27,23,4,939,796,143,18,17,1,0,100,NoArch
d455c5d47062506cacfe5c4e0a27700f3f725be8,1,1,1,0,2,0,0,0,14,0,1,1,0,222,3,132,8,27,27,0,935,939,4,18,18,0,0,100,NoArch
699ccc1b69f5889e739be86e65da1cde6d7d7708,2,10,11,1,21,1,0,1,187,4,1,2,0.998363673,6427,17,24,0,898,898,0,24198,24194,4,444,444,0,0,100,NoArch
ac6825313527e4a3298fd7aa7bfd81f1538a2ddc,1,2,8,6,10,0,0,0,16,1,1,1,0,232,4,133,8,27,28,1,932,961,29,19,19,0,0,100,NoArch
ee4a7def4bc3953b34bb65b0544e336454d795db,3,228,7,221,235,1,0,1,86,46,1,3,0.823459452,1384,9,134,9,283,253,30,7650,6892,758,84,56,28,0,99.83022071,NoArch
dfd416f7f3a027d3209b7056c4bb44b1bfd13716,1,1,0,1,1,1,0,1,56,58,1,1,0,4194,10,163,0,663,663,0,21644,21635,9,144,144,0,4,100,NoArch
3472a90be9f233bcfcdbc4378a91fb7e680d26d9,1,1,0,1,1,1,0,1,43,101,1,1,0,307,9,164,1,3,3,0,2151,2142,9,1,1,0,0,100,NoArch
3cd35ffaaaf5ae4698a85cb1e0e56aa242daef5a,0,0,0,0,0,0,0,0,0,0,0,0,0,0,0,65,2,0,0,0,0,0,0,0,0,0,1,100,NoArch
b9507c2a463774f204e01c822aaeaa4f92049e18,1,1,0,1,1,1,0,1,56,41,1,1,0,147,12,66,2,1,1,0,1092,1079,13,1,1,0,1,100,NoArch
673a6d1497428ceefc1fb8cfd83cd09c31c8d706,1,1,1,0,2,0,0,0,3,8,1,1,0,177,1,135,10,20,20,0,742,740,2,11,11,0,0,100,NoArch
4625af85b4a9f388a4dea090e645414944491c67,0,0,0,0,0,0,0,0,0,0,0,0,0,0,0,136,11,0,0,0,0,0,0,0,0,0,0,100,NoArch
7662296e5c2679d350f48d6d6f104d15c6f3c00d,1,14,11,3,25,0,0,0,28,138,1,1,0,954,11,165,2,100,100,0,2992,2964,28,39,39,0,1,100,NoArch
4c42d503f6592c6ecc511c30bb49599316a937ff,1,2,1,1,3,0,0,0,29,0,1,1,0,957,11,166,3,101,100,1,2998,2992,6,39,39,0,1,100,NoArch
ed4717279c0ce14efa012728a128dbb015317eba,0,0,0,0,0,0,0,0,0,0,0,0,0,0,0,15,0,0,0,0,0,0,0,0,0,0,0,100,NoArch
424d983d6d48683e806b6e5783b620c476ee640d,1,1,1,0,2,0,0,0,188,19,1,1,0,6194,17,16,1,870,870,0,23227,23237,10,425,425,0,0,100,NoArch
e6ba0d8be3bc6592037d7b2748a28db11495a7cf,1,1,1,0,2,0,0,0,2,254,1,1,0,285,1,218,1,39,39,0,964,962,2,13,13,0,0,100,NoArch
6c3182f6fc7becd9aebc7c1b64d9005cba17eb39,84,1418,2715,1297,4133,11,0,11,189,395,1,14,4.295540684,30059,2,219,2,3898,4205,307,115409,122832,7423,1617,1641,24,0,96.52956298,Arch
2a5268836058cadfa9b8f4d26985ea2ef51e1f2e,1,638,0,638,638,1,0,1,1,0,1,1,0,0,1,220,3,140,0,140,4155,0,4155,43,0,43,0,99.69631236,NoArch
e3bfa4824aae753af7f876104c46b5d8b532e0bd,0,0,0,0,0,0,0,0,0,0,0,0,0,0,0,67,2,0,0,0,0,0,0,0,0,0,0,100,NoArch
08260b619b6323b7acf14635efa1e68584648829,0,0,0,0,0,0,0,0,0,0,0,0,0,0,0,68,3,0,0,0,0,0,0,0,0,0,0,100,NoArch
20a0ccb5ec972148504459a2a43e3a9101586a13,0,0,0,0,0,0,0,0,0,0,0,0,0,0,0,167,4,0,0,0,0,0,0,0,0,0,0,100,NoArch
867b61b4fa1f7779319d61deef23bbf300a53163,1,31,30,1,61,0,0,0,190,5,1,1,0,6195,17,137,8,863,870,7,23213,23227,14,425,425,0,0,100,NoArch
f3924b1c14d674cc9824067d87f930eafda0aff8,5,63,31,32,94,1,0,1,59,5,1,3,1.436276555,4752,1,221,3,877,867,10,24178,23968,210,262,260,2,0,100,NoArch
4467dd5c2461e3e955dbb38b242fd874f38a9801,1,78,0,78,78,1,0,1,2,120,1,1,0,295,1,138,9,37,27,10,1353,1097,256,28,18,10,0,100,NoArch
2babcf3b3b6d311690a00eaa279b65cfccba647a,2,72,28,44,100,0,0,0,57,8,1,2,0.893173458,1731,11,222,4,226,212,14,6601,6197,404,78,77,1,0,100,NoArch
f15a4d95f060eb69ed45d992477b9f82d1554324,1,4,3,1,7,0,0,0,12,523,1,1,0,112,6,223,5,6,6,0,360,342,18,4,4,0,0,100,NoArch
c8f5e07f5f77f5617b6597b69fbfa576f91555aa,1,10,6,4,16,0,0,0,33,0,1,1,0,1000,11,224,6,130,130,0,3662,3652,10,43,43,0,0,100,NoArch
64631b832a2d09c2faba0ede7d816e9cbaf4bbc8,1,36,3,33,39,0,0,0,3,8,1,1,0,659,1,225,7,150,145,5,4420,4260,160,46,44,2,0,100,NoArch
7779d94de074c1a52f2319fc53edc2c87f022522,1,2,1,1,3,0,0,0,4,0,1,1,0,692,1,226,8,150,150,0,4424,4420,4,46,46,0,0,100,NoArch
f3bc4a12cfc15d9636681934ea6511d159b475ee,1,3,3,0,6,0,0,0,5,0,1,1,0,693,1,227,9,150,150,0,4436,4424,12,46,46,0,0,100,NoArch
c47308f2758a700ee640680df4ab1badac777e38,1,362,0,362,362,1,0,1,1,0,1,1,0,0,1,139,4,42,0,42,2631,0,2631,42,0,42,0,99.91311903,NoArch
2d004a00bbe2aaf4235d0017c9b49ef87412489b,2,10,5,5,15,0,0,0,58,5,1,2,0.996791632,1779,11,228,10,227,226,1,6664,6611,53,78,78,0,0,100,NoArch
b573446c3376d7c697c7b497cfcd6c091d61a173,1,43,19,24,62,0,0,0,2,2,1,1,0,362,1,140,5,42,42,0,2631,2631,0,42,42,0,0,100,NoArch
a4f6789f34eac176f179ff6ec0779fc5613a8041,0,0,0,0,0,0,0,0,0,0,0,0,0,0,0,168,3,0,0,0,0,0,0,0,0,0,0,100,NoArch
dd157a82abbb0521e2df05e109eaca173bc491d1,1,1,0,1,1,1,0,1,44,43,1,1,0,308,9,229,11,3,3,0,2160,2151,9,1,1,0,0,100,NoArch
01cd49bbba858038647a22b45e84f2ca77d12d02,0,0,0,0,0,0,0,0,0,0,0,0,0,0,0,230,12,0,0,0,0,0,0,0,0,0,0,100,NoArch
bf4fc251ce82aa0d5c49b053b7b291b006fac43d,0,0,0,0,0,0,0,0,0,0,0,0,0,0,0,231,13,0,0,0,0,0,0,0,0,0,0,100,NoArch
3bd830b3290daebe3ccda5692ac7dd4e21cc1b5c,3,112,94,18,206,0,0,0,59,92,1,2,1.007159386,1508,2,169,4,252,248,4,7564,7470,94,81,81,0,1,100,NoArch
c65768674f83df2c438db96117d3c302f39d778e,1,25,17,8,42,0,0,0,9,21,1,1,0,466,4,170,5,44,43,1,1563,1504,59,21,21,0,1,100,NoArch
4aa67fa7a6ee90821fa5cd79f7bb2a2e1aeef61b,0,0,0,0,0,0,0,0,0,0,0,0,0,0,0,171,6,0,0,0,0,0,0,0,0,0,1,100,NoArch
cf605582ba9487f26650e1b17db7329dafacb5e7,1,3,0,3,3,1,0,1,17,21,1,1,0,161,6,232,14,20,19,1,534,526,8,13,13,0,0,100,NoArch
1584583841b56525ae319af330592605c04e216a,2,29,2,27,31,0,0,0,60,0,1,2,0.999249248,1491,2,172,7,254,252,2,7671,7530,141,81,81,0,1,100,NoArch
5b334c600e6dd50ff8d7f6749a887ce28cf2322c,1,40,32,8,72,0,0,0,3,2,1,1,0,386,1,141,6,42,42,0,2623,2631,8,42,42,0,0,100,NoArch
8974228a445b223a48323578c8cbd8a725bf8498,0,0,0,0,0,0,0,0,0,0,0,0,0,0,0,93,0,0,0,0,0,0,0,0,0,0,1,100,NoArch
46689bf44ae1da708161031e1be6898ee8cac9ca,1,15,0,15,15,1,0,1,3,15,1,1,0,373,1,142,5,38,37,1,1417,1353,64,29,28,1,0,100,NoArch
41668eb435c2934ead6dc9d616eda9efb9252d97,1,1,1,0,2,0,0,0,4,0,1,1,0,388,1,143,6,38,38,0,1417,1417,0,29,29,0,0,100,NoArch
f26b4aa7c24bf128774bca85d83bb9280a3db511,1,24,1,23,25,0,0,0,191,18,1,1,0,6196,17,173,6,867,863,4,23306,23213,93,426,425,1,1,100,NoArch
e4caa169905b985cdde1850de6f40aaf32cffae0,0,0,0,0,0,0,0,0,0,0,0,0,0,0,0,174,7,0,0,0,0,0,0,0,0,0,0,100,NoArch
c1d017f791b69f73dde2dc07214303a77d7e718a,0,0,0,0,0,0,0,0,0,0,0,0,0,0,0,175,8,0,0,0,0,0,0,0,0,0,0,100,NoArch
187608204d1531ca3266992801e036adf03c8458,1,4,2,2,6,0,0,0,8,2,1,1,0,719,2,233,15,154,153,1,4586,4555,31,46,46,0,0,100,NoArch
ad04cab39ad9b7a378035dd8c28eca6c22301309,2,22,0,22,22,2,0,2,58,23,1,2,0.684038436,2221,5,94,1,423,418,5,11167,11063,104,103,99,4,0,100,NoArch
d87c7ddf1702ea6f40c0612355426e15162b2a3f,1,15,1,14,16,0,0,0,60,22,1,1,0,855,7,234,16,171,169,2,4350,4286,64,77,77,0,0,100,NoArch
b5cc220980cb38176db98e805bd678667c28484b,1,2,1,1,3,0,0,0,61,0,1,1,0,869,7,235,17,171,171,0,4361,4350,11,77,77,0,0,100,NoArch
1df4ef4fb0f3df86738de0d404d6d9f205f89f81,1,3,1,2,4,0,0,0,62,0,1,1,0,870,7,236,18,172,171,1,4375,4361,14,77,77,0,0,100,NoArch
e63ae30b17648efeb229d72bf0e9503f0138403a,1,4,4,0,8,0,0,0,63,0,1,1,0,872,7,237,19,172,172,0,4391,4375,16,77,77,0,0,100,NoArch
028f0bbeaad4c5a75448b2872a9d21b0e2315fbf,0,0,0,0,0,0,0,0,0,0,0,0,0,0,0,144,7,0,0,0,0,0,0,0,0,0,0,100,NoArch
29eb0b76ea8f1edad35bdcee2de9b6df8fe34bf2,0,0,0,0,0,0,0,0,0,0,0,0,0,0,0,145,8,0,0,0,0,0,0,0,0,0,0,100,NoArch
962cdc40af36c5b806e969267320d8b2b18f9198,1,2,2,0,4,0,0,0,4,12,1,1,0,394,1,146,9,42,42,0,2623,2623,0,42,42,0,0,100,NoArch
46c1b26fbabb2f95c6351391e1b7a06bed9fba3b,1,1,1,0,2,0,0,0,192,18,1,1,0,6219,17,69,0,867,867,0,23306,23306,0,426,426,0,0,100,NoArch
984bd52b6d4ae03ed6b02c3b0ccc33aea20c4056,0,0,0,0,0,0,0,0,0,0,0,0,0,0,0,25,0,0,0,0,0,0,0,0,0,0,0,100,NoArch
1bd80e550b5039c6e2b20db86cc09af94d4ace48,0,0,0,0,0,0,0,0,0,0,0,0,0,0,0,26,1,0,0,0,0,0,0,0,0,0,1,100,NoArch
0129412ea3d9afd10f5ed3b8bd43ba8e1f37a767,1,1,0,1,1,1,0,1,58,44,1,1,0,147,12,27,2,1,1,0,1092,1079,13,1,1,0,1,100,NoArch
f65f4ce97c4e59efeebd1554d3dbc6b8a4a7b6c6,1,45,1,44,46,0,0,0,4,63,1,1,0,177,1,147,10,24,20,4,973,742,231,12,11,1,0,100,NoArch
95038db052b0b56b504c492035750d2e197753c3,2,258,145,113,403,1,0,1,5,6,1,1,0.977492863,394,1,148,10,42,42,0,2887,2623,264,42,42,0,0,99.82661465,NoArch
8d512eaa4bc6a5b3192d39340034884fe3bb96be,5,199,357,158,556,0,0,0,61,55,1,4,1.309936175,5899,2,238,13,1127,1143,16,29304,29332,28,227,229,2,0,100,NoArch
026d9fc60458be6f251b3e866c35c62596413acc,1,55,44,11,99,0,0,0,193,24,1,1,0,6219,17,9,0,868,867,1,23328,23306,22,427,426,1,0,100,NoArch
71a48fc66a57676e8fd3761d4fed2123bcb43d08,1,3,2,1,5,0,0,0,194,10,1,1,0,6230,17,10,1,868,868,0,23331,23328,3,427,427,0,0,100,NoArch
ab88b48ff7159b4422cdc840fb3c561a22173b0e,0,0,0,0,0,0,0,0,0,0,0,0,0,0,0,11,2,0,0,0,0,0,0,0,0,0,0,100,NoArch
852dcab436f0b4a62dde9c1e35fd77709cde238e,1,1,0,1,1,1,0,1,14,191,1,1,0,83,7,12,3,1,1,0,708,691,17,1,1,0,0,100,NoArch
5595bda97949ac288dad7bcbdf24eb6859afc0ab,1,2,1,1,3,0,0,0,45,57,1,1,0,309,10,13,4,3,3,0,2169,2160,9,1,1,0,0,100,NoArch
2eccdf00580306a788a2ed69c2784d132022e584,4,71,27,44,98,0,0,0,60,78,1,3,1.70254277,5910,10,239,1,967,952,15,29647,29304,343,243,242,1,0,100,NoArch
6c9ce95f8e93ed06bf9909c8a95a3417dcfd9aea,1,1,1,0,2,0,0,0,59,0,1,1,0,3541,10,240,2,521,521,0,17794,17802,8,130,130,0,0,100,NoArch
6fbf05e766203f2de802035894d060567d131191,1,2,0,2,2,1,0,1,46,13,1,1,0,310,10,241,3,3,3,0,2178,2169,9,1,1,0,0,100,NoArch
c4193c55e4341c48ba2672528ff1665921d5c9d0,1,1,1,0,2,0,0,0,47,0,1,1,0,312,10,242,4,3,3,0,2178,2178,0,1,1,0,0,100,NoArch
f68da0a0baa25546bceea3415dfd0270466159f2,1,1,1,0,2,0,0,0,48,0,1,1,0,312,10,243,5,3,3,0,2180,2178,2,1,1,0,0,100,NoArch
db0f052626496bfb9606633e98cc4382d8c93fed,9,115,30,85,145,2,0,2,64,135,1,4,3.00329104,8738,2,244,6,1489,1476,13,45771,45069,702,432,428,4,0,100,NoArch
4feb7dea597ed08800b5345a6c393a89bc2c8c2b,5,11,11,0,22,0,0,0,12,95,1,1,1.971747257,644,3,245,7,16,16,0,3214,3170,44,11,11,0,0,100,NoArch
c9cabe23dbb0a92041bf908be93535658c1dc8f5,0,0,0,0,0,0,0,0,0,0,0,0,0,0,0,17,0,0,0,0,0,0,0,0,0,0,0,100,NoArch
a25fff32dec0bc1fe91ec0ed42786ec101a4ef0b,0,0,0,0,0,0,0,0,0,0,0,0,0,0,0,18,1,0,0,0,0,0,0,0,0,0,0,100,NoArch
508014648861e06c54f5e9da6fc31d9074ab8426,2,16,128,112,144,0,1,1,15,423,1,2,0.822100404,489,2,19,2,39,58,19,1302,1836,534,18,26,8,2,96.0034379,Arch
677bc2cdf8964d610cd079f3c037c782ea4e5249,1,2,2,0,4,0,0,0,65,15,1,1,0,876,7,246,7,174,172,2,4474,4462,12,77,77,0,0,100,NoArch
a8c9e453f062db6b386253c09ec80c2477eeac7d,1,1,1,0,2,0,0,0,23,111,1,1,0,671,6,247,8,147,147,0,3210,3210,0,35,35,0,0,100,NoArch
87626c2bd773c6ae823eb9e30f6e75e2435971bd,1,3,4,1,7,0,0,0,61,15,1,1,0,3554,10,248,9,523,523,0,17928,17932,4,130,130,0,0,100,NoArch
47f9b9254a712ea19dd6d26ba84e4054b3aa15ed,2,64,76,12,140,0,0,0,24,976,1,2,0.187176257,743,3,249,10,148,149,1,3320,3348,28,37,37,0,0,100,NoArch
2c3ccc7b9409166decf486ea01729c84f01bee61,1,1,1,0,2,0,0,0,25,0,1,1,0,657,6,250,11,146,146,0,3166,3165,1,35,35,0,0,100,NoArch
804a4ef073fef839a179030efb996c09bd9a0830,3,104,0,104,104,3,0,3,59,34,1,2,0.433056213,148,12,70,0,10,1,9,1594,1092,502,5,1,4,1,99.14420197,NoArch
7f8b9ac5740e87092ff19a16a77c38535b817e4a,0,0,0,0,0,0,0,0,0,0,0,0,0,0,0,71,1,0,0,0,0,0,0,0,0,0,1,100,NoArch
3eeadf0c61447ef26c8d90ce06fc6fcf657b193e,0,0,0,0,0,0,0,0,0,0,0,0,0,0,0,176,0,0,0,0,0,0,0,0,0,0,2,100,NoArch
b76479e58bc1b59d9dd15d3e69f5233e914ed590,18,288,460,172,748,5,0,5,60,487,1,7,3.0868603,1659,2,72,2,116,85,31,5329,7785,2456,72,56,16,1,96.38143891,Arch
2a33abfe9ed1bb93a105b606d3abb11897f28162,2,13,6,7,19,0,0,0,6,0,1,1,0.629249224,152,2,73,3,20,25,5,564,604,40,19,19,0,1,100,NoArch
6c68b9893e61064429516b06f04532d5e988a175,2,92,25,67,117,0,0,0,7,949,1,2,0.172036949,405,4,74,4,63,52,11,1756,1582,174,51,41,10,1,100,NoArch
8747c5a5d5368b344ea78a63be20fbd277072b20,1,1,1,0,2,0,0,0,8,0,1,1,0,116,4,75,5,16,17,1,456,464,8,16,16,0,1,100,NoArch
2ca9bde27f1dceb590b392acc0e722f22bf01ae2,2,7,7,0,14,0,0,0,2,0,1,2,0.863120569,163,1,76,6,17,17,0,760,760,0,17,17,0,1,99.83108108,NoArch
515f0276e8a8c55ea23e1c1139251fb460018426,1,1,1,0,2,0,0,0,3,0,1,1,0,47,1,77,7,1,1,0,295,304,9,1,1,0,1,100,NoArch
8d11bdbe05173073d22a503a7d3f2e39d9720a29,2,15,17,2,32,0,0,0,29,543,1,2,0.69621226,785,5,78,8,132,132,0,4014,3863,151,125,125,0,1,100,NoArch
d2c69898be023b7109d9cafdbb4b0f40280f707d,3,4,4,0,8,0,0,0,13,0,1,2,1.5,444,3,79,9,70,70,0,2505,2513,8,70,70,0,1,100,NoArch
8446c69f4036d2aacc6318a050542a10c9f5a244,1,6,6,0,12,0,0,0,30,0,1,1,0,458,5,80,10,65,64,1,2416,2408,8,57,57,0,1,100,NoArch
f2e021d69844625767cbbb70475a720f9796f1df,0,0,0,0,0,0,0,0,0,0,0,0,0,0,0,81,11,0,0,0,0,0,0,0,0,0,1,100,NoArch
cdfb16abf2faee101b4709c8ac8c358bddee7872,1,5,0,5,5,1,0,1,2,285,1,1,0,162,1,149,0,18,17,1,509,493,16,14,13,1,1,100,NoArch
f4fe04f78ac18f43e51c7565703bf986cf0aee43,5,29,33,4,62,0,0,0,14,5,1,3,1.971227808,604,3,82,12,108,90,18,3239,3069,170,89,89,0,0,99.83108108,NoArch
4ccab7eb47c9903c74b490bca604f0228784d907,1,1,1,0,2,0,0,0,17,252,1,1,0,263,6,150,1,27,27,0,792,792,0,7,7,0,1,100,NoArch
433330bcb976157b83406a7c48cc02a4d4aeaa43,0,0,0,0,0,0,0,0,0,0,0,0,0,0,0,151,2,0,0,0,0,0,0,0,0,0,1,100,NoArch
07366fafa84a1afa092ef30294fd40f5db9a2319,0,0,0,0,0,0,0,0,0,0,0,0,0,0,0,177,1,0,0,0,0,0,0,0,0,0,0,100,NoArch
47c6ba05db2758311c7d8b1d7ee99ee86cd905ee,1,48,6,42,54,0,0,0,7,807,1,1,0,259,5,178,2,39,32,7,1352,1208,144,14,8,6,1,100,NoArch
f926be21af58091ea6ce7d17a158a097f39f51b5,1,123,0,123,123,1,0,1,8,0,1,1,0,301,5,179,2,53,39,14,1884,1352,532,17,14,3,1,100,NoArch
26d481d0c48dd0334b97134fabf691f48a9382a3,1,38,32,6,70,0,0,0,9,0,1,1,0,424,5,180,3,53,53,0,1892,1884,8,17,17,0,1,100,NoArch
7b3da89aa7961b6b574ac759ee5442838a972fbc,67,2492,2322,170,4814,11,0,11,192,293,1,10,3.999005873,16952,3,251,0,2402,2398,4,72233,71468,765,1005,981,24,0,94.69666533,Arch
c265d3c3d913b37b17870f1203bd130099bfdd2a,1,165,0,165,165,1,0,1,1,0,1,1,0,0,1,252,1,29,0,29,903,0,903,26,0,26,0,97.76802049,Arch
b208024dfe32c83629c8dd5829cba055b3e4fb26,3,25,6,19,31,0,0,0,63,223,1,2,0.886570351,3727,1,253,2,524,522,2,18640,18569,71,158,157,1,0,100,NoArch
e9e2da9167fb716d996998183366681898e4672b,1,1,0,1,1,1,0,1,3,0,1,1,0,551,1,254,3,67,67,0,2080,2074,6,35,35,0,0,100,NoArch
3296f862112feae94c68467dec6e51275a44f1d4,0,0,0,0,0,0,0,0,0,0,0,0,0,0,0,255,4,0,0,0,0,0,0,0,0,0,0,100,NoArch
da97181cb7f0d2b32a79e7a9c52270e7b9c0ca99,1,6,7,1,13,0,0,0,11,23,1,1,0,114,5,256,5,16,22,6,456,508,52,16,16,0,0,100,NoArch
9fb06f1cef0f35663da57a53641f925acaf48c92,1,2,2,0,4,0,0,0,5,23,1,1,0,42,3,257,6,5,5,0,105,111,6,3,3,0,0,100,NoArch
6e0d8466b6e74ecb9b09fef081d189a1418c45ad,0,0,0,0,0,0,0,0,0,0,0,0,0,0,0,258,7,0,0,0,0,0,0,0,0,0,0,100,NoArch
fb21f2fc075e14e6ca7d018a91f552866a1ae211,1,1,1,0,2,0,0,0,6,0,1,1,0,42,3,259,8,4,5,1,106,105,1,3,3,0,0,100,NoArch
9cec9ca4ad20f27c6076c0288535c40f429db941,5,19,11,8,30,0,0,0,61,40,1,2,1.969974075,289,2,83,3,17,16,1,792,743,49,9,9,0,0,100,NoArch
ace761693228a2dbcd876283efc5effecbc77b7d,1,6,1,5,7,0,0,0,9,533,1,1,0,389,2,48,0,25,24,1,952,936,16,5,5,0,0,100,NoArch
dcc76fcd524b63f7ebad4fa91b41f77f893df7eb,1,20,6,14,26,0,0,0,62,164,1,1,0,704,11,260,9,108,105,3,3278,3210,68,41,41,0,0,100,NoArch
a5c152ff62e4772e5dcad0c726110081b8faf468,0,0,0,0,0,0,0,0,0,0,0,0,0,0,0,261,10,0,0,0,0,0,0,0,0,0,0,100,NoArch
508e983e4373e262a6b028805d9ab5486c32a20b,0,0,0,0,0,0,0,0,0,0,0,0,0,0,0,262,11,0,0,0,0,0,0,0,0,0,0,100,NoArch
b15d741b432e2358d2c941fc5fdf54f6acd483cc,0,0,0,0,0,0,0,0,0,0,0,0,0,0,0,263,12,0,0,0,0,0,0,0,0,0,0,100,NoArch
de36eb5b25b80cab0bed2461a9ec1f21e3816697,0,0,0,0,0,0,0,0,0,0,0,0,0,0,0,264,13,0,0,0,0,0,0,0,0,0,0,100,NoArch
66babe32a1574e8e454d1e5a884b05309b5c72e1,0,0,0,0,0,0,0,0,0,0,0,0,0,0,0,265,14,0,0,0,0,0,0,0,0,0,0,100,NoArch
8bfa798ec4e8ae3774c06f65352627f3ed94fec5,0,0,0,0,0,0,0,0,0,0,0,0,0,0,0,266,15,0,0,0,0,0,0,0,0,0,0,100,NoArch
ae2b5e591ae68b44588eb0fd22593251332c6930,0,0,0,0,0,0,0,0,0,0,0,0,0,0,0,267,16,0,0,0,0,0,0,0,0,0,0,100,NoArch
aba03ca52610212e79b37d66818a694e1c46b1f5,1,2,1,1,3,0,0,0,7,19,1,1,0,42,4,181,4,4,4,0,106,106,0,3,3,0,0,100,NoArch
9da121ec6af19ca7b097e6514f7b4d74d2accaab,1,1,1,0,2,0,0,0,8,0,1,1,0,43,4,182,5,4,4,0,106,106,0,3,3,0,0,100,NoArch
bc46abaa40816cdfad9573ab074202a7a198a5f4,1,1,1,0,2,0,0,0,9,0,1,1,0,43,4,183,6,4,4,0,106,106,0,3,3,0,0,100,NoArch
048b2375c6575c01d220e4a309d16dbc648a79b8,1,2,1,1,3,0,0,0,64,21,1,1,0,3112,10,268,17,456,454,2,16460,16435,25,120,120,0,0,100,NoArch
bab4731c252161eb68f4718a8b3f29882cc84e75,0,0,0,0,0,0,0,0,0,0,0,0,0,0,0,269,18,0,0,0,0,0,0,0,0,0,0,100,NoArch
4c36460c41761b25f9f7065efe854c5b403e1e91,2,17,3,14,20,1,0,1,36,22,1,2,0.970950594,1148,11,270,19,165,163,2,4816,4749,67,57,56,1,0,100,NoArch
aaac29237501ba553b3825d97db2d794b6483537,0,0,0,0,0,0,0,0,0,0,0,0,0,0,0,271,20,0,0,0,0,0,0,0,0,0,0,100,NoArch
7ef05a89525fa60075c2137ec71acd9dc9e70ea3,2,9,4,5,13,0,0,0,63,22,1,2,0.961236605,2950,2,272,21,584,580,4,16222,16178,44,142,142,0,0,100,NoArch
fdaa310a99d99edfd77c4b7cdcbc0ef41eabd3e2,3,25,3,22,28,1,0,1,67,14,1,3,1.263809174,3794,9,273,22,696,693,3,19719,19632,87,194,193,1,0,100,NoArch
d7e85fa70435f3f7fae16e21c4bc29a4d0645ffb,1,31,13,18,44,0,0,0,65,1,1,1,0,3113,10,274,23,463,456,7,16587,16460,127,121,120,1,0,100,NoArch
96ee17548dd6d2fa26821e68659847ef60d290b4,1,2,3,1,5,0,0,0,63,4,1,1,0,718,11,275,24,108,108,0,3268,3278,10,41,41,0,0,100,NoArch
fba20da1a9e1c90025ab38bea4d6f55bc5f52630,2,5,8,3,13,0,0,0,66,0,1,2,0.619382195,3848,10,276,25,571,571,0,19841,19855,14,162,162,0,0,100,NoArch
c448a79d80bd30c089fd5bb7b2d7bf586671348e,1,17,18,1,35,0,0,0,67,0,1,1,0,3128,10,277,26,461,463,2,16548,16573,25,121,121,0,0,100,NoArch
111f10c068f2e9fcea3a7f0e9873cf53624b4747,0,0,0,0,0,0,0,0,0,0,0,0,0,0,0,278,27,0,0,0,0,0,0,0,0,0,0,100,NoArch
ef623e50e5c381de951bd1b74e1be7597301b70a,0,0,0,0,0,0,0,0,0,0,0,0,0,0,0,84,1,0,0,0,0,0,0,0,0,0,1,100,NoArch
a2d10edf10c3d8aba211f66a9e1046f6260c9113,0,0,0,0,0,0,0,0,0,0,0,0,0,0,0,85,2,0,0,0,0,0,0,0,0,0,1,100,NoArch
0f4b63227f1d16e3a3074b4e4d567112f9803f53,0,0,0,0,0,0,0,0,0,0,0,0,0,0,0,86,3,0,0,0,0,0,0,0,0,0,1,100,NoArch
039339814bead4700958dc7322fbf1fc2575285b,0,0,0,0,0,0,0,0,0,0,0,0,0,0,0,87,4,0,0,0,0,0,0,0,0,0,0,100,NoArch
f9c18b21d92a841ae0dd0a395a726d2b53a61499,2,10,8,2,18,0,0,0,68,21,1,1,0.964078765,3579,1,279,28,542,541,1,19000,18993,7,145,145,0,0,100,NoArch
9ea4809775c1175ad79d26d6f4a9f9aea4eb59e1,0,0,0,0,0,0,0,0,0,0,0,0,0,0,0,88,5,0,0,0,0,0,0,0,0,0,0,100,NoArch
ec36ce95d821d79be09655ff700a3856cbe5c171,0,0,0,0,0,0,0,0,0,0,0,0,0,0,0,89,6,0,0,0,0,0,0,0,0,0,1,100,NoArch
6c29193f004212a6b301b1b7d4e597b4bce6e8fc,2,16,0,16,16,2,0,2,65,14,1,2,0.988699408,2364,3,280,29,463,458,5,12551,12420,131,110,109,1,0,100,NoArch
5935459c73a6259bd8c055841bcf36a212088f6c,0,0,0,0,0,0,0,0,0,0,0,0,0,0,0,281,21,0,0,0,0,0,0,0,0,0,0,100,NoArch
429f12383ac7548c274733a254820229fe87f4b3,1,1,1,0,2,0,0,0,69,15,1,1,0,3126,10,282,22,461,461,0,16533,16532,1,121,121,0,1,100,NoArch
cebcfad644f1cfaa6e6dc864b7549a12c9d82d8d,1,31,10,21,41,0,0,0,48,375,1,1,0,585,12,184,3,80,74,6,2289,2154,135,44,44,0,1,100,NoArch
c0bcabdecd032efc0855fbf9fea328516133a6b0,1,8,1,7,9,0,0,0,3,52,1,1,0,83,2,185,4,5,3,2,176,131,45,3,3,0,0,100,NoArch
feb0a6cac5c7bfd94e77181af8a6620527fc42a5,0,0,0,0,0,0,0,0,0,0,0,0,0,0,0,283,23,0,0,0,0,0,0,0,0,0,0,100,NoArch
7d2442cae9605a3252ef78b2abae761f6050bd15,3,36,41,5,77,1,0,1,70,39,1,2,0.988059718,3865,1,284,24,549,554,5,19183,19200,17,174,175,1,0,100,NoArch
de752b7cb3687f1d64c20448956e4487acea497c,3,10,6,4,16,0,0,0,3,245,1,1,1.579434003,502,1,152,0,60,62,2,1761,1746,15,29,29,0,0,100,NoArch
ecc8bf7dfae19f255d01a9590bf42585ed1e7783,1,4,4,0,8,0,0,0,9,1733,1,1,0,229,6,90,6,20,20,0,849,875,26,7,7,0,0,100,NoArch
77362f9a31ffcab5b9dab8d5126fca2ff5eac5cb,1,26,19,7,45,0,0,0,68,41,1,1,0,945,7,285,10,178,177,1,4534,4513,21,78,78,0,0,100,NoArch
329835cbb58797ccf78eb38b9d65f3313ea50f08,5,54,28,26,82,1,0,1,66,55,1,4,2.016212665,3943,5,12,0,655,656,1,18486,18345,141,202,202,0,0,100,NoArch
5603d952930b0fcaccc593e1ba39e1a12789c741,1,7,1,6,8,0,0,0,3,298,1,1,0,268,1,153,1,42,41,1,1393,1360,33,13,13,0,0,100,NoArch
78c174903c0f086f4026a01a6d2edc22e04f574e,0,0,0,0,0,0,0,0,0,0,0,0,0,0,0,286,7,0,0,0,0,0,0,0,0,0,0,100,NoArch
f543d82b7ceaf67c7b19b2dc5a2a80f9877282aa,1,1,1,0,2,0,0,0,52,44,1,1,0,678,9,287,8,97,96,1,3884,3872,12,20,20,0,0,100,NoArch
4612b60e1fc38bc813b28c317510b5f18b55ab25,0,0,0,0,0,0,0,0,0,0,0,0,0,0,0,288,9,0,0,0,0,0,0,0,0,0,0,100,NoArch
f4c9ee5dd4ea1b1e8c7f70e7bb8eba354bdba919,1,1,1,0,2,0,0,0,4,0,1,1,0,274,1,154,2,42,42,0,1391,1393,2,13,13,0,0,100,NoArch
08ba66ef26913f1157d21321cb551584d7f2e49e,1,20,0,20,20,1,0,1,9,29,1,1,0,180,3,289,10,45,38,7,1345,1171,174,15,14,1,0,100,NoArch
156e11830fc8f206ab36d9a1436cb969769f966a,1,3,1,2,4,0,0,0,10,0,1,1,0,200,3,290,11,46,45,1,1382,1345,37,15,15,0,0,100,NoArch
aca0b1a645a5fcadee227d07443b20462775bad8,0,0,0,0,0,0,0,0,0,0,0,0,0,0,0,291,12,0,0,0,0,0,0,0,0,0,0,100,NoArch
a8f462eed6bbcd0f88a52280b279fc85d3b0b0ef,0,0,0,0,0,0,0,0,0,0,0,0,0,0,0,292,13,0,0,0,0,0,0,0,0,0,0,100,NoArch
7414964a7ed2184081ffafea7eaeb2b8fb2564ab,1,4,0,4,4,1,0,1,195,189,1,1,0,6231,17,293,14,869,868,1,23355,23331,24,427,427,0,0,100,NoArch
9b55cf2a338553e9d720ac30ea2648fdf5d8c9e6,0,0,0,0,0,0,0,0,0,0,0,0,0,0,0,91,6,0,0,0,0,0,0,0,0,0,0,100,NoArch
10b05079d20089a643e49ac8921f4cf83b4932e7,1,4,4,0,8,0,0,0,22,393,1,1,0,219,8,186,2,23,22,1,569,551,18,13,13,0,0,100,NoArch
1a1f2c4306f8debc75522b46b377eeb04c3f3b17,0,0,0,0,0,0,0,0,0,0,0,0,0,0,0,187,3,0,0,0,0,0,0,0,0,0,0,100,NoArch
9a4a256c9c8c932067f62fec9fd2f7f2f9a60b81,2,80,80,0,160,0,0,0,62,62,1,1,0.995938608,135,12,92,6,5,5,0,184,184,0,2,2,0,0,100,NoArch
15439b97ccb603455a17873981c81b0362d1e510,2,2,1,1,3,1,0,1,12,40,1,1,0.918295834,159,5,188,4,22,20,2,584,562,22,19,19,0,0,100,NoArch
de443436bddb05696e7f6ed4e802aecd9b022f2f,0,0,0,0,0,0,0,0,0,0,0,0,0,0,0,189,5,0,0,0,0,0,0,0,0,0,0,100,NoArch
896f6e86a2086ecca1134def8f6ca76777bce2f7,0,0,0,0,0,0,0,0,0,0,0,0,0,0,0,190,6,0,0,0,0,0,0,0,0,0,0,100,NoArch
b93b5403868898776431891a97350bdd4976010a,1,8,8,0,16,0,0,0,11,220,1,1,0,1786,2,155,3,310,310,0,8970,8970,0,52,52,0,0,100,NoArch
a5e824304640a56a90a66682556d938363249484,0,0,0,0,0,0,0,0,0,0,0,0,0,0,0,93,5,0,0,0,0,0,0,0,0,0,1,100,NoArch
0a6c64d7da85ebe1857f31347cd8b05a2b7d07a0,5,5,11,6,16,0,0,0,63,39,1,2,2.099601753,297,2,94,6,16,17,1,750,792,42,9,9,0,0,100,NoArch
fdc5f9a02ff8926db8185b90cc9e850188b02ac2,0,0,0,0,0,0,0,0,0,0,0,0,0,0,0,294,14,0,0,0,0,0,0,0,0,0,0,100,NoArch
abcd9528964e0fda0b1c16b9485637b208f5f0a3,0,0,0,0,0,0,0,0,0,0,0,0,0,0,0,191,7,0,0,0,0,0,0,0,0,0,0,100,NoArch
b277a3e06eecf1e769e1cee784045d1fa98a1bf0,0,0,0,0,0,0,0,0,0,0,0,0,0,0,0,192,8,0,0,0,0,0,0,0,0,0,0,100,NoArch
9f98e7359ad05be0122d85e45dec1989fdadc561,0,0,0,0,0,0,0,0,0,0,0,0,0,0,0,295,15,0,0,0,0,0,0,0,0,0,0,100,NoArch
b2693d51b64d364950a9806d20ac211d9527a5b0,0,0,0,0,0,0,0,0,0,0,0,0,0,0,0,296,16,0,0,0,0,0,0,0,0,0,0,100,NoArch
93a09510b18fd9d93818cf41bd1617a14a7d2cd6,1,2,1,1,3,0,0,0,71,22,1,1,0,3110,10,297,16,458,457,1,16484,16466,18,120,120,0,0,100,NoArch
6ce71d53c489500e6a60946304a14d4344f70b2b,1,118,34,84,152,0,0,0,4,227,1,1,0,977,2,298,17,301,288,13,6206,5797,409,32,29,3,0,100,NoArch
a8b56813799a626903b466f9020c47e9efa67edf,1,43,65,22,108,0,0,0,5,0,1,1,0,1061,2,299,18,299,301,2,6195,6206,11,32,32,0,0,100,NoArch
650089300e8891164d633dc895fb2136951b65ea,1,1,2,1,3,0,0,0,72,3,1,1,0,3111,10,300,19,457,458,1,16473,16484,11,120,120,0,0,100,NoArch
814a2c5329373a9785dc66d9e2f1561ab425688e,1,58,0,58,58,1,0,1,1,0,1,1,0,0,1,95,5,8,0,8,264,0,264,6,0,6,1,99.93002099,NoArch
fa621a7aa574eb0199498fd6c30e8daf07413982,0,0,0,0,0,0,0,0,0,0,0,0,0,0,0,96,6,0,0,0,0,0,0,0,0,0,0,100,NoArch
60f88857f27911cb453dcbcf4d7988114b377a3a,1,1,1,0,2,0,0,0,11,467,1,1,0,494,4,97,7,72,72,0,2020,2020,0,21,21,0,0,100,NoArch
f5e82e5ccd421f8240d2ae71639ee61c16213540,2,22,10,12,32,1,0,1,26,59,1,2,0.69621226,446,7,98,8,56,56,0,1622,1603,19,26,26,0,1,100,NoArch
f5a2751dd82f7044a4468a17c87b0bf19573e4f4,1,1,1,0,2,0,0,0,9,1064,1,1,0,532,3,193,9,56,56,0,1188,1188,0,28,28,0,0,100,NoArch
19fbf14458dd641369aa054841eaa9b877e3839e,1,1,1,0,2,0,0,0,5,17,1,1,0,101,1,99,9,10,10,0,483,483,0,5,5,0,0,100,NoArch
42f52c0f7ae172f782d0a9d84b6158eb2c75f87c,12,154,29,125,183,6,0,6,15,596,1,2,2.818224313,3993,3,95,0,1683,1662,21,30722,30208,514,657,644,13,0,100,NoArch
0d630d24392ce542fd686657a9ba461d68af3c21,2,76,42,34,118,0,0,0,10,1134,1,1,0.549482768,476,2,194,8,53,53,0,1919,1919,0,17,17,0,0,100,NoArch
b078b6f10f68894c55f33e5a231f06b98c36337c,1,13,13,0,26,0,0,0,11,3,1,1,0,457,5,195,9,53,53,0,1892,1892,0,17,17,0,0,100,NoArch
e683e27ab34d9f90403b69639b9bb0db0d348987,0,0,0,0,0,0,0,0,0,0,0,0,0,0,0,100,8,0,0,0,0,0,0,0,0,0,0,100,NoArch
9a7ee2e2cc5af06486d1892b4ec8e5e690f0479e,1,2,79,77,81,0,0,0,12,14,1,1,0,457,5,196,5,42,53,11,1463,1892,429,17,17,0,0,100,NoArch
15bcc9eef7eff039969f76cc3675ef3f03d944bf,1,41,41,0,82,0,0,0,13,0,1,1,0,380,5,197,6,42,42,0,1463,1463,0,17,17,0,0,100,NoArch
b5f7a1934ae7cbc09b2567375539676c8e1eec26,1,21,21,0,42,0,0,0,14,0,1,1,0,380,5,198,7,42,42,0,1463,1463,0,17,17,0,0,100,NoArch
0e51c96bdf8e3bbc4e4a322f343b2174225d16fd,2,39,0,39,39,2,0,2,196,26,1,2,0.961236605,6235,17,101,6,873,869,4,23431,23355,76,431,427,4,1,99.9301188,NoArch
bda53ad6dc1a667cd32c3ff50d601fe967eab930,0,0,0,0,0,0,0,0,0,0,0,0,0,0,0,301,3,0,0,0,0,0,0,0,0,0,0,100,NoArch
deecbe7243b247e5ed0acba347fb48439a6b1cda,4,84,199,115,283,0,0,0,73,42,1,4,1.038262141,5400,2,302,4,903,919,16,26653,27145,492,224,221,3,0,99.09816164,NoArch
dea3c0e554ce613b8c2efcbbe508b86a73e25846,3,16,7,9,23,0,0,0,67,76,1,3,1.214295263,1591,2,303,2,268,268,0,8121,8118,3,101,101,0,1,100,NoArch
58fef2c501d7086dc5c626376637a6cd12d3d1de,0,0,0,0,0,0,0,0,0,0,0,0,0,0,0,304,3,0,0,0,0,0,0,0,0,0,0,100,NoArch
028af15845b48877ab12a603c88ddd3ba19391ce,8,214,333,119,547,0,0,0,74,118,1,7,1.602304665,8040,5,305,4,1410,1402,8,42323,42361,38,366,363,3,0,99.82788296,NoArch
54ff96f26803681ca3581dc3e013258393e377db,0,0,0,0,0,0,0,0,0,0,0,0,0,0,0,306,5,0,0,0,0,0,0,0,0,0,0,100,NoArch
ff5552a7c66b2194f24a7191e8692fd42b6b4fb9,2,13,2,11,15,1,0,1,75,35,1,1,0.996791632,3677,1,307,6,526,525,1,18659,18622,37,156,155,1,0,100,NoArch
e0b2bcccd360e49ff83b89da99d8d155b09e0073,1,6,2,4,8,0,0,0,8,0,1,1,0,938,2,308,7,298,297,1,5981,5964,17,34,34,0,0,100,NoArch
854e32f0ed6ab7acaadd381329f54c6dea54e9c3,1,1,1,0,2,0,0,0,76,1,1,1,0,3118,10,156,0,459,459,0,16527,16527,0,120,120,0,0,100,NoArch
53c2f0a4f386957865145bdf81e250d691298041,1,17,1,16,18,0,0,0,77,0,1,1,0,3118,10,309,8,463,459,4,16615,16527,88,121,120,1,0,100,NoArch
e8b251edf9160ffaef32ebc1f1eb4150130ed9fb,1,19,18,1,37,0,0,0,69,2,1,1,0,642,12,310,9,99,97,2,3006,2974,32,42,42,0,0,100,NoArch
2ba8410c2bb694ab36f02db3b83e73805167923b,2,11,1,10,12,1,0,1,78,4,1,1,0.918295834,3704,1,311,10,533,530,3,18822,18747,75,157,157,0,0,100,NoArch
3d0ae5fb032021f51733b14691ba3ea92f919c5f,1,7,2,5,9,0,0,0,14,7,1,1,0,779,2,312,11,164,162,2,4971,4909,62,47,47,0,0,100,NoArch
ec89363470d0aa3bba5afee627eba261dc78a91d,1,4,2,2,6,0,0,0,69,71,1,1,0,952,7,313,12,179,178,1,4544,4534,10,78,78,0,0,100,NoArch
938b77270b1071ff4f2894a675beee53055c0d50,3,26,6,20,32,0,0,0,37,142,1,2,1.247556249,1939,2,314,13,318,314,4,9409,9235,174,106,104,2,0,98.93177119,NoArch
97fe1e663379ba8ac0132b7252f91af0a6548044,7,151,167,16,318,1,0,1,79,53,1,5,1.645481966,8049,2,315,14,1365,1362,3,42271,42285,14,391,389,2,1,100,NoArch
e4ffaa0b9aef18ad81d50256d383773c3d44b9dc,1,1,1,0,2,0,0,0,80,0,1,1,0,3106,10,316,15,456,456,0,16493,16493,0,121,121,0,0,100,NoArch
e069b08eeddebf707ec51a5ed15c4c6ade31f5b8,3,14,7,7,21,0,0,0,81,0,1,2,1.441166544,3890,9,317,16,568,567,1,20692,20653,39,150,150,0,0,100,NoArch
9a39eb68bd226d98b85f2310ee6d015fd883d874,3,9,8,1,17,0,0,0,82,24,1,2,0.834347023,4266,3,318,17,682,681,1,22464,22449,15,214,214,0,1,100,NoArch
1bc19b97abef63e17949f8ec9b1d645f671c8040,1,32,5,27,37,0,0,0,38,5,1,1,0,1001,11,319,18,136,132,4,3988,3835,153,45,44,1,0,100,NoArch
740d1bc8ee263386d9ea2e53f728997d8ddb2157,1,9,0,9,9,1,0,1,17,1,1,1,0,781,2,320,19,166,164,2,5009,4953,56,47,47,0,0,100,NoArch
befa7863c985ed24a72c9f69ce42d529616be3ec,3,8,2,6,10,1,0,1,83,50,1,2,1.156779649,4238,4,321,20,658,656,2,21542,21504,38,218,218,0,0,100,NoArch
3fb2af043da35daf70dda2581b4e01d0819dc7c3,0,0,0,0,0,0,0,0,0,0,0,0,0,0,0,322,21,0,0,0,0,0,0,0,0,0,0,100,NoArch
15e7605996b8f15711f02af4df191cf31918d1a4,2,35,1,34,36,1,0,1,197,15,1,2,0.183122068,7278,17,323,22,1012,1007,5,27508,27376,132,477,474,3,0,100,NoArch
f99e5a91596a2d6a87ca402a80b357738229e09c,0,0,0,0,0,0,0,0,0,0,0,0,0,0,0,324,23,0,0,0,0,0,0,0,0,0,0,100,NoArch
ca0c14f5834fb8d8a310b99d5d8f17d9f7cb947c,1,2,1,1,3,0,0,0,13,74,1,1,0,114,6,325,24,18,17,1,480,472,8,16,16,0,0,100,NoArch
197e3e11f378213c2d3af311a242e5630735c955,1,7,5,2,12,0,0,0,70,18,1,1,0,643,12,326,25,99,99,0,3014,3006,8,42,42,0,0,100,NoArch
83de2fbe53ebcb2dbe921cac1ef16674dc3033be,1,1,1,0,2,0,0,0,10,332,1,1,0,474,5,0,0,44,44,0,1567,1563,4,21,21,0,0,100,NoArch
7d2f9ef676836507cfbadf6d09d6190d3ae34825,0,0,0,0,0,0,0,0,0,0,0,0,0,0,0,1,1,0,0,0,0,0,0,0,0,0,0,100,NoArch
cb3bf30d5a5f7e6340767231527d0364d82a810d,1,2,2,0,4,0,0,0,2,847,1,1,0,102,1,96,0,14,14,0,353,395,42,3,3,0,0,100,NoArch
07482081f3d93c67f8a0cd649d0c467fe44ad09a,1,2,1,1,3,0,0,0,9,59,1,1,0,942,2,327,5,299,298,1,5987,5981,6,34,34,0,0,100,NoArch
f73e6919d653a23682af048f28dd3c1404942589,1,21,5,16,26,0,0,0,13,67,1,1,0,1714,2,328,1,307,304,3,8907,8817,90,52,52,0,0,100,NoArch
878018b82731d0aed58fe929072fa8f38975e0a8,1,40,52,12,92,0,0,0,10,8,1,1,0,943,2,329,2,303,299,4,6051,5987,64,36,34,2,0,100,NoArch
c2ec90d6f8581e7088b92ddd696163f8d7d37bc1,0,0,0,0,0,0,0,0,0,0,0,0,0,0,0,330,3,0,0,0,0,0,0,0,0,0,0,100,NoArch
5ffeeade0afa6a1bd204d04b173fcf9e6fc7db1a,3,4,15,11,19,0,0,0,84,103,1,1,1.215533232,3930,4,331,4,624,626,2,20079,20125,46,175,176,1,0,100,NoArch
c3f6b95554a7300e022e7dc6d93270c10255c7a9,1,5,2,3,7,0,0,0,85,0,1,1,0,3112,10,332,5,459,458,1,16540,16525,15,121,121,0,0,100,NoArch
a23c89cbd57482e17ed2ef47bc0da6ac9d0ffb31,2,19,21,2,40,0,0,0,86,0,1,1,0.998195879,3762,6,333,6,607,607,0,19705,19721,16,157,157,0,0,100,NoArch
12707d32eb67d675dfe97c5b2336d99af9376974,1,13,0,13,13,1,0,1,12,63,1,1,0,202,3,334,7,49,46,3,1474,1382,92,16,15,1,0,99.01129944,NoArch
e2c144ccce02d0262b5a43471f23bb48f4fd1bf2,1,1,1,0,2,0,0,0,13,0,1,1,0,215,3,335,8,49,49,0,1474,1474,0,16,16,0,0,100,NoArch
e2b19e366f2ea38729168ac2a3a51d5b3bb02f8e,0,0,0,0,0,0,0,0,0,0,0,0,0,0,0,336,9,0,0,0,0,0,0,0,0,0,0,100,NoArch
ac448b39ce8efd6a8708c12d3973c879f9995b2c,1,6,0,6,6,1,0,1,87,2,1,1,0,3112,10,337,10,459,459,0,16547,16527,20,121,121,0,0,100,NoArch
594ad875b3d7e5de9b8e33e45f4d3b5f93c4ffd1,0,0,0,0,0,0,0,0,0,0,0,0,0,0,0,338,11,0,0,0,0,0,0,0,0,0,0,100,NoArch
875117355ca24dbcc678b0d1c002b585bbf9376d,2,47,34,13,81,0,0,0,18,31,1,2,0.539216343,1005,2,339,12,223,215,8,6591,6483,108,65,63,2,0,100,NoArch
6b8e71e72511c2f12106ae1245fa7a1443385bfd,1,16,49,33,65,0,0,0,88,0,1,1,0,3118,10,340,13,455,459,4,16385,16547,162,120,121,1,0,100,NoArch
616cdd8f77dffaf431b71241be35a54a594f8072,0,0,0,0,0,0,0,0,0,0,0,0,0,0,0,341,14,0,0,0,0,0,0,0,0,0,0,100,NoArch
ec385d3d32f8fe8b466dc22c91c5e72b4dd8bd5f,1,1,0,1,1,1,0,1,71,57,1,1,0,645,12,342,15,100,99,1,3027,3014,13,42,42,0,0,100,NoArch
621e62f281d1747d7625fc2f3c8511206a594018,0,0,0,0,0,0,0,0,0,0,0,0,0,0,0,2,0,0,0,0,0,0,0,0,0,0,0,100,NoArch
8976032fce3bff693f72047a9db2a1e0b9c64321,0,0,0,0,0,0,0,0,0,0,0,0,0,0,0,3,1,0,0,0,0,0,0,0,0,0,0,100,NoArch
c13994ea07956717a1f3c8b2def273896c5430c4,2,5,4,1,9,0,0,0,40,31,1,2,0.764204507,1244,11,343,16,188,187,1,5475,5473,2,61,61,0,0,100,NoArch
1cf3618e6fb18efbcf14fdbb55a6c70ffa056cee,1,39,9,30,48,0,0,0,198,75,1,1,0,6285,18,4,2,883,876,7,23657,23533,124,432,432,0,0,100,NoArch
8b82de8d3fc4e560b0b42fa9e71c1bf03af67c2f,1,2,2,0,4,0,0,0,6,900,1,1,0,373,2,199,0,55,55,0,1231,1231,0,25,25,0,0,100,NoArch
9702d4e1b454431fe36a90b31f579a7475f0ab4d,1,236,10,226,246,0,0,0,5,909,1,1,0,163,3,200,1,53,18,35,1640,617,1023,18,8,10,0,100,NoArch
c7f166c8667836098e1b5d24208dcf93c2f4669c,3,1164,934,230,2098,0,0,0,19,1561,1,1,0.889624669,3633,4,201,2,361,278,83,9603,7277,2326,272,202,70,1,100,NoArch
ecea3eab3adb29b1226622d70a6ab4b3e65f3e46,0,0,0,0,0,0,0,0,0,0,0,0,0,0,0,202,3,0,0,0,0,0,0,0,0,0,0,100,NoArch
37214a748e7e6987f4f54707f043b358c494fb1b,1,24,21,3,45,0,0,0,31,809,1,1,0,540,10,203,4,66,64,2,1973,1933,40,22,21,1,0,100,NoArch
8ccee67efebdbc2d50319bfc70addf0e62aa13f0,6,98,0,98,98,6,0,6,1,0,1,1,2.435789124,0,1,204,5,3,0,3,184,0,184,2,0,2,1,98.25538233,NoArch
58b125f76250754a49789546ba907d2868e82393,3,181,5,176,186,1,0,1,199,954,1,3,1.371201089,6625,2,157,0,932,910,22,25677,24821,856,466,447,19,0,99.42987457,NoArch
b1418402dbf5410f0a67ae98ec4d23184811cb6a,2,26,2,24,28,1,0,1,200,297,1,2,0.591672779,6558,3,158,1,922,918,4,25162,25046,116,455,454,1,1,100,NoArch
289905878850e1b3f22372ce45e245f0fff3098f,1,251,219,32,470,0,0,0,6,24,1,1,0,389,3,205,6,54,53,1,1690,1640,50,19,18,1,0,100,NoArch
e411ac6454e5e07c4b2baf6cc040309b0b9dd14f,1,0,4,4,4,0,0,0,14,90,1,1,0,1730,2,159,2,306,307,1,8894,8907,13,52,52,0,0,100,NoArch
4c6c59a1087dd38365a8f53bac6680df2aa57821,2,8,2,6,10,0,0,0,201,422,1,1,1,7353,5,102,0,1026,1024,2,26875,26848,27,519,519,0,1,100,NoArch
7ba32a5232b5d8e44bafacd27386c860354115dc,1,139,0,139,139,1,0,1,20,153,1,1,0,1123,5,344,0,201,192,9,5974,5542,432,122,119,3,0,100,NoArch
6fcc7414f138ccaf07937404d6ff19d48af1a6d7,6,371,348,23,719,0,0,0,72,491,1,1,1.469529878,3662,7,345,1,571,574,3,16283,16922,639,201,194,7,0,100,NoArch
f1e735b1ad6666f87b755d1f038c12d03a74ba75,8,213,222,9,435,0,0,0,89,390,1,5,0.88942024,6225,2,346,2,843,837,6,28026,27877,149,267,262,5,0,99.81060606,NoArch
53abdbd7d1ec724f421f92b026b29d88a72dc6b2,6,88,6,82,94,1,0,1,13,715,1,4,0.768597785,462,2,347,3,28,23,5,2027,1912,115,19,16,3,0,99.92424242,NoArch
50dd3c59a000cbee60905c0f38f2f51a3a34f006,1,0,3,3,3,0,0,0,73,3,1,1,0,802,12,348,4,120,121,1,3135,3154,19,58,59,1,0,100,NoArch
46095cbb0cef6d11b67e8a4b7cab56acafd55dbc,1,0,0,0,0,1,0,1,1,0,1,1,0,0,1,160,0,0,0,0,0,0,0,0,0,0,0,99.92435703,NoArch
7f521fead701974b83222e28c918af93b21449a4,1,41,0,41,41,1,0,1,202,17,1,1,0,6444,18,161,1,904,900,4,24210,24044,166,446,442,4,0,100,NoArch
e64aec47d1adec547e0b0b18fbcf23c0e2ffd4fb,1,3,2,1,5,0,0,0,21,936,1,1,0,510,7,349,5,43,43,0,1198,1198,0,10,10,0,0,100,NoArch
3b74136133e16e993c80270823afc4e21938737b,1,0,2,2,2,0,0,0,7,280,1,1,0,578,1,350,6,70,70,0,2190,2201,11,36,36,0,0,100,NoArch
f129925dfcbcb58fd1cff04eef9c2f97f636b2f8,11,109,119,10,228,1,0,1,74,310,1,4,2.379812847,5778,2,351,7,896,907,11,25284,25482,198,297,299,2,0,99.73544974,NoArch
3a9aea40e1f66f51ab6e9014d7c2862433c969a9,0,0,0,0,0,0,0,0,0,0,0,0,0,0,0,352,8,0,0,0,0,0,0,0,0,0,0,100,NoArch
09320ae12ecb4feca6ab0c6876d956ebd8d03d18,0,0,0,0,0,0,0,0,0,0,0,0,0,0,0,353,9,0,0,0,0,0,0,0,0,0,0,100,NoArch
9c6c90fedb76bd0c5eb760739be1eb93d167bc45,0,0,0,0,0,0,0,0,0,0,0,0,0,0,0,162,2,0,0,0,0,0,0,0,0,0,0,100,NoArch
f94364a81723da0aa18b5cfa43f60fcbad1a0850,0,0,0,0,0,0,0,0,0,0,0,0,0,0,0,163,3,0,0,0,0,0,0,0,0,0,0,100,NoArch
20b0cb5bbca92cd7424ce44b4229ff1e009cbd38,1,7,6,1,13,0,0,0,68,275,1,1,0,2204,7,354,10,425,425,0,11417,11414,3,96,96,0,0,100,NoArch
61c1bf1bc469dab5ca923b87aea581692b3ec465,4,146,361,215,507,2,0,2,12,1575,1,3,0.421580321,687,2,103,1,42,89,47,1621,2538,917,33,36,3,2,100,NoArch
afc40d67c2fbe2dc1140fb0d73cd5034d9bb298a,0,0,0,0,0,0,0,0,0,0,0,0,0,0,0,164,4,0,0,0,0,0,0,0,0,0,0,100,NoArch
f907134061c3abec42ca4747debf01e2723cd7d2,3,31,14,17,45,1,0,1,203,436,1,2,1.214508943,6890,3,104,2,951,950,1,25702,25562,140,491,490,1,1,100,NoArch
5f9f35fff749c54fdc9a352eb271d57c11fb3d33,1,7,211,204,218,0,0,0,6,0,1,1,0,286,3,105,3,5,42,37,192,794,602,3,40,37,1,100,NoArch
5929e0a3f8d214c01494109b91fdf525ad29a2d0,0,0,0,0,0,0,0,0,0,0,0,0,0,0,0,165,5,0,0,0,0,0,0,0,0,0,0,100,NoArch
b3338f138adb793c447ad61b3526f8894aecca90,1,24,24,0,48,0,0,0,7,0,1,1,0,139,3,106,4,5,5,0,683,682,1,5,5,0,1,100,NoArch
4e3002187ffb2179dd5b8784b2c7ca9fb13a2082,2,113,1,112,114,1,0,1,88,318,1,1,0.175565026,1233,1,5,0,250,242,8,6579,6431,148,53,46,7,0,99.88670695,NoArch
93243d82abccefd069e2bac590f6a161f8724c43,1,3,0,3,3,1,0,1,3,800,1,1,0,155,2,355,6,14,13,1,382,366,16,6,6,0,0,100,NoArch
76476311207351f4ade938cff4e00e11dc5a0009,1,30,80,50,110,0,0,0,11,47,1,1,0,220,2,356,7,14,21,7,323,502,179,7,12,5,0,100,NoArch
1401f8316ee3ac1afe4a0d0bdf15951491d1ae9c,2,2,2,0,4,0,0,0,12,0,1,2,1,328,2,357,8,28,28,0,705,705,0,13,13,0,0,100,NoArch
09803ac80f101d96d8796b0409701ece55513fed,0,0,0,0,0,0,0,0,0,0,0,0,0,0,0,358,9,0,0,0,0,0,0,0,0,0,0,100,NoArch
996917d39fdcd34fe421f59a8ab4905460ffb2c3,2,28,3,25,31,1,0,1,31,424,1,1,0.205592508,506,6,359,10,75,72,3,2178,1993,185,42,42,0,0,100,NoArch
0fe2890ea06cd2fca13a903092e3d2f98c71f532,1,9,2,7,11,0,0,0,75,27,1,1,0,839,12,360,11,119,118,1,3152,3133,19,59,58,1,0,100,NoArch
36f9c8fe50b39a6690273702ad31aa6acad54ba1,3,12,1,11,13,2,0,2,20,171,1,3,1.57662122,1389,2,361,12,271,268,3,7970,7892,78,87,86,1,0,100,NoArch
b3a49db6f9dc849f8735417f4bda02212ac1c903,5,64,29,35,93,0,0,0,69,363,1,4,2.125870585,3742,2,362,13,679,675,4,18817,18599,218,192,190,2,0,99.96229261,NoArch
33b3e04c78049f800c3330442b04ae0859b1400e,1,4,0,4,4,1,0,1,89,6,1,1,0,1234,10,363,14,244,242,2,6465,6428,37,46,46,0,0,100,NoArch
07d95548d62dd2dd0bd0a38e5639b7f46de15b61,1,5,0,5,5,1,0,1,7,1,1,1,0,86,3,364,15,7,6,1,140,126,14,5,4,1,0,100,NoArch
f3b06372718c95dc5aac2a6f93e8f09cf6e50d44,1,70,5,65,75,0,0,0,11,1036,1,1,0,268,5,6,1,52,44,8,1056,913,143,19,16,3,1,100,NoArch
6864e67d06c45b080932a1ee884cbfd7bfe35873,0,0,0,0,0,0,0,0,0,0,0,0,0,0,0,365,16,0,0,0,0,0,0,0,0,0,0,100,NoArch
a0e548e9e8d189fcf108f7bc5e096578a647ccaa,1,29,3,26,32,0,0,0,32,218,1,1,0,543,11,0,0,68,66,2,2032,1973,59,23,22,1,1,100,NoArch
3630e61aad81ca634e8642928dfb85ef326cc50d,0,0,0,0,0,0,0,0,0,0,0,0,0,0,0,1,1,0,0,0,0,0,0,0,0,0,1,100,NoArch
b17bbec99ce99dc80778bced8b170cc515a59762,7,496,16,480,512,4,0,4,143,117,1,2,1.978063256,1983,1,166,1,354,332,22,11197,9819,1378,100,81,19,0,99.62462462,NoArch
5f411b3ed9213af1da94e6032ee2f5e90cbf3cd6,11,230,3,227,233,8,0,8,2,0,1,1,3.215502887,464,1,167,1,29,19,10,1636,1298,338,28,19,9,0,99.47916667,NoArch
0f23ebf63090839a2dcad0d792823527f93fe23a,1,11,0,11,11,1,0,1,3,0,1,1,0,82,1,168,2,9,8,1,249,215,34,8,8,0,0,99.8515219,NoArch
25e99927e4cfdda673cc59e83436c7a8a81fa8aa,0,0,0,0,0,0,0,0,0,0,0,0,0,0,0,366,11,0,0,0,0,0,0,0,0,0,0,100,NoArch
85ef958e6d7bc7adc1b370267c984507abe9fe36,2,11,1,10,12,1,0,1,76,36,1,1,0.650022422,999,6,367,12,140,138,2,3920,3881,39,70,68,2,0,100,NoArch
0b124468365ac4d1827088829fb44ee91275449b,2,28,1,27,29,1,0,1,90,166,1,1,0.362051252,3732,6,368,13,608,603,5,19654,19552,102,157,156,1,0,100,NoArch
e0d3655e1e4d0ac6b5db7369713a3283dbe69d68,0,0,0,0,0,0,0,0,0,0,0,0,0,0,0,369,14,0,0,0,0,0,0,0,0,0,0,100,NoArch
cb3df6cd5b006333115025dcf61d121a35411e2e,1,7,2,5,9,0,0,0,18,6,1,1,0,1700,2,370,15,305,301,4,8787,8725,62,50,50,0,0,100,NoArch
c13b52205517fd301697e3dbf844df858eb425c9,1,11,7,4,18,0,0,0,30,6,1,1,0,675,6,371,16,154,153,1,3303,3279,24,37,37,0,0,100,NoArch
e72904a5a516f97fdfed14e1c38d78d66c6bd015,5,43,26,17,69,2,0,2,73,235,1,4,2.191877519,4846,2,372,17,916,911,5,26302,26185,117,272,269,3,0,100,NoArch
c962680a5c4c6b5f3f90bc08e4b8644c3f0213b5,0,0,0,0,0,0,0,0,0,0,0,0,0,0,0,373,18,0,0,0,0,0,0,0,0,0,0,100,NoArch
ebdea1112f7424fb7aff8a6466a3bdcdc1813a1e,1,50,5,45,55,0,0,0,204,54,1,1,0,6482,18,169,3,910,904,6,24347,24226,121,448,446,2,0,100,NoArch
3068192eb67a1bef9f7951d10a41687462c7521f,1,14,40,26,54,0,0,0,205,0,1,1,0,6527,18,170,4,908,910,2,24282,24347,65,446,448,2,0,100,NoArch
320c1c7f61824009cb03948681dec4765fc9189a,1,0,3,3,3,0,0,0,13,38,1,1,0,170,2,374,19,14,14,0,298,323,25,7,7,0,0,100,NoArch
a00b5d6e1fc283eba838e49d8c3af7a23d877684,0,0,0,0,0,0,0,0,0,0,0,0,0,0,0,375,20,0,0,0,0,0,0,0,0,0,0,100,NoArch
9b6fddc28f347a3bd50839deb0907d86d82919b2,0,0,0,0,0,0,0,0,0,0,0,0,0,0,0,376,21,0,0,0,0,0,0,0,0,0,0,100,NoArch
e45c43d5634bb26b6edc97b5e70fdf34213bfa04,1,2,2,0,4,0,0,0,74,34,1,1,0,969,7,377,11,182,182,0,4635,4635,0,80,80,0,0,100,NoArch
c4f6e136108e195220f0f1b34ed03c7dea5e1c64,1,16,10,6,26,0,0,0,19,35,1,1,0,1705,2,378,12,306,305,1,8818,8787,31,51,50,1,0,100,NoArch
956004bf37163a2473dc9d75888d03a91f6ea64e,3,9,1,8,10,2,0,2,28,1013,1,2,1.485475297,923,3,379,13,61,59,2,2156,2107,49,55,53,2,0,99.85174203,NoArch
2ceb1238371b911aac7b032a38fd924badb4091e,2,41,316,275,357,0,0,0,91,76,1,2,0.591672779,3999,6,380,14,588,581,7,19406,19206,200,202,197,5,0,99.96309963,NoArch
0fb96cd1aab742ca7395b613203b01f5d31ccc7e,11,189,486,297,675,0,0,0,92,403,1,7,2.364547589,10153,2,381,7,1687,1674,13,51987,51670,317,470,477,7,0,97.46401645,Arch
5423f5730f3fe3abd893cb577124f2312b762f4e,0,0,0,0,0,0,0,0,0,0,0,0,0,0,0,382,8,0,0,0,0,0,0,0,0,0,0,100,NoArch
0794113561901f4512f02140c09fc13f63199379,2,4,2,2,6,0,0,0,21,64,1,2,0.918295834,1793,1,383,9,311,311,0,8956,8941,15,54,54,0,0,100,NoArch
034e4640e994b8503ea5c39eea45ccd76777d76c,1,1,1,0,2,0,0,0,4,471,1,1,0,169,1,171,0,18,18,0,528,526,2,14,14,0,0,100,NoArch
8b0e93a7dcc92f4e9b3d5a2dbbee22f98e28378c,3,139,19,120,158,1,0,1,2,562,1,1,1.236184934,182,1,172,1,31,17,14,1037,570,467,23,11,12,0,99.80824545,NoArch
225d9f2097f4a2ae986c53382d363deea24afade,3,11,2,9,13,1,0,1,16,435,1,2,1.295737801,1040,3,97,0,276,273,3,5282,5233,49,158,156,2,0,100,NoArch
73e0aee0d51efb46a03e2b3c3119eaf404c97646,4,22,7,15,29,0,0,0,17,110,1,2,1.69135017,1526,3,98,1,539,534,5,10036,9973,63,190,186,4,0,100,NoArch
1d02d917ef7e08c0e617a69159856a84007aac70,1,32,2,30,34,0,0,0,3,479,1,1,0,62,1,173,2,7,4,3,305,169,136,3,2,1,0,99.93630573,NoArch
229c9e65fd0f72e041c67ba8a5c3d95dbe2e78d9,4,79,9,70,88,0,0,0,18,0,1,2,1.804242359,1541,3,99,2,557,539,18,10403,10036,367,195,190,5,0,100,NoArch
9c50b4f3eb9e5a8a2b90d4b26caa2722da6f44ca,0,0,0,0,0,0,0,0,0,0,0,0,0,0,0,174,3,0,0,0,0,0,0,0,0,0,0,100,NoArch
bf1d08069d6d2da409b3eff61fd2ecd72709900f,2,8,8,0,16,0,0,0,77,101,1,2,0.543564443,1419,4,206,0,182,182,0,4501,4501,0,93,93,0,0,100,NoArch
948f39deeb2c6f83041df53a16a9838031ba8db7,2,35,2,33,37,1,0,1,19,10,1,2,0.800392208,911,3,100,3,232,226,6,4977,4843,134,165,162,3,0,100,NoArch
ec4bb1d0abf03bce6fb297ded29f86d8b766377a,5,82,9,73,91,1,0,1,20,100,1,2,1.984893443,1902,3,101,4,580,563,17,13187,12784,403,210,198,12,0,100,NoArch
368c66a5af6079a56ba1abc14225a4c23cfa4eef,3,119,28,91,147,1,0,1,93,88,1,2,0.699066527,4728,11,384,3,766,746,20,24305,23764,541,211,205,6,0,100,NoArch
71dcb6d75aaf9c53dc4b05ab0965a5dc54cff95e,1,4,5,1,9,0,0,0,94,0,1,1,0,3154,10,385,2,470,469,1,16907,16895,12,128,128,0,0,100,NoArch
e49f2d5518f472899ebe1c4e3238a1cecf227bdd,3,79,8,71,87,0,0,0,21,0,1,2,1.439868363,1192,3,102,5,333,312,21,6366,5987,379,193,179,14,0,100,NoArch
b6247fb4bda84a4ef45fbaa0448a1cc33a1c8a3a,3,35,1,34,36,2,0,2,22,0,1,2,1.328469066,1263,3,103,6,339,333,6,6474,6366,108,197,193,4,0,100,NoArch
62d4fb2e1d5b58efbaa8803503f7cfefbc6d91ca,1,1,1,0,2,0,0,0,75,54,1,1,0,969,7,386,3,182,182,0,4635,4635,0,80,80,0,0,100,NoArch
466d3de5c6dc591d91d7150954a7cb32e805112b,4,178,27,151,205,3,0,3,95,23,1,3,1.16577457,6201,6,387,4,1082,1069,13,33031,32086,945,300,296,4,0,99.90473166,NoArch
54f0bc4fa7772f0d905fecd0e96c95d99dc79a91,0,0,0,0,0,0,0,0,0,0,0,0,0,0,0,388,4,0,0,0,0,0,0,0,0,0,0,100,NoArch
dd4d6938abde10aed81d608637091a8ea4ef816f,1,8,0,8,8,1,0,1,24,45,1,1,0,825,2,389,5,181,179,2,5419,5367,52,49,49,0,0,100,NoArch
40c30193843eceedf968f9decda1843bd9d9e935,1,13,5,8,18,0,0,0,25,1,1,1,0,833,2,390,6,184,181,3,5449,5419,30,49,49,0,0,100,NoArch
e4854301883ebcb99b7102d984dfdea93a64a27e,0,0,0,0,0,0,0,0,0,0,0,0,0,0,0,391,7,0,0,0,0,0,0,0,0,0,0,100,NoArch
d2f90a29d5c847e1d653be1eb95205ddfad08243,2,37,95,58,132,0,0,0,96,25,1,1,0.064254625,3928,9,392,8,565,573,8,21058,21348,290,149,149,0,0,100,NoArch
da98d3c37a6422706a4f7bbcde0c9e1a6c982b22,3,65,2,63,67,2,0,2,23,9,1,2,1.218328309,1297,3,104,7,358,339,19,6824,6474,350,212,197,15,0,100,NoArch
f9584eacbdb7b988e403c20e9fe91f37d45c8ff6,0,0,0,0,0,0,0,0,0,0,0,0,0,0,0,207,1,0,0,0,0,0,0,0,0,0,0,100,NoArch
de228da091f4328f93a7b477cd2c6ccc77c04b16,2,25,1,24,26,1,0,1,24,8,1,2,0.98285869,1143,3,105,6,281,277,4,6150,6002,148,212,208,4,0,100,NoArch
2f03950aa7548e9820a77e683ab085792af92515,2,29,9,20,38,0,0,0,25,0,1,2,0.926819064,1167,3,106,7,285,281,4,6280,6150,130,214,212,2,0,100,NoArch
b5dca6f34a523c0409c4129f60d22f6ced710a08,1,54,17,37,71,0,0,0,12,137,1,1,0,333,5,208,2,53,52,1,1130,1056,74,19,19,0,1,100,NoArch
926357dc5da69095d4d99fadaf689c675a4771bc,3,42,1,41,43,2,0,2,26,3,1,2,1.102985711,1404,3,107,7,379,366,13,7358,7102,256,226,218,8,0,100,NoArch
f42d716b7df46b87c771f9b0ae9f34ecdd2de38f,1,1,1,0,2,0,0,0,18,506,1,1,0,40,8,209,3,1,1,0,46,46,0,1,1,0,1,100,NoArch
4a0498513122f3221e08c501b8cb67f566765efa,1,1,1,0,2,0,0,0,33,122,1,1,0,569,11,210,4,68,68,0,2032,2032,0,23,23,0,1,100,NoArch
007d5614d19709e560238d1786dd275f812ff04e,1,1,13,12,14,0,0,0,90,139,1,1,0,1238,10,211,5,243,244,1,6411,6465,54,46,46,0,1,100,NoArch
267f6e31f384757909a7e74b53e731b5b6576a7d,1,3,22,19,25,0,0,0,13,0,1,1,0,370,5,212,6,51,53,2,1087,1130,43,18,19,1,0,100,NoArch
167d5974d56da607b2b214cd6ea6edea787fc867,0,0,0,0,0,0,0,0,0,0,0,0,0,0,0,213,7,0,0,0,0,0,0,0,0,0,0,100,NoArch
f0adebf32c44b1f68edc83b6c5399d42d4262623,1,124,9,115,133,0,0,0,91,8,1,1,0,1226,10,7,0,260,243,17,6849,6411,438,47,46,1,0,100,NoArch
63fa0e5d02d2efe3191ce0b400e2d6e9670dea61,0,0,0,0,0,0,0,0,0,0,0,0,0,0,0,8,1,0,0,0,0,0,0,0,0,0,0,100,NoArch
c06b52e69769e60cea8accf03e32da26d0c1a639,3,33,2,31,35,1,0,1,27,15,1,2,1.14888354,1445,3,108,6,385,379,6,7517,7358,159,230,226,4,0,100,NoArch
d691c9a163ba4bd9aed60cfb3951c0d5933d6cdb,1,3,0,3,3,1,0,1,92,14,1,1,0,1341,10,393,3,261,260,1,6862,6849,13,47,47,0,0,100,NoArch
a882b241153430064387b9d4c4b4922776a1a980,0,0,0,0,0,0,0,0,0,0,0,0,0,0,0,28,0,0,0,0,0,0,0,0,0,0,0,100,NoArch
cb33b493946d05d3bd2eec5449d19144f13f979e,2,23,3,20,26,0,0,0,93,1025,1,2,0.89049164,1519,4,107,0,276,274,2,7772,7615,157,58,58,0,1,100,NoArch
aa5b5b16532e1c20d565229c6b5addab89db82f4,4,90,9,81,99,1,0,1,206,220,1,3,1.456917227,10499,6,394,1,1544,1521,23,45407,44946,461,674,667,7,0,100,NoArch
c63e8b844116f4153daaf02d681b4f5cede0e9c5,0,0,0,0,0,0,0,0,0,0,0,0,0,0,0,29,1,0,0,0,0,0,0,0,0,0,1,100,NoArch
ceac78856e8840a297c1ec59e019ca4315dc4e10,0,0,0,0,0,0,0,0,0,0,0,0,0,0,0,30,2,0,0,0,0,0,0,0,0,0,0,100,NoArch
eb1581d5a18aca35756b09052df5fb438c5a10bb,1,0,2,2,2,0,0,0,207,7,1,1,0,6562,18,395,2,927,928,1,24628,24645,17,451,451,0,0,100,NoArch
9e572f0c977058f7ed4fcedb46a6cd8897b87890,0,0,0,0,0,0,0,0,0,0,0,0,0,0,0,31,3,0,0,0,0,0,0,0,0,0,0,100,NoArch
5a74ac360c4820d09268215fb624a9954b2b17da,0,0,0,0,0,0,0,0,0,0,0,0,0,0,0,32,4,0,0,0,0,0,0,0,0,0,0,100,NoArch
10eba81d240b561cf472e2d9f5638e3f7a14b64c,1,2,2,0,4,0,0,0,13,368,1,1,0,141,4,214,0,23,23,0,1134,1132,2,13,13,0,0,100,NoArch
02d8c7e8ef9f78aa7052d842495f108e39dbddf8,1,14,7,7,21,0,0,0,3,392,1,1,0,124,1,215,1,14,12,2,308,280,28,4,4,0,1,100,NoArch
6a50264d03bb26111a4b8dde4ff9d7559bef0c4d,1,66,3,63,69,0,0,0,4,0,1,1,0,131,1,216,2,29,14,15,534,308,226,18,4,14,1,100,NoArch
b6f916339c7b7377f0b2b2ab79352a5999efd955,1,1,1,0,2,0,0,0,4,180,1,1,0,195,2,175,0,27,27,0,622,624,2,27,27,0,0,100,NoArch
323323aea19bb834a0f563b0dd438bfef4dae84a,2,10,0,10,10,2,0,2,3,112,1,1,1,239,1,176,1,29,27,2,902,868,34,23,21,2,1,100,NoArch
4dd4ba7fd523d03d4ef9d336a9c04e49cabd7980,3,12,4,8,16,0,0,0,98,77,1,2,1.5,4558,2,396,3,744,742,2,25496,25457,39,203,203,0,0,100,NoArch
06346709fdc48b74b26379b8e8645b74266930df,2,24,1,23,25,1,0,1,28,46,1,2,0.904381458,1256,3,109,0,307,301,6,6819,6680,139,231,226,5,0,100,NoArch
e21ed8ac11f3362b0fcf862110d11693984f6aed,1,4,3,1,7,0,0,0,99,17,1,1,0,3256,10,397,3,475,475,0,17460,17462,2,130,130,0,0,100,NoArch
86f31c074b8724bda8194394c445d673ec751592,0,0,0,0,0,0,0,0,0,0,0,0,0,0,0,398,4,0,0,0,0,0,0,0,0,0,0,100,NoArch
a2429820a0eed0b87c9f1056b6a8995c9fde6801,0,0,0,0,0,0,0,0,0,0,0,0,0,0,0,399,5,0,0,0,0,0,0,0,0,0,0,100,NoArch
f8fe8a2165511062f9fed9fbb28116baa6e0d294,2,19,1,18,20,1,0,1,100,332,1,1,0.468995594,3390,5,400,6,491,488,3,18044,17906,138,139,138,1,0,100,NoArch
78ca80a6a0f7a6d67ca6dbd5582dc52f89b4d976,1,2,2,0,4,0,0,0,101,0,1,1,0,3257,10,401,7,475,475,0,17454,17458,4,130,130,0,0,100,NoArch
d5401a467eabe32426447cd174ec329948a88b3c,1,1,1,0,2,0,0,0,102,0,1,1,0,3257,10,402,8,475,475,0,17452,17454,2,130,130,0,0,100,NoArch
45c08cb00d7879b5e4f57e3fd4fd205f19175403,2,171,161,10,332,1,0,1,11,256,1,2,0.796639467,474,1,0,0,50,44,6,1882,1567,315,24,21,3,1,99.93654822,NoArch
bcd3942bb90b9aff3b7f9661e08fe0d92a82fd7a,52,28,114,86,142,0,0,0,94,791,1,19,5.239201479,21250,4,1,1,3411,3411,0,85102,85212,110,1488,1488,0,0,99.55513187,NoArch
b31e096358e810a9c8c531a0c3eb2e60ee9c8df0,1,7,1,6,8,0,0,0,24,22,1,1,0,1754,3,403,6,316,314,2,9217,9161,56,52,52,0,0,100,NoArch
69dd3ab01df0c37cc86de13f53be6231e8a92cad,1,7,6,1,13,0,0,0,14,58,1,1,0,141,5,404,7,23,23,0,1130,1134,4,13,13,0,0,100,NoArch
9dd69da01eb7ee28ff2bd84455b4883ac0e4e213,2,2,2,0,4,0,0,0,12,188,1,1,1,362,5,405,2,46,46,0,1016,1008,8,42,42,0,0,100,NoArch
02686db48d8df56f3a6692681c9096a3ce1c8650,1,1,1,0,2,0,0,0,10,44,1,1,0,353,6,177,0,81,80,1,2137,2133,4,9,9,0,1,100,NoArch
88c06a350b27952ccb5c5bf3cbc41ebfc66ee3a3,1,6,2,4,8,0,0,0,22,64,1,1,0,1258,6,217,0,203,201,2,6004,5974,30,122,122,0,1,100,NoArch
486786204109100eef7e8604ffbedd6bca5dcc3b,1,11,3,8,14,0,0,0,13,317,1,1,0,270,5,9,0,26,25,1,1070,1027,43,18,18,0,0,100,NoArch
e49e7c050b5e4dc306be2dff013e6daab885b238,0,0,0,0,0,0,0,0,0,0,0,0,0,0,0,406,1,0,0,0,0,0,0,0,0,0,0,100,NoArch
de1983928186a43c95e9c6b052bdf74aaf4ad052,1,5,3,2,8,0,0,0,208,105,1,1,0,6560,18,178,1,927,927,0,24643,24628,15,451,451,0,0,100,NoArch
21f5f3f25cb9d1d807f2c7699be6ecf064727fce,2,5,1,4,6,1,0,1,14,159,1,2,0.918295834,328,3,10,1,34,33,1,1335,1325,10,24,23,1,0,100,NoArch
f3994c0d9a4eb61ef10343ddd4f182e47a299c5c,1,16,0,16,16,1,0,1,209,12,1,1,0,6562,18,218,1,930,927,3,24761,24643,118,452,451,1,1,100,NoArch
ca96248541b81850ac5c553b9cc101c036c83bd5,2,8,2,6,10,0,0,0,15,49,1,2,0.721928095,682,6,219,2,68,67,1,2646,2620,26,35,34,1,1,100,NoArch
f1b7e1658c91201fa6b63466774f28822a43569b,1,449,222,227,671,0,0,0,210,3,1,1,0,6578,18,11,2,958,930,28,25650,24761,889,452,452,0,1,100,NoArch
3c7119c48ade95483ce303bd8384f05a12e50cb8,1,21,2,19,23,0,0,0,26,357,1,1,0,463,7,220,3,51,49,2,2055,1958,97,12,12,0,1,100,NoArch
d2ceb34ca779f64d449b110f1e4c5a4c5e760e9b,1,5,0,5,5,1,0,1,27,0,1,1,0,482,7,221,4,51,51,0,2104,2055,49,12,12,0,1,100,NoArch
617964e1aad9aa4223bdd7c303f6c42b6f5eafbf,1,0,0,0,0,1,0,1,2,376,1,1,0,0,2,407,0,0,0,0,0,0,0,0,0,0,0,99.93626514,NoArch
f46ddc7e1294c97fec7260029599c7209fb9caa6,0,0,0,0,0,0,0,0,0,0,0,0,0,0,0,0,0,0,0,0,0,0,0,0,0,0,1,100,NoArch
2024298f6abce3ecb48c7b5172780bfdcbab8b61,47,2640,2692,52,5332,7,0,7,211,456,1,12,3.022328975,24666,1,408,1,4186,4173,13,113832,112848,984,1664,1670,6,0,93.72427984,Arch
76f48d963ad1f0242fc10bb2d74081eb37d97055,12,32,636,604,668,0,0,0,32,1092,1,4,2.381383679,1954,5,409,2,121,193,72,6969,8734,1765,99,147,48,0,94.4043941,Arch
e05127cb4ebd6cace591026182018cb56fe3e02f,3,65,65,0,130,1,0,1,29,131,1,2,1.309691097,2128,1,410,3,356,355,1,10511,10446,65,72,72,0,0,99.45894335,NoArch
6dd15bd448fa045acef27585e2df6d9cd6c0c9ae,1,3,5,2,8,0,0,0,5,400,1,1,0,116,2,411,4,4,4,0,353,387,34,4,4,0,0,100,NoArch
db56c0fbc47cec3a1f1dddf6a4497035d588bb99,1,1,1,0,2,0,0,0,16,588,1,1,0,217,3,412,5,52,52,0,1508,1500,8,16,16,0,0,100,NoArch
d79eed36eaabcf02cac6f87dd504f61c99a77a23,4,300,359,59,659,0,0,0,27,113,1,3,1.07269072,3007,3,413,6,612,625,13,15010,16151,1141,97,98,1,0,99.42638623,NoArch
af9f2ea56414308d9737d889c45271741f430aae,2,18,15,3,33,1,0,1,6,3276,1,2,0.918295834,447,2,0,0,68,67,1,2040,1978,62,24,23,1,1,100,NoArch
4436fc2d8b80a24f351053b203c320e5d1a5ed6b,1,50,2,48,52,0,0,0,2,2695,1,1,0,76,2,1,1,19,9,10,445,228,217,11,3,8,1,100,NoArch
a0ae861c09a4a02acf2595bdbabd1562279d6e8b,0,0,0,0,0,0,0,0,0,0,0,0,0,0,0,2,2,0,0,0,0,0,0,0,0,0,0,100,NoArch
5abd4ecd0cd98ce5c6b9278ba021f42f07e21788,2,112,53,59,165,0,0,0,7,2,1,2,0.980597441,450,2,3,3,72,68,4,2312,2040,272,27,24,3,0,100,NoArch
903df1c6920db792b4249a2f9e3e130fef8bcc20,10,435,27,408,462,5,0,5,212,13,1,5,2.740040031,10759,1,414,7,1893,1852,41,49120,47247,1873,623,602,21,0,93.81230663,Arch
a97e74e0301dd9772cc2cccc384bfc34f80602fa,1,10,9,1,19,0,0,0,29,0,1,1,0,1657,3,415,8,300,300,0,8675,8668,7,51,51,0,0,100,NoArch
4eb43ba0ca2032ea0766404c27333474d42debc0,1,75,22,53,97,0,0,0,3,3,1,1,0,124,2,4,4,35,19,16,757,445,312,18,11,7,1,100,NoArch
b318770dd4cf6907bdfb9a6d7a6df7b64090e38f,1,43,7,36,50,0,0,0,4,0,1,1,0,177,2,5,5,47,35,12,1012,757,255,21,18,3,1,100,NoArch
baed16c60d8798dc81ef74e2773bd0cc8f9ea605,2,80,51,29,131,1,0,1,7,1311,1,2,0.06466105,426,2,6,6,75,72,3,2097,1961,136,36,32,4,1,100,NoArch
a267fddafa86b6116f8324b69c274bb9ca849600,2,25,27,2,52,1,0,1,213,2,1,2,0.235193382,7243,19,7,7,1041,1043,2,27692,27769,77,488,489,1,0,100,NoArch
7c7c69d71ca04c06a3e5182870afc376bf37ee8e,1,72,7,65,79,0,0,0,6,554,1,1,0,265,1,179,0,40,33,7,1581,1202,379,22,21,1,0,100,NoArch
3c55749ae44e325e5def2c556972648b20e3838a,2,34,74,40,108,0,0,0,214,4,1,2,0.710676854,7241,19,8,8,1033,1041,8,27526,27692,166,482,488,6,0,99.92581602,NoArch
441869aa6dcb1cefc4c026b1d1882591ce314569,6,63,77,14,140,1,0,1,215,1029,1,3,1.895109381,9341,4,416,9,1356,1354,2,37300,37277,23,556,556,0,0,100,NoArch
ae633172a1c74bb54fe58534df170edc2fc66523,1,17,5,12,22,0,0,0,5,989,1,1,0,388,1,180,1,40,38,2,1442,1417,25,30,29,1,0,100,NoArch
c0044f46c67508313a6ed323608e18f85b515223,1,33,9,24,42,0,0,0,8,5,1,1,0,208,2,9,9,49,42,7,1119,1003,116,24,19,5,0,100,NoArch
a6a52471244a0b00127dc1444356f35d6d3f5ce7,0,0,0,0,0,0,0,0,0,0,0,0,0,0,0,10,10,0,0,0,0,0,0,0,0,0,0,100,NoArch
35837f7e8a714f2181ba68fc6a3b79a1afeb48dc,1,18,8,10,26,0,0,0,13,1156,1,1,0,299,6,11,11,50,48,2,1205,1155,50,22,21,1,0,100,NoArch
82a3bb63139f9adee8ec3b0a5e8a767de7398ef2,0,0,0,0,0,0,0,0,0,0,0,0,0,0,0,12,12,0,0,0,0,0,0,0,0,0,0,100,NoArch
dc7c1e3be5a7e68f63412839069f8bf24b4d260a,4,80,96,16,176,1,0,1,8,38,1,2,1.79290898,969,1,13,13,110,111,1,3639,3683,44,81,76,5,0,99.55473098,NoArch
664aeae4bd76fb61aa03778701b7f72731fa1339,1,1,1,0,2,0,0,0,2,0,1,1,0,44,1,14,14,5,5,0,208,208,0,3,3,0,0,100,NoArch
b4d286729855fb3a44876a931e9a37811f23a044,1,5,5,0,10,0,0,0,9,0,1,1,0,232,2,15,15,49,49,0,1116,1119,3,24,24,0,0,100,NoArch
625cb325c5658319edd4c920942ac48ed1daddb3,0,0,0,0,0,0,0,0,0,0,0,0,0,0,0,33,0,0,0,0,0,0,0,0,0,0,0,100,NoArch
767e10eb5c5875324e3d1ab7fca1a7cf007a05fc,3,26,0,26,26,3,0,3,30,177,1,2,1.104790937,1498,4,110,0,397,391,6,7738,7643,95,239,235,4,0,100,NoArch
ba1d80fc76737feb90b8d3ab5ff3bdcc622f2747,0,0,0,0,0,0,0,0,0,0,0,0,0,0,0,16,16,0,0,0,0,0,0,0,0,0,0,100,NoArch
c88e2000b11c844dd09ec4d7fc17b888728f0b57,0,0,0,0,0,0,0,0,0,0,0,0,0,0,0,34,1,0,0,0,0,0,0,0,0,0,0,100,NoArch
18756913584dd3d2cf96e7ecbe3d5b39cbd4af1d,1,11,3,8,14,0,0,0,10,7,1,1,0,232,2,17,17,51,49,2,1164,1116,48,25,24,1,0,100,NoArch
779f1c38f58a7fc02425ff358de34d1a256b981c,0,0,0,0,0,0,0,0,0,0,0,0,0,0,0,18,18,0,0,0,0,0,0,0,0,0,0,100,NoArch
7790220e182880953ae7fe20bb4db7b7365b2fb3,2,26,14,12,40,0,0,0,14,4,1,2,0.721928095,549,2,19,19,106,101,5,2425,2369,56,48,47,1,0,100,NoArch
d0b473f544f378693cdaee3b2b4358f46c0ec6c1,7,621,551,70,1172,1,0,1,15,385,1,4,1.910155044,1483,2,20,20,238,212,26,6455,5891,564,116,107,9,0,100,NoArch
445858c57588e9caaa6b4eca88bff516f6ca3564,0,0,0,0,0,0,0,0,0,0,0,0,0,0,0,21,21,0,0,0,0,0,0,0,0,0,0,100,NoArch
9954b83c0cfe8013ed6cc8a24039886676c07b3a,0,0,0,0,0,0,0,0,0,0,0,0,0,0,0,22,22,0,0,0,0,0,0,0,0,0,0,100,NoArch
0196bc6a28efa30d58fcf94d0b30ed7858e87068,3,48,1,47,49,2,0,2,7,143,1,3,0.489538633,90,1,23,23,12,6,6,739,503,236,7,4,3,1,99.92581602,NoArch
8ede31b25a1b7e9fa4da0e33751a0b21ea81408c,0,0,0,0,0,0,0,0,0,0,0,0,0,0,0,24,24,0,0,0,0,0,0,0,0,0,0,100,NoArch
b918c6e3290db7c19139e1f91eebd8f8b5ef9dd5,0,0,0,0,0,0,0,0,0,0,0,0,0,0,0,25,25,0,0,0,0,0,0,0,0,0,0,100,NoArch
95c5e4cdc09a82644a6c1702b71fca616be2128f,1,922,950,28,1872,0,0,0,216,22,1,1,0,6971,19,26,26,991,991,0,26517,26543,26,461,461,0,0,100,NoArch
2a63b21cb31bc541bb3c680f745c2920c6d2339c,4,173,115,58,288,0,0,0,11,2025,1,2,1.628539422,616,2,27,27,65,47,18,3112,2198,914,42,28,14,0,99.96293551,NoArch
89d1df367023f330e34c6a938bca667b9d65c167,0,0,0,0,0,0,0,0,0,0,0,0,0,0,0,1,0,0,0,0,0,0,0,0,0,0,0,100,NoArch
7f7bd98b21b4a4a5dd588d3eb27c681f7fe6e3fe,4,44,35,9,79,0,0,0,144,427,1,1,1.04809377,2101,3,181,2,349,348,1,10461,10348,113,94,93,1,0,100,NoArch
5744fc59e687317866084c58af833d5c48e8f574,4,35,44,9,79,0,0,0,145,4,1,1,1.04809377,2110,3,182,3,348,349,1,10348,10461,113,93,94,1,0,100,NoArch
cf142d5fee77ff09240d6425a05dec375544606b,0,0,0,0,0,0,0,0,0,0,0,0,0,0,0,2,1,0,0,0,0,0,0,0,0,0,0,100,NoArch
fcac7bdc160ac751b67617485e59fcc2a921ce50,2,7,2,5,9,1,0,1,77,201,1,2,0.99107606,1807,2,417,0,368,366,2,10171,10104,67,129,129,0,0,100,NoArch
6a76af98fa32ff6e736890a0824bdbb0d6409c6b,1,39,11,28,50,0,0,0,217,23,1,1,0,6943,20,3,2,994,991,3,26601,26517,84,463,461,2,0,100,NoArch
b6494e6074b42aafffdbe17bc354935e54f21d47,0,0,0,0,0,0,0,0,0,0,0,0,0,0,0,4,3,0,0,0,0,0,0,0,0,0,0,100,NoArch
606d381209432e04ae052e7f8f453137b20349b7,14,408,447,39,855,1,0,1,218,753,1,4,2.717180441,14579,2,418,1,2208,2180,28,65443,64401,1042,845,842,3,0,99.88872404,NoArch
fb69679c0009498135bc6f5c0a85a9d5582f4656,1,1,25,24,26,0,0,0,76,68,1,1,0,777,10,419,2,137,142,5,3971,4140,169,50,51,1,0,100,NoArch
3f30a452e844ee70d5ce9063964fbbb022ea6e87,2,96,30,66,126,1,0,1,31,0,1,2,0.946818832,337,1,420,3,58,44,14,1709,1411,298,28,20,8,0,99.92581602,NoArch
15e7adaef8bb9ec33e72bff799b8e281ba5cf7fb,1,21,6,15,27,0,0,0,2,2,1,1,0,80,1,421,4,19,16,3,459,375,84,10,9,1,0,100,NoArch
1b5ab8c28f25785c0b3b63acce078bc1fe89bad0,1,2,0,2,2,1,0,1,219,6,1,1,0,6874,20,5,4,985,987,2,26425,26484,59,458,459,1,0,100,NoArch
55726f942ddef875986150879576373f9ff15379,11,237,310,73,547,1,0,1,27,476,1,4,2.608113655,2327,4,28,5,335,330,5,9424,9329,95,159,155,4,0,100,NoArch
dd67ac94892da5f706d9ee7783f9790c6494b50c,4,17,9,8,26,1,0,1,78,65,1,3,1.884313528,2321,2,422,5,453,453,0,13159,13130,29,153,152,1,0,99.77736549,NoArch
fa15b77dda3f34b7a20b387713d543a570dc7aa8,7,193,145,48,338,0,0,0,147,27,1,5,1.527637539,7599,7,423,6,1311,1290,21,41124,40331,793,422,419,3,0,99.77736549,NoArch
f0f5146df80d96104af15847536e38271e2ff6d5,0,0,0,0,0,0,0,0,0,0,0,0,0,0,0,14,0,0,0,0,0,0,0,0,0,0,0,100,NoArch
d626680d0b7348bf319517520d01357f18e9bc6f,0,0,0,0,0,0,0,0,0,0,0,0,0,0,0,183,0,0,0,0,0,0,0,0,0,0,0,100,NoArch
b7b5c036d652c7853c65075d34eadae7393f0d71,4,73,23,50,96,0,0,0,148,21,1,1,1.370228494,2530,8,424,7,436,433,3,13231,13151,80,116,115,1,0,100,NoArch
01638486a10314c9c1b0474a5a76028ccad1ef70,2,14,8,6,22,0,0,0,36,18,1,2,0.684038436,1980,2,425,8,363,362,1,10839,10770,69,68,68,0,0,100,NoArch
e925c3e5677d40999659b961fb9b96c15f96e93a,1,9,2,7,11,0,0,0,20,3,1,1,0,856,7,426,9,185,183,2,4887,4842,45,92,92,0,0,100,NoArch
ced65631aa754a981dfbab8eabc07eb0533dfce6,0,0,0,0,0,0,0,0,0,0,0,0,0,0,0,427,10,0,0,0,0,0,0,0,0,0,0,100,NoArch
1db2196c547f0a46b61d5af01ddaa68ef06305df,1,9,0,9,9,1,0,1,12,231,1,1,0,227,7,29,1,28,27,1,830,813,17,11,10,1,0,100,NoArch
e626673ea0e890f4de218a02fa2fb5a64b00891b,0,0,0,0,0,0,0,0,0,0,0,0,0,0,0,30,2,0,0,0,0,0,0,0,0,0,0,100,NoArch
d2ccb6ca026e86f22339cc86c683782b209a452f,0,0,0,0,0,0,0,0,0,0,0,0,0,0,0,31,3,0,0,0,0,0,0,0,0,0,0,100,NoArch
f6812517a05faca6acce11fb6fc6f80095adb222,3,9,8,1,17,0,0,0,106,54,1,2,1.332820405,4073,7,428,11,673,673,0,21637,21622,15,185,185,0,0,100,NoArch
651159c6315a3986de417d517d9febdf42c7bd9f,0,0,0,0,0,0,0,0,0,0,0,0,0,0,0,32,4,0,0,0,0,0,0,0,0,0,0,100,NoArch
f566074c4cad343b4fda15dd9254b46b4e9825fb,1,1,0,1,1,1,0,1,107,0,1,1,0,3217,10,429,12,492,492,0,17572,17572,0,134,134,0,0,100,NoArch
35f29a1b39e13b8b2caeabb4d518d6b0efbea5dc,1,5,12,7,17,0,0,0,5,104,1,1,0,97,2,430,13,8,9,1,200,249,49,8,8,0,0,99.85179696,NoArch
5f5600f9465fa550c0aeef6844982635235fd173,1,4,0,4,4,1,0,1,4,110,1,1,0,122,3,431,10,10,9,1,195,181,14,9,8,1,0,100,NoArch
93a4533c4d845d5e697a7a583b0ea4568616e379,0,0,0,0,0,0,0,0,0,0,0,0,0,0,0,35,0,0,0,0,0,0,0,0,0,0,0,100,NoArch
85dcf1f191fa4820f119234bd431bafaee9b3f46,1,3,5,2,8,0,0,0,3,102,1,1,0,812,1,432,11,204,202,2,5190,5193,3,36,36,0,0,100,NoArch
5370c3eaa633a0d6e2213edd6501973cb5a0ed1e,1,0,1,1,1,0,0,0,6,3,1,1,0,90,2,433,12,8,8,0,193,200,7,8,8,0,0,100,NoArch
19e32b8e146712d176f16a0d9d672bd56d47d85e,1,46,58,12,104,0,0,0,37,6,1,1,0,1925,3,434,13,359,359,0,10722,10745,23,66,65,1,0,100,NoArch
9d16bf90f6d692055653e1c3005b65a26261d677,0,0,0,0,0,0,0,0,0,0,0,0,0,0,0,15,1,0,0,0,0,0,0,0,0,0,0,100,NoArch
2c22eb968f2514fa94f5e912bc3bbe2c30d1f1ca,1,3,0,3,3,1,0,1,38,1,1,1,0,1913,3,435,13,360,359,1,10742,10722,20,66,66,0,0,100,NoArch
69d8151c1b91adda69d2cfc3ad7e71d539a980b8,5,21,10,11,31,0,0,0,39,811,1,4,1.825272333,3206,5,16,2,526,524,2,16917,16872,45,102,101,1,0,100,NoArch
441387913b442bdba8c11315c9d76b9c06fb8f60,1,4,0,4,4,1,0,1,9,45,1,1,0,325,2,184,1,42,41,1,1618,1595,23,24,23,1,0,100,NoArch
f554c1fe1a32256a423f632f02bc674f5a7bd51d,1,76,58,18,134,0,0,0,9,252,1,1,0,223,4,33,4,34,28,6,1010,900,110,14,13,1,0,100,NoArch
1bd9268b090c001c727880626437be2de6c50416,19,154,356,202,510,2,0,2,220,430,1,4,2.973348122,14713,4,436,14,2452,2513,61,65553,67217,1664,920,914,6,0,99.74160207,NoArch
fb3119f83731f8a5cde1c912ce9c661a80123b02,2,1,73,72,74,0,1,1,8,916,1,1,0.179256067,185,2,437,15,8,12,4,333,409,76,4,8,4,0,99.85267035,NoArch
2f07710910aeed84296194393c7efe99b73eaf9a,6,120,79,41,199,1,0,1,221,114,1,5,1.342165036,11014,20,438,16,1753,1741,12,49331,49023,308,657,650,7,0,99.77835242,NoArch
527f17ab3809ac29f5f23f4da1b9eaecd75ad296,1,3,2,1,5,0,0,0,24,261,1,1,0,217,9,439,17,23,23,0,584,569,15,13,13,0,0,100,NoArch
bcbd3c4efe59671ad2c8a39a1b9f069c1d7a16ba,3,15,3,12,18,1,0,1,108,457,1,3,1.546631615,5570,10,440,18,946,941,5,29526,29459,67,241,240,1,0,100,NoArch
431c638b49ee11ed0b1e5c1d2b3d28302721829d,0,0,0,0,0,0,0,0,0,0,0,0,0,0,0,441,19,0,0,0,0,0,0,0,0,0,0,100,NoArch
2a96e2d1e2cac3bfb5c202f9e22a5f3dfe8fc065,3,128,38,90,166,1,0,1,222,7,1,2,1.403917677,9737,3,442,18,1665,1656,9,44285,43392,893,571,566,5,0,100,NoArch
f7d1b4708d131c992a8fa6bb4f0e0c7f2f422829,2,26,10,16,36,1,0,1,43,8,1,2,0.764204507,2173,5,443,19,405,401,4,11982,11885,97,87,86,1,0,100,NoArch
92269dc3df969d6e6ff55ad1bef585f8b95df58d,3,92,40,52,132,1,0,1,20,52,1,3,1.530926423,310,1,34,5,66,59,7,2612,2261,351,24,19,5,1,99.48867787,NoArch
bc3758378ac48fdb684c9be64c238eb290798b3b,1,12,13,1,25,0,0,0,18,149,1,1,0,349,4,444,15,74,76,2,1652,1693,41,23,22,1,0,100,NoArch
2aa70e7b8feabb5f5ded39f17ad898f62f0ad686,6,146,60,86,206,4,0,4,10,242,1,1,1.573623279,1222,4,185,1,182,165,17,5723,5264,459,97,87,10,0,100,NoArch
dae2d1f1ff6f4fe76c437d0aea413b041af0cba9,1,35,0,35,35,1,0,1,1,0,1,1,0,0,1,186,2,2,0,2,73,0,73,2,0,2,0,99.92795389,NoArch
75d3f837a3c71ed0b0300a83d7d2b8c10a47e837,1,26,15,11,41,0,0,0,11,0,1,1,0,373,2,187,3,50,48,2,1973,1897,76,25,25,0,0,100,NoArch
b5e52b44b40bbab55f374b0334a9e62a008e55dc,7,57,43,14,100,0,0,0,12,0,1,1,2.319046403,1354,1,188,4,189,186,3,5996,5872,124,99,99,0,0,99.74811083,NoArch
fe37e737b645bbd7d316199290ea796b1387f114,7,65,15,50,80,4,0,4,13,0,1,1,2.242651273,1368,1,189,5,200,189,11,6233,5996,237,108,99,9,0,100,NoArch
ffd341f4eb331ac4a38e62c4cc4fa8c85288efff,1,2,2,0,4,0,0,0,9,14,1,1,0,97,5,35,2,8,8,0,196,196,0,7,7,0,0,100,NoArch
b8896ee201898d162fefe7f6664d66245a14b88b,1,9,8,1,17,0,0,0,8,1,1,1,0,314,1,190,6,49,49,0,1680,1639,41,17,17,0,0,100,NoArch
1a6766ab255531fef451d24fdc53a78ebcb29848,1,17,0,17,17,1,0,1,14,2,1,1,0,388,2,191,7,54,53,1,2059,1966,93,28,27,1,0,100,NoArch
abb771501f2a80728f97ff16ba47939b9f9aeb49,0,0,0,0,0,0,0,0,0,0,0,0,0,0,0,192,8,0,0,0,0,0,0,0,0,0,0,100,NoArch
a0c6c27a055715a9387313e672f4965a449046a8,2,18,5,13,23,0,0,0,21,6,1,2,0.932111568,290,1,36,3,67,65,2,2101,2026,75,24,23,1,0,100,NoArch
f409b33620a69b3837a584f3551499fd00fad6d5,20,800,616,184,1416,3,0,3,223,215,1,5,1.791513544,17215,7,445,9,2827,2704,123,78608,76682,1926,1076,1042,34,0,99.85616685,NoArch
edb45085cc0d5e272bf7eabe982f8e2fb825b2de,0,0,0,0,0,0,0,0,0,0,0,0,0,0,0,446,10,0,0,0,0,0,0,0,0,0,0,100,NoArch
911ed3ad4ac8856df4ab363fb02cb6a2fc61bcd2,1,1,5,4,6,0,0,0,110,0,1,1,0,3307,10,447,11,518,520,2,18112,18138,26,141,141,0,0,100,NoArch
008c832d79728f995a5301f7b7b0bbf5888c1853,4,166,125,41,291,0,0,0,22,370,1,4,1.07778013,865,1,37,4,171,162,9,5319,4957,362,63,57,6,1,98.71987952,NoArch
ffefadbc7a9a297e8747a7b964d12883df591425,2,31,2,29,33,0,0,0,23,0,1,2,0.994030211,349,1,38,5,84,78,6,2705,2511,194,33,29,4,1,100,NoArch
b574c09c0028a579d65b75017c6876b0da3b7193,1,5,0,5,5,1,0,1,73,19,1,1,0,2263,8,39,6,445,444,1,11762,11739,23,100,100,0,1,100,NoArch
930346419163a8cfcecb4d62992a88df619a464f,1,17,0,17,17,1,0,1,74,0,1,1,0,2268,8,40,7,451,445,6,11852,11762,90,101,100,1,1,100,NoArch
793155f8ac02df77acafa598fd8be4f181425d61,13,94,174,80,268,3,0,3,224,196,1,5,2.73255278,12815,7,448,12,2107,2123,16,58155,58633,478,845,859,14,0,100,NoArch
57ff9ac0cf46501c0d7ea9d2a34c62127651033f,4,49,34,15,83,0,0,0,46,10,1,3,1.242160792,2307,2,449,13,418,418,0,12507,12464,43,135,135,0,0,100,NoArch
10c447b79a34f62c1f18c0cc904523537e4a264a,0,0,0,0,0,0,0,0,0,0,0,0,0,0,0,450,14,0,0,0,0,0,0,0,0,0,0,100,NoArch
db23cc4d4cb7553fb166239399ca824ddf83499f,0,0,0,0,0,0,0,0,0,0,0,0,0,0,0,17,0,0,0,0,0,0,0,0,0,0,0,100,NoArch
27b815b0d7b984583034308fdfdb3798156778c1,0,0,0,0,0,0,0,0,0,0,0,0,0,0,0,193,9,0,0,0,0,0,0,0,0,0,0,100,NoArch
04cb772210d3e3738ca3613edcdc862a565c5e4a,1,18,16,2,34,0,0,0,6,87,1,1,0,83,3,194,10,8,8,0,316,305,11,4,4,0,0,100,NoArch
9316a2e7fd631f3bf91ac98b969021363d0af6d8,1,49,3,46,52,0,0,0,15,12,1,1,0,405,2,195,10,62,54,8,2286,2059,227,29,28,1,0,100,NoArch
8bff9971d1f660a45eec20ecf6d01b91c45d5d52,1,6,2,4,8,0,0,0,3,1269,1,1,0,211,1,196,11,20,19,1,708,696,12,11,10,1,0,100,NoArch
1cb791947afeb86bcab0a058a23f5514248adfb4,0,0,0,0,0,0,0,0,0,0,0,0,0,0,0,451,15,0,0,0,0,0,0,0,0,0,0,100,NoArch
bd221023cdf50ae07478877fb160436867536da1,1,9,5,4,14,0,0,0,225,6,1,1,0,6904,20,452,16,989,988,1,26506,26494,12,460,460,0,0,100,NoArch
a6698b446e1ee7337587439c1ccde58d69e44538,1,25,2,23,27,0,0,0,14,174,1,1,0,340,2,54,6,86,79,7,1890,1762,128,40,36,4,0,100,NoArch
767e6b655040c4d7bff5380ee3cbef945ba94c93,5,499,1,498,500,4,0,4,38,7,1,2,1.720675066,870,4,118,1,216,185,31,8172,4632,3540,197,178,19,0,99.41383353,NoArch
34391eb0d765e6ddf00d817e69a8ab895cd2fe15,3,9971,0,9971,9971,3,0,3,1,0,1,1,0.872724268,0,1,119,2,2785,0,2785,50384,0,50384,238,0,238,0,99.76816074,NoArch
b5610c06f1d57dee554a1e35903d5439a3924c9c,8,58,26,32,84,1,0,1,55,217,1,5,2.698632494,3735,2,472,13,685,677,8,18940,18702,238,177,175,2,0,100,NoArch
11bf499e3b2f75d3c4d11755f022adfeb6204c6e,1,54,31,23,85,0,0,0,2,0,1,1,0,7663,1,120,3,1959,1959,0,36229,35930,299,166,166,0,0,100,NoArch
caf6936edfc2da5f083cf10f5b2a46f19f725e40,3,30,26,4,56,0,0,0,155,12,1,1,1.17124759,2440,4,473,14,510,509,1,13781,13775,6,116,115,1,0,100,NoArch
3e38cc19188e99faf26449410662196f3bd6f5dd,0,0,0,0,0,0,0,0,0,0,0,0,0,0,0,474,15,0,0,0,0,0,0,0,0,0,0,100,NoArch
8327c5439026863957c43f143a3ffb11842d10d2,0,0,0,0,0,0,0,0,0,0,0,0,0,0,0,475,16,0,0,0,0,0,0,0,0,0,0,100,NoArch
d8569aa901eb85bf6d569996d36a9fa73ef3ca57,1,18,61,43,79,0,0,0,6,80,1,1,0,230,1,205,0,24,23,1,683,786,103,11,12,1,0,100,NoArch
c0971fd6e6a546e0984bb1eb71f9ccbc8bf56dbf,0,0,0,0,0,0,0,0,0,0,0,0,0,0,0,206,1,0,0,0,0,0,0,0,0,0,0,100,NoArch
378c5e17cdffc5c1d430e297df2da71c714e6639,1,4,4,0,8,0,0,0,7,0,1,1,0,187,1,207,2,24,24,0,683,683,0,11,11,0,0,100,NoArch
4e5b1648264bbd84271a4cfee88ce6bb72c13d08,0,0,0,0,0,0,0,0,0,0,0,0,0,0,0,2,0,0,0,0,0,0,0,0,0,0,0,100,NoArch
8270f7275db9f4ee2b01c7ae225d022ecb40c666,0,0,0,0,0,0,0,0,0,0,0,0,0,0,0,3,1,0,0,0,0,0,0,0,0,0,0,100,NoArch
c73c488eed830a0fa81993909053e703e9942926,0,0,0,0,0,0,0,0,0,0,0,0,0,0,0,4,2,0,0,0,0,0,0,0,0,0,0,100,NoArch
e8075b04ffd62558a3db46725979da79bd286184,0,0,0,0,0,0,0,0,0,0,0,0,0,0,0,5,3,0,0,0,0,0,0,0,0,0,0,100,NoArch
59eefd61d362c4dd6c4e474aacf07f46e068c99a,0,0,0,0,0,0,0,0,0,0,0,0,0,0,0,6,4,0,0,0,0,0,0,0,0,0,0,100,NoArch
4cf388053795c08fc661441f670d7e4648912df5,0,0,0,0,0,0,0,0,0,0,0,0,0,0,0,7,5,0,0,0,0,0,0,0,0,0,0,100,NoArch
97c1de6080b6e8317b72e188ebd7ceab03a95c15,0,0,0,0,0,0,0,0,0,0,0,0,0,0,0,8,6,0,0,0,0,0,0,0,0,0,0,100,NoArch
0593a5b4d377b885e7d36c543fc3926f4bda1be7,0,0,0,0,0,0,0,0,0,0,0,0,0,0,0,9,7,0,0,0,0,0,0,0,0,0,0,100,NoArch
44f36b826b67dcf492085c69e7fcd60aea1a366d,0,0,0,0,0,0,0,0,0,0,0,0,0,0,0,10,8,0,0,0,0,0,0,0,0,0,0,100,NoArch
e2a8c738010928c0bab8b73bbb24cc4e53bcecd9,0,0,0,0,0,0,0,0,0,0,0,0,0,0,0,11,9,0,0,0,0,0,0,0,0,0,0,100,NoArch
c0d4c35c07bbf91902d5d170a7a628eee35f38c8,0,0,0,0,0,0,0,0,0,0,0,0,0,0,0,12,10,0,0,0,0,0,0,0,0,0,0,100,NoArch
0a9bed17fc7f7d2cd93b7ca12ab557e4ee5bdfff,0,0,0,0,0,0,0,0,0,0,0,0,0,0,0,13,11,0,0,0,0,0,0,0,0,0,0,100,NoArch
d4cd2717a14a2ef225865969f0760fffc4055ba5,0,0,0,0,0,0,0,0,0,0,0,0,0,0,0,14,12,0,0,0,0,0,0,0,0,0,0,100,NoArch
b5a59de5c00e398d755755a00d2771629d896464,0,0,0,0,0,0,0,0,0,0,0,0,0,0,0,15,13,0,0,0,0,0,0,0,0,0,0,100,NoArch
740f33373a83fedaf196c53d64974e0848004592,0,0,0,0,0,0,0,0,0,0,0,0,0,0,0,16,14,0,0,0,0,0,0,0,0,0,0,100,NoArch
c8897be5a234136ffe6df6e8fa030d5efac45227,0,0,0,0,0,0,0,0,0,0,0,0,0,0,0,17,15,0,0,0,0,0,0,0,0,0,0,100,NoArch
d750847815ec7de14d89e7eccefd44b76bf2756b,0,0,0,0,0,0,0,0,0,0,0,0,0,0,0,18,16,0,0,0,0,0,0,0,0,0,0,100,NoArch
8c9f48fc6aeeb1d9ffd1d3bcce5f8b99c9bc0117,0,0,0,0,0,0,0,0,0,0,0,0,0,0,0,19,17,0,0,0,0,0,0,0,0,0,0,100,NoArch
401e8d04eb7281da7788e83b28e3c6f13e2f78c4,1,9,2,7,11,0,0,0,13,256,1,1,0,243,4,55,7,50,48,2,979,928,51,20,20,0,0,100,NoArch
cb8a1de6890086a7070c870601aded128898e781,1,21,8,13,29,0,0,0,6,3132,1,1,0,150,3,56,8,16,13,3,699,644,55,13,10,3,0,100,NoArch
bf5e4ce9defee22bea4915572089183dd3f80207,1,35,32,3,67,0,0,0,99,97,1,1,0,293,13,57,8,40,38,2,1143,1110,33,15,13,2,0,100,NoArch
da40c2c067e718c8f0b5c9376a17c962db1cba23,1,1,1,0,2,0,0,0,28,299,1,1,0,486,8,58,7,52,51,1,2108,2104,4,12,12,0,0,100,NoArch
26b4fd4db1ed341103cde93cad7065807affed7b,1,8,4,4,12,0,0,0,57,7,1,1,0,2120,5,476,10,480,480,0,12603,12589,14,92,92,0,0,100,NoArch
2b743472959f1f966617f8a3020106e3962ee55a,0,0,0,0,0,0,0,0,0,0,0,0,0,0,0,18,0,0,0,0,0,0,0,0,0,0,0,100,NoArch
1e14ac0cca91b682bb94c933efbd36fae4942e0b,0,0,0,0,0,0,0,0,0,0,0,0,0,0,0,20,18,0,0,0,0,0,0,0,0,0,0,100,NoArch
7de8b056e7298464815611299884a1f6ce2dde1f,1,48,0,48,48,1,0,1,37,62,1,1,0,293,9,477,6,41,36,5,1336,1178,158,20,17,3,0,100,NoArch
20d7c712fe13090db4a60e0adae5c6744d0bd17c,1,1,10,9,11,0,0,0,38,0,1,1,0,341,9,478,7,39,41,2,1238,1336,98,20,20,0,0,100,NoArch
6b36e0a8c6e8f4ac7f295e5c4c5b93a89da417e9,1,25,17,8,42,0,0,0,58,18,1,1,0,2124,5,479,8,481,480,1,12627,12603,24,93,92,1,1,100,NoArch
d504ac05e6e48bf7d51df265245e9dec0408da59,1,11,4,7,15,0,0,0,7,64,1,1,0,822,3,21,19,210,209,1,5316,5281,35,36,36,0,1,100,NoArch
0e03cf3975b449d5fc1cece8606a301e1946bf30,1,89,0,89,89,1,0,1,8,405,1,1,0,2614,4,42,0,207,157,50,4812,3781,1031,199,149,50,0,100,NoArch
62ea79373d7f4a856ced9c22af28a91488633107,1,0,89,89,89,0,0,0,9,0,1,1,0,2703,5,208,3,157,207,50,3781,4812,1031,149,199,50,0,100,NoArch
9e5b56092825457ef64b421bf24e52edcdeff68a,0,0,0,0,0,0,0,0,0,0,0,0,0,0,0,480,8,0,0,0,0,0,0,0,0,0,0,100,NoArch
92b179205f5bd1262c7d73f0ca693c2331256388,1,3,2,1,5,0,0,0,114,71,1,1,0,3280,10,481,9,525,525,0,17980,17982,2,142,142,0,2,100,NoArch
3c64165d9119c3f19a30c58a56714c4dd96ea4a9,0,0,0,0,0,0,0,0,0,0,0,0,0,0,0,482,10,0,0,0,0,0,0,0,0,0,0,100,NoArch
cf156e7f37da8fe56755fa15c6f1a274d927c1c9,5,377,102,275,479,2,0,2,39,55,1,3,1.147614548,2248,1,121,3,603,543,60,12669,11629,1040,388,357,31,0,99.922899,NoArch
c71e8c0364caab4eca77ab26283336600017995c,0,0,0,0,0,0,0,0,0,0,0,0,0,0,0,59,4,0,0,0,0,0,0,0,0,0,0,100,NoArch
dd6b91a1f2a3e093e76273b0b61016a68b9bdd86,0,0,0,0,0,0,0,0,0,0,0,0,0,0,0,60,5,0,0,0,0,0,0,0,0,0,1,100,NoArch
bc14476be8c00b57cdf9f641c167892ddb48fe79,0,0,0,0,0,0,0,0,0,0,0,0,0,0,0,61,6,0,0,0,0,0,0,0,0,0,0,100,NoArch
8503f2fad09d67fb655ad177c013f21bcd28bc19,1,4,0,4,4,1,0,1,5,187,1,1,0,126,3,483,7,11,10,1,209,195,14,10,9,1,0,100,NoArch
00b05a3f3c81aef1ba55faba22f7ebf176da5330,0,0,0,0,0,0,0,0,0,0,0,0,0,0,0,484,8,0,0,0,0,0,0,0,0,0,0,100,NoArch
2ea14ec53d6c3b3d29e08b592424778118c836a8,9,905,2684,1779,3589,3,1,4,59,163,1,3,1.544398954,6467,1,485,9,838,902,64,23082,24213,1131,284,396,112,0,99.69230769,NoArch
ec146467a4c2ba263f706b6e2f3a9fad321348ff,1,6,16,10,22,0,0,0,2,1669,1,1,0,252,2,62,3,34,36,2,888,926,38,15,15,0,1,100,NoArch
c4cd859cef3414a6854579931802f64ea66ae0f3,2,9,0,9,9,2,0,2,32,118,1,2,0.918295834,1319,2,486,9,272,271,1,8209,8109,100,73,73,0,0,98.75457875,NoArch
bad5f9e8eddc40d9c18bb9dfffc06663a6a1d215,1,16,2,14,18,0,0,0,4,149,1,1,0,174,1,487,10,34,30,4,1116,970,146,26,26,0,0,100,NoArch
f7496d8ba1bcc82f0f3c82bc99f20306a7f18cb0,1,7,22,15,29,0,0,0,2,11,1,1,0,372,1,488,11,74,74,0,1758,1808,50,29,29,0,0,100,NoArch
7fa41234904e0f6b82311d482ee41994c88b1322,1,1,1,0,2,0,0,0,60,11,1,1,0,2180,5,489,12,486,486,0,12935,12938,3,93,93,0,0,100,NoArch
3168d1168ff8540400dc9282b81446e90db6d98a,1,6,4,2,10,0,0,0,115,18,1,1,0,3281,10,490,13,525,525,0,17984,17980,4,142,142,0,0,100,NoArch
c35ad8215c3558d6a23df79e019854e34ff6dd04,3,15,38,23,53,1,0,1,33,0,1,3,0.365791974,1516,2,491,14,301,306,5,9137,9325,188,98,99,1,0,98.75457875,NoArch
97d05e8bcf45cb23d8bbba0803b29f8ef82c740a,0,0,0,0,0,0,0,0,0,0,0,0,0,0,0,492,15,0,0,0,0,0,0,0,0,0,0,100,NoArch
c0109765288eeb16885cd61b310a706a84b05f52,0,0,0,0,0,0,0,0,0,0,0,0,0,0,0,493,16,0,0,0,0,0,0,0,0,0,0,100,NoArch
079253f2c9d94beed6de398405e2f3961a53306e,0,0,0,0,0,0,0,0,0,0,0,0,0,0,0,494,17,0,0,0,0,0,0,0,0,0,0,100,NoArch
4b470f5ad588c0d4b4954654194b4b914285380d,7,773,21,752,794,3,0,3,116,138,1,3,2.144669297,5932,5,0,0,1033,916,117,31992,28470,3522,356,310,46,0,98.50091408,NoArch
d1cc54c029c04becb9dda74945ec118ec5e72a68,1,2,0,2,2,1,0,1,15,0,1,1,0,622,5,1,1,70,70,0,1486,1479,7,37,37,0,0,100,NoArch
13454df864616bb33e782b64a42ebc5c4b64a2f7,1,1,2,1,3,0,0,0,2,0,1,1,0,362,1,2,2,62,62,0,1928,1937,9,18,18,0,0,100,NoArch
432e0fd30e6900823938ad62449f892a895d256f,1,1,1,0,2,0,0,0,117,0,1,1,0,3352,11,495,18,540,540,0,18478,18485,7,146,146,0,0,100,NoArch
d8a507b8072f7ff439609898c02822e3fae333fe,1,2,2,0,4,0,0,0,10,93,1,1,0,362,3,3,3,54,54,0,1173,1169,4,26,26,0,0,100,NoArch
f1a43e271d3637102ae610afd38377010a079f1c,2,63,6,57,69,0,0,0,118,0,1,1,0.849054424,3713,11,4,4,616,602,14,20878,20406,472,166,164,2,0,100,NoArch
214a12f9c3a0cfd0ce92d4e65f257523903e50e0,1,16,1,15,17,0,0,0,18,311,1,1,0,227,5,209,1,30,27,3,1039,943,96,19,19,0,0,100,NoArch
667236ef5f1bcafa5c1802be62d4bc9d2ce39d06,0,0,0,0,0,0,0,0,0,0,0,0,0,0,0,496,19,0,0,0,0,0,0,0,0,0,0,100,NoArch
1f89c35c9caab2d23e95a0f9e13f2e42f6d82c4f,1,3,0,3,3,1,0,1,228,92,1,1,0,6917,20,497,20,994,992,2,26603,26576,27,462,462,0,0,100,NoArch
02f3247fc4258a07ccd2043b5603c2a5d6b0313b,0,0,0,0,0,0,0,0,0,0,0,0,0,0,0,498,21,0,0,0,0,0,0,0,0,0,0,100,NoArch
ce5f63f9a214dd1aec1e84d15edee2cfecfaacd1,1,4,1,3,5,0,0,0,34,2,1,1,0,836,2,499,22,182,181,1,5452,5439,13,48,48,0,0,100,NoArch
58faf881e49848bf82a90b7f0859346660df26b0,2,5,0,5,5,2,0,2,24,83,1,1,0.721928095,963,7,500,23,191,189,2,4973,4947,26,100,99,1,0,99.68619247,NoArch
cbae388c29f5a90714cddd29e238b4024b9e98c6,1,2,0,2,2,1,0,1,78,97,1,1,0,2298,8,501,24,455,454,1,11954,11932,22,101,101,0,0,100,NoArch
4d1e457f8a193ac23222de777bdeb6c5d209d030,1,37,5,32,42,0,0,0,7,5,1,1,0,134,3,502,25,14,12,2,252,221,31,13,11,2,0,100,NoArch
5bd2e260d36f2f73f169168930475fcda7f7a121,0,0,0,0,0,0,0,0,0,0,0,0,0,0,0,12,0,0,0,0,0,0,0,0,0,0,0,100,NoArch
59201342a48d8796f36ea0a1bd6ee3315fe7c799,1,2,1,1,3,0,0,0,229,6,1,1,0,6920,20,503,26,994,994,0,26605,26603,2,462,462,0,0,100,NoArch
29937ddb0e20e0fb606d6bbbc6ca4a906bca94ee,0,0,0,0,0,0,0,0,0,0,0,0,0,0,0,22,0,0,0,0,0,0,0,0,0,0,0,100,NoArch
a9a1e375b27920941064ae5ca56f486678aad4a3,2,135,19,116,154,0,0,0,230,179,1,2,0.294615206,7063,6,19,0,1030,1017,13,28017,27739,278,484,475,9,0,100,NoArch
8403db59a9f1a88a606b496c5914d18990265599,0,0,0,0,0,0,0,0,0,0,0,0,0,0,0,23,1,0,0,0,0,0,0,0,0,0,1,100,NoArch
523e38fbd8d689755321593dd73b5314f3f7ed03,0,0,0,0,0,0,0,0,0,0,0,0,0,0,0,24,2,0,0,0,0,0,0,0,0,0,1,100,NoArch
dffedf5f26251432ea10d9d7ada03fbe70c65a59,1,1,0,1,1,1,0,1,54,466,1,1,0,70,11,25,3,3,3,0,101,96,5,1,1,0,1,100,NoArch
def20972d6e91d8d1d1be58444e59b5470f2aec7,5,558,0,558,558,5,0,5,1,0,1,1,2.282976164,0,1,210,1,47,0,47,3358,0,3358,47,0,47,0,99.61818813,NoArch
99fd0476b7fa65ca4f9e4e422c7278ded9b069f0,1,138,0,138,138,1,0,1,1,0,1,1,0,0,1,211,2,19,0,19,764,0,764,19,0,19,0,99.9308915,NoArch
8af6d326e2e668c53c5e6f8c3b56dde3d355084e,0,0,0,0,0,0,0,0,0,0,0,0,0,0,0,20,1,0,0,0,0,0,0,0,0,0,1,100,NoArch
17b69f9a6e430ce0cfb1595e57b242bacc7bfcd1,4,73,54,19,127,3,0,3,156,94,1,1,0.937808923,2861,9,212,2,568,563,5,15622,15350,272,147,148,1,0,99.96546961,NoArch
74b09cb93052f1827e5fc2c3d1430e3b4fa55efa,1,71,52,19,123,0,0,0,15,1037,1,1,0,380,5,223,0,45,42,3,1520,1463,57,18,17,1,1,100,NoArch
46a87a9cd8b7814d140edd7244c41bcb0e0b8857,0,0,0,0,0,0,0,0,0,0,0,0,0,0,0,43,0,0,0,0,0,0,0,0,0,0,0,100,NoArch
160f6fb8e72dd761c26a97b8b2091a0ea0eb11e0,1,15,3,12,18,0,0,0,3,51,1,1,0,357,1,504,0,75,74,1,1790,1758,32,30,29,1,0,100,NoArch
5309594367cf984d952ac88822c1b3989e9979d3,3,17,17,0,34,0,0,0,100,157,1,3,1.253297578,738,3,213,3,84,84,0,2850,2848,2,36,36,0,0,99.82734807,NoArch
28851b4c6196304728eebd62e152f252a9b90214,1,56,0,56,56,1,0,1,42,0,1,1,0,0,9,214,4,0,0,0,86,0,86,0,0,0,0,99.5532646,NoArch
9ff245de02978980e007adacfdd70133e1ee9206,3,9,23,14,32,0,0,0,62,3,1,2,1.335584193,2363,3,215,5,493,493,0,13494,13495,1,98,98,0,0,99.8630606,NoArch
d28d8235630d3a5d2940598a8fd562039a078c57,0,0,0,0,0,0,0,0,0,0,0,0,0,0,0,44,1,0,0,0,0,0,0,0,0,0,0,100,NoArch
5825ec9a343bb60657e1a449e6d6ba0ce1d63273,0,0,0,0,0,0,0,0,0,0,0,0,0,0,0,45,2,0,0,0,0,0,0,0,0,0,0,100,NoArch
3cda34bf56c20000cb3c801abb9b75307670b135,0,0,0,0,0,0,0,0,0,0,0,0,0,0,0,46,3,0,0,0,0,0,0,0,0,0,0,100,NoArch
57fb4ea87d5da826d971493e2b239ec6b03d7a01,4,156,20,136,176,2,0,2,119,54,1,3,1.836396558,4609,3,5,0,811,798,13,26926,26330,596,219,214,5,0,99.86338798,NoArch
5aec1216d8a2fb7f267cb62bcbe79111f7e2b525,1,2,2,0,4,0,0,0,36,4,1,1,0,856,3,6,1,185,185,0,5603,5603,0,49,49,0,0,100,NoArch
9ebea0cbddcad1ab6636da61962a368138828bf0,12,180,132,48,312,0,0,0,157,104,1,6,1.78755307,5283,7,216,4,902,898,4,25881,25769,112,293,290,3,0,97.11087035,Arch
3cd7a5079e43b61dbf1ff74e8021bd28889cc707,1,30,0,30,30,1,0,1,1,0,1,1,0,0,1,217,5,0,0,0,100,0,100,0,0,0,0,99.92313605,NoArch
4d3a020b5cd8b9549498716e48f45c1b79ab8e99,1,2,2,0,4,0,0,0,18,172,1,1,0,984,5,7,2,312,311,1,6940,6936,4,39,39,0,0,100,NoArch
96f5e2dccb874a5d25a79fe619a7183d787cfd67,0,0,0,0,0,0,0,0,0,0,0,0,0,0,0,47,4,0,0,0,0,0,0,0,0,0,0,100,NoArch
a0d8b50973e71d0414f99983983f926a5e0c0ce7,0,0,0,0,0,0,0,0,0,0,0,0,0,0,0,218,6,0,0,0,0,0,0,0,0,0,0,100,NoArch
85898e997b65907e7760c5c7c4f3a8816ad2e44a,0,0,0,0,0,0,0,0,0,0,0,0,0,0,0,224,1,0,0,0,0,0,0,0,0,0,0,100,NoArch
13f5a8625c227ac009bff66c161be5b103903f55,1,1,4,3,5,0,0,0,19,3,1,1,0,984,5,8,3,311,312,1,6922,6940,18,39,39,0,0,100,NoArch
8226764289215b27385bf59a96fbf7804d9e4ebd,3,104,0,104,104,3,0,3,79,61,1,3,0.266396387,2370,1,9,4,465,456,9,12891,12527,364,109,102,7,0,99.7698504,NoArch
5751d8d642edf92524f54e057c3369a6a4917783,14,90,74,16,164,1,0,1,158,2,1,7,2.646685512,5446,3,219,7,903,906,3,26122,26245,123,300,297,3,0,96.96312364,Arch
bf362c1453be55e8f3dcebaf6c495d7b653dbb33,2,2,2,0,4,0,0,0,159,0,1,1,1,180,1,220,8,0,0,0,361,361,0,0,0,0,0,99.72630859,NoArch
802c80d3e2f96c4b7a9b0cd132563558d98e3f03,6,35,4,31,39,2,0,2,17,0,1,3,2.12856872,3004,3,221,9,574,574,0,16153,15929,224,146,146,0,0,99.48892675,NoArch
e3b04bef43e2256fa54ad3767423b856a89dddcd,1,7,1,6,8,0,0,0,5,11,1,1,0,392,1,10,5,68,67,1,2135,2117,18,21,21,0,0,100,NoArch
e9f2ea4a0cb6d56b4d29b2534786df64083c99dd,19,36,23,13,59,3,0,3,103,280,1,5,4.138679439,5527,1,222,9,1086,1086,0,28300,28233,67,278,278,0,0,96.83360258,Arch
14b1b84e59db2927c10c914b0a5bf89b287b5455,2,7,6,1,13,0,0,0,80,159,1,1,0.89049164,925,4,223,10,148,148,0,4163,4122,41,61,61,0,0,98.57651246,NoArch
c1cc2b16d643518ac079753575729d39640e167b,2,20,11,9,31,0,0,0,104,0,1,2,0.823811633,2552,1,224,11,541,539,2,14603,14581,22,116,116,0,0,100,NoArch
aaf071926a00ff53a70cfdfa920008be884003fa,1,2,1,1,3,0,0,0,231,60,1,1,0,7037,20,225,12,1006,1007,1,26873,26879,6,471,471,0,0,100,NoArch
ae71a57a76b4bc792da50fd2b2e5619b9651164c,1,1,1,0,2,0,0,0,81,91,1,1,0,970,9,505,1,182,182,0,4620,4622,2,82,82,0,0,100,NoArch
5cc94acf824c9aacaffd139df59d67a9f0289eac,1,2,1,1,3,0,0,0,232,1,1,1,0,7038,20,506,2,1006,1006,0,26878,26873,5,471,471,0,0,100,NoArch
0401a83f05384e5acfb8f308bf5287f4ceb69f73,1,56,120,64,176,0,0,0,14,385,1,1,0,284,5,507,2,14,13,1,895,807,88,5,5,0,0,100,NoArch
f9f471fb87b93be002efbb5a6ef13ad28210c5ef,1,1,1,0,2,0,0,0,19,616,1,1,0,40,9,63,0,1,1,0,46,46,0,1,1,0,0,100,NoArch
75696ddeeb2a731b228f4cf25f4dbc67137e3a83,0,0,0,0,0,0,0,0,0,0,0,0,0,0,0,64,1,0,0,0,0,0,0,0,0,0,0,100,NoArch
003d8de296e6893206b1512fac4ea87b301f0625,1,7,4,3,11,0,0,0,14,1051,1,1,0,115,7,65,2,19,18,1,488,480,8,16,16,0,0,100,NoArch
19ad4a039cb7173703a865568d0a57a8980d1536,0,0,0,0,0,0,0,0,0,0,0,0,0,0,0,66,3,0,0,0,0,0,0,0,0,0,0,100,NoArch
723f942fc1fb9c87b0d47d94073b5da6c62357de,0,0,0,0,0,0,0,0,0,0,0,0,0,0,0,67,4,0,0,0,0,0,0,0,0,0,0,100,NoArch
e2bac81497eb9110179637425358ac0ad95c0d01,1,1,1,0,2,0,0,0,5,1868,1,1,0,285,4,68,5,44,44,0,1231,1231,0,21,21,0,0,100,NoArch
2aeb9029513d6e4a64f2110fdb0c67ba033f6d2a,0,0,0,0,0,0,0,0,0,0,0,0,0,0,0,69,6,0,0,0,0,0,0,0,0,0,0,100,NoArch
8434ccd8d05d6a9de26a4db2e1a4ac942ff91c9a,0,0,0,0,0,0,0,0,0,0,0,0,0,0,0,70,7,0,0,0,0,0,0,0,0,0,0,100,NoArch
b9b3c71f074625873f5b6d2c14acb8b66aa49931,0,0,0,0,0,0,0,0,0,0,0,0,0,0,0,71,8,0,0,0,0,0,0,0,0,0,0,100,NoArch
296c3b141fe16a0668163313572ea258a69f6a05,0,0,0,0,0,0,0,0,0,0,0,0,0,0,0,72,9,0,0,0,0,0,0,0,0,0,0,100,NoArch
6c8bff524433aa4404bc409372dd9e9a0b5f80c6,0,0,0,0,0,0,0,0,0,0,0,0,0,0,0,73,10,0,0,0,0,0,0,0,0,0,0,100,NoArch
20dacb5dff5bff40aa2189d09b16ac59bd8af602,4,104,37,67,141,2,0,2,120,76,1,3,1.576111004,3979,1,508,3,673,669,4,22429,22302,127,197,195,2,0,99.86394558,NoArch
8e552b59689e5fe956033698dfe32aa96869d316,1,9,0,9,9,1,0,1,233,6,1,1,0,7039,20,509,4,1007,1006,1,26906,26878,28,472,471,1,0,100,NoArch
e923f809206372a950345031caeda059ac19ee83,1,1,1,0,2,0,0,0,234,0,1,1,0,7048,20,510,5,1007,1007,0,26906,26906,0,472,472,0,0,100,NoArch
6298b8730e84087551b1e97ee82d753e61d1f423,1,1,1,0,2,0,0,0,17,69,1,1,0,142,6,511,6,23,23,0,1140,1138,2,13,13,0,0,100,NoArch
95232b2612b529078850c0cd9df18bdc2de346e6,1,103,0,103,103,1,0,1,2,12,1,1,0,30,2,2,0,0,0,0,100,100,0,0,0,0,0,100,NoArch
4ac5e112ddc274e381268cb01a8843ee970c4f85,0,0,0,0,0,0,0,0,0,0,0,0,0,0,0,74,11,0,0,0,0,0,0,0,0,0,0,100,NoArch
7a1cf960df53229f5b25c37fdf664ce161eebc5a,0,0,0,0,0,0,0,0,0,0,0,0,0,0,0,75,12,0,0,0,0,0,0,0,0,0,0,100,NoArch
216f598d100c5cc401999238e736921be03ff032,0,0,0,0,0,0,0,0,0,0,0,0,0,0,0,76,13,0,0,0,0,0,0,0,0,0,0,100,NoArch
f828a2cf9d41e468cbe4953a290cebd4430ae612,0,0,0,0,0,0,0,0,0,0,0,0,0,0,0,77,14,0,0,0,0,0,0,0,0,0,0,100,NoArch
491e499d477c20092e64f2c4643904ea05983357,0,0,0,0,0,0,0,0,0,0,0,0,0,0,0,78,15,0,0,0,0,0,0,0,0,0,0,100,NoArch
8dad08a6345342b27131e6fabd6f2313dabbed2f,0,0,0,0,0,0,0,0,0,0,0,0,0,0,0,79,16,0,0,0,0,0,0,0,0,0,0,100,NoArch
08f809143bfe391fdaff6c84c920b12d89e6358e,0,0,0,0,0,0,0,0,0,0,0,0,0,0,0,80,17,0,0,0,0,0,0,0,0,0,0,100,NoArch
c00e6a05687b5024f26d33fd64319be316143a47,0,0,0,0,0,0,0,0,0,0,0,0,0,0,0,81,18,0,0,0,0,0,0,0,0,0,0,100,NoArch
4c6a8dcf2afcea165fe013a003fabf986a3144c2,0,0,0,0,0,0,0,0,0,0,0,0,0,0,0,82,19,0,0,0,0,0,0,0,0,0,0,100,NoArch
c6ad4b061aff127ade6b73fc65131141c47db266,0,0,0,0,0,0,0,0,0,0,0,0,0,0,0,83,20,0,0,0,0,0,0,0,0,0,0,100,NoArch
37fe91b1b42532e6a67f54a3b6560eda1576c95f,0,0,0,0,0,0,0,0,0,0,0,0,0,0,0,84,21,0,0,0,0,0,0,0,0,0,0,100,NoArch
2b47364a9dd229f121dce587f2bdcd18cb3e8fd0,0,0,0,0,0,0,0,0,0,0,0,0,0,0,0,85,22,0,0,0,0,0,0,0,0,0,0,100,NoArch
97af998776ff65a5770600b7c74906a7d618c416,0,0,0,0,0,0,0,0,0,0,0,0,0,0,0,86,23,0,0,0,0,0,0,0,0,0,0,100,NoArch
ccb4fce714e1e41d548d4e9bc73993fee55bfd0a,0,0,0,0,0,0,0,0,0,0,0,0,0,0,0,87,24,0,0,0,0,0,0,0,0,0,0,100,NoArch
596049728977fb0a719abea59a7951b08c7e7233,3,153,40,113,193,0,0,0,235,46,1,2,1.075748768,8168,3,88,25,1304,1255,49,34164,33333,831,529,523,6,1,100,NoArch
c7973ebae5b8d887d73ecc49de9f8a4f311b8f62,10,33,16,17,49,0,0,0,106,9,1,6,2.552629742,4455,4,3,1,841,837,4,23236,23167,69,287,283,4,0,100,NoArch
68fc809a937c4b6d104d25decce313bf4e882c6a,0,0,0,0,0,0,0,0,0,0,0,0,0,0,0,4,2,0,0,0,0,0,0,0,0,0,0,100,NoArch
37f4e03c62163ecbff54d99ce215c909eb3c7752,2,2,9,7,11,0,0,0,160,7,1,1,0.684038436,356,17,5,3,34,34,0,1100,1098,2,33,33,0,0,100,NoArch
b97cfd0dd95820bbe0c4b4edd92b5502de24b98f,4,178,54,124,232,1,0,1,161,0,1,2,1.598628967,2546,2,6,4,503,503,0,13799,13850,51,101,101,0,0,99.18339571,NoArch
7baf7b71671202146d57df441b979693d90fb271,2,109,7,102,116,0,0,0,236,3,1,2,0.12565805,7276,7,89,26,1086,1061,25,29378,28528,850,495,491,4,1,100,NoArch
117357c7818abe04b86fa031093b084bad861332,1,19,5,14,24,0,0,0,17,2,1,1,0,206,4,7,5,40,34,6,935,844,91,35,33,2,0,99.96594005,NoArch
f058738d5f9d1df8ff2f607c73f35760ea13db96,0,0,0,0,0,0,0,0,0,0,0,0,0,0,0,90,27,0,0,0,0,0,0,0,0,0,0,100,NoArch
640213774bae0b77be0c21ccb265412b49a59666,3,6,6,0,12,0,0,0,29,246,1,3,1.251629167,637,2,21,0,128,128,0,3758,3758,0,62,62,0,0,100,NoArch
5c83fe519f348aa95367ee2e907a8122adcfa492,5,0,760,760,760,0,5,5,7,2374,1,2,2.008378681,760,3,48,4,0,74,74,0,2345,2345,0,41,41,0,99.24734861,NoArch
dc1144e365a35f1a6b0dfe08363d0ee78581d027,0,0,0,0,0,0,0,0,0,0,0,0,0,0,0,49,5,0,0,0,0,0,0,0,0,0,0,100,NoArch
2c65522a494079990d1e22b8bd7882387b7a69fc,0,0,0,0,0,0,0,0,0,0,0,0,0,0,0,50,6,0,0,0,0,0,0,0,0,0,0,100,NoArch
e169a194f789afd83b428138ec09b8953d7a523b,0,0,0,0,0,0,0,0,0,0,0,0,0,0,0,51,7,0,0,0,0,0,0,0,0,0,0,100,NoArch
d7a48809afc76df7b25a5715d3ed04190911d577,0,0,0,0,0,0,0,0,0,0,0,0,0,0,0,52,8,0,0,0,0,0,0,0,0,0,0,100,NoArch
7652dee5afc908a796fc5b9f16dae72c406f3416,0,0,0,0,0,0,0,0,0,0,0,0,0,0,0,91,28,0,0,0,0,0,0,0,0,0,0,100,NoArch
fdacee1a37e31932676049978b28fe8750e3ce2f,0,0,0,0,0,0,0,0,0,0,0,0,0,0,0,53,8,0,0,0,0,0,0,0,0,0,0,100,NoArch
29dad79b631f51654145f0754e91098c606a2881,0,0,0,0,0,0,0,0,0,0,0,0,0,0,0,54,9,0,0,0,0,0,0,0,0,0,0,100,NoArch
5b2522e167d8b34ac81d180ba22c36e37a86126a,0,0,0,0,0,0,0,0,0,0,0,0,0,0,0,92,29,0,0,0,0,0,0,0,0,0,0,100,NoArch
d0e029b8702ede3a5fc8f06867f932446e49ed29,0,0,0,0,0,0,0,0,0,0,0,0,0,0,0,93,30,0,0,0,0,0,0,0,0,0,0,100,NoArch
48f3c4f213ac272e02a477df624db86b7e316f17,2,77,31,46,108,0,0,0,237,19,1,2,0.628071016,8077,3,94,31,1296,1283,13,33889,33696,193,521,518,3,1,100,NoArch
76db8bd22d8d7ac634ac4f80c23e928078eb2623,1,6,11,5,17,0,0,0,17,353,1,1,0,318,6,95,32,54,54,0,1224,1252,28,22,22,0,1,100,NoArch
637b274700f79cf66cd1c0f7df814828e18cdf9b,1,1,1,0,2,0,0,0,2,3535,1,1,0,194,2,96,33,17,17,0,403,403,0,6,6,0,0,100,NoArch
f29d92686d534e053b693f10b454ec9e5126fe96,0,0,0,0,0,0,0,0,0,0,0,0,0,0,0,55,8,0,0,0,0,0,0,0,0,0,0,100,NoArch
09db9ac84344472106d5bedb55e58f511b7327bd,3,94,107,13,201,0,0,0,3,177,1,1,0.221054621,9994,2,56,9,2783,2785,2,50586,50683,97,236,238,2,0,100,NoArch
638aae4dbe4aee647105dae44725dac152fd4c9d,0,0,0,0,0,0,0,0,0,0,0,0,0,0,0,57,10,0,0,0,0,0,0,0,0,0,0,100,NoArch
75fe13c080e3d9ce6144bd21082d86e4c680267e,0,0,0,0,0,0,0,0,0,0,0,0,0,0,0,58,11,0,0,0,0,0,0,0,0,0,0,100,NoArch
f37be0399c857ce5035a5ad3ef31f762799ff3da,0,0,0,0,0,0,0,0,0,0,0,0,0,0,0,109,0,0,0,0,0,0,0,0,0,0,0,100,NoArch
643925e507ac6ffe85b622644e29283f6ffab844,0,0,0,0,0,0,0,0,0,0,0,0,0,0,0,97,34,0,0,0,0,0,0,0,0,0,0,100,NoArch
318055ce87404746a69c55a78622ee66c253c139,0,0,0,0,0,0,0,0,0,0,0,0,0,0,0,98,35,0,0,0,0,0,0,0,0,0,0,100,NoArch
a0c02a537c40ea754b18296b789866ca1583e4f0,0,0,0,0,0,0,0,0,0,0,0,0,0,0,0,99,36,0,0,0,0,0,0,0,0,0,0,100,NoArch
69ce6890504bd86f18ff7738e76f914a6800fcd4,0,0,0,0,0,0,0,0,0,0,0,0,0,0,0,100,37,0,0,0,0,0,0,0,0,0,0,100,NoArch
18fd60d58dc9b8beddad048d398133adfacd012f,0,0,0,0,0,0,0,0,0,0,0,0,0,0,0,101,38,0,0,0,0,0,0,0,0,0,0,100,NoArch
060cc2435770fad49c572aca1cd0409d1624ba41,0,0,0,0,0,0,0,0,0,0,0,0,0,0,0,102,39,0,0,0,0,0,0,0,0,0,0,100,NoArch
8e0653e5463aa20e42e93a50bb60777aa5ff5e79,1,4,0,4,4,1,0,1,6,21,1,1,0,2256,3,103,40,504,503,1,13426,13398,28,101,101,0,1,100,NoArch
7968013d54de081d2fb51e8132efc723b070f09c,2,104,105,1,209,0,0,0,9,333,1,2,0.136577216,398,2,104,41,41,40,1,1779,1766,13,22,22,0,1,100,NoArch
8fc652580f77abfb7422128f4b8839696460049e,0,0,0,0,0,0,0,0,0,0,0,0,0,0,0,110,1,0,0,0,0,0,0,0,0,0,0,100,NoArch
1f1eae9c22ce8a37e55eca5e807e142b786b2c01,0,0,0,0,0,0,0,0,0,0,0,0,0,0,0,105,42,0,0,0,0,0,0,0,0,0,0,100,NoArch
671dbe6b695ccf916b991a991fe9d67ab6d242c8,0,0,0,0,0,0,0,0,0,0,0,0,0,0,0,106,43,0,0,0,0,0,0,0,0,0,0,100,NoArch
6e2d1451ed1a645b331677592b6028209a5fa8c5,0,0,0,0,0,0,0,0,0,0,0,0,0,0,0,107,44,0,0,0,0,0,0,0,0,0,0,100,NoArch
0cafd6ac3a7030c6e9af5369f42b92ca561d2548,0,0,0,0,0,0,0,0,0,0,0,0,0,0,0,111,2,0,0,0,0,0,0,0,0,0,0,100,NoArch
43dccfdc929dcd86ad600b9dcfc51ad901f19930,0,0,0,0,0,0,0,0,0,0,0,0,0,0,0,112,3,0,0,0,0,0,0,0,0,0,0,100,NoArch
5134b1ef93d1dd806bc70761faacb72cc6c37f47,0,0,0,0,0,0,0,0,0,0,0,0,0,0,0,59,11,0,0,0,0,0,0,0,0,0,0,100,NoArch
c919c6f1a41ab3ff747bfe907bc4e81806f2ebc5,1,4,13,9,17,0,0,0,6,31,1,1,0,285,5,11,1,42,44,2,1191,1231,40,19,21,2,0,100,NoArch
2d7c36e9306a2ed62681859082b7128e9b4fdcb7,2,3,3,0,6,0,0,0,162,212,1,2,0.650022422,327,2,108,45,12,12,0,875,891,16,10,10,0,0,100,NoArch
75aee771038d9857dcad78e0d5537a786904bb69,1,95,172,77,267,0,0,0,19,321,1,1,0,906,8,109,46,131,131,0,5069,5099,30,19,19,0,0,100,NoArch
67436344e8b8dd8f82e7e0350d593971a9e6f6e4,3,22,8,14,30,1,0,1,64,386,1,2,0.650022422,227,13,110,47,16,15,1,687,561,126,11,10,1,0,99.65647544,NoArch
9f1947b8ecbba52891d9c8efc6edfa17a952bf7d,2,15,10,5,25,0,0,0,238,153,1,1,0.970950594,7534,5,111,48,1106,1106,0,29461,29456,5,500,500,0,1,100,NoArch
15c2146819995a51db1f9eb33686bf36b9696459,19,9607,9628,21,19235,0,0,0,239,426,1,9,0.907998032,22115,3,112,49,4622,4622,0,99231,99231,0,1002,1002,0,0,100,NoArch
58ac8e852dfc9ce8df237d092aa7c281c2ce136e,8,27,33,6,60,0,0,0,9,3308,1,2,2.736452798,701,2,113,50,29,29,0,791,811,20,14,14,0,0,100,NoArch
eaac48964cea22a19cc5be9465453a4f746b772d,1,49,70,21,119,0,0,0,29,728,1,1,0,231,5,114,51,0,0,0,376,424,48,0,0,0,0,100,NoArch
f428eb6818455509cf16c954e8ab265900f5b279,2,27,9,18,36,0,0,0,19,761,1,2,1,452,7,115,52,76,75,1,3594,3461,133,34,32,2,0,100,NoArch
03d16a3e1c7c98cd39a7fa908637b597a1cf2613,1,64,7,57,71,0,0,0,20,6,1,1,0,158,7,116,43,28,24,4,1701,1277,424,18,14,4,0,99.89697802,NoArch
b6dc4279a5fad80b0257d0e03fce51268448f402,2,46,13,33,59,0,0,0,21,5,1,2,0.616166193,527,7,117,29,84,80,4,4256,4018,238,42,38,4,0,100,NoArch
21c57aaa19798d243e0c5959312627b3c10564ae,2,126,2,124,128,1,0,1,4,118,1,2,0.422762344,314,1,118,29,236,226,10,1898,1387,511,14,7,7,0,99.86268452,NoArch
de8d93e9d5974cc545232a5e221e1f70a440abe8,1,1,0,1,1,1,0,1,9,57,1,1,0,71,5,119,30,1,1,0,591,582,9,1,1,0,0,100,NoArch
98c8b9dd4e86bd3fb57074234a3acf3b737cda23,8,183,126,57,309,3,0,3,40,125,1,3,2.38789623,1959,2,120,31,721,710,11,12917,12518,399,453,445,8,0,99.69178082,NoArch
927492ea1c6c9d98948f1cd4a3807037dff20268,4,74,5,69,79,2,0,2,11,574,1,3,0.553975684,1371,1,121,32,465,462,3,12132,11700,432,236,233,3,0,99.76084728,NoArch
705c4a84c96453e9da7dfcf5a749d1a6a58868c0,5,73,5,68,78,3,0,3,12,137,1,3,1.560097905,486,1,122,32,16,10,6,3854,3556,298,16,10,6,0,99.82940976,NoArch
56e7d5b439ca86e464f75d21ae5b0e4371eea20b,0,0,0,0,0,0,0,0,0,0,0,0,0,0,0,123,33,0,0,0,0,0,0,0,0,0,0,100,NoArch
62ca065f7be37cae52b0171a1fc23d6e9d22e2e5,0,0,0,0,0,0,0,0,0,0,0,0,0,0,0,124,33,0,0,0,0,0,0,0,0,0,0,100,NoArch
64d210049ac6a17cd06f0bbe44b5e9633b627c6c,0,0,0,0,0,0,0,0,0,0,0,0,0,0,0,125,34,0,0,0,0,0,0,0,0,0,0,100,NoArch
ad38ccbbcbb4bdba5e4d91f1acba49dd01c7a2bc,0,0,0,0,0,0,0,0,0,0,0,0,0,0,0,126,35,0,0,0,0,0,0,0,0,0,0,100,NoArch
a400a387497cbe78ab0060a93e7e856083dba7fe,1,1,1,0,2,0,0,0,3,1,1,1,0,97,1,127,36,3,3,0,548,548,0,3,3,0,0,100,NoArch
3f9ddd0ca4446f41589cea187589ab5a4c4d411a,1,1,7,6,8,0,0,0,20,16,1,1,0,829,8,128,37,131,131,0,5038,5069,31,19,19,0,0,100,NoArch
cfbe04c81aef42629fb2e403012cc6e9017511bf,0,0,0,0,0,0,0,0,0,0,0,0,0,0,0,129,38,0,0,0,0,0,0,0,0,0,0,100,NoArch
fd282f9ccdca5c7a933292953d0b7f9896c35ee6,1,15,1,14,16,0,0,0,2,121,1,1,0,138,2,130,38,23,19,4,861,764,97,21,19,2,0,100,NoArch
4e46a838399b54a8570caa19475bf3eafb97d981,0,0,0,0,0,0,0,0,0,0,0,0,0,0,0,131,39,0,0,0,0,0,0,0,0,0,0,100,NoArch
7e2ffcba007f92d2910a3eaf7642be0da7b63519,0,0,0,0,0,0,0,0,0,0,0,0,0,0,0,132,40,0,0,0,0,0,0,0,0,0,0,100,NoArch
0de407b08ef57be4bffa1c88d9591a6dbb4c5cec,0,0,0,0,0,0,0,0,0,0,0,0,0,0,0,133,41,0,0,0,0,0,0,0,0,0,0,100,NoArch
e648f958ae1dc1159e25d5f1f54fefffa0ff7074,0,0,0,0,0,0,0,0,0,0,0,0,0,0,0,134,42,0,0,0,0,0,0,0,0,0,0,100,NoArch
c34bf912fcb7492c2bdc18c9f18eea1e671e2cd0,0,0,0,0,0,0,0,0,0,0,0,0,0,0,0,135,42,0,0,0,0,0,0,0,0,0,0,100,NoArch
9974b836498237676fbb66544473b97c673fb7dc,0,0,0,0,0,0,0,0,0,0,0,0,0,0,0,136,43,0,0,0,0,0,0,0,0,0,0,100,NoArch
d94930c2f818ced294da1956eab31f10b4a54c98,0,0,0,0,0,0,0,0,0,0,0,0,0,0,0,137,44,0,0,0,0,0,0,0,0,0,0,100,NoArch
a68e7d6453e790555a7c137b7771ebfc23568494,0,0,0,0,0,0,0,0,0,0,0,0,0,0,0,138,45,0,0,0,0,0,0,0,0,0,0,100,NoArch
981abc5bbe00ea3e0f3a5049decb2a630c41875a,0,0,0,0,0,0,0,0,0,0,0,0,0,0,0,139,46,0,0,0,0,0,0,0,0,0,0,100,NoArch
f0dac8e86a47dfde69c86340b429cc4fbf5f85c7,0,0,0,0,0,0,0,0,0,0,0,0,0,0,0,140,47,0,0,0,0,0,0,0,0,0,0,100,NoArch
d20f52d0bdeee80076696998b40805371d17118f,0,0,0,0,0,0,0,0,0,0,0,0,0,0,0,141,48,0,0,0,0,0,0,0,0,0,0,100,NoArch
58a81fb4527cd210adedde1238fa132cf6433b6f,0,0,0,0,0,0,0,0,0,0,0,0,0,0,0,142,49,0,0,0,0,0,0,0,0,0,0,100,NoArch
8eafeb8d87917e87becadda51c6181e790ee5849,1,4,0,4,4,1,0,1,15,59,1,1,0,118,7,143,50,20,19,1,512,488,24,17,16,1,0,100,NoArch
5d891147f3b75594a1b9ed52e3f906e655033b09,0,0,0,0,0,0,0,0,0,0,0,0,0,0,0,144,51,0,0,0,0,0,0,0,0,0,0,100,NoArch
27bf83e41c1f67920a59c4c07ace880b1430013b,1,25,21,4,46,0,0,0,31,70,1,1,0,483,9,145,52,54,52,2,2089,2094,5,14,12,2,0,100,NoArch
1bc91cadd22c88501689d6496b8bee5975269b15,0,0,0,0,0,0,0,0,0,0,0,0,0,0,0,146,53,0,0,0,0,0,0,0,0,0,0,100,NoArch
a299c8605020291e015065da41f32882c7dabbd7,7,115,248,133,363,0,0,0,3,2989,1,1,2.399809686,774,2,147,54,28,29,1,885,907,22,16,17,1,0,100,NoArch
bb3cb23376975209b8e0d1106ff344a9ee055705,0,0,0,0,0,0,0,0,0,0,0,0,0,0,0,148,55,0,0,0,0,0,0,0,0,0,0,100,NoArch
7a611b3b7bc0860217108dcef5024261c2045416,0,0,0,0,0,0,0,0,0,0,0,0,0,0,0,149,56,0,0,0,0,0,0,0,0,0,0,100,NoArch
c4257be9144e79f58974f8030f5757bea8f71067,0,0,0,0,0,0,0,0,0,0,0,0,0,0,0,150,57,0,0,0,0,0,0,0,0,0,0,100,NoArch
9612b3ee80a9e9a14cc6ad43972620e88235c363,0,0,0,0,0,0,0,0,0,0,0,0,0,0,0,151,58,0,0,0,0,0,0,0,0,0,0,100,NoArch
71c5cfcc84d8593f1221c2737b407f093f578b00,0,0,0,0,0,0,0,0,0,0,0,0,0,0,0,152,59,0,0,0,0,0,0,0,0,0,0,100,NoArch
2b778789617b49c5e0761ba520f8e40e79949a97,0,0,0,0,0,0,0,0,0,0,0,0,0,0,0,153,60,0,0,0,0,0,0,0,0,0,0,100,NoArch
fe8c18bc3de9825b1c752d3a030e6167002cc27d,0,0,0,0,0,0,0,0,0,0,0,0,0,0,0,154,61,0,0,0,0,0,0,0,0,0,0,100,NoArch
b151004d9a57eb9e2edd5196baa78a98fb2db25e,0,0,0,0,0,0,0,0,0,0,0,0,0,0,0,155,48,0,0,0,0,0,0,0,0,0,0,100,NoArch
b994871856dc087ad757ba2da1acd8c62a6fefa0,0,0,0,0,0,0,0,0,0,0,0,0,0,0,0,156,48,0,0,0,0,0,0,0,0,0,0,100,NoArch
ff9ff21f9f362e05ba7a697de7247b31300af5b6,1,5,5,0,10,0,0,0,21,23,1,1,0,823,8,157,48,132,131,1,5042,5038,4,19,19,0,0,100,NoArch
7b0f7df668f308a6e75040c05ffe5d5222fb1e3c,0,0,0,0,0,0,0,0,0,0,0,0,0,0,0,158,45,0,0,0,0,0,0,0,0,0,0,100,NoArch
41288482327bf2accae168bfd8683c50f6b6fedc,0,0,0,0,0,0,0,0,0,0,0,0,0,0,0,159,43,0,0,0,0,0,0,0,0,0,0,100,NoArch
dcc5efc8284dd269ffa015d898518a6130ed81b8,1,3,1,2,4,0,0,0,5,176,1,1,0,204,3,12,0,25,25,0,549,529,20,16,16,0,0,100,NoArch
48a4ae4e3bf64019e925a6303ff85d274cad5a37,1,0,1,1,1,0,0,0,22,6,1,1,0,823,8,160,44,132,132,0,5042,5042,0,19,19,0,0,100,NoArch
0217406df273b116a19885fab607675f07482f66,0,0,0,0,0,0,0,0,0,0,0,0,0,0,0,161,44,0,0,0,0,0,0,0,0,0,0,100,NoArch
39025a45f3c866e95170014134f2e171dd26fca4,0,0,0,0,0,0,0,0,0,0,0,0,0,0,0,162,45,0,0,0,0,0,0,0,0,0,0,100,NoArch
cb7f0ea37ae0cde421630a1d3508a40d5049092f,0,0,0,0,0,0,0,0,0,0,0,0,0,0,0,163,46,0,0,0,0,0,0,0,0,0,0,100,NoArch
5869de85038a39c4ee6a670d931e44ad0ebb6f52,0,0,0,0,0,0,0,0,0,0,0,0,0,0,0,164,47,0,0,0,0,0,0,0,0,0,0,100,NoArch
d2c18288dc49ce15a6e1d45f04634d5c7468118c,0,0,0,0,0,0,0,0,0,0,0,0,0,0,0,60,0,0,0,0,0,0,0,0,0,0,0,100,NoArch
9c9a7507f5e0f293fd9ab8719217ed03f11074b6,0,0,0,0,0,0,0,0,0,0,0,0,0,0,0,61,1,0,0,0,0,0,0,0,0,0,0,100,NoArch
d35f8a6186ab31c0e592b713b27f384b56481018,1,5,10,5,15,0,0,0,23,4,1,1,0,822,8,165,48,131,132,1,5020,5042,22,19,19,0,0,100,NoArch
22ebc0e9583ae105891495fa8f4345004ac9768e,0,0,0,0,0,0,0,0,0,0,0,0,0,0,0,166,48,0,0,0,0,0,0,0,0,0,0,100,NoArch
fc83be67b35213b49e222a150438a5c8eaee4727,1,6,0,6,6,1,0,1,3,29,1,1,0,152,2,167,49,24,23,1,918,861,57,22,21,1,0,100,NoArch
6a5eda43e537077c910d3eb4fbeba0136d600ba7,1,1,1,0,2,0,0,0,24,0,1,1,0,817,8,168,50,131,131,0,5020,5020,0,19,19,0,0,100,NoArch
d7c5d65b8736d7655e703b67cf29c2eb249a39c1,3,0,9981,9981,9981,0,0,0,5,51,1,1,0.872230216,9981,3,62,2,0,2783,2783,0,50586,50586,0,236,236,0,99.58819492,NoArch
c2a500217b09db7bfa147dcff879df10bd7a7fe0,0,0,0,0,0,0,0,0,0,0,0,0,0,0,0,63,3,0,0,0,0,0,0,0,0,0,0,100,NoArch
9732a5bd9fcea5b15f600ecc1492b2ce5cea47e1,3,86,86,0,172,0,0,0,25,1452,1,2,0.476490488,1047,8,169,49,153,154,1,5487,5478,9,36,36,0,0,100,NoArch
16c219f097baf0791f01ce0a445349da14ce0237,1,90,80,10,170,0,0,0,26,2,1,1,0,816,8,170,46,130,130,0,5026,5029,3,22,19,3,0,100,NoArch
58bf9b93da5d7b0cd1fc34ce9ab10a7e38f968e8,0,0,0,0,0,0,0,0,0,0,0,0,0,0,0,171,45,0,0,0,0,0,0,0,0,0,0,100,NoArch
ca9d0d7e4822c36d1d26474e4ae07bea001863ee,0,0,0,0,0,0,0,0,0,0,0,0,0,0,0,172,46,0,0,0,0,0,0,0,0,0,0,100,NoArch
67616736fcdf4068d8d29f9555a79b8bf85a0ec4,2,45,45,0,90,1,0,1,4,78,1,2,0.26231122,310,2,173,47,37,36,1,1894,1868,26,35,34,1,0,100,NoArch
78594c6df22cd0a5dcc3c936c85ea291cfac03c3,0,0,0,0,0,0,0,0,0,0,0,0,0,0,0,13,1,0,0,0,0,0,0,0,0,0,0,100,NoArch
1d55c495c9ca713b08287ea98468436504c697a5,3,38,73,35,111,0,0,0,121,129,1,1,0.432079566,3986,1,14,2,630,640,10,21708,21853,145,177,178,1,0,100,NoArch
880d9daa9575f9d61aa1a6bcf018073f43ae351e,0,0,0,0,0,0,0,0,0,0,0,0,0,0,0,174,33,0,0,0,0,0,0,0,0,0,0,100,NoArch
7848fc9bf2f91438f32537cfaff68e93eb49160f,1,3,13,10,16,0,0,0,5,3545,1,1,0,122,2,175,20,6,6,0,555,529,26,6,6,0,0,100,NoArch
7b676c5ca630bbf73cff11b55b09f7b1ab623198,1,46,45,1,91,0,0,0,54,331,1,1,0,570,15,176,21,72,71,1,2082,2064,18,40,39,1,0,100,NoArch
12d39381f6057f1ac28a395d81681377ed7b7a3e,1,2,4,2,6,0,0,0,6,2,1,1,0,112,2,177,22,6,6,0,544,555,11,6,6,0,0,100,NoArch
905b980227d94ff6e95bacacb6fc059a3362462f,36,2113,0,2113,2113,36,0,36,13,1,1,4,4.630998767,75,5,122,0,258,1,257,8923,618,8305,189,1,188,0,97.27731092,Arch
262847b6a882847f94fac61e1e5b832e98ff3de0,1,57,0,57,57,1,0,1,1,0,1,1,0,0,1,123,1,2,0,2,219,0,219,2,0,2,0,99.86919555,NoArch
a40409fddbd8c58395d33357e99119ab43b42d22,2,4,2,2,6,0,0,0,2,0,1,2,0.918295834,321,2,178,23,37,37,0,1356,1337,19,11,11,0,0,100,NoArch
7ab6d671c0facc387e7b99ff2b17db25b59290cb,1,13,7,6,20,0,0,0,2,0,1,1,0,57,2,179,24,2,2,0,255,219,36,2,2,0,0,100,NoArch
76927cea64dbacc4ffbd648c16cb7d62f8a67d1f,4,26,31,5,57,0,0,0,3,0,1,2,1.616539414,409,2,180,25,34,36,2,1814,1807,7,24,24,0,0,100,NoArch
e3e137dcff1fd76ae769ee77f5c633c6fb1dd672,0,0,0,0,0,0,0,0,0,0,0,0,0,0,0,181,26,0,0,0,0,0,0,0,0,0,0,100,NoArch
f1770bd192a6b4282f222648795b50d21a974064,1,1,1,0,2,0,0,0,37,128,1,1,0,856,4,182,27,185,185,0,5603,5603,0,49,49,0,1,100,NoArch
69a42ff4d774b05a3021e1fe0b39c07812ad3846,0,0,0,0,0,0,0,0,0,0,0,0,0,0,0,64,4,0,0,0,0,0,0,0,0,0,0,100,NoArch
3d43a3f60212b6a3fbe6fadf8fcef9563397397a,0,0,0,0,0,0,0,0,0,0,0,0,0,0,0,183,28,0,0,0,0,0,0,0,0,0,0,100,NoArch
7c320e3af3aad7df4adb572ecc89aeca51f3a3bb,8,110,24,86,134,2,0,2,4,6,1,3,2.346820017,602,2,124,2,103,95,8,3289,2917,372,71,64,7,0,99.60886571,NoArch
ba967f594eb869fd5908133342d34278730a7e61,122,2035,2122,87,4157,3,0,3,65,1774,1,29,5.188629828,12587,2,184,25,977,977,0,43856,44773,917,806,806,0,0,97.17012175,Arch
4e3e1d2bac858eb37750fb9d7d91a7271debce3f,3,38,3,35,41,1,0,1,3,96,1,2,1.549455716,421,1,125,3,62,54,8,2296,2095,201,23,22,1,0,99.39434724,NoArch
59a060d1dc51290b06f94ae153eb55c5d6ef2001,1,2,2,0,4,0,0,0,82,89,1,1,0,756,12,0,0,134,134,0,3896,3896,0,48,48,0,1,100,NoArch
96bda46c343e03cd179b2e425453ed968a21cb5f,1,3,0,3,3,1,0,1,27,35,1,1,0,826,9,1,1,131,130,1,5050,5026,24,22,22,0,1,100,NoArch
3699bd635030e90b1d06c58e8ee373a32075b572,0,0,0,0,0,0,0,0,0,0,0,0,0,0,0,2,2,0,0,0,0,0,0,0,0,0,0,100,NoArch
d62e5d2778424bd44bfe4d7753cf9bd91502d2c6,1,0,36,36,36,0,0,0,12,377,1,1,0,186,5,512,0,21,27,6,378,537,159,19,25,6,0,100,NoArch
4f2b4a6040b1d324db573705da29e8ce92c8bf11,1,1,1,0,2,0,0,0,16,223,1,1,0,624,5,513,1,70,70,0,1484,1486,2,37,37,0,0,100,NoArch
6343b98e0c5d634e9ea687f7237ac2a82f768020,0,0,0,0,0,0,0,0,0,0,0,0,0,0,0,514,2,0,0,0,0,0,0,0,0,0,0,100,NoArch
37af1ef26e15a6fa5a61f4f8c260e3a04b9d3e2f,0,0,0,0,0,0,0,0,0,0,0,0,0,0,0,515,3,0,0,0,0,0,0,0,0,0,0,100,NoArch
65bb1723be1902089782395fc1bcd057db0f805d,2,23,3,20,26,0,0,0,122,172,1,1,0.98285869,4057,9,516,4,654,650,4,22888,22766,122,168,167,1,0,100,NoArch
2451ea59e1a31fee8effb97b8d33f4d3351197b5,0,0,0,0,0,0,0,0,0,0,0,0,0,0,0,517,5,0,0,0,0,0,0,0,0,0,0,100,NoArch
2c5b3afae67291110ac9729f596299c5f18002cc,1,15,36,21,51,0,0,0,28,10,1,1,0,829,9,3,3,125,131,6,4930,5050,120,22,22,0,1,100,NoArch
1b4bb5d70cc93a81849ea3fb9e243287c8a9b120,0,0,0,0,0,0,0,0,0,0,0,0,0,0,0,4,4,0,0,0,0,0,0,0,0,0,0,100,NoArch
bc88f036a253e1553408ca32e8f553e58d69e5a8,0,0,0,0,0,0,0,0,0,0,0,0,0,0,0,5,5,0,0,0,0,0,0,0,0,0,0,100,NoArch
d439ebdeac99f0f0d0cbce5c11f1bf98d9c914e5,0,0,0,0,0,0,0,0,0,0,0,0,0,0,0,6,6,0,0,0,0,0,0,0,0,0,1,100,NoArch
0af989ac0dc7988a3741440d6ba8fe1b044d5703,1,92,28,64,120,0,0,0,240,109,1,1,0,7282,21,26,0,1079,1071,8,28585,28423,162,490,485,5,1,100,NoArch
ef683efb1e184a9cbad9e4899752ee53ed707fbb,1,8,1,7,9,0,0,0,123,18,1,1,0,3437,11,518,6,559,559,0,19165,19141,24,147,147,0,1,100,NoArch
5b0ac99c07d92ce1fe1a4001482aa8ae44bcea36,0,0,0,0,0,0,0,0,0,0,0,0,0,0,0,519,7,0,0,0,0,0,0,0,0,0,0,100,NoArch
22d5aa429beae17aa27fca26732009a43a6e32f9,1,16,0,16,16,1,0,1,124,0,1,1,0,3444,11,520,8,562,559,3,19239,19165,74,148,147,1,0,100,NoArch
c476474994bc74aa4cab5360e2fae6a028cea0e2,0,0,0,0,0,0,0,0,0,0,0,0,0,0,0,521,9,0,0,0,0,0,0,0,0,0,0,100,NoArch
9b6950f5e50894c5b48ccb6c2bb1c8418cb006e0,1,16,14,2,30,0,0,0,80,158,1,1,0,2303,9,522,10,457,456,1,12004,11967,37,101,101,0,0,100,NoArch
ce7b3d3a6bdda23a3516fa412ccac3491a11e9e6,0,0,0,0,0,0,0,0,0,0,0,0,0,0,0,523,11,0,0,0,0,0,0,0,0,0,0,100,NoArch
385b22827b7a1679a2eacaa17f5f3e52fd814638,1,42,8,34,50,0,0,0,38,35,1,1,0,856,4,524,12,197,185,12,5778,5603,175,51,49,2,0,100,NoArch
0c77dd66e834754b9d73a7c50438825609a21c70,1,12,1,11,13,0,0,0,10,243,1,1,0,468,1,525,13,88,86,2,2646,2577,69,25,24,1,0,100,NoArch
2369b4296a63270a9fd882e96b59fd60393ab115,1,2,0,2,2,1,0,1,61,19,1,1,0,640,9,526,14,96,95,1,3755,3747,8,21,21,0,0,100,NoArch
1e8a16d67bce27aba60b3d5818bbc39ec8d2998c,0,0,0,0,0,0,0,0,0,0,0,0,0,0,0,185,3,0,0,0,0,0,0,0,0,0,0,100,NoArch
3772682e4991898fd7a0bd2cc3e94cb691182233,0,0,0,0,0,0,0,0,0,0,0,0,0,0,0,186,4,0,0,0,0,0,0,0,0,0,0,100,NoArch
5e16342ec7e285528e928fa22dd139774179934d,18,114,48,66,162,2,0,2,163,143,1,4,3.141229051,5524,5,8,0,1060,1056,4,27579,27605,26,285,281,4,0,99.21875,NoArch
46b374451158886b9ea83893b644215a08da6ca4,1,0,10,10,10,0,0,0,3,37,1,1,0,9,3,9,1,0,1,1,0,39,39,0,1,1,0,99.93206522,NoArch
28ad3caf076beee82d01fb890aec0a8456a284fd,4,14,36,22,50,0,0,0,164,0,1,1,1.862387426,2750,10,10,2,542,546,4,14495,14611,116,135,137,2,0,100,NoArch
86781fe0e44491e18a58d9c8571cf9727cc4b875,4,196,7,189,203,2,0,2,20,38,1,2,1.891487592,198,4,11,3,36,21,15,1179,736,443,21,16,5,1,99.79640312,NoArch
f85db7acbe456a7e6da494cd94d5ec222dde83ed,1,21,33,12,54,0,0,0,29,24,1,1,0,808,9,7,7,124,125,1,4928,4930,2,22,22,0,2,100,NoArch
661980bdd1f0e3330ce3f8ea6ed82a670d76eb89,1,18,0,18,18,1,0,1,30,0,1,1,0,796,9,8,8,124,124,0,4928,4928,0,22,22,0,0,100,NoArch
11f40bd332223d5e1c2f163f43e26289e44b2b82,0,0,0,0,0,0,0,0,0,0,0,0,0,0,0,126,1,0,0,0,0,0,0,0,0,0,0,100,NoArch
b5b8df7b414963da895bda5c822f5e50072825bc,1,2,1,1,3,0,0,0,6,1686,1,1,0,83,4,527,15,6,6,0,137,136,1,6,6,0,0,100,NoArch
b2554bdf2507d963de975e29e48f5917bd458f50,0,0,0,0,0,0,0,0,0,0,0,0,0,0,0,127,1,0,0,0,0,0,0,0,0,0,0,100,NoArch
64e95d5e5a7c4905337fe95b3d7942f733424c46,0,0,0,0,0,0,0,0,0,0,0,0,0,0,0,65,0,0,0,0,0,0,0,0,0,0,1,100,NoArch
1ce01bde6980b47e3c56ebead6deb7dfd52669a5,1,1,1,0,2,0,0,0,81,20,1,1,0,2305,9,15,0,457,457,0,12004,12004,0,101,101,0,1,100,NoArch
cf80466f2d086ecf87537edc669ad630a443b0a7,8,41,41,0,82,2,0,2,241,328,1,7,2.54146268,14793,3,528,16,2330,2328,2,66178,66205,27,882,883,1,0,100,NoArch
6a749951b744d61eeaccefdb877920dac593c92c,1,9,4,5,13,0,0,0,10,902,1,1,0,163,7,12,4,22,21,1,782,764,18,11,11,0,1,100,NoArch
d8d36e5f72b7c8e6fe00a1ba03177841e7f275f9,1,36,8,28,44,0,0,0,34,786,1,1,0,569,11,13,5,72,68,4,2113,2032,81,25,23,2,1,100,NoArch
8ebe8f3910b3028ef08f97bc58188a7099698410,1,3,0,3,3,1,0,1,23,12,1,1,0,258,7,529,11,43,42,1,986,959,27,29,29,0,0,100,NoArch
3a9204bca97929a8282b4ebfe6e1f9b47a432926,15,906,453,453,1359,13,0,13,31,0,1,2,3.024997304,876,1,9,6,150,124,26,6113,4958,1155,43,22,21,0,98.89373114,NoArch
7bd1d92f118d391e06d723d86d33d92af3b6fd51,0,0,0,0,0,0,0,0,0,0,0,0,0,0,0,225,0,0,0,0,0,0,0,0,0,0,0,100,NoArch
572ee5b13788bd34f59aa267fc85a4a57ff21772,0,0,0,0,0,0,0,0,0,0,0,0,0,0,0,66,1,0,0,0,0,0,0,0,0,0,0,100,NoArch
56a92c23d34e1aa196533c5356d922b1fbe80b34,0,0,0,0,0,0,0,0,0,0,0,0,0,0,0,67,2,0,0,0,0,0,0,0,0,0,0,100,NoArch
17fc494c15580c2c1626f093bf53807bbec39957,0,0,0,0,0,0,0,0,0,0,0,0,0,0,0,10,3,0,0,0,0,0,0,0,0,0,0,100,NoArch
9a86a33256a6696f4ece864f0d26aab09e3f2a7d,0,0,0,0,0,0,0,0,0,0,0,0,0,0,0,68,3,0,0,0,0,0,0,0,0,0,0,100,NoArch
732dbd0f560eff9428a596e869096a0a682fef00,0,0,0,0,0,0,0,0,0,0,0,0,0,0,0,69,4,0,0,0,0,0,0,0,0,0,0,100,NoArch
5ac78dcd40766806665a15ac47e305ba0ff488ae,1,19,28,9,47,0,0,0,81,20,1,1,0,854,12,530,11,120,122,2,3153,3199,46,61,61,0,0,100,NoArch
04e64b8fedc1f696ec3626773b68478d8d615cab,8,60,122,62,182,1,0,1,82,818,1,5,2.192257652,5700,6,531,10,1147,1150,3,29638,29767,129,286,286,0,0,99.93359894,NoArch
b152411fd16b33f194b6b565960f2432f76e4a16,3,85,0,85,85,3,0,3,1,0,1,1,1.49953912,0,1,532,11,8,0,8,372,0,372,6,0,6,1,99.76798144,NoArch
4bf159bd155c27f0d2bc873402a1871b83410fa7,1,1,1,0,2,0,0,0,39,41,1,1,0,890,4,533,10,197,197,0,5778,5778,0,51,51,0,0,100,NoArch
52b7201ac33ff19211111cd2ec6af9267b0b10fc,1,77,49,28,126,0,0,0,126,20,1,1,0,3472,11,534,8,559,565,6,19342,19303,39,147,149,2,0,100,NoArch
c5c7ee6974065497e69f8c6ce6fbda05c25b2e36,1,16,1,15,17,0,0,0,3,1693,1,1,0,29,1,535,8,5,2,3,257,133,124,5,2,3,2,100,NoArch
e6182a43e02a74afda2f6752a90f0d9165c6f231,1,6,0,6,6,1,0,1,242,22,1,1,0,7350,21,536,9,1083,1080,3,28629,28605,24,491,491,0,1,100,NoArch
ee7b74db09c689b4fd88d637915dc940270c644d,1,2,2,0,4,0,0,0,24,299,1,1,0,1262,6,226,1,203,203,0,6016,6017,1,122,122,0,1,100,NoArch
8fec295a839c2e5e993a9bdc54df21a2029b013c,1,20,0,20,20,1,0,1,243,0,1,1,0,7356,21,227,2,1084,1083,1,28661,28629,32,492,491,1,1,100,NoArch
4b69769c9f17ed70723fc95142adc836fd655b07,1,1,1,0,2,0,0,0,23,2,1,1,0,965,6,537,10,310,310,0,6902,6886,16,38,38,0,1,100,NoArch
fb3b750bfdfc18bef2d91327a60957fbe5763743,1,21,0,21,21,1,0,1,63,380,1,1,0,451,8,538,11,67,67,0,1424,1424,0,39,39,0,0,100,NoArch
9b9adad8e7aec34bf0ed79cfeebe2db4e70fa3d9,1,21,4,17,25,0,0,0,69,3,1,1,0,2239,6,539,12,507,501,6,13365,13225,140,100,100,0,2,100,NoArch
d179cb955786b872bf32abe2fb7e0a8e5c8462b8,0,0,0,0,0,0,0,0,0,0,0,0,0,0,0,540,13,0,0,0,0,0,0,0,0,0,0,100,NoArch
28890aca0ce1c1096b7f3f2feb4deee66e71c499,1,8,50,42,58,0,0,0,127,3,1,1,0,3500,11,541,14,559,559,0,19153,19342,189,147,147,0,0,100,NoArch
c368a7248a31fdc47c36e8b44f22a2a63aba1138,0,0,0,0,0,0,0,0,0,0,0,0,0,0,0,187,2,0,0,0,0,0,0,0,0,0,0,100,NoArch
ff98e6a7460ea991463a8770a9c7a6fca5db7769,1,12,10,2,22,0,0,0,55,256,1,1,0,71,12,188,3,3,3,0,124,101,23,1,1,0,0,100,NoArch
5bd86628e4b3a07e8a8f3443b202e4636520fa06,1,2,6,4,8,0,0,0,25,3,1,1,0,1262,7,189,2,203,203,0,6007,6016,9,122,122,0,0,100,NoArch
75644b34fdfc2052ad14fef4d1926d5f2ffdbb65,1,2,1,1,3,0,0,0,17,73,1,1,0,120,7,190,3,20,20,0,512,512,0,17,17,0,0,100,NoArch
d346803788eb765afecbe031bae9633e2d841b5f,0,0,0,0,0,0,0,0,0,0,0,0,0,0,0,191,4,0,0,0,0,0,0,0,0,0,0,100,NoArch
4aa1e077b152bca8142340bed9d3c12f265b6989,0,0,0,0,0,0,0,0,0,0,0,0,0,0,0,192,5,0,0,0,0,0,0,0,0,0,0,100,NoArch
d49bc11433f4d500f5135f30e88627ed8836efe6,1,2,2,0,4,0,0,0,15,444,1,1,0,178,6,193,6,19,19,0,470,470,0,18,18,0,0,100,NoArch
9ea064f6acd91d7788320608e4432f1ab59eb9dd,0,0,0,0,0,0,0,0,0,0,0,0,0,0,0,194,7,0,0,0,0,0,0,0,0,0,0,100,NoArch
8b5f4006f721c81eddfcbfcde366c7fa4368fd19,6,246,119,127,365,0,0,0,83,321,1,5,1.74915255,5083,2,195,8,1005,966,39,25850,25147,703,318,306,12,1,100,NoArch
484a49e38d028fc5da2f2095d705eb66dd576434,0,0,0,0,0,0,0,0,0,0,0,0,0,0,0,196,9,0,0,0,0,0,0,0,0,0,0,100,NoArch
e81393619982594fdb27d6a1a8e9401af4deb2c0,0,0,0,0,0,0,0,0,0,0,0,0,0,0,0,197,10,0,0,0,0,0,0,0,0,0,0,100,NoArch
bd12e1d6eae55330be119379495772c6bf9cf616,0,0,0,0,0,0,0,0,0,0,0,0,0,0,0,198,11,0,0,0,0,0,0,0,0,0,0,100,NoArch
1ef6f28a7d390f7232ba67cef9a1666cdcf507b9,1,1,2,1,3,0,0,0,18,2,1,1,0,121,7,199,12,20,20,0,512,512,0,17,17,0,0,100,NoArch
124384c585757707d037c15ff87c5440808297e9,0,0,0,0,0,0,0,0,0,0,0,0,0,0,0,200,13,0,0,0,0,0,0,0,0,0,0,100,NoArch
f1d9c084fde56e203fb06a51e659a63119fdf458,9,76,80,4,156,3,0,3,66,16,1,1,2.588481396,253,1,201,14,9,8,1,721,599,122,7,6,1,0,98.74876523,NoArch
7891943845b2f53878f36864a055c6a0acbf4346,2,8,2,6,10,0,0,0,83,6,1,2,1,1816,4,542,15,342,342,0,9423,9379,44,117,117,0,1,100,NoArch
a499384db2d13a29bdb9c17d90a20e2a6b9e67b8,1,14,0,14,14,1,0,1,1,0,1,1,0,0,1,202,15,1,0,1,36,0,36,1,0,1,0,99.9017038,NoArch
1210e2355da496b99d0e1fd5b3a78c8f58d125e9,0,0,0,0,0,0,0,0,0,0,0,0,0,0,0,203,16,0,0,0,0,0,0,0,0,0,0,100,NoArch
5d4919fff9a7e085d92b35169ffc6ab677ea7654,1,4,1,3,5,0,0,0,2,0,1,1,0,73,1,204,17,9,3,6,188,124,64,1,1,0,0,100,NoArch
1b72802a04df5e2b0841855a610843de7ce2ea24,0,0,0,0,0,0,0,0,0,0,0,0,0,0,0,205,18,0,0,0,0,0,0,0,0,0,0,100,NoArch
c83f98cc9de4e0046ee03b7c5dea4f8c92e8e0aa,0,0,0,0,0,0,0,0,0,0,0,0,0,0,0,206,19,0,0,0,0,0,0,0,0,0,0,100,NoArch
09c9dc22cdaae3e3423e7dc29d4cefeefa7922a0,0,0,0,0,0,0,0,0,0,0,0,0,0,0,0,207,20,0,0,0,0,0,0,0,0,0,0,100,NoArch
c0a9e4cbe89418934b26fc3e80af74a90fbda4af,0,0,0,0,0,0,0,0,0,0,0,0,0,0,0,208,21,0,0,0,0,0,0,0,0,0,0,100,NoArch
dca2b4c33a0bc853ac9115cfb1cea5ca2dc799be,0,0,0,0,0,0,0,0,0,0,0,0,0,0,0,209,22,0,0,0,0,0,0,0,0,0,0,100,NoArch
f1f9f7dad43daef9dafd31cee92440400adfa151,2,18,1,17,19,1,0,1,16,646,1,2,0.485460761,688,6,27,0,69,68,1,2768,2646,122,36,35,1,1,100,NoArch
f685502e6c6e58c3456d91779ad4b382d6727680,0,0,0,0,0,0,0,0,0,0,0,0,0,0,0,28,1,0,0,0,0,0,0,0,0,0,0,100,NoArch
07b4a220fa2fb3c82347a13f80c8a785c51c95c4,1,2,2,0,4,0,0,0,10,1340,1,1,0,229,6,228,3,20,20,0,849,849,0,7,7,0,0,100,NoArch
f9a772e39f7d8735bd20b3c4765fc7d009757939,2,13,3,10,16,0,0,0,70,302,1,2,0.988699408,2284,1,543,16,512,509,3,13520,13444,76,103,102,1,0,100,NoArch
e86c1ea65406d7766c22a7cf691a8ae7c6158426,7,1019,0,1019,1019,7,0,7,21,10,1,2,1.61493109,258,1,14,2,173,23,150,4567,772,3795,71,14,57,0,99.51044386,NoArch
b3584f3bde0808218a93dcd4eeba302123344ac0,1,2,2,0,4,0,0,0,2,0,1,1,0,103,1,15,3,14,14,0,458,470,12,7,7,0,0,99.8699187,NoArch
7b35217e89e770b3a49ce0a34006e73084c77d23,0,0,0,0,0,0,0,0,0,0,0,0,0,0,0,16,4,0,0,0,0,0,0,0,0,0,0,100,NoArch
6b10d593b6ba4571cf57f53c32100ee98714de25,0,0,0,0,0,0,0,0,0,0,0,0,0,0,0,17,5,0,0,0,0,0,0,0,0,0,0,100,NoArch
e165aed171289edecd6685f1bdc72bdccdcb69d7,1,1,1,0,2,0,0,0,11,0,1,1,0,229,6,229,4,20,20,0,849,849,0,7,7,0,0,100,NoArch
680096804ad1582e07c190f380ffe88e869e6d16,0,0,0,0,0,0,0,0,0,0,0,0,0,0,0,210,23,0,0,0,0,0,0,0,0,0,1,100,NoArch
2f4d18abbef075cf35d2e2e74a803cfcd952e601,0,0,0,0,0,0,0,0,0,0,0,0,0,0,0,211,24,0,0,0,0,0,0,0,0,0,0,100,NoArch
d7fe54adea948a1aa82721deb2f49f4aca4ac107,23,499,101,398,600,9,0,9,32,14,1,2,3.91230372,1266,1,11,2,203,150,53,7955,6067,1888,55,43,12,0,99.41822883,NoArch
1f0883f6fb9d3b54dae5474de908bc30796d8e8a,0,0,0,0,0,0,0,0,0,0,0,0,0,0,0,212,25,0,0,0,0,0,0,0,0,0,0,100,NoArch
fd91e0f61480883276216d2cb6cd03edd69c5ed4,0,0,0,0,0,0,0,0,0,0,0,0,0,0,0,128,0,0,0,0,0,0,0,0,0,0,0,100,NoArch
6b1265a9df0c5e8099793959b6e024c2a7f1a951,1,13,0,13,13,1,0,1,5,29,1,1,0,257,3,16,0,58,55,3,824,773,51,32,29,3,1,100,NoArch
a22282dd2602adcbe176dc57b36658c04157f9fb,35,744,502,242,1246,18,4,22,193,494,1,10,4.145707873,16802,4,544,13,3599,3552,47,96155,94064,2091,1518,1497,21,0,98.12930752,NoArch
6d45753aa5804dce6afc76ebf07281ce56d21482,1,4,0,4,4,1,0,1,4,41,1,1,0,44,1,545,14,6,5,1,285,257,28,6,5,1,0,100,NoArch
db181de2fc3d13adec62308ac9926f5ab2f14aa3,1,80,5,75,85,0,0,0,129,0,1,1,0,3630,11,546,15,582,572,10,20445,20077,368,152,150,2,0,100,NoArch
9f079b77adcfb163500d1c674f1bc6cf5b6eaeb9,1,67,47,20,114,0,0,0,244,43,1,1,0,7376,21,213,24,1084,1084,0,28658,28661,3,492,492,0,0,100,NoArch
29736725aedc6cfe99bcd4da0300a9e13937804d,1,139,105,34,244,0,0,0,245,0,1,1,0,7396,21,214,25,1085,1084,1,28668,28658,10,493,492,1,1,100,NoArch
daa1f06c7a155d8c9740539c35271e23d6435cff,1,44,23,21,67,0,0,0,246,0,1,1,0,7430,21,215,26,1084,1085,1,28653,28668,15,493,493,0,0,100,NoArch
8d093afdbc4e1622599e1a931864d0100835a903,1,216,239,23,455,0,0,0,247,0,1,1,0,7451,21,216,27,1045,1084,39,28232,28653,421,498,493,5,1,100,NoArch
1c3efc0f8c936efbaca44515591d843cb759160b,1,33,6,27,39,0,0,0,248,0,1,1,0,7428,21,217,28,1045,1045,0,28213,28232,19,498,498,0,1,100,NoArch
9250c80f94053813ffaec7b6ecf1ae54ebbf44a3,0,0,0,0,0,0,0,0,0,0,0,0,0,0,0,218,29,0,0,0,0,0,0,0,0,0,0,100,NoArch
400ff33caf17df7fa64a219b72843a473891a109,0,0,0,0,0,0,0,0,0,0,0,0,0,0,0,219,30,0,0,0,0,0,0,0,0,0,0,100,NoArch
c7d041aadfe26ee3e40d384a39b8ec3f90848189,1,1,1,0,2,0,0,0,4,117,1,1,0,103,2,220,24,11,11,0,536,538,2,7,7,0,0,100,NoArch
a8409bf33dc73c53ce0c056d4ca73c68c958d841,2,9,9,0,18,0,0,0,4,2046,1,1,0.503258335,342,2,221,21,34,35,1,755,784,29,18,18,0,1,100,NoArch
dbb06195249aeb0788415c16e5af094a1f417590,2,20,20,0,40,1,0,1,5,0,1,1,0.769192829,342,2,222,18,37,34,3,816,755,61,20,18,2,1,100,NoArch
7b0aacc239a021a7b181baab8513162eb44e6901,6,95,47,48,142,1,0,1,6,105,1,3,1.823848868,578,2,129,1,84,81,3,3019,2654,365,48,46,2,0,100,NoArch
ea461d3270b3f82efceeb5773e8c336b9957b1f4,1,3,1,2,4,0,0,0,3,120,1,1,0,169,1,130,2,11,11,0,911,894,17,8,8,0,0,100,NoArch
2d8bc4dfb084d354ffe31e84a4ea1930a4bd1103,4,34,3,31,37,2,0,2,7,102,1,3,1.788480456,183,2,131,3,30,26,4,1209,1038,171,29,26,3,0,99.96646546,NoArch
40e501d43b7f5e837f788f21e7aee1bb293e990c,2,16,9,7,25,0,0,0,4,63,1,1,0.721928095,246,1,132,4,25,23,2,1295,1244,51,20,20,0,0,100,NoArch
2bdc0594715aeaeba1ce9ffadad880717daa1568,2,226,2,224,228,1,0,1,2,23,1,2,0.58515699,681,1,18,0,142,121,21,3553,2806,747,54,38,16,0,99.69859344,NoArch
5bfe3eb72c8f4730dc1175b1176285c59ce056b3,1,26,0,26,26,1,0,1,249,12,1,1,0,7455,22,19,1,1047,1045,2,28291,28213,78,499,498,1,0,100,NoArch
69c13587719df03923d8cc81d6461a8eca702b62,6,101,30,71,131,0,0,0,130,18,1,4,1.957706731,8903,4,547,3,1670,1650,20,48484,48011,473,450,443,7,0,100,NoArch
12d22e8e54ca1d36fc66b1d98b8f26b67446ab4c,1,53,60,7,113,0,0,0,2,255,1,1,0,369,2,548,4,75,75,0,1772,1792,20,30,30,0,0,100,NoArch
753a8c35ee49de311a07261780ecb253b42a7f1e,0,0,0,0,0,0,0,0,0,0,0,0,0,0,0,13,0,0,0,0,0,0,0,0,0,0,0,100,NoArch
1543feafc81c29d9d6b802031809931064d86cc6,1,28,2,26,30,0,0,0,3,2,1,1,0,362,2,549,5,75,75,0,1772,1772,0,30,30,0,0,100,NoArch
2187bee7ca7491e9e29751f1424d99bb89e5e117,7,255,6,249,261,6,0,6,33,6,1,2,2.768499908,536,1,12,0,101,83,18,3992,3316,676,27,21,6,0,99.60026649,NoArch
b02d5bc93c8c2630e8a55ca669ae177a81ec3fe3,0,0,0,0,0,0,0,0,0,0,0,0,0,0,0,70,0,0,0,0,0,0,0,0,0,0,0,100,NoArch
a12f7bd8c15926112c41faf22ae81b22eb08018f,0,0,0,0,0,0,0,0,0,0,0,0,0,0,0,71,1,0,0,0,0,0,0,0,0,0,0,100,NoArch
a1b8a5741cb9c92358b2199a537e4a1e82dcd319,1,23,8,15,31,0,0,0,109,111,1,1,0,292,14,14,1,49,46,3,1339,1254,85,16,15,1,1,100,NoArch
fed72b624817e9010f44a5557d10cc5005e1180d,16,140,563,423,703,2,13,15,34,35,1,2,3.980329602,1079,1,13,1,98,136,38,3912,5070,1158,25,34,9,0,98.9973262,NoArch
578e2694d634134f0d729b907b3974eb7dcfbea5,0,0,0,0,0,0,0,0,0,0,0,0,0,0,0,15,2,0,0,0,0,0,0,0,0,0,1,100,NoArch
842e90f84cd1f192687c9dc5a2dab8b28870f814,0,0,0,0,0,0,0,0,0,0,0,0,0,0,0,14,2,0,0,0,0,0,0,0,0,0,0,100,NoArch
c8d5e91f98d820b0cd8f53d750725260ef07b24b,2,38,23,15,61,0,0,0,83,152,1,2,0.943226155,836,4,223,7,140,138,2,4226,4062,164,53,51,2,0,100,NoArch
741437c185dc990cad0b499d7ab2dda1e315e031,6,63,61,2,124,0,0,0,7,202,1,2,0.591700652,588,1,224,3,83,67,16,2183,2032,151,27,24,3,0,99.32659933,NoArch
042dcea4516dc5a3d377c72cf81466944be7d271,2,2,2,0,4,0,0,0,2,0,1,1,1,44,1,225,4,2,2,0,176,176,0,2,2,0,0,99.86531987,NoArch
15ed6f44618d514f25e425f543a029702aa134fb,2,2,2,0,4,0,0,0,2,0,1,1,1,59,1,226,5,2,2,0,329,329,0,2,2,0,0,99.86531987,NoArch
5546ec0f04f1daee3efd6c1f1454ebafce238687,4,4,4,0,8,0,0,0,8,39,1,1,2,136,3,227,6,4,4,0,848,848,0,4,4,0,0,99.73063973,NoArch
8c7d5cbfd7e4944b5812e06971b8a9db632c30ff,0,0,0,0,0,0,0,0,0,0,0,0,0,0,0,113,0,0,0,0,0,0,0,0,0,0,0,100,NoArch
5166cfda6859b439a6cd4bcb6a7fa02850572e8d,1,39,16,23,55,0,0,0,8,438,1,1,0,187,1,226,0,27,24,3,805,683,122,11,11,0,0,100,NoArch
84b35331bc91aa9f16013f04788311ca59dfb72f,5,82,10,72,92,2,0,2,8,68,1,2,2.072943978,722,2,133,0,123,109,14,4256,3827,429,80,74,6,0,99.93265993,NoArch
76f21ccd4abe6353f6de55f5ea24adb009e34f0e,0,0,0,0,0,0,0,0,0,0,0,0,0,0,0,134,1,0,0,0,0,0,0,0,0,0,0,100,NoArch
bfa0e581ab18eddcf8a1b9fc1daf5518eca3aa3a,1,25,25,0,50,0,0,0,8,15,1,1,0,423,4,228,5,62,70,8,1781,1841,60,24,22,2,0,100,NoArch
d3da3a445cb721e5ad19f252e6ba0312798a1053,2,471,181,290,652,0,0,0,3,71,1,1,0.658265839,812,1,20,0,183,137,46,4739,3402,1337,64,46,18,0,99.76517947,NoArch
a829ba85e8fe194b5c2be4bcfca1395a75e2a63b,7,285,9,276,294,4,0,4,38,162,1,3,2.053050393,1512,2,135,2,305,275,30,9725,8774,951,209,193,16,0,99.6329663,NoArch
19501f70e0fe4ded7e35a2c3057c53f949dfbf84,0,0,0,0,0,0,0,0,0,0,0,0,0,0,0,229,6,0,0,0,0,0,0,0,0,0,0,100,NoArch
ec54d4cfc4ccd0a84e1085276b9f9a2a72c8707e,0,0,0,0,0,0,0,0,0,0,0,0,0,0,0,22,0,0,0,0,0,0,0,0,0,0,0,100,NoArch
8290407e98098164392f23801004a0e8cc3ab5f6,1,29,13,16,42,0,0,0,6,136,1,1,0,313,3,21,1,39,36,3,1206,1101,105,20,19,1,1,100,NoArch
f8efb9c344684a1baf4c550933da89fc688d8343,1,20,1,19,21,0,0,0,11,157,1,1,0,479,1,550,0,89,88,1,2662,2646,16,25,25,0,0,100,NoArch
9d3d661b0309ad559cbc650ed628fe2810255a2b,16,485,129,356,614,4,0,4,131,53,1,7,3.181876302,13477,6,551,1,2836,2742,94,74320,72086,2234,1019,985,34,0,99.06209573,NoArch
01c5b0acea4768edffd1b2609c651bfeb5121889,2,3,2,1,5,1,0,1,87,0,1,2,0.970950594,3515,4,552,2,729,731,2,19772,19777,5,165,165,0,0,100,NoArch
eda9819a7589923285be2b9fdf2c14ff92eb9cb7,0,0,0,0,0,0,0,0,0,0,0,0,0,0,0,230,7,0,0,0,0,0,0,0,0,0,0,100,NoArch
b6e16f01b544bc90ea3277db612f42f84708fe30,0,0,0,0,0,0,0,0,0,0,0,0,0,0,0,231,8,0,0,0,0,0,0,0,0,0,0,100,NoArch
b29c272389410549a87371f7d5a49b301105c08d,0,0,0,0,0,0,0,0,0,0,0,0,0,0,0,232,9,0,0,0,0,0,0,0,0,0,0,100,NoArch
b27a3b824346f400fb694985bcdd7311bed8e979,0,0,0,0,0,0,0,0,0,0,0,0,0,0,0,233,10,0,0,0,0,0,0,0,0,0,0,100,NoArch
d3ed5c490f5b38ce0a0cc285289568f64bd39b1b,0,0,0,0,0,0,0,0,0,0,0,0,0,0,0,234,11,0,0,0,0,0,0,0,0,0,0,100,NoArch
f8d872ed00eadeb7317d14be9638726f0cb919ec,1,1,1,0,2,0,0,0,250,73,1,1,0,7481,22,235,7,1047,1047,0,28291,28291,0,499,499,0,1,100,NoArch
19a0a119e0db4de660373247f659526bbd13e284,1,2,1,1,3,0,0,0,251,0,1,1,0,7481,22,236,8,1048,1047,1,28310,28291,19,499,499,0,1,100,NoArch
9d45bbb6aa62d080322f8d99d4e92205bfbbe412,0,0,0,0,0,0,0,0,0,0,0,0,0,0,0,237,9,0,0,0,0,0,0,0,0,0,0,100,NoArch
4c746a8ebfccf24a2266ed8c2f8793c31d67eb66,4,21,15,6,36,1,0,1,252,801,1,2,1.675822058,8227,22,238,10,1206,1204,2,31454,31432,22,573,573,0,1,100,NoArch
8c976cc5db08ab41377ff34f1a9538faad3097d0,17,2099,321,1778,2420,9,0,9,22,44,1,3,3.210189543,1289,1,239,11,307,193,114,10598,5345,5253,174,100,74,1,99.15704027,NoArch
59cf86ae79627422f1e09183881d743916f96a73,3,31,4,27,35,1,0,1,88,21,1,3,1.069385739,4356,7,553,3,909,896,13,22647,22449,198,246,245,1,0,100,NoArch
be973fcaca5f14fa353e4758d6bd720637334ae4,16,1582,1697,115,3279,0,0,0,194,664,1,5,1.669547257,9887,4,240,12,1721,1718,3,50346,51312,966,493,493,0,1,99.96898263,NoArch
41dda1ceebc3eaf683f871b1a4c4faee9c4c8f4d,0,0,0,0,0,0,0,0,0,0,0,0,0,0,0,241,13,0,0,0,0,0,0,0,0,0,1,100,NoArch
ef7c7e23a071b0f423b134ce295435153be5d579,0,0,0,0,0,0,0,0,0,0,0,0,0,0,0,242,13,0,0,0,0,0,0,0,0,0,1,100,NoArch
e662c8d5d20546fd83309a00be74e69184f70800,1,63,48,15,111,0,0,0,2,345,1,1,0,95,2,554,4,8,5,3,258,196,62,5,4,1,1,100,NoArch
c6d5fb371751026d3fb1c2ff820d889cf53a8ce0,0,0,0,0,0,0,0,0,0,0,0,0,0,0,0,243,14,0,0,0,0,0,0,0,0,0,1,100,NoArch
b8b960128e85f7121d0417cd80e56e928ed60f6d,1,276,277,1,553,0,0,0,28,334,1,1,0,834,9,244,15,180,179,1,4771,4745,26,89,89,0,1,100,NoArch
33494935fa58606358f426b93cd83735946d1bc1,0,0,0,0,0,0,0,0,0,0,0,0,0,0,0,245,16,0,0,0,0,0,0,0,0,0,1,100,NoArch
6f837d2ee34ecd0055b3eeb5a7693a9a354e8fd7,0,0,0,0,0,0,0,0,0,0,0,0,0,0,0,246,17,0,0,0,0,0,0,0,0,0,1,100,NoArch
0926ab687f4735cebcd84c834adeb86f50f85b7e,2,8,1,7,9,1,0,1,71,161,1,1,0.764204507,2475,6,247,18,545,545,0,14270,14270,0,134,134,0,1,100,NoArch
06a919c4df4e283e12ffae1c0ae4ccfd74360cdf,1,3,2,1,5,0,0,0,16,388,1,1,0,399,6,248,19,45,45,0,1522,1520,2,18,18,0,1,100,NoArch
83dc044d1987a92103ba260852a7ef53e0f1e30b,1,16,20,4,36,0,0,0,253,25,1,1,0,7488,22,6,0,1052,1050,2,28435,28349,86,500,499,1,1,100,NoArch
2f4b849263e3a7a1f6a86e7051af825f23af771d,1,7,1,6,8,0,0,0,4,53,1,1,0,942,1,22,0,164,163,1,4084,4063,21,54,54,0,0,100,NoArch
c8b650f66850e6c004327b7c638492499f337c87,1,2,0,2,2,1,0,1,25,619,1,1,0,218,10,23,1,24,23,1,602,584,18,13,13,0,0,100,NoArch
c90bca302da270f7bd432c3e75d4dfa00b1ee573,0,0,0,0,0,0,0,0,0,0,0,0,0,0,0,249,19,0,0,0,0,0,0,0,0,0,0,100,NoArch
5e6e1460b7542f961815a33d08e3067fc76bdb78,0,0,0,0,0,0,0,0,0,0,0,0,0,0,0,250,15,0,0,0,0,0,0,0,0,0,1,100,NoArch
00ad5c928a91d368dced140986f76703c4b67924,11,810,24,786,834,9,0,9,17,84,1,5,2.4968658,1459,5,555,2,298,161,137,9055,4186,4869,123,80,43,0,98.74155924,NoArch
246b6cd3e8171a78c46929a87880e860cc9af83a,0,0,0,0,0,0,0,0,0,0,0,0,0,0,0,556,3,0,0,0,0,0,0,0,0,0,0,100,NoArch
1e54518c95cec04cbc13970cca017aaf842609d1,1,3,3,0,6,0,0,0,17,14,1,1,0,400,6,72,0,45,45,0,1534,1522,12,18,18,0,0,100,NoArch
3c550dcd5fbae5a7230e5b8c5025ac81a16031e4,1,1,1,0,2,0,0,0,29,18,1,1,0,833,9,251,16,180,180,0,4771,4771,0,89,89,0,0,100,NoArch
8ec1fdfe00bb42d95cbaadc09600ff4c2331f47f,1,9,1,8,10,0,0,0,14,1077,1,1,0,167,2,557,4,16,14,2,335,298,37,9,7,2,0,100,NoArch
b709fbff0cc63f59b3eeb1370b8d598f06ca80d1,1,50,39,11,89,0,0,0,2,4,1,1,0,356,2,252,17,85,83,2,2481,2449,32,19,19,0,0,100,NoArch
0eec193b7ff1cb709e0b424b402b4f98326ddea6,1,14,6,8,20,0,0,0,90,25,1,1,0,2465,9,253,18,490,490,0,13026,12987,39,107,107,0,1,100,NoArch
59b50353cc28ba769a5a38d7949f5030f45f63f5,1,1,0,1,1,1,0,1,15,242,1,1,0,91,4,254,18,3,3,0,161,154,7,3,3,0,0,100,NoArch
f6d34303b7e725f9ef61380425eea52fcf6397c1,1,4,0,4,4,1,0,1,11,327,1,1,0,837,3,255,18,228,225,3,5503,5469,34,36,36,0,1,100,NoArch
12929de7afabc3b6b02fcb0970f6372a0235b5b8,1,52,32,20,84,0,0,0,26,171,1,1,0,1258,7,558,5,207,203,4,6095,6007,88,124,122,2,1,100,NoArch
ceccc4cee84d80fe390b01fa7aee8d4f4d53d954,1,14,3,11,17,0,0,0,18,9,1,1,0,638,5,559,6,74,72,2,1556,1518,38,39,39,0,1,100,NoArch
034b666de2f202507c2ca661c38ba57f7d70ff3c,2,39,18,21,57,1,0,1,133,696,1,1,0.127418512,3794,4,560,7,606,602,4,20101,19962,139,171,170,1,1,100,NoArch
0702d0e528a2957aadb43ab119e66cc8b14137f8,1,2,2,0,4,0,0,0,134,0,1,1,0,3654,12,561,8,588,588,0,19728,19728,0,153,153,0,0,100,NoArch
142b9becc3c415edda7347a706f172a7703d5857,1,1,1,0,2,0,0,0,24,174,1,1,0,965,6,562,9,310,310,0,6904,6902,2,38,38,0,1,100,NoArch
2b174a00700a8055cb5269172785099a343fe351,1,25,0,25,25,1,0,1,35,95,1,1,0,540,10,563,10,87,83,4,3536,3365,171,22,21,1,0,100,NoArch
735b003976d34eb8ad9914d47269f4c59718ceaf,1,4,3,1,7,0,0,0,11,579,1,1,0,652,2,564,11,89,89,0,2568,2578,10,44,44,0,1,100,NoArch
e1fed9265c70127adffa163fc1ad15e7d512523d,1,5,3,2,8,0,0,0,36,0,1,1,0,565,10,565,12,88,87,1,3541,3536,5,22,22,0,0,100,NoArch
64a00c725f739d22221ff58976849640d50c9759,2,9,4,5,13,1,0,1,254,8,1,2,0.89049164,8325,3,256,17,1280,1280,0,33967,33938,29,537,536,1,1,100,NoArch
ae8d702dccb8776ab0d6cdd228010fa6e0ed0c76,1,50,136,86,186,0,0,0,37,0,1,1,0,567,10,257,18,88,88,0,2946,3541,595,22,22,0,0,100,NoArch
9074369555a06d6a8a561da8bebbd6d0344a5faa,7,54,6,48,60,1,0,1,36,114,1,4,1.984956057,1154,2,136,0,428,422,6,8414,8067,347,72,69,3,0,100,NoArch
d3e2ea1152ea0fd99ced04d013a4ce6b6445570e,0,0,0,0,0,0,0,0,0,0,0,0,0,0,0,7,1,0,0,0,0,0,0,0,0,0,0,100,NoArch
a7ea9947a68bdf6d30b88314c5ffe3c864b7430d,0,0,0,0,0,0,0,0,0,0,0,0,0,0,0,23,0,0,0,0,0,0,0,0,0,0,0,100,NoArch
8713b31b7e4b2db1d820ef7d08cf919e9d9e7372,0,0,0,0,0,0,0,0,0,0,0,0,0,0,0,73,1,0,0,0,0,0,0,0,0,0,0,100,NoArch
c1bb60c73cbc62d96d0ce1cb8baed12aa69b18f0,1,32,25,7,57,0,0,0,255,10,1,1,0,7493,22,258,16,1058,1055,3,28523,28498,25,501,501,0,1,100,NoArch
e0f3f02ce475fd6c816677be53b42e28634c1902,1,7,8,1,15,0,0,0,10,189,1,1,0,237,4,259,17,33,33,0,994,995,1,12,12,0,1,100,NoArch
7f2758a92f20dba45c6c7156388457763f6aa372,0,0,0,0,0,0,0,0,0,0,0,0,0,0,0,260,18,0,0,0,0,0,0,0,0,0,0,100,NoArch
eee7da22ac76eb6815a70a0599e5f244ee8d3b0d,1,4,0,4,4,1,0,1,4,1060,1,1,0,76,4,261,19,13,11,2,427,394,33,8,8,0,1,100,NoArch
ef9515588cd9293bcc9834123ae02e732d4cdfc0,11,41,71,30,112,1,0,1,256,114,1,4,2.897121589,15118,6,137,1,3488,3514,26,77548,78018,470,1453,1465,12,0,100,NoArch
b34e9036c4eec13d7edd55e0e63aa59247ea7887,3,1,21,20,22,0,0,0,45,135,1,2,0.699857857,1408,4,138,2,269,273,4,7068,7126,58,229,231,2,0,100,NoArch
7eb1e6ee1f0f9dceea2899603e7ac07b5448de22,1,48,29,19,77,0,0,0,257,5,1,1,0,7512,22,262,13,1060,1059,1,28585,28546,39,506,502,4,1,100,NoArch
f4f3d81b1b5e335dc9de43f27e72d58f94ef88fc,1,3,3,0,6,0,0,0,258,0,1,1,0,7531,22,263,14,1060,1060,0,28585,28585,0,506,506,0,1,100,NoArch
cd6dca6f22e95076a219af87bf76b9973338e640,2,66,17,49,83,0,0,0,23,58,1,2,0.98223093,630,3,264,15,103,94,9,3189,2863,326,35,31,4,1,99.87853022,NoArch
d129f2097ff75f54ac33fff163dae117da2529f3,1,7,14,7,21,0,0,0,19,20,1,1,0,649,5,566,11,74,74,0,1553,1556,3,39,39,0,0,100,NoArch
0d804290a8445ec49cb49869cf8f5e45aabf2568,1,1,3,2,4,0,0,0,32,325,1,1,0,487,9,567,12,53,54,1,2086,2089,3,14,14,0,1,100,NoArch
616c0a4049cb33e29a1d17fa15e53a990d45c135,2,4,19,15,23,1,0,1,259,108,1,2,0.666578358,7699,22,568,13,1081,1082,1,29296,29367,71,517,517,0,0,100,NoArch
792dfc98545f4728e5635226e772e51c6582e8db,2,53,24,29,77,1,0,1,16,1261,1,1,0.879697578,504,2,569,14,71,66,5,2611,2407,204,35,33,2,1,100,NoArch
bc7c5a173f31ffe13adf12a13501f3757abc959f,1,12,5,7,17,0,0,0,18,29,1,1,0,400,6,230,0,47,45,2,1549,1534,15,18,18,0,1,100,NoArch
87fe152321b778e6da4fd13b789b3b25422c3214,1,6,1,5,7,0,0,0,260,0,1,1,0,7535,22,570,15,1061,1061,0,28612,28610,2,507,507,0,1,100,NoArch
45e82f5c5da15bd1b7dfa28ccd09c3748dd11bf2,1,13,1,12,14,0,0,0,14,672,1,1,0,236,8,571,16,29,28,1,858,836,22,12,11,1,1,100,NoArch
7c07749a55d6ab8b18c32845a2f526c8bf31ea31,1,26,5,21,31,0,0,0,25,21,1,1,0,965,6,572,17,321,310,11,7043,6904,139,38,38,0,1,100,NoArch
d72bcda23fa6b1e4c0d7a290725533195300d097,1,18,17,1,35,0,0,0,261,0,1,1,0,7540,22,573,18,1061,1061,0,28647,28612,35,507,507,0,1,100,NoArch
d7e08039407fdf56bb9a25187560557501a8390f,1,4,1,3,5,0,0,0,262,0,1,1,0,7541,22,574,19,1061,1061,0,28650,28647,3,507,507,0,1,100,NoArch
4c28fadc284ad44260b0b9083b929277c1d11bbd,0,0,0,0,0,0,0,0,0,0,0,0,0,0,0,575,20,0,0,0,0,0,0,0,0,0,0,100,NoArch
033fe4813e3f2f9675f25e26b40103262d29e379,1,0,3,3,3,0,0,0,72,46,1,1,0,2259,6,576,21,507,507,0,13354,13392,38,100,100,0,1,100,NoArch
6e20de5acbfbe3812bbbd61bfc7d2ac9b6c9917b,482,5171,11769,6598,16940,69,0,69,263,896,1,44,8.566197434,91258,3,231,1,13356,13356,0,358438,358437,1,5823,5823,0,1,100,NoArch
c4946d5639c171fcf6a30e11588e898afcc0cb5c,3,17,7,10,24,2,0,2,31,0,1,3,1.459147917,1377,10,577,22,287,285,2,7832,7781,51,133,130,3,1,100,NoArch
934dd9b89bd840f721919f22685097db1daaf125,3,10,2,8,12,1,0,1,136,0,1,2,1.040852083,5045,10,578,23,858,856,2,27074,27044,30,288,286,2,1,100,NoArch
a94ad29908fba4a1049f4549635d20230322a2c8,4,2007,389,1618,2396,1,0,1,74,0,1,2,1.169687736,2929,4,579,24,787,621,166,20509,16332,4177,214,150,64,0,99.93932039,NoArch
4cfbda7702f8d856371ebd4ec72ffd37871b252d,1,11,10,1,21,0,0,0,39,3,1,1,0,478,10,580,25,89,88,1,2941,2946,5,23,22,1,1,100,NoArch
b5230c1a84c2ac6bd5607323888e5c6a36e0305f,1,5,1,4,6,0,0,0,137,3,1,1,0,3627,12,581,26,589,588,1,19768,19742,26,153,153,0,1,100,NoArch
824d1c89098f1ff608675039aafb709e8410b82f,1,1,1,0,2,0,0,0,9,2,1,1,0,297,4,582,27,41,41,0,1228,1228,0,19,19,0,0,100,NoArch
233a89aa6bd813e40015c7950102edc04b306efe,1,10,3,7,13,0,0,0,6,2,1,1,0,742,3,583,28,85,82,3,2252,2216,36,26,26,0,0,100,NoArch
e53a22853cf50ce826d78f9613217efcaa5b712f,1,1,1,0,2,0,0,0,7,0,1,1,0,749,3,584,29,85,85,0,2252,2252,0,26,26,0,0,100,NoArch
81a86dbce6163df1cf03083c3a9bf8144abdec69,1,2,1,1,3,0,0,0,8,0,1,1,0,749,3,585,30,85,85,0,2259,2252,7,26,26,0,0,100,NoArch
fed5af8e879d891abe735d7b0359d190f7e59f85,1,4,2,2,6,0,0,0,9,0,1,1,0,750,3,586,31,85,85,0,2269,2259,10,26,26,0,0,100,NoArch
48a160583fb66ffae69130f3c8801f67e55c092b,31,322,328,6,650,0,0,0,85,0,1,6,3.668273725,4578,3,265,15,618,614,4,15867,15951,84,287,282,5,0,100,NoArch
aaefb6abb8749db82647f12c5c545b63c3bcdd56,0,0,0,0,0,0,0,0,0,0,0,0,0,0,0,139,3,0,0,0,0,0,0,0,0,0,0,100,NoArch
9e63a714934d6757a37815ddce7d6cd071a6be4a,1,16,3,13,19,0,0,0,7,1,1,1,0,948,3,24,0,166,164,2,4115,4068,47,55,54,1,0,100,NoArch
b024d44713010c836bf465624198d145ed1dad86,6,58,65,7,123,1,0,1,138,5,1,3,2.217216228,4817,10,587,32,782,775,7,25595,25888,293,241,234,7,0,100,NoArch
6b39e094e16ca4a121e23f714bf47d41c40d293a,0,0,0,0,0,0,0,0,0,0,0,0,0,0,0,588,33,0,0,0,0,0,0,0,0,0,0,100,NoArch
a201db03624d69e53a314099f2b6ec6f60818d5f,1,8,2,6,10,0,0,0,20,8,1,1,0,389,7,589,34,47,47,0,1583,1549,34,18,18,0,1,100,NoArch
58e0273023d781250e9429ee9d6c40e525763392,1,1,1,0,2,0,0,0,14,10,1,1,0,236,7,590,33,22,22,0,1082,1082,0,8,8,0,0,100,NoArch
537c0997b2698a78235ac2a0d820b8ee7018afd7,1,1,1,0,2,0,0,0,15,0,1,1,0,236,7,591,34,22,22,0,1082,1082,0,8,8,0,0,100,NoArch
fcb663ded69b6ce4cbe4c52fff11176c16cc151e,0,0,0,0,0,0,0,0,0,0,0,0,0,0,0,266,14,0,0,0,0,0,0,0,0,0,0,100,NoArch
a0d4d79f179a8259b0d31e8ae725091da057db36,1,3,3,0,6,0,0,0,264,15,1,1,0,7525,22,267,13,1061,1061,0,28657,28650,7,507,507,0,1,100,NoArch
8a12022c767d9613219e6dcf2ebcf2efd2f31813,1,23,4,19,27,0,0,0,33,16,1,1,0,796,10,268,14,184,179,5,4892,4739,153,91,89,2,1,100,NoArch
1c947d6b43d93708bb36aeb9f51a2bfc5b6e5be8,7,375,311,64,686,1,0,1,75,26,1,2,1.888007017,3987,2,25,1,759,750,9,19905,19782,123,224,214,10,2,99.33130699,NoArch
a4816df1494535ad3949664163264f55bc76095c,1,133,32,101,165,0,0,0,66,25,1,1,0,438,10,26,2,85,67,18,1734,1373,361,46,39,7,1,100,NoArch
b684478df8011ab3977b3c7450acaa7110e09696,1,20,16,4,36,0,0,0,20,35,1,1,0,237,7,269,7,32,31,1,911,890,21,11,10,1,1,100,NoArch
a2737f6fef305b697b83062a846d778e29334355,1,81,68,13,149,0,0,0,21,26,1,1,0,395,7,270,8,49,47,2,1632,1583,49,18,18,0,1,100,NoArch
d06921100e5a2a98b1eee1cad83345204a65db26,0,0,0,0,0,0,0,0,0,0,0,0,0,0,0,74,0,0,0,0,0,0,0,0,0,0,0,100,NoArch
c7125cf887caec401a7ba0fb8ecff0024492e2a1,1,3,3,0,6,0,0,0,34,35,1,1,0,455,10,75,1,53,53,0,2092,2086,6,14,14,0,0,100,NoArch
63e49262aa04b48587181a392453c15eb5a9722a,0,0,0,0,0,0,0,0,0,0,0,0,0,0,0,76,2,0,0,0,0,0,0,0,0,0,0,100,NoArch
d8096ccf881b49ddc8ff58824e8d8033b764d6ae,2,14,9,5,23,0,0,0,24,21,1,2,0.828055725,459,9,271,9,72,72,0,1852,1852,0,51,51,0,0,100,NoArch
fc0027ee1619f2ced48687ad382c31aa394ff394,0,0,0,0,0,0,0,0,0,0,0,0,0,0,0,272,8,0,0,0,0,0,0,0,0,0,0,100,NoArch
e47d6b28e2f9c4740a372ea29aac74f2c224dda7,0,0,0,0,0,0,0,0,0,0,0,0,0,0,0,77,3,0,0,0,0,0,0,0,0,0,0,100,NoArch
1a5fc570cae0a1c60382799d27b2a34267f7d421,0,0,0,0,0,0,0,0,0,0,0,0,0,0,0,78,4,0,0,0,0,0,0,0,0,0,0,100,NoArch
6129ba394350103ccfaa0013547dc279ed1a0a4a,0,0,0,0,0,0,0,0,0,0,0,0,0,0,0,17,0,0,0,0,0,0,0,0,0,0,0,100,NoArch
a778081c4fd25416e0a92e4ad4bb3968317f998a,1,18,24,6,42,0,0,0,16,31,1,1,0,236,8,79,5,22,22,0,1091,1082,9,8,8,0,0,100,NoArch
eafeaab2f73968fcfed714ff2802c75ff481accf,2,36,28,8,64,0,0,0,265,18,1,2,0.200622324,8461,22,27,3,1230,1227,3,32794,32763,31,563,561,2,0,100,NoArch
57e0c7651a67fe96797d92f9bdbc7630e53695d0,2,4,3,1,7,0,0,0,35,3,1,2,0.985228136,685,8,80,6,75,75,0,3175,3183,8,22,22,0,0,100,NoArch
ecae592a11e8eee1af99a57a88100dd3465c9622,0,0,0,0,0,0,0,0,0,0,0,0,0,0,0,81,7,0,0,0,0,0,0,0,0,0,0,100,NoArch
2057ef6ccb1aeb1159d4098dd5df751c6b2de608,3,130,61,69,191,1,0,1,76,12,1,1,0.479651199,2940,3,28,4,615,591,24,15434,15047,387,154,149,5,0,100,NoArch
03e8d94e192e49df4c33bdcaab51f937ef898d45,1,50,36,14,86,0,0,0,77,0,1,1,0,2266,7,29,5,532,529,3,13640,13522,118,108,107,1,1,100,NoArch
7b92ced60e08aa01ffb453b95361364d02c81be4,1,13,6,7,19,0,0,0,78,0,1,1,0,2280,7,30,6,534,532,2,13700,13640,60,109,108,1,1,100,NoArch
018599cfb373ab5056651edcf387c4ddc2c58db2,1,44,27,17,71,0,0,0,79,2,1,1,0,2287,7,31,7,536,534,2,13873,13700,173,110,109,1,0,100,NoArch
e9915285c0689894df73355cae653599a11f4f89,1,4,1,3,5,0,0,0,3,49,1,1,0,123,2,592,5,16,15,1,697,678,19,4,4,0,0,100,NoArch
90dd81b779a4d6dab02b45dd80a86cf30a86838a,1,44,21,23,65,0,0,0,80,5,1,1,0,2304,7,32,7,548,536,12,14011,13873,138,110,110,0,0,100,NoArch
edae5ec57bcea053dc65aa9d9df2c7b7984b1abc,2,8,3,5,11,0,0,0,93,54,1,2,0.684038436,2945,2,593,1,581,579,2,15764,15719,45,133,133,0,0,100,NoArch
ef77a9384472b479eb8e6c67434fdf46f9a2708b,6,343,168,175,511,2,0,2,54,36,1,2,1.783328255,2289,1,594,2,452,422,30,13336,12384,952,157,144,13,1,97.38173163,Arch
ee2a374b0654845fb66273e51af579896354011e,1,62,85,23,147,0,0,0,19,56,1,1,0,234,7,273,6,27,27,0,792,792,0,7,7,0,1,100,NoArch
e641d037a2607f0c8cbff9ee7b02c7d296a377b8,1,1,1,0,2,0,0,0,2,1,1,1,0,148,2,274,7,35,35,0,867,867,0,10,10,0,0,100,NoArch
477be0ffc646bef2823de9e3935cd38e8582e997,0,0,0,0,0,0,0,0,0,0,0,0,0,0,0,275,6,0,0,0,0,0,0,0,0,0,0,100,NoArch
7a6b6831bed2d2a7889bb64d27503692dd85c913,1,1,0,1,1,1,0,1,16,60,1,1,0,367,7,276,7,59,59,0,1186,1186,0,20,20,0,0,100,NoArch
5c4921b6bf13059596ad9793fcfa204aad25b370,1,35,1,34,36,0,0,0,17,1,1,1,0,368,7,277,8,69,59,10,1350,1186,164,24,20,4,1,100,NoArch
f95d9ac297d73761caf9efbd691372931499f6c9,0,0,0,0,0,0,0,0,0,0,0,0,0,0,0,278,9,0,0,0,0,0,0,0,0,0,0,100,NoArch
c94d2056d4c62dc6b4c24ada1a6b94aa0cf4d17e,0,0,0,0,0,0,0,0,0,0,0,0,0,0,0,279,10,0,0,0,0,0,0,0,0,0,0,100,NoArch
992445e71d2a824870d3dc4a95cfecbe2c288604,0,0,0,0,0,0,0,0,0,0,0,0,0,0,0,280,11,0,0,0,0,0,0,0,0,0,0,100,NoArch
a42b22c2b511160e8dc7b189f9d550cdbbe66730,0,0,0,0,0,0,0,0,0,0,0,0,0,0,0,281,12,0,0,0,0,0,0,0,0,0,1,100,NoArch
40179bced0442e9fab77c3e5c0ef6a400f09be31,0,0,0,0,0,0,0,0,0,0,0,0,0,0,0,282,13,0,0,0,0,0,0,0,0,0,0,100,NoArch
e635199c2c8a027f2bc2e2d0441c7056c14b79b8,2,12,7,5,19,0,0,0,81,20,1,1,0.998000884,3271,7,33,8,722,717,5,18199,18146,53,166,166,0,1,100,NoArch
bb413d8eace01b7030feff8a5e3c60199bfa2587,1,0,3,3,3,0,0,0,82,2,1,1,0,2335,7,34,9,549,550,1,14027,14051,24,110,110,0,0,100,NoArch
71555251b694752aa520b04f1d39a5039556a215,1,40,3,37,43,0,0,0,40,69,1,1,0,479,10,15,0,98,89,9,3169,2941,228,31,23,8,1,100,NoArch
c657bf8c518d679f9353c3272c4980d3267c872a,1,2,2,0,4,0,0,0,19,84,1,1,0,576,9,35,7,77,77,0,2159,2159,0,37,37,0,0,100,NoArch
bc30f90768e49137544d081d2107aa1a29f3879d,1,4,0,4,4,1,0,1,41,12,1,1,0,516,10,16,1,99,98,1,3179,3169,10,32,31,1,0,100,NoArch
db18095323b169733e94f0c5d21ea295b81496c5,6,324,192,132,516,1,0,1,166,45,1,1,1.73097599,3931,2,36,5,814,785,29,20628,20137,491,221,215,6,1,99.97091332,NoArch
21d991895fe8dacad74964d81ad5bf5d344a8ff7,3,25,8,17,33,1,0,1,4,93,1,2,1.530030381,360,2,17,2,65,62,3,1615,1507,108,34,32,2,0,100,NoArch
9ee7ebf2eeee0a77323ab8dd0c2a59ca3bb5de4c,1,1,1,0,2,0,0,0,20,11,1,1,0,576,9,37,4,77,77,0,2158,2159,1,37,37,0,0,100,NoArch
3fdc9b32c0bc7edccd09e473a9fd7f15ab9ab78d,0,0,0,0,0,0,0,0,0,0,0,0,0,0,0,18,3,0,0,0,0,0,0,0,0,0,1,100,NoArch
4edadd21576efeab5738bb0fb5cb063c53a6550c,0,0,0,0,0,0,0,0,0,0,0,0,0,0,0,38,4,0,0,0,0,0,0,0,0,0,0,100,NoArch
7c65597c7a47efd21937c8fb38a09793cea00a5b,1,4,2,2,6,0,0,0,266,70,1,1,0,7525,22,8,0,1062,1061,1,28679,28659,20,507,507,0,1,100,NoArch
bac77379e06b791c1e1f3839efa2dee7063976d2,1,24,6,18,30,0,0,0,84,24,1,1,0,2341,7,39,4,555,551,4,14167,14069,98,113,112,1,1,100,NoArch
e5574979bb2df9cf4e61c813a276f51a22d261d5,0,0,0,0,0,0,0,0,0,0,0,0,0,0,0,283,0,0,0,0,0,0,0,0,0,0,0,100,NoArch
43cac5c3b05ef536fae73e5009b564f5de8f303e,0,0,0,0,0,0,0,0,0,0,0,0,0,0,0,0,0,0,0,0,0,0,0,0,0,0,0,100,NoArch
a1b83767be0b087ef7ea7bf08ee2565d4f2a3cc2,0,0,0,0,0,0,0,0,0,0,0,0,0,0,0,1,1,0,0,0,0,0,0,0,0,0,0,100,NoArch
eb0ed529afe7384b54696e74d0537d64a74afff0,0,0,0,0,0,0,0,0,0,0,0,0,0,0,0,2,2,0,0,0,0,0,0,0,0,0,0,100,NoArch
5ac65ea3f6e08c2f31673cb9f3e339accd05c31b,1,32,23,9,55,0,0,0,4,117,1,1,0,255,3,40,5,42,39,3,988,964,24,14,13,1,0,100,NoArch
cc95674a2b155ee0338f1be986c8d3f11dd6553d,0,0,0,0,0,0,0,0,0,0,0,0,0,0,0,29,0,0,0,0,0,0,0,0,0,0,1,100,NoArch
fa6a7b908ca155449a314a0dd61e8bbf3a09da66,1,1,1,0,2,0,0,0,5,0,1,1,0,264,3,41,6,42,42,0,995,988,7,14,14,0,0,100,NoArch
ea752ed9a0cba9a9e002b2262e2d51697bbeaca3,1,5,1,4,6,0,0,0,6,0,1,1,0,264,3,42,7,42,42,0,995,995,0,14,14,0,0,100,NoArch
d7c393eb64c974482c9787e2baefd825d55b09b2,1,39,18,21,57,0,0,0,7,120,1,1,0,101,4,9,1,10,9,1,280,246,34,6,6,0,1,100,NoArch
84dc055f88a8ff4f6a3bb73d776070f101219b56,2,33,4,29,37,0,0,0,267,69,1,2,0.303374836,7773,9,10,2,1096,1094,2,30673,30615,58,531,529,2,1,100,NoArch
8383fce2223214983dc793fafc1b9e884e1918ba,0,0,0,0,0,0,0,0,0,0,0,0,0,0,0,3,3,0,0,0,0,0,0,0,0,0,1,100,NoArch
6b41b58f52c8c64ffd03c7d6bb3db988ab3f4147,0,0,0,0,0,0,0,0,0,0,0,0,0,0,0,4,4,0,0,0,0,0,0,0,0,0,0,100,NoArch
8fcaa211d9de420d787abfbacd4a38262ed029b6,0,0,0,0,0,0,0,0,0,0,0,0,0,0,0,5,5,0,0,0,0,0,0,0,0,0,0,100,NoArch
333adba5975f1430e516eb742890585a902c0f96,0,0,0,0,0,0,0,0,0,0,0,0,0,0,0,6,6,0,0,0,0,0,0,0,0,0,0,100,NoArch
b5757a8bcfd01f593dbfa103981c493c8fd45b0f,2,530,157,373,687,1,0,1,36,61,1,2,0.583552223,567,1,7,7,86,72,14,2996,2113,883,35,25,10,1,99.79573971,NoArch
4e04daf110cc352aba3e8388fec2a6c8cb7dd34d,1,19,8,11,27,0,0,0,7,4,1,1,0,268,4,11,3,44,42,2,1041,995,46,15,14,1,1,100,NoArch
2d9c04a61c194f9c9156aaef9ee85d23e9de6aa3,1,24,0,24,24,1,0,1,1,0,1,1,0,0,1,12,4,1,0,1,46,0,46,1,0,1,1,99.94152047,NoArch
c356b8b885e77a26424fc698c0d5f6322e6ff04c,0,0,0,0,0,0,0,0,0,0,0,0,0,0,0,13,5,0,0,0,0,0,0,0,0,0,1,100,NoArch
168f02304494c7b862a3aded11df2c02ed83f920,0,0,0,0,0,0,0,0,0,0,0,0,0,0,0,14,6,0,0,0,0,0,0,0,0,0,0,100,NoArch
647207389eed259500903829bed2ff3872e72897,0,0,0,0,0,0,0,0,0,0,0,0,0,0,0,15,7,0,0,0,0,0,0,0,0,0,0,100,NoArch
204f62b3c4c4a2e1f758a38ebaab850aa416b715,1,11,0,11,11,1,0,1,268,2,1,1,0,7556,22,16,8,1065,1064,1,28762,28735,27,510,509,1,1,100,NoArch
90adbd21a0afe67cd7d3927e934a53d2f3e5a5f2,1,5,2,3,7,0,0,0,269,0,1,1,0,7567,22,17,9,1066,1065,1,28772,28762,10,510,510,0,1,100,NoArch
3bb47fa7e363b2396b04d6338250ea9229c024a8,0,0,0,0,0,0,0,0,0,0,0,0,0,0,0,8,8,0,0,0,0,0,0,0,0,0,0,100,NoArch
6cff712b0b0ece99723b488035574daf0869d614,1,12,3,9,15,0,0,0,5,128,1,1,0,57,5,9,9,10,7,3,193,131,62,6,5,1,0,100,NoArch
9fee73fc4a36bcefd1cc7e96a0f7236db984ec13,1,2,1,1,3,0,0,0,10,125,1,1,0,297,4,595,0,41,41,0,1231,1228,3,19,19,0,1,100,NoArch
7736a7ff2c75a12dca5b12bb2a4be7b1cc0cfa1d,6,645,12,633,657,2,0,2,139,115,1,6,0.630661265,4103,7,596,1,795,645,150,25845,21881,3964,220,178,42,1,99.27092447,NoArch
7fc706376defdf77aeb60eac7da186abfca65695,2,61,1,60,62,1,0,1,2,0,1,2,0.972806322,599,1,597,2,144,144,0,3697,3683,14,40,40,0,0,99.67967385,NoArch
7482f926842303488e2e395797688bf27a2f474d,1,1,1,0,2,0,0,0,6,130,1,1,0,63,2,598,3,6,6,0,286,285,1,6,6,0,0,100,NoArch
0e3c8b4647572921d45d0c39202985053724849e,1,20,15,5,35,0,0,0,85,15,1,1,0,2359,7,599,4,556,555,1,14198,14167,31,113,113,0,0,100,NoArch
bd7e205ef6cf5e6099432935b436f855a2059d00,1,1,3,2,4,0,0,0,270,5,1,1,0,7570,22,600,5,1065,1066,1,28752,28772,20,510,510,0,0,99.97086247,NoArch
1f335047a8761d988e2ccef6322954fca6778214,2,1,34,33,35,0,0,0,7,130,1,1,0.512709142,223,3,10,10,30,31,1,620,646,26,5,6,1,1,99.94169096,NoArch
520724e87af10c5c20eb478cff23e47f4bfbe5af,1,8,0,8,8,1,0,1,68,84,1,1,0,554,10,601,6,88,86,2,1778,1744,34,49,47,2,0,100,NoArch
02a2b5c08a59edbaba612488ce39cbd6be9ae8ea,1,16,0,16,16,1,0,1,6,2,1,1,0,66,5,11,11,10,10,0,193,193,0,6,6,0,0,100,NoArch
6766e45e8e9fe05752b9acca2e9294113708730a,1,1,1,0,2,0,0,0,3,130,1,1,0,86,2,602,7,9,9,0,273,272,1,7,7,0,0,100,NoArch
9b7baeb8b9b573dacaca55a32a5f319ac78c6e81,8,2708,0,2708,2708,8,0,8,1,0,1,2,2.754364411,0,1,19,2,295,0,295,11706,0,11706,139,0,139,0,99.4199536,NoArch
2bc99ae0e87635427b6b31086a019f39f169c69b,1,4,3,1,7,0,0,0,27,133,1,1,0,190,11,12,12,24,24,0,605,602,3,13,13,0,0,100,NoArch
b408cefc9dcb315d5991436aecf1bd51f9ce4a92,0,0,0,0,0,0,0,0,0,0,0,0,0,0,0,13,13,0,0,0,0,0,0,0,0,0,0,100,NoArch
64289937ee69c7f7ec96c86603e610d9a7c82d72,0,0,0,0,0,0,0,0,0,0,0,0,0,0,0,14,14,0,0,0,0,0,0,0,0,0,1,100,NoArch
418afc6c99e099f798ddf90b649073fd4440bcdd,0,0,0,0,0,0,0,0,0,0,0,0,0,0,0,15,15,0,0,0,0,0,0,0,0,0,0,100,NoArch
8414ce06d94f6498d47a79d489d08088301eac55,0,0,0,0,0,0,0,0,0,0,0,0,0,0,0,16,16,0,0,0,0,0,0,0,0,0,1,100,NoArch
c7789522db6e674a224a1dd8707b413b5a069d73,0,0,0,0,0,0,0,0,0,0,0,0,0,0,0,17,17,0,0,0,0,0,0,0,0,0,0,100,NoArch
2343145e1f0f5617bf7cda61d913f5b6d6f73e9a,0,0,0,0,0,0,0,0,0,0,0,0,0,0,0,18,18,0,0,0,0,0,0,0,0,0,0,100,NoArch
8a43c9e4a361685887a5cab2452577fbb5735045,0,0,0,0,0,0,0,0,0,0,0,0,0,0,0,19,19,0,0,0,0,0,0,0,0,0,0,100,NoArch
15152cebf8aad43bfc365b99d2efe6191fe60e5a,5,0,270,270,270,0,0,0,5,130,1,2,2.136250376,270,3,20,20,0,21,21,0,735,735,0,12,12,1,99.68180503,NoArch
81396120129e83c90313395e18f59bc5fd1a88bb,1,49,44,5,93,0,0,0,3,133,1,1,0,79,3,21,21,7,7,0,215,209,6,5,5,0,0,100,NoArch
1e9103047fc73a616425df8b9c6531a89f4aef56,1,6,5,1,11,0,0,0,36,90,1,1,0,455,11,22,22,53,53,0,2086,2086,0,14,14,0,0,100,NoArch
45f5bd5e2147d46e4952b56e8027929effa935ef,0,0,0,0,0,0,0,0,0,0,0,0,0,0,0,23,23,0,0,0,0,0,0,0,0,0,0,100,NoArch
61e075c08051098d810b6e5527cbdf862046301e,2,15,22,7,37,0,0,0,9,66,1,1,0.405977038,359,4,24,24,35,35,0,1530,1530,0,23,23,0,0,100,NoArch
ddd34bd2cab5798ff97d2563a5d3eded59cbe128,0,0,0,0,0,0,0,0,0,0,0,0,0,0,0,25,25,0,0,0,0,0,0,0,0,0,0,100,NoArch
7f71afc823f2a0a8cfa793aef5797c3f17e0bf4a,0,0,0,0,0,0,0,0,0,0,0,0,0,0,0,26,26,0,0,0,0,0,0,0,0,0,0,100,NoArch
dcb527a5b45ddd1baa8a64fbf47ec93f362788ea,1,5,5,0,10,0,0,0,89,133,1,1,0,1038,11,27,27,208,208,0,4998,4998,0,90,90,0,0,100,NoArch
978cbabed52e95722830423b6aa0e6ef398ae107,0,0,0,0,0,0,0,0,0,0,0,0,0,0,0,28,28,0,0,0,0,0,0,0,0,0,0,100,NoArch
0f7a9092e43b9b941febf8e521a1af45f18acf10,0,0,0,0,0,0,0,0,0,0,0,0,0,0,0,29,29,0,0,0,0,0,0,0,0,0,0,100,NoArch
9a7c26af9b487cdca62f893b2998b385d24c888f,1,0,4,4,4,0,0,0,2,2,1,1,0,263,1,20,3,23,23,0,1283,1313,30,5,5,0,0,99.91291727,NoArch
d3176203bc120c2c5f42a1b97f45c2578b567d3d,1,57,0,57,57,1,0,1,1,0,1,1,0,0,1,30,30,6,0,6,165,0,165,6,0,6,0,99.94196169,NoArch
0218b5115f177249cbbb9b782e50c5c1fd644e00,2,306,0,306,306,2,0,2,1,0,1,2,0.994785987,0,1,31,31,39,0,39,1214,0,1214,18,0,18,0,98.70854124,NoArch
66cc1f248b3ac544a4679e266017c85c3e6432a9,1,59,68,9,127,0,0,0,21,39,1,1,0,576,10,32,32,76,77,1,2113,2158,45,37,37,0,0,99.97029115,NoArch
49e9d68ff5775d31379d4f96b408eb1096f1a889,4,373,87,286,460,3,0,3,2,0,1,1,1.983320087,166,1,33,33,49,24,25,1775,703,1072,22,10,12,0,99.79240807,NoArch
55e4329a7db95cddf9df6e791c8e4595da700542,0,0,0,0,0,0,0,0,0,0,0,0,0,0,0,34,34,0,0,0,0,0,0,0,0,0,0,100,NoArch
b7d6b4b5b9bd314307ce98a838364d3d93955b9b,0,0,0,0,0,0,0,0,0,0,0,0,0,0,0,35,35,0,0,0,0,0,0,0,0,0,0,100,NoArch
388e8a76a7eb62a71c5c6be0c018599d6771d9f3,0,0,0,0,0,0,0,0,0,0,0,0,0,0,0,36,36,0,0,0,0,0,0,0,0,0,0,100,NoArch
5d121eff3d68c24c104b0f23df43889c6811059d,1,76,3,73,79,0,0,0,2,0,1,1,0,110,1,37,37,26,10,16,694,387,307,14,5,9,0,100,NoArch
0328b9a2b1ccc87bc02caf6ac90856a5ce007e18,1,13,1,12,14,0,0,0,3,0,1,1,0,183,1,38,38,26,26,0,694,694,0,14,14,0,0,100,NoArch
59ea50b43e206c71852448286a4e8b52f6b45da0,1,6,1,5,7,0,0,0,4,0,1,1,0,195,1,39,39,26,26,0,683,694,11,14,14,0,0,100,NoArch
9a3dc6824454c64099666d2f51ad83e6e97fdd91,2,41,19,22,60,0,0,0,5,0,1,1,0.650022422,332,1,40,40,50,45,5,1298,1167,131,27,25,2,0,100,NoArch
7da2d4045df75ee92c2afe7947c0dbded9a8ae6d,2,45,23,22,68,0,0,0,6,0,1,1,0.478250164,354,1,41,41,54,50,4,1366,1298,68,31,27,4,0,100,NoArch
2bbd39501455bea01f6c0290e5a3025e3a52548f,1,4,4,0,8,0,0,0,7,0,1,1,0,247,1,42,42,35,35,0,917,917,0,20,20,0,0,100,NoArch
877ed1273973decf6b056fc1142a87ad36530508,1,0,2,2,2,0,0,0,8,0,1,1,0,247,1,43,43,35,35,0,910,917,7,20,20,0,0,100,NoArch
c6ecf0ee45a4b91564338cc25f22da27f7e7eaa6,1,14,14,0,28,0,0,0,9,0,1,1,0,245,1,44,44,35,35,0,910,910,0,20,20,0,0,100,NoArch
264d65ddb6b9625c16e6e8234939d5e82cf44b5c,4,61,49,12,110,0,0,0,10,0,1,1,1.61554339,584,1,45,45,74,74,0,2294,2263,31,37,37,0,0,100,NoArch
a7d0c754c423704fe2147c514abbf0a5237a67f7,2,30,20,10,50,0,0,0,15,136,1,1,1,655,4,46,46,76,76,0,2797,2808,11,25,25,0,0,99.32905484,NoArch
017ba8d9b3ec036712249237a3afb1a5a1c67e1d,1,1,1,0,2,0,0,0,3,0,1,1,0,90,1,47,47,7,7,0,404,404,0,1,1,0,0,100,NoArch
06c2f5c5fbb5dfc2c756f11d2f9e7a885f4d1889,0,0,0,0,0,0,0,0,0,0,0,0,0,0,0,18,10,0,0,0,0,0,0,0,0,0,0,100,NoArch
fcfd0f96e7f4f8a147661dc017c8d3cba2bc868c,0,0,0,0,0,0,0,0,0,0,0,0,0,0,0,19,11,0,0,0,0,0,0,0,0,0,0,100,NoArch
a9cfe31f3b30196b0ca02934f23c40d65407066f,0,0,0,0,0,0,0,0,0,0,0,0,0,0,0,20,12,0,0,0,0,0,0,0,0,0,0,100,NoArch
1f58acef38e682ccb8286bc75e3ad0492b6e75d6,1,1,1,0,2,0,0,0,2,18,1,1,0,96,1,48,48,8,8,0,279,279,0,8,8,0,0,100,NoArch
c952cb68a6ac517dc7710ab093c795917d5506e7,0,0,0,0,0,0,0,0,0,0,0,0,0,0,0,49,49,0,0,0,0,0,0,0,0,0,0,100,NoArch
b34b029a23d4d24de55b1f2b64498be3dd610a7e,0,0,0,0,0,0,0,0,0,0,0,0,0,0,0,50,50,0,0,0,0,0,0,0,0,0,0,100,NoArch
60c959ad74c68274317302cf738277d6f18b9df2,0,0,0,0,0,0,0,0,0,0,0,0,0,0,0,51,51,0,0,0,0,0,0,0,0,0,0,100,NoArch
c2d943a768e2e0f8e7417d0c052bc1b60ce26331,0,0,0,0,0,0,0,0,0,0,0,0,0,0,0,52,52,0,0,0,0,0,0,0,0,0,0,100,NoArch
0c6083f9f0b0c45184dc19430124d4a1cdd2cf61,0,0,0,0,0,0,0,0,0,0,0,0,0,0,0,53,53,0,0,0,0,0,0,0,0,0,0,100,NoArch
47fc93d068db35ee99ff57348ad6a255756b2c1c,0,0,0,0,0,0,0,0,0,0,0,0,0,0,0,54,54,0,0,0,0,0,0,0,0,0,0,100,NoArch
a51928dc8e048f4c6d2f95b3b63a5a8823b49e27,0,0,0,0,0,0,0,0,0,0,0,0,0,0,0,55,55,0,0,0,0,0,0,0,0,0,0,100,NoArch
d66334b0f1c82022bb4c4b0712668dd16fa19d94,1,1,2,1,3,0,0,0,85,143,1,1,0,726,12,284,1,134,134,0,3902,3902,0,48,48,0,0,100,NoArch
b6ca5a757e10bdb58c6727f4109b24b18da16d0a,0,0,0,0,0,0,0,0,0,0,0,0,0,0,0,285,2,0,0,0,0,0,0,0,0,0,0,100,NoArch
466fe67ed4ec518f9c8e5266acb46d0d6f5fb056,0,0,0,0,0,0,0,0,0,0,0,0,0,0,0,286,3,0,0,0,0,0,0,0,0,0,0,100,NoArch
b1e166918fd64891c69cba6e93cb06e9424b7aa5,0,0,0,0,0,0,0,0,0,0,0,0,0,0,0,287,4,0,0,0,0,0,0,0,0,0,0,100,NoArch
1b56972afbe5d786fc9eab6076b76e6890400152,0,0,0,0,0,0,0,0,0,0,0,0,0,0,0,288,5,0,0,0,0,0,0,0,0,0,1,100,NoArch
f8b76a79c124fa8d25ee018f28ec2c2294a0c64a,1,1,1,0,2,0,0,0,2,19,1,1,0,24,2,289,6,1,1,0,46,46,0,1,1,0,0,100,NoArch
027662a990ed150a0ea76f4a24cc884385485d3a,1,77,21,56,98,0,0,0,271,13,1,1,0,7568,22,290,7,1075,1065,10,29077,28752,325,513,510,3,2,100,NoArch
5eb67cf681ba5bd537db1d7267d7f9bcab477ea9,1,1,0,1,1,1,0,1,34,127,1,1,0,815,10,291,8,184,184,0,4901,4892,9,91,91,0,0,100,NoArch
d3bbf351db6c1702a0b0dc06960b7772ca8e9109,0,0,0,0,0,0,0,0,0,0,0,0,0,0,0,56,56,0,0,0,0,0,0,0,0,0,0,100,NoArch
1b31ab13b2d08a532cbf8032e2bbd71c2978d712,0,0,0,0,0,0,0,0,0,0,0,0,0,0,0,57,57,0,0,0,0,0,0,0,0,0,0,100,NoArch
45e7adb1d267d1ad9ad5a001287bcd99633cbe5b,0,0,0,0,0,0,0,0,0,0,0,0,0,0,0,58,58,0,0,0,0,0,0,0,0,0,0,100,NoArch
e8775af2175474c1a391d42ad213b007a697abbd,0,0,0,0,0,0,0,0,0,0,0,0,0,0,0,59,59,0,0,0,0,0,0,0,0,0,0,100,NoArch
e6e6c53032ca7a762b8a7473fbacc58433ff3101,0,0,0,0,0,0,0,0,0,0,0,0,0,0,0,60,60,0,0,0,0,0,0,0,0,0,0,100,NoArch
87beb1359a9f03de9d637f76c0f2646d9f568bd8,0,0,0,0,0,0,0,0,0,0,0,0,0,0,0,61,61,0,0,0,0,0,0,0,0,0,0,100,NoArch
f596dc04612d978deb323d40f2f6241d5cb050e1,0,0,0,0,0,0,0,0,0,0,0,0,0,0,0,62,62,0,0,0,0,0,0,0,0,0,0,100,NoArch
acca08bd5330c30cf8f1c965d49adf94268eb2d7,0,0,0,0,0,0,0,0,0,0,0,0,0,0,0,63,63,0,0,0,0,0,0,0,0,0,0,100,NoArch
b605a2fda2dbfd9a0adbeca212d6b30a61f318a1,0,0,0,0,0,0,0,0,0,0,0,0,0,0,0,64,64,0,0,0,0,0,0,0,0,0,0,100,NoArch
532d977cb9a7313d1513ca07b715de7ec8a4a51b,0,0,0,0,0,0,0,0,0,0,0,0,0,0,0,65,65,0,0,0,0,0,0,0,0,0,0,100,NoArch
73ff93758e05690a044511850f6b4bb7d4993a7b,0,0,0,0,0,0,0,0,0,0,0,0,0,0,0,66,66,0,0,0,0,0,0,0,0,0,0,100,NoArch
633007f3e6b5ba19cbf6e0d7604f13fcb567d785,0,0,0,0,0,0,0,0,0,0,0,0,0,0,0,67,67,0,0,0,0,0,0,0,0,0,0,100,NoArch
d76d0aeae73a7b5bee8f3c7d320a27504bb370e6,0,0,0,0,0,0,0,0,0,0,0,0,0,0,0,68,68,0,0,0,0,0,0,0,0,0,0,100,NoArch
af242feb32e4d7b47a9ce9c62c5071c25668a4c5,0,0,0,0,0,0,0,0,0,0,0,0,0,0,0,69,69,0,0,0,0,0,0,0,0,0,0,100,NoArch
0a3de970a221edab9f57c59a8fade20133c7ad95,0,0,0,0,0,0,0,0,0,0,0,0,0,0,0,70,70,0,0,0,0,0,0,0,0,0,0,100,NoArch
e50f5d4eb153692cc0d3328c9c7c9441cd8fa323,0,0,0,0,0,0,0,0,0,0,0,0,0,0,0,71,71,0,0,0,0,0,0,0,0,0,0,100,NoArch
2ddb5bed530996bb1dae73c6f248a02bf275a908,0,0,0,0,0,0,0,0,0,0,0,0,0,0,0,72,72,0,0,0,0,0,0,0,0,0,0,100,NoArch
baeae8ba1a541441b8ad8b51f5662be0307e53fb,0,0,0,0,0,0,0,0,0,0,0,0,0,0,0,73,73,0,0,0,0,0,0,0,0,0,0,100,NoArch
a127f8ff52ee48b0eacec1b38da4fc5ab2fad042,0,0,0,0,0,0,0,0,0,0,0,0,0,0,0,74,74,0,0,0,0,0,0,0,0,0,0,100,NoArch
cd17641be446d283100acb25abd69057cecd3b09,0,0,0,0,0,0,0,0,0,0,0,0,0,0,0,75,75,0,0,0,0,0,0,0,0,0,0,100,NoArch
48d630d4059e9509aea03305c97c332eab7e9657,0,0,0,0,0,0,0,0,0,0,0,0,0,0,0,292,9,0,0,0,0,0,0,0,0,0,0,100,NoArch
fd467d46c86a3171d420dcd3ace810f57c66a955,0,0,0,0,0,0,0,0,0,0,0,0,0,0,0,76,76,0,0,0,0,0,0,0,0,0,0,100,NoArch
766bd879666953584f7145b9b4a7319a145732fc,0,0,0,0,0,0,0,0,0,0,0,0,0,0,0,77,77,0,0,0,0,0,0,0,0,0,0,100,NoArch
a4d5604e0f750963a3d19b86b0d6dbb3f473aea1,0,0,0,0,0,0,0,0,0,0,0,0,0,0,0,78,78,0,0,0,0,0,0,0,0,0,0,100,NoArch
a040af797bf4cf1af732863290ee37d360fa6571,0,0,0,0,0,0,0,0,0,0,0,0,0,0,0,79,79,0,0,0,0,0,0,0,0,0,0,100,NoArch
86285b9748508ebda9423324b57aebf00106995f,0,0,0,0,0,0,0,0,0,0,0,0,0,0,0,80,80,0,0,0,0,0,0,0,0,0,0,100,NoArch
039ee0dd3fa42395d0ec08d3443f1d6776c073ca,0,0,0,0,0,0,0,0,0,0,0,0,0,0,0,81,81,0,0,0,0,0,0,0,0,0,0,100,NoArch
93cfb54d30e96dd89d7f4d2ea94adeb4a8707642,0,0,0,0,0,0,0,0,0,0,0,0,0,0,0,82,82,0,0,0,0,0,0,0,0,0,0,100,NoArch
eaaac191f0392aa26cd10e35cffdb4f2c50756bc,0,0,0,0,0,0,0,0,0,0,0,0,0,0,0,83,83,0,0,0,0,0,0,0,0,0,0,100,NoArch
9481ee622b3f7f8bc64d4de1579afb2c2933b185,0,0,0,0,0,0,0,0,0,0,0,0,0,0,0,84,84,0,0,0,0,0,0,0,0,0,0,100,NoArch
8688477f09f7760158238a323c1808f8e4f7683f,0,0,0,0,0,0,0,0,0,0,0,0,0,0,0,85,85,0,0,0,0,0,0,0,0,0,0,100,NoArch
456c98406e9092601d45eeaf038b714ceb0f77cc,0,0,0,0,0,0,0,0,0,0,0,0,0,0,0,86,86,0,0,0,0,0,0,0,0,0,0,100,NoArch
ced449e1c230535b74ef49d5d92a4d3d34e3736c,1,4,0,4,4,1,0,1,56,148,1,1,0,541,16,87,87,73,72,1,2092,2082,10,41,40,1,0,100,NoArch
e55c41e1214ba4aa95c0b09e757ac72d07184dab,0,0,0,0,0,0,0,0,0,0,0,0,0,0,0,88,88,0,0,0,0,0,0,0,0,0,0,100,NoArch
b39c7573aea7c138ab39b7257be3f2559cee8b21,0,0,0,0,0,0,0,0,0,0,0,0,0,0,0,89,89,0,0,0,0,0,0,0,0,0,0,100,NoArch
3ff379cced093b134893c18e00e7692c09b46654,0,0,0,0,0,0,0,0,0,0,0,0,0,0,0,90,90,0,0,0,0,0,0,0,0,0,0,100,NoArch
55c4983ed843082802ead17874214554e5f6405a,0,0,0,0,0,0,0,0,0,0,0,0,0,0,0,91,91,0,0,0,0,0,0,0,0,0,0,100,NoArch
557afc7ccbce8ea810de39fc90bdc913c2e30873,1,22,0,22,22,1,0,1,272,5,1,1,0,7624,22,293,10,1077,1075,2,29109,29077,32,515,513,2,1,100,NoArch
e3f658a00274e5421741cb99e283b389864ca05c,0,0,0,0,0,0,0,0,0,0,0,0,0,0,0,92,92,0,0,0,0,0,0,0,0,0,0,100,NoArch
99daa90c06a510628f7c2e7f72142e8839ee9188,0,0,0,0,0,0,0,0,0,0,0,0,0,0,0,93,93,0,0,0,0,0,0,0,0,0,0,100,NoArch
78affcee2bffbe9ea0f3e3b13eb176a82a1dcdb0,0,0,0,0,0,0,0,0,0,0,0,0,0,0,0,94,94,0,0,0,0,0,0,0,0,0,0,100,NoArch
9a0e7f850ee3bf018f1439005d3fbbbae7b9287c,0,0,0,0,0,0,0,0,0,0,0,0,0,0,0,95,95,0,0,0,0,0,0,0,0,0,0,100,NoArch
2c45458c48e5c004ac8cb2cba497dcf077bf8f9d,0,0,0,0,0,0,0,0,0,0,0,0,0,0,0,96,96,0,0,0,0,0,0,0,0,0,0,100,NoArch
e4c037faeff8f1c3da93a3cab62dbf6e50d2bf95,0,0,0,0,0,0,0,0,0,0,0,0,0,0,0,232,0,0,0,0,0,0,0,0,0,0,1,100,NoArch
1f0deb5f1502de063dc91fab392efe9c44332c94,2,5,1,4,6,1,0,1,273,1,1,2,0.918295834,7663,1,294,11,1080,1079,1,29174,29153,21,518,517,1,0,99.88499137,NoArch
f927bed66b5ac3fa4feccb9cc74ab1ed95793326,0,0,0,0,0,0,0,0,0,0,0,0,0,0,0,97,97,0,0,0,0,0,0,0,0,0,0,100,NoArch
545aed3104b85e8ccae8f719a883c52ca97cd28e,0,0,0,0,0,0,0,0,0,0,0,0,0,0,0,98,98,0,0,0,0,0,0,0,0,0,0,100,NoArch
d193f2ae17a172ac42a2b81eb2f185f5420b08ff,0,0,0,0,0,0,0,0,0,0,0,0,0,0,0,99,99,0,0,0,0,0,0,0,0,0,0,100,NoArch
d6cb79da7b2dfd5b7b316b351051fc2f1d312d3c,0,0,0,0,0,0,0,0,0,0,0,0,0,0,0,100,100,0,0,0,0,0,0,0,0,0,0,100,NoArch
8966d4c40b9a665aa60890f7a40839fc9b58d22a,0,0,0,0,0,0,0,0,0,0,0,0,0,0,0,101,101,0,0,0,0,0,0,0,0,0,0,100,NoArch
8512d9dbe47c409b89ee1302c8d37c79d91b28f9,0,0,0,0,0,0,0,0,0,0,0,0,0,0,0,102,102,0,0,0,0,0,0,0,0,0,0,100,NoArch
9753164681580c7f2d1b8268c0806e40282038ff,0,0,0,0,0,0,0,0,0,0,0,0,0,0,0,103,103,0,0,0,0,0,0,0,0,0,0,100,NoArch
31eaf94ff881145e85523f6e0eb614c721526aa8,0,0,0,0,0,0,0,0,0,0,0,0,0,0,0,104,104,0,0,0,0,0,0,0,0,0,0,100,NoArch
eb61950da94fe983b11bfb0621d2d61616840b36,0,0,0,0,0,0,0,0,0,0,0,0,0,0,0,105,105,0,0,0,0,0,0,0,0,0,0,100,NoArch
68d2cf0a0284f5a793edbe075eb79d908595d096,0,0,0,0,0,0,0,0,0,0,0,0,0,0,0,106,106,0,0,0,0,0,0,0,0,0,0,100,NoArch
2a5252635865b8e0f02c4620cc6283da74368cb6,0,0,0,0,0,0,0,0,0,0,0,0,0,0,0,107,107,0,0,0,0,0,0,0,0,0,0,100,NoArch
5f8ee7411ad89a5f39ac3eeadcdd4e85df95df3a,0,0,0,0,0,0,0,0,0,0,0,0,0,0,0,108,108,0,0,0,0,0,0,0,0,0,0,100,NoArch
b8668e39d97a5ea791969f2d67d3323c02981837,0,0,0,0,0,0,0,0,0,0,0,0,0,0,0,109,109,0,0,0,0,0,0,0,0,0,0,100,NoArch
febf47b67d77950e24cf08aed27a5b13d112bf16,1,2,0,2,2,1,0,1,3,12,1,1,0,96,1,110,110,8,8,0,279,279,0,8,8,0,0,100,NoArch
018bb098148629c0234b80e01ef95c6a7ce1f969,0,0,0,0,0,0,0,0,0,0,0,0,0,0,0,111,111,0,0,0,0,0,0,0,0,0,0,100,NoArch
da4c8fdb7c304b57d7553a924c94e7a9b07e5b6d,1,4,3,1,7,0,0,0,22,16,1,1,0,567,10,43,4,76,76,0,2113,2113,0,37,37,0,0,100,NoArch
9a54ce4ed494e2cc977180023693f6b38a8b02d9,0,0,0,0,0,0,0,0,0,0,0,0,0,0,0,112,112,0,0,0,0,0,0,0,0,0,0,100,NoArch
663886dfacadab8924d71ff3e5597bfda6fd01a0,0,0,0,0,0,0,0,0,0,0,0,0,0,0,0,113,113,0,0,0,0,0,0,0,0,0,0,100,NoArch
08d8f0a7122171b75e13d4aacd66a6a464d6b95f,0,0,0,0,0,0,0,0,0,0,0,0,0,0,0,114,114,0,0,0,0,0,0,0,0,0,0,100,NoArch
00565b07b7b73bc9e264da2f17b62a047a32deeb,0,0,0,0,0,0,0,0,0,0,0,0,0,0,0,115,115,0,0,0,0,0,0,0,0,0,0,100,NoArch
420cf06c0ccf9fb359ff8b755016f3ff5dc6d9f1,0,0,0,0,0,0,0,0,0,0,0,0,0,0,0,116,116,0,0,0,0,0,0,0,0,0,0,100,NoArch
a36b4e4022a71cb77eca178639d5b639d853847f,0,0,0,0,0,0,0,0,0,0,0,0,0,0,0,117,117,0,0,0,0,0,0,0,0,0,0,100,NoArch
dec1789c4541dda3b10a9b3d526645231b5cfd32,0,0,0,0,0,0,0,0,0,0,0,0,0,0,0,118,118,0,0,0,0,0,0,0,0,0,0,100,NoArch
14bb4d4a06f14c4dc5efe2fc6c08d41fc29d1087,0,0,0,0,0,0,0,0,0,0,0,0,0,0,0,119,119,0,0,0,0,0,0,0,0,0,0,100,NoArch
d41bf62441be5f3089927ab67ce760062fb32799,0,0,0,0,0,0,0,0,0,0,0,0,0,0,0,120,120,0,0,0,0,0,0,0,0,0,0,100,NoArch
c4106e0da4b1944013b0c2d1aafdcebd81517ac9,0,0,0,0,0,0,0,0,0,0,0,0,0,0,0,121,121,0,0,0,0,0,0,0,0,0,0,100,NoArch
ea7ef0c8453496cda84a4d8d9a612a46bbd79586,0,0,0,0,0,0,0,0,0,0,0,0,0,0,0,122,122,0,0,0,0,0,0,0,0,0,0,100,NoArch
283a89541e584f110109bc484bfa2c6a94ba90c6,0,0,0,0,0,0,0,0,0,0,0,0,0,0,0,123,123,0,0,0,0,0,0,0,0,0,0,100,NoArch
f9a41739b31139c2b714a316efc0e9db3c96934e,0,0,0,0,0,0,0,0,0,0,0,0,0,0,0,124,124,0,0,0,0,0,0,0,0,0,0,100,NoArch
5af8cf0ac9becc2aec11c766883534438a7a607c,1,109,0,109,109,1,0,1,1,0,1,1,0,0,1,125,125,9,0,9,279,0,279,5,0,5,0,99.9137931,NoArch
ed4d48f492ad2aab1531e5ae37f99baea02436a4,0,0,0,0,0,0,0,0,0,0,0,0,0,0,0,126,126,0,0,0,0,0,0,0,0,0,0,100,NoArch
cc5a73a91c38b0c3176766eae400fc5c740d2050,1,53,10,43,63,0,0,0,2,0,1,1,0,109,1,127,127,16,9,7,487,279,208,11,5,6,0,100,NoArch
73b8f6fea9ad4802c32c4f394db85e73bac78f0d,2,1,99,98,100,0,0,0,37,15,1,2,0.141440543,942,1,128,128,78,86,8,2717,2996,279,27,35,8,0,99.88505747,NoArch
b1b4411dd3eaacb9888abf3bc7c02a70917d8612,0,0,0,0,0,0,0,0,0,0,0,0,0,0,0,129,129,0,0,0,0,0,0,0,0,0,0,100,NoArch
01610a74947455972cfcdb03cdb282a6a39435d1,0,0,0,0,0,0,0,0,0,0,0,0,0,0,0,130,130,0,0,0,0,0,0,0,0,0,0,100,NoArch
9c07a665dc0139beec62224c6d6ce0e058a72c38,1,69,0,69,69,1,0,1,1,0,1,1,0,0,1,131,131,7,0,7,221,0,221,4,0,4,0,99.94252874,NoArch
d12d126b916ea2eb0316c9466fbde89e707ecf8d,1,97,0,97,97,1,0,1,1,0,1,1,0,0,1,132,132,4,0,4,249,0,249,4,0,4,0,99.94259472,NoArch
ea861a8a8a6b5eb1b08c29853cda4aae22393cab,2,18,13,5,31,0,0,0,2,0,1,1,0.823811633,166,1,133,133,12,11,1,486,470,16,8,8,0,0,100,NoArch
5a8b0a6f4794175bb60503edc4b1907717bc830d,0,0,0,0,0,0,0,0,0,0,0,0,0,0,0,134,134,0,0,0,0,0,0,0,0,0,0,100,NoArch
93210935bace18e6df4f162850871b83c5204ee2,0,0,0,0,0,0,0,0,0,0,0,0,0,0,0,135,135,0,0,0,0,0,0,0,0,0,0,100,NoArch
1e22ab1271c994e64113020c87030650ee064cfd,1,80,0,80,80,1,0,1,1,0,1,1,0,0,1,136,136,11,0,11,287,0,287,4,0,4,0,99.94266055,NoArch
2ff3c510f3d11f4029b4156f28482b2258d96a38,0,0,0,0,0,0,0,0,0,0,0,0,0,0,0,137,137,0,0,0,0,0,0,0,0,0,0,100,NoArch
21f27c582561dac2d922aa5b037563c10efd8da4,1,25,8,17,33,0,0,0,3,0,1,1,0,152,1,138,138,19,16,3,549,487,62,13,11,2,0,100,NoArch
deea851dad65a55e54ffce110f4214962bee43de,0,0,0,0,0,0,0,0,0,0,0,0,0,0,0,139,139,0,0,0,0,0,0,0,0,0,0,100,NoArch
d154677ad38e3b5d2c950489b09266e4d9955372,0,0,0,0,0,0,0,0,0,0,0,0,0,0,0,140,140,0,0,0,0,0,0,0,0,0,0,100,NoArch
05207691b074a671f2e0e06225d58ef5ef51a333,0,0,0,0,0,0,0,0,0,0,0,0,0,0,0,141,141,0,0,0,0,0,0,0,0,0,0,100,NoArch
478cdd1f6fc06a602d8619a5af681076674e7895,0,0,0,0,0,0,0,0,0,0,0,0,0,0,0,142,142,0,0,0,0,0,0,0,0,0,0,100,NoArch
6d1c9defb7f0e8dcdf51b18c93c31d3bf13546bc,0,0,0,0,0,0,0,0,0,0,0,0,0,0,0,143,143,0,0,0,0,0,0,0,0,0,0,100,NoArch
3729b28ba23aa87e192af94a310c4201cf3e1bec,0,0,0,0,0,0,0,0,0,0,0,0,0,0,0,144,144,0,0,0,0,0,0,0,0,0,0,100,NoArch
f9022f908cf941f06f5142e7bf0f0d2c0ae1cf2f,0,0,0,0,0,0,0,0,0,0,0,0,0,0,0,145,145,0,0,0,0,0,0,0,0,0,0,100,NoArch
cfea9731eea3de59beb5fbf4689047ade2a2d491,0,0,0,0,0,0,0,0,0,0,0,0,0,0,0,146,146,0,0,0,0,0,0,0,0,0,0,100,NoArch
034797deae79bf32ea8cee65ed8e23d8031e3dca,3,100,74,26,174,1,0,1,3,0,1,2,1.062693506,153,1,147,147,22,19,3,597,524,73,11,8,3,1,99.71354913,NoArch
b71d27d97f0c79754329f8144b167ba09a155a76,0,0,0,0,0,0,0,0,0,0,0,0,0,0,0,148,148,0,0,0,0,0,0,0,0,0,0,100,NoArch
1a684bd2087268e451189eed251afd538f9946cd,0,0,0,0,0,0,0,0,0,0,0,0,0,0,0,149,149,0,0,0,0,0,0,0,0,0,0,100,NoArch
bd3ef143f528b800dcc98021ce162d34baa2c94d,0,0,0,0,0,0,0,0,0,0,0,0,0,0,0,150,150,0,0,0,0,0,0,0,0,0,0,100,NoArch
95b03b7c104049214a9885020dbb3e6b0badaddd,1,3,1,2,4,0,0,0,2,0,1,1,0,99,1,151,151,11,11,0,334,310,24,7,7,0,0,100,NoArch
1c0b5a36771d50d00fca8f428ea5b5fd0ee3b09a,1,4,2,2,6,0,0,0,3,0,1,1,0,101,1,152,152,11,11,0,310,334,24,7,7,0,0,100,NoArch
f4087002da2a540b3d2d49d71caf09aa43902f51,0,0,0,0,0,0,0,0,0,0,0,0,0,0,0,153,153,0,0,0,0,0,0,0,0,0,0,100,NoArch
00a4cb19d6591f15b2504072fc33ffa5c7d37c23,0,0,0,0,0,0,0,0,0,0,0,0,0,0,0,154,154,0,0,0,0,0,0,0,0,0,0,100,NoArch
24558c411a9a6f3baf291c82a0bb816aa418e241,3,86,10,76,96,1,0,1,4,0,1,2,0.74299334,201,1,155,155,25,15,10,839,559,280,17,11,6,0,99.94275902,NoArch
7fa40d35c97681880e4fb374d1e6f7a4f5976814,1,1,1,0,2,0,0,0,5,0,1,1,0,95,1,156,156,11,11,0,314,310,4,7,7,0,0,100,NoArch
ef7a05e2558e9979d8458c5fca804dbdc5043cea,1,0,1,1,1,0,0,0,2,0,1,1,0,82,1,157,157,10,10,0,258,265,7,6,6,0,0,100,NoArch
f4b3d67c781bf7baf067f4991945079d20a11ba4,0,0,0,0,0,0,0,0,0,0,0,0,0,0,0,158,158,0,0,0,0,0,0,0,0,0,0,100,NoArch
8b3e042dec491c634d8bb492beb5906ed1eeec32,0,0,0,0,0,0,0,0,0,0,0,0,0,0,0,159,159,0,0,0,0,0,0,0,0,0,0,100,NoArch
c61dcf1d9ea7cacc2ae6b408aa7ee811ead44f1e,0,0,0,0,0,0,0,0,0,0,0,0,0,0,0,160,160,0,0,0,0,0,0,0,0,0,0,100,NoArch
aac90e7e12c5cbe0ef233b2ef6eab47a7b66dae2,0,0,0,0,0,0,0,0,0,0,0,0,0,0,0,161,161,0,0,0,0,0,0,0,0,0,0,100,NoArch
3968b47a14f764d3c93b87c1c85fd3f55288b1f7,0,0,0,0,0,0,0,0,0,0,0,0,0,0,0,162,162,0,0,0,0,0,0,0,0,0,0,100,NoArch
b6a37baae884d7cf63f84f1ae06f09ac59a193aa,0,0,0,0,0,0,0,0,0,0,0,0,0,0,0,163,163,0,0,0,0,0,0,0,0,0,0,100,NoArch
7be26cf3f507eef961572c8628abf6152f4c9cd2,2,40,64,24,104,0,0,0,12,154,1,1,0.51594693,355,5,295,12,53,52,1,1449,1528,79,20,20,0,1,100,NoArch
6e89c4de5656dd45c37e240d7a0231ca59ab482c,1,3,2,1,5,0,0,0,3,25,1,1,0,631,1,603,8,147,144,3,3695,3670,25,40,40,0,0,100,NoArch
d5b7235dce7672c46d1ace2cd5dd43b14db24c9c,0,0,0,0,0,0,0,0,0,0,0,0,0,0,0,164,164,0,0,0,0,0,0,0,0,0,0,100,NoArch
2e42e45a64a261a36d35ad68ac1385a047b2f23c,0,0,0,0,0,0,0,0,0,0,0,0,0,0,0,165,165,0,0,0,0,0,0,0,0,0,0,100,NoArch
7ab6670af68f2dbf5b3d63e90233fd1be6ba84ee,0,0,0,0,0,0,0,0,0,0,0,0,0,0,0,166,166,0,0,0,0,0,0,0,0,0,0,100,NoArch
e1619e32b45ad905418911dcdf0741c5ccf7f49d,3,343,84,259,427,1,0,1,4,2,1,2,0.803126116,181,1,167,167,38,14,24,1539,522,1017,26,10,16,0,99.88558352,NoArch
23a4ded6fe9f62e5cadb69d973ce34f6362057da,3,113,73,40,186,1,0,1,6,1,1,2,0.290823727,535,1,168,168,53,49,4,2127,1853,274,35,33,2,0,100,NoArch
33b2f1bd0a90bb7ff353b33146b64e2fd4670aab,1,47,10,37,57,0,0,0,3,0,1,1,0,374,1,169,169,43,38,5,1657,1538,119,28,24,4,0,99.91416309,NoArch
3135b00c2ae34b6418d81c3b496a142655767363,0,0,0,0,0,0,0,0,0,0,0,0,0,0,0,170,170,0,0,0,0,0,0,0,0,0,0,100,NoArch
5c794e87199e1eb3190df44c166c3df0392d2a64,1,37,1,36,38,0,0,0,2,3,1,1,0,80,1,171,168,16,11,5,409,287,122,6,4,2,0,99.94275902,NoArch
67ceedcb1e0f151fe9267de6e151a39318f668c3,1,7,1,6,8,0,0,0,7,0,1,1,0,95,1,172,169,12,11,1,355,323,32,7,7,0,0,100,NoArch
77e4d33d7632e582434c1782a1b818da813d2f14,0,0,0,0,0,0,0,0,0,0,0,0,0,0,0,173,170,0,0,0,0,0,0,0,0,0,0,100,NoArch
d607d13d49bb9db0fa880684677ddbcea41fcd72,0,0,0,0,0,0,0,0,0,0,0,0,0,0,0,174,171,0,0,0,0,0,0,0,0,0,0,100,NoArch
75e68a3e9ff9e5c82f497a406d26d04a29bd1439,0,0,0,0,0,0,0,0,0,0,0,0,0,0,0,175,172,0,0,0,0,0,0,0,0,0,0,100,NoArch
e65e1eb9987733ee466b289351467398880182dc,0,0,0,0,0,0,0,0,0,0,0,0,0,0,0,176,173,0,0,0,0,0,0,0,0,0,0,100,NoArch
4205198cf96856f28b05ab233ae1125d43cbc9ba,0,0,0,0,0,0,0,0,0,0,0,0,0,0,0,177,174,0,0,0,0,0,0,0,0,0,0,100,NoArch
4451fb1f1ac2b100e18b5c6d415560728d156d7b,0,0,0,0,0,0,0,0,0,0,0,0,0,0,0,178,175,0,0,0,0,0,0,0,0,0,0,100,NoArch
797c8b2fdd03f55c80d3d1bfda6796ea69e9826c,0,0,0,0,0,0,0,0,0,0,0,0,0,0,0,179,176,0,0,0,0,0,0,0,0,0,0,100,NoArch
8f440766bb296cf76b909b0ec1aee7291f033001,0,0,0,0,0,0,0,0,0,0,0,0,0,0,0,180,177,0,0,0,0,0,0,0,0,0,0,100,NoArch
12645806679aa397aedf5f9c8e583a642c95ce14,0,0,0,0,0,0,0,0,0,0,0,0,0,0,0,181,178,0,0,0,0,0,0,0,0,0,0,100,NoArch
0521678319b59037ca6f0ae9fab79107cf08be90,0,0,0,0,0,0,0,0,0,0,0,0,0,0,0,182,179,0,0,0,0,0,0,0,0,0,0,100,NoArch
39eaf1a714d6af94f0c53ec5d4f58c12b7f6aa24,0,0,0,0,0,0,0,0,0,0,0,0,0,0,0,183,180,0,0,0,0,0,0,0,0,0,0,100,NoArch
6d4643fc44a0f23f7a6ecc727aa073f04a0aadf8,1,3,0,3,3,1,0,1,8,37,1,1,0,279,4,44,1,45,44,1,1064,1041,23,15,15,0,0,100,NoArch
3586eed66b7b0705788e84b85ff048732ccc0890,0,0,0,0,0,0,0,0,0,0,0,0,0,0,0,184,181,0,0,0,0,0,0,0,0,0,0,100,NoArch
c6ebc5379734ac8008eccfe9e72e2dcbb2481ef6,2,3,27,24,30,0,0,0,38,6,1,2,0.721928095,1013,12,185,182,94,97,3,3198,3266,68,37,40,3,0,100,NoArch
7d53e89026cf241abd9fbecaca558d976017e03e,1,46,14,32,60,0,0,0,8,1,1,1,0,101,1,186,183,19,12,7,498,355,143,11,7,4,0,100,NoArch
7bbd26155142edf8f9ba94d6a0ed92f65070734f,0,0,0,0,0,0,0,0,0,0,0,0,0,0,0,187,184,0,0,0,0,0,0,0,0,0,0,100,NoArch
c0fff52486084e1c153284dfd73fae83bd070615,0,0,0,0,0,0,0,0,0,0,0,0,0,0,0,188,185,0,0,0,0,0,0,0,0,0,0,100,NoArch
a2419caa40a615730f9f1c21ca83eb3ca844088c,0,0,0,0,0,0,0,0,0,0,0,0,0,0,0,189,186,0,0,0,0,0,0,0,0,0,0,100,NoArch
eaf534fa7085e11f03c315692cadc4ba9d15789f,0,0,0,0,0,0,0,0,0,0,0,0,0,0,0,0,0,0,0,0,0,0,0,0,0,0,0,100,NoArch
150e89044c3191dea6b4553e64431ec15516a2e6,1,1,1,0,2,0,0,0,140,34,1,1,0,3649,12,296,12,593,593,0,19943,19935,8,154,154,0,1,100,NoArch
5bb50bae7eac70ab1d9faeaa5bf55676bdc5dcdb,1,5,4,1,9,0,0,0,3,108,1,1,0,148,2,297,13,35,35,0,878,867,11,10,10,0,1,100,NoArch
d30c259a396e2b0e0a98d473994e3b3a3bede9a9,11,594,1,593,595,10,0,10,42,7,1,3,3.238171533,520,1,21,2,156,99,57,4812,3179,1633,77,32,45,0,99.34584755,NoArch
eb68bdf6884e8924855e9ae6ce5b50138b015cc8,1,4,0,4,4,1,0,1,2,0,1,1,0,84,1,22,3,7,6,1,380,360,20,1,1,0,0,100,NoArch
0cc659adf4bb182a38b8d407e03ef07bdbf50921,1,1,1,0,2,0,0,0,2,0,1,1,0,106,1,23,4,17,17,0,384,376,8,12,12,0,0,100,NoArch
a324bdc67bbf8d54441f4021bc090f74f69b00d5,0,0,0,0,0,0,0,0,0,0,0,0,0,0,0,24,5,0,0,0,0,0,0,0,0,0,0,100,NoArch
bafab45d9bb5ffbf8b863bb58e666f35ec83f414,29,702,460,242,1162,3,0,3,274,99,1,11,3.924822681,22927,5,1,1,4186,4144,42,114211,112433,1778,1381,1359,22,0,99.80253879,NoArch
74a9df0c7e21374b845eaec27541e0e296cb6b3c,4,342,0,342,342,4,0,4,1,0,1,1,1.602719931,0,1,2,2,55,0,55,1544,0,1544,24,0,24,0,99.69109801,NoArch
ecdd9486d57b67d63f50cb022dbc194fefb51a8b,4,0,342,342,342,0,4,4,2,0,1,1,1.602719931,342,1,3,3,0,55,55,0,1544,1544,0,24,24,0,99.69109801,NoArch
197451937cb07b4c4d5ab3109d726fc92733fffe,4,342,0,342,342,4,0,4,1,0,1,1,1.602719931,0,1,4,4,55,0,55,1544,0,1544,24,0,24,0,99.66301601,NoArch
b81124641e7451d78367607a2634a4bf1bfc0370,1,10,3,7,13,0,0,0,12,1,1,1,0,294,5,5,5,41,41,0,1238,1209,29,19,19,0,0,100,NoArch
12f7a14bf0a3dbb45a04971022eb37aa297fd29e,1,12,14,2,26,0,0,0,13,0,1,1,0,301,5,6,6,41,41,0,1260,1238,22,19,19,0,0,100,NoArch
858f190f4e9b1fe9245bf6761f3b3e84ac402855,3,2,4,2,6,0,0,0,39,5,1,2,1.584962501,1400,1,190,182,137,137,0,4864,4855,9,65,65,0,0,99.80397648,NoArch
8e0800e0eefb86c26c1234e52340547cfe3163a3,0,0,0,0,0,0,0,0,0,0,0,0,0,0,0,191,183,0,0,0,0,0,0,0,0,0,0,100,NoArch
7a96da8e7da4a5c2cee014e3ebaa34016cae9d58,0,0,0,0,0,0,0,0,0,0,0,0,0,0,0,192,184,0,0,0,0,0,0,0,0,0,0,100,NoArch
f2272cc1a083d331f5e11538d770a8fed74a966f,0,0,0,0,0,0,0,0,0,0,0,0,0,0,0,193,185,0,0,0,0,0,0,0,0,0,0,100,NoArch
1b8fe0ec2132b916760148014967003cb6ed2c8d,1,18,6,12,24,0,0,0,5,0,1,1,0,409,1,194,185,47,43,4,1709,1650,59,31,28,3,0,100,NoArch
ce82e3b34f0e8cb577b01bacffde06c292cccf0c,0,0,0,0,0,0,0,0,0,0,0,0,0,0,0,195,186,0,0,0,0,0,0,0,0,0,0,100,NoArch
603ea187fe5fac883b1200c5b9102b887e841b3e,1,4,2,2,6,0,0,0,9,8,1,1,0,133,1,196,187,17,19,2,454,498,44,11,11,0,0,100,NoArch
a4c250b84019c552b8ffc43750bdf4c6e3dd610f,0,0,0,0,0,0,0,0,0,0,0,0,0,0,0,197,188,0,0,0,0,0,0,0,0,0,0,100,NoArch
6eeb4655b1ee52cffb51405e3e203399eda0f376,0,0,0,0,0,0,0,0,0,0,0,0,0,0,0,198,189,0,0,0,0,0,0,0,0,0,0,100,NoArch
2130ffe5da932dc2df6c0fb3376d4807313a03ac,2,61,7,54,68,0,0,0,10,6,1,2,0.969204095,241,1,199,189,23,21,2,1001,720,281,15,15,0,0,100,NoArch
90c353cd2c645480f157af24448fbdadfd44bcad,1,1,3,2,4,0,0,0,11,0,1,1,0,158,1,200,190,19,17,2,614,570,44,11,11,0,0,100,NoArch
51a1977f215b5e6231dab73430930e5845e7c146,0,0,0,0,0,0,0,0,0,0,0,0,0,0,0,25,6,0,0,0,0,0,0,0,0,0,0,100,NoArch
e1796fd5e71349991fd3f19f7c075e8afb273d4e,15,589,86,503,675,4,0,4,4,2,1,4,3.003243779,666,1,26,7,129,63,66,3904,1785,2119,79,50,29,0,99.66489807,NoArch
f9fb43f6e4569f7b3d7085834e0c0838f7a8abde,1,54,1,53,55,0,0,0,23,18,1,1,0,568,10,604,9,91,76,15,2457,2113,344,40,37,3,1,100,NoArch
6e114625c0ee3ef4d1c71b3e02d484d7e84c58a5,1,1,0,1,1,1,0,1,24,0,1,1,0,621,10,605,10,91,91,0,2464,2457,7,40,40,0,0,100,NoArch
de7d20a9d32032d1b951db1f565eeff5592aaed4,1,95,0,95,95,1,0,1,1,0,1,1,0,0,1,27,8,7,0,7,399,0,399,2,0,2,0,99.91648107,NoArch
a9f22b481ea43734f890c7e9df03534f7f59843a,4,194,1,193,195,3,0,3,43,1,1,3,0.567756816,724,1,28,9,148,116,32,4564,3886,678,65,38,27,0,99.80609418,NoArch
68543f11927b19aff21e859eb9fe59168192bbbe,2,2,3,1,5,0,0,0,12,2,1,2,0.970950594,293,1,201,189,25,25,0,1036,1045,9,15,15,0,0,100,NoArch
716a587243b700970669149fd9e35cbd6e44a218,1,24,6,18,30,0,0,0,4,175,1,1,0,383,4,202,172,88,85,3,2518,2481,37,20,19,1,0,100,NoArch
f5545c75d562a24b4bd0de1bd779669124bd9035,1,1,1,0,2,0,0,0,50,8,1,1,0,899,6,203,173,209,209,0,5899,5899,0,44,44,0,0,100,NoArch
e60f566795ab57ed639cd75643cc37600f52c069,1,8,0,8,8,1,0,1,32,8,1,1,0,180,11,204,174,34,32,2,760,728,32,24,22,2,0,100,NoArch
59fa2ee5ca0f09c3fb6011b94dcd06ffa712c657,1,209,48,161,257,0,0,0,5,0,1,1,0,401,4,205,175,107,88,19,3358,2518,840,22,20,2,0,100,NoArch
b4b0dec957421fb76361bd6ad9888f720ffd0fb6,1,27,8,19,35,0,0,0,4,39,1,1,0,90,1,206,176,10,7,3,493,404,89,2,1,1,0,100,NoArch
662ce8fb526d1c7fb7ce0e485e7fefc788df877e,1,5,5,0,10,0,0,0,11,39,1,1,0,251,1,207,177,35,35,0,929,925,4,20,20,0,0,100,NoArch
70f640158ce153403db525817607d77569f0c23a,1,1,1,0,2,0,0,0,5,0,1,1,0,109,1,208,178,10,10,0,493,493,0,2,2,0,0,100,NoArch
867b6efc032a43a0b2e362e57d0734078ebddb1e,1,5,0,5,5,1,0,1,12,0,1,1,0,251,1,209,179,35,35,0,935,929,6,20,20,0,0,100,NoArch
60ed0fc2542ff16255c4d947ec199999b97dfab3,0,0,0,0,0,0,0,0,0,0,0,0,0,0,0,210,180,0,0,0,0,0,0,0,0,0,0,100,NoArch
9cd7b453c70429c93776d9f4cc5a9a7993ff82f6,0,0,0,0,0,0,0,0,0,0,0,0,0,0,0,211,181,0,0,0,0,0,0,0,0,0,0,100,NoArch
c61da7c8ed23e1f24ff335ed8066125283819670,0,0,0,0,0,0,0,0,0,0,0,0,0,0,0,212,182,0,0,0,0,0,0,0,0,0,0,100,NoArch
227261b0c00475a84f64e873fcabd1c0160b1fce,0,0,0,0,0,0,0,0,0,0,0,0,0,0,0,213,183,0,0,0,0,0,0,0,0,0,0,100,NoArch
4fbb92b53664d4cbb9136660de1bb3384a5a755e,0,0,0,0,0,0,0,0,0,0,0,0,0,0,0,214,184,0,0,0,0,0,0,0,0,0,0,100,NoArch
0bf607378d0b58ea8bc210020f2394e4b4fa0d9e,1,10,1,9,11,0,0,0,2,40,1,1,0,140,1,215,185,17,15,2,556,511,45,8,8,0,0,100,NoArch
fa758bd3af8b288a43a083b8d6fa33d3f947307b,1,3,1,2,4,0,0,0,14,8,1,1,0,299,5,606,3,42,41,1,1281,1260,21,19,19,0,0,100,NoArch
5c6bfa3c5f205fb2ab45794b0164674896f502eb,1,4,2,2,6,0,0,0,69,50,1,1,0,562,11,30,0,89,88,1,1800,1778,22,49,49,0,1,100,NoArch
21f49c49a007f29be44f4977856f75da0a937cb0,14,433,75,358,508,5,0,5,142,62,1,5,2.562390935,10953,10,607,4,2040,2002,38,60429,58247,2182,614,601,13,1,97.46004566,Arch
b214cc994a3ec953cb705117d9ece25fec5c210b,0,0,0,0,0,0,0,0,0,0,0,0,0,0,0,216,168,0,0,0,0,0,0,0,0,0,0,100,NoArch
7aa16c12acd92954d6141884f898ee7397d4691c,0,0,0,0,0,0,0,0,0,0,0,0,0,0,0,217,169,0,0,0,0,0,0,0,0,0,0,100,NoArch
ef4e5128a7122449ccf045e8f2c7d6c5441236d3,0,0,0,0,0,0,0,0,0,0,0,0,0,0,0,298,14,0,0,0,0,0,0,0,0,0,0,100,NoArch
c930f1538701f4f9476ab2613d8af1b11bc0b9e7,0,0,0,0,0,0,0,0,0,0,0,0,0,0,0,299,15,0,0,0,0,0,0,0,0,0,0,100,NoArch
ece81c11c78a0d5e61b36f3677e965d881336990,7,48,123,75,171,0,0,0,167,49,1,4,2.088265345,2573,2,300,16,272,272,0,10410,10426,16,125,125,0,0,100,NoArch
ddcf27daef03bb9e9e4eed8eb0e1b20fd8c9e67d,1,35,34,1,69,0,0,0,14,185,1,1,0,630,4,301,10,91,91,0,2609,2593,16,46,46,0,0,100,NoArch
3501610f7b3580ad05fdf8cac45125657f12567b,0,0,0,0,0,0,0,0,0,0,0,0,0,0,0,114,0,0,0,0,0,0,0,0,0,0,0,100,NoArch
9c49db39eb277327f417a58702997b4ee96944bb,1,2,0,2,2,1,0,1,37,53,1,1,0,456,11,218,153,53,53,0,2086,2086,0,14,14,0,0,100,NoArch
c4080c4b1881a843ab2f919163f275719e088c17,1,58,8,50,66,0,0,0,38,0,1,1,0,458,11,219,154,57,53,4,2269,2086,183,15,14,1,0,100,NoArch
c3750c8f1d62d7a3f57d00a89da4cd64d5117f40,0,0,0,0,0,0,0,0,0,0,0,0,0,0,0,220,155,0,0,0,0,0,0,0,0,0,0,100,NoArch
a22926209e8400d24bd4dd05e01eeb43c89ae7dd,1,3,12,9,15,0,0,0,39,0,1,1,0,508,11,221,156,53,57,4,2207,2269,62,14,15,1,0,100,NoArch
e3c514c40507c250ec9943ab2bb6afd8a2dbddf5,0,0,0,0,0,0,0,0,0,0,0,0,0,0,0,222,157,0,0,0,0,0,0,0,0,0,0,100,NoArch
48001ab24be76dc3d3f2aa4bbb2bfee0a0eab330,1,17,11,6,28,0,0,0,18,144,1,1,0,231,9,223,158,22,22,0,1113,1089,24,8,8,0,0,99.94086339,NoArch
9a1ba445949f3c3dee1e75c37dec6b9efb13184b,0,0,0,0,0,0,0,0,0,0,0,0,0,0,0,18,0,0,0,0,0,0,0,0,0,0,0,100,NoArch
058e4e21382d5c0da03b4acc72d0d1fffb9cd260,13,133,177,44,310,0,0,0,44,11,1,4,3.261231936,1770,1,29,8,262,255,7,7852,7818,34,126,128,2,0,99.64454976,NoArch
c12ac983da96b28114dbe505fb739c0ddf50129e,0,0,0,0,0,0,0,0,0,0,0,0,0,0,0,30,9,0,0,0,0,0,0,0,0,0,0,100,NoArch
71a593024006ff77fb4db3af6a6c64ad00e34b0c,1,1,1,0,2,0,0,0,19,1,1,1,0,237,9,224,144,22,22,0,1109,1113,4,8,8,0,0,100,NoArch
6c95ba8e66cd78bd470be212e0a4761ce3d70695,0,0,0,0,0,0,0,0,0,0,0,0,0,0,0,225,145,0,0,0,0,0,0,0,0,0,0,100,NoArch
b4860fd20d89660f54a03cc4d1c5efb01cb5a366,7,7,40,33,47,0,0,0,13,189,1,2,2.507029418,402,3,302,9,35,36,1,977,1027,50,29,29,0,0,100,NoArch
83b38080118fd2c1072584b9c6a109cb414bfaa3,0,0,0,0,0,0,0,0,0,0,0,0,0,0,0,226,146,0,0,0,0,0,0,0,0,0,0,100,NoArch
81fce84516488e7dce1a48c7c5d1f572994804b2,2,0,4,4,4,0,0,0,40,1,1,2,1,736,10,303,10,75,75,0,3316,3316,0,22,22,0,0,100,NoArch
47a90cb223a034e80026810dab9d7b4783b7f17a,0,0,0,0,0,0,0,0,0,0,0,0,0,0,0,19,1,0,0,0,0,0,0,0,0,0,0,100,NoArch
98a92e4df055acd1b98ff56a93984ba7d61b7230,4,106,30,76,136,3,0,3,3,188,1,2,1.570218821,178,1,20,2,13,9,4,1304,1026,278,12,8,4,1,99.12808178,NoArch
ebd92ad52462d90a5dbc2ef3581ac2c9504e068d,144,1160,1237,77,2397,0,0,0,196,175,1,40,4.382315372,35331,3,304,10,6226,6228,2,162569,163145,576,2392,2392,0,0,99.20391917,NoArch
36735332946a8de7cbfa6b2d14718666156eb366,1,1,1,0,2,0,0,0,4,0,1,1,0,40,3,305,11,2,2,0,63,63,0,2,2,0,0,100,NoArch
efaa68816660f1585b117f31fb4bad8f73ada366,8,196,224,28,420,0,0,0,45,7,1,2,1.668147685,2941,2,306,12,375,375,0,14060,14048,12,152,152,0,0,100,NoArch
433c8f0ffc34c11261732f6af096418fefa47ad2,6,112,123,11,235,0,0,0,29,62,1,5,1.877953629,2490,4,307,13,499,503,4,13241,13284,43,129,128,1,0,100,NoArch
72bea5b9f4704472601ae7fc155ad6a7cc1785a2,1,27,9,18,36,0,0,0,5,191,1,1,0,176,3,308,14,20,20,0,333,333,0,19,19,0,0,100,NoArch
f860adcf0a6e82affa4cc668273ab4ef8360228f,1,2,2,0,4,0,0,0,12,103,1,1,0,1069,3,45,2,208,206,2,4880,4858,22,63,63,0,0,100,NoArch
76a8a38a4354e5fac505d8576014654f4159b09e,3,478,0,478,478,3,0,3,1,0,1,1,0.782767042,0,1,0,0,71,0,71,1974,0,1974,31,0,31,1,99.78507829,NoArch
fd247b5fe408f3b673da00c53beceb0c048e740f,12,375,84,291,459,3,0,3,46,38,1,5,3.014478216,1561,3,31,10,267,233,34,8036,7089,947,129,116,13,0,99.6009822,NoArch
f3fdadb9df7b2f532550e612fa86f01b25b68c0c,1,1,0,1,1,1,0,1,15,18,1,1,0,301,5,46,2,43,42,1,1294,1281,13,19,19,0,0,100,NoArch
b2601e69fedfb96e0060d78e8c511a21da3f5f1e,1,21,1,20,22,0,0,0,88,5,1,1,0,2381,8,47,3,560,556,4,14402,14273,129,116,116,0,1,100,NoArch
20b4070f83261f25c3f17ce7aaccb6259a33f7e9,1,13,3,10,16,0,0,0,95,15,1,1,0,2522,10,608,5,499,497,2,13358,13314,44,108,108,0,1,100,NoArch
51ef532bd4ce6b0f96bf69d397e265a8e4132997,0,0,0,0,0,0,0,0,0,0,0,0,0,0,0,609,6,0,0,0,0,0,0,0,0,0,0,100,NoArch
30dae759eccabe88742cb36e5d970bdb868df3f2,1,86,2,84,88,0,0,0,275,29,1,1,0,7650,23,610,7,1091,1078,13,29768,29124,644,518,516,2,1,99.96924969,NoArch
7fcf28b1cc90fe4281cd7e970d230c4679dac606,1,0,6,6,6,0,0,0,18,134,1,1,0,402,8,611,8,68,69,1,1313,1350,37,23,24,1,1,100,NoArch
773d675e43769a9361620fca6abdafb368ed253d,2,1,34,33,35,0,0,0,41,17,1,2,0.315997133,600,2,612,9,69,74,5,2689,2909,220,18,19,1,0,100,NoArch
412a6785f74e0db702610da6ca5bc91d0c3e9cc6,1,12,12,0,24,0,0,0,276,1,1,1,0,7734,23,233,0,1091,1091,0,29768,29768,0,518,518,0,0,100,NoArch
0c61e9f9d038554188a339ab0e99f1130ef92db1,2,14,6,8,20,0,0,0,47,105,1,2,0.811278124,581,2,32,11,107,105,2,3456,3415,41,34,33,1,0,100,NoArch
9d8b95b81fd33dd4e16510c5f1cecb5485f1d6e5,1,0,11,11,11,0,0,0,2,9,1,1,0,54,2,309,13,4,4,0,127,234,107,1,1,0,0,99.81561156,NoArch
f73c4c3feca55df3bc86497174bdce88eab27063,1,0,1,1,1,0,0,0,5,0,1,1,0,41,3,310,14,5,5,0,130,137,7,2,2,0,0,100,NoArch
0c0cb137124ceb43826ac966695872a70851d0c9,24,494,485,9,979,3,0,3,277,111,1,9,2.651010296,17026,23,311,15,2431,2431,0,74646,74775,129,981,981,0,0,100,NoArch
7d4883a8f7c64688fc94678e8047679229280b4a,10,294,359,65,653,0,0,0,87,48,1,6,1.923731809,3777,2,312,16,677,679,2,18881,19166,285,258,258,0,0,100,NoArch
ecbabf58313a9d1bfa179d974ce17cc05e95c83b,1,17,3,14,20,0,0,0,3,1,1,1,0,403,2,1,1,69,67,2,1854,1815,39,28,27,1,1,100,NoArch
a43e6acfd3700942d3d48cd9ccdb93177fe0ff81,0,0,0,0,0,0,0,0,0,0,0,0,0,0,0,33,12,0,0,0,0,0,0,0,0,0,0,100,NoArch
5f99beaada8754204d903ac3cfdbd0515688d78e,4,203,49,154,252,0,0,0,89,78,1,1,1.700130202,3896,3,48,3,834,813,21,21040,20479,561,227,219,8,3,100,NoArch
be51ac75af3d49e0ba106440b152524f44e167c8,26,863,425,438,1288,3,0,3,111,48,1,8,3.284430375,8550,5,7,0,1863,1788,75,48434,46360,2074,538,488,50,0,99.08592322,NoArch
9ddf9ca888d0799a0582380f5acab5c8aa045d88,1,4,0,4,4,1,0,1,91,0,1,1,0,2472,8,49,4,575,573,2,14791,14762,29,119,119,0,0,100,NoArch
5befd87b78c432be4b7fd2a3aa3f1f4a42a5a8f9,0,0,0,0,0,0,0,0,0,0,0,0,0,0,0,8,1,0,0,0,0,0,0,0,0,0,0,100,NoArch
e8b760a70944b792e9bf10a0541718b559dec9cd,1,2,1,1,3,0,0,0,92,0,1,1,0,2476,8,9,2,575,575,0,14795,14791,4,119,119,0,0,100,NoArch
61ee7b41b955a29590e9a6c6073919ccd0716303,12,450,409,41,859,0,0,0,93,1,1,6,2.340119509,6650,5,10,3,1471,1469,2,37810,37926,116,375,371,4,0,100,NoArch
4cdb0a263e3acc809df3e6efa2c9b00699b00131,1,0,2,2,2,0,0,0,46,222,1,1,0,891,6,613,7,184,184,0,4346,4366,20,177,177,0,1,100,NoArch
ae62acd174f623cee85a40a97498cf7fe4124693,1,23,3,20,26,0,0,0,15,158,1,1,0,480,2,614,8,98,92,6,2843,2728,115,28,27,1,1,100,NoArch
446e5b34f6406765f3b181838ff872ad92129d5f,1,1,1,0,2,0,0,0,13,213,1,1,0,67,6,615,9,8,8,0,232,238,6,6,6,0,0,100,NoArch
f7d53e73026a754a224f4d571af522ffd4a02454,1,18,5,13,23,0,0,0,16,0,1,1,0,500,2,616,10,103,98,5,2913,2843,70,29,28,1,1,99.87904445,NoArch
6ef9f42932147838399319aab65991e1f3aa49aa,1,3,7,4,10,0,0,0,145,10,1,1,0,3652,13,617,11,589,590,1,19997,20014,17,153,153,0,1,100,NoArch
da3e3b25e89420afef89ffaf59548caef745bf89,1,94,7,87,101,0,0,0,48,11,1,1,0,548,10,34,7,103,102,1,3966,3319,647,32,32,0,1,100,NoArch
046a4544e315f05a4f0a60df99a7530637d0bb74,1,4,5,1,9,0,0,0,5,119,1,1,0,192,3,35,8,38,38,0,808,797,11,22,22,0,1,100,NoArch
e510143439b7cf357d879ca7429a93ad22ab26bb,4,13,17,4,30,0,0,0,52,7,1,3,1.339572262,2510,6,618,12,578,579,1,14506,14518,12,163,163,0,0,100,NoArch
78cb3185c0c368cb3514735d97d8901a03557fa4,23,270,676,406,946,0,0,0,5,23,1,2,3.500383304,1963,1,36,7,198,237,39,6410,9322,2912,56,69,13,0,97.96359148,Arch
08150a8b832496655874a80562fcd707dee98dfd,1,4,4,0,8,0,0,0,94,4,1,1,0,2514,9,21,0,580,580,0,14793,14789,4,126,126,0,0,100,NoArch
f27decea01dfe66553fd4c5707f6d8baa513aa17,1,5,2,3,7,0,0,0,146,5,1,1,0,3648,13,619,12,589,589,0,20004,19997,7,153,153,0,1,100,NoArch
aa5fe4616feb0d8d3c53ef21e69c8842e5a43f6d,2,55,1,54,56,1,0,1,278,55,1,2,0.222284831,7982,9,313,15,1134,1123,11,31995,31706,289,543,540,3,1,100,NoArch
47c0e5779932f30a99c5cdc4d11fe27b86b22d2d,2,70,57,13,127,1,0,1,25,23,1,2,0.997807431,622,1,620,13,90,91,1,2469,2464,5,41,40,1,1,99.87417427,NoArch
846e7032bf22cf2bdf2ee65d1935844ff37f75fd,3,17,17,0,34,0,0,0,7,24,1,1,1.289608558,819,3,621,14,141,139,2,4514,4449,65,34,34,0,1,100,NoArch
b826972ffe4e63ce6cab3c66d95a2db614776af2,0,0,0,0,0,0,0,0,0,0,0,0,0,0,0,622,15,0,0,0,0,0,0,0,0,0,0,100,NoArch
9fb8588d7724db396c8fbdab8b00ff77208299dc,4,131,54,77,185,1,0,1,26,7,1,3,1.24049624,1502,3,623,16,254,237,17,7906,7386,520,74,71,3,1,100,NoArch
3335ba046e793bcf2fb2d37ed91a995e91b1f5b7,1,5,1,4,6,0,0,0,5,83,1,1,0,176,2,624,17,26,25,1,674,640,34,15,15,0,1,100,NoArch
46ec77ea33bba60a4671ff76e916a65955d99c62,0,0,0,0,0,0,0,0,0,0,0,0,0,0,0,625,18,0,0,0,0,0,0,0,0,0,0,100,NoArch
2ab1cc5346ae5616591664f9ab9155cb4ec8bfcf,3,42,15,27,57,0,0,0,9,73,1,1,0.436753451,838,4,626,19,157,150,7,4793,4597,196,41,40,1,0,100,NoArch
c3c81179c48121a480f8318cd533bdb11c64e312,1,2,2,0,4,0,0,0,10,0,1,1,0,582,4,627,20,118,118,0,3514,3514,0,24,24,0,0,100,NoArch
c77c55bdefdac5296214c354ef3b912043be2aae,1,3,3,0,6,0,0,0,18,7,1,1,0,236,7,628,21,35,35,0,1071,1069,2,15,15,0,1,100,NoArch
888b04c980d8fc4704b7a201a27eb2f49768e73f,1,108,6,102,114,0,0,0,279,3,1,1,0,7790,23,22,1,1123,1102,21,30487,30053,434,525,521,4,1,100,NoArch
c02faefdb2ab51308cc5b08557da0c9da104b278,2,38,22,16,60,0,0,0,17,112,1,2,0.754034056,357,5,629,21,49,46,3,1443,1377,66,24,22,2,1,100,NoArch
4594efe5f90eb9570f1baf3907e5a083219f9bb4,0,0,0,0,0,0,0,0,0,0,0,0,0,0,0,37,8,0,0,0,0,0,0,0,0,0,0,100,NoArch
8b44206f2e87ff1500b81d44a5f8bd252e541c33,0,0,0,0,0,0,0,0,0,0,0,0,0,0,0,38,9,0,0,0,0,0,0,0,0,0,0,100,NoArch
0d517ce3884e053edf93c196f362256d72a9b76b,4,125,76,49,201,1,0,1,280,57,1,3,1.148446649,8421,9,314,14,1211,1209,2,33728,33653,75,571,569,2,1,99.93718593,NoArch
213e36a39779aaf0a80586567cebeb91de2b6e56,2,21,13,8,34,0,0,0,95,5,1,2,0.672294817,2822,5,630,22,625,624,1,16120,16119,1,145,145,0,0,100,NoArch
fa9fd2ac0c3cf5e49391a3c5cad5e1557f11f663,7,161,100,61,261,1,0,1,281,13,1,3,1.660578265,11825,8,631,23,2081,2076,5,54041,53937,104,726,721,5,0,99.59362301,NoArch
f29dc2fa71e5cd56494bea0c658492464761f383,1,17,0,17,17,1,0,1,282,0,1,1,0,7850,23,632,24,1111,1110,1,30129,30099,30,526,525,1,1,100,NoArch
ac5520efff80537e34a10b78c10fe1b9318a5c18,0,0,0,0,0,0,0,0,0,0,0,0,0,0,0,31,0,0,0,0,0,0,0,0,0,0,0,100,NoArch
9866d61ec44e58e929c9bddb1793d67f14d6152e,1,5,0,5,5,1,0,1,93,43,1,1,0,1038,12,315,6,213,208,5,5074,4995,79,90,90,0,0,100,NoArch
caea23302e1851081d5bce67739344d3290e8720,1,4,4,0,8,0,0,0,283,2,1,1,0,7867,23,316,7,1111,1111,0,30129,30129,0,526,526,0,0,100,NoArch
5076bf8c204a67fd7818c16e28023fd2d2d3b372,2,97,55,42,152,0,0,0,284,0,1,2,0.989860373,7981,23,317,8,1132,1128,4,30751,30665,86,534,530,4,1,99.84433375,NoArch
9a66955f4ef37adcb61c5087b0d58ce344b03640,2,24,3,21,27,0,0,0,53,10,1,2,0.380946586,1046,6,318,9,242,240,2,6408,6354,54,54,52,2,1,100,NoArch
4d298e0ffc06c6817ab4e27a0fc23ed7d59ce1fc,0,0,0,0,0,0,0,0,0,0,0,0,0,0,0,319,10,0,0,0,0,0,0,0,0,0,0,100,NoArch
9ec0f169ba158b7c863c1017b58fed5bf7d52b8e,0,0,0,0,0,0,0,0,0,0,0,0,0,0,0,320,11,0,0,0,0,0,0,0,0,0,0,100,NoArch
09fb95e3fd375880b7c139a4b595911423d0b2b3,0,0,0,0,0,0,0,0,0,0,0,0,0,0,0,321,12,0,0,0,0,0,0,0,0,0,0,100,NoArch
2fce46ca3daafadd5f3ed6875eea4cf50b0b53fe,0,0,0,0,0,0,0,0,0,0,0,0,0,0,0,633,25,0,0,0,0,0,0,0,0,0,0,100,NoArch
d127c50e5607de733830df50094b7c3d4e6884e7,0,0,0,0,0,0,0,0,0,0,0,0,0,0,0,634,26,0,0,0,0,0,0,0,0,0,0,100,NoArch
3a63649f8be74285f2acfa50000617ae3fd360e9,1,1,0,1,1,1,0,1,16,24,1,1,0,1102,4,50,3,213,213,0,5034,5027,7,65,65,0,0,100,NoArch
7a2238600c979e9ed4ccef6ae966bc2803069493,0,0,0,0,0,0,0,0,0,0,0,0,0,0,0,51,4,0,0,0,0,0,0,0,0,0,0,100,NoArch
281e1cd03cdd10e43b9e4b283dad963c698f3909,5,3,8,5,11,0,0,0,5,6,1,1,2.186704346,497,1,635,27,84,84,0,2564,2582,18,32,32,0,0,99.626401,NoArch
cfcd223960af6cbb003b1d803a1003536eb0b13b,1,5,2,3,7,0,0,0,19,49,1,1,0,273,7,32,1,28,28,0,1215,1215,0,20,20,0,0,100,NoArch
7a6e1bc56a16cade47a82af7078d899623c3a1e8,1,0,225,225,225,0,0,0,13,26,1,1,0,335,6,636,23,13,56,43,373,1373,1000,7,41,34,1,100,NoArch
88835cd0f2d6fac9945563d9e9c99920555111ef,0,0,0,0,0,0,0,0,0,0,0,0,0,0,0,234,0,0,0,0,0,0,0,0,0,0,0,100,NoArch
db01e1999c54efecd6be7074c59d3ca81775f4bd,1,6,1,5,7,0,0,0,285,5,1,1,0,7848,23,23,2,1103,1103,0,30007,30006,1,526,526,0,1,100,NoArch
28332c5d4204aca07a052205322600fcf1937f31,0,0,0,0,0,0,0,0,0,0,0,0,0,0,0,637,24,0,0,0,0,0,0,0,0,0,0,100,NoArch
bb3b3144bebebb24ca22d704cb77d767387e1b56,0,0,0,0,0,0,0,0,0,0,0,0,0,0,0,638,25,0,0,0,0,0,0,0,0,0,0,100,NoArch
a0a2310ed94b18cbdef26ef740b6d15e81425684,1,197,0,197,197,1,0,1,1,0,1,1,0,0,1,2,1,37,0,37,841,0,841,25,0,25,1,99.93777225,NoArch
31a914c8d582b04daa87bd047d7d78396dfb0025,0,0,0,0,0,0,0,0,0,0,0,0,0,0,0,3,2,0,0,0,0,0,0,0,0,0,0,100,NoArch
f132ecbb922268017b43d06b15830ada5472a115,0,0,0,0,0,0,0,0,0,0,0,0,0,0,0,4,3,0,0,0,0,0,0,0,0,0,0,100,NoArch
ddce0e8cb0f52cf30c5972e26a864d4c1291d888,0,0,0,0,0,0,0,0,0,0,0,0,0,0,0,39,6,0,0,0,0,0,0,0,0,0,0,100,NoArch
acc97950a3038d608048f21fb36b59f9e1a28e03,1,52,72,20,124,0,0,0,2,3,1,1,0,197,2,40,7,34,37,3,682,841,159,25,25,0,0,100,NoArch
c2ff883430c1188459366ee804af4455731c2b0c,1,30,9,21,39,0,0,0,4,80,1,1,0,149,2,322,9,41,35,6,1004,878,126,12,10,2,1,100,NoArch
ec4ce10097ca26f67a98e1957e15f3f7919489f1,0,0,0,0,0,0,0,0,0,0,0,0,0,0,0,323,10,0,0,0,0,0,0,0,0,0,0,100,NoArch
db4d10ebe36f13c899d435910d592f24ccb82bc0,1,2,2,0,4,0,0,0,3,1,1,1,0,177,2,5,3,34,34,0,682,682,0,25,25,0,1,100,NoArch
1557ea3b7b8aa9989041647433a1de1dfc58afea,17,385,263,122,648,2,0,2,97,24,1,6,2.812976296,5794,5,11,3,1287,1265,22,33298,32897,401,348,331,17,0,99.46825149,NoArch
3c4845df3e12bc28627a7537373ebecc8c34b42e,1,1,1,0,2,0,0,0,4,6,1,1,0,177,2,6,4,34,34,0,682,682,0,25,25,0,1,100,NoArch
c034e449cadefd165afc90d1b9b5a2f1e0caed39,0,0,0,0,0,0,0,0,0,0,0,0,0,0,0,41,5,0,0,0,0,0,0,0,0,0,0,100,NoArch
61ca73a581ce559021fee46683adc097d37cf3de,3,349,9,340,358,2,0,2,3,40,1,2,0.722379626,166,1,42,6,53,21,32,2472,550,1922,43,13,30,0,99.90566038,NoArch
5cb376c10b754308f4fda2583332c6594c7d46f6,0,0,0,0,0,0,0,0,0,0,0,0,0,0,0,43,7,0,0,0,0,0,0,0,0,0,0,100,NoArch
2b09801e74cb7cf2c737371de76146f6310b244a,1,10,8,2,18,0,0,0,17,18,1,1,0,1103,4,52,2,213,213,0,5040,5034,6,65,65,0,1,100,NoArch
07b44301b70319ab3936b420702755785a03ff46,1,13,0,13,13,1,0,1,286,15,1,1,0,7853,23,53,3,1105,1103,2,30053,30007,46,527,526,1,1,100,NoArch
04ea899100faf97b9009b3856f5c0c90dc29c106,0,0,0,0,0,0,0,0,0,0,0,0,0,0,0,54,4,0,0,0,0,0,0,0,0,0,1,100,NoArch
e4f9d0e90c35ad756d05f89873a8c0cd1a47aa92,1,1,2,1,3,0,0,0,2,63,1,1,0,156,1,44,8,23,23,0,616,616,0,12,12,0,0,100,NoArch
449bb5c250106260b9ef778b3624cec067534a7d,2,6,3,3,9,0,0,0,27,16,1,2,0.764204507,1352,10,12,1,246,245,1,7011,6985,26,87,87,0,0,100,NoArch
1b7bc8226bb64784bb081974f12580696d994297,2,18,0,18,18,2,0,2,98,2,1,1,0.503258335,3586,9,13,2,790,784,6,19555,19417,138,189,187,2,0,100,NoArch
9a6bec06c1aeb06a00eb8e4ad882318f4c1fed34,0,0,0,0,0,0,0,0,0,0,0,0,0,0,0,45,8,0,0,0,0,0,0,0,0,0,0,100,NoArch
6cc1ef3542de287fd8c08b5a1f8e51d0b0288cf2,21,543,429,114,972,3,0,3,99,55,1,7,3.370950791,6962,5,14,3,1414,1385,29,36208,35932,276,427,399,28,0,99.03336452,NoArch
38f5e513710960a6092d50b54895dea81e302470,4,259,245,14,504,0,0,0,59,86,1,2,1.3888671,2087,2,324,11,404,398,6,11359,11159,200,115,114,1,1,100,NoArch
14e66ec467e16b2f65dc638083040ab6ef584daa,1,2,2,0,4,0,0,0,100,0,1,1,0,2527,9,325,12,584,584,0,14495,14495,0,130,130,0,0,100,NoArch
12e31a00333d43067abce6d233eb3f0b29e7dec4,1,1,1,0,2,0,0,0,101,0,1,1,0,2527,9,326,13,584,584,0,14495,14495,0,130,130,0,1,100,NoArch
fdc23558f752c40a788011fa00c4ac10b2582917,0,0,0,0,0,0,0,0,0,0,0,0,0,0,0,327,14,0,0,0,0,0,0,0,0,0,1,100,NoArch
dd16e89395139397ae24b8bda58351fb4c60704d,1,3,10,7,13,0,0,0,6,0,1,1,0,230,2,328,15,62,63,1,1356,1386,30,15,15,0,1,100,NoArch
d6e337987cf978e21939744309e8625ee9d52c0a,1,29,6,23,35,0,0,0,4,55,1,1,0,417,3,46,9,72,69,3,1941,1854,87,30,28,2,0,100,NoArch
2135a7ca437a62d88197f4a290a9c26433cb8bb6,4,65,46,19,111,0,0,0,21,303,1,2,1.630106969,710,2,329,16,97,91,6,2918,2842,76,44,38,6,1,100,NoArch
92fa68c011b92078f252a40373ced0bb87319fd1,1,3,3,0,6,0,0,0,5,0,1,1,0,440,3,330,17,72,72,0,1962,1941,21,30,30,0,0,100,NoArch
14936fff96b675b17547e5d01d08a7bf30c3c83a,1,3,3,0,6,0,0,0,6,0,1,1,0,440,3,331,17,72,72,0,1941,1962,21,30,30,0,0,100,NoArch
24cf140692ccdfaf135083deb43531051f67213a,11,202,170,32,372,1,0,1,102,9,1,6,3.004349806,4371,6,15,4,931,929,2,23631,23624,7,247,246,1,0,99.56642924,NoArch
72a0e90be6b8128905436440b17f5a7824a56e90,1,4,4,0,8,0,0,0,8,0,1,1,0,138,2,16,5,25,26,1,566,595,29,17,17,0,0,100,NoArch
ee15cbdc834e6dfeece50ae3a329ff4a9c7380ce,1,170,0,170,170,1,0,1,1,0,1,1,0,0,1,47,10,15,0,15,512,0,512,7,0,7,1,99.93804213,NoArch
e8f166a5333a4d3adf14adbe98ee3538c5b0aa57,1,14,46,32,60,0,0,0,2,2,1,1,0,170,1,48,11,15,15,0,512,512,0,7,7,0,1,100,NoArch
7830367ad57aab4054a511b4fd2da5d8c1594bce,1,29,0,29,29,1,0,1,55,5,1,1,0,841,6,639,10,210,195,15,5606,5425,181,44,42,2,1,100,NoArch
fb733df03e88869345b70b22d9d6d047cdfb388b,0,0,0,0,0,0,0,0,0,0,0,0,0,0,0,640,11,0,0,0,0,0,0,0,0,0,0,100,NoArch
c26bb1b82e81d919256993e6cc552a506012dd5d,1,2,2,0,4,0,0,0,3,0,1,1,0,138,2,332,18,15,15,0,505,512,7,7,7,0,0,100,NoArch
7c405465996dfb3f23303eab1b8cb67a0f1b460d,2,6,38,32,44,0,0,0,56,2,1,1,0.902393283,1093,2,333,19,258,272,14,6760,6962,202,57,59,2,0,100,NoArch
b6e9ebd098c8add07639e6a8dfc883d297c01fbb,0,0,0,0,0,0,0,0,0,0,0,0,0,0,0,334,20,0,0,0,0,0,0,0,0,0,0,100,NoArch
63b8cdcaec0fb3b317c3b826233aa8614543823b,1,1,1,0,2,0,0,0,57,0,1,1,0,840,6,335,21,195,195,0,5425,5425,0,42,42,0,0,100,NoArch
de39fd714ae2b43fb1f23f8386b8e0f0a86e456b,0,0,0,0,0,0,0,0,0,0,0,0,0,0,0,336,22,0,0,0,0,0,0,0,0,0,0,100,NoArch
81930c286dae281d047c9b8e933f6d3432eb4b16,0,0,0,0,0,0,0,0,0,0,0,0,0,0,0,337,23,0,0,0,0,0,0,0,0,0,0,100,NoArch
97269ba1b6b81a9d7617f3d1e643a415ab5d3c98,0,0,0,0,0,0,0,0,0,0,0,0,0,0,0,338,24,0,0,0,0,0,0,0,0,0,0,100,NoArch
a7d8b465c18ec2d669b36d46514d82192583cccd,1,11,10,1,21,0,0,0,19,69,1,1,0,396,8,339,25,69,68,1,1326,1313,13,23,23,0,1,100,NoArch
f7401ec32415d45e7c0e8697ff29e7761315e08a,1,1,1,0,2,0,0,0,23,63,1,1,0,408,7,641,11,50,49,1,1638,1632,6,18,18,0,1,100,NoArch
e4374a680ce0b4bcac441809012f54c69a4a0c59,6,115,12,103,127,4,0,4,147,155,1,4,1.84873944,6646,5,642,11,1153,1146,7,35717,35429,288,319,313,6,1,99.8762759,NoArch
6a28ca79b33afd72801d9bf9141539fcf0dac67b,1,3,10,7,13,0,0,0,4,7,1,1,0,138,3,227,0,15,15,0,461,505,44,7,7,0,1,100,NoArch
b8e5822d403f03a6ebbbb7375f604d6017a60632,0,0,0,0,0,0,0,0,0,0,0,0,0,0,0,228,1,0,0,0,0,0,0,0,0,0,1,100,NoArch
e56441ee08d91296ec1449b7daa399f5bc12ca56,1,26,2,24,28,0,0,0,5,1,1,1,0,131,3,49,10,17,15,2,601,461,140,8,7,1,0,100,NoArch
44d45f61050391b981b5e789b3be231e1cb7f81b,2,4,308,304,312,1,1,2,7,16,1,2,0.098959095,748,1,50,11,73,102,29,1956,3853,1897,31,60,29,0,99.90723562,NoArch
5d42005b13b2ff7bfec236acbcae0de3c415a5ee,0,0,0,0,0,0,0,0,0,0,0,0,0,0,0,140,0,0,0,0,0,0,0,0,0,0,0,100,NoArch
97a45dfb3e3c5212c3610cd90fe1e7434614b260,19,422,233,189,655,3,0,3,103,18,1,6,3.154877421,7723,3,17,6,1675,1628,47,42210,41116,1094,477,469,8,0,99.78354978,NoArch
8b2f6c8dbbb6b545915f84556ab9e8904ddd48da,3,235,133,102,368,1,0,1,104,0,1,2,1.148000003,2703,1,18,7,634,611,23,15766,15157,609,152,141,11,0,99.93823348,NoArch
fb05c014bd4b2ef444005af27a9c2be1c9a2aeb7,1,7,7,0,14,0,0,0,87,92,1,1,0,852,14,19,8,122,122,0,3247,3247,0,62,62,0,0,100,NoArch
feff5190da5f70f1c4ca7a93241b85006dbf279e,3,32,25,7,57,0,0,0,287,75,1,2,0.590723919,9096,23,55,3,1331,1331,0,35548,35555,7,599,598,1,1,100,NoArch
af82f25d9624dfda822613f1748c81a867de5e73,1,23,8,15,31,0,0,0,6,5,1,1,0,148,1,20,9,36,34,2,957,904,53,9,9,0,0,100,NoArch
ed823bd58d2b9fd49d493fbf2f45f4505cd1bf3f,1,4,3,1,7,0,0,0,288,1,1,1,0,7865,24,21,0,1105,1105,0,30056,30048,8,527,527,0,1,100,NoArch
ccedbe192519a82b7336882194dcfe3f554d1b2a,2,7,5,2,12,0,0,0,11,66,1,1,0.650022422,725,4,229,2,136,135,1,4078,4053,25,32,32,0,0,100,NoArch
076da589890d7f22b0093bd476bd92c91a05fffd,0,0,0,0,0,0,0,0,0,0,0,0,0,0,0,230,3,0,0,0,0,0,0,0,0,0,0,100,NoArch
eccfc10dd9b04481e0afcd16917151e9fbdd5be2,0,0,0,0,0,0,0,0,0,0,0,0,0,0,0,231,4,0,0,0,0,0,0,0,0,0,0,100,NoArch
c4cf0ba6269fe07ec3a43b31b3ecdf8ab4916110,1,2,1,1,3,0,0,0,24,21,1,1,0,408,7,235,0,51,50,1,1644,1638,6,18,18,0,0,100,NoArch
aa5fdf635bbe15ca133144e331d8138df8099ad3,0,0,0,0,0,0,0,0,0,0,0,0,0,0,0,232,5,0,0,0,0,0,0,0,0,0,0,100,NoArch
8acab6cc1849319f1e25270b3513066c753fb02c,0,0,0,0,0,0,0,0,0,0,0,0,0,0,0,233,6,0,0,0,0,0,0,0,0,0,1,100,NoArch
ea150167f3b2a875148b2bbdfcfd64d758db9d40,0,0,0,0,0,0,0,0,0,0,0,0,0,0,0,236,1,0,0,0,0,0,0,0,0,0,0,100,NoArch
8dac17df3bdd6a9f10e59459695813ca602d68f4,2,8,5,3,13,1,0,1,18,86,1,2,0.961236605,713,3,22,1,135,134,1,4045,4003,42,55,55,0,1,100,NoArch
400357f257ff83ae2bdc84b3a40c036975de5667,0,0,0,0,0,0,0,0,0,0,0,0,0,0,0,237,2,0,0,0,0,0,0,0,0,0,1,100,NoArch
5eab90b91ce9548b537dd1651cc5e6d3497a34f8,1,137,138,1,275,0,0,0,19,0,1,1,0,515,4,340,16,101,101,0,2929,2931,2,29,29,0,0,100,NoArch
c97fe11343ecdd5cf307c318b56da008224a75b4,1,35,3,32,38,0,0,0,8,24,1,1,0,221,2,341,17,71,63,8,1494,1335,159,15,15,0,1,100,NoArch
b1cd7cbf2aec9f066b4a006d9d4b74a54c8721fb,0,0,0,0,0,0,0,0,0,0,0,0,0,0,0,342,18,0,0,0,0,0,0,0,0,0,1,100,NoArch
e222d4f5cf8cc7645d0c622712bb43d7d2ee2e5e,3,75,20,55,95,1,0,1,14,66,1,2,1.199136888,289,1,234,7,31,25,6,1246,1036,210,21,15,6,2,99.93830969,NoArch
043d76b1cdd6f4c33548b85fa33baffd08f4aecd,3,131,54,77,185,0,0,0,15,0,1,2,1.254970639,344,1,235,8,44,31,13,1479,1246,233,32,21,11,2,100,NoArch
e8b9cfd726e0b43a01f20785d987c983b59c9a37,0,0,0,0,0,0,0,0,0,0,0,0,0,0,0,236,9,0,0,0,0,0,0,0,0,0,0,100,NoArch
4cbad60140e80674a5aff61ef54d4429ecd37e0a,1,5,0,5,5,1,0,1,3,0,1,1,0,89,1,237,10,7,7,0,402,384,18,7,7,0,0,100,NoArch
d3cc18eebb11b8218b426484f386b2913de59654,0,0,0,0,0,0,0,0,0,0,0,0,0,0,0,238,11,0,0,0,0,0,0,0,0,0,0,100,NoArch
f2132a61d8989ce38128fa993a4df44104a8fb49,0,0,0,0,0,0,0,0,0,0,0,0,0,0,0,239,12,0,0,0,0,0,0,0,0,0,0,100,NoArch
045bceb0f4d8c81911b400e823d4b9bfd14f68ab,0,0,0,0,0,0,0,0,0,0,0,0,0,0,0,240,13,0,0,0,0,0,0,0,0,0,0,100,NoArch
544d4b54e3a53ea528f228fc56be812ebd78802a,1,63,0,63,63,1,0,1,1,0,1,1,0,0,1,241,14,5,0,5,109,0,109,4,0,4,1,99.93838571,NoArch
ad1593d7084ee239b39fa789c4ed880dcf6e75d0,0,0,0,0,0,0,0,0,0,0,0,0,0,0,0,242,15,0,0,0,0,0,0,0,0,0,1,100,NoArch
a40185c6fcf2123322a91ff8c70ae1d53c23e257,0,0,0,0,0,0,0,0,0,0,0,0,0,0,0,243,16,0,0,0,0,0,0,0,0,0,0,100,NoArch
8ef328574f48eb46f699aca8b6ca0d7fafc5dc63,0,0,0,0,0,0,0,0,0,0,0,0,0,0,0,244,17,0,0,0,0,0,0,0,0,0,1,100,NoArch
28eb0e69ed8a8ea2ac13866e32a4d1f5b732fa04,0,0,0,0,0,0,0,0,0,0,0,0,0,0,0,245,18,0,0,0,0,0,0,0,0,0,0,100,NoArch
2b1d95cd0c4d810de1480a729174ba3c52fe8228,0,0,0,0,0,0,0,0,0,0,0,0,0,0,0,246,19,0,0,0,0,0,0,0,0,0,0,100,NoArch
c9630a13f803f263465e0970fbcb3397d90134cb,0,0,0,0,0,0,0,0,0,0,0,0,0,0,0,247,20,0,0,0,0,0,0,0,0,0,0,100,NoArch
634b6c6b910877426c39da94fd749370821d1861,0,0,0,0,0,0,0,0,0,0,0,0,0,0,0,248,21,0,0,0,0,0,0,0,0,0,0,100,NoArch
f1b7d27110bb8402f3251348c9d4fb400054d77b,0,0,0,0,0,0,0,0,0,0,0,0,0,0,0,249,22,0,0,0,0,0,0,0,0,0,0,100,NoArch
0fe4442eadcd1dd0faf3e86c3c2571860ff1587c,0,0,0,0,0,0,0,0,0,0,0,0,0,0,0,250,23,0,0,0,0,0,0,0,0,0,0,100,NoArch
5c575be52c9f3a4fb6effb86b8016762be06e1b3,0,0,0,0,0,0,0,0,0,0,0,0,0,0,0,251,24,0,0,0,0,0,0,0,0,0,1,100,NoArch
4750d800b7fed9545d580eeff9628ff2be800934,0,0,0,0,0,0,0,0,0,0,0,0,0,0,0,252,25,0,0,0,0,0,0,0,0,0,0,100,NoArch
a293ff4c7b88d5741d22c514a38be9918eb959f7,0,0,0,0,0,0,0,0,0,0,0,0,0,0,0,253,26,0,0,0,0,0,0,0,0,0,0,100,NoArch
384af1f4a2580abc2775a0e06a7f2b1528bfb45f,0,0,0,0,0,0,0,0,0,0,0,0,0,0,0,254,27,0,0,0,0,0,0,0,0,0,0,100,NoArch
c53cca664fca461d6d087335dafa26023ac2893a,0,0,0,0,0,0,0,0,0,0,0,0,0,0,0,255,28,0,0,0,0,0,0,0,0,0,0,100,NoArch
672d3e5e31722f23507f10a1f0dc42c37e6e7304,0,0,0,0,0,0,0,0,0,0,0,0,0,0,0,256,29,0,0,0,0,0,0,0,0,0,0,100,NoArch
e7f58d99f20c7396b37b3f87a97b977a5ad87fbc,1,16,19,3,35,0,0,0,9,1,1,1,0,253,2,343,19,71,71,0,1460,1494,34,15,15,0,1,100,NoArch
27935c553d141a43032ff065a669c228e6d7a146,6,233,117,116,350,3,0,3,105,7,1,4,1.852508351,4199,3,21,10,1038,1016,22,25307,24697,610,248,226,22,0,98.96810507,NoArch
54ce2365c8538556e643d76906d24aa2fd21fb8b,1,20,31,11,51,0,0,0,106,2,1,1,0,2539,9,22,11,582,586,4,14281,14397,116,132,135,3,0,100,NoArch
8c03552bf82fae3bed96c3cbe71ff0e58c98ab79,1,0,0,0,0,1,0,1,1,0,1,1,0,107,1,344,20,5,5,0,295,295,0,1,1,0,1,99.8729352,NoArch
e54cae98c310c2141040936232fdc056ee78405c,0,0,0,0,0,0,0,0,0,0,0,0,0,0,0,345,21,0,0,0,0,0,0,0,0,0,1,100,NoArch
7ddf8fec87df15b756f71335290e8b9534c73cbe,1,0,812,812,812,0,1,1,3,2591,1,1,0,812,3,346,22,0,1,1,0,1056,1056,0,1,1,0,99.90464081,NoArch
185eccc45f9e6810a8f1f412b05f884470f47b4e,1,1,1,0,2,0,0,0,11,103,1,1,0,285,6,56,4,45,45,0,1074,1074,0,15,15,0,1,100,NoArch
fbe6d8b9ed67d6a3fc1484c10d5366b398208bf5,0,0,0,0,0,0,0,0,0,0,0,0,0,0,0,257,30,0,0,0,0,0,0,0,0,0,1,100,NoArch
18804ee144ffab56a5ff6b457aa2ffdcb6ea45e3,0,0,0,0,0,0,0,0,0,0,0,0,0,0,0,258,31,0,0,0,0,0,0,0,0,0,0,100,NoArch
78e6eefc08a22b88c617b1baa7d03b4aa89f695c,7,119,64,55,183,1,0,1,107,5,1,4,1.884102025,4343,1,23,11,1049,1042,7,25729,25416,313,250,248,2,0,99.87277354,NoArch
34e806ea5886a7910b42e63dcf6f297165fb2b00,0,0,0,0,0,0,0,0,0,0,0,0,0,0,0,57,5,0,0,0,0,0,0,0,0,0,0,100,NoArch
dcb00b785dea154bf8c4b011d65de2e61f6f96bc,1,11,1,10,12,0,0,0,15,129,1,1,0,841,5,24,12,228,225,3,5492,5432,60,37,36,1,0,100,NoArch
8addfeca2f9f4e7c03061b792dc8d1bfa63d5062,1,0,2,2,2,0,0,0,3,0,1,1,0,113,2,347,23,22,22,0,565,578,13,17,17,0,0,100,NoArch
26af9a8c136c07a8681a210fab508486f4036715,2,34,53,19,87,0,0,0,289,5,1,2,0.999904695,8717,5,348,24,1327,1333,6,35450,35548,98,563,564,1,1,100,NoArch
5b3f39f8cf0961b76b7daa2ae4cc808fb6fcfdb5,3,33,17,16,50,1,0,1,88,45,1,3,1.337282358,2279,6,25,13,417,414,3,12227,12112,115,127,126,1,0,100,NoArch
06cd0384d460b40a691c274519800a6990f4ac7b,1,31,0,31,31,1,0,1,1,0,1,1,0,0,1,26,14,1,0,1,155,0,155,1,0,1,0,99.90464081,NoArch
a709dc2fc0ca4478d932355787736a64f2e0f5a2,1,6,1,5,7,0,0,0,108,1,1,1,0,2545,9,349,25,583,582,1,14367,14353,14,131,131,0,1,100,NoArch
621131bb49dad96cbb98fed83bdb5badc56e9769,1,3,0,3,3,1,0,1,17,1,1,1,0,871,5,350,26,235,234,1,5626,5605,21,38,38,0,1,100,NoArch
70770f1e67a943d33608eb668d538aa220538ee9,18,139,108,31,247,0,0,0,290,82,1,7,3.47753418,17059,3,351,27,2754,2729,25,78865,78469,396,1120,1109,11,3,99.61880559,NoArch
3e5c346ae8484299047151740709c68922107d27,0,0,0,0,0,0,0,0,0,0,0,0,0,0,0,352,28,0,0,0,0,0,0,0,0,0,0,100,NoArch
058083780827750a397b7eb5bf33196e7049dafb,2,73,0,73,73,2,0,2,1,0,1,2,0.950566853,0,1,353,29,9,0,9,355,0,355,6,0,6,1,99.14367269,NoArch
7f5267edf51754e7da30a0a3e8d09389ee796193,2,12,115,103,127,1,0,1,18,10,1,2,0.161320671,1214,5,643,4,316,337,21,7020,7748,728,62,62,0,1,100,NoArch
a29048d066f1a9b4d6d42c619937b4ab65b92b7d,10,356,11,345,367,7,0,7,98,18,1,5,2.476435744,5636,1,644,5,1142,1087,55,31085,29515,1570,316,296,20,0,99.58990536,NoArch
95274dfbf14c77cf40266b4264e7470369fb2715,5,25,10,15,35,0,0,0,95,0,1,4,1.921661668,1596,1,645,6,309,306,3,8002,7904,98,119,117,2,1,100,NoArch
6dbd994551e793e0bcd0fa67a178922e042cb870,0,0,0,0,0,0,0,0,0,0,0,0,0,0,0,646,7,0,0,0,0,0,0,0,0,0,0,100,NoArch
b6e3ac6f2e723f7602e793b602ebeab66881dcac,4,1874,1899,25,3773,0,0,0,109,33,1,3,0.061330667,2784,4,354,22,618,618,0,15252,15258,6,157,157,0,0,100,NoArch
c1276faa92c6418e15385a1c47ed2b3d0a9ca84d,1,113,43,70,156,0,0,0,10,303,1,1,0,306,3,355,23,85,67,18,2186,1669,517,27,22,5,1,100,NoArch
e45d4ed09f163346cec12b8c1985567b694f7491,0,0,0,0,0,0,0,0,0,0,0,0,0,0,0,356,24,0,0,0,0,0,0,0,0,0,1,100,NoArch
62d23ed5d88e911bc5358acadca23b3a8dcc4342,1,120,0,120,120,1,0,1,149,4,1,1,0,3682,13,647,8,616,591,25,21031,20155,876,159,154,5,0,100,NoArch
8285954ffdf4f3e063ee35d78c3b9873fa628078,2,145,120,25,265,1,0,1,150,3,1,1,0.993570476,4420,12,648,9,722,718,4,24832,24670,162,182,182,0,0,99.84281672,NoArch
c403736a9eaf88f9182f16075334285f9485908e,0,0,0,0,0,0,0,0,0,0,0,0,0,0,0,649,10,0,0,0,0,0,0,0,0,0,1,100,NoArch
71dcef447583ab87094ecd3cd97b823d5238f20b,1,16,1,15,17,0,0,0,15,7,1,1,0,610,3,650,11,147,143,4,3585,3460,125,40,40,0,1,99.25396332,NoArch
cc1a71c0edd3b7d4b6b23debe02df7f6f9dc8fa1,1,16,15,1,31,0,0,0,16,0,1,1,0,625,3,651,12,147,147,0,3585,3585,0,40,40,0,0,100,NoArch
a5e04fc7189b1e6621cc1928365d9e20ad4bd38b,1,7,0,7,7,1,0,1,151,0,1,1,0,3682,13,652,13,592,591,1,20170,20155,15,154,154,0,1,100,NoArch
7073a3480db6b9225121723f134bd519cb97fdc6,3,24,2,22,26,2,0,2,8,62,1,1,1.072737286,546,3,51,3,80,77,3,2231,2115,116,37,35,2,0,100,NoArch
4ef6c11f98d04a383ba9dc3899781f1aeec8e549,1,1,1,0,2,0,0,0,19,5,1,1,0,768,6,58,3,213,212,1,4867,4863,4,38,38,0,1,100,NoArch
205fe0394183de48b5eae5aa524969ed7d905eec,0,0,0,0,0,0,0,0,0,0,0,0,0,0,0,357,25,0,0,0,0,0,0,0,0,0,0,100,NoArch
2b05bd6f246ff5f9541a9ed7cb9a24f34f96a95f,0,0,0,0,0,0,0,0,0,0,0,0,0,0,0,238,3,0,0,0,0,0,0,0,0,0,1,100,NoArch
e347ad1d525b54166c72b758645910ef3b56c1eb,1,12,12,0,24,0,0,0,7,306,1,1,0,252,2,141,1,46,45,1,1307,1299,8,14,14,0,1,100,NoArch
5b77adb99fa0e9c45fa84a75b817beaa12eb6260,0,0,0,0,0,0,0,0,0,0,0,0,0,0,0,358,26,0,0,0,0,0,0,0,0,0,0,100,NoArch
56c33e4c11a0a47ae905025ebd12a179a1d04b5d,0,0,0,0,0,0,0,0,0,0,0,0,0,0,0,359,27,0,0,0,0,0,0,0,0,0,0,100,NoArch
871b105fa36672ea9e26786fb19bb5053f993962,0,0,0,0,0,0,0,0,0,0,0,0,0,0,0,239,4,0,0,0,0,0,0,0,0,0,1,100,NoArch
2ccb8f08fba8b051d75f46be609109a93d7eca50,0,0,0,0,0,0,0,0,0,0,0,0,0,0,0,52,3,0,0,0,0,0,0,0,0,0,0,100,NoArch
dce0b176c44930378c17386134db84aa22600ea3,1,13,19,6,32,0,0,0,25,18,1,1,0,409,8,24,0,51,51,0,1653,1644,9,18,18,0,1,100,NoArch
63f1fd80b4bebf99873c99e9c38a206673a2b405,2,22,8,14,30,0,0,0,72,14,1,2,0.650022422,1191,3,653,12,240,236,4,5468,5390,78,89,89,0,1,100,NoArch
06391eaa9175fc067a1c45331fd733d7798e145f,0,0,0,0,0,0,0,0,0,0,0,0,0,0,0,240,5,0,0,0,0,0,0,0,0,0,0,100,NoArch
b8d092151b891aa2686042a1b492d82150f9870f,0,0,0,0,0,0,0,0,0,0,0,0,0,0,0,654,13,0,0,0,0,0,0,0,0,0,0,100,NoArch
7c59d0bee58684bb5d6cd394cc19b9526092ccc5,1,1,0,1,1,1,0,1,3,307,1,1,0,23,3,360,23,0,0,0,40,27,13,0,0,0,1,100,NoArch
cfde903d91e6d5a6e48a30127fc26d298a6b181b,1,19,3,16,22,0,0,0,8,116,1,1,0,117,3,361,24,12,10,2,551,486,65,6,5,1,1,100,NoArch
dad181a9e5c97b192f3c281c7ed3fdba7f4e8849,2,20,2,18,22,1,0,1,9,208,1,1,0.574635698,21,1,362,25,2,1,1,135,72,63,2,1,1,0,99.93857494,NoArch
b5dbc6efce215f000e67a7c0264496da4c6a75c9,6,93,8,85,101,4,0,4,110,20,1,4,2.000620004,2949,1,27,10,698,688,10,17723,17222,501,162,156,6,1,99.7856049,NoArch
a7afc22dc0896576ae960c44615e5e9da9447761,1,3,1,2,4,0,0,0,111,1,1,1,0,2544,9,28,11,589,588,1,14541,14528,13,132,132,0,0,100,NoArch
e5ef353c24155668dc4f54178bf512495c333101,1,7,2,5,9,0,0,0,70,5,1,1,0,763,12,655,13,132,131,1,4733,4677,56,28,28,0,1,100,NoArch
fb1df6b1910f4d0390a734f92cf0e8954e6b699e,2,54,40,14,94,1,0,1,8,118,1,1,0.784992089,351,5,363,23,33,32,1,936,849,87,18,17,1,1,100,NoArch
3b666146704b22d3b68106739e91e3f4a6482ad8,0,0,0,0,0,0,0,0,0,0,0,0,0,0,0,364,24,0,0,0,0,0,0,0,0,0,1,100,NoArch
7fccbed079447b8e6c8c495c215c07029ca3dc7a,1,3,7,4,10,0,0,0,22,50,1,1,0,254,7,365,25,34,35,1,930,947,17,14,14,0,1,100,NoArch
df1ff7ca0b6af3958492cb59e5bec2389400ad8d,0,0,0,0,0,0,0,0,0,0,0,0,0,0,0,366,26,0,0,0,0,0,0,0,0,0,1,100,NoArch
796384a36e7629cb7d110f34f9e949b4e273b22a,1,34,23,11,57,0,0,0,291,14,1,1,0,7827,24,241,6,1096,1093,3,29926,29845,81,525,525,0,1,100,NoArch
3b3d0e5fb93a6d1f44cd3d10789f3a888b46947d,0,0,0,0,0,0,0,0,0,0,0,0,0,0,0,242,7,0,0,0,0,0,0,0,0,0,0,100,NoArch
98e346e8ced09072ecd046010c34d8737900b7d9,1,5,3,2,8,0,0,0,292,0,1,1,0,7838,24,367,27,1096,1096,0,29926,29926,0,525,525,0,0,100,NoArch
9298b147cc245eedf2b8abddc090056767109c1b,1,22,4,18,26,0,0,0,293,0,1,1,0,7840,24,243,8,1099,1096,3,30017,29926,91,526,525,1,0,100,NoArch
992c1b23bd1e928db1f1871660e3dab81d918240,0,0,0,0,0,0,0,0,0,0,0,0,0,0,0,53,3,0,0,0,0,0,0,0,0,0,0,100,NoArch
962ca1aac38629cd41044f96c376cbb3d802e4c9,0,0,0,0,0,0,0,0,0,0,0,0,0,0,0,54,3,0,0,0,0,0,0,0,0,0,0,100,NoArch
4f87f26b6368ca469224ba33d558361a7db7be47,0,0,0,0,0,0,0,0,0,0,0,0,0,0,0,55,4,0,0,0,0,0,0,0,0,0,0,100,NoArch
11b2b954da17f1557e1f97cdd8adaa8ce1641ceb,0,0,0,0,0,0,0,0,0,0,0,0,0,0,0,56,5,0,0,0,0,0,0,0,0,0,0,100,NoArch
7f305430fdac5d2a30431abf2a4f61c9bcdf9c51,0,0,0,0,0,0,0,0,0,0,0,0,0,0,0,368,28,0,0,0,0,0,0,0,0,0,0,100,NoArch
038daa41ce1d488fe5adee3df96324c466140ba2,0,0,0,0,0,0,0,0,0,0,0,0,0,0,0,369,29,0,0,0,0,0,0,0,0,0,0,100,NoArch
1914cd349c1ef2fef35bbe5dca363d6f2a0ec24d,1,27,23,4,50,0,0,0,9,14,1,1,0,459,3,7,0,76,75,1,2106,2044,62,33,32,1,1,100,NoArch
7a36f30c57527d64370097006e70a6cca20ed909,1,3,2,1,5,0,0,0,10,0,1,1,0,463,3,57,6,76,76,0,2109,2106,3,33,33,0,0,100,NoArch
de49005cf0ea685b59ed48988160df00d928d83e,0,0,0,0,0,0,0,0,0,0,0,0,0,0,0,370,30,0,0,0,0,0,0,0,0,0,1,100,NoArch
865d3f86e2b0c453747119578ad044507550d1eb,1,36,36,0,72,0,0,0,6,320,1,1,0,159,3,371,31,25,25,0,944,944,0,23,23,0,1,100,NoArch
79f9e20f1017e7aba27e954c67fb6d6efbcd2db0,0,0,0,0,0,0,0,0,0,0,0,0,0,0,0,372,32,0,0,0,0,0,0,0,0,0,1,100,NoArch
16b7dcdd4dfa5d9c49036c3d0f1b47bacea0c18d,0,0,0,0,0,0,0,0,0,0,0,0,0,0,0,259,30,0,0,0,0,0,0,0,0,0,0,100,NoArch
f4ae72c6dcaae878f744083c1e079b4f57efc73e,8,37,24,13,61,0,0,0,99,92,1,7,2.432351886,6258,2,373,33,1326,1321,5,34255,34183,72,321,321,0,1,100,NoArch
a9959448187d782f2cc48480ba6829c4453c4b7e,0,0,0,0,0,0,0,0,0,0,0,0,0,0,0,260,31,0,0,0,0,0,0,0,0,0,1,100,NoArch
78d960c26809187edc20e1386f9b5c94e56b5d14,0,0,0,0,0,0,0,0,0,0,0,0,0,0,0,58,7,0,0,0,0,0,0,0,0,0,0,100,NoArch
e99edfbcce77f8a58217096c9f7929d0e2856cab,1,76,2,74,78,0,0,0,11,3,1,1,0,464,3,8,1,85,76,9,2409,2109,300,39,33,6,0,100,NoArch
5d82019da7d6249083a854e72755a015959438b5,1,2,4,2,6,0,0,0,12,0,1,1,0,538,3,9,2,85,85,0,2400,2409,9,39,39,0,0,100,NoArch
3187f8886b027366ccaf034d72c92d5dcaf7cbc2,2,11,15,4,26,0,0,0,61,2,1,1,0.706274089,1091,2,374,34,268,270,2,6907,6903,4,57,57,0,1,100,NoArch
7786eaba7ff1f3888f037c7db0dfb38d63ecf3dc,0,0,0,0,0,0,0,0,0,0,0,0,0,0,0,29,9,0,0,0,0,0,0,0,0,0,0,100,NoArch
22b1e7f2574c4e4e0a39064aed0353bba6b231f4,0,0,0,0,0,0,0,0,0,0,0,0,0,0,0,59,8,0,0,0,0,0,0,0,0,0,1,100,NoArch
113333cc3ad44ab73201929e73aba0485ca68984,0,0,0,0,0,0,0,0,0,0,0,0,0,0,0,375,35,0,0,0,0,0,0,0,0,0,0,100,NoArch
9245306ce77163990aa55a8cb5f6c8a312e643f3,0,0,0,0,0,0,0,0,0,0,0,0,0,0,0,376,36,0,0,0,0,0,0,0,0,0,1,100,NoArch
e5aa7449cb77afbe8964ca867ab8c5d11d60f4b3,1,181,159,22,340,0,0,0,89,29,1,1,0,845,14,377,37,121,121,0,3206,3206,0,62,62,0,0,100,NoArch
4d05d8cd6a06abe11f5acb4300415dd270f3f3c6,1,8,0,8,8,1,0,1,13,4,1,1,0,536,3,10,3,87,85,2,2441,2400,41,40,39,1,0,100,NoArch
3482670636b034860b119c816fadd63c550c5062,0,0,0,0,0,0,0,0,0,0,0,0,0,0,0,60,9,0,0,0,0,0,0,0,0,0,1,100,NoArch
f9720ba40b658281fa2748ec268528adce2387e5,3,20,21,1,41,0,0,0,16,268,1,3,1.065805532,539,2,378,38,53,51,2,2587,2592,5,27,25,2,1,99.75542648,NoArch
3e497428ffef6b45453a18410d52c882a67eca16,1,51,31,20,82,0,0,0,14,1,1,1,0,544,3,11,4,90,87,3,2598,2441,157,42,40,2,0,100,NoArch
1b6332586a5ada51a9f9b54386362c1706978a07,1,1,1,0,2,0,0,0,62,5,1,1,0,827,6,379,39,194,194,0,5368,5366,2,42,42,0,1,100,NoArch
91f3c18b27bf4d75ed294692eab8416304ada46d,0,0,0,0,0,0,0,0,0,0,0,0,0,0,0,30,9,0,0,0,0,0,0,0,0,0,0,100,NoArch
967e4024b751960a9d36f1f3c9a29e8987bc0611,1,4,0,4,4,1,0,1,5,140,1,1,0,559,2,61,10,90,89,1,3094,3080,14,24,23,1,1,100,NoArch
f1300bc0a7bf2c9c1ce3f5f66a8f955208c9111c,1,21,11,10,32,0,0,0,15,2,1,1,0,564,3,12,5,91,90,1,2618,2598,20,42,42,0,0,100,NoArch
e40daa00e9bf6c0cdfb7e23ccf82efb30629e802,1,2,2,0,4,0,0,0,4,29,1,1,0,63,2,62,11,0,0,0,94,94,0,0,0,0,0,100,NoArch
96da74fbb1eaeb54415dd5b871586365161f1476,0,0,0,0,0,0,0,0,0,0,0,0,0,0,0,63,12,0,0,0,0,0,0,0,0,0,1,100,NoArch
3e1690a5c827a1a4d1ea59f1f54d4cc01946e3a1,1,2,0,2,2,1,0,1,16,8,1,1,0,574,3,64,13,91,91,0,2643,2618,25,42,42,0,0,100,NoArch
b293b42331484ada832883433b078fe47e2ef987,0,0,0,0,0,0,0,0,0,0,0,0,0,0,0,65,14,0,0,0,0,0,0,0,0,0,0,100,NoArch
f37565918637ee8d654be6f7523addb7bb74b2ab,5,255,111,144,366,1,0,1,294,48,1,4,1.020083336,9759,7,380,28,1462,1434,28,39522,38639,883,678,670,8,0,99.87775061,NoArch
b7fd4236d14f54e0ba5f9e3ea8a305f6dd9257f6,1,22,26,4,48,0,0,0,2,0,1,1,0,250,1,381,28,45,46,1,1551,1641,90,14,11,3,0,100,NoArch
2a24e68f2f63dc8c52600afe49b00aa6df2c5dc9,0,0,0,0,0,0,0,0,0,0,0,0,0,0,0,656,13,0,0,0,0,0,0,0,0,0,0,100,NoArch
ad1a25fa323ff6213f72ad02cef24f104aeca8a7,0,0,0,0,0,0,0,0,0,0,0,0,0,0,0,657,14,0,0,0,0,0,0,0,0,0,0,100,NoArch
b0844f1d527a953731a97ea9a460bada68908ca6,10,167,15,152,182,3,0,3,100,212,1,5,2.368057784,4207,2,142,1,1161,1145,16,25949,25061,888,177,172,5,0,99.72535856,NoArch
511c7908d38e885f2558e0df3e39232e5dba8701,1,84,48,36,132,0,0,0,17,2,1,1,0,576,3,13,6,91,91,0,2663,2643,20,42,42,0,0,100,NoArch
7bd1ed9818b65df78ca8c8e7bda24218349bad8e,0,0,0,0,0,0,0,0,0,0,0,0,0,0,0,261,2,0,0,0,0,0,0,0,0,0,0,100,NoArch
6a7e160de0c8419c9ef0012ac945381a955fcce9,2,563,11,552,574,1,0,1,18,2,1,1,0.509613325,612,1,14,7,148,91,57,4732,2663,2069,69,42,27,0,99.4538835,NoArch
d5c7e6b8d25b1182715f6d0b9d5629334e37f6f6,1,14,9,5,23,0,0,0,2,0,1,1,0,509,1,15,8,57,57,0,2069,2069,0,27,27,0,0,100,NoArch
2cdb6de0d96f4b7ca0b905537c6a6f5580423163,1,115,120,5,235,0,0,0,7,88,1,1,0,267,4,382,24,31,31,0,882,882,0,26,26,0,0,100,NoArch
5e629a69c210ec994f8ddd16fba76b54ffd41203,1,44,21,23,65,0,0,0,20,122,1,1,0,283,7,383,25,55,54,1,1377,1228,149,23,22,1,1,99.84907938,NoArch
2ba882d97c5dbca9f8db1b3749b0db34d86a984e,2,64,15,49,79,1,0,1,11,4,1,2,0.973835482,204,2,143,2,26,18,8,1663,1390,273,18,16,2,0,99.96982498,NoArch
02cf0c491abf50e0a2009c202c999ca553c795af,2,90,5,85,95,1,0,1,112,19,1,2,0.339855078,2546,1,658,5,597,589,8,14915,14541,374,136,132,4,1,98.62469438,NoArch
a7ca194fb371071bfbd27adc2ef15fee2d90f3b1,2,13,3,10,16,0,0,0,9,36,1,1,0.543564443,365,5,659,6,35,33,2,994,936,58,19,18,1,1,100,NoArch
25a0b5f2fabdd0b997d83152411f01c93fd0bda9,1,1,3,2,4,0,0,0,295,7,1,1,0,7752,24,660,6,1081,1081,0,29241,29261,20,523,523,0,1,100,NoArch
a7f0095f7de1cafefcb259c0ccf67ead40ccecfb,1,78,5,73,83,0,0,0,19,1,1,1,0,655,3,66,13,103,91,12,2984,2663,321,47,42,5,0,98.64580199,NoArch
6a91691e9916bc9de054f03aec5645fbb44c396f,0,0,0,0,0,0,0,0,0,0,0,0,0,0,0,67,14,0,0,0,0,0,0,0,0,0,0,100,NoArch
f4048251535b857a4cf1e759630cbc6f40789cc7,3,105,27,78,132,0,0,0,21,235,1,1,1.506675836,640,3,384,21,118,108,10,3146,2687,459,50,44,6,1,99.85358712,NoArch
aa4267e75016e93f22081952f4dda5791f0eb616,1,1,1,0,2,0,0,0,296,3,1,1,0,7750,24,661,5,1081,1081,0,29241,29241,0,523,523,0,0,100,NoArch
91188c4be78e7e775a79de3f94bfc099284191cb,3,43,32,11,75,1,0,1,89,172,1,3,1.506538423,798,4,385,20,150,148,2,4247,4208,39,57,54,3,0,99.94145199,NoArch
aaeb880c7b76ff0cac49c729efea744dcb476709,0,0,0,0,0,0,0,0,0,0,0,0,0,0,0,68,15,0,0,0,0,0,0,0,0,0,0,100,NoArch
93aeefb4988c4d11b5719bd31fc9a45c1156eb17,27,459,427,32,886,3,0,3,113,85,1,6,3.553641724,7357,5,31,2,1510,1477,33,38131,37495,636,527,518,9,0,98.69565217,NoArch
92214e01b69972c76174b05b3c86a63ba25b6a99,1,54,5,49,59,0,0,0,17,163,1,1,0,346,3,386,19,96,86,10,2265,1892,373,46,40,6,0,99.88512349,NoArch
bc626581dceb5baad13073b6704f7f3a41c0a722,8,155,115,40,270,4,0,4,114,0,1,4,1.750838381,4122,4,32,3,969,964,5,24136,23852,284,292,286,6,0,99.79908152,NoArch
ffb945367cb893d246c4716040adf7984551db17,1,13,6,7,19,0,0,0,152,50,1,1,0,3689,13,662,6,594,592,2,20202,20170,32,154,154,0,1,100,NoArch
96c0829f22b21ba9d1f7ef47da29d50629392f4e,0,0,0,0,0,0,0,0,0,0,0,0,0,0,0,82,0,0,0,0,0,0,0,0,0,0,0,100,NoArch
5853fd6b3ddfc50d77a790840b0f643013a3b306,0,0,0,0,0,0,0,0,0,0,0,0,0,0,0,83,1,0,0,0,0,0,0,0,0,0,0,100,NoArch
3139e1dedcd66f2e62528cb32359097585373317,0,0,0,0,0,0,0,0,0,0,0,0,0,0,0,69,16,0,0,0,0,0,0,0,0,0,0,100,NoArch
d2bcb1d3308ce06db177d2ed9f5546c61916d653,1,12,2,10,14,0,0,0,20,9,1,1,0,728,3,70,17,105,103,2,3056,2984,72,47,47,0,0,100,NoArch
cffe1cbed98aedb48d1d2673246baa88ff0fb0bf,1,3,12,9,15,0,0,0,3,11,1,1,0,514,1,16,9,55,57,2,2012,2069,57,26,27,1,0,100,NoArch
0777e57e2f0fe2770ba6ab44980469f513bd1863,14,18,30,12,48,0,0,0,115,59,1,8,3.444773835,6842,2,387,19,1260,1260,0,34531,34617,86,416,416,0,0,100,NoArch
08acb7e6e47eedb4c174ceecf132740a3fc35ae4,1,6,8,2,14,0,0,0,21,2,1,1,0,738,3,71,17,104,105,1,3054,3056,2,48,47,1,0,100,NoArch
244de7ae7ce8090df72cda34797c0e4367238ec0,10,151,1,150,152,9,0,9,7,7,1,2,3.320841338,826,1,33,4,165,165,0,4604,4604,0,77,77,0,0,100,NoArch
c751aad0fe08c3793b0cc71e5db3ce6ec12cc087,0,0,0,0,0,0,0,0,0,0,0,0,0,0,0,72,18,0,0,0,0,0,0,0,0,0,0,100,NoArch
10435abfd032c6dd60a4fd337e2aa31685dda751,0,0,0,0,0,0,0,0,0,0,0,0,0,0,0,73,19,0,0,0,0,0,0,0,0,0,0,100,NoArch
fc308cfec21f2a3977439f50cfbfedfad3366227,1,246,116,130,362,0,0,0,116,0,1,1,0,2514,9,34,5,638,598,40,15472,14778,694,134,133,1,0,100,NoArch
db25ab022c7bb13954614ea7664f38e21fbdceb9,1,7,1,6,8,0,0,0,22,0,1,1,0,736,3,74,17,106,104,2,3088,3054,34,48,48,0,0,100,NoArch
a23f85d0f4441e29ac27b6947b8b17d38d1691e8,0,0,0,0,0,0,0,0,0,0,0,0,0,0,0,75,18,0,0,0,0,0,0,0,0,0,0,100,NoArch
e348781f2db447e9c3112f3f996fafdc00034365,0,0,0,0,0,0,0,0,0,0,0,0,0,0,0,76,19,0,0,0,0,0,0,0,0,0,0,100,NoArch
f85a71f2c0494b986dab67fd07b8dbbba5caa7de,3,51,55,4,106,0,0,0,117,4,1,3,1.577145785,3376,5,35,6,801,803,2,19508,19498,10,181,180,1,0,100,NoArch
d6699b1c0073c2e00d57e9276e8cd784970aee58,0,0,0,0,0,0,0,0,0,0,0,0,0,0,0,77,19,0,0,0,0,0,0,0,0,0,0,100,NoArch
2355fbcaf6f5d6c7c6db9f9ff9d0df77fb18d8ff,5,109,39,70,148,1,0,1,22,130,1,3,1.959683769,1342,4,388,15,225,203,22,5651,5321,330,112,110,2,0,100,NoArch
d50bb2346128af180f8247c12da311f3cf26e14e,1,54,0,54,54,1,0,1,10,0,1,1,0,326,5,389,15,50,48,2,1285,1260,25,37,35,2,1,100,NoArch
243c52b140cf8adc9656c641a66d5808a4ccd49b,1,5,1,4,6,0,0,0,63,32,1,1,0,827,6,390,16,195,194,1,5391,5368,23,42,42,0,1,100,NoArch
bdcf6b935867097de0802d8b86ef11a7c7e14d5a,0,0,0,0,0,0,0,0,0,0,0,0,0,0,0,78,19,0,0,0,0,0,0,0,0,0,0,100,NoArch
2e7318c54bed0b89e3d40c95762361bb39bf33ee,0,0,0,0,0,0,0,0,0,0,0,0,0,0,0,79,20,0,0,0,0,0,0,0,0,0,0,100,NoArch
83629dc16c88975c082249f71d8c566b9cac4ee8,6,606,283,323,889,2,0,2,118,9,1,3,1.189953761,4269,1,36,7,1044,976,68,24926,23375,1551,259,236,23,0,99.94266055,NoArch
1de0dc74615b4ce6d505c96b8c09b08f4f367082,0,0,0,0,0,0,0,0,0,0,0,0,0,0,0,391,16,0,0,0,0,0,0,0,0,0,0,100,NoArch
da42eb823f7d0d44f1223c985414532d8bdae330,0,0,0,0,0,0,0,0,0,0,0,0,0,0,0,392,17,0,0,0,0,0,0,0,0,0,0,100,NoArch
45defe23886c2b623e71efe57968af04e9091d26,0,0,0,0,0,0,0,0,0,0,0,0,0,0,0,37,8,0,0,0,0,0,0,0,0,0,0,100,NoArch
b62e4d3165b4d899a3b6c71dba2858c9362b2e1b,1,24,23,1,47,0,0,0,119,1,1,1,0,2528,9,38,8,609,609,0,14683,14631,52,130,130,0,0,100,NoArch
2a138098cd8b4f17d77e85747d780fd0de38173f,1,38,10,28,48,0,0,0,3,27,1,1,0,246,1,393,18,52,45,7,1726,1551,175,17,14,3,0,100,NoArch
39cafd6fb895372a721e53572cbd7de153673813,1,34,38,4,72,0,0,0,16,3,1,1,0,404,3,39,9,117,117,0,2542,2552,10,29,29,0,0,100,NoArch
bdaeb800effbfc845dac0d847cbda4e3e7386ee5,1,4,0,4,4,1,0,1,4,0,1,1,0,274,1,394,19,53,52,1,1751,1726,25,18,17,1,0,100,NoArch
4c5029be3df3c24554209d649f3b7a1bc876ff4b,1,5,1,4,6,0,0,0,5,0,1,1,0,278,1,395,19,54,53,1,1767,1751,16,19,18,1,0,100,NoArch
92cd5d12f42c88b1d80044ad2c8cccb1a2622c41,1,1,1,0,2,0,0,0,6,0,1,1,0,282,1,396,20,54,54,0,1763,1767,4,19,19,0,0,100,NoArch
5b2effd421a35656f3035b8960e5fbc5cf5fb243,0,0,0,0,0,0,0,0,0,0,0,0,0,0,0,397,19,0,0,0,0,0,0,0,0,0,0,100,NoArch
4404db8aeefd044a3d4547b848e2d7c12ebdeff6,1,6,0,6,6,1,0,1,3,166,1,1,0,43,2,663,7,5,3,2,372,325,47,2,2,0,1,98.33953622,NoArch
aa930207069324964b6653336f3583c5d17ece52,1,5,1,4,6,0,0,0,153,14,1,1,0,3696,13,664,8,595,594,1,20208,20202,6,154,154,0,0,100,NoArch
b8fcdfc6f34e9591f21103cd7ca1751c33bad7c1,0,0,0,0,0,0,0,0,0,0,0,0,0,0,0,665,9,0,0,0,0,0,0,0,0,0,1,100,NoArch
d825e206eb0c6b5e5b430b6f393bb16663c9e678,1,1,1,0,2,0,0,0,64,6,1,1,0,831,6,666,10,195,195,0,5405,5391,14,42,42,0,0,100,NoArch
0abab9989260e7c88b78cf0e9be910166da86c36,0,0,0,0,0,0,0,0,0,0,0,0,0,0,0,667,11,0,0,0,0,0,0,0,0,0,0,100,NoArch
efe311214367bc2fbcb708468f20b65249eb853e,1,14,9,5,23,0,0,0,8,181,1,1,0,98,5,40,9,18,13,5,376,350,26,11,10,1,0,100,NoArch
c499b09e02436947fc8c643bc69c9136eddd872d,13,54,74,20,128,1,0,1,297,50,1,8,2.927750761,22334,3,41,10,3993,3991,2,105661,105773,112,1297,1297,0,0,99.97139588,NoArch
d3a511c4600c8b34cf49aeaa8d29ce4e02ea2ac0,0,0,0,0,0,0,0,0,0,0,0,0,0,0,0,398,18,0,0,0,0,0,0,0,0,0,0,100,NoArch
71677ec60be4f581f583ab3a35cc468a8a7a195b,1,12,1,11,13,0,0,0,20,3,1,1,0,635,3,668,12,153,149,4,3722,3654,68,40,39,1,1,100,NoArch
daeadebf423c1ea5ed8bef13b88af1fa64c1baeb,0,0,0,0,0,0,0,0,0,0,0,0,0,0,0,42,11,0,0,0,0,0,0,0,0,0,0,100,NoArch
ee01679b1e6c152f9aca1676c992343e496e19fd,2,228,67,161,295,0,0,0,121,6,1,2,0.852664658,2958,1,43,12,748,704,44,18135,17047,1088,163,156,7,0,100,NoArch
ad0881855ac928424dc24f669a82873389c66429,7,106,87,19,193,0,0,0,155,115,1,3,2.018221002,6180,6,44,13,1095,1083,12,34537,34696,159,304,299,5,0,100,NoArch
dfc67d021b257cdc24b7932999edaa5ec1c6841d,2,16,11,5,27,0,0,0,51,139,1,1,0.605186577,218,11,45,14,18,17,1,707,650,57,8,8,0,0,100,NoArch
c5508171ce7720a2cafe1c0e53c68b5c630ae1fb,0,0,0,0,0,0,0,0,0,0,0,0,0,0,0,46,15,0,0,0,0,0,0,0,0,0,0,100,NoArch
5ea9f67a5594c1eb3598d4e4dc8579c47a199c2e,1,96,0,96,96,1,0,1,23,18,1,1,0,742,3,17,4,116,106,10,3324,3088,236,51,48,3,0,100,NoArch
1f3c65c64d27e21f727d321517a49059a04e4aaa,1,45,7,38,52,0,0,0,5,21,1,1,0,505,2,18,5,65,55,10,2166,2012,154,29,26,3,0,100,NoArch
cc2258506435f06f6b155b623d1cbe2f5aa46f1f,1,2,2,0,4,0,0,0,122,10,1,1,0,2611,9,47,16,633,633,0,15222,15222,0,131,131,0,0,100,NoArch
c0eb547fc02a7f3fed8abd830fd030eb8f6c1283,1,76,1,75,77,0,0,0,7,18,1,1,0,282,1,399,17,67,54,13,2332,1763,569,22,19,3,0,100,NoArch
097ce972f1eb59c0d14aa3391fcdbb40df14f8a8,0,0,0,0,0,0,0,0,0,0,0,0,0,0,0,400,18,0,0,0,0,0,0,0,0,0,0,100,NoArch
bf9407cefa62c2c29efc2e9b73b691da55197546,2,23,5,18,28,0,0,0,298,23,1,2,0.966618633,7814,24,401,19,1093,1090,3,29486,29368,118,530,529,1,1,100,NoArch
d65eb99cf44a8c43a0cb40a40db81905b338af8e,2,4,7,3,11,0,0,0,299,327,1,2,0.945660305,8006,4,402,20,1100,1101,1,30359,30358,1,538,538,0,1,100,NoArch
ce7aa9ad2cea0df2c005fc0b5dcbe2d3d834048c,2,58,3,55,61,1,0,1,17,58,1,2,0.998254569,454,2,33,0,58,52,6,2133,1854,279,29,26,3,1,100,NoArch
d0e7e8b489695266908392fee018c3b9bc93561e,1,1,1,0,2,0,0,0,18,0,1,1,0,394,8,34,1,45,45,0,1597,1597,0,18,18,0,0,100,NoArch
74df63ec94473d3ecf092513ce00e07991a084af,1,6,1,5,7,0,0,0,28,46,1,1,0,620,11,19,5,86,86,0,2452,2452,0,39,39,0,1,100,NoArch
d0fe26c417d2782d86b22e96be3e0535db9736f0,1,1,1,0,2,0,0,0,29,0,1,1,0,625,11,20,6,87,86,1,2462,2452,10,39,39,0,1,100,NoArch
123db05cb9149af2e637e1355dc32b0c114be11c,0,0,0,0,0,0,0,0,0,0,0,0,0,0,0,80,14,0,0,0,0,0,0,0,0,0,1,100,NoArch
4661f53e4d20841454198bd629bae5ccf3718ed9,0,0,0,0,0,0,0,0,0,0,0,0,0,0,0,262,0,0,0,0,0,0,0,0,0,0,1,100,NoArch
ae06cbd232044abb44cb95f572452fbf4e4cf572,2,3,14,11,17,0,0,0,300,331,1,2,0.787126586,7853,2,403,19,1089,1089,0,29784,29774,10,529,529,0,1,100,NoArch
0f9c01e886704303f15028c1594d13700a55a970,0,0,0,0,0,0,0,0,0,0,0,0,0,0,0,81,13,0,0,0,0,0,0,0,0,0,0,100,NoArch
0f219e77078f8713ebe95d3205c22d49f52fb098,0,0,0,0,0,0,0,0,0,0,0,0,0,0,0,21,5,0,0,0,0,0,0,0,0,0,0,100,NoArch
aaaa3fc116e97a3ca7466313ff5cf13dabef2be3,3,44,8,36,52,1,0,1,301,3,1,3,1.194706843,8103,1,404,17,1160,1150,10,31830,31572,258,547,545,2,0,99.91423671,NoArch
776c493463d15f44784e1c0c7310413116d14aa3,0,0,0,0,0,0,0,0,0,0,0,0,0,0,0,35,2,0,0,0,0,0,0,0,0,0,0,100,NoArch
26f902502d197ffb2dcd24606d9c953967eced87,0,0,0,0,0,0,0,0,0,0,0,0,0,0,0,82,11,0,0,0,0,0,0,0,0,0,1,100,NoArch
e8a9d851e32ab7452b83fc0af7476f89e42477e7,0,0,0,0,0,0,0,0,0,0,0,0,0,0,0,48,15,0,0,0,0,0,0,0,0,0,1,100,NoArch
f761ca2ac1187b761f8d49f21de0b8d4537327e9,0,0,0,0,0,0,0,0,0,0,0,0,0,0,0,49,16,0,0,0,0,0,0,0,0,0,1,100,NoArch
f9f3239e2b2a1a3d3f319843ad94bc2562f2350a,0,0,0,0,0,0,0,0,0,0,0,0,0,0,0,263,1,0,0,0,0,0,0,0,0,0,1,100,NoArch
2cfb5dde14ad8ed0bf10834e5cad1acf14afc9c2,0,0,0,0,0,0,0,0,0,0,0,0,0,0,0,50,17,0,0,0,0,0,0,0,0,0,1,100,NoArch
2ca6f66484b6c20535a9df786df40e44d76cb628,0,0,0,0,0,0,0,0,0,0,0,0,0,0,0,51,18,0,0,0,0,0,0,0,0,0,1,100,NoArch
8507ef5c509b9f7cb4a6e4bc384174f2e634a2e0,1,9,5,4,14,0,0,0,21,41,1,1,0,330,5,52,17,47,47,0,1519,1508,11,19,19,0,0,100,NoArch
634a569079901cd90eda4157bd66520833f843d3,1,4,2,2,6,0,0,0,20,402,1,1,0,181,5,244,0,9,7,2,581,557,24,2,2,0,0,100,NoArch
ffb26b48af193d3e6600a1480e7006e461790361,1,11,12,1,23,0,0,0,29,403,1,1,0,364,9,53,17,49,48,1,1376,1358,18,21,20,1,1,100,NoArch
cce09b67611b2b692f93515a54f3eb1cb7937d00,0,0,0,0,0,0,0,0,0,0,0,0,0,0,0,54,18,0,0,0,0,0,0,0,0,0,0,100,NoArch
77791cd17d917aaf212e605ca4d17adac6b76b20,2,18,1,17,19,1,0,1,30,48,1,2,0.485460761,1131,6,55,19,269,262,7,6367,6243,124,62,59,3,1,99.79994284,NoArch
a71f35b3ed502d66967c477b3a2676055ff2ec64,1,24,0,24,24,1,0,1,31,0,1,1,0,380,9,56,20,65,56,9,1646,1487,159,25,24,1,0,100,NoArch
b395a965d75616d5c3df13129801d6ce2948e25d,0,0,0,0,0,0,0,0,0,0,0,0,0,0,0,264,2,0,0,0,0,0,0,0,0,0,2,100,NoArch
a66baa3d957506d2d76a4a0cd59cac3680e9e3c2,0,0,0,0,0,0,0,0,0,0,0,0,0,0,0,405,15,0,0,0,0,0,0,0,0,0,0,100,NoArch
f695a00a01980e5b7560f015e44f71744a2e9634,0,0,0,0,0,0,0,0,0,0,0,0,0,0,0,406,15,0,0,0,0,0,0,0,0,0,0,100,NoArch
b5f3ddc979554adc835f167db35bfd5befa16ec5,2,62,23,39,85,1,0,1,92,16,1,2,0.983060555,684,1,407,16,144,141,3,3984,3745,239,52,49,3,1,99.94285714,NoArch
485f967bc1d03fc1e4ec03636119ebf950c9b7a5,0,0,0,0,0,0,0,0,0,0,0,0,0,0,0,408,17,0,0,0,0,0,0,0,0,0,1,100,NoArch
010946de60c9847921fb614dc147263096d8d12a,0,0,0,0,0,0,0,0,0,0,0,0,0,0,0,409,18,0,0,0,0,0,0,0,0,0,0,100,NoArch
a94c344ab5d6c795dbb81887b9576b31274142dc,2,37,0,37,37,2,0,2,66,14,1,2,0.974024864,831,1,57,21,202,195,7,5548,5401,147,45,42,3,0,99.94292237,NoArch
db366eb024d00441c2b3a582e55af65c70bfd58d,1,2,1,1,3,0,0,0,67,0,1,1,0,846,6,58,22,200,200,0,5506,5495,11,43,43,0,0,100,NoArch
f85c3ff1a0e65219f27e25cfd9f2551646dc0074,1,1,1,0,2,0,0,0,302,10,1,1,0,7751,24,245,1,1084,1084,0,29271,29271,0,523,523,0,1,100,NoArch
e57dc08ba0daef3285f79212d493d0c3c7871cf6,1,13,15,2,28,0,0,0,24,27,1,1,0,838,3,83,3,119,116,3,3317,3324,7,53,51,2,0,100,NoArch
0bc29cf3986090cdd078e07993f6f84b192fb52c,1,2,1,1,3,0,0,0,8,408,1,1,0,82,5,669,6,9,9,0,263,254,9,9,9,0,1,100,NoArch
bb933c5d480d92f17ced210454297d14965cc688,1,4,1,3,5,0,0,0,22,32,1,1,0,498,5,670,7,102,101,1,2648,2621,27,29,29,0,1,100,NoArch
96281b05fd29c68c20fed3b5183716fcf4c50507,0,0,0,0,0,0,0,0,0,0,0,0,0,0,0,246,2,0,0,0,0,0,0,0,0,0,1,100,NoArch
1f1bd18da2d5d93198cd9ae5bbf030943a69fd17,1,32,8,24,40,0,0,0,12,115,1,1,0,285,6,671,8,49,45,4,1159,1074,85,15,15,0,1,100,NoArch
f83ddedd927ee22aff64c489873343bde3004316,1,0,0,0,0,1,0,1,1,0,1,1,0,89,1,672,9,16,16,0,546,546,0,12,12,0,0,99.8288648,NoArch
15092f94bc36be9e3858e2421895ea385438e702,0,0,0,0,0,0,0,0,0,0,0,0,0,0,0,673,10,0,0,0,0,0,0,0,0,0,0,100,NoArch
073020c3dc91813bea23abcb1897164b7e321aa9,1,7,0,7,7,1,0,1,102,37,1,1,0,2560,11,674,11,509,508,1,13583,13543,40,109,109,0,1,100,NoArch
321816d5f55507f7a26294d3ff63241beabfe68f,1,1,1,0,2,0,0,0,2,0,1,1,0,89,1,675,12,16,16,0,548,546,2,12,12,0,0,100,NoArch
4af73976f9669a95c4e6cc266cf74a70b59d090e,1,47,46,1,93,0,0,0,23,410,1,1,0,225,7,410,13,24,24,0,789,770,19,15,15,0,1,100,NoArch
fc919c637394f1c8f295c5b9fd05b584273a3c88,1,19,11,8,30,0,0,0,13,2,1,1,0,309,6,676,9,50,49,1,1223,1159,64,15,15,0,1,100,NoArch
b978bec06a34de3d417ffc3499767bcd21ff7059,1,17,0,17,17,1,0,1,23,48,1,1,0,346,7,411,13,61,60,1,1614,1544,70,27,27,0,1,100,NoArch
f5fdf62b6192c8adba51c72aa9e40a8c75c1d7c5,4,76,14,62,90,0,0,0,303,68,1,2,1.384822911,9240,24,59,19,1376,1359,17,36192,35874,318,645,638,7,2,100,NoArch
f5bd7ad888f754b0ccaaeebb4ae5e6288d57d768,0,0,0,0,0,0,0,0,0,0,0,0,0,0,0,60,18,0,0,0,0,0,0,0,0,0,1,100,NoArch
02857c09edd833afab9e241689f922b1959fc3a8,1,21,1,20,22,0,0,0,14,2,1,1,0,317,6,61,19,53,50,3,1365,1223,142,16,15,1,1,100,NoArch
23df4399277354bcbb5ab91677249cf6fb4021c0,1,11,14,3,25,0,0,0,15,0,1,1,0,337,6,62,20,53,53,0,1374,1365,9,16,16,0,1,100,NoArch
c930c6a60f8befba0ffb556c993f9ca95b86963c,1,69,0,69,69,1,0,1,304,2,1,1,0,7753,25,0,0,1092,1086,6,29484,29286,198,527,523,4,1,100,NoArch
7ce00d136e466abe41f0458fdf044fa286234914,1,29,32,3,61,0,0,0,7,195,1,1,0,137,3,677,9,18,18,0,773,779,6,4,4,0,1,100,NoArch
a5f4a95205e6eeffa45b69af250713c3499090e1,2,12,7,5,19,0,0,0,156,49,1,2,0.74248757,4528,11,412,13,783,782,1,25220,25191,29,246,246,0,1,100,NoArch
2d458e0a61e3e647e743e1e282c400ce86055573,1,4,0,4,4,1,0,1,6,55,1,1,0,125,2,413,14,23,22,1,574,558,16,18,17,1,1,100,NoArch
17ade06f30ce98532da91b713a952905233ac89f,1,1,0,1,1,1,0,1,7,0,1,1,0,129,2,414,15,24,23,1,585,574,11,18,18,0,1,100,NoArch
113f4a353e108e24bb48be49acf4b58f34bb2956,1,51,16,35,67,0,0,0,9,20,1,1,0,379,1,415,16,83,74,9,2777,2515,262,25,23,2,0,100,NoArch
6435c3efe733f6d4439a33b2d230cdbcf8059dba,2,121,95,26,216,1,0,1,73,78,1,2,0.105591036,868,1,678,9,156,151,5,5501,5279,222,38,36,2,1,100,NoArch
0a246a002904697e8f70ab3b7cbd4388b978783b,1,12,7,5,19,0,0,0,305,4,1,1,0,7822,25,1,1,1094,1092,2,29539,29484,55,527,527,0,1,100,NoArch
11e90a91db84efe296ae70b793aac7003e11913b,1,11,8,3,19,0,0,0,306,0,1,1,0,7827,25,2,2,1093,1094,1,29536,29539,3,527,527,0,1,100,NoArch
44cbd031a50154d1d14af71470c94a465823fd74,1,1,1,0,2,0,0,0,307,0,1,1,0,7830,25,3,3,1093,1093,0,29536,29536,0,527,527,0,0,100,NoArch
576936b3431f31633991ee24cef6b624e0c69604,0,0,0,0,0,0,0,0,0,0,0,0,0,0,0,4,4,0,0,0,0,0,0,0,0,0,0,100,NoArch
b81ae2aa66fbc53fe93397e4f585709c28152142,1,52,1,51,53,0,0,0,308,0,1,1,0,7830,25,416,17,1097,1093,4,29681,29536,145,531,527,4,1,100,NoArch
22cb44fa1a00063d4623eacea109db5b45af2751,1,12,0,12,12,1,0,1,10,3,1,1,0,414,1,417,18,86,83,3,2864,2777,87,27,25,2,0,100,NoArch
c759adcb1f5b8e429169c5e471931e4cf6dee41c,4,400,122,278,522,1,0,1,42,217,1,4,1.076293343,1146,1,679,10,135,129,6,5543,3836,1707,59,54,5,2,99.714856,NoArch
5d6b367aa7f576e432ad55548b5dfabe30a69bf7,2,76,35,41,111,0,0,0,13,150,1,1,0.130162791,724,4,680,11,153,141,12,4671,4277,394,36,33,3,2,100,NoArch
170bbb270b8435470a2c5147ab8b7941f76964a8,1,3,1,2,4,0,0,0,309,2,1,1,0,7881,25,418,19,1099,1097,2,29705,29681,24,531,531,0,1,100,NoArch
f41ee9de30b86b6ebdb443eb6653c3606ce5f290,0,0,0,0,0,0,0,0,0,0,0,0,0,0,0,419,20,0,0,0,0,0,0,0,0,0,1,100,NoArch
667cd7f3e3bfc24660f472242d3a0429974645bd,1,20,20,0,40,0,0,0,23,2,1,1,0,651,6,420,21,71,71,0,1624,1624,0,36,36,0,0,100,NoArch
c4d65c97fc34c070763b5fad94004a3192ee5033,1,19,8,11,27,0,0,0,19,35,1,1,0,394,8,421,22,45,45,0,1588,1597,9,18,18,0,0,100,NoArch
21fd4fc1e02f39b0d8e91eeaeb221f01a146127b,0,0,0,0,0,0,0,0,0,0,0,0,0,0,0,422,23,0,0,0,0,0,0,0,0,0,0,100,NoArch
e4544b887da07a347bf50835b62c03741d75af24,3,29,24,5,53,1,0,1,24,31,1,3,0.461490599,982,1,681,12,82,81,1,4053,4005,48,45,45,0,0,99.94298746,NoArch
b93aef67b5040758b9a1f250118dadd5065dddbf,6,64,27,37,91,2,0,2,97,33,1,5,1.762108483,2838,1,682,13,566,554,12,16345,16019,326,176,172,4,0,100,NoArch
b85342ab645e1abfb7aea0986f5a603863a14491,1,9,1,8,10,0,0,0,25,1,1,1,0,654,6,683,14,73,72,1,1663,1647,16,37,36,1,0,100,NoArch
5177ffed80436c32bc83f9c515de02d955e5a7ee,1,1,0,1,1,1,0,1,4,222,1,1,0,233,2,423,24,19,19,0,1596,1585,11,7,7,0,0,100,NoArch
4231c6bb8260101079137f3028a430be4c921153,0,0,0,0,0,0,0,0,0,0,0,0,0,0,0,424,25,0,0,0,0,0,0,0,0,0,0,100,NoArch
e049f63f6cd5435dd3002f95b8f8e01b05aee645,0,0,0,0,0,0,0,0,0,0,0,0,0,0,0,425,26,0,0,0,0,0,0,0,0,0,0,100,NoArch
dd9b3d812674c61274ae5b8eb3bdd8b2ec778b82,1,18,18,0,36,0,0,0,26,1,1,1,0,662,6,426,27,73,73,0,1663,1663,0,37,37,0,0,100,NoArch
f794efe9d5ed4ca6404407adc69c9270bfbada93,0,0,0,0,0,0,0,0,0,0,0,0,0,0,0,684,15,0,0,0,0,0,0,0,0,0,0,100,NoArch
afad57e238bdfa4e93a8684ba3e9dc12b0b68b7d,1,8,8,0,16,0,0,0,157,11,1,1,0,3704,13,685,16,601,596,5,20292,20206,86,155,154,1,0,100,NoArch
b611613438321cb58ad22e688b300fb6b3e8746d,0,0,0,0,0,0,0,0,0,0,0,0,0,0,0,686,17,0,0,0,0,0,0,0,0,0,0,100,NoArch
c22c2c384cdaf52e631aed8e9d4f2ce3c1ceb8d5,0,0,0,0,0,0,0,0,0,0,0,0,0,0,0,427,24,0,0,0,0,0,0,0,0,0,0,100,NoArch
2989c411ad85abf084821e7305939815f89599d2,0,0,0,0,0,0,0,0,0,0,0,0,0,0,0,247,3,0,0,0,0,0,0,0,0,0,0,100,NoArch
445b1ed5ce69f26bbafe8315513bc1cd9db18f64,0,0,0,0,0,0,0,0,0,0,0,0,0,0,0,36,1,0,0,0,0,0,0,0,0,0,0,100,NoArch
a49ba96a4e965707cabc5ef033d7726a86493266,1,23,14,9,37,0,0,0,39,61,1,1,0,791,8,428,24,239,239,0,5534,5534,0,34,34,0,0,100,NoArch
c67d768e7e07834b0f434b2a11103518a7fb1327,0,0,0,0,0,0,0,0,0,0,0,0,0,0,0,22,1,0,0,0,0,0,0,0,0,0,0,100,NoArch
85bdf2feceb7afc5f17f3a15083318f2a6509382,0,0,0,0,0,0,0,0,0,0,0,0,0,0,0,23,2,0,0,0,0,0,0,0,0,0,0,100,NoArch
eed238ff77ddba0411d47e2833eeb00a55f563d7,0,0,0,0,0,0,0,0,0,0,0,0,0,0,0,24,3,0,0,0,0,0,0,0,0,0,0,100,NoArch
aad4538dc6aa70d908254f9937f3e0f75772fac9,0,0,0,0,0,0,0,0,0,0,0,0,0,0,0,429,24,0,0,0,0,0,0,0,0,0,0,100,NoArch
69cc6c6f5e736e0ff5df051fbe6a9e0f92b2759e,2,22,8,14,30,0,0,0,123,63,1,2,0.996791632,2848,7,430,25,674,668,6,16409,16310,99,147,146,1,0,100,NoArch
86b01178c6123b2569030843120e3198e9f9d9f3,1,147,46,101,193,0,0,0,310,16,1,1,0,7883,25,248,4,1099,1099,0,29705,29705,0,531,531,0,1,100,NoArch
b851994f6ada2841f70a0c4a7fc517d38520ab70,0,0,0,0,0,0,0,0,0,0,0,0,0,0,0,431,26,0,0,0,0,0,0,0,0,0,0,100,NoArch
31131b49d076da1e52a54486bfc4d6e12540a159,1,177,46,131,223,0,0,0,311,2,1,1,0,7984,25,37,1,1099,1099,0,29705,29705,0,531,531,0,1,100,NoArch
ab82caecfc06faa3d6be6c82c20bd2f186f6eea0,1,41,68,27,109,0,0,0,41,25,1,1,0,829,11,63,15,186,187,1,4744,5014,270,92,92,0,1,100,NoArch
181f505caec29adf69e3b73da13fd03754868f67,0,0,0,0,0,0,0,0,0,0,0,0,0,0,0,64,16,0,0,0,0,0,0,0,0,0,1,100,NoArch
c984077cd753f19be200b08938b399d73bbe8f9d,6,77,44,33,121,1,0,1,158,28,1,5,1.616188077,8095,4,687,18,1636,1620,16,46793,46603,190,382,382,0,0,100,NoArch
246aaae492af094410397e436ceeff03348b9c18,1,6,2,4,8,0,0,0,159,0,1,1,0,3703,13,688,19,601,601,0,20316,20292,24,155,155,0,1,100,NoArch
a8acecd8ef17b1c4a268b711149e690b00c7b4f6,2,96,3,93,99,1,0,1,9,44,1,1,0.368556778,150,1,689,20,39,21,18,1185,645,540,13,7,6,0,99.94301994,NoArch
17c855089ec40fb7270f272256f51c6851fc51e1,0,0,0,0,0,0,0,0,0,0,0,0,0,0,0,432,27,0,0,0,0,0,0,0,0,0,0,100,NoArch
c3e062d89a61174f4a988b457c8669fa0d97a661,0,0,0,0,0,0,0,0,0,0,0,0,0,0,0,433,28,0,0,0,0,0,0,0,0,0,0,100,NoArch
b39f791d082f8ca240355de6a7f5f2457f1aadde,0,0,0,0,0,0,0,0,0,0,0,0,0,0,0,434,29,0,0,0,0,0,0,0,0,0,0,100,NoArch
8c8bea04136c722599da1c4a264c9def417c6f6f,0,0,0,0,0,0,0,0,0,0,0,0,0,0,0,435,30,0,0,0,0,0,0,0,0,0,0,100,NoArch
9482d3c0fdeec91519ed3c393ed0d0ac6773395d,0,0,0,0,0,0,0,0,0,0,0,0,0,0,0,436,31,0,0,0,0,0,0,0,0,0,0,100,NoArch
d6e9a23d64ca8fa9444530f2c89f0e11fa8cc9a6,1,22,4,18,26,0,0,0,30,55,1,1,0,625,11,25,3,87,87,0,2462,2462,0,39,39,0,1,100,NoArch
5f7ad0b1bc8b0cc5057c7b85de0ba96bb5ede12e,1,58,5,53,63,0,0,0,2,1,1,1,0,92,2,65,13,26,18,8,795,533,262,9,6,3,0,100,NoArch
3b2cf206789898a390dfbc6e1143b9c428bd75af,1,26,22,4,48,0,0,0,42,2,1,1,0,802,11,437,32,186,186,0,4743,4744,1,92,92,0,0,100,NoArch
e359d0ea6b0c5b29dcd05c9439f51897937ff740,1,333,286,47,619,0,0,0,312,2,1,1,0,8115,25,438,33,1099,1099,0,29705,29705,0,531,531,0,1,100,NoArch
d9712659f9b1b40bb2b730e7a190f9290165e668,1,5,0,5,5,1,0,1,125,2,1,1,0,2626,9,66,14,638,637,1,15314,15304,10,131,131,0,0,100,NoArch
93440725cdbc1e285e0498a8547795375fdb3f50,5,36,18,18,54,1,0,1,160,43,1,4,2.13374306,7726,3,690,21,1522,1517,5,42271,42105,166,387,384,3,1,100,NoArch
939b9beb417f747741a38c64fc234398ea42bc29,0,0,0,0,0,0,0,0,0,0,0,0,0,0,0,691,22,0,0,0,0,0,0,0,0,0,0,100,NoArch
4cb2646520dc5edb2fa116eb7abc355d4ee917c4,1,3,2,1,5,0,0,0,113,212,1,1,0,260,15,692,23,42,41,1,1137,1129,8,16,16,0,0,100,NoArch
af1e594f467b4df0ff1f21d1f728163666f0e0ba,0,0,0,0,0,0,0,0,0,0,0,0,0,0,0,84,1,0,0,0,0,0,0,0,0,0,0,100,NoArch
2615a6853c9f7c8ac4ea31793832bade3f43090f,0,0,0,0,0,0,0,0,0,0,0,0,0,0,0,26,4,0,0,0,0,0,0,0,0,0,1,100,NoArch
c8b514b7883f2702c3636493161535cd348650c1,1,105,89,16,194,0,0,0,313,3,1,1,0,8162,25,693,24,1099,1099,0,29705,29705,0,531,531,0,1,100,NoArch
e24f807b84a70082d101298ee108fba07ec2fa54,1,22,3,19,25,0,0,0,26,9,1,1,0,249,7,694,25,44,41,3,1362,1159,203,17,16,1,1,100,NoArch
7056579f3d49981c8bcbfa7b91b6913462dcaf76,0,0,0,0,0,0,0,0,0,0,0,0,0,0,0,695,26,0,0,0,0,0,0,0,0,0,0,100,NoArch
e5a11c6908f2700a9de8f190de5a696916a78bfb,2,154,63,91,217,0,0,0,314,21,1,2,0.105197211,8946,6,439,29,1311,1312,1,34578,34585,7,569,569,0,1,100,NoArch
5723771d303d385b6d795620990cfd643ac4e764,0,0,0,0,0,0,0,0,0,0,0,0,0,0,0,696,27,0,0,0,0,0,0,0,0,0,0,100,NoArch
d74e99650070bc2deeb691f93f987e8681dfc7c2,1,58,37,21,95,0,0,0,315,0,1,1,0,8268,25,440,30,1098,1098,0,29672,29672,0,531,531,0,1,100,NoArch
9303772abbf5b18b295de47bf88a3b8ef4352ca3,0,0,0,0,0,0,0,0,0,0,0,0,0,0,0,27,5,0,0,0,0,0,0,0,0,0,1,100,NoArch
4006e9615cef9b3f68bd1f0064838536d2a65d3b,0,0,0,0,0,0,0,0,0,0,0,0,0,0,0,28,6,0,0,0,0,0,0,0,0,0,1,100,NoArch
7da8511cbc62481d597091f813e5684394d058e4,1,11,1,10,12,0,0,0,316,3,1,1,0,8289,25,59,0,1101,1098,3,29726,29672,54,532,531,1,0,100,NoArch
1a161d7474c17d2381e0ce38ddfe572a0f5607c1,1,313,76,237,389,0,0,0,317,0,1,1,0,8299,25,441,31,1101,1101,0,29726,29726,0,532,532,0,1,100,NoArch
d80cb98fb65cf4bbee0cb403e3636c2ca6034048,1,3,3,0,6,0,0,0,31,7,1,1,0,643,11,60,1,87,87,0,2462,2462,0,39,39,0,0,100,NoArch
e8dc4624bf738df4d4a8ce90879d84e7de1fbead,0,0,0,0,0,0,0,0,0,0,0,0,0,0,0,85,1,0,0,0,0,0,0,0,0,0,0,100,NoArch
cdcbafc40e18bda1d1f3638fe12f5422f57aaede,1,2,4,2,6,0,0,0,20,185,1,1,0,397,8,442,32,69,69,0,1309,1326,17,23,23,0,1,100,NoArch
9780edd3c67c69a7e79a177b3c9d442166198f2a,0,0,0,0,0,0,0,0,0,0,0,0,0,0,0,29,7,0,0,0,0,0,0,0,0,0,1,100,NoArch
a489937e150daa6d54f0eb3b91a5bbcd227e2a13,0,0,0,0,0,0,0,0,0,0,0,0,0,0,0,30,8,0,0,0,0,0,0,0,0,0,1,100,NoArch
79323211561011026cb9ac46d4bf31c3c3c6f700,1,12,0,12,12,1,0,1,161,8,1,1,0,3715,13,443,31,606,604,2,20454,20385,69,156,156,0,1,100,NoArch
f0ad471786c47dadd1a940066f9876408e582817,2,10,5,5,15,0,0,0,76,230,1,2,0.566509507,652,6,67,8,103,103,0,2240,2210,30,55,55,0,1,100,NoArch
314a877158ed362b4e5a8fd2cc6affa6931ba04b,1,17,0,17,17,1,0,1,318,2,1,1,0,8536,25,444,32,1103,1101,2,29794,29726,68,533,532,1,1,100,NoArch
d0a26ffdd8903c7f568ff7ca7a4f366cb919024e,1,158,53,105,211,0,0,0,319,0,1,1,0,8553,25,445,33,1103,1103,0,29816,29794,22,533,533,0,1,100,NoArch
033359d56bd617553e4bd94f46085a51ac57d03f,1,9,3,6,12,0,0,0,22,8,1,1,0,648,3,68,9,155,154,1,3776,3741,35,40,40,0,1,99.54648526,NoArch
4539f5e22dbb6e2aed87bd324db4650d47fd9d68,0,0,0,0,0,0,0,0,0,0,0,0,0,0,0,86,2,0,0,0,0,0,0,0,0,0,1,100,NoArch
18745713c060c3092c1c4ead424766139b642d7e,1,6,1,5,7,0,0,0,9,263,1,1,0,331,3,23,0,59,58,1,2013,1993,20,20,20,0,1,100,NoArch
b95f2831a79dbdea741499e19290f6d3d75c1b77,0,0,0,0,0,0,0,0,0,0,0,0,0,0,0,446,34,0,0,0,0,0,0,0,0,0,0,100,NoArch
07cb9b353fc522d4bac798d6fa17fe191abed0e5,2,136,0,136,136,2,0,2,320,624,1,2,0.811278124,8797,5,447,35,1122,1108,14,30969,30499,470,546,538,8,1,100,NoArch
9894b1c1e7f6ae4d466bb2fd9a82942cae8ff6da,0,0,0,0,0,0,0,0,0,0,0,0,0,0,0,448,36,0,0,0,0,0,0,0,0,0,0,100,NoArch
7394f963773b52d3e12076c819c527709c99863b,1,28,0,28,28,1,0,1,321,0,1,1,0,8760,25,449,37,1120,1116,4,30136,30052,84,542,540,2,1,100,NoArch
f53c41e5c9cb3a5d64b7c17d9a7a4707d6af8f84,0,0,0,0,0,0,0,0,0,0,0,0,0,0,0,450,38,0,0,0,0,0,0,0,0,0,1,100,NoArch
066e95304678ae9854a85cd10cb0b98752e60b78,1,1,1,0,2,0,0,0,98,32,1,1,0,1052,12,451,39,216,216,0,5153,5155,2,91,91,0,0,100,NoArch
a344fe0b252fb56d927c8aa5d922523538bb3f11,1,21,11,10,32,0,0,0,2,111,1,1,0,89,2,69,6,9,8,1,474,381,93,4,4,0,1,99.9717833,NoArch
fd5a6feb4557ae22bf37366d1229c6fa2396b0c0,0,0,0,0,0,0,0,0,0,0,0,0,0,0,0,70,7,0,0,0,0,0,0,0,0,0,1,100,NoArch
99069769cc8402de89a43d496ff1c4e5478375cf,0,0,0,0,0,0,0,0,0,0,0,0,0,0,0,71,8,0,0,0,0,0,0,0,0,0,0,100,NoArch
0d48b6ef5b83808731e308eaaff5841fac4e1fe3,1,34,4,30,38,0,0,0,40,26,1,1,0,800,8,72,9,248,239,9,5746,5534,212,34,34,0,1,100,NoArch
f7b6a1395689301bae2927e30885034e57fc3036,1,1,1,0,2,0,0,0,16,462,1,1,0,124,6,697,17,26,26,0,467,469,2,19,19,0,0,100,NoArch
d4351e509908463dbfd1e2c8b6b917a01e9829b5,1,30,0,30,30,1,0,1,1,0,1,1,0,0,1,31,9,1,0,1,179,0,179,1,0,1,1,99.71854771,NoArch
7f64abe48e4fb701d4bed228e81f1f066db100c2,1,21,3,18,24,0,0,0,19,22,1,1,0,399,4,87,3,116,116,0,2579,2490,89,29,29,0,0,100,NoArch
3df30a82e45cc53b4c1cb60c7e255af67a7406f6,0,0,0,0,0,0,0,0,0,0,0,0,0,0,0,88,4,0,0,0,0,0,0,0,0,0,1,100,NoArch
c707231fe8ddeecf52d3a9501735fda117412bb6,0,0,0,0,0,0,0,0,0,0,0,0,0,0,0,698,15,0,0,0,0,0,0,0,0,0,1,100,NoArch
c2a94abd0d5eff9bf9524ee2349a49bb3837e099,1,1,1,0,2,0,0,0,43,22,1,1,0,806,11,699,16,186,186,0,4743,4743,0,92,92,0,0,100,NoArch
326fdcac324198cc75f10949d6c1cc3a5ca410ba,1,12,1,11,13,0,0,0,322,15,1,1,0,8788,25,61,2,1123,1120,3,30190,30136,54,543,542,1,0,100,NoArch
7817d7c7628da463bef11c52edb9b2493bb1c1c3,0,0,0,0,0,0,0,0,0,0,0,0,0,0,0,62,3,0,0,0,0,0,0,0,0,0,1,100,NoArch
da944b261f6dd16770e7fece43d8f95f91a0eaf1,5,125,118,7,243,1,0,1,127,78,1,5,1.524464285,5024,4,700,13,1179,1188,9,30321,30565,244,239,239,0,3,99.85962942,NoArch
60622a1b405ad6e6a3ae0a02abe8e620378ac970,2,69,50,19,119,0,0,0,99,433,1,2,0.612985748,1366,5,701,14,300,300,0,7442,7374,68,123,120,3,1,100,NoArch
e3754daaaa4fe1c754cf87c1fbae36c9adc5a420,1,41,3,38,44,0,0,0,8,57,1,1,0,134,3,702,15,27,18,9,1071,773,298,5,4,1,1,98.48685957,NoArch
551fe746b0afb135ddc1b85cd3c3675c9f1d73f5,1,297,17,280,314,0,0,0,323,2,1,1,0,8799,25,452,24,1123,1123,0,30194,30190,4,543,543,0,0,100,NoArch
2ac9ef99eb3aefe4f0f5eeade1da14fa0e0e8292,1,13,14,1,27,0,0,0,20,233,1,1,0,276,7,249,1,28,28,0,1198,1215,17,20,20,0,1,100,NoArch
ac18ce1544de0f6d22aa47849656a5102064f040,1,23,3,20,26,0,0,0,21,0,1,1,0,275,7,250,2,29,28,1,1219,1198,21,21,20,1,1,100,NoArch
da87655ee34f1dbb4c1e7161c40389035164d4da,0,0,0,0,0,0,0,0,0,0,0,0,0,0,0,703,16,0,0,0,0,0,0,0,0,0,0,100,NoArch
7f0886671db503607f28ac0d229f4619fb5e4481,1,20,4,16,24,0,0,0,22,0,1,1,0,295,7,251,3,31,29,2,1309,1219,90,21,21,0,1,100,NoArch
d577e372b7e46dde3948e137db0e40dcd4e19f9f,1,0,7,7,7,0,0,0,23,0,1,1,0,311,7,252,4,29,31,2,1274,1309,35,21,21,0,1,100,NoArch
c1abbde1a9442664734fe4c60592c7b283a580c4,0,0,0,0,0,0,0,0,0,0,0,0,0,0,0,253,5,0,0,0,0,0,0,0,0,0,0,100,NoArch
cf4f6966b0866790909473e04aac72a4f8a705c0,0,0,0,0,0,0,0,0,0,0,0,0,0,0,0,704,17,0,0,0,0,0,0,0,0,0,0,100,NoArch
53afae3199419998c26038902c48a1d9cf1a7d0b,1,8,7,1,15,0,0,0,92,105,1,1,0,849,14,73,10,121,121,0,3068,3065,3,62,62,0,1,100,NoArch
44bd1a3190e838ce6dfb319b910c9fc15f7889aa,9,183,337,154,520,0,0,0,324,350,1,2,1.377964076,11940,5,74,11,1579,1599,20,44255,44840,585,780,794,14,0,99.59534648,NoArch
17ee95ea4fbd37106e4fd42e8b4df7e95506962c,19,145,244,99,389,0,0,0,128,121,1,5,3.346977953,6384,3,75,11,1395,1409,14,34394,34746,352,369,383,14,0,99.5642143,NoArch
8b73f313c51639b0a2c2538ad3d208efdba0dffe,1,8,27,19,35,0,0,0,24,9,1,1,0,304,7,254,5,28,29,1,1237,1274,37,20,21,1,1,100,NoArch
a928a031b9b3f3400de57bcaba34da6b11b4e89a,3,80,0,80,80,3,0,3,93,6,1,3,0.759840305,1670,1,76,9,276,267,9,8596,8198,398,97,95,2,0,99.94829369,NoArch
0c723fcc3652e79d7f825e0c66ed5741435d7759,1,2,2,0,4,0,0,0,8,367,1,1,0,122,4,25,0,10,10,0,280,280,0,6,6,0,0,100,NoArch
2de9c5a91ffaf4c06ec83e20f9fffa2d8975a1f7,1,1,1,0,2,0,0,0,9,0,1,1,0,122,4,26,1,10,10,0,280,280,0,6,6,0,0,100,NoArch
a67bc5880352c56e08aeb309bf69a4e522a14821,19,2113,68,2045,2181,18,0,18,45,0,1,2,3.941392015,798,1,77,10,483,184,299,12404,4701,7703,254,91,163,0,98.53201721,NoArch
319b27e6397054fe27c7ef35ec8b50d1ff2130a3,0,0,0,0,0,0,0,0,0,0,0,0,0,0,0,84,0,0,0,0,0,0,0,0,0,0,1,100,NoArch
2f0e2ef27666c14134ec0ecc3bd5f4e17f98e45e,0,0,0,0,0,0,0,0,0,0,0,0,0,0,0,89,3,0,0,0,0,0,0,0,0,0,0,100,NoArch
48497020b9ba790936fc65e2643de27de6d17e5e,1,3,0,3,3,1,0,1,2,2,1,1,0,318,1,78,11,38,37,1,872,854,18,28,28,0,0,100,NoArch
306a2582d3de4f742f5f79183983535db1eb9402,1,11,10,1,21,0,0,0,4,52,1,1,0,509,2,79,12,117,117,0,2947,2931,16,33,32,1,1,100,NoArch
ed884ee602612131522dd974b6c8d3cef6db5c15,2,111,15,96,126,1,0,1,11,131,1,1,0.611822858,598,5,453,10,105,86,19,2614,2225,389,63,54,9,1,100,NoArch
a8b6b01943c2283f0f117ec94e7339c70d2e11dc,4,169,0,169,169,4,0,4,10,13,1,2,1.292810559,151,1,80,11,39,21,18,1351,652,699,13,7,6,1,99.82668977,NoArch
a3bcfe29fd9b8f9f31dd362e57f67d0ea2e13129,5,191,167,24,358,1,0,1,3,70,1,2,1.503210734,190,1,454,8,19,18,1,790,736,54,8,7,1,0,99.6541502,NoArch
0e791091e3b93faee3d0ad381fa2d3bf94bf9ff0,1,12,6,6,18,0,0,0,325,17,1,1,0,9079,25,5,0,1125,1123,2,30228,30186,42,543,543,0,1,100,NoArch
4cdad5e7f70df6ce8e7b055d1c7047429e5963cd,0,0,0,0,0,0,0,0,0,0,0,0,0,0,0,81,12,0,0,0,0,0,0,0,0,0,0,100,NoArch
1ae3d95cefe4519f64eb127fe74c3ed71682d3d8,0,0,0,0,0,0,0,0,0,0,0,0,0,0,0,85,1,0,0,0,0,0,0,0,0,0,0,100,NoArch
9d38c724d878f120a123ba6c92709c869e960cfa,0,0,0,0,0,0,0,0,0,0,0,0,0,0,0,86,2,0,0,0,0,0,0,0,0,0,0,100,NoArch
a13fbf30c1420605f65045a99df2e7fcc42ed11f,0,0,0,0,0,0,0,0,0,0,0,0,0,0,0,87,3,0,0,0,0,0,0,0,0,0,0,100,NoArch
c4c71fb015fe185d608bc4fb9547e35d6f20ef22,0,0,0,0,0,0,0,0,0,0,0,0,0,0,0,455,8,0,0,0,0,0,0,0,0,0,0,100,NoArch
e98bd0e95153328084fab88cceadfaefac9be034,0,0,0,0,0,0,0,0,0,0,0,0,0,0,0,456,9,0,0,0,0,0,0,0,0,0,0,100,NoArch
56482a743746607e9e0132ced60b93fd58738880,1,8,13,5,21,0,0,0,5,198,1,1,0,261,3,457,5,54,55,1,1125,1151,26,33,33,0,1,100,NoArch
de4654551fbf85301f41546da34386cf60404079,14,193,191,2,384,1,0,1,129,38,1,7,2.557567309,6513,6,82,13,1447,1437,10,35596,35620,24,354,356,2,1,99.8019802,NoArch
d62b603f9b6245092ba7813549b05168193a9c00,1,71,112,41,183,0,0,0,22,96,1,1,0,334,5,83,14,42,47,5,1294,1519,225,18,19,1,0,99.97519841,NoArch
85ad4df9fd2cbd8ea7ace2eba74ebcb4237ee00c,1,7,7,0,14,0,0,0,3,5,1,1,0,321,2,458,6,38,38,0,872,872,0,28,28,0,0,100,NoArch
8d3d32a77688fe220c9abf96c562ccf00ff80ad0,1,12,0,12,12,1,0,1,326,5,1,1,0,9085,25,459,7,1126,1125,1,30250,30228,22,544,543,1,1,100,NoArch
11a9b9687d22d87df4d9a39ffe065eb012953ecb,1,15,5,10,20,0,0,0,327,1,1,1,0,9097,25,6,1,1128,1126,2,30289,30250,39,544,544,0,1,100,NoArch
2f8dee204e2621927f7a5dade018f2eea5737a34,1,21,13,8,34,0,0,0,22,56,1,1,0,769,6,460,8,215,213,2,4940,4906,34,38,38,0,1,100,NoArch
2550e93ce2c3578c53da27fb542e0cd3c9816f22,12,193,109,84,302,1,0,1,130,9,1,5,2.441113466,5609,2,84,11,1301,1280,21,32020,31550,470,309,304,5,0,99.67508123,NoArch
14048ea41268ed455be541bdaa7c7d9ef700def9,1,21,3,18,24,0,0,0,77,18,1,1,0,826,12,705,7,151,147,4,5242,5174,68,34,33,1,0,100,NoArch
d0d6cbd8f0403d2474181f5eb36ecb190957eb7a,1,12,1,11,13,0,0,0,13,1,1,1,0,242,3,90,2,56,54,2,1206,1132,74,25,25,0,0,100,NoArch
9c3544f3837b86dba6d537728e35db3145ef5f7b,19,50,2098,2048,2148,0,17,17,46,0,1,2,3.947064154,2846,2,255,6,184,484,300,4701,12422,7721,91,254,163,1,98.5335019,NoArch
13ca80c04399928a73b10e7f65d29e7ccac6c9b9,0,0,0,0,0,0,0,0,0,0,0,0,0,0,0,91,2,0,0,0,0,0,0,0,0,0,0,100,NoArch
64dfec1d74fae7cfb217ba5cd7f5a8d8b822f4ee,0,0,0,0,0,0,0,0,0,0,0,0,0,0,0,92,3,0,0,0,0,0,0,0,0,0,1,100,NoArch
506373f58568924acbbd9ea874bb7d3cad1b1a31,0,0,0,0,0,0,0,0,0,0,0,0,0,0,0,93,4,0,0,0,0,0,0,0,0,0,0,100,NoArch
9d15fd89c27e7631359e91193acda4e25df139ea,2,58,35,23,93,0,0,0,14,239,1,1,0.882601331,325,3,461,9,25,25,0,808,782,26,13,13,0,1,100,NoArch
df208cd66510f1f95370105b801f659eef4872c6,1,28,14,14,42,0,0,0,10,509,1,1,0,53,5,462,10,0,0,0,49,49,0,0,0,0,0,100,NoArch
7a0aa398ac412740b610e3d690edcec4af503b37,0,0,0,0,0,0,0,0,0,0,0,0,0,0,0,463,11,0,0,0,0,0,0,0,0,0,1,100,NoArch
c754f4783cda1b064b416ac9cc606bcfda488877,0,0,0,0,0,0,0,0,0,0,0,0,0,0,0,85,12,0,0,0,0,0,0,0,0,0,1,100,NoArch
657f1838d804495a86dc9edc781cce6f79ff7a02,0,0,0,0,0,0,0,0,0,0,0,0,0,0,0,94,5,0,0,0,0,0,0,0,0,0,0,100,NoArch
45056413862161e021aa03cd57c9838ea5138286,1,27,0,27,27,1,0,1,25,103,1,1,0,836,3,32,0,123,119,4,3469,3317,152,55,53,2,0,100,NoArch
889409b4163335c6cb7ac05ed1f31521ed9e9e52,1,11,31,20,42,0,0,0,26,0,1,1,0,863,3,33,1,118,123,5,3292,3469,177,56,55,1,0,100,NoArch
51cf3040c75fa9f246f305bd835d874f1e61d3a8,0,0,0,0,0,0,0,0,0,0,0,0,0,0,0,95,6,0,0,0,0,0,0,0,0,0,1,100,NoArch
50c1fa742a843ab378b1714c753182fc12a7ced0,3,10,6,4,16,1,0,1,24,255,1,2,1.561278124,742,4,464,12,120,119,1,2696,2654,42,47,46,1,0,100,NoArch
519330ec1bdca8a3ae5b183653cfb4d0fc196015,1,22,0,22,22,1,0,1,8,139,1,1,0,154,6,706,3,33,30,3,666,613,53,25,23,2,1,100,NoArch
3d630504502e0e407b54db7ca80a20d9917c5ca3,1,3,6,3,9,0,0,0,78,11,1,1,0,844,12,707,4,150,151,1,5231,5242,11,34,34,0,1,100,NoArch
f519c3050b3b9d1db2af811d53090c9115d58130,1,4,2,2,6,0,0,0,47,9,1,1,0,798,11,708,4,185,184,1,4709,4701,8,91,91,0,1,100,NoArch
d2b9d5043a970be4270f2c70e480d73f6487161d,1,6,1,5,7,0,0,0,8,7,1,1,0,258,3,709,5,26,25,1,717,694,23,13,13,0,1,100,NoArch
54f1ba3f8ac919370b01b654b10133c38f76c7f7,1,11,32,21,43,0,0,0,17,44,1,1,0,624,4,710,6,136,140,4,3758,3945,187,27,27,0,1,100,NoArch
1a757edbaba508cd3b9c1a74f4f84fc2dd1a0c43,1,5,3,2,8,0,0,0,18,0,1,1,0,603,4,711,7,137,136,1,3772,3758,14,27,27,0,1,100,NoArch
4473ae6caa913c41667644dad2beb0c959a930e2,1,44,0,44,44,1,0,1,328,14,1,1,0,9107,25,712,8,1134,1128,6,30479,30289,190,547,544,3,1,100,NoArch
d4a9d6778bdf0d73ed12f1aff0ea58073f8735bf,0,0,0,0,0,0,0,0,0,0,0,0,0,0,0,96,7,0,0,0,0,0,0,0,0,0,1,100,NoArch
3e758add5242dac42280a6a1d27761dec8dbd52e,1,0,1,1,1,0,0,0,2,216,1,1,0,27,2,7,2,1,1,0,174,181,7,1,1,0,0,100,NoArch
7749c66da32834a6b2019db82b8248da829b720c,0,0,0,0,0,0,0,0,0,0,0,0,0,0,0,97,8,0,0,0,0,0,0,0,0,0,0,100,NoArch
4efc74f952353e37f44dcb514ec5fe23a9765faa,0,0,0,0,0,0,0,0,0,0,0,0,0,0,0,98,9,0,0,0,0,0,0,0,0,0,0,100,NoArch
cd05e7d670255a416fcaa468e29b696027432ae4,1,46,24,22,70,0,0,0,12,12,1,1,0,289,2,713,9,77,73,4,1713,1645,68,16,16,0,0,100,NoArch
d085e62dbdbfdce3bace37160506b78102c76cbc,717,311,0,311,311,717,0,717,1,0,1,89,0.344316472,120237,1,1,1,17527,17483,44,499587,498401,1186,8074,8056,18,0,22.18588171,Arch
dc9d6df7761a49ff6f5215537372f1951f353226,717,0,0,0,0,717,0,717,328,536,2,89,0,120548,2,714,9,17527,17527,0,499587,499587,0,8074,8074,0,0,22.59550257,Arch
1a4d13442ace882f26e7df6af01b6c637e1f9618,0,0,0,0,0,0,0,0,0,0,0,0,0,0,0,715,0,0,0,0,0,0,0,0,0,0,0,100,NoArch
1fc5888f69c0d9c058bb319f084631d75ddeda4b,1,19,20,1,39,0,0,0,329,54,1,1,0,9151,25,716,1,1133,1134,1,30441,30479,38,548,547,1,0,100,NoArch
99dddd8f0996537691c001be1852d41e302f8dd4,59,3419,1103,2316,4522,15,0,15,330,165,1,22,4.495025842,33320,1,717,2,6154,5751,403,169449,159014,10435,2086,1958,128,0,94.83681113,Arch
9a6ac48d9f5263376fdf5556cdca76bf6d4e4380,1,18,0,18,18,1,0,1,6,375,1,1,0,191,3,99,0,42,38,4,908,808,100,25,22,3,1,100,NoArch
dcf6745ab8de656a442c7a08de263b90a8e881e2,7,241,123,118,364,2,0,2,331,82,1,5,2.409492289,12657,1,718,0,1857,1848,9,49685,49327,358,720,715,5,0,99.79965655,NoArch
248303930648db15e31fa00eefba0ff3a6cd4704,8,374,133,241,507,0,0,0,332,226,1,7,2.428312114,14448,25,719,1,2285,2258,27,57930,57219,711,856,834,22,0,100,NoArch
d4e1b9d0089403eb44ea08a9e0871946a33aa623,5,153,20,133,173,2,0,2,333,57,1,5,1.43542691,10728,1,720,2,1364,1343,21,37179,36430,749,639,632,7,0,99.94285714,NoArch
6be5e16b149ebb2d981c8e7b66e577bd14518da5,2,20,8,12,28,1,0,1,334,15,1,2,0.222284831,9756,25,721,3,1221,1218,3,32743,32662,81,590,590,0,0,100,NoArch
152a94ec151f4c27139ac459f12860c0df19038d,40,2351,1846,505,4197,2,0,2,335,322,1,13,3.42476452,25414,3,722,4,4216,4147,69,117591,115504,2087,1487,1438,49,0,98.68871152,NoArch
4a815838776de417be138691c1c8df1eb1b73332,13,62,46,16,108,2,0,2,336,389,2,11,3.196010845,15331,6,723,5,2205,2203,2,60021,59948,73,861,861,0,0,100,NoArch
2a686696d7c8e9c57531bfc15abdb8a1accb2cbf,13,110,538,428,648,0,4,4,164,27,1,8,2.55607438,9332,1,724,6,1697,1752,55,49317,52103,2786,459,477,18,0,99.17519909,NoArch
47274ce9d8e2eacf1ebed3028e2c661b6c349774,0,0,0,0,0,0,0,0,0,0,0,0,0,0,0,725,7,0,0,0,0,0,0,0,0,0,0,100,NoArch
3ea40f9854c8e4365873de9ffd6f2eb0086062de,2,31,21,10,52,0,0,0,24,34,1,1,0.664695305,923,3,86,0,272,265,7,4867,4812,55,80,80,0,1,100,NoArch
6f8a1dcbd2fd43cc78b88ef9a81d7f0c9bd91632,2,29,37,8,66,0,0,0,136,8,1,2,0.532835063,3248,2,726,8,778,774,4,18716,18728,12,168,168,0,0,100,NoArch
3e4593efe5cc838b81a4bcceb15834d1cf868477,0,0,0,0,0,0,0,0,0,0,0,0,0,0,0,727,9,0,0,0,0,0,0,0,0,0,0,100,NoArch
c8c8c89cc6f3b5a19d9cdd8d801b826f06cc0f3f,727,0,0,0,0,727,0,727,337,520,2,90,0,123638,3,729,11,18038,18038,0,512156,512156,0,8277,8277,0,0,16.45021645,Arch
4310f42a1750879a35ec8323c554c0fb67bff941,0,0,0,0,0,0,0,0,0,0,0,0,0,0,0,258,2,0,0,0,0,0,0,0,0,0,0,100,NoArch
e2752bb1bc07bbe85222d0505ab620b8d9161c3e,727,0,0,0,0,727,0,727,10,0,1,90,0,123638,1,2,2,18038,18038,0,512156,512156,0,8277,8277,0,0,16.45021645,Arch
77468ae7a2a2eda787cff316afceb1765c39e996,727,51,29,22,80,726,0,726,337,520,2,90,0,123638,3,0,0,18039,18038,1,512253,512156,97,8277,8277,0,1,16.45021645,Arch
be48878933c98c78caa518e44672570d6adfd793,727,0,0,0,0,727,0,727,10,0,1,90,0,123660,1,0,0,18039,18039,0,512253,512253,0,8277,8277,0,1,16.45021645,Arch
833d9a0c5bb2d555af49c75f9973bf05e8cc8fe2,727,0,0,0,0,727,0,727,337,520,2,90,0,123660,3,465,0,18039,18039,0,512253,512253,0,8277,8277,0,1,16.45021645,Arch
2dcd5585c69acedfe52916786a3f4e6a8d54a2b9,727,0,0,0,0,727,0,727,10,0,1,90,0,123660,1,0,0,18039,18039,0,512253,512253,0,8277,8277,0,1,16.45021645,Arch
a2da3edec2fe6f833977fc35985e05223abd75a1,727,86,12,74,98,725,0,725,337,520,2,90,1.357487858,123660,3,1,1,18043,18039,4,512353,512253,100,8278,8277,1,1,16.45021645,Arch
2f934dbb320878936d3427891ec663090e7c044e,727,0,0,0,0,727,0,727,10,0,1,90,0,123734,1,1,1,18043,18043,0,512353,512353,0,8278,8278,0,1,16.45021645,Arch
d9da6d6f109fb814888792b1189386f085acfc0b,727,14,12,2,26,726,0,726,337,520,2,90,0,123734,3,466,1,18044,18043,1,512362,512353,9,8278,8278,0,0,16.45021645,Arch
9fb0c0e820a892e5e6c1b257f8b6403db7403777,727,0,0,0,0,727,0,727,10,0,1,90,0,123736,1,1,1,18044,18044,0,512362,512362,0,8278,8278,0,0,16.45021645,Arch
691c0d045fdd92f6f56db7af64549643e427ea88,727,14,3,11,17,725,0,725,337,520,2,90,0.522559375,123736,3,467,2,18046,18044,2,512412,512362,50,8278,8278,0,0,16.45021645,Arch
208e4557d61b41704fc4229186a261ad1ad6fd5f,727,0,0,0,0,727,0,727,10,0,1,90,0,123747,1,2,2,18046,18046,0,512412,512412,0,8278,8278,0,0,16.45021645,Arch
5fcb35c0fa34d9c3866970c0d6d3192f3fb2dfc3,727,1,1,0,2,726,0,726,337,520,2,90,0,123747,3,468,3,18046,18046,0,512412,512412,0,8278,8278,0,0,16.45021645,Arch
54d1621820f9a58d01e67a4e72d079d7903391b7,727,0,0,0,0,727,0,727,10,0,1,90,0,123747,1,3,3,18046,18046,0,512412,512412,0,8278,8278,0,0,16.45021645,Arch
0c8aa32105b5849b2cbc7e4ab3f09ddc14050464,727,20,8,12,28,726,0,726,337,520,2,90,0,123747,3,469,4,18053,18046,7,512495,512412,83,8279,8278,1,0,16.45021645,Arch
0fa0657b8c439a9dd5e38d6c2f3a3ef211033a5c,727,0,0,0,0,727,0,727,10,0,1,90,0,123759,1,4,4,18053,18053,0,512495,512495,0,8279,8279,0,0,16.45021645,Arch
baf60322f0630261243c90e2addf4d10365905dc,729,391,240,151,631,723,0,723,338,513,3,91,2.087263552,123759,3,470,5,18082,18053,29,513138,512495,643,8292,8279,13,0,16.44547028,Arch
5c4351e554c68eab24f1f74baaab693f7e40a06e,728,0,0,0,0,728,0,728,11,0,1,90,0,123910,1,5,5,18082,18082,0,513138,513138,0,8292,8292,0,0,16.28645683,Arch
ca4a8814a3dcf31537d09c8704da921eb879c881,728,0,0,0,0,728,0,728,338,514,2,90,0,123910,3,100,0,18082,18082,0,513138,513138,0,8292,8292,0,1,16.28645683,Arch
9852223ab74ebc6ad80044a60fefbc1f96fcd0ea,728,0,0,0,0,728,0,728,11,0,1,90,0,123910,1,1,0,18082,18082,0,513138,513138,0,8292,8292,0,1,16.28645683,Arch
cd1b55126df67d8dc1cf73600017dcfb21ebc7cb,728,162,54,108,216,726,0,726,338,514,2,90,0.075841506,123910,3,729,0,18097,18082,15,513477,513138,339,8297,8292,5,0,16.28645683,Arch
1b937315deb9e365b743a4e4d3f02a9ec9067257,728,0,0,0,0,728,0,728,11,0,1,90,0,124018,1,16,0,18097,18097,0,513477,513477,0,8297,8297,0,0,16.28645683,Arch
39c2d84a41866acc891e2094dcbb51caafa1f5c8,728,397,73,324,470,725,0,725,339,514,2,90,0.538259641,124018,3,471,6,18128,18097,31,514191,513477,714,8324,8297,27,0,16.28645683,Arch
1dd3d5897dab4b570a47c6c48ba5c28cc242f3da,728,0,0,0,0,728,0,728,12,0,1,90,0,124342,1,6,6,18128,18128,0,514191,514191,0,8324,8324,0,0,16.28645683,Arch
e1089a63cacc11a99343875d4bba07e7f2628066,728,12,2,10,14,727,0,727,340,514,2,90,0,124342,3,472,7,18130,18128,2,514257,514191,66,8325,8324,1,0,16.28645683,Arch
e00b2c5a619c1b49897362540713e3b78b16e0a3,728,0,0,0,0,728,0,728,13,0,1,90,0,124352,1,7,7,18130,18130,0,514257,514257,0,8325,8325,0,0,16.28645683,Arch
c13a0b9400b671327875b2f66a743553f61645db,728,36,18,18,54,725,0,725,341,512,2,90,0.684136326,124352,3,473,8,18130,18130,0,514271,514257,14,8325,8325,0,0,16.28645683,Arch
e1f0dfb07bd366f5a6a962b2369d842c7fd4a621,728,0,0,0,0,728,0,728,14,0,1,90,0,124370,1,8,8,18130,18130,0,514271,514271,0,8325,8325,0,0,16.28645683,Arch
77588887baa8510a93571f2111504025187a2b94,728,0,0,0,0,728,0,728,341,512,2,90,0,124370,3,101,1,18130,18130,0,514271,514271,0,8325,8325,0,1,16.28645683,Arch
6c31ef0e2594e861a5a97993636c5fd49d88d7f5,728,0,0,0,0,728,0,728,14,0,1,90,0,124370,1,2,1,18130,18130,0,514271,514271,0,8325,8325,0,1,16.28645683,Arch
07060149ffa531c80d5225f835f29959f266fbfe,728,0,0,0,0,728,0,728,341,512,2,90,0,124370,3,474,9,18130,18130,0,514271,514271,0,8325,8325,0,0,16.28645683,Arch
8d2539b47982d7f2c711afaf3faf9f82cadd9adc,728,0,0,0,0,728,0,728,14,0,1,90,0,124370,1,9,9,18130,18130,0,514271,514271,0,8325,8325,0,0,16.28645683,Arch
39f5a1d3c5cd8ad09e0e4d1ed07a937a7f766493,728,0,0,0,0,728,0,728,341,512,2,90,0,124370,3,475,10,18130,18130,0,514271,514271,0,8325,8325,0,0,16.28645683,Arch
99983240e71c2b844944a8a8bb5bc22804bc6089,728,0,0,0,0,728,0,728,14,0,1,90,0,124370,1,10,10,18130,18130,0,514271,514271,0,8325,8325,0,0,16.28645683,Arch
fe434379e1d95c4d38bfc1b2c1f836b6241bb14f,728,2,0,2,2,728,0,728,341,512,2,90,0,124370,3,476,5,18130,18130,0,514271,514271,0,8325,8325,0,0,16.28645683,Arch
2d5ab513108bb5e41761753ab23189c12630bae3,728,0,0,0,0,728,0,728,14,0,1,90,0,124372,1,11,5,18130,18130,0,514271,514271,0,8325,8325,0,0,16.28645683,Arch
30343977a21bd07730ece1d393fe9bbdcc904e05,728,6,0,6,6,728,0,728,341,512,2,90,0,124372,3,477,6,18131,18130,1,514314,514271,43,8325,8325,0,0,16.28645683,Arch
cb0c1ad8d631ccf02ca94019978bebfb54bb3a8b,728,0,0,0,0,728,0,728,14,0,1,90,0,124378,1,12,6,18131,18131,0,514314,514314,0,8325,8325,0,0,16.28645683,Arch
c51cce49e9d3f258d7eaf59a37698a68d4b25de3,728,0,0,0,0,728,0,728,341,512,2,90,0,124378,3,478,7,18131,18131,0,514314,514314,0,8325,8325,0,0,16.28645683,Arch
b2c23c8d7bd58d9c675a12b615d0a84a21f0823b,728,0,0,0,0,728,0,728,14,0,1,90,0,124378,1,13,7,18131,18131,0,514314,514314,0,8325,8325,0,0,16.28645683,Arch
ec28cc5f21f9353b4379f4c46c3e8045adbfaa6b,728,13,7,6,20,727,0,727,341,512,2,90,0,124378,3,730,0,18133,18131,2,514349,514314,35,8325,8325,0,1,16.28645683,Arch
e302f5cae8a5a44464021e677d897fb5067b40f6,728,0,0,0,0,728,0,728,14,0,1,90,0,124384,1,17,0,18133,18133,0,514349,514349,0,8325,8325,0,1,16.28645683,Arch
658fb6b43b58bf7ef16068eb7773c68f8c0350cb,728,11,2,9,13,727,0,727,341,512,2,90,0,124384,3,731,1,18140,18133,7,514413,514349,64,8325,8325,0,1,15.94202899,Arch
bb5cfcdab2d221593def3294c55ba37ba72c53b7,728,0,0,0,0,728,0,728,14,0,1,90,0,124393,1,18,1,18140,18140,0,514413,514413,0,8325,8325,0,1,15.94202899,Arch
c3a8679f5d8196e486f6ffdb33171bbe2cce7416,728,5,5,0,10,727,0,727,341,512,2,90,0,124393,3,732,2,18140,18140,0,514417,514413,4,8325,8325,0,0,15.94202899,Arch
cd090f23430a6a7e926461edabad87a1b9b53f3f,728,0,0,0,0,728,0,728,14,0,1,90,0,124393,1,19,2,18140,18140,0,514417,514417,0,8325,8325,0,0,15.94202899,Arch
4c04ee720ab4800bf3b205863b344b1b3d2ee840,728,1,0,1,1,728,0,728,341,512,2,90,0,124393,3,479,3,18140,18140,0,514426,514417,9,8325,8325,0,0,15.94202899,Arch
99296677951aa9a06b3dcc6ac9fac01905acabd4,728,0,0,0,0,728,0,728,14,0,1,90,0,124394,1,14,3,18140,18140,0,514426,514426,0,8325,8325,0,0,15.94202899,Arch
1d01a7e5c57c47a4023e6fc86052fec3e32faba0,729,233,180,53,413,725,0,725,341,511,3,91,1.674654132,124394,3,480,4,18150,18140,10,514292,514426,134,8329,8325,4,0,15.32656023,Arch
af79ba24db44ad014c70f07c247856d60c638b1e,728,0,0,0,0,728,0,728,14,0,1,90,0,124448,2,15,4,18150,18150,0,514292,514292,0,8329,8329,0,0,15.7712305,Arch
e07e58531186253fd49a4c73a0f781b9aac90124,728,6,2,4,8,726,0,726,341,512,2,90,0.811278124,124448,3,481,5,18151,18150,1,514333,514292,41,8330,8329,1,0,15.7712305,Arch
b167e91704a2520743013a768874043ed52f9035,728,0,0,0,0,728,0,728,14,0,1,90,0,124452,2,16,5,18151,18151,0,514333,514333,0,8330,8330,0,0,15.7712305,Arch
289b64b762abacda3f7f74632c49fed29b5dcec1,728,78,3,75,81,727,0,727,342,512,2,90,0,124452,3,482,6,18157,18151,6,514479,514333,146,8336,8330,6,0,15.7712305,Arch
d140e8a1feecb26782f097ffd1741f36d48ea01c,728,0,0,0,0,728,0,728,15,0,1,90,0,124527,2,17,6,18157,18157,0,514479,514479,0,8336,8336,0,0,15.7712305,Arch
22cabbefc4807885fd5aeb83273e45f7b7c1f285,728,22,0,22,22,728,0,728,343,512,2,90,0,124527,3,483,7,18159,18157,2,514523,514479,44,8338,8336,2,0,15.7712305,Arch
26b450065d6b222e540b0f44c32b9516286b9ba4,728,0,0,0,0,728,0,728,16,0,1,90,0,124549,2,18,7,18159,18159,0,514523,514523,0,8338,8338,0,0,15.7712305,Arch
4a9ca0349926d8f85c50ef7b651292f0051497d8,728,14,0,14,14,728,0,728,344,512,2,90,0,124549,3,484,8,18160,18159,1,514560,514523,37,8339,8338,1,0,15.7712305,Arch
5c28ef8371b4d7141e6e56b467daac93e737a7b9,728,0,0,0,0,728,0,728,17,0,1,90,0,124563,2,19,8,18160,18160,0,514560,514560,0,8339,8339,0,0,15.7712305,Arch
1ee6d5197976b6328064369cc17038fbd1bc8557,728,32,12,20,44,727,0,727,344,512,2,90,0,124563,3,485,9,18164,18160,4,514681,514560,121,8339,8339,0,0,15.7712305,Arch
41cb990497d9c32ec0a4a35dc9a90bbc641b8be2,728,0,0,0,0,728,0,728,17,0,1,90,0,124583,2,20,9,18164,18164,0,514681,514681,0,8339,8339,0,0,15.7712305,Arch
98c86d3840392951bca05d398d561f6fa06f4a0e,728,35,0,35,35,728,0,728,345,512,2,90,0,124583,3,486,10,18167,18164,3,514771,514681,90,8342,8339,3,0,15.7712305,Arch
577aff318325222f15edb42a128c41865ac94a7e,728,0,0,0,0,728,0,728,18,0,1,90,0,124618,2,21,10,18167,18167,0,514771,514771,0,8342,8342,0,0,15.7712305,Arch
0d7ce2b9f8dbeadfaffa72d78d3a03c81820c04f,728,71,37,34,108,727,0,727,345,512,2,90,0.346268574,124618,3,487,11,18176,18167,9,514966,514771,195,8345,8342,3,0,15.7712305,Arch
4963920149ab4f423da2583d0ace4f3ce1b087f9,728,0,0,0,0,728,0,728,18,0,1,90,0,124652,2,22,11,18176,18176,0,514966,514966,0,8345,8345,0,0,15.7712305,Arch
6ac6f4d7aa7df34cc243c94b70701457fa7ccf1d,728,94,6,88,100,726,0,726,346,512,2,90,0.841464636,124652,3,488,12,18186,18176,10,515440,514966,474,8348,8345,3,0,15.7712305,Arch
74003473c4770c90060d672d67b912762a920816,728,0,0,0,0,728,0,728,19,0,1,90,0,124740,2,23,12,18186,18186,0,515440,515440,0,8348,8348,0,0,15.7712305,Arch
f7d80a798ba19ece75ebc798017045f4658a6fee,728,0,17,17,17,725,0,725,346,512,2,90,1.383099991,124740,3,91,0,18181,18186,5,515284,515440,156,8348,8348,0,0,15.7712305,Arch
a0f734c9e75fb02e4f45e88202c934f2f1e3b00b,728,0,0,0,0,728,0,728,19,0,1,90,0,124723,2,5,0,18181,18181,0,515284,515284,0,8348,8348,0,0,15.7712305,Arch
8eff111997db9a796f0342a920c9b22a7e3fbb4c,728,128,8,120,136,727,0,727,346,512,2,90,0,124723,3,733,3,18201,18181,20,515621,515284,337,8353,8348,5,0,15.7712305,Arch
09b1e15724d34c896b6ae992c4db809ff77f3e3a,728,0,0,0,0,728,0,728,19,0,1,90,0,124843,2,20,3,18201,18201,0,515621,515621,0,8353,8353,0,0,15.7712305,Arch
f4096206302fb680c9fc7054381ff90732afaadb,728,4,1,3,5,727,0,727,346,512,2,90,0,124843,3,92,1,18202,18201,1,515650,515621,29,8353,8353,0,1,15.7712305,Arch
f16019be4080fa9ede19665603e7bbd530598fdf,728,0,0,0,0,728,0,728,19,0,1,90,0,124846,2,6,1,18202,18202,0,515650,515650,0,8353,8353,0,1,15.7712305,Arch
8a53abc98bf1239a2b585d0761e90b5e145072e2,728,0,0,0,0,728,0,728,346,512,2,90,0,124846,3,2,0,18202,18202,0,515650,515650,0,8353,8353,0,0,15.7712305,Arch
716777e41df43f91b3a7c882180e74b91ade37ca,728,0,0,0,0,728,0,728,19,0,1,90,0,124846,2,2,0,18202,18202,0,515650,515650,0,8353,8353,0,0,15.7712305,Arch
a760316c17b1da3ed8a98845fad541af639085de,728,60,6,54,66,725,0,725,347,513,2,90,1.616606401,124846,3,489,13,18209,18202,7,515860,515650,210,8359,8353,6,0,15.7712305,Arch
90bf34b538ddf469f0e0ba7f47d59d0f79a6f275,728,0,0,0,0,728,0,728,20,0,1,90,0,124900,2,24,13,18209,18209,0,515860,515860,0,8359,8359,0,0,15.7712305,Arch
043acd4d6aa62fb0cedf0f08a8a5d668ca69a508,728,0,0,0,0,728,0,728,347,513,2,90,0,124900,3,490,14,18209,18209,0,515860,515860,0,8359,8359,0,0,15.7712305,Arch
f93d8dd9af6d147400920b19cd87ae544c6e1dd8,728,0,0,0,0,728,0,728,20,0,1,90,0,124900,2,25,14,18209,18209,0,515860,515860,0,8359,8359,0,0,15.7712305,Arch
3bf92402ee1c45476ce2a51126657f49118a5dc8,728,166,32,134,198,721,0,721,347,520,2,90,2.858866274,124900,3,144,0,18234,18209,25,516552,515860,692,8367,8359,8,0,16.07142857,Arch
9462df288d48d473be3497e46438d0b1404760b2,728,0,0,0,0,728,0,728,20,0,1,90,0,125034,3,0,0,18234,18234,0,516552,516552,0,8367,8367,0,0,15.91236668,Arch
11422a4e76db481d1f673c73d3ce2d698661847d,728,1,1,0,2,727,0,727,347,520,2,90,0,125034,3,3,1,18235,18234,1,516560,516552,8,8367,8367,0,1,15.91236668,Arch
41f3e11188acc791725bc9523ad7b060a71e724d,728,0,0,0,0,728,0,728,20,0,1,90,0,125034,3,3,1,18235,18235,0,516560,516560,0,8367,8367,0,1,15.91236668,Arch
e310a933c23f0806a4999d167881ecf1f0bbd27c,728,8,0,8,8,728,0,728,347,520,2,90,0,125034,3,145,1,18236,18235,1,516624,516560,64,8368,8367,1,0,15.91236668,Arch
f5147bbe850d15d5bbf8310f8b2fb6509415a3da,728,0,0,0,0,728,0,728,20,0,1,90,0,125042,3,1,1,18236,18236,0,516624,516624,0,8368,8368,0,0,15.91236668,Arch
5ea6dbbc563502d3cef9f869ebc0276b9dac0c1b,728,0,0,0,0,728,0,728,347,520,2,90,0,125042,3,491,12,18236,18236,0,516624,516624,0,8368,8368,0,0,15.91236668,Arch
c02056ff5a6f719e1d54d22ddbdc1ce53f1ef936,728,0,0,0,0,728,0,728,20,0,1,90,0,125042,3,26,12,18236,18236,0,516624,516624,0,8368,8368,0,0,15.91236668,Arch
fc17279c2b79666de5d10cd49bbececa5b20cd35,728,0,0,0,0,728,0,728,347,520,2,90,0,125042,3,492,13,18236,18236,0,516624,516624,0,8368,8368,0,0,15.91236668,Arch
d3ca21a2531f8490df4f0aa30323ab52cbd96d6d,728,0,0,0,0,728,0,728,20,0,1,90,0,125042,3,27,13,18236,18236,0,516624,516624,0,8368,8368,0,0,15.91236668,Arch
7fe2eed0da0895d704b0da56cad69f8f7a733b7b,728,5,1,4,6,727,0,727,347,520,2,90,0,125042,3,734,1,18237,18236,1,516640,516624,16,8368,8368,0,1,15.91236668,Arch
e44e221216e4eaec5993453adeb0d14b782aa376,728,0,0,0,0,728,0,728,20,0,1,90,0,125046,3,21,1,18237,18237,0,516640,516640,0,8368,8368,0,1,15.91236668,Arch
67e0a6ef2eeba3d602562feba8dd8aa102716d86,728,32,1,31,33,727,0,727,347,520,2,90,1.481863125,125046,3,493,14,18242,18237,5,516829,516640,189,8368,8368,0,0,15.91236668,Arch
9d71c7e198783f49491676bf55626777de1f0d30,728,0,0,0,0,728,0,728,20,0,1,90,0,125077,3,28,14,18242,18242,0,516829,516829,0,8368,8368,0,0,15.91236668,Arch
32dce4a972fedb4d74c0a10613088ac21d77fb68,728,23,20,3,43,727,0,727,347,520,2,90,0,125077,3,494,3,18243,18242,1,516837,516829,8,8368,8368,0,0,15.91236668,Arch
705d33a16a340d99241fde2ee32e870024ba00f2,728,0,0,0,0,728,0,728,20,0,1,90,0,125080,3,29,3,18243,18243,0,516837,516837,0,8368,8368,0,0,15.91236668,Arch
06c0a382210f2ceedc631e6deae469a619fef34a,728,0,0,0,0,728,0,728,347,520,2,90,0,125080,3,495,4,18243,18243,0,516837,516837,0,8368,8368,0,0,15.91236668,Arch
a1aabe1090d0f6371430472aaed24ca3bb318d86,728,0,0,0,0,728,0,728,20,0,1,90,0,125080,3,30,4,18243,18243,0,516837,516837,0,8368,8368,0,0,15.91236668,Arch
57ca72077e6f03eb03b4f0ab18b20f1ea066c51d,728,36,14,22,50,725,0,725,347,520,2,90,1.360964047,125080,3,496,5,18246,18243,3,516902,516837,65,8370,8368,2,0,15.91236668,Arch
0576d4675a40b0a65d27da08f49b36afe6efabc8,728,0,0,0,0,728,0,728,20,0,1,90,0,125102,3,31,5,18246,18246,0,516902,516902,0,8370,8370,0,0,15.91236668,Arch
f1ff6a75296d9fdd68e67063a9835e1977b9ee0b,728,0,0,0,0,728,0,728,347,520,2,90,0,125102,3,497,6,18246,18246,0,516902,516902,0,8370,8370,0,0,15.91236668,Arch
fc8acf4bf2d8fc9b97e1eb9e26b43b51d41bb7e5,728,0,0,0,0,728,0,728,20,0,1,90,0,125102,3,32,6,18246,18246,0,516902,516902,0,8370,8370,0,0,15.91236668,Arch
d9e9a8c97c7d3ddf5b1c20c37d64e7f597780121,728,11,1,10,12,727,0,727,347,520,2,90,0,125102,3,498,7,18247,18246,1,516912,516902,10,8371,8370,1,0,15.91236668,Arch
4f432b69a924b4a4d165e3ba82d2c8ddc69f8cd2,728,0,0,0,0,728,0,728,20,0,1,90,0,125112,3,33,7,18247,18247,0,516912,516912,0,8371,8371,0,0,15.91236668,Arch
a0bb8c9dcff794a008e8b7c948fba70aa43ddf53,728,10,19,9,29,726,0,726,347,520,2,90,0.362051252,125112,3,499,8,18246,18247,1,516826,516912,86,8371,8371,0,0,15.91236668,Arch
2542e81350912b3415b2423fcb4f34f8bcc5e92f,728,0,0,0,0,728,0,728,20,0,1,90,0,125103,3,34,8,18246,18246,0,516826,516826,0,8371,8371,0,0,15.91236668,Arch
701c5ff98490945ba06d915c03af021431e59d0b,728,13,10,3,23,726,0,726,347,520,2,90,0.987692509,125103,3,735,1,18248,18246,2,516851,516826,25,8372,8371,1,1,15.91236668,Arch
bbce10eb34199397409b6dea6268f8c13545295d,728,0,0,0,0,728,0,728,20,0,1,90,0,125106,3,22,1,18248,18248,0,516851,516851,0,8372,8372,0,1,15.91236668,Arch
d34bf50bfbd84d3886b3720156bef6c94a779772,728,12,2,10,14,727,0,727,347,520,2,90,0,125106,3,736,2,18249,18248,1,516864,516851,13,8372,8372,0,1,15.91236668,Arch
d04239e1d64833d8d00f928caa1d11f52e6b5441,728,0,0,0,0,728,0,728,20,0,1,90,0,125116,3,23,2,18249,18249,0,516864,516864,0,8372,8372,0,1,15.91236668,Arch
17dc687e63c556d3c860aa5455f9bfafaacf767e,728,17,3,14,20,727,0,727,347,520,2,90,0,125116,3,737,3,18252,18249,3,516913,516864,49,8373,8372,1,1,15.91236668,Arch
d6d5248508a1e21fa98d64f64062a4e50142dfa6,728,0,0,0,0,728,0,728,20,0,1,90,0,125130,3,24,3,18252,18252,0,516913,516913,0,8373,8373,0,1,15.91236668,Arch
dd84b92480f20131a933dcfa8248485498df41d7,728,2,1,1,3,727,0,727,347,520,2,90,0,125130,3,738,4,18252,18252,0,516921,516913,8,8373,8373,0,1,15.91236668,Arch
dcb94d5727f9a9f393144ee78daa83d28489ce8a,728,0,0,0,0,728,0,728,20,0,1,90,0,125131,3,25,4,18252,18252,0,516921,516921,0,8373,8373,0,1,15.91236668,Arch
29f8fdfcd890a246abd59cbf82d39e8893116997,728,13,15,2,28,727,0,727,347,520,2,90,0,125131,3,739,5,18252,18252,0,516935,516921,14,8373,8373,0,0,15.91236668,Arch
7b9a5ea4ab32ed00ca8b5ba23371ce47a3258c48,728,0,0,0,0,728,0,728,20,0,1,90,0,125129,3,26,5,18252,18252,0,516935,516935,0,8373,8373,0,0,15.91236668,Arch
2fb64dc3d79affb0cbc9aebbffec1030fd833ab5,728,0,0,0,0,728,0,728,347,520,2,90,0,125129,3,740,6,18252,18252,0,516935,516935,0,8373,8373,0,0,15.91236668,Arch
3f54ad06dfd1e5bc4372ebb2833103babd6c0978,0,0,0,0,0,0,0,0,0,0,0,0,0,0,0,741,7,0,0,0,0,0,0,0,0,0,0,100,NoArch
2368f6a50e0cf146a4f575e441e8b963b0243a65,728,0,0,0,0,728,0,728,20,0,1,90,0,125129,3,35,7,18252,18252,0,516935,516935,0,8373,8373,0,0,15.91236668,Arch
5012b65a8d29061bb9636a2078df9a2297720b7a,2,69,32,37,101,0,0,0,21,57,1,2,0.140327271,10658,3,36,8,1335,1328,7,36537,36388,149,650,645,5,0,100,NoArch
d975e9baf536f690aa022fcfaccaccac394952ad,2,7,1,6,8,1,0,1,3,191,1,2,0.543564443,1292,2,37,8,231,229,2,5962,5923,39,101,101,0,0,100,NoArch
dd57fef2eac262e9d88cfa5db3bb815beec032fb,3,14,12,2,26,0,0,0,3,206,1,1,1.072737286,1044,2,38,9,78,78,0,2731,2729,2,18,18,0,0,100,NoArch
117d316207e156a6def70c759878ec7d0b08be27,1,107,24,83,131,0,0,0,22,5,1,1,0,10220,3,39,10,1243,1236,7,33626,33414,212,623,617,6,0,100,NoArch
5b13367311821bc21017f178b164b73a9f1e4f5b,1,12,25,13,37,0,0,0,23,0,1,1,0,10303,3,40,11,1242,1243,1,33605,33626,21,622,623,1,0,100,NoArch
2680156632a5f8a36e66c7ad4cf16179314b5bd4,0,0,0,0,0,0,0,0,0,0,0,0,0,0,0,41,12,0,0,0,0,0,0,0,0,0,0,100,NoArch
3e033ba09d15fdd90d76cf99e06eaa4b0b9ef756,1,36,34,2,70,0,0,0,24,0,1,1,0,10290,3,42,13,1241,1242,1,33608,33605,3,621,622,1,0,100,NoArch
fd0b5f3581d36b3161a034a085a9295db49956dc,1,3,13,10,16,0,0,0,25,0,1,1,0,10292,3,43,14,1240,1241,1,33584,33608,24,620,621,1,0,100,NoArch
8f649e5e022c48294c534e39d398ca2d5e10ca8b,0,0,0,0,0,0,0,0,0,0,0,0,0,0,0,262,0,0,0,0,0,0,0,0,0,0,0,100,NoArch
1db3b158f7d416ee171c558213b616a6f0be50d5,728,0,0,0,0,728,0,728,352,520,2,90,0,125235,3,259,0,18265,18265,0,517295,517295,0,8381,8381,0,0,15.91236668,Arch
c635bba9e8ba36010b1d68a32976ab8eeb9071ef,1,88,5,83,93,0,0,0,353,2,1,1,0,10282,25,509,15,1246,1240,6,33788,33584,204,626,620,6,0,100,NoArch
121376aec9e40b2dab09f411da90d66381e827ef,1,15,2,13,17,0,0,0,354,0,1,1,0,10365,25,510,16,1247,1246,1,33816,33788,28,627,626,1,0,100,NoArch
321b5432b6692858227d381af92497f9a05b24d2,0,0,0,0,0,0,0,0,0,0,0,0,0,0,0,511,17,0,0,0,0,0,0,0,0,0,0,100,NoArch
05ad613eca45ec3748886116c1559d9f99fa2eaf,2,14,9,5,23,1,0,1,141,163,1,1,0.666578358,2945,10,512,18,702,700,2,16790,16754,36,154,153,1,0,100,NoArch
2775d20fecb7d713dcec663f29bc5218c5f2a4f0,1,4,0,4,4,1,0,1,24,248,1,1,0,350,10,513,19,39,38,1,1343,1307,36,17,17,0,0,100,NoArch
2d02d6b1a15e75898b7c2f537b034121db8d6a9b,0,0,0,0,0,0,0,0,0,0,0,0,0,0,0,514,20,0,0,0,0,0,0,0,0,0,0,100,NoArch
aa5a10a23ee0a8161cc49bdabe904da6e3fad7ab,0,0,0,0,0,0,0,0,0,0,0,0,0,0,0,102,0,0,0,0,0,0,0,0,0,0,0,100,NoArch
91e988187c8b192f735eb84347d0734951b0cdb4,0,0,0,0,0,0,0,0,0,0,0,0,0,0,0,103,1,0,0,0,0,0,0,0,0,0,0,100,NoArch
50532e20ac047ef3ff0de7a8fa2b985f3cec65ad,11,148,7,141,155,8,0,8,107,411,1,5,2.455011038,3487,1,0,0,661,644,17,18069,17232,837,233,216,17,1,97.91220557,Arch
4549775a634c66d411e5b2511b5616b0c6f46c2e,11,7,148,141,155,0,2,2,108,0,1,5,2.455011038,3628,1,1,1,644,661,17,17232,18069,837,216,233,17,0,97.91220557,Arch
f363378d414f9cfd5370361e0c32bd6cd7f452c9,6,97,36,61,133,1,0,1,27,527,1,5,1.788846943,558,5,515,21,58,26,32,2653,1472,1181,54,24,30,0,99.82910852,NoArch
e7d2ecb6e7173e641a674c9534e305b7f421c55f,3,136,99,37,235,0,0,0,355,90,1,2,1.145596953,10452,2,516,22,1260,1251,9,34283,34096,187,635,630,5,0,100,NoArch
321d5bf1ed4f6410cb419ba043abf809ec3a7474,3,36,27,9,63,1,0,1,356,56,1,2,0.956009077,11292,6,517,23,1492,1489,3,39457,39400,57,676,675,1,0,100,NoArch
42efe37c37c8b17e8d39bab5699ae3d8217cc6cf,0,0,0,0,0,0,0,0,0,0,0,0,0,0,0,518,22,0,0,0,0,0,0,0,0,0,0,100,NoArch
a92e4913cd814707b542b27d7676fb6af633b418,2,84,84,0,168,0,0,0,20,205,1,2,0.16232618,936,4,519,23,144,144,0,3918,3918,0,54,54,0,0,100,NoArch
baf45ddc02a6dbc0128e80c5e8dc7a8c1945990f,2,48,19,29,67,0,0,0,10,474,1,2,0.980467931,269,6,104,2,36,30,6,1576,1277,299,8,8,0,1,100,NoArch
cb38923f27c7722afbb50df85542d3052e050586,1,7,0,7,7,1,0,1,1,0,1,1,0,0,1,105,3,1,0,1,24,0,24,1,0,1,0,99.94311718,NoArch
1b5d4a7863ebf5858b9221e4634073c3fb217636,3,41,27,14,68,1,0,1,357,3,1,2,1.244031312,11301,6,520,22,1494,1492,2,39496,39457,39,677,676,1,0,100,NoArch
fbe0a3e072ed65c5af348f35ca0d887055a68719,0,0,0,0,0,0,0,0,0,0,0,0,0,0,0,521,23,0,0,0,0,0,0,0,0,0,0,100,NoArch
35308ac5e102eaee7d9ec0023eedac7b30fc266e,1,1,0,1,1,1,0,1,142,16,1,1,0,2715,9,740,5,660,659,1,15646,15637,9,133,133,0,1,100,NoArch
ce9ec84e2d05433f734a54a31ba198c2a5f1d821,4,48,4,44,52,1,0,1,143,14,1,3,1.409390755,4356,1,741,6,1019,1015,4,25030,24855,175,281,279,2,1,99.88639591,NoArch
5452b2bc482d843fd47d380780256637402b0801,1,6,3,3,9,0,0,0,8,883,1,1,0,54,5,742,7,7,6,1,160,137,23,6,6,0,1,100,NoArch
e48099002a4fdd0dff5b5fc1cdc18669d8396bf7,11,148,7,141,155,8,0,8,109,0,1,5,2.455011038,3487,1,2,2,661,644,17,18069,17232,837,233,216,17,1,97.89445629,Arch
f1e8a7455e4fddcecaffbdde619e4956f8b03e6b,4,477,0,477,477,4,0,4,11,0,1,2,0.996238139,93,1,3,3,70,1,69,3167,804,2363,55,1,54,1,97.33263598,Arch
250db54a2f09007f6966a69fa5d5274b9203f139,3,76,0,76,76,3,0,3,19,231,1,3,0.276122345,258,1,4,4,30,23,7,1686,1342,344,28,22,6,1,99.94550409,NoArch
c0b89ced895daad111a4b878c0aa0ff34ef7cf41,0,0,0,0,0,0,0,0,0,0,0,0,0,0,0,5,5,0,0,0,0,0,0,0,0,0,1,100,NoArch
0bba047f9607249bdc9f661d2d93657875d64a6f,2,309,303,6,612,0,0,0,72,182,1,1,0.056832405,1397,3,6,6,334,334,0,8216,8183,33,69,69,0,1,100,NoArch
df3ddfa11f90776c4ef2f3b80f53f3c0740d8eea,0,0,0,0,0,0,0,0,0,0,0,0,0,0,0,522,24,0,0,0,0,0,0,0,0,0,0,100,NoArch
bbd054f58509afdfcab651677f9c3f13cdaffe77,3,60,11,49,71,1,0,1,358,90,1,3,1.432183378,10506,25,523,25,1266,1261,5,34525,34368,157,641,637,4,0,99.89115646,NoArch
d1eb9c6574bc4cd8f36224b19b68b9dc61433d76,2,42,1,41,43,1,0,1,14,467,1,1,0.782444129,382,3,524,24,83,77,6,2097,1926,171,28,26,2,0,99.48285248,NoArch
2f5c15e4ccc30b7d68d8d0446e9a2527a98873cb,1,2,2,0,4,0,0,0,359,2,1,1,0,10317,26,4,0,1233,1233,0,33536,33536,0,625,625,0,0,100,NoArch
056983cfc4790954e23b714ef79943a2fdbe9e27,0,0,0,0,0,0,0,0,0,0,0,0,0,0,0,106,4,0,0,0,0,0,0,0,0,0,1,100,NoArch
19cea13bfcfd543a48c1d5af2240a7f55ddfc951,5,246,93,153,339,1,0,1,104,253,1,4,1.897870813,2122,1,743,4,429,395,34,12606,11415,1191,152,140,12,1,97.57669502,Arch
d0b10dec5d64555f24dce638afee16ac1ad8d4f7,1,3,2,1,5,0,0,0,168,251,1,1,0,3791,13,525,25,611,610,1,20869,20865,4,156,156,0,0,100,NoArch
2cecf9ed2a5c71d7bbf382f7e7c1cb4e8df8d0fc,1,14,13,1,27,0,0,0,23,78,1,1,0,618,4,744,4,139,139,0,3859,3859,0,27,27,0,0,100,NoArch
3d441645f00f746244a577fb283d8c3a862d278e,0,0,0,0,0,0,0,0,0,0,0,0,0,0,0,526,26,0,0,0,0,0,0,0,0,0,0,100,NoArch
65eda87c52097eab6f87fbb578ec10e67c7f31d8,0,0,0,0,0,0,0,0,0,0,0,0,0,0,0,745,5,0,0,0,0,0,0,0,0,0,0,100,NoArch
428957724c35b05269c4fd1cce857bb6bb746ac6,0,0,0,0,0,0,0,0,0,0,0,0,0,0,0,746,6,0,0,0,0,0,0,0,0,0,0,100,NoArch
9b65c7c6a46329e6f573fe317a7a9a2a5ba6ea58,0,0,0,0,0,0,0,0,0,0,0,0,0,0,0,747,7,0,0,0,0,0,0,0,0,0,0,100,NoArch
4d0a86669a7b6a7b5235e1c84b39e3faad5821b3,320,29599,7260,22339,36859,156,12,168,441,166,1,60,6.877734248,62224,1,789,6,15038,10218,4820,581542,279163,302379,6765,3957,2808,0,89.18451222,Arch
e5bd8e80355857e5618869d704e4ea7617c29803,2,126,18,108,144,1,0,1,2,16,1,1,0.183122068,115,1,238,16,29,15,14,617,385,232,10,6,4,0,100,NoArch
058a66a2ee827789a017feaa67ea6b50df8a09b0,3,38,38,0,76,1,0,1,442,313,1,3,0.584401517,11684,28,863,2,1386,1386,0,37405,37419,14,704,704,0,0,100,NoArch
7ec61ba57e365396257ed0b251f1f0b6da2cf212,320,7278,29710,22432,36988,18,138,156,377,136,1,60,6.880874412,84673,1,578,1,10222,15052,4830,279240,581783,302543,3957,6769,2812,0,89.18451222,Arch
8aef7afadaed6d812653d49743e82513fcbe7d41,320,29697,7260,22437,36957,156,13,169,442,166,1,60,6.880102192,62241,1,864,3,15053,10222,4831,581807,279240,302567,6769,3957,2812,0,89.18451222,Arch
25254d0c9755e349ddd095d7007e624838abcdd2,320,7196,29628,22432,36824,18,140,158,377,138,1,60,6.871310301,84678,1,579,2,10223,15053,4830,279264,581807,302543,3957,6769,2812,0,89.18451222,Arch
da398634003abac9faa4151cc2f43618aae1d04b,320,29601,7170,22431,36771,156,13,169,442,167,1,60,6.870405227,62246,1,865,4,15053,10223,4830,581792,279264,302528,6769,3957,2812,0,89.18451222,Arch
73c5e0d7e2a90b3bccc04a0b3883f586dcdb4bef,321,7389,29661,22272,37050,18,140,158,377,138,1,60,6.883231484,85219,1,38,0,10316,15118,4802,282275,583958,301683,3993,6798,2805,3,89.18451222,Arch
30c93f8a6a8992a7f145f288cbd41b05e4d8d893,321,29606,7177,22429,36783,156,13,169,442,168,1,60,6.872412843,62947,1,41,0,15146,10316,4830,584786,282275,302511,6805,3993,2812,3,89.18451222,Arch
17f82702243b8c01209dc1be926f66896a7a8f4a,4,114,103,11,217,0,0,0,443,193,1,3,1.042853593,12394,10,866,3,1558,1554,4,43555,43434,121,771,765,6,0,100,NoArch
d5a0659a881fb7acd54e96c20719eefc3b607b57,321,7206,29632,22426,36838,18,140,158,378,138,1,60,6.874515898,85387,1,580,3,10320,15150,4830,282402,584907,302505,3999,6811,2812,0,89.18451222,Arch
afc69b16c7398776c0f75e700228cfd5f4119434,321,29632,7193,22439,36825,156,13,169,443,168,1,60,6.873118178,62961,1,239,1,15152,10320,4832,584968,282402,302566,6811,3999,2812,1,89.18451222,Arch
ae9ac378afac1486d92a161228089f10da0a65c1,323,7216,29628,22412,36844,20,140,160,378,135,1,60,6.878924379,85400,1,263,0,10323,15152,4829,282500,584968,302468,4000,6811,2811,1,89.13137424,Arch
5e9fe64741cfdd904047ae61c52948caf7da84f0,321,29620,7180,22440,36800,156,13,169,443,168,1,60,6.873211545,62960,1,263,0,15152,10322,4830,584968,282408,302560,6811,3999,2812,1,89.20785668,Arch
91e712ccb5d5c8034ed183e244c720557fa6b79c,323,7238,29633,22395,36871,18,140,158,378,138,1,60,6.879613614,86480,1,766,0,10510,15324,4814,287328,589588,302260,4059,6868,2809,1,89.31447225,Arch
9c3ee652ddc5ff65d04b54f937ec0cbb3893f0c6,323,29624,7205,22419,36829,157,13,170,443,167,1,60,6.875432957,64085,1,790,0,15330,10510,4820,589760,287328,302432,6870,4059,2811,1,89.31447225,Arch
96dfb4566dbf563550ef11528d6ce0ed88a08a54,323,7213,29632,22419,36845,18,140,158,378,138,1,60,6.876684063,86504,1,767,1,10510,15330,4820,287328,589760,302432,4059,6870,2811,1,89.31447225,Arch
2c6de6a69826117b1439547ed3f9a63bc74a672f,321,29620,7179,22441,36799,156,13,169,443,168,1,60,6.873225271,62983,1,791,1,15163,10333,4830,585122,282553,302569,6812,4000,2812,1,89.31447225,Arch
36d2737bd82e69245dc25decddf34b439b061d4f,2,2,5,3,7,0,0,0,209,60,1,2,0.985228136,4771,4,792,2,857,859,2,26810,26842,32,213,213,0,1,100,NoArch
0c70e3004b1e779b0dc3fe23a304da4367a8ef93,321,7187,29628,22441,36815,18,140,158,378,139,1,60,6.874477506,85421,1,768,2,10331,15161,4830,282521,585090,302569,4000,6812,2812,1,89.31447225,Arch
099787f95f5267171ce107d9a857dec8a10b447d,321,29623,7180,22443,36803,156,13,169,443,170,1,60,6.873146617,62980,1,793,3,15161,10331,4830,585102,282521,302581,6812,4000,2812,1,89.31447225,Arch
2274576e9d53c07e03c672f655becad6916ea68b,321,7187,29628,22441,36815,18,140,158,378,140,1,60,6.874477506,85423,1,769,3,10331,15161,4830,282533,585102,302569,4000,6812,2812,1,89.31447225,Arch
ac0e952b314b52fd15be7bfe3803ca17a5348f5f,321,29622,7179,22443,36801,156,13,169,443,169,1,60,6.87336776,62982,1,264,1,15162,10331,4831,585111,282533,302578,6812,4000,2812,1,89.31447225,Arch
cae24438fa3ec04c0de0fbc2d00cfa84056ec20a,1,13,6,7,19,0,0,0,10,9,1,1,0,154,4,265,2,23,21,2,819,772,47,11,11,0,1,100,NoArch
eb5a7d63e854a185c53bbdcddfd656f444f032b7,0,0,0,0,0,0,0,0,0,0,0,0,0,0,0,266,3,0,0,0,0,0,0,0,0,0,1,100,NoArch
a727f763a0794f3d6b3426463313e564f1018293,321,7190,29640,22450,36830,18,140,158,378,140,1,60,6.875476329,85432,1,264,1,10331,15164,4833,282533,585158,302625,4000,6812,2812,1,89.31447225,Arch
224338ee6fea3fd6b00445d9203f0e5a5f1ff785,321,29627,7057,22570,36684,156,13,169,443,169,1,60,6.866785615,62982,1,794,4,15184,10331,4853,585495,282533,302962,6817,4000,2817,0,89.31447225,Arch
996eacecceed480688ae499b209364a879e722e2,321,7083,29635,22552,36718,18,140,158,378,140,1,60,6.866397233,85552,1,770,4,10336,15184,4848,282656,585495,302839,4000,6817,2817,0,89.31447225,Arch
b95d16b19308e12d37972c2951fed53117d6ceed,321,29627,7057,22570,36684,156,13,169,443,169,1,60,6.866785615,63000,1,795,5,15189,10336,4853,585618,282656,302962,6817,4000,2817,0,89.31447225,Arch
a2f8dae162ca3b5d5b04027043e0c755b7698c29,1,22,14,8,36,0,0,0,129,64,1,1,0,2719,12,267,4,545,543,2,14656,14606,50,114,114,0,1,100,NoArch
f7c1f689f227a3ddda8c78bd0e44ad7ca48b3657,321,7062,29632,22570,36694,18,140,158,378,140,1,60,6.867681518,85578,1,265,2,10338,15191,4853,282706,585668,302962,4000,6817,2817,1,89.31447225,Arch
118ea2d38588c71648c54aabe9f834ea3b6f25af,322,29644,7062,22582,36706,156,13,169,443,168,1,60,6.869950085,63579,1,796,6,15324,10467,4857,589335,286245,303090,6843,4025,2818,1,89.31447225,Arch
8d15671ccfe427fce2eb80ef15b123084b51fbb9,321,7062,29632,22570,36694,18,140,158,378,140,1,60,6.867681518,85578,1,771,5,10338,15191,4853,282706,585668,302962,4000,6817,2817,1,87.47099768,Arch
f51c1ceba6cca0e9710b32ea26fd86a97fd08a22,322,29651,7057,22594,36708,157,13,170,443,168,1,60,6.870155528,63359,1,797,7,15289,10430,4859,588333,285211,303122,6853,4033,2820,1,87.46803069,Arch
40419af2fb6095e5be52500f0a833d911a5f6851,321,7062,29632,22570,36694,18,140,158,378,140,1,60,6.867681518,85578,1,772,6,10338,15191,4853,282706,585668,302962,4000,6817,2817,1,87.46220051,Arch
115f65186913e9c654432e9f7489f1d54daaafdf,323,29856,7057,22799,36913,158,13,171,443,168,1,60,6.883824848,63008,1,240,1,15246,10338,4908,586657,282706,303951,6833,4000,2833,0,87.33736059,Arch
dd9e6233061fa177c1e009f9ce099c2273155273,1,1,1,0,2,0,0,0,2,7,1,1,0,62,1,241,2,15,15,0,211,212,1,7,7,0,0,100,NoArch
734f2c1b404311a967fce7de620eb78bd58c3b0f,0,0,0,0,0,0,0,0,0,0,0,0,0,0,0,268,5,0,0,0,0,0,0,0,0,0,1,100,NoArch
4fce85084eb0861ae408065b215a833ba40b5240,323,7062,29861,22799,36923,18,141,159,378,136,1,60,6.884713011,85807,1,266,3,10338,15246,4908,282706,586656,303950,4000,6833,2833,1,87.33736059,Arch
755f43434c38324dc007590fe8dc8ff6a1f940c6,324,29861,7075,22786,36936,158,13,171,443,169,1,61,6.887067614,63403,1,269,6,15338,10434,4904,588851,284978,303873,6878,4046,2832,1,87.33736059,Arch
e10e774f48a7d133d460ad935a5c318b55e76d3f,324,7069,29861,22792,36930,18,142,160,378,136,1,61,6.888800443,86189,1,773,7,10432,15338,4906,284957,588851,303894,4046,6878,2832,1,87.33736059,Arch
30600bb3ed3948cbcbcaece7aa4eeab3412d1238,324,29856,7064,22792,36920,158,13,171,443,169,1,61,6.887913481,63397,1,270,5,15338,10432,4906,588851,284957,303894,6878,4046,2832,1,87.33736059,Arch
056df96e8ef069ace35600bdc12c534f83f8489a,0,0,0,0,0,0,0,0,0,0,0,0,0,0,0,242,2,0,0,0,0,0,0,0,0,0,1,100,NoArch
7a4e6afadcf57d7185fdf662f8b3246958f320ab,2,56,25,31,81,0,0,0,8,106,1,1,0.997249633,742,1,243,3,67,63,4,3178,3068,110,19,19,0,0,100,NoArch
18e715e5a7d9883d2221628bfe645af145f42220,2,123,97,26,220,0,0,0,9,0,1,1,0.996181238,773,1,244,4,83,67,16,3518,3178,340,19,19,0,1,99.89874443,NoArch
1654502aadd6040a75013c713769a6e33d454797,324,7070,29918,22848,36988,18,140,158,378,138,1,61,6.888359194,86246,1,774,3,10432,15358,4926,284961,589301,304340,4046,6878,2832,1,87.33736059,Arch
295305569f3351155e1bafcb044faab343c9afc8,324,30024,7065,22959,37089,158,13,171,443,169,1,61,6.88750328,63398,1,245,4,15363,10432,4931,589789,284961,304828,6880,4046,2834,1,87.33736059,Arch
8b20954619ae4097805876fec968e38354598a1f,4,52,12,40,64,2,0,2,41,192,1,3,1.716459443,749,1,867,0,157,151,6,4020,3797,223,83,80,3,0,99.95951417,NoArch
e33e36a480c1867f88e4692940b77abf98109e73,325,7070,30067,22997,37137,18,143,161,378,138,1,61,6.892772012,86395,1,581,0,10432,15368,4936,284961,589988,305027,4046,6883,2837,0,87.29679517,Arch
6332b88926783c37fe1fe4a376a9ee1c912fa040,326,30063,7065,22998,37128,160,13,173,443,169,1,61,6.892150986,63698,1,868,1,15419,10481,4938,590915,285866,305049,6896,4059,2837,0,87.29679517,Arch
3c4f9fd320cc82ab69f12a52200a8019a873263e,325,7070,30067,22997,37137,18,143,161,378,138,1,61,6.892772012,86395,1,582,1,10432,15368,4936,284961,589988,305027,4046,6883,2837,0,87.29679517,Arch
6aa85a2161ebeae2fec105e597bf81085666a98a,329,30165,7126,23039,37291,159,13,172,443,165,1,63,6.909071491,64215,3,271,2,15454,10516,4938,594324,288918,305406,6928,4091,2837,1,87.29679517,Arch
d0c750ab1cfb5180871c710b4f4e48c3f44e2a83,325,7070,30067,22997,37137,18,143,161,378,138,1,61,6.892772012,86395,1,267,0,10432,15368,4936,284961,589988,305027,4046,6883,2837,1,87.29679517,Arch
849237a5e07c38b70e77eef16666fff49d2faa54,325,30062,7065,22997,37127,159,13,172,443,167,1,61,6.891888893,63398,1,246,4,15368,10432,4936,589988,284961,305027,6883,4046,2837,1,87.29679517,Arch
b56bb733f6e4b9e3e519f11a2de10d6bb2448f7a,1,1,1,0,2,0,0,0,21,0,1,1,0,236,3,272,3,18,18,0,1487,1487,0,15,15,0,0,100,NoArch
0f97cbb3da1afd101f2bcecc029c9bb779ab2454,325,7070,30067,22997,37137,18,143,161,378,138,1,61,6.892772012,86395,1,268,1,10432,15368,4936,284961,589988,305027,4046,6883,2837,0,87.29679517,Arch
b4c3c42dbef44e15abadd76634e29c9734724a81,326,30082,7066,23016,37148,159,13,172,443,170,1,62,6.894907107,63498,1,273,4,15387,10443,4944,590612,285394,305218,6895,4057,2838,1,87.29679517,Arch
0a85cbd6466a2bc4eaf688b078e971a49ac23502,325,7070,30067,22997,37137,18,143,161,378,138,1,61,6.892772012,86395,1,269,2,10432,15368,4936,284961,589988,305027,4046,6883,2837,1,87.29679517,Arch
0713648f734aebc578692d8985d1ed636ce3b065,328,30722,7065,23657,37787,162,13,175,443,157,1,62,6.920114981,63398,1,2,0,15450,10432,5018,592724,284961,307763,6918,4046,2872,1,87.15511245,Arch
c19d18299b122f0d90c6446f674d27af198de69e,0,0,0,0,0,0,0,0,0,0,0,0,0,0,0,247,5,0,0,0,0,0,0,0,0,0,1,100,NoArch
3ee4c6694f7051683798431ab8140bda0b5a90f8,0,0,0,0,0,0,0,0,0,0,0,0,0,0,0,248,6,0,0,0,0,0,0,0,0,0,0,100,NoArch
4f59767ab7e6ce240914bb51331e956d0f65204d,0,0,0,0,0,0,0,0,0,0,0,0,0,0,0,249,7,0,0,0,0,0,0,0,0,0,0,100,NoArch
b0c7dea860cf1444e81bc8e73e1d044a27843808,1,92,8,84,100,0,0,0,444,99,1,1,0,10881,28,3,1,1275,1270,5,34583,34348,235,655,653,2,1,100,NoArch
785398b8c13c1edefb2953aaeb5df149cf5b878b,1,45,0,45,45,1,0,1,445,0,1,1,0,10965,28,274,4,1284,1275,9,34723,34583,140,656,655,1,1,100,NoArch
fb4c7b97ce305ae6e2e53e6711d1c5ee21d40789,328,7078,30819,23741,37897,18,146,164,379,138,1,62,6.916118271,87184,1,270,3,10441,15464,5023,285101,593099,307998,4047,6921,2874,1,87.15511245,Arch
595bca368aa43d5bffc4180aa29372c077550e5c,0,0,0,0,0,0,0,0,0,0,0,0,0,0,0,5,0,0,0,0,0,0,0,0,0,0,1,100,NoArch
53063df2336508f188dcec34bd4b7b8cbeb15f40,337,31136,7160,23976,38296,166,13,179,445,171,1,63,6.951531114,63802,1,869,2,15517,10466,5051,595116,286361,308755,6967,4071,2896,0,86.94746586,Arch
ec59b5ac356b84b79c3f7f3f66ae433113e6bd79,1,108,83,25,191,0,0,0,42,181,1,1,0,1193,3,250,8,176,173,3,4748,4674,74,93,91,2,0,100,NoArch
7f5b58572cfe84fe61479317a7bfc2a444bb5c24,0,0,0,0,0,0,0,0,0,0,0,0,0,0,0,251,9,0,0,0,0,0,0,0,0,0,0,100,NoArch
a22b0d83402724d87635761b8d01b015d9b3449d,0,0,0,0,0,0,0,0,0,0,0,0,0,0,0,252,10,0,0,0,0,0,0,0,0,0,0,100,NoArch
3a59273945b1cc043de9960e7ab4709760a0fb5f,0,0,0,0,0,0,0,0,0,0,0,0,0,0,0,253,11,0,0,0,0,0,0,0,0,0,0,100,NoArch
e9a0981c41006fe2031bec1038005b8329b67428,2,63,47,16,110,1,0,1,30,379,1,2,0.524111877,397,6,254,12,51,50,1,2005,1961,44,20,18,2,1,100,NoArch
7e6665edd44b8aae796e1e8e24110bf216331496,337,7117,31038,23921,38155,17,149,166,380,143,1,63,6.963113502,87819,1,6,1,10473,15521,5048,286634,595234,308600,4073,6971,2898,1,86.94746586,Arch
9358c8a8de6db89310d91228c6dcb76666931f42,337,31081,7160,23921,38241,166,13,179,446,172,1,63,6.957966835,63898,1,4,2,15521,10473,5048,595300,286634,308666,6971,4073,2898,1,86.94746586,Arch
85cb455b9b270dfeb19b2708aa377725f4ed1fea,38,621,442,179,1063,0,0,0,212,510,1,6,4.09564922,9076,2,798,0,1691,1644,47,51764,50861,903,591,590,1,2,99.31603299,NoArch
90eeaefba21a22656e998e36dfacd4a7943081ca,337,7103,31201,24098,38304,17,114,131,380,144,1,63,6.967925119,87998,1,271,4,10473,15568,5095,286642,596203,309561,4073,6972,2899,2,86.96759259,Arch
6bd2860f6f5d7839d60c7e851c169c31f8cf5856,337,31213,7124,24089,38337,166,13,179,446,209,1,63,6.969016909,63900,1,799,1,15568,10473,5095,596138,286642,309496,6972,4073,2899,1,86.96759259,Arch
a2e51fb1d810d5fbefd950e49664ac4beb0eddac,337,7103,31201,24098,38304,17,149,166,380,145,1,63,6.967925119,87989,1,775,1,10473,15568,5095,286577,596138,309561,4073,6972,2899,1,86.96759259,Arch
c948d21aef350055811389a1d6bb164aca03bdb6,1,10,3,7,13,0,0,0,119,81,1,1,0,2643,12,776,2,527,524,3,14073,14038,35,111,111,0,1,100,NoArch
a1c15d08715c7e840ce07fa58cc17f1aa2a7d47d,337,31198,7100,24098,38298,166,13,179,446,209,1,63,6.966904566,63898,1,800,2,15571,10476,5095,596173,286612,309561,6972,4073,2899,1,86.96759259,Arch
b0315b70b6656a7c16d39722df7490e33d0a840d,1,8,1,7,9,0,0,0,22,100,1,1,0,303,5,5,3,94,90,4,1874,1829,45,16,16,0,1,100,NoArch
3314b46e9d455399c3539c8abc2e7cfd10a406d9,337,7104,31209,24105,38313,17,149,166,380,145,1,63,6.968879426,88003,1,7,2,10476,15575,5099,286612,596218,309606,4073,6972,2899,1,86.96759259,Arch
a83b7c0a707ca077c53378148f619f05dc1cc118,1,8,1,7,9,0,0,0,18,100,1,1,0,305,4,8,3,94,90,4,1902,1857,45,16,16,0,1,100,NoArch
99acc94940affe3284c9d2dc58fb756f1a033af5,338,31219,7100,24119,38319,167,13,180,446,207,1,63,6.970841278,63905,1,801,3,15580,10480,5100,596365,286657,309708,6973,4073,2900,0,86.93037243,Arch
95f4ad18d5fb7c47840d43d5133a4c2d6a1e88fb,1,14,3,11,17,0,0,0,103,188,1,1,0,1079,12,802,4,201,198,3,7035,6941,94,42,42,0,1,100,NoArch
c6304198f6ddd85635ed71de955dd43cd946d43b,338,7102,31221,24119,38323,17,150,167,380,145,1,63,6.971888296,88035,1,777,2,10483,15583,5100,286751,596459,309708,4073,6973,2900,1,86.93037243,Arch
8250cf5c3d31cfd629f080f8d6b4b9db8c337c0c,338,31218,7099,24119,38317,167,13,180,446,207,1,63,6.970868757,63916,1,803,5,15583,10483,5100,596459,286751,309708,6973,4073,2900,0,86.93037243,Arch
254bc36547fff424264a9dd9ac89ea414ce871db,338,7093,31217,24124,38310,17,150,167,380,145,1,63,6.972539994,88035,1,778,3,10482,15583,5101,286734,596459,309725,4073,6973,2900,1,86.93037243,Arch
cc5aebff5d6a9f767f43b578fa7d65f9532ee872,338,31223,7090,24133,38313,167,13,180,446,206,1,63,6.971943892,63911,1,804,6,15586,10482,5104,596533,286734,309799,6973,4073,2900,1,86.67767036,Arch
24062ef3b587b90bab6d15909c9a32138b133c4a,1,21,7,14,28,0,0,0,126,214,1,1,0,1286,14,805,7,267,264,3,5862,5817,45,108,108,0,1,100,NoArch
d7aa5e86b13704baed533d5a78f16c2175365625,338,7099,31232,24133,38331,17,150,167,380,145,1,63,6.972797961,88058,1,779,4,10485,15589,5104,286779,596578,309799,4073,6973,2900,1,86.67767036,Arch
15f8b49d1b5921109e6a4c878c03f5a4a61585db,340,31318,7171,24147,38489,167,13,180,446,205,1,63,6.984447588,64731,1,870,3,15738,10630,5108,599640,289728,309912,7031,4130,2901,0,86.67767036,Arch
06792d5f6a19633eb9cbd692864eec9e544a0467,0,0,0,0,0,0,0,0,0,0,0,0,0,0,0,255,9,0,0,0,0,0,0,0,0,0,0,100,NoArch
aa4a016323e644216d19b73bf7d003ad7bbb937a,1,1,39,38,40,0,0,0,213,8,1,1,0,4448,13,871,4,761,772,11,24667,24914,247,195,197,2,0,100,NoArch
2a65e17c944d6ec61b360d73d92a0f30329f3b8f,1,1,1,0,2,0,0,0,214,0,1,1,0,4410,13,872,5,761,761,0,24667,24667,0,195,195,0,0,100,NoArch
690e90abd0de900aee43ddac5a75ca299a4b300d,338,7137,31232,24095,38369,17,150,167,380,145,1,63,6.970880956,88020,1,583,2,10485,15578,5093,286779,596331,309552,4073,6971,2898,1,86.67767036,Arch
74f6dd7efb4746021b11ca3b61461e478dea0f69,338,31295,7151,24144,38446,167,13,180,446,206,1,63,6.965907599,63925,1,256,10,15586,10485,5101,596808,286779,310029,6974,4073,2901,0,86.67767036,Arch
659ec564e7e77ba06ec426513d84228729862279,0,0,0,0,0,0,0,0,0,0,0,0,0,0,0,257,10,0,0,0,0,0,0,0,0,0,1,100,NoArch
d92a2b3d87f371dd65b98ad2052d699478660417,1,34,1,33,35,0,0,0,6,1287,1,1,0,155,4,806,8,20,17,3,689,601,88,9,8,1,1,99.91694352,NoArch
4dfa9f7b741d94223251ddb96e82fe8d746eff5f,1,6,0,6,6,1,0,1,131,21,1,1,0,2734,13,0,0,550,548,2,14726,14691,35,114,114,0,1,100,NoArch
8c24d61302c8362d02410103f35dd41cebe0e71a,339,7160,31337,24177,38497,17,150,167,380,145,1,63,6.97073055,88263,1,0,0,10504,15608,5104,287415,597532,310117,4081,6983,2902,1,86.59599529,Arch
7f08de4af1c0d90d3f24c075b0af86f4a27aec89,339,31351,7187,24164,38538,167,13,180,446,207,1,63,6.969289277,64086,1,807,9,15609,10504,5105,597478,287415,310063,6983,4081,2902,1,86.59599529,Arch
d4d0f1fe3eadb2d7ac87958ffcef1d2922ae39fe,339,7153,31330,24177,38483,17,150,167,380,145,1,63,6.97091933,88250,1,780,5,10505,15609,5104,287346,597478,310132,4081,6983,2902,1,86.59599529,Arch
cc4a58de1d483be75fa82c31d1b8ff064bca1009,339,31323,7146,24177,38469,167,13,180,446,207,1,63,6.970292669,64073,1,258,9,15609,10505,5104,597478,287346,310132,6983,4081,2902,0,86.59599529,Arch
aadb6ca2b98e672f1bd73dc917d3e43ad8987f99,339,7136,31326,24190,38462,17,150,167,380,146,1,63,6.969687669,88250,1,781,6,10501,15609,5108,287269,597478,310209,4080,6983,2903,1,86.59599529,Arch
c0fa652cc9dc1f8c1bdd881b9370680db77e72b7,339,31319,7129,24190,38448,167,13,180,446,207,1,63,6.969060504,64060,1,259,9,15609,10501,5108,597478,287269,310209,6983,4080,2903,0,86.59599529,Arch
49f6626177573cf85d43ca519b54b7da77afb938,2,2,2,0,4,0,0,0,215,112,1,2,1,4929,2,808,10,848,848,0,28412,28402,10,237,237,0,1,100,NoArch
bbee6dc6e66add2bd1c48247589eae8a7e729a32,0,0,0,0,0,0,0,0,0,0,0,0,0,0,0,809,11,0,0,0,0,0,0,0,0,0,1,100,NoArch
56e2e8a2ba3099bfd160873959a7220c6864fd40,1,7,5,2,12,0,0,0,105,2,1,1,0,1101,12,810,12,206,206,0,7142,7125,17,42,42,0,1,100,NoArch
4c513e9681849c8b430404691be2a2a032b694c0,339,7142,31331,24189,38473,17,149,166,380,146,1,63,6.969463446,88252,1,782,7,10501,15609,5108,287310,597505,310195,4080,6983,2903,1,86.59599529,Arch
7697d4809c4adfd9f6941f90c555d7366ea24bdb,340,31328,7135,24193,38463,168,13,181,446,211,1,63,6.969637515,64154,1,275,0,15619,10510,5109,597724,287515,310209,6993,4089,2904,1,86.59599529,Arch
0073869247902b2622a1b26b0a598944b7041eb0,1,10,0,10,10,1,0,1,5,603,1,1,0,71,2,1,1,13,11,2,517,418,99,6,6,0,1,100,NoArch
314d2121cf69a5d3d759278113523b9bceaaf80d,1,159,82,77,241,0,0,0,447,32,1,1,0,11010,28,873,4,1283,1284,1,34895,34789,106,661,656,5,1,100,NoArch
c9003c175efee114e0fef641baa3cf7f7ca84871,340,7224,31504,24280,38728,17,149,166,380,146,1,63,6.958803968,88434,1,584,1,10510,15620,5110,287515,597929,310414,4089,6998,2909,0,86.59599529,Arch
5228b773d4137716d95b28b2ec8ffa5552849827,340,31498,7238,24260,38736,168,13,181,447,214,1,63,6.960682581,64154,1,2,2,15600,10510,5090,597676,287515,310161,6998,4089,2909,1,86.59599529,Arch
3bc35e90717fc0a27b114f0c9179c004e1f57ddf,340,7224,31504,24280,38728,17,150,167,380,146,1,63,6.958803968,88414,1,1,1,10490,15600,5110,287262,597676,310414,4089,6998,2909,1,86.59599529,Arch
fea184004943c9c8f23fea503c42a5f2b8ade4eb,340,31497,7217,24280,38714,168,13,181,447,214,1,63,6.95817358,64134,1,3,3,15600,10490,5110,597676,287262,310414,6998,4089,2909,1,86.59599529,Arch
18627cbc8838c24053fff35a765f449c7649e638,340,7224,31504,24280,38728,17,150,167,380,146,1,63,6.958803968,88414,1,2,2,10490,15600,5110,287262,597676,310414,4089,6998,2909,1,86.59599529,Arch
ca50c1504adede7f013633933d2a0c710bdb5de8,340,31502,7218,24284,38720,168,13,181,447,214,1,63,6.958091754,64134,1,4,4,15602,10490,5112,597701,287262,310439,6998,4089,2909,1,86.59599529,Arch
c56d873e0a19ee861c56aa578112d332e165abc7,340,7224,31504,24280,38728,17,150,167,380,146,1,63,6.958803968,88418,1,3,3,10492,15602,5110,287287,597701,310414,4089,6998,2909,1,86.59599529,Arch
aa976b6cb315cf10ae3413049e38bbf5951a3c08,340,31497,7217,24280,38714,168,13,181,447,214,1,63,6.95817358,64138,1,260,5,15602,10492,5110,597701,287287,310414,6998,4089,2909,2,86.59599529,Arch
1f1235012058f991d3ae34aca2706f69e627b577,5,258,30,228,288,2,0,2,448,53,1,3,2.14382297,11884,1,874,4,1456,1425,31,41178,39950,1228,732,720,12,0,99.89637306,NoArch
b6733fffc172393bce19054267b7fdb90ed1955a,1,8,1,7,9,0,0,0,216,18,1,1,0,4410,14,5,5,764,761,3,24693,24667,26,196,195,1,1,100,NoArch
cca22061302f3f7537bd1fa33eb07660376c0329,342,7239,31747,24508,38986,17,151,168,380,145,1,63,6.96775787,88653,1,4,4,10495,15636,5141,287313,598955,311642,4090,7011,2921,1,86.49411765,Arch
8cf7f24f48c860b621206e5c9087b9fec4c57679,342,31743,7233,24510,38976,170,13,183,448,211,1,63,6.96693286,64145,1,6,6,15637,10495,5142,598968,287313,311655,7011,4090,2921,1,86.49411765,Arch
b6bd5cf079daca3cf9d8c4dab39909eaf6b1d963,342,7239,31747,24508,38986,17,152,169,380,145,1,63,6.96775787,88655,1,5,5,10496,15637,5141,287326,598968,311642,4090,7011,2921,1,86.49411765,Arch
618f38939aaf73fa664dcce4eaf88faadb32e626,345,31815,7261,24554,39076,172,13,185,448,210,1,63,6.978123982,64546,1,875,5,15694,10548,5146,600419,288636,311783,7055,4129,2926,0,86.4307476,Arch
6768868e6c1d7bc052c5eedbc61bc341d40c40e6,1,15,7,8,22,0,0,0,218,1,1,1,0,4419,14,7,7,769,765,4,24752,24706,46,197,196,1,1,100,NoArch
6a0249ec1354fb89d45fafaf436121d4dab96440,0,0,0,0,0,0,0,0,0,0,0,0,0,0,0,8,8,0,0,0,0,0,0,0,0,0,1,100,NoArch
92fc816aeeaf8b67db3d198ae2529372ae74f3a2,345,7275,31837,24562,39112,17,154,171,380,143,1,63,6.977647868,89108,1,6,6,10548,15698,5150,288636,600465,311829,4129,7056,2927,1,86.4307476,Arch
fd87cb6a830831d482b417c643ac04d099c59998,345,31830,7268,24562,39098,172,13,185,448,210,1,63,6.977025321,64546,1,65,0,15698,10548,5150,600469,288636,311833,7056,4129,2927,0,86.4307476,Arch
d5f9b65878a28e70be7bb9a9963621163aa3bf8d,3,15,5,10,20,0,0,0,107,51,1,3,0.921928095,2775,2,876,3,543,542,1,17696,17613,83,145,144,1,0,100,NoArch
d2b9d9bbfd357d49015e17781dc6ce1c84f90f76,1,3,3,0,6,0,0,0,26,917,1,1,0,386,7,877,4,65,65,0,1704,1699,5,31,31,0,1,100,NoArch
551e924441aef43ea235004ee5a57796688dcf15,2,90,117,27,207,0,0,0,10,1343,1,2,0.655600757,308,4,878,5,31,35,4,920,927,7,15,12,3,0,100,NoArch
6d12636798b4f61cd8e4c717c33479078cd25bb4,347,7282,31858,24576,39140,17,153,170,380,147,1,64,6.980073691,89675,1,585,1,10629,15780,5151,290963,602907,311944,4167,7095,2928,0,86.4307476,Arch
539183300a4769899bbf3c040c2ed1227aa27ef8,347,31849,7274,24575,39123,172,13,185,448,208,1,64,6.979023524,65099,1,879,6,15780,10629,5151,602900,290963,311937,7095,4167,2928,0,86.4307476,Arch
824fd03ac774c8dc4dc0e57fee47b555ab5928e6,348,7284,31856,24572,39140,18,154,172,380,150,1,64,6.980268772,89724,1,8,0,10633,15783,5150,291103,603026,311923,4170,7098,2928,1,86.4307476,Arch
1ddf5482b052ed341ebcd66031e433b054104fb4,347,31849,7274,24575,39123,172,13,185,448,208,1,64,6.979023524,65099,1,9,0,15780,10629,5151,602900,290963,311937,7095,4167,2928,1,86.4307476,Arch
13e6af843d30ac2a4d36650dae1404b2d439ad30,1,1,0,1,1,1,0,1,449,13,1,1,0,11106,28,10,1,1283,1283,0,34980,34971,9,661,661,0,1,100,NoArch
734ed126ee71b4ceb504a167013b8acf246333a1,0,0,0,0,0,0,0,0,0,0,0,0,0,0,0,11,2,0,0,0,0,0,0,0,0,0,1,100,NoArch
a5ccffbb54c93ce1012f6a61c8cfbf7b1ebdb593,0,0,0,0,0,0,0,0,0,0,0,0,0,0,0,66,1,0,0,0,0,0,0,0,0,0,0,100,NoArch
dce8d7ddae94e0eee2e8462a2a542244879babcc,1,3,3,0,6,0,0,0,6,920,1,1,0,169,3,880,7,23,23,0,709,703,6,7,7,0,0,100,NoArch
af9671ad99cf40ba6ea3d835042201c49f545408,1,1,1,0,2,0,0,0,4,1597,1,1,0,136,3,9,9,13,12,1,301,290,11,7,7,0,1,100,NoArch
e0303e19c7a3a0754ba176bdac45428139f29647,348,7284,31860,24576,39144,17,154,171,380,147,1,64,6.980684882,89844,1,7,7,10652,15803,5151,291666,603618,311952,4174,7102,2928,1,86.4307476,Arch
892a174e77a69f62effb18cd45cc7d4570b50998,348,31868,7277,24591,39145,172,13,185,449,206,1,64,6.98066515,65268,1,881,8,15807,10652,5155,603678,291666,312012,7105,4174,2931,0,86.4307476,Arch
eb8cf91727a69923a768c2e4b41be4bee2a3985a,1,11,5,6,16,0,0,0,20,0,1,1,0,489,3,882,9,112,110,2,3242,3190,52,38,37,1,0,100,NoArch
0b30a72dc9b19fab8741978cca383a87b3c209b2,2,695,9,686,704,1,0,1,450,108,1,1,0.08970339,11274,6,276,1,1299,1299,0,35390,35390,0,671,671,0,2,100,NoArch
63b5aee8282023a41340a89fbc4405c710888561,2,35,18,17,53,0,0,0,219,149,1,1,0.941423108,4936,5,811,5,873,873,0,27548,27461,87,227,226,1,1,100,NoArch
abb7326dad61c842d1350e4d824d10f010dc4239,349,7289,32564,25275,39853,17,154,171,380,150,1,64,6.940769592,90735,1,783,3,10672,15825,5153,292209,604227,312018,4186,7117,2931,1,86.4307476,Arch
ee9bd087f5068ff235824bd8f2247f0480935c68,349,32557,7282,25275,39839,173,13,186,450,204,1,64,6.940136147,65460,1,277,2,15825,10672,5153,604227,292209,312018,7117,4186,2931,1,86.4307476,Arch
796e6a545ed6043aa2f77c3989691bf583330e68,3,56,4,52,60,1,0,1,44,467,1,3,1.147443419,1826,11,812,6,262,254,8,6710,6533,177,104,102,2,1,100,NoArch
8cff05d9d518e2ff495552a56e5eeb7bde2721b4,349,7282,32493,25211,39775,17,154,171,380,154,1,64,6.941045575,90787,1,784,4,10686,15833,5147,292846,604404,311558,4190,7119,2929,1,86.4307476,Arch
a507dee4ab43d8e227a9494883816ea021b20b2d,349,32490,7278,25212,39768,173,13,186,450,204,1,64,6.940487808,65576,1,813,7,15833,10686,5147,604411,292846,311565,7119,4190,2929,0,86.4307476,Arch
745313d6f8e5dc95207f148d7e970b0bb1a14ddf,349,7282,32493,25211,39775,17,154,171,380,156,1,64,6.941045575,90788,1,785,5,10686,15833,5147,292853,604411,311558,4190,7119,2929,0,86.4307476,Arch
c4b2c68a8ce86500bbfe4e11fa4faa5c7084dc37,349,32494,7279,25215,39773,173,13,186,450,203,1,64,6.941013913,65577,1,278,3,15834,10686,5148,604425,292853,311572,7120,4190,2930,1,86.4307476,Arch
91dbdf67e4a44b386d3c958baaf61d7e8f628976,349,7282,32493,25211,39775,17,154,171,380,158,1,64,6.941045575,90792,1,272,0,10687,15834,5147,292867,604425,311558,4191,7120,2929,1,86.4307476,Arch
59d5230aca83fabf144e2a439b92106e170fa21a,349,32489,7278,25211,39767,173,13,186,450,203,1,64,6.940383965,65581,1,115,0,15834,10687,5147,604425,292867,311558,7120,4191,2929,0,86.4307476,Arch
a9ce34508fbf74fe585122598920fca43b4e6146,349,7282,32493,25211,39775,17,154,171,380,158,1,64,6.941045575,90792,1,89,0,10687,15834,5147,292867,604425,311558,4191,7120,2929,0,86.4307476,Arch
383db49c3b490080215e50581c00f5ce161b0a61,349,32496,7280,25216,39776,173,13,186,450,203,1,64,6.940426077,65581,1,814,6,15835,10687,5148,604464,292867,311597,7120,4191,2929,1,86.4307476,Arch
1e3e91a9c98504e7ebf0ea921490e62ea497b1fa,349,7281,32493,25212,39774,17,154,171,380,158,1,64,6.941092751,90797,1,786,5,10688,15835,5147,292902,604464,311562,4191,7120,2929,1,86.4307476,Arch
5b6737fc204e2d548e117b83ba038828a771e2cd,349,32505,7284,25221,39789,173,13,186,450,203,1,64,6.940493383,65585,1,815,7,15835,10688,5147,604500,292902,311598,7120,4191,2929,1,86.4307476,Arch
d03fe7587adc4fa732d0795a1b0f968d60645b42,349,7283,32497,25214,39780,17,154,171,380,158,1,64,6.941020592,90806,1,787,6,10688,15835,5147,292926,604500,311574,4191,7120,2929,1,86.4307476,Arch
7327539017bdb8c73ea0efd6278c6707c450c149,349,32503,7283,25220,39786,173,13,186,450,203,1,64,6.939696279,65592,1,816,8,15836,10688,5148,604540,292926,311614,7120,4191,2929,1,86.4307476,Arch
898df87b4846d22570d2eaa5f711da76c4316251,349,7283,32497,25214,39780,17,154,171,380,158,1,64,6.941020592,90812,1,788,7,10689,15836,5147,292966,604540,311574,4191,7120,2929,1,86.4307476,Arch
f4b3c55f5763b78ae27be65dfcdc3e5eba0dc851,349,32482,7282,25200,39764,173,13,186,451,203,1,64,6.940893823,65598,1,883,10,15834,10689,5145,604452,292966,311486,7120,4191,2929,1,86.4307476,Arch
9af174a9babaa98d8f66ffd0aab9c6dd8f7534b7,1,9,10,1,19,0,0,0,134,1,1,1,0,2746,13,817,9,549,551,2,14762,14765,3,114,114,0,1,100,NoArch
08777d9f4403fdac1cd3dc5c607acafdf5f731f6,349,7286,32486,25200,39772,17,154,171,380,158,1,64,6.941555358,90797,1,789,7,10687,15832,5145,292963,604449,311486,4191,7120,2929,1,86.4307476,Arch
4b78332e00cdc992375f8e67ca76f67a2f3b1858,349,32483,7287,25196,39770,173,13,186,451,203,1,64,6.941523725,65597,1,279,4,15831,10687,5144,604435,292963,311472,7119,4191,2928,1,86.4307476,Arch
d3586c170391047119377812f956e82b63cec3c3,349,7286,32486,25200,39772,17,154,171,380,156,1,64,6.941555358,90793,1,273,1,10686,15831,5145,292949,604435,311486,4190,7119,2929,1,86.4307476,Arch
3620579d451537643b60d37ec77019ee7dcd920e,1,3,3,0,6,0,0,0,100,181,1,1,0,806,13,790,8,168,167,1,4460,4444,16,57,57,0,0,100,NoArch
803214f8fe4eb7b9e96a46b811f54c33a68d95f0,1,9,1,8,10,0,0,0,22,42,1,1,0,382,4,791,9,93,92,1,2217,2195,22,45,45,0,1,100,NoArch
46caf2b3a88301c76bad8049049a7bb9c552dda7,1,10,18,8,28,0,0,0,23,0,1,1,0,390,5,9,0,92,93,1,2195,2217,22,45,45,0,1,100,NoArch
1d8c398ff3cec7df1a60ddfb2231c8eeeadeffc8,1,9,1,8,10,0,0,0,24,0,1,1,0,382,5,10,1,93,92,1,2217,2195,22,45,45,0,1,100,NoArch
95b84c24a9e77b93504b586234036c9ab10fd296,349,32495,7303,25192,39798,173,13,186,451,203,1,64,6.942749551,65601,1,261,1,15831,10688,5143,604435,292987,311448,7119,4190,2929,1,86.4307476,Arch
d1ebd523370b23f964fb52e9f63e8b95a7812ed4,349,7307,32499,25192,39806,17,154,171,380,154,1,64,6.943414976,90793,1,11,2,10688,15831,5143,292987,604435,311448,4190,7119,2929,1,86.4307476,Arch
9936bf9c43c77e5883f8540fb3dfd6404bc11bf9,349,32495,7303,25192,39798,173,13,186,451,203,1,64,6.942749551,65601,1,6,0,15831,10688,5143,604435,292987,311448,7119,4190,2929,0,86.4307476,Arch
cecc807dbef852b6a2db01a61b5685e94aea5601,1,15,10,5,25,0,0,0,12,59,1,1,0,360,3,884,11,69,68,1,1588,1569,19,29,29,0,1,100,NoArch
cac04bb644027c861f114dff449a466ce13f6a51,349,7307,32499,25192,39806,17,154,171,380,154,1,64,6.943414976,90793,1,586,2,10688,15831,5143,292987,604435,311448,4190,7119,2929,1,86.4307476,Arch
76be5f78f514c481c7f44883051926df02aef9b4,350,32524,7303,25221,39827,174,13,187,452,206,1,65,6.941626929,65774,1,7,1,15846,10694,5152,605459,293904,311555,7125,4196,2929,1,86.4307476,Arch
49edeb517913491cc40af1fae751eff0110fab22,8,44,30,14,74,0,0,0,176,420,1,5,2.63564406,7555,3,8,2,1686,1689,3,42948,43078,130,384,383,1,1,100,NoArch
c3d1a4567d2e0b3d549d40f6191c1d116dd27fe7,1,18,10,8,28,0,0,0,22,77,1,1,0,388,4,9,3,92,91,1,2284,2262,22,46,46,0,2,100,NoArch
26e1dd3c495311bfccaac02ad412963f834bd8e6,351,7313,32556,25243,39869,17,153,170,380,167,1,65,6.941192346,91082,1,107,0,10695,15845,5150,293994,605441,311447,4197,7127,2930,1,86.4307476,Arch
3f3b732a224a545ad6d8c5cf675dc4fab2384e01,351,32561,7310,25251,39871,174,13,187,452,209,1,65,6.940594475,65839,1,262,2,15847,10695,5152,605482,293994,311488,7127,4197,2930,1,86.4307476,Arch
7511c483f81965621f50754d81b763eb2bdc153d,2,61,52,9,113,0,0,0,21,9,1,2,0.400930682,631,4,885,12,123,125,2,3503,3543,40,44,45,1,1,99.95888158,NoArch
59b36b54699c57f888c2416b4236a5ccd102c41e,352,7355,32619,25264,39974,17,154,171,381,168,1,65,6.949368546,91235,1,587,3,10706,15858,5152,294277,605743,311466,4204,7133,2929,1,86.38387626,Arch
4b036a7ebd0d9a24f9ebd659e31ea5b3c25fdb6a,2,64,47,17,111,0,0,0,15,381,1,2,0.339486,611,4,588,4,114,112,2,3454,3424,30,40,40,0,1,97.49859472,Arch
432c08b50f49604cc08b371197827d2c972c7d9a,1,17,0,17,17,1,0,1,16,0,1,1,0,478,3,589,5,105,101,4,3234,3152,82,36,33,3,1,100,NoArch
6f6fc53ab6ea5372244f36aec50975ce8c9604f8,351,32580,7310,25270,39890,174,13,187,452,209,1,65,6.9392514,65855,1,10,9,15854,10699,5155,605652,294087,311565,7127,4200,2927,1,85.1022864,Arch
c1b9a263fa5b18bb012f731c4337eaa055883b9b,351,7311,32541,25230,39852,17,154,171,381,167,1,65,6.940572628,91125,1,8,7,10708,15854,5146,294298,605652,311354,4201,7127,2926,1,85.1022864,Arch
e4cb0688179c9e27d64ae263e55b2f6c1dda6cc3,351,32555,7307,25248,39862,174,13,187,452,209,1,65,6.940356809,65895,1,263,3,15858,10708,5150,605763,294298,311465,7128,4201,2927,0,85.1022864,Arch
9dce06c0580340796736387b4e6cda6eca020d91,1,6,1,5,7,0,0,0,35,1,1,1,0,711,5,11,9,173,172,1,4106,4069,37,44,44,0,1,100,NoArch
71647d48f8b521cf06caf07496674521cb5a8ee6,351,7311,32559,25248,39870,17,154,171,381,167,1,65,6.941028155,91148,1,9,8,10709,15859,5150,294335,605800,311465,4201,7128,2927,1,85.1022864,Arch
02f60fba1211fb0e7f61bd1ab0683ad68aebbf03,351,32567,7307,25260,39874,174,13,187,452,208,1,65,6.940928847,65900,1,12,9,15863,10709,5154,605889,294335,311554,7128,4201,2927,1,85.15042118,Arch
54b09ef95e60028a4f1d3b549c0e1ca3c8d403e3,351,7312,32571,25259,39883,17,154,171,382,167,1,65,6.94153306,91160,1,10,8,10710,15863,5153,294349,605889,311540,4201,7128,2927,1,85.15042118,Arch
be0020ea12fd710dd4b347f740b658567d293dad,1,14,4,10,18,0,0,0,383,0,1,1,0,11038,27,11,9,1309,1305,4,35642,35549,93,663,663,0,1,100,NoArch
f25e48ed7758e015785858ee6df75589a4217123,355,32778,7417,25361,40195,174,13,187,452,220,1,65,6.956836958,66432,1,886,12,15921,10772,5149,608364,296020,312344,7158,4231,2927,0,85.15042118,Arch
6aef38f7447bedc06634c4406476f2a7bcf176c9,1,14,3,11,17,0,0,0,135,6,1,1,0,2745,13,280,4,552,549,3,14821,14762,59,117,114,3,1,100,NoArch
e21ef55a7275d79a8dd130590aa2eebad16656a3,354,7417,32780,25363,40197,17,154,171,383,168,1,65,6.956857564,91741,1,274,2,10773,15922,5149,295796,608155,312359,4232,7159,2927,1,85.15042118,Arch
9d2f4bd3a3355cbf1f6d0cfa4a40d600368546ac,354,32777,7413,25364,40190,174,13,187,452,217,1,65,6.956272929,66378,1,887,13,15922,10773,5149,608155,295796,312359,7159,4232,2927,0,85.15042118,Arch
a1175e65b12d879adb34dc73b309c06c0907d7e2,11,25,12,13,37,2,0,2,223,771,1,8,3.210151516,8193,2,10,4,1338,1338,0,42640,42640,0,410,410,0,0,100,NoArch
173612138c1dc95136cc75380cc340e5d5df39d5,0,0,0,0,0,0,0,0,0,0,0,0,0,0,0,818,7,0,0,0,0,0,0,0,0,0,0,100,NoArch
612cf4da1c9f5ee3d5e985edabf4ea0420e32409,21,619,498,121,1117,6,4,10,46,259,1,3,3.87172022,2999,1,819,8,555,544,11,16290,15496,794,251,245,6,0,99.44683467,NoArch
9119cc3ebce37c822b693b5e80696e7ff12eee22,7,287,304,17,591,0,0,0,224,148,1,6,0.856040628,8286,3,11,5,1395,1395,0,43424,43393,31,421,421,0,0,100,NoArch
631329ecdc7b47329374ef9a160250997fdec397,1,4,0,4,4,1,0,1,11,739,1,1,0,98,4,12,6,9,8,1,229,215,14,7,7,0,0,100,NoArch
ab65e489e1a677791f748e967b50f8e2cb240861,0,0,0,0,0,0,0,0,0,0,0,0,0,0,0,13,7,0,0,0,0,0,0,0,0,0,0,100,NoArch
b7940cfefed5059394f89f298d4459975c4ea241,3,47,6,41,53,2,0,2,179,2,1,2,1.191673991,5185,4,820,9,1158,1148,10,29077,28853,224,305,303,2,0,100,NoArch
2a6886bcae7ca33fb1e66b94c47b0f5d8594865a,14,276,147,129,423,3,0,3,48,119,1,5,2.760114428,2365,1,821,10,434,403,31,11842,11310,532,218,203,15,0,99.77500511,NoArch
3b5e94f243b5ba42ef6fd15da7d4a4f2bd865cc5,4,13,16,3,29,0,0,0,180,1,1,4,1.502004701,4789,2,14,8,1118,1118,0,27409,27415,6,268,268,0,0,100,NoArch
7e67dc6966307cf2792b81181b8a4f5cbe4121aa,8,64,28,36,92,1,0,1,36,63,1,2,2.989747511,1448,7,13,9,374,357,17,9820,9440,380,90,89,1,1,99.35157042,NoArch
6d487665229f23e766e752b70c24b96581034899,2,65,38,27,103,0,0,0,114,4,1,2,0.991757024,1361,14,822,11,259,255,4,8439,8265,174,72,71,1,0,100,NoArch
f2b05035cd569114b1646b4a21f052d9f267bdb2,365,7702,33390,25688,41092,17,138,155,383,168,1,65,6.993374788,93291,1,792,9,10918,16137,5219,300301,614632,314331,4324,7275,2951,0,85.25367473,Arch
35982f55dcf8999ae9db14c5530d1cb68f769999,1,4,0,4,4,1,0,1,18,551,1,1,0,333,6,793,10,51,50,1,1261,1230,31,15,15,0,1,100,NoArch
c3037c1033d97aaffe046610972ad289f3d5784b,365,33385,7697,25688,41082,180,13,193,452,224,1,65,6.992730385,67603,1,823,12,16137,10918,5219,614632,300301,314331,7275,4324,2951,1,85.25367473,Arch
93b23f8d6103c0826a4fdfcce4c1f6b57f70f1ee,365,7720,33380,25660,41100,17,158,175,384,167,1,65,6.991599807,93291,1,12,9,10935,16137,5202,300525,614632,314107,4325,7275,2950,1,85.25367473,Arch
1f2d6e0cbedb6e094bae3d93c94314cec58c4ff8,374,33809,7715,26094,41524,189,13,202,452,219,1,67,7.028871465,67631,1,0,0,16203,10935,5268,616643,300525,316118,7320,4325,2995,0,84.83132814,Arch
70c79fa5820161fb0064bcbc3747e674d7c42a45,1,1,1,0,2,0,0,0,225,0,1,1,0,4437,15,281,5,768,768,0,24810,24810,0,198,198,0,1,100,NoArch
4a7ab7feda34ef240e0999452089324f16a1b09d,374,7720,33814,26094,41534,17,167,184,384,160,1,67,7.029504025,93725,1,275,3,10935,16203,5268,300525,616643,316118,4325,7320,2995,1,84.83132814,Arch
ee75bf986056f70a05ae539beb1c9aad000cd179,374,33802,7715,26087,41517,189,13,202,452,219,1,67,7.028284141,67631,1,282,6,16203,10935,5268,616641,300525,316116,7320,4325,2995,1,84.83132814,Arch
1e5aa802c11a37cb2f7821eb0e17fbc7524a1c08,4,112,0,112,112,4,0,4,1,0,1,1,1.780376589,0,1,888,14,18,0,18,440,0,440,18,0,18,0,99.821464,NoArch
076be1abb1b0935a8fb81fde78970cf3c84eaab6,4,0,112,112,112,0,4,4,3,0,1,1,1.780376589,112,2,889,15,0,18,18,0,432,432,0,18,18,0,99.821464,NoArch
ea257771bfa4be0e321856aeac6f41ff258b4a2a,6,129,82,47,211,0,0,0,453,30,1,5,1.590712328,13505,4,824,13,1526,1522,4,42043,41763,280,787,785,2,0,99.94036971,NoArch
cbedea770fbea1660cd7e663482b6ece4bea8821,0,0,0,0,0,0,0,0,0,0,0,0,0,0,0,825,14,0,0,0,0,0,0,0,0,0,0,100,NoArch
51a119745442a77bab95656b295c5c02d0571268,0,0,0,0,0,0,0,0,0,0,0,0,0,0,0,890,16,0,0,0,0,0,0,0,0,0,0,100,NoArch
5757ef078b3e3f5abf461b60fa2778196043816a,1,1,1,0,2,0,0,0,7,2,1,1,0,78,4,891,17,2,2,0,191,191,0,2,2,0,0,100,NoArch
502f1f9aef0c880baf92419cc22b21299e5c4d9e,1,126,6,120,132,0,0,0,454,16,1,1,0,11808,28,892,15,1300,1290,10,35296,35042,254,671,661,10,1,100,NoArch
05448670b06a95ec30fd65be857439b7b6a699c0,374,7729,33862,26133,41591,17,166,183,385,160,1,67,7.028649248,93885,1,590,5,10945,16217,5272,300779,617183,316404,4335,7332,2997,1,84.8041529,Arch
757ec3596d04d9a7d98222877074e35142a9505f,374,34040,7722,26318,41762,189,13,202,454,209,1,67,7.038034743,67752,1,1,1,16217,10945,5272,617183,300779,316404,7332,4335,2997,0,84.8041529,Arch
e47a0da8c3a2c8a88be1b81b7ae97233bcd4f8c8,0,0,0,0,0,0,0,0,0,0,0,0,0,0,0,2,2,0,0,0,0,0,0,0,0,0,1,100,NoArch
ed84e03a50e145e7e9c00aa58f06abb016be8362,1,4,5,1,9,0,0,0,15,278,1,1,0,164,4,893,10,21,21,0,826,833,7,13,13,0,1,100,NoArch
4dd61ffd01ba6b309c6c2cc4f58c28f770c9fa33,374,7729,34046,26317,41775,17,167,184,385,160,1,67,7.038811401,94069,1,591,5,10945,16217,5272,300779,617176,316397,4335,7332,2997,1,84.8041529,Arch
fc8acf27c7349b9d0b2dca90d3215ef1c0cb7632,374,34079,7737,26342,41816,189,13,202,455,209,1,67,7.034382819,67752,1,894,11,16221,10945,5276,617223,300779,316444,7333,4335,2998,0,84.8041529,Arch
983318f685c5b8ee12932457264fa6e3828f0a64,1,1,1,0,2,0,0,0,456,0,1,1,0,11953,28,895,12,1304,1304,0,35348,35343,5,672,672,0,0,100,NoArch
7abe3e63378f9a4f6a2f20902affe8ae57fb30e9,374,7742,34047,26305,41789,17,167,184,386,160,1,67,7.03789639,94094,1,592,6,10949,16221,5272,300901,617228,316327,4336,7333,2997,0,84.8041529,Arch
ae6af426beb83b6dc750376c97a038252d821405,2,124,72,52,196,0,0,0,18,1452,1,2,0.956294006,291,3,593,7,50,37,13,1375,1049,326,28,20,8,1,99.91291727,NoArch
0d7d83c89539289d706136680404716b8e5dd643,374,33921,7668,26253,41589,189,13,202,456,209,1,67,7.026780861,67841,1,14,4,16221,10962,5259,617228,301227,316001,7333,4344,2989,1,84.82416804,Arch
b038af459fa572b902b3292c9a6e330990abe4c9,374,7673,33926,26253,41599,17,167,184,386,167,1,67,7.027501298,94094,1,13,5,10962,16221,5259,301227,617228,316001,4344,7333,2989,1,84.82416804,Arch
3a0f887bf19f9c004d78656c3f867e943a479364,377,33989,7679,26310,41668,189,13,202,457,214,1,67,7.031493853,68409,1,896,13,16311,11048,5263,619865,303680,316185,7371,4380,2991,0,84.82416804,Arch
7a868aa89ba919411ad9256cdafe89f2ae609dfd,377,7761,34025,26264,41786,17,167,184,387,169,1,67,7.025319884,94719,1,594,8,11052,16311,5259,303831,619865,316034,4382,7371,2989,0,84.82416804,Arch
7d6bf581bd99e2b4422edb4ae1ea91923a9278b9,377,34029,7756,26273,41785,189,13,202,457,213,1,67,7.026052942,68455,1,897,14,16313,11052,5261,619939,303831,316108,7372,4382,2990,0,84.82416804,Arch
4777dc25c2ff60aa392a3334a12e017af08691c4,3,45,40,5,85,0,0,0,458,21,1,2,1.221047785,12348,1,898,15,1370,1370,0,37057,37052,5,695,695,0,0,100,NoArch
445996bf3328d0dfebd052ce6510a01dd6ae598e,1,9,1,8,10,0,0,0,7,109,1,1,0,50,3,15,5,6,5,1,198,154,44,3,3,0,1,99.98011928,NoArch
29aaed0859b4187e9ad33480f58877fafe82b203,1,46,0,46,46,1,0,1,1,0,1,1,0,0,1,3,3,8,0,8,262,0,262,2,0,2,1,99.96025437,NoArch
dae7534d434564e94ef04347d4715d8b0d8f2178,378,7803,34118,26315,41921,17,167,184,388,170,1,67,7.03244569,94787,1,12,0,11053,16322,5269,303892,620250,316358,4383,7374,2991,1,84.70976876,Arch
213a58076280909fd230cfb622961b5d74e6d097,0,0,0,0,0,0,0,0,0,0,0,0,0,0,0,13,1,0,0,0,0,0,0,0,0,0,0,100,NoArch
cb1163b5bf0443856f832f482c7398a626f473a6,1,6,4,2,10,0,0,0,3,0,1,1,0,52,2,14,2,6,4,2,253,238,15,2,2,0,1,100,NoArch
be6cb63067bf567efc3969a9375246020062863a,378,34106,7789,26317,41895,190,13,203,459,206,1,67,7.032873936,68474,1,15,5,16322,11055,5267,620269,303907,316362,7374,4383,2991,1,84.70976876,Arch
b2adafbe42193f51eac3a902464507c0e18c5a39,1,9,9,0,18,0,0,0,23,797,1,1,0,191,7,899,13,10,10,0,594,594,0,3,3,0,0,100,NoArch
3cbad912eef764fb6943358916205a7c22bcd1ce,2,16,2,14,18,0,0,0,19,573,1,2,0.503258335,378,6,900,14,54,54,0,1464,1464,0,16,16,0,0,100,NoArch
eac8ffd1ff9c2b7d3b95ec0f0b65ff0298c66fc0,0,0,0,0,0,0,0,0,0,0,0,0,0,0,0,901,13,0,0,0,0,0,0,0,0,0,1,100,NoArch
091044c6ed7e58106a34f2be453c208153edbc6c,380,7805,34136,26331,41941,17,168,185,388,167,1,67,7.036975786,95333,1,595,5,11116,16383,5267,305762,622124,316362,4401,7392,2991,1,84.70976876,Arch
1abfe4667cac0c9423a6ff44346e43642e2a9d42,380,34132,7801,26331,41933,190,13,203,460,210,1,67,7.035976458,69002,1,16,1,16383,11116,5267,622124,305762,316362,7392,4401,2991,1,84.70976876,Arch
36cedde63a4462770303e69bd1c8aa6c18e7d65d,3,7,5,2,12,0,0,0,226,60,1,2,1.251629167,6879,14,826,0,1251,1250,1,38084,38067,17,349,349,0,0,100,NoArch
07cbba7024a48c99848a81d27e3fdf6590154e28,0,0,0,0,0,0,0,0,0,0,0,0,0,0,0,827,1,0,0,0,0,0,0,0,0,0,0,100,NoArch
0f56b5d8ac9718dbaddb668c8d173a95aa0c26e0,1,7,33,26,40,0,0,0,461,3,1,1,0,11970,28,17,2,1299,1302,3,35330,35396,66,672,672,0,1,100,NoArch
372d031967649dcc0e4392c89f9a7d024c65ced4,380,7810,34143,26333,41953,17,168,185,389,167,1,67,7.03634399,95309,1,15,3,11113,16381,5268,305696,622075,316379,4401,7392,2991,1,84.70976876,Arch
794a232c24eec0a4bc42981265e3b026f8c4a7f3,380,34139,7806,26333,41945,190,13,203,461,210,1,67,7.035771807,68976,1,18,3,16381,11113,5268,622075,305696,316379,7392,4401,2991,1,84.70976876,Arch
cd87c22d0ddbfc980381db6e26e872224fa2f53c,3,264,15,249,279,2,0,2,462,0,1,2,1.01104082,12741,14,19,4,1490,1465,25,40257,39738,519,749,727,22,2,99.94042891,NoArch
396c42748be5ed1d885a5a37dd196f1d8c5848ed,1,1,8,7,9,0,0,0,463,0,1,1,0,12093,28,20,5,1310,1313,3,35536,35588,52,684,684,0,1,100,NoArch
910da34c973145f00a151e370bb881bab42c0750,1,0,2,2,2,0,0,0,20,8,1,1,0,337,7,21,6,51,51,0,1254,1261,7,15,15,0,0,99.94044074,NoArch
b7f6cae0d5f6dc6b21607af4a95f2fb265829faa,1,4,2,2,6,0,0,0,24,50,1,1,0,567,9,22,7,74,74,0,2626,2618,8,26,26,0,1,100,NoArch
c088646a5f52a54898caf1fd3a9b8765595d5d08,0,0,0,0,0,0,0,0,0,0,0,0,0,0,0,23,8,0,0,0,0,0,0,0,0,0,1,100,NoArch
cc30bf4c4c30832740e8cb1d84113a18890441bb,0,0,0,0,0,0,0,0,0,0,0,0,0,0,0,24,9,0,0,0,0,0,0,0,0,0,1,100,NoArch
4a80a6cb812bdb7f2d1418dbac16965c3466898c,0,0,0,0,0,0,0,0,0,0,0,0,0,0,0,25,10,0,0,0,0,0,0,0,0,0,1,100,NoArch
d4e8ec7cf326967ead2f080ade6ac8b234ff7a02,0,0,0,0,0,0,0,0,0,0,0,0,0,0,0,26,11,0,0,0,0,0,0,0,0,0,1,100,NoArch
b18ccb15292250d115fefdd5f5f581bcdbb67e94,0,0,0,0,0,0,0,0,0,0,0,0,0,0,0,27,12,0,0,0,0,0,0,0,0,0,1,100,NoArch
e504ff7c517032f0ac1ce5a6face59d2091f4c0e,2,128,0,128,128,2,0,2,2,0,1,1,0.065914412,97,1,28,13,19,10,9,467,239,228,19,10,9,1,99.96030171,NoArch
40f6734b8e1c03e24d319190e8b2cb785d2049e2,0,0,0,0,0,0,0,0,0,0,0,0,0,0,0,29,14,0,0,0,0,0,0,0,0,0,1,100,NoArch
7fb8dce53165120ac187a283fcc31a203edfbd6a,1,25,3,22,28,0,0,0,464,2,1,1,0,12086,28,30,15,1312,1310,2,35586,35536,50,686,684,2,1,100,NoArch
d96beae86468aface8fa18d2d88bbf20608e2cc1,2,3,2,1,5,0,0,0,465,11,1,2,0.970950594,12365,11,31,16,1346,1346,0,37627,37625,2,709,709,0,1,100,NoArch
e650642505e0cac325f5e15465e4a5675094bc33,1,7,9,2,16,0,0,0,108,5,1,1,0,800,14,32,17,167,167,0,4420,4430,10,55,55,0,1,100,NoArch
0f36c4b56112ce582d62927d859bf71de15cecad,1,5,0,5,5,1,0,1,129,8,1,1,0,1276,14,208,0,265,263,2,5747,5716,31,109,108,1,0,100,NoArch
bccb6e17f44e769805128834998c1df16c701383,2,17,1,16,18,1,0,1,52,291,1,2,0.99107606,1324,1,209,1,248,242,6,6486,6342,144,96,95,1,1,100,NoArch
460e0fd09ca1e9bf61b3ebf266c111c5f184d24e,0,0,0,0,0,0,0,0,0,0,0,0,0,0,0,33,18,0,0,0,0,0,0,0,0,0,0,100,NoArch
455c33c566919bf89af8c3d5d0fdefa6763d3745,2,15,3,12,18,1,0,1,136,877,1,2,1,2843,6,16,2,567,563,4,15185,15129,56,128,126,2,2,100,NoArch
59f7bd42b4a2116dbbff57380637e08fb644be47,383,7846,34591,26745,42437,17,168,185,389,168,1,67,7.039741652,95820,1,14,1,11128,16437,5309,306060,623352,317292,4412,7438,3026,2,84.69700542,Arch
bb8b2aa7805c40443331b6484b72c69f0303b473,383,34587,7839,26748,42426,192,13,205,465,213,1,67,7.038942729,69075,1,210,2,16438,11128,5310,623369,306060,317309,7438,4412,3026,0,84.69700542,Arch
9e7b717cf60cb40216eca5b53b1d80abfca570dc,1,8,0,8,8,1,0,1,53,17,1,1,0,1283,6,211,3,246,243,3,6307,6248,59,92,92,0,0,100,NoArch
ee5a613ec7144c1cec33fd32e9c4b887090a97b0,383,7872,34633,26761,42505,17,170,187,390,168,1,67,7.035514966,95831,1,16,4,11129,16441,5312,306040,623428,317388,4412,7438,3026,3,84.69700542,Arch
a121fbf9f81d40c563cd2468e8f76b951b65b7be,383,34592,7836,26756,42428,192,13,205,466,213,1,67,7.039124436,69070,1,34,19,16442,11129,5313,623408,306040,317368,7438,4412,3026,3,84.69700542,Arch
4004808230c9c439a80de6be8ee9cb9c3c5d93b8,383,7843,34599,26756,42442,17,170,187,390,168,1,67,7.039884117,95826,1,17,5,11129,16442,5313,306040,623408,317368,4412,7438,3026,0,84.69700542,Arch
51db8f991c6de81af6ef344a8cf8fbe99fa5f481,383,34592,7836,26756,42428,192,13,205,466,213,1,67,7.039124436,69070,1,35,20,16442,11129,5313,623408,306040,317368,7438,4412,3026,0,84.69700542,Arch
ee41a8699281726b3af2210249194f9337d65509,0,0,0,0,0,0,0,0,0,0,0,0,0,0,0,283,0,0,0,0,0,0,0,0,0,0,1,100,NoArch
5700ecd697df893e7d5030a41abb2827fe31b05a,383,7866,34603,26737,42469,17,170,187,391,168,1,67,7.038016281,95826,1,18,6,11130,16442,5312,306101,623408,317307,4413,7438,3025,1,84.69700542,Arch
b5a619a6616e5244891abceee28bb2d22dea9ef6,1,26,8,18,34,0,0,0,4,38,1,1,0,54,2,19,7,7,6,1,345,253,92,2,2,0,1,100,NoArch
674f343bfd5729c68d2d3724d07e9996be84a838,1,4,3,1,7,0,0,0,5,0,1,1,0,72,2,20,8,7,7,0,343,345,2,2,2,0,1,100,NoArch
ab66d8e6fbc914288fbb144f0f955b35e0dd123e,0,0,0,0,0,0,0,0,0,0,0,0,0,0,0,21,9,0,0,0,0,0,0,0,0,0,1,100,NoArch
6283567a83246a12e2949ffc8305305f5d7f7883,383,34617,7859,26758,42476,192,13,205,467,211,1,67,7.039536406,69108,1,36,21,16447,11131,5316,623614,306191,317423,7440,4413,3027,2,84.69700542,Arch
9cc952bde670d4cd9425fcabff741eb1312628cd,1,13,1,12,14,0,0,0,4,0,1,1,0,73,2,37,22,7,7,0,343,343,0,2,2,0,0,100,NoArch
d7f0292c8cff91a02a0dbc90f6e69f312189b5d2,1,43,5,38,48,0,0,0,14,76,1,1,0,179,8,264,0,18,16,2,508,410,98,12,10,2,1,99.94046438,NoArch
548bd38832a3806b3b56f51f48a36c93da65803a,383,7869,34677,26808,42546,17,170,187,391,168,1,67,7.044082497,95916,1,22,10,11131,16449,5318,306191,623712,317521,4413,7442,3029,1,84.71698113,Arch
07df4a6b852ec12a5367456b62ee7e89404b1107,383,34672,7864,26808,42536,191,13,204,468,211,1,67,7.04332713,69108,1,38,23,16449,11131,5318,623705,306191,317514,7442,4413,3029,1,84.71698113,Arch
99ff48340e1e0f0cf30ee55702e4c328b8301316,0,0,0,0,0,0,0,0,0,0,0,0,0,0,0,265,1,0,0,0,0,0,0,0,0,0,1,100,NoArch
23f803fb33ba1f8660db5de8e2ba65bb88902a74,1,11,1,10,12,0,0,0,23,153,1,1,0,310,6,17,1,97,94,3,1950,1874,76,17,16,1,1,100,NoArch
709998deaf329a6f6056cff5a174cde0b02d9642,383,7871,34679,26808,42550,17,170,187,391,168,1,67,7.044085038,95926,1,15,1,11134,16452,5318,306267,623781,317514,4414,7443,3029,1,84.71698113,Arch
dae188a4aa73efea3d6a47266a4e1237ec3d82a4,383,34672,7864,26808,42536,191,13,204,468,211,1,67,7.04332713,69118,1,2,0,16452,11134,5318,623781,306267,317514,7443,4414,3029,1,84.71698113,Arch
2e1c1191492e31e1906bb1640bb1e4050483ae82,1,65,11,54,76,0,0,0,469,4,1,1,0,12122,28,39,23,1323,1314,9,35837,35625,212,687,687,0,2,100,NoArch
78802a00fbe2855c589f47f3912402a8623ce674,383,7872,34680,26808,42552,17,170,187,392,168,1,67,7.043946918,95980,1,23,8,11143,16461,5318,306481,623993,317512,4414,7443,3029,2,84.71698113,Arch
14cfdd0fd10634b9b25f6cc8df861d61f0bafb62,383,34678,7868,26810,42546,191,13,204,470,211,1,67,7.042635709,69172,1,40,23,16461,11143,5318,623987,306481,317506,7443,4414,3029,1,84.71698113,Arch
8e7690eb73d2cc04c2735902c937d8663de6d030,383,7872,34680,26808,42552,17,170,187,393,168,1,67,7.043946918,95982,1,24,9,11143,16461,5318,306475,623987,317512,4414,7443,3029,1,84.71698113,Arch
f72296237beeff78510094fb526a8c17faf71f63,383,34697,7865,26832,42562,191,13,204,470,211,1,67,7.045144056,69174,1,18,2,16468,11143,5325,624150,306475,317675,7445,4414,3031,1,84.72581784,Arch
d718e40b0bf3dc2c5ddd98bbbf53ca9202adcee4,383,7874,34682,26808,42556,17,170,187,393,167,1,67,7.044324166,96006,1,16,2,11150,16468,5318,306638,624150,317512,4416,7445,3029,1,87.79238138,Arch
7bba59bf81c3cd6cc6cecbe6eddb3ea2a2105e08,420,37335,9176,28159,46511,194,13,207,471,275,1,72,7.20293131,73409,3,902,0,17301,11724,5577,648890,325807,323083,7945,4774,3171,0,86.44334532,Arch
3519b6fb2cad6bd4ccca03b0e06929f5cc0709f7,7,104,90,14,194,1,0,1,23,0,1,3,2.468163518,2095,3,903,1,372,370,2,11284,11218,66,161,160,1,1,99.7382199,NoArch
bb2c1bf0f10bc0191e34c00ff57e04a527cc4595,0,0,0,0,0,0,0,0,0,0,0,0,0,0,0,266,2,0,0,0,0,0,0,0,0,0,1,100,NoArch
a49644d7513925ffca411f82e52ab85e8649865b,3,9,0,9,9,3,0,3,181,61,1,2,1.392147224,5141,3,212,4,1166,1164,2,28307,28278,29,303,301,2,0,100,NoArch
cb41502eef59c56ff7c20fb159218c65da4c77a3,421,9240,37446,28206,46686,17,173,190,393,166,1,72,7.210472677,101591,4,17,3,11717,17305,5588,325644,648985,323341,4772,7948,3176,1,83.0952381,Arch
c0ceba1e8c276e5ca475a9fddca525832b1c5592,421,37417,9235,28182,46652,195,13,208,471,272,1,72,7.208127843,73385,3,19,3,17298,11717,5581,648822,325644,323178,7946,4772,3174,1,83.08279647,Arch
726970f5e0c64e7e2c41ec93a8bece09fc67b88d,0,0,0,0,0,0,0,0,0,0,0,0,0,0,0,267,3,0,0,0,0,0,0,0,0,0,1,100,NoArch
764b02e1f694f231fbb5325b5688f42fb2f7fc3f,1,4,0,4,4,1,0,1,137,18,1,1,0,2759,13,284,1,556,554,2,14873,14848,25,117,117,0,1,100,NoArch
492eafbfe95f60232c5ed22ff52bd58f86f6ffb4,421,9241,37423,28182,46664,17,174,191,393,166,1,72,7.208880484,101571,4,276,0,11719,17300,5581,325669,648847,323178,4772,7946,3174,1,83.08279647,Arch
84ab8bc90a24f67960f57d6ed88eb6eff3a60b99,422,37432,9253,28179,46685,195,13,208,471,275,1,72,7.209678006,73447,3,285,2,17306,11725,5581,648999,325839,323160,7953,4778,3175,1,83.08279647,Arch
63af96e63a240e2f9520ae948683ff62358152a7,5,23,10,13,33,0,0,0,228,368,1,2,1.877532958,7356,14,828,0,1297,1298,1,40592,40605,13,367,367,0,0,100,NoArch
f8047179ca912e0e17df5679fb17b7aa18f012dc,422,9263,37455,28192,46718,17,174,191,393,167,1,72,7.211554931,101639,4,0,0,11725,17305,5580,325839,648986,323147,4778,7953,3175,1,83.08279647,Arch
2abdca0d21d8db4fd9e7f9b5e1d50ce09ef99284,422,37450,9258,28192,46708,195,13,208,472,278,1,72,7.210675511,73447,3,3,1,17305,11725,5580,648993,325839,323154,7953,4778,3175,1,83.08279647,Arch
920cff6b164b1c11313275a868fbba4f82812b0b,1,29,0,29,29,1,0,1,473,0,1,1,0,12182,28,4,2,1325,1323,2,35914,35845,69,689,687,2,1,100,NoArch
c304a987d5314c474e012b5829b8dbd57ce3b871,2,62,33,29,95,0,0,0,13,569,1,1,0.547246947,457,3,904,2,100,84,16,1991,1847,144,47,42,5,1,100,NoArch
68237f2687fc7be48fd14aff5b8e807a538ba4ab,1,3,1,2,4,0,0,0,3,1708,1,1,0,168,2,286,3,34,34,0,849,840,9,12,12,0,1,100,NoArch
7a9becf283fdfa235dbfe19b374c1f6de98c3eab,1,4,4,0,8,0,0,0,27,1007,1,1,0,226,8,287,4,24,24,0,791,789,2,15,15,0,1,100,NoArch
cc6893e1b6d9a6839332f5cff90500a3836cb87d,425,9298,37550,28252,46848,17,174,191,393,171,1,72,7.217783917,102324,4,277,1,11843,17441,5598,328526,651902,323376,4832,8014,3182,1,83.08279647,Arch
95f6680ebd7ded900957689d18d12e38b602cff5,425,37546,9293,28253,46839,195,13,208,473,267,1,72,7.217065541,74072,3,288,5,17442,11843,5599,651912,328526,323386,8014,4832,3182,1,83.08279647,Arch
f14e66a5be5ace0b526c81290b3db722bab1a753,1,45,29,16,74,0,0,0,31,317,1,1,0,413,8,289,6,58,54,4,1663,1607,56,24,21,3,1,100,NoArch
da0c2304621b6a445025ff60bc5fde1851c34945,425,9299,37552,28253,46851,17,174,191,393,170,1,72,7.217815126,102341,4,278,2,11847,17446,5599,328582,651968,323386,4835,8017,3182,1,83.08279647,Arch
8f4b779eeab3ef5316ea49c07c569c22afe68cd2,425,37578,9293,28285,46871,195,13,208,473,266,1,72,7.218650696,74088,3,829,1,17450,11847,5603,652061,328582,323479,8020,4835,3185,1,83.08279647,Arch
11b307b0bf7ee55b9d5c7586bb18dbbad88073a9,0,0,0,0,0,0,0,0,0,0,0,0,0,0,0,830,2,0,0,0,0,0,0,0,0,0,0,100,NoArch
fec2f6fb6f1bac894e9b05f691b0f934a778d8a5,2,48,8,40,56,0,0,0,67,0,1,2,0.781728122,1074,3,830,2,154,149,5,4842,4698,144,56,54,2,1,98.05537941,NoArch
d1a46bbe60483c4f96a54a7271e20ead7c9cc781,0,0,0,0,0,0,0,0,0,0,0,0,0,0,0,832,4,0,0,0,0,0,0,0,0,0,0,100,NoArch
dbf67e9503e30435f264d8699ef35a066ab686d0,425,9332,37640,28308,46972,17,173,190,393,177,1,72,7.225712444,102413,4,18,4,11854,17455,5601,328659,652205,323546,4835,8022,3187,1,82.6469111,Arch
aa976b5f98b709eb04da994522bc108da9b7d3ad,0,0,0,0,0,0,0,0,0,0,0,0,0,0,0,19,5,0,0,0,0,0,0,0,0,0,1,100,NoArch
7aabe3316935fcf7477c39b45b5a23a200ec7f6a,425,37634,9326,28308,46960,195,13,208,473,265,1,72,7.225220698,74105,3,833,5,17455,11854,5601,652205,328659,323546,8022,4835,3187,0,82.6469111,Arch
354d9278a8789936a8289f9c62b439180f7f8ca8,425,9338,37641,28303,46979,17,174,191,393,177,1,72,7.225920041,102413,4,20,5,11856,17455,5599,328698,652205,323507,4835,8022,3187,1,82.6469111,Arch
60dac0bc0b819f4fcee9a82e841bf0af6d3e4c8e,425,37642,9333,28309,46975,195,13,208,473,265,1,72,7.225320945,74110,3,20,2,17457,11856,5601,652231,328698,323533,8022,4835,3187,1,82.6469111,Arch
987186c9159c51f72f2bea899d778d393a07e319,1,125,136,11,261,0,0,0,7,33,1,1,0,136,3,834,6,15,16,1,513,538,25,6,7,1,0,100,NoArch
a7982b3f6ec0b2f8dcbefa1143b73189ed16dcc3,1,3,3,0,6,0,0,0,15,52,1,1,0,217,9,835,7,19,18,1,527,508,19,12,12,0,1,100,NoArch
42e7c891d4356093257319728a5b53dcba28d8c3,1,2,4,2,6,0,0,0,16,0,1,1,0,217,9,836,8,19,19,0,517,527,10,12,12,0,1,100,NoArch
c83440a1ac4352f248d6351d55164301c579fe26,425,9343,37635,28292,46978,17,173,190,393,177,1,72,7.225243788,102406,4,21,3,11857,17457,5600,328708,652215,323507,4835,8021,3186,1,82.6469111,Arch
96c27392cb8d14f6911332b3901554dadfcfeeaa,1,9,3,6,12,0,0,0,148,1,1,1,0,2726,10,22,4,665,663,2,15749,15722,27,133,133,0,1,100,NoArch
f8dc1ae2e2c90dcd351ceac0fce1368a9922f021,425,37766,9355,28411,47121,195,13,208,473,265,1,72,7.231658599,74120,3,837,4,17467,11859,5608,652757,328735,324022,8027,4835,3192,1,82.6469111,Arch
487f039e1369cc41b288dd8b33938fb138787b63,425,9351,37645,28294,46996,17,174,191,393,174,1,72,7.225977136,102531,4,794,0,11869,17467,5598,329218,652757,323539,4841,8027,3186,1,82.6469111,Arch
4b7bbe063802de4de5ce3eb71d793a416c444b94,425,37570,9350,28220,46920,195,13,208,473,265,1,72,7.224524047,74237,3,838,5,17451,11869,5582,652349,329218,323131,8023,4841,3182,1,82.6469111,Arch
d0ea6660433228182f602444eaf504abf470e39e,0,0,0,0,0,0,0,0,0,0,0,0,0,0,0,839,6,0,0,0,0,0,0,0,0,0,0,100,NoArch
1917a34b3fb61ddf177b9e86f5ea7d14a87e8823,425,9368,37576,28208,46944,17,174,191,393,174,1,72,7.224510759,102457,4,23,3,11872,17451,5579,329317,652349,323032,4841,8023,3182,1,82.67202411,Arch
7c5c159ec211cae207bed1198da8022de09e27bd,425,37570,9362,28208,46932,195,13,208,473,265,1,72,7.224009186,74249,3,840,7,17451,11872,5579,652349,329317,323032,8023,4841,3182,0,82.67202411,Arch
1b74a24b5f22124add60da1f2b4b4247e21243e5,425,9368,37576,28208,46944,17,174,191,393,174,1,72,7.224510759,102457,4,596,0,11872,17451,5579,329317,652349,323032,4841,8023,3182,0,82.67202411,Arch
40d8d8beb3141359a1e5939bfed61bcc91ae2320,1,2,2,0,4,0,0,0,10,1,1,1,0,284,5,597,1,26,26,0,1115,1111,4,13,13,0,0,100,NoArch
aaffe721eb51ad7986f30209dd245017025ed565,425,37572,9364,28208,46936,195,13,208,473,265,1,72,7.224367991,74249,3,905,0,17451,11872,5579,652349,329321,323028,8023,4841,3182,0,82.67202411,Arch
66ef14134f9b743e7bd8c032587f8e98e6ba43d6,25,309,47,262,356,8,0,8,55,591,1,11,3.663089818,5248,3,906,1,918,871,47,24922,23805,1117,439,416,23,0,99.88952718,NoArch
1707283cef2a540d628dcdf017b2dc5b88e12013,436,9406,37876,28470,47282,20,173,193,393,192,1,73,7.236143608,103671,4,795,1,11957,17583,5626,332096,656246,324150,4894,8099,3205,1,82.58906172,Arch
e572c6aa77e83e7bfb0fe6c8b19982995c6e9452,436,37865,9395,28470,47260,199,13,212,473,271,1,73,7.235775152,75201,3,841,8,17583,11957,5626,656246,332096,324150,8099,4894,3205,0,82.58906172,Arch
228a83fff4a9b25daffaf4345bf73935ff7a1ad7,436,9406,37876,28470,47282,20,176,196,393,192,1,73,7.236143608,103671,4,796,2,11957,17583,5626,332096,656246,324150,4894,8099,3205,1,82.58906172,Arch
b10fd0ac8c64e93dfe270289b890822252522502,1,0,1,1,1,0,0,0,394,92,1,1,0,11297,27,797,3,1345,1345,0,36436,36443,7,676,676,0,0,100,NoArch
ac36ba2c039014ae853933e2faf4f1fb16a6aeb9,436,37865,9394,28471,47259,199,13,212,473,271,1,73,7.235838888,75200,3,842,5,17583,11957,5626,656246,332089,324157,8099,4894,3205,0,82.58906172,Arch
400ec55c8377b517acb4d9873d8004d8cfdb7a04,169,9872,4429,5443,14301,81,9,90,698,642,2,47,5.347214784,64491,1,459,50,12013,11190,823,324620,314829,9791,4546,5068,522,0,93.73605948,Arch
8a603158723e33df951646b518df6db6e3fb8cfc,144,3983,7151,3168,11134,9,29,38,692,668,3,52,6.098906598,64839,0,1237,4,9682,10177,495,272832,288604,15772,3428,3553,125,0,97.83158656,Arch
eb9b080f9d1af19b018436054a8ea5ff2d503872,1,128,15,113,143,0,0,0,36,0,1,1,0,547,1,1238,5,99,98,1,3813,3776,37,35,35,0,0,100,NoArch
5b690aa13a99aad08c6163a09cef5b7fbc20b4c3,1,6,5,1,11,0,0,0,37,0,1,1,0,660,1,1239,6,99,99,0,3857,3813,44,35,35,0,0,100,NoArch
d266eee1b9131850bb8f41c828879ab3e7c335ce,1,2,0,2,2,1,0,1,38,0,1,1,0,661,1,1240,7,99,99,0,3857,3857,0,35,35,0,0,100,NoArch
d1e36621ed8bd70383ab747ee76bbec6847cc8ca,1,35,0,35,35,1,0,1,39,0,1,1,0,663,1,1241,8,110,99,11,4016,3857,159,37,35,2,0,100,NoArch
16825ba44ccb4e7f26160780dece169bd2b45f16,144,7155,4133,3022,11288,35,0,35,698,286,3,52,6.076572274,61822,1,460,47,10179,9694,485,288644,273072,15572,3553,3430,123,0,97.83158656,Arch
318b90efc7589fb24d4456650a8b7e2f5eb0d32c,2,146,0,146,146,2,0,2,4,17,1,1,0.181166402,123,1,461,48,40,14,26,1505,629,876,11,8,3,0,99.9294657,NoArch
6db1b5ad172792b0913defc69d5611aa02d02ed8,38,119,2965,2846,3084,1,21,22,316,107,1,12,4.54858146,17126,1,332,22,3067,3501,434,83375,99876,16501,672,785,113,0,98.71106337,NoArch
3a7f6bf791f408296bf173a0deee7c3a1e0be92a,2,9,3,6,12,1,0,1,4,866,1,2,0.979868757,334,3,332,22,46,44,2,1832,1772,60,30,29,1,0,100,NoArch
0c2c3f55e7997c8bab0b5a1d73ecaf3e8304c58b,0,0,0,0,0,0,0,0,0,0,0,0,0,0,0,334,24,0,0,0,0,0,0,0,0,0,0,100,NoArch
793e59c6ab7f5b0c339bfbccb58dae3511301cae,3,3,1,2,4,2,0,2,317,49,1,2,1.5,4269,10,335,24,840,835,5,27718,27688,30,193,193,0,1,100,NoArch
fbf9ad8bf020db09a6a54d0d47a8553c3ff3c90b,144,4348,7102,2754,11450,35,10,45,698,805,2,42,4.735789324,66187,1,59,15,11029,11448,419,308478,302744,5734,4997,4366,631,1,94.54202077,Arch
83148d6fef697e242a1a4990651c60d7f55b39aa,171,10029,4433,5596,14462,82,10,92,698,637,2,47,5.376935827,65251,1,462,48,12227,11379,848,330599,319886,10713,4579,5098,519,0,93.68381943,Arch
14ee19d0f0421de394381370e442dc072e428004,43,143,2990,2847,3133,3,22,25,317,136,2,16,4.619642642,19637,3,1180,4,3552,3993,441,97475,113970,16495,781,893,112,2,98.71106337,NoArch
00b929e840ed6a408283c70cfef4f3126a85d677,144,4347,7100,2753,11447,35,15,50,698,807,2,42,4.735858917,66182,1,1127,4,11022,11436,414,308450,302696,5754,4997,4366,631,2,94.54202077,Arch
6dce89ea4fda87048332bcd479c1127b972baab0,171,10058,4439,5619,14497,82,10,92,698,637,2,47,5.377862321,65247,1,463,49,12231,11372,859,330679,319858,10821,4582,5098,516,0,93.99029489,Arch
ec86c76065e7e19b4d352a76d0d21b9a0b802253,8,45,22,23,67,4,0,4,328,454,2,7,2.369340123,6428,3,471,57,1231,1233,2,37131,36978,153,328,325,3,0,100,NoArch
0723a0257daeb1750f1866d3dd6a7fb1cb64785c,37,108,2988,2880,3096,0,22,22,317,66,1,10,4.520945535,16777,1,336,25,2988,3428,440,83300,99954,16654,621,739,118,1,98.48948031,NoArch
cdcb8feaf9daf8eaae29d804a72bdda4065b038e,37,2987,98,2889,3085,26,0,26,328,55,1,10,4.520704874,13897,1,472,58,3431,2988,443,100028,83300,16728,739,621,118,1,98.48948031,NoArch
73cd84455c2293dbb82eefdff64f5e01025283d7,0,0,0,0,0,0,0,0,0,0,0,0,0,0,0,473,59,0,0,0,0,0,0,0,0,0,0,100,NoArch
41723960982b0001361ac8ae53a5adf155e7f4e8,1,52,0,52,52,1,0,1,14,3,1,1,0,375,1,474,60,80,63,17,3156,2806,350,11,8,3,0,100,NoArch
5e807cf20b30de4df0b83cefcf935cc2212e2514,1,16,4,12,20,0,0,0,329,0,1,1,0,2089,18,475,61,385,381,4,13664,13593,71,113,112,1,0,100,NoArch
ff6c9277b48b5a9538da4eaf60a770dae8b7d141,39,1066,3393,2327,4459,1,21,22,317,62,1,11,4.344773426,17360,1,343,31,3224,3565,341,90585,103656,13071,683,781,98,0,98.09713664,NoArch
1e3ea1d72b7f8ee6a91d51947ff6f6cc89e7955e,37,3055,102,2953,3157,26,0,26,329,55,1,10,4.514615622,13897,1,484,68,3452,2988,464,100449,83300,17149,743,621,122,0,98.44748858,NoArch
df5e19fb8ec61c98406ee699212a07ef53733530,0,0,0,0,0,0,0,0,0,0,0,0,0,0,0,485,69,0,0,0,0,0,0,0,0,0,0,100,NoArch
2d4f5cd282fb1beb907fa486eaf8b783d66fc71c,150,4547,8438,3891,12985,9,31,40,692,666,3,53,6.071465639,67390,0,1242,9,9947,10604,657,281598,302767,21169,3516,3675,159,0,97.51325654,Arch
a175626b8aabac6f4f8cd885fe99195b5d31a5c2,120,5468,4480,988,9948,12,1,13,698,361,3,49,5.599668639,58030,1,344,26,9069,8858,211,255540,251104,4436,3281,3243,38,1,98.6681465,NoArch
7bebe355a9fc32bea05c05f5906e795abb175049,37,3055,102,2953,3157,26,0,26,329,54,1,10,4.514615622,13947,1,486,54,3470,3006,464,100865,83716,17149,744,622,122,1,98.44748858,NoArch
c29ad7ff069d8877a77acf15a9dd6667e4907a05,38,106,3060,2954,3166,0,22,22,317,63,1,11,4.529922295,17658,1,2006,21,3192,3656,464,88751,105904,17153,652,774,122,1,98.44748858,NoArch
107e51efc07d16d7ed6a0d89237023acf3ec95f9,146,4685,8123,3438,12808,35,11,46,698,799,2,42,4.818685423,67377,1,1974,18,11135,11693,558,311657,310471,1186,5035,4429,606,1,94.05940594,Arch
efb8d08aa565028199321231804dec5a42cf46d8,406,21318,16606,4712,37924,252,57,309,704,580,2,99,6.863011328,94127,1,2033,28,15649,14933,716,434013,429381,4632,6531,7078,547,0,81.11339436,Arch
d461619bec5e4591942c5270ad7c3c0a160f8f92,273,9007,10281,1274,19288,168,73,241,698,605,2,74,6.464580557,65339,0,2007,21,8794,8952,158,253284,259102,5818,3782,3841,59,0,86.75857065,Arch
4a9115ba15cb66478be796a9b3732014560092b0,146,4685,8123,3438,12808,35,18,53,698,799,2,42,4.818685423,67378,1,1975,19,11135,11693,558,311657,310471,1186,5035,4429,606,0,94.05940594,Arch
77f3d1ab2e24779e75c4f803be8d5c992a6a7c7f,406,21318,16606,4712,37924,252,66,318,704,580,2,99,6.863011328,94136,1,2034,29,15649,14933,716,434013,429381,4632,6531,7078,547,0,81.11339436,Arch
3e05f0f2d622920993986b60cfb6a1bb7198394d,275,9293,10550,1257,19843,169,73,242,698,593,2,75,6.500308855,65339,0,2008,22,8795,8952,157,253380,259102,5722,3783,3841,58,1,86.72710789,Arch
e31c763a3b7c221d2e716d0fe15e48528c54bcec,2,27,45,18,72,0,0,0,5,5270,1,1,0.681290887,166,1,2009,23,8,12,4,521,649,128,8,12,4,0,99.81505456,NoArch
6aec76770a493b6705b6f37c19da9573d638876f,148,4685,8140,3455,12825,35,19,54,698,792,2,43,4.827308059,67664,1,1976,20,11164,11723,559,312551,311461,1090,5058,4453,605,0,93.84175405,Arch
7e920b096a66bd638e46535bcaa010983200c1b2,2,17,0,17,17,2,0,2,9,28,1,2,0.322756959,269,1,1977,21,30,29,1,990,894,96,24,23,1,1,99.78367748,NoArch
6179aaed22d37721414fe7a4716ea089bca922d6,406,21318,16606,4712,37924,252,66,318,704,580,2,99,6.863011328,94138,1,2038,33,15649,14933,716,434024,429392,4632,6531,7078,547,0,81.06386964,Arch
e48dc9404ee286461e5385122f99dcf597ee52a5,273,9007,10281,1274,19288,168,73,241,698,600,2,74,6.464580557,65341,0,2010,24,8794,8952,158,253295,259113,5818,3782,3841,59,0,86.72485907,Arch
1adf82023ee1c6807a3b91d26c87dca06c2c7ac8,146,4685,8123,3438,12808,35,18,53,698,799,2,42,4.818685423,67378,1,1978,22,11135,11693,558,311657,310471,1186,5035,4429,606,0,94.04352806,Arch
5ba3dec26e8b9ca92353161bfbf9aa0acb463318,406,21318,16606,4712,37924,252,66,318,704,580,2,99,6.863011328,94138,1,2040,35,15649,14933,716,434024,429392,4632,6531,7078,547,0,81.06386964,Arch
132e873b1451de2480fb4b5c6efe3839834eef72,273,9007,10281,1274,19288,168,73,241,698,600,2,74,6.464580557,65341,0,2011,25,8794,8952,158,253295,259113,5818,3782,3841,59,0,86.72485907,Arch
59d53109d967d249a130794467e8a3368841c2f0,146,4685,8123,3438,12808,35,18,53,698,799,2,42,4.818685423,67378,1,1979,23,11135,11693,558,311657,310471,1186,5035,4429,606,0,94.04352806,Arch
93e4ef293fb235efb3909396ec3a22414381121a,146,8122,4684,3438,12806,60,10,70,698,770,2,44,4.818267453,63940,1,2012,26,11693,11135,558,310471,311657,1186,4429,5035,606,1,94.04352806,Arch
60b805952ee5ca833a892064544356da5fdaf973,0,0,0,0,0,0,0,0,0,0,0,0,0,0,0,2013,27,0,0,0,0,0,0,0,0,0,1,100,NoArch
851159451e555562819bd1dc9c8e04a01ef28f4c,0,0,0,0,0,0,0,0,0,0,0,0,0,0,0,2014,28,0,0,0,0,0,0,0,0,0,1,100,NoArch
cd1e833aa24b401608bfec3c75e9a51fe4f2b928,146,4685,8123,3438,12808,35,19,54,698,799,2,42,4.818685423,67378,1,1980,24,11135,11693,558,311657,310471,1186,5035,4429,606,1,94.04352806,Arch
af5ce0c2928a4552614ac0704530752ec30e499b,0,0,0,0,0,0,0,0,0,0,0,0,0,0,0,1981,25,0,0,0,0,0,0,0,0,0,1,100,NoArch
67afb8cf429d33f2d5ca4e76b89d9a12f0ede9c3,0,0,0,0,0,0,0,0,0,0,0,0,0,0,0,1982,26,0,0,0,0,0,0,0,0,0,1,100,NoArch
fc44e0ff19308fec6a363f749534b6be8f66f4af,147,8124,4686,3438,12810,60,10,70,698,771,2,44,4.820849556,64470,1,2015,28,11842,11283,559,313794,314972,1178,4456,5062,606,1,94.04352806,Arch
51e954939385d1ea25c447198260e0d43340544b,146,4685,8123,3438,12808,35,19,54,698,799,2,42,4.818685423,67378,1,1983,26,11135,11693,558,311657,310471,1186,5035,4429,606,1,94.04352806,Arch
403aac08c70d11322699e1b54ea51ff4793fa7d9,1,10,1,9,11,0,0,0,71,7,1,1,0,757,10,1984,27,188,186,2,5085,5035,50,31,30,1,1,100,NoArch
bb7b52749cac881521b236c19043f10bec580e15,1,0,2,2,2,0,0,0,66,17,1,1,0,1074,16,1985,28,170,170,0,4169,4187,18,60,60,0,1,100,NoArch
ce58e5d9904643b1a09a28165bb13bd085d81cfb,146,8124,4684,3440,12808,60,10,70,698,770,2,44,4.819402536,63938,1,2016,29,11693,11135,558,310471,311639,1168,4429,5035,606,1,94.04352806,Arch
7d045c229e5d84e3aea9a2d60e4fa4fde50906b4,1,0,2,2,2,0,0,0,66,17,1,1,0,1074,16,2017,30,170,170,0,4169,4187,18,60,60,0,1,100,NoArch
4c5c29d76e0d16a144e42b21bec3eec2fff38caa,1,1,1,0,2,0,0,0,67,0,1,1,0,1072,16,2018,31,170,170,0,4169,4169,0,60,60,0,1,100,NoArch
82c23853b2aa41d1db7f47300d1ec10da0942a8d,146,4685,8123,3438,12808,35,19,54,698,798,2,42,4.818685423,67376,1,1986,29,11135,11693,558,311639,310453,1186,5035,4429,606,1,94.04352806,Arch
4d1c9ab57ef68b70c4943bcf24ba851fd5f4f2a9,147,8132,4694,3438,12826,60,10,70,698,767,2,45,4.827542609,67622,1,2019,32,12063,11505,558,320835,322021,1186,4637,5243,606,1,94.04352806,Arch
6d027d35d7434aed177f31057b1ee60c404c3d90,0,0,0,0,0,0,0,0,0,0,0,0,0,0,0,2020,33,0,0,0,0,0,0,0,0,0,1,100,NoArch
802e9c6e26e290a28bb7071cfb109cf0d9f668be,0,0,0,0,0,0,0,0,0,0,0,0,0,0,0,2021,34,0,0,0,0,0,0,0,0,0,1,100,NoArch
84f034bf972298e4e90ecfa283f255c6fed6235a,3,18,10,8,28,2,0,2,103,288,1,3,1.148834854,5020,5,345,27,590,587,3,15722,15691,31,299,298,1,1,100,NoArch
16a74d0ac5adbe5bc44073e7ba2950fba91f7b2d,146,4685,8123,3438,12808,35,19,54,698,799,2,42,4.818685423,67384,1,60,13,11138,11696,558,311670,310484,1186,5036,4430,606,1,94.04352806,Arch
07ce6e2bd3505d747c38880485bb825cd41419cb,146,8122,4684,3438,12806,60,10,70,698,770,2,44,4.818267453,63946,1,0,0,11696,11138,558,310484,311670,1186,4430,5036,606,1,94.04352806,Arch
dc249643093da2bc2c2c49a89bb7638ebc0e8630,1,5,0,5,5,1,0,1,16,1471,1,1,0,102,4,1,1,16,16,0,579,553,26,8,8,0,1,100,NoArch
591c350c6e8fd7ea58b2e575c6837b2f1a7da072,4,10,23,13,33,0,0,0,104,299,1,4,1.588387987,5135,4,2022,35,603,606,3,16244,16301,57,306,307,1,1,100,NoArch
4d0616db8af50bb19240bfb4e5ae92c23ef241e1,2,8,0,8,8,2,0,2,68,433,1,2,1,1336,5,2023,36,220,217,3,5340,5309,31,91,90,1,0,100,NoArch
f3810b2796ed7a12b13eee1903042637482812e3,0,0,0,0,0,0,0,0,0,0,0,0,0,0,0,2024,36,0,0,0,0,0,0,0,0,0,0,100,NoArch
537dda1f761e49996054c7489985d0c0f17db91a,125,4560,5556,996,10116,9,10,19,692,788,3,51,5.658423735,59992,0,1243,10,9066,9279,213,256245,260679,4434,3312,3349,37,0,98.46267827,NoArch
dae67b709c4cc545a6f1c82b10e8ba2f8694238f,125,5553,4557,996,10110,13,1,14,698,428,3,51,5.661065607,58996,1,2025,37,9279,9066,213,260679,256245,4434,3349,3312,37,1,98.46267827,NoArch
fea88aec7562c6dcdcc418e359facaf5b5dfc0cd,1,1,0,1,1,1,0,1,56,184,1,1,0,571,8,1181,5,169,169,0,3828,3812,16,49,49,0,1,100,NoArch
892733f19edc72ada3abb66ec52436dcb3ca61d2,3,46,23,23,69,0,0,0,217,92,1,3,0.970600371,7711,8,346,27,1399,1396,3,34362,34224,138,429,429,0,1,100,NoArch
f1d6190588a67ac5dd54f40a638730770d7c0a1e,2,11,10,1,21,1,0,1,104,138,1,2,0.276195428,4255,8,346,27,539,539,0,14210,14194,16,257,257,0,1,100,NoArch
044e9fc2f3e186446ac8cb5ee9fe562a5d1662c1,0,0,0,0,0,0,0,0,0,0,0,0,0,0,0,348,29,0,0,0,0,0,0,0,0,0,0,100,NoArch
63a30a5e06d1dda0ad1d32ff51e2e9ae017ba13c,147,4695,8134,3439,12829,35,12,47,698,788,2,43,4.828353606,71093,1,61,11,11511,12069,558,322206,321036,1170,5244,4638,606,1,94.04352806,Arch
be61849e2c618db1d2859111f228d3b14c1dd55f,148,8149,4730,3419,12879,61,10,71,698,775,2,46,4.843884227,67756,1,2026,37,12082,11527,555,321445,322759,1314,4646,5252,606,0,94.04352806,Arch
0aafa7374bdbf9bad52f90d209ec21729b58213d,2,17,5,12,22,0,0,0,28,501,1,2,0.945660305,604,4,2027,35,82,79,3,2485,2433,52,36,35,1,1,100,NoArch
b5eb8772ceaafea3c561fdcaab378e1f7c688808,2,37,12,25,49,1,0,1,217,103,1,2,0.14372617,4026,8,2028,36,1029,1026,3,23996,23826,170,221,221,0,0,100,NoArch
15683c26b710547e2ea6966253fd3e0e403d73ff,148,4695,8135,3440,12830,35,19,54,698,791,2,44,4.829153412,71200,1,1987,25,11529,12087,558,322809,321639,1170,5252,4646,606,0,94.04352806,Arch
6e77c99c6c3cb081a79dcd45e99f71a226868921,148,8134,4694,3440,12828,61,10,71,698,766,2,46,4.828737405,67760,1,2029,37,12087,11529,558,321639,322809,1170,4646,5252,606,1,94.04352806,Arch
b2c07cc791126607cf0219da5f8d07ae2e8f8337,0,0,0,0,0,0,0,0,0,0,0,0,0,0,0,1182,5,0,0,0,0,0,0,0,0,0,1,100,NoArch
7546c0fb7dd36e9e5eec9e57a1ae3d840caa98bd,148,4695,8135,3440,12830,35,19,54,698,791,2,44,4.829153412,71200,1,1128,5,11529,12087,558,322809,321639,1170,5252,4646,606,1,94.04352806,Arch
5df839b9a5a9487e22565d8a185d9e9d3637f03b,148,8134,4694,3440,12828,61,10,71,698,766,2,46,4.828737405,67760,1,349,30,12087,11529,558,321639,322809,1170,4646,5252,606,0,94.04352806,Arch
0f4fea09e7bdb7ce51dcd32a0e13e32c074763ae,148,4695,8135,3440,12830,35,19,54,698,791,2,44,4.829153412,71200,1,62,11,11529,12087,558,322809,321639,1170,5252,4646,606,0,94.04352806,Arch
40ad6622f878c7aaa5f666f7db9eeb685b6ca8ab,149,8136,4696,3440,12832,61,10,71,698,757,2,46,4.83131259,68269,1,2030,38,12152,11593,559,323527,324691,1164,4674,5280,606,1,94.04352806,Arch
c6176ca13b805e942910b6cbb65eb70e93d3ce21,0,0,0,0,0,0,0,0,0,0,0,0,0,0,0,2031,39,0,0,0,0,0,0,0,0,0,0,100,NoArch
456e6a6ef2f27f6a78b5a3c4b5e1287333efb622,1,8,3,5,11,0,0,0,105,3,1,1,0,3684,9,2032,40,370,370,0,10408,10382,26,208,208,0,1,100,NoArch
f3256a58dda1a8e104e7dc34b86202bf931529b1,0,0,0,0,0,0,0,0,0,0,0,0,0,0,0,2033,41,0,0,0,0,0,0,0,0,0,0,100,NoArch
a36ac72ba87146ff55c9d59cace6b23f299cc0bb,148,4698,8143,3445,12841,35,19,54,698,791,2,44,4.832714958,71205,1,1988,26,11529,12087,558,322809,321665,1144,5252,4646,606,1,94.04352806,Arch
ba74fdd8820c4d5dea39d314cb3f7569bb4a10fe,0,0,0,0,0,0,0,0,0,0,0,0,0,0,0,1989,27,0,0,0,0,0,0,0,0,0,0,100,NoArch
6dcf3ad69a0e696c1a7e4da4b3e582e528d8423c,0,0,0,0,0,0,0,0,0,0,0,0,0,0,0,1990,28,0,0,0,0,0,0,0,0,0,0,100,NoArch
677fa85400347b5d12b5bf6e38cad28ead168c24,148,8159,4697,3462,12856,61,10,71,698,766,2,46,4.83113251,67760,1,350,30,12092,11529,563,321759,322809,1050,4648,5252,604,0,94.04352806,Arch
4295757bba1eca7fdaba67fe7166e78cb4168f2b,0,0,0,0,0,0,0,0,0,0,0,0,0,0,0,530,4,0,0,0,0,0,0,0,0,0,1,100,NoArch
d59c3b03fb57e638a3b28d04301037ed9d488b33,148,4698,8160,3462,12858,35,19,54,698,791,2,44,4.831547728,71222,1,522,5,11529,12092,563,322809,321759,1050,5252,4648,604,1,94.04352806,Arch
732cfddd4216a2bbf1e1b73e1c4e50195eff2ced,150,8293,4697,3596,12990,63,10,73,698,749,2,46,4.873513986,67760,1,0,0,12101,11529,572,322317,322809,492,4651,5252,601,1,93.9717665,Arch
45d9e6d9c837b38cc0730bb8e02327de8a75e1d4,148,4698,8160,3462,12858,35,19,54,698,791,2,44,4.831547728,71222,1,0,0,11529,12092,563,322809,321759,1050,5252,4648,604,1,94.03354937,Arch
c31efd511272a2b3fa777bff11344a1210190419,148,8159,4697,3462,12856,61,10,71,698,766,2,46,4.83113251,67760,1,351,23,12092,11529,563,321759,322809,1050,4648,5252,604,1,94.03354937,Arch
c146b063b0ca7a82b3d664007f8525262558e8d3,4,46,14,32,60,0,0,0,699,1290,1,2,1.452793631,19736,3,352,22,2262,2258,4,59252,59189,63,1041,1039,2,1,100,NoArch
a4680da2db9a16eaf585ec41b9c969f41e5e1b19,37,3055,102,2953,3157,26,0,26,329,54,1,10,4.514615622,13947,1,496,47,3470,3006,464,100865,83716,17149,744,622,122,0,98.66982507,NoArch
5477683f0b85cf29a706902ac6426f14cfbc5cd1,2,93,43,50,136,1,0,1,7,714,1,2,0.583468025,290,3,1,1,39,36,3,1789,1723,66,11,7,4,1,99.51307484,NoArch
6ebdc8519a3505047193758b7aea47fa2fa742bd,2,43,93,50,136,0,0,0,6,230,1,2,0.583468025,340,2,497,47,36,39,3,1723,1789,66,7,11,4,0,99.51307484,NoArch
7458cab47f46ee528c55d9542466f478d768a3a3,1,12,0,12,12,1,0,1,32,95,1,1,0,398,4,498,47,79,67,12,2590,2518,72,27,27,0,0,100,NoArch
7ea34e3211aa40befe704229df850b7ab9c2317c,0,0,0,0,0,0,0,0,0,0,0,0,0,0,0,499,47,0,0,0,0,0,0,0,0,0,0,100,NoArch
31caeb28f28817b6a898ce766473334152cb70ae,2,93,43,50,136,1,0,1,7,714,1,2,0.583468025,290,3,2034,38,39,36,3,1789,1723,66,11,7,4,0,99.51307484,NoArch
64837e008a720521618684974ad01a17f7c15395,6,101,131,30,232,0,0,0,49,358,1,2,1.804818234,1111,3,2035,38,139,140,1,5721,5923,202,41,45,4,2,96.49615889,Arch
d8aba22987983db7d631cafb32b7daf98d5210f5,2,62,32,30,94,0,0,0,9,398,1,1,0.520737569,424,3,2036,38,89,85,4,3384,3234,150,40,36,4,1,96.13950019,Arch
ef86419bd5916248a082d959b12e749f71f63efc,1,51,31,20,82,0,0,0,13,700,1,1,0,203,5,2037,39,26,26,0,1696,1521,175,12,12,0,1,100,NoArch
28fc2160812e452896ad2beb6490ecd89fd49d3c,178,4790,11299,6509,16089,33,38,71,698,668,2,47,5.458067481,76784,1,1991,24,12066,13115,1049,337510,353758,16248,5411,4935,476,1,93.26201201,Arch
bdfc34a4f551a7221538679b0eef5b061c2516f0,179,11299,4790,6509,16089,85,10,95,699,658,2,50,5.458015255,70366,1,2038,40,13124,12075,1049,354229,337981,16248,4938,5414,476,0,93.26201201,Arch
40b2449af4ed89ee34da28c389effcc2c40b1739,179,4795,11290,6495,16085,34,41,75,698,668,2,47,5.456735142,76875,1,1992,25,12077,13124,1047,338104,354229,16125,5416,4938,478,1,93.26201201,Arch
656ac2387069ad574727c39f0d53e5450e21f6f9,0,0,0,0,0,0,0,0,0,0,0,0,0,0,0,1993,26,0,0,0,0,0,0,0,0,0,0,100,NoArch
1efa5d7566cb81e15d30036630d360dbe9715f21,179,11316,4796,6520,16112,85,10,95,699,658,2,50,5.462865139,70380,1,2039,37,13126,12077,1049,354302,338104,16198,4940,5416,476,1,93.26201201,Arch
4994631f15839673cf8643371c72ee1506d5e32d,76,3309,2272,1037,5581,9,0,9,701,1085,2,25,5.064392214,42617,3,1252,8,6704,6549,155,187615,182040,5575,2340,2284,56,0,99.85637343,NoArch
82afc0e5aa40cf15efe5025c896952ff64074065,232,6941,14473,7532,21414,30,37,67,698,580,3,55,6.095662278,83753,1,1994,20,12971,14173,1202,368482,390182,21700,5785,5363,422,1,93.20570571,Arch
954e5175a7b3c4749bf0063a98612db2ae0ca2d2,182,11470,4953,6517,16423,85,10,95,699,658,2,50,5.520691395,71126,1,2040,34,13225,12175,1050,358609,342240,16369,4970,5445,475,2,93.26201201,Arch
052ed0afc271acc1e4f77b05eac8b00bdbf45a04,7,190,214,24,404,0,0,0,94,473,1,4,2.132041501,3041,6,2,2,415,415,0,14535,14699,164,161,163,2,1,100,NoArch
38b1c94ed0ce70d01dfbfb5376d2ee8bc6562210,8,301,204,97,505,1,0,1,95,364,1,5,2.454864306,3147,7,2,2,431,415,16,15175,14622,553,166,161,5,1,100,NoArch
79eb2b72b67379ab50c0dd7f939b49b5d8865480,182,4948,11467,6519,16415,35,41,76,698,665,2,47,5.51778642,77716,1,1,1,12191,13241,1050,342572,358998,16426,5448,4973,475,1,93.26201201,Arch
6ad91cdbb8b16a964e22dae7d98ba4bc0507f55d,183,11480,4958,6522,16438,85,10,95,699,649,2,50,5.525686841,71420,1,2041,35,13267,12217,1050,360690,344268,16422,4985,5460,475,0,93.26201201,Arch
5c7c02d32099fe8228f9820ab9178cbab5df2125,1,1,0,1,1,1,0,1,16,56,1,1,0,366,1,500,18,86,86,0,2650,2632,18,17,17,0,0,100,NoArch
32c60461c91ee806c0ae7695e8ef3b05a25daf3a,1,31,8,23,39,0,0,0,12,2139,1,1,0,155,5,501,19,29,24,5,871,718,153,12,9,3,1,100,NoArch
24ba7ae0718a09da615f6eff81f8d5312eccfa52,183,4958,11481,6523,16439,35,40,75,698,664,2,47,5.525735608,77943,1,2,2,12217,13267,1050,344268,360708,16440,5460,4985,475,1,93.26201201,Arch
e098d8f91d54eaaad5280b43c5290f37e1f92227,183,11486,4958,6528,16444,85,10,95,699,649,2,50,5.525630997,71420,1,502,19,13270,12217,1053,360756,344268,16488,4985,5460,475,0,93.26201201,Arch
9f0d5b2033644df55041d7c294a996f18c3611ed,0,0,0,0,0,0,0,0,0,0,0,0,0,0,0,2042,36,0,0,0,0,0,0,0,0,0,0,100,NoArch
9c860550fb394990dc54a837c4518ca5f0962a15,183,4958,11486,6528,16444,35,41,76,698,664,2,47,5.525682095,77948,1,1995,21,12217,13270,1053,344268,360756,16488,5460,4985,475,0,93.26201201,Arch
b3169cabac09d34a53be4974093c3a84c7d0f04c,184,11487,4959,6528,16446,85,10,95,699,649,2,50,5.526716054,71477,1,503,17,13279,12226,1053,361070,344578,16492,4986,5461,475,0,93.26201201,Arch
2199693f7ef87e4de724e3cecd9f214f28331514,2,5,3,2,8,0,0,0,330,23,1,2,0.811278124,2470,1,504,18,472,472,0,16362,16342,20,130,130,0,0,100,NoArch
feaf687f3d2f3b4804405db1f36efeefdb453d68,1,1,1,0,2,0,0,0,172,45,1,1,0,2331,1,505,19,667,666,1,15470,15464,6,80,80,0,0,100,NoArch
7bf40ceabbeb507acd151fe1187d843489c1998c,185,5002,11494,6492,16496,35,39,74,698,656,2,47,5.539233582,79308,1,10,0,12427,13468,1041,350284,366608,16324,5562,5083,479,2,93.26201201,Arch
07bc37f4fd85a0ed5689e7a46fd0a814d768a9ff,1,18,18,0,36,0,0,0,58,0,1,1,0,1339,7,11,1,201,201,0,5720,5706,14,101,101,0,1,100,NoArch
63d22d8d08016a3cd0c0b8ac8b31f3319a36d9c1,185,11508,4978,6530,16486,85,10,95,699,642,2,50,5.537292406,72816,1,9,0,13481,12427,1054,366802,350298,16504,5087,5562,475,2,93.26201201,Arch
8c8a1fda63dcc5a9255c1af4b1e01bc52a1254fb,1,18,18,0,36,0,0,0,58,0,1,1,0,1339,7,10,1,201,201,0,5720,5706,14,101,101,0,1,100,NoArch
c3a136b88b67de5ef29ce040746c9a7f55122908,7,107,68,39,175,1,0,1,700,92,1,7,1.757977354,25007,13,2,0,3302,3310,8,92064,92099,35,1320,1321,1,1,100,NoArch
bff060f89ca8b156439ddc362596ea93d1e84cd0,4,7,5,2,12,0,0,0,330,110,1,4,1.79248125,4858,1,2043,37,1148,1147,1,32146,32116,30,211,211,0,0,100,NoArch
622f414fb9c0bf244ca46068e96e48c5649f7128,185,5020,11512,6492,16532,35,39,74,699,656,2,47,5.544659403,79372,1,2,0,12433,13474,1041,350499,366809,16310,5565,5086,479,1,93.26201201,Arch
4b501b77299aec61c9716ac598f5ca0297155e8a,184,11490,4960,6530,16450,85,10,95,700,649,2,50,5.526912905,71541,1,11,2,13286,12232,1054,361297,344779,16518,4989,5464,475,0,93.26201201,Arch
1a617351e54b63f11209f491771383ebd10a8db0,184,4964,11491,6527,16455,35,41,76,700,659,2,47,5.527896983,78071,1,1996,22,12232,13286,1054,344782,361297,16515,5464,4989,475,1,93.26201201,Arch
1b939002402524828c92dd13edc06748edbaff1d,184,11490,4960,6530,16450,85,10,95,701,649,2,50,5.526912905,71544,1,2044,38,13286,12232,1054,361300,344782,16518,4989,5464,475,1,93.26201201,Arch
3d898f3f6b151bb4943a897e4a8d8dc04a3245ca,2,4,0,4,4,2,0,2,2,18,2,2,1,134,2,4,4,9,9,0,558,558,0,3,3,0,1,100,NoArch
1cdfa213b9a6ae0a103cf23d5a9fae1632585e8d,184,4960,11490,6530,16450,35,41,76,700,659,2,47,5.526963985,78076,1,3,3,12232,13286,1054,344782,361300,16518,5464,4989,475,1,93.26201201,Arch
797f814fa2b7dacd1136cdccdba956b290e724f0,184,11490,4960,6530,16450,85,10,95,701,649,2,50,5.526912905,71546,2,531,1,13286,12232,1054,361300,344782,16518,4989,5464,475,1,93.26201201,Arch
42af63b4191d9b1052cfe61113b5a25da347b1e7,184,4960,11490,6530,16450,35,41,76,700,659,2,47,5.526963985,78076,1,523,1,12232,13286,1054,344782,361300,16518,5464,4989,475,1,93.26201201,Arch
c16e72ee04a5225254135a2c54b6ed06f56136d2,185,11492,4962,6530,16454,85,10,95,701,646,2,50,5.5288387,71823,2,532,2,13316,12262,1054,362502,345984,16518,4993,5468,475,1,93.26201201,Arch
62c60c849f98ad5b65d98bfa4dacb2b54470d6a2,184,4960,11490,6530,16450,35,41,76,700,659,2,47,5.526963985,78076,1,524,2,12232,13286,1054,344782,361300,16518,5464,4989,475,1,93.26201201,Arch
8070e6bba8b8bc91495ef4d8f2f7018399d51178,187,16432,8775,7657,25207,86,10,96,702,634,2,50,4.919961366,72316,2,2045,38,13575,12315,1260,369473,347399,22074,5227,5497,270,0,93.13191968,Arch
5b9263f50613a7714f5ef056d59d169baf3c412b,1,2,2,0,4,0,0,0,4,878,1,1,0,277,1,2046,39,30,30,0,1202,1202,0,4,4,0,0,100,NoArch
f0ca6893aa56551c90f58488d0ba3f8d0d74e483,34,5195,4038,1157,9233,3,0,3,703,1005,2,17,2.115597042,29489,3,2047,32,3869,3690,179,113086,106774,6312,2018,1839,179,0,99.53430056,NoArch
bc726169ee4422954e613776ab0f98b2c00fd7c8,2,39,8,31,47,1,0,1,40,139,1,2,0.784992089,1198,1,506,18,394,385,9,6918,6754,164,42,42,0,1,100,NoArch
84900d791bd0c29074af4bb0b2425ef1f4409cdb,2,2,2,0,4,0,0,0,173,5,1,1,1,3380,2,0,0,1017,1015,2,21374,21360,14,117,117,0,0,100,NoArch
0f40c66917bb68074cb79024d79936164eeb1abf,1,40,34,6,74,0,0,0,14,432,1,1,0,334,6,533,3,49,48,1,1838,1816,22,9,9,0,1,100,NoArch
358dba2d5e273277f646f741c2e84b18528ad030,208,12450,21295,8845,33745,31,41,72,700,682,2,54,4.669178485,85072,1,525,3,12815,14265,1450,367315,395879,28564,5756,5665,91,1,92.71535581,Arch
b28a767455ba5b21411c214bdb5c6e05889f3847,208,21304,12460,8844,33764,89,10,99,703,705,2,57,4.670684467,76227,2,1,1,14264,12815,1449,395879,367315,28564,5665,5756,91,0,92.71535581,Arch
6ce01c1687204788b65a74e8003c1060ef975071,0,0,0,0,0,0,0,0,0,0,0,0,0,0,0,2,2,0,0,0,0,0,0,0,0,0,0,100,NoArch
8141f6098f930f4b8fa5f43d5982aeaa203207f0,124,11220,12760,1540,23980,9,4,13,701,850,3,43,3.683040074,61197,1,1253,4,9366,9654,288,274095,281916,7821,3254,3598,344,0,99.26549624,NoArch
97e5dd69a84537818f0bec597d5b9a8d1a93ba5a,237,6934,14238,7304,21172,32,33,65,700,591,3,56,6.14965771,85784,1,1997,10,13288,14449,1161,378970,399713,20743,5931,5496,435,1,93.20570571,Arch
74e9603031a8f8eb16b9d281e4bbe58feee91819,208,21324,12460,8864,33784,89,10,99,703,705,2,57,4.670197229,76227,2,507,18,14266,12815,1451,395964,367315,28649,5666,5756,90,0,92.71535581,Arch
ed1a070aeb38c1462333341906a19be16315b9be,1,40,34,6,74,0,0,0,14,432,1,1,0,334,6,508,19,49,48,1,1838,1816,22,9,9,0,1,100,NoArch
2a8abafe4ea66e7de95471b40256d2c32444b495,2,2,5,3,7,0,0,0,32,38,1,2,0.863120569,1153,1,509,20,241,241,0,7354,7379,25,64,64,0,0,99.92849482,NoArch
caffb32c660ed36193a6b4f7a59d708b0f0fd8c1,0,0,0,0,0,0,0,0,0,0,0,0,0,0,0,2048,22,0,0,0,0,0,0,0,0,0,1,100,NoArch
d0c2c7c4271ffc0714b12073ffe08c2d9c134df8,126,11260,12823,1563,24083,9,4,13,701,839,3,43,3.706501443,61867,1,1254,3,9482,9773,291,277709,285612,7903,3294,3639,345,0,99.19383733,NoArch
32e11505675a1785b1a3424690d457c27cef0313,2,51,46,5,97,0,0,0,335,124,1,2,0.999309899,3164,18,1255,4,555,543,12,18568,18315,253,170,170,0,0,100,NoArch
0358371a8c1dd6923d2f84a555eafb4390ee8ce3,0,0,0,0,0,0,0,0,0,0,0,0,0,0,0,1256,5,0,0,0,0,0,0,0,0,0,0,100,NoArch
9661d0c5c8e313720e6caf99ffb3dba8510bb960,59,10637,8014,2623,18651,9,0,9,706,579,2,29,2.357361312,42749,2,1257,6,6794,6346,448,195311,181778,13533,2716,2313,403,0,99.35506987,NoArch
a466f24a95bcc179106520cfdea4fe9b2a71ec4d,82,2312,3272,960,5584,3,1,4,703,330,2,28,5.0650322,38896,2,510,17,6445,6594,149,181051,186486,5435,2292,2345,53,0,99.66077486,NoArch
0987bafed077491cf09760a27b08bf6460845322,0,0,0,0,0,0,0,0,0,0,0,0,0,0,0,511,18,0,0,0,0,0,0,0,0,0,1,100,NoArch
0b97d9d2ef8fe8ff9ceb895e208a336080d269f2,76,3258,2193,1065,5451,9,0,9,706,1005,2,25,5.004550754,37427,3,1258,6,6550,6381,169,184259,178376,5883,2333,2275,58,0,99.80385164,NoArch
9b2cbf72b997fa1395b31109d772d79d2d7546a0,271,8363,9369,1006,17732,116,6,122,710,214,3,69,5.813552876,71552,1,2079,15,10675,10846,171,307653,313608,5955,4441,4500,59,0,87.58181497,Arch
8425dc6cbadab28f81905887adb43b809b5d1696,1,349,302,47,651,0,0,0,180,0,1,1,0,2316,3,2080,16,670,664,6,15581,15326,255,81,80,1,0,100,NoArch
b428ac1389cf8ac69c3bcd39b926c6ada0c3851d,202,6362,6503,141,12865,117,6,123,703,789,2,47,4.930991531,50855,1,0,0,6985,6989,4,199565,199748,183,3353,3353,0,0,87.72333274,Arch
8a50a04df986ab1fc4511053ba80d63dff25423f,209,12451,21423,8972,33874,31,32,63,700,677,2,54,4.675550794,85199,1,0,0,12815,14287,1472,367315,396409,29094,5756,5671,85,0,92.70619039,Arch
4cfcd148308258054bcbb293ed1eb5a376e92667,209,21423,12451,8972,33874,90,10,100,703,705,2,57,4.675525988,76227,2,2049,15,14287,12815,1472,396409,367315,29094,5671,5756,85,1,92.70619039,Arch
50e24b755583944792216e6a32df9f0dea61889b,209,12451,21423,8972,33874,31,46,77,700,677,2,54,4.675550794,85199,1,1998,7,12815,14287,1472,367315,396409,29094,5756,5671,85,0,92.70619039,Arch
55ba673e8523e8cb684a76c1cb17eba549939096,209,21423,12451,8972,33874,90,10,100,703,705,2,57,4.675525988,76227,2,2050,16,14287,12815,1472,396409,367315,29094,5671,5756,85,0,92.70619039,Arch
d6010e63a456cce212978d0b66009beb88da746f,196,6483,6272,211,12755,119,4,123,710,190,2,51,4.907051583,50240,1,2083,19,6945,6921,24,197521,196890,631,3341,3336,5,0,87.91519435,Arch
ddb7b75e6bb28b88374156ffd14bac956c692167,196,6239,6485,246,12724,114,6,120,703,816,2,44,4.89842243,50451,1,534,3,6921,6945,24,196890,197521,631,3336,3341,5,0,87.91519435,Arch
a6a2795f5d0a519a0a2fcf6808fcb4c07cb4d3ac,209,12451,21423,8972,33874,31,45,76,700,677,2,54,4.675550794,85199,1,526,3,12815,14287,1472,367315,396409,29094,5756,5671,85,0,92.70619039,Arch
9be2126972971a81f4243207e7e54ad1248db49e,210,21429,12452,8977,33881,90,10,100,703,706,2,58,4.67738706,76581,2,0,0,14317,12845,1472,397901,368776,29125,5688,5773,85,0,92.70619039,Arch
65ce3cab0663a7b1cc94ce0b9f8d2e90230f72c8,2,42,19,23,61,0,0,0,69,26,1,2,0.514091279,1435,17,2051,16,207,202,5,5712,5680,32,79,77,2,1,100,NoArch
4dbc4050fc68e77600f007fb491d44bfe807b624,0,0,0,0,0,0,0,0,0,0,0,0,0,0,0,2052,17,0,0,0,0,0,0,0,0,0,0,100,NoArch
d5a85437bbeb2a6ab5af355f93feb84b14c46734,0,0,0,0,0,0,0,0,0,0,0,0,0,0,0,2053,18,0,0,0,0,0,0,0,0,0,0,100,NoArch
4fd8e8e94c6a29c82a354f471bea30f689baef9f,209,12451,21423,8972,33874,31,46,77,700,677,2,54,4.675550794,85227,1,1999,8,12820,14292,1472,367378,396472,29094,5758,5673,85,1,92.70619039,Arch
20be3259f2709dd36b00f2ef5c835ca768832c02,209,21423,12451,8972,33874,90,10,100,703,705,2,57,4.675525988,76255,2,2054,18,14292,12820,1472,396472,367378,29094,5673,5758,85,0,92.70619039,Arch
53f2561566b69a53c3e1ac2ffbd4f9491e1a57fd,1,44,45,1,89,0,0,0,106,53,1,1,0,3689,9,2055,16,370,370,0,10417,10408,9,208,208,0,1,100,NoArch
7e167f607ad87a52cc6ad52a94815f6ff6c82d40,209,12451,21423,8972,33874,31,46,77,700,677,2,54,4.675550794,85226,1,2001,7,12820,14292,1472,367387,396481,29094,5758,5673,85,1,92.70619039,Arch
245932f2293a28fd2e728d8a3296a7f3bc4004b8,451,39055,29837,9218,68892,268,14,282,710,590,2,106,6.399956033,99291,1,2089,20,17298,15802,1496,486989,457264,29725,7292,7372,80,0,80.32969068,Arch
ab3a28e5f2698924057dc9f72f2324a8dd492c01,196,6249,6487,238,12736,113,7,120,703,816,2,44,4.904636552,50513,1,2056,17,6926,6950,24,196962,197593,631,3338,3343,5,1,87.91519435,Arch
6839b522b3398a5ecc8c3dad386345efaa4c2762,209,12451,21423,8972,33874,31,45,76,700,677,2,54,4.675550794,85234,1,2002,8,12820,14292,1472,367387,396481,29094,5758,5673,85,1,92.70619039,Arch
0c6533e1297fa2272eb91b247de9557d75db54a4,451,39063,29845,9218,68908,268,14,282,710,590,2,106,6.399450559,99299,1,2090,21,17298,15802,1496,486989,457264,29725,7292,7372,80,1,80.32969068,Arch
988674a4e975f0441388f4e06ae69762ddf8aa90,196,6245,6486,241,12731,113,7,120,703,820,2,44,4.902476161,50521,1,535,4,6926,6950,24,196993,197593,600,3338,3343,5,0,87.91519435,Arch
d5c7df5057067c1c3f5e3448be485a173bdb4c74,209,12451,21423,8972,33874,31,45,76,700,677,2,54,4.675550794,85234,1,0,0,12820,14292,1472,367387,396481,29094,5758,5673,85,0,92.70619039,Arch
d09be2dbc424260d0eab7a295dca2fb3b5fa0b98,210,21431,12454,8977,33885,90,10,100,703,703,2,58,4.67823853,76621,2,536,5,14323,12850,1473,397994,368879,29115,5690,5775,85,0,92.70619039,Arch
c5c70ac20c27d198db04c04880f62fb4b19c6db0,209,12451,21423,8972,33874,31,46,77,700,677,2,54,4.675550794,85234,1,527,4,12820,14292,1472,367387,396481,29094,5758,5673,85,0,92.70619039,Arch
7598684403a4b6f027a7a1817d64ddfe0a417dfb,453,39605,30395,9210,70000,268,14,282,710,592,2,107,6.446999948,99309,1,2091,21,17298,15803,1495,486871,457316,29555,7292,7372,80,0,80.26780733,Arch
4e66413c75ef0099d2109c4e908d052bb11ab054,197,6269,6507,238,12776,112,7,119,703,810,2,44,4.922632584,50634,1,537,6,6928,6951,23,197860,198314,454,3339,3344,5,1,87.90351188,Arch
ea00c36e2d35b5c5ce3325cbddf12169b41ba187,209,12451,21423,8972,33874,31,45,76,700,677,2,54,4.675550794,85234,1,528,5,12820,14292,1472,367387,396481,29094,5758,5673,85,1,92.70619039,Arch
d457ee5eaaeda674fa0d4933efc8ef2161fcc736,209,21666,12451,9215,34117,90,10,100,703,704,2,57,4.673423508,76262,2,512,12,14339,12820,1519,397969,367387,30582,5682,5758,76,0,92.70619039,Arch
dbb833baf0ba3b6a17cd454f0fa544764adb6bb0,1,21,5,16,26,0,0,0,178,0,1,1,0,2618,2,513,13,734,730,4,17455,17292,163,91,90,1,0,100,NoArch
bf2239a825efd618eb04ad62434fc0f314c3eca2,200,6508,6564,56,13072,118,4,122,710,182,2,53,4.930884313,51708,1,2092,22,7206,7234,28,203481,204674,1193,3432,3437,5,0,87.90351188,Arch
d683a86c4bf34a65420a04751cc810211f311710,8,82,73,9,155,1,0,1,3,722,2,4,1.865370084,1797,1,2093,21,277,277,0,9790,9754,36,131,132,1,0,99.41644562,NoArch
cd91a0bd25f210d9be615b86325ab893f6d6e39b,330,18314,17540,774,35854,177,6,183,706,660,3,80,6.325642135,70372,0,1259,6,10784,10644,140,311833,306560,5273,4485,4433,52,0,87.61769408,Arch
2fa4789f84312dea39e93e547a6f9c05d0701dc6,0,0,0,0,0,0,0,0,0,0,0,0,0,0,0,1260,7,0,0,0,0,0,0,0,0,0,0,100,NoArch
28784c186395febf2ac153e11c48cfafedc5101c,80,2554,3316,762,5870,2,1,3,703,331,2,28,5.047018556,43021,2,2057,14,6943,7055,112,194280,198396,4116,2575,2621,46,1,99.71489665,NoArch
f2b7c8757281b80d8e3d50fbae563dadcfdb4663,209,12451,21682,9231,34133,31,38,69,700,677,2,54,4.672991778,85493,1,2003,7,12820,14343,1523,367387,398132,30745,5758,5683,75,1,92.70619039,Arch
3c2340cb43135db10a6a63e94af97bffc96c9d28,209,21682,12451,9231,34133,90,10,100,703,704,2,57,4.67296716,76262,2,538,7,14343,12820,1523,398132,367387,30745,5683,5758,75,0,92.70619039,Arch
be15ada266a25df0362eab0884332526e5cd2f34,1,1,1,0,2,0,0,0,5,41,1,1,0,277,1,539,6,30,30,0,1202,1202,0,4,4,0,0,100,NoArch
1a08e24536f5eb392d14472e07ce10c840515611,1,1,1,0,2,0,0,0,6,162,1,1,0,256,3,540,7,38,38,0,1054,1054,0,10,10,0,0,100,NoArch
43312ba4e9ae628255bedc870c0736eaf9708fef,1,1,1,0,2,0,0,0,3,334,1,1,0,148,1,541,8,27,27,0,589,589,0,14,14,0,0,100,NoArch
f62d1f8d9817ff2fa8f0fa8f6d1641eca86f1e75,1,1,1,0,2,0,0,0,6,699,1,1,0,126,1,542,9,28,28,0,346,346,0,5,5,0,0,100,NoArch
2974e4253f2f5694167d9280520c9240bccadecf,0,0,0,0,0,0,0,0,0,0,0,0,0,0,0,543,10,0,0,0,0,0,0,0,0,0,0,100,NoArch
e5eaf442b5efd5f77e7487179802dbb87cba1ed8,0,0,0,0,0,0,0,0,0,0,0,0,0,0,0,544,11,0,0,0,0,0,0,0,0,0,0,100,NoArch
4c52351fbd209b0fca0b1a5825a19f824d5e211b,1,1,1,0,2,0,0,0,2,1205,1,1,0,42,1,545,12,4,4,0,66,66,0,4,4,0,0,100,NoArch
b838e906a4259bf47da48913fe9fc2112dde786a,0,0,0,0,0,0,0,0,0,0,0,0,0,0,0,546,13,0,0,0,0,0,0,0,0,0,0,100,NoArch
b98f3c2078e776569871f462fb8fc26a316c54b8,1,18,18,0,36,0,0,0,218,76,1,1,0,3479,15,2058,11,860,860,0,20168,20168,0,172,172,0,0,100,NoArch
4f3dc6fd02b171144def64455d0b8209b7e64024,213,12456,21687,9231,34143,31,46,77,700,659,2,54,4.676046223,86086,1,2004,7,12909,14432,1523,369590,400335,30745,5785,5710,75,0,92.70619039,Arch
3af2f3ae2c80441c60de678021da4842b5807a46,213,21687,12456,9231,34143,90,10,100,703,696,2,57,4.676021613,76855,2,547,13,14432,12909,1523,400335,369590,30745,5710,5785,75,0,92.70619039,Arch
ec5d37959bb9b908c1e89c2b89fef5014dd8aa7f,2,277,0,277,277,2,0,2,704,24,1,2,0.847663173,13064,35,5,0,1649,1607,42,44925,43980,945,1004,973,31,1,99.96434938,NoArch
969c9e083d08f6fba1972fc926ed74c4881dfd72,268,11739,12028,289,23767,174,60,234,710,590,2,71,6.557528968,55492,1,512,0,8067,8137,70,223731,225833,2102,3604,3641,37,0,87.8087791,Arch
4f800346c7c106ba846abd12238ea49198591add,0,0,0,0,0,0,0,0,0,0,0,0,0,0,0,513,1,0,0,0,0,0,0,0,0,0,0,100,NoArch
b41fd425f340a8694ebe34e15e80a452f8bd32b9,268,12094,11741,353,23835,171,72,243,705,583,2,69,6.559422253,55203,0,2059,10,8140,8067,73,225875,223731,2144,3643,3604,39,1,87.8087791,Arch
9068e646ff4033ee67c4434e1564262104f819b1,214,12511,21806,9295,34317,31,43,74,701,657,2,54,4.677834462,86427,1,4,0,12951,14477,1526,370535,401322,30787,5816,5743,73,0,92.71164268,Arch
828ba25f2210ee708691e67f6ceeb9c07e3bd1ba,2,119,55,64,174,0,0,0,702,0,1,2,0.948980459,18867,35,2005,7,1976,1973,3,53295,53253,42,1021,1019,2,0,100,NoArch
f194a1a3f6eb01a02198cc9fbacc57b7a19fae91,459,40684,31806,8878,72490,268,70,338,710,618,2,107,6.521941852,99678,1,514,2,17299,15849,1450,486957,458356,28601,7292,7406,114,0,80.20872158,Arch
8e1188880d90484493c828b3e98701e6b603b11f,1,5,5,0,10,0,0,0,711,44,1,1,0,13066,34,2094,10,1607,1607,0,43972,43984,12,973,973,0,0,100,NoArch
8c8b24038b93e77c24128fc075d59a20bb3860ad,13,662,47,615,709,3,0,3,714,104,2,7,2.209463716,21213,1,2099,15,3664,3565,99,92609,89872,2737,1414,1371,43,0,98.08849558,NoArch
f2fdbdeb4c5cd11bc5c325d9cc788a000e99560e,258,10257,10511,254,20768,168,66,234,705,609,2,66,6.410138536,51016,0,2060,9,6980,7006,26,199599,200180,581,3350,3354,4,0,85.98047915,Arch
525f3695525eb239b02837a6f318763b7b2b9526,258,10469,10448,21,20917,174,64,238,714,605,2,68,6.414345221,50762,1,2100,16,6956,6980,24,198545,199599,1054,3347,3350,3,0,87.84864097,Arch
ed0ec44cbc1da1e27ee5b026889ff514189787bc,1,236,7,229,243,0,0,0,187,0,1,1,0,2413,3,2101,17,734,686,48,17455,15860,1595,91,84,7,0,100,NoArch
bfad6ea6e1b55cf895b2681ebb3416f3d9846f2e,0,0,0,0,0,0,0,0,0,0,0,0,0,0,0,2102,18,0,0,0,0,0,0,0,0,0,0,100,NoArch
a3ff40de169c911bdffe82cc867e83cdd4c84ca3,0,0,0,0,0,0,0,0,0,0,0,0,0,0,0,517,5,0,0,0,0,0,0,0,0,0,0,100,NoArch
c851ef8aaeb16a6af017aa8b677e34eba324093f,1,11,9,2,20,0,0,0,3,4637,1,1,0,26,3,518,6,1,1,0,208,174,34,1,1,0,0,99.70017637,NoArch
33b6572f389b88eb0a008a2ccb5637b830550c43,0,0,0,0,0,0,0,0,0,0,0,0,0,0,0,519,7,0,0,0,0,0,0,0,0,0,0,100,NoArch
d42789830c3265f010d6ec976a885903111853d4,259,10621,10743,122,21364,168,67,235,705,608,2,67,6.433116997,48398,0,2061,10,6256,6271,15,182730,182893,163,3267,3264,3,1,87.6879533,Arch
984dd41990869fe160fa107d5fd6a15fd63b8323,213,12456,21695,9239,34151,31,43,74,702,659,2,54,4.675816232,86196,1,2006,7,12912,14435,1523,369688,400433,30745,5788,5713,75,1,92.71164268,Arch
a260f947dc74703ad22da501b8b5781160a8aa83,463,41445,32084,9361,73529,268,70,338,714,629,2,107,6.569851276,99595,1,520,8,17355,15817,1538,488961,458053,30908,7306,7384,78,0,80.58234421,Arch
b2c32c812be72514113d5b65e4d07c8471a5c148,0,0,0,0,0,0,0,0,0,0,0,0,0,0,0,521,9,0,0,0,0,0,0,0,0,0,0,100,NoArch
a6ad21addec24aa9195a7706f6e75a54d11351d2,0,0,0,0,0,0,0,0,0,0,0,0,0,0,0,522,10,0,0,0,0,0,0,0,0,0,0,100,NoArch
d354eaabc367a4e7fc07b1d3c2ccfc35825030bd,0,0,0,0,0,0,0,0,0,0,0,0,0,0,0,523,11,0,0,0,0,0,0,0,0,0,0,100,NoArch
cc60b7b5b4bd9bdaedec10edc23dfad5c2aa64e9,0,0,0,0,0,0,0,0,0,0,0,0,0,0,0,524,12,0,0,0,0,0,0,0,0,0,0,100,NoArch
ecab9ddfcca17bf61997c88f33332c296d4cfad4,0,0,0,0,0,0,0,0,0,0,0,0,0,0,0,525,13,0,0,0,0,0,0,0,0,0,0,100,NoArch
877433fb13a00b46fb2d46af67b142fcd2a6524d,261,11047,11162,115,22209,168,68,236,705,627,2,67,6.489471317,48398,0,2062,5,6258,6271,13,182780,182893,113,3268,3264,4,1,87.6879533,Arch
fccbe87b6c26744909a236ec0644dfee4a555e49,213,12456,21695,9239,34151,31,46,77,702,659,2,54,4.675816232,86196,1,2007,4,12912,14435,1523,369688,400433,30745,5788,5713,75,1,92.71164268,Arch
396f121803a1e482dc175fa0bc41965b2542bde0,465,41864,32510,9354,74374,268,72,340,714,639,2,107,6.605158775,99602,1,526,14,17355,15819,1536,488961,458103,30858,7306,7385,79,0,80.58234421,Arch
1ca3f45af81e074335a413244e81a8fc285f671e,0,0,0,0,0,0,0,0,0,0,0,0,0,0,0,527,15,0,0,0,0,0,0,0,0,0,0,100,NoArch
3cb65f41502d1b29c8d2a3df4aa5ad1e182875e0,0,0,0,0,0,0,0,0,0,0,0,0,0,0,0,528,16,0,0,0,0,0,0,0,0,0,0,100,NoArch
258edc75bf4c95eeaf9a8981551665c235e71dd5,261,11047,11162,115,22209,168,70,238,705,627,2,67,6.489471317,48398,0,514,2,6258,6271,13,182780,182893,113,3268,3264,4,0,87.6879533,Arch
e547a7c31904b0dc6af9e1a6f53c429c5007e37c,4,354,294,60,648,0,0,0,8,1188,1,1,1.753826264,380,3,515,3,0,0,0,1736,1544,192,0,0,0,1,100,NoArch
036d87e4281939ba9eff959aed8d391d51cd1594,2,178,9,169,187,0,0,0,108,26,1,1,0.343784863,4021,9,2063,6,440,425,15,12246,11803,443,243,235,8,1,100,NoArch
5f480e6f49585bab6efed3887dc3c2f9dbdd9b03,1,2,1,1,3,0,0,0,22,0,1,1,0,331,5,2064,7,56,56,0,1417,1407,10,28,28,0,1,99.98218104,NoArch
d590fb79fc1d78e47a8a0a1298b890ea7a4ff5cf,218,12751,22051,9300,34802,31,46,77,702,648,2,55,4.755911081,87131,1,2008,5,12982,14505,1523,373061,404008,30947,5823,5748,75,0,92.71164268,Arch
477ebbfbc0ad527855ccd85dee6eb714693a0941,465,41864,32679,9185,74543,268,71,339,714,639,2,107,6.600222961,99771,1,2104,8,17355,15834,1521,488961,458546,30415,7306,7393,87,0,80.58234421,Arch
e915533f7b7aeef7d7e8104276603e9d3dc418c7,7,503,306,197,809,1,0,1,8,764,2,3,2.292557848,1069,1,2107,11,108,97,11,4918,4264,654,66,58,8,0,100,NoArch
8f72343583e15cdbca979cc8ad0ea9115eb7065d,0,0,0,0,0,0,0,0,0,0,0,0,0,0,0,2108,12,0,0,0,0,0,0,0,0,0,0,100,NoArch
715cfc45e1d4d413ef03111218c4462cd38df668,2,180,10,170,190,0,0,0,6,26,1,1,0.398459274,4021,1,2111,15,440,425,15,12256,11803,453,243,235,8,0,99.98243765,NoArch
511924ee53328ad8459d3b1aa2dd2643e5604697,259,10365,10599,234,20964,168,68,236,705,625,2,66,6.431930378,48705,0,548,1,6274,6297,23,183314,183808,494,3276,3280,4,1,87.6879533,Arch
6feadb439c926f1028051ba09697c23901b89011,218,12751,22051,9300,34802,31,46,77,702,651,2,55,4.755911081,87149,1,529,0,12983,14506,1523,373142,404089,30947,5823,5748,75,1,92.71164268,Arch
715ce09cedbb46244682dc3146ebc3c36541ef26,218,22051,12751,9300,34802,90,10,100,705,692,2,58,4.755886937,77849,2,516,2,14506,12983,1523,404089,373142,30947,5748,5823,75,0,92.71164268,Arch
25c2a19a36e927c268898bd181df0920b52ec970,5,160,54,106,214,0,0,0,180,143,1,4,1.767390756,5824,1,517,3,1515,1479,36,34022,33203,819,350,344,6,1,100,NoArch
982b4b37ca6d95a9764ad7427b0b375d49d603fd,218,12753,22159,9406,34912,31,44,75,702,651,2,55,4.761517613,87255,1,63,0,12983,14542,1559,373142,404908,31766,5823,5754,69,0,92.71164268,Arch
61e13d6e61be0f168727a79b0084463521493200,267,24631,15287,9344,39918,96,11,107,706,763,3,65,5.299427973,83714,2,1261,0,15490,13925,1565,436099,403125,32974,6168,6245,77,0,92.54623576,Arch
2533673dba45f0e43cd05a025ce561c7e8ff9c55,1,0,1,1,1,0,0,0,16,0,1,1,0,348,2,1262,1,76,76,0,1473,1488,15,45,45,0,0,100,NoArch
5e6fa9226d7ee88e2bf82e48683b5255f3194caf,22,1684,646,1038,2330,4,0,4,709,546,1,11,3.19190682,27094,1,1263,2,4344,4215,129,112921,108964,3957,1768,1707,61,0,99.94660021,NoArch
738a6d9b71b53f9f1acac08a70801a1f04076244,0,0,0,0,0,0,0,0,0,0,0,0,0,0,0,549,1,0,0,0,0,0,0,0,0,0,0,100,NoArch
5d2cdfd86813217e5ca8d05f503e008fea059f66,79,2273,3225,952,5498,0,1,1,705,342,2,26,5.055313414,41488,2,518,4,7076,7203,127,193969,198939,4970,2521,2574,53,0,99.73290598,NoArch
d46da38fb155b4d4c7c201ba7a24db1625046005,80,3236,2275,961,5511,9,0,9,709,974,2,26,5.078485346,40714,3,1264,3,7228,7101,127,199749,194739,5010,2591,2536,55,0,99.76851852,NoArch
453e53da8ef0608485b9c6fd875f08d4f81311a1,0,0,0,0,0,0,0,0,0,0,0,0,0,0,0,1265,4,0,0,0,0,0,0,0,0,0,0,100,NoArch
b7dbda7ce5ccd871a28a5fe84aac369617a1f2f9,334,13759,14468,709,28227,174,60,234,714,544,3,84,6.805196271,74733,1,2112,7,11388,11491,103,324111,328546,4435,4709,4760,51,0,87.46685522,Arch
1d83059d68afdc9286acf299994f7f8e755f259b,1,16,19,3,35,0,0,0,6,97,1,1,0,187,3,2113,8,24,24,0,1126,1179,53,21,21,0,0,100,NoArch
88cb35b4466f57e0a08e00b3b6c71af71035b80c,260,10241,10489,248,20730,169,67,236,705,619,2,68,6.409848236,49278,0,519,5,6385,6409,24,187204,187713,509,3314,3318,4,0,87.6879533,Arch
ed77845e1d44dd318630304bdf3f40d0e3acabe1,1,126,3,123,129,0,0,0,706,47,1,1,0,13166,35,2065,3,1619,1610,9,44415,44078,337,985,976,9,1,100,NoArch
9057be382a9c9e34cefa570b9c8ea617e9f1806d,259,10489,10240,249,20729,174,64,238,716,620,2,69,6.409396104,48781,1,2115,10,6331,6307,24,185352,184830,522,3310,3306,4,0,87.6879533,Arch
1f75d7ca0494936dda4ee1caa1499793a7fe17fc,336,14503,13910,593,28413,177,67,244,709,662,3,84,6.819065652,74703,0,1266,5,11603,11508,95,332456,328285,4171,4798,4756,42,0,87.46685522,Arch
42186ec2070775b05f4925182b1885eb87030d96,7,309,56,253,365,1,0,1,711,107,1,6,2.045227836,19361,1,1267,6,3229,3176,53,81328,79979,1349,1352,1337,15,0,100,NoArch
322578724aac0b5d7a60e85313471e1046c766ba,258,10481,10230,251,20711,174,64,238,722,616,2,68,6.404476791,48767,1,2116,11,6332,6308,24,185183,184648,535,3316,3312,4,0,87.70535241,Arch
b2b9566c0a75be47966a9b9d65722f1ba417ef16,260,10306,10481,175,20787,170,67,237,711,624,2,67,6.417699207,50093,0,520,6,6480,6502,22,189728,190103,375,3372,3374,2,1,87.67437754,Arch
3e04c8e7b550cd533baccc280ce36e79c8243181,1,10,2,8,12,0,0,0,181,14,1,1,0,2665,3,521,7,748,745,3,17683,17657,26,92,92,0,0,100,NoArch
feb29cf5a4d4dac494fe7950e1a184bb74d81fcd,1,13,6,7,19,0,0,0,35,213,1,1,0,464,8,2066,3,82,73,9,2022,1913,109,36,36,0,1,100,NoArch
979153f5ce8308c1ceebea8c81cd6db8eca54eda,1,7,3,4,10,0,0,0,17,2239,1,1,0,426,5,2067,4,53,53,0,1304,1304,0,40,40,0,0,100,NoArch
7a76d6a3b3a214cd3b98ca870db1334f0b95c133,273,14798,25534,10736,40332,30,39,69,702,576,3,62,5.306509965,94797,1,2009,1,13938,15691,1753,404395,442919,38524,6236,6239,3,1,92.53313422,Arch
c96fa627ad9e789d38ab8d4c63be437575338779,1,7,3,4,10,0,0,0,17,2239,1,1,0,426,5,2010,2,53,53,0,1304,1304,0,40,40,0,0,100,NoArch
0d3f9b7bb0f942335f27075ce4cd62ec168fca34,272,25533,14801,10732,40334,98,10,108,711,770,3,65,5.305382899,83635,2,522,6,15638,13885,1753,441615,403091,38524,6199,6196,3,0,92.53313422,Arch
ae55f0cba690f5b9f0b39ca29f1fc3466e670ad1,1,22,3,19,25,0,0,0,182,6,1,1,0,2673,3,523,7,757,748,9,17854,17683,171,93,92,1,0,100,NoArch
fc657718ac205e3443b67a54791112931ff06282,1,3,22,19,25,0,0,0,181,14,1,1,0,2692,3,2068,3,748,757,9,17683,17854,171,92,93,1,0,100,NoArch
2f8e2951e1a0d3a431999718e712c45a7b937a55,1,22,3,19,25,0,0,0,182,6,1,1,0,2673,3,2069,4,757,748,9,17854,17683,171,93,92,1,0,100,NoArch
35848095a083b951524ae3708f3d9ace1424d93d,2,12,6,6,18,0,0,0,53,385,1,2,0.918295834,667,1,524,8,146,145,1,3696,3704,8,37,36,1,0,100,NoArch
74df6070b10cf58f7945da82c8e61c8d77a70c3f,1,14,2,12,16,0,0,0,183,2,1,1,0,2692,3,525,9,761,757,4,17923,17854,69,93,93,0,0,100,NoArch
bca2eb813f9d3ee834d1867017f090d69f9daae6,2,7,2,5,9,1,0,1,20,9,1,2,0.764204507,473,1,526,10,99,98,1,3421,3391,30,19,19,0,0,100,NoArch
7b4fd83bed300125e338609c159bbcabba387292,1,12,8,4,20,0,0,0,21,0,1,1,0,375,1,527,11,88,88,0,2759,2727,32,17,17,0,0,100,NoArch
5618e6d187a537ca9ca7294ba987ffc130b54722,1,3,0,3,3,1,0,1,22,0,1,1,0,379,1,528,12,91,88,3,2789,2759,30,17,17,0,0,100,NoArch
f2e347632df40e31dff2da739b33f39740f585b2,0,0,0,0,0,0,0,0,0,0,0,0,0,0,0,2070,5,0,0,0,0,0,0,0,0,0,0,100,NoArch
89f4ad8facf193f17cf990f3374ee4560023ab76,2,1,2,1,3,0,0,0,23,212,1,2,0.918295834,221,8,2071,6,21,21,0,561,561,0,17,17,0,0,100,NoArch
8ebd3e5c32c54d45630f59511b992f768b714896,2,131,0,131,131,2,0,2,5,88,1,1,0.977648278,104,1,529,13,26,17,9,1514,701,813,6,3,3,0,99.94667615,NoArch
04a9bf940c37a3a5732a5facd6defa8354a7b347,1,34,0,34,34,1,0,1,50,112,1,1,0,1049,4,530,14,368,349,19,6113,5900,213,37,37,0,0,100,NoArch
ec090482c0f9f3a3c9a2ae5ad07c9c433303adf2,0,0,0,0,0,0,0,0,0,0,0,0,0,0,0,531,15,0,0,0,0,0,0,0,0,0,0,100,NoArch
f7ce180a540830c962a7a84f9e781c77304f3f76,2,4,1,3,5,1,0,1,202,229,1,2,0.970950594,3219,10,532,16,650,648,2,17742,17722,20,148,148,0,0,100,NoArch
e08c389d67809a421f4f33c27012c54294f98259,3,29,1,28,30,2,0,2,29,51,1,3,0.69984284,1670,3,533,17,310,302,8,8666,8421,245,69,69,0,0,100,NoArch
0c2b64e2e508227c647b82ad866785d237066736,1,5,0,5,5,1,0,1,184,3,1,1,0,2704,3,534,18,762,761,1,17955,17923,32,93,93,0,0,100,NoArch
5bbf4b5c86b789150cd12a4235c594c491d0caea,274,14840,25779,10939,40619,30,43,73,702,569,3,62,5.327068589,95180,1,0,0,14021,15829,1808,406157,446264,40107,6232,6238,6,1,92.49860049,Arch
0a7d04a16c9c65862559c0e9c3fa42f17b842c34,274,25833,14846,10987,40679,99,10,109,712,770,3,65,5.324103231,84241,2,3,0,15832,14021,1811,446407,406157,40250,6241,6232,9,0,92.49860049,Arch
7f883f105e647f1aeaf9f0d8827fdc85aba721df,1,28,22,6,50,0,0,0,713,0,1,1,0,13337,36,2072,7,1622,1622,0,44558,44558,0,988,988,0,1,100,NoArch
daf0532fb4045ddb3b1bb44b8475c72c30f04fdf,274,14846,25833,10987,40679,30,49,79,703,569,3,62,5.313059776,95234,1,3,0,14022,15832,1810,406236,446407,40171,6233,6241,8,0,92.49860049,Arch
59492e91893ab4b7bd5f21a595360a8615524f7d,1,28,22,6,50,0,0,0,704,0,1,1,0,18740,35,2011,2,1937,1937,0,52549,52549,0,994,994,0,1,100,NoArch
62b113d56de009404e08770a699436d36c24ecde,274,25994,14937,11057,40931,99,10,109,714,770,3,65,5.294797152,84253,2,2073,8,15836,14022,1814,446422,406236,40186,6246,6233,13,1,92.49860049,Arch
d0ae114ddb028b3ac7bb10d27404cf96e093be61,274,15010,25975,10965,40985,30,49,79,705,569,3,62,5.288663102,95310,1,2012,3,14027,15836,1809,406342,446422,40080,6239,6246,7,0,92.49860049,Arch
7b2c39f30be6292dbe77df9be98b9734edaa4fdd,274,26378,15271,11107,41649,99,10,109,714,770,3,65,5.31866187,84345,2,2074,8,15845,14027,1818,446747,406342,40405,6255,6239,16,1,92.49860049,Arch
ba1e09c7d0bf98ac4ad458f6a29082d01a486a4d,274,15010,25975,10965,40985,30,49,79,705,569,3,62,5.288663102,95452,1,2013,4,14036,15845,1809,406667,446747,40080,6248,6255,7,1,92.49860049,Arch
f44ce37699af574035089023cfb91b6a6419b895,274,25988,15018,10970,41006,99,10,109,714,765,3,65,5.290711552,84487,2,43,0,15846,14036,1810,446774,406667,40107,6256,6248,8,1,92.49860049,Arch
fde0fae1adc10a719208c02b8c77929d662bf552,2,229,23,206,252,0,0,0,110,721,1,2,0.222284831,4152,6,2075,9,429,417,12,12344,11948,396,246,234,12,1,100,NoArch
b1e5f00c60b3ff711a63262c4d50486361688180,274,15010,25975,10965,40985,30,49,79,705,569,3,62,5.288663102,95663,1,2014,5,14049,15858,1809,407090,447170,40080,6261,6268,7,0,92.49860049,Arch
e165eae300fe72507a2627add8fb04965fddebda,274,26060,15031,11029,41091,99,10,109,715,770,3,65,5.28207511,84698,2,2076,10,15863,14049,1814,447295,407090,40205,6270,6261,9,1,92.49860049,Arch
136890ad4905252cf4e9e053e806f2147f882de4,274,15010,25975,10965,40985,30,49,79,706,569,3,62,5.288663102,95727,1,2015,6,14054,15863,1809,407215,447295,40080,6263,6270,7,0,92.49860049,Arch
d11169d8402c20da6969e9733abaa725e693b51e,0,0,0,0,0,0,0,0,0,0,0,0,0,0,0,2016,7,0,0,0,0,0,0,0,0,0,1,100,NoArch
b5bc5ce221e3a0d33495da416a9f0629855f2e5c,274,26013,15323,10690,41336,98,10,108,714,770,3,65,5.300173713,84762,3,43,0,15845,14054,1791,446745,407215,39530,6255,6263,8,0,92.49860049,Arch
6d75065966e347859ff34d09305982dbd0faeafe,274,15359,26007,10648,41366,29,49,78,706,569,3,62,5.305093605,95452,1,2017,8,14056,15845,1789,407279,446745,39466,6265,6255,10,1,92.49860049,Arch
742bf88dbaf52c0b23af27c3dd78c7abdb799f4f,274,25982,15017,10965,40999,99,10,109,715,770,3,65,5.289938118,84804,2,2077,11,15865,14056,1809,447359,407279,40080,6272,6265,7,0,92.49860049,Arch
a8e8b240d4516b5822a3995800fe4aabf46874b8,2,18,26,8,44,0,0,0,24,41,1,1,0.439496987,475,5,2078,12,73,73,0,1978,1960,18,39,39,0,1,100,NoArch
7de07f7a6918e35551f3b06583320112fd5a3eae,274,15011,25976,10965,40987,30,49,79,706,569,3,62,5.289055885,95761,1,2018,9,14056,15865,1809,407288,447368,40080,6265,6272,7,1,92.49860049,Arch
5d4d65174ea2b8ce27899754eecdfb0592815c26,275,25985,15019,10966,41004,99,10,109,715,767,3,65,5.291054377,84841,2,2079,13,15865,14056,1809,447455,407375,40080,6272,6265,7,0,92.49860049,Arch
7cb86801c7dd7915c7d08d3c37fb6ea931633eaf,1,1,1,0,2,0,0,0,3,155,1,1,0,93,3,2080,14,9,9,0,469,471,2,3,3,0,0,100,NoArch
5b5bbfc65f0053a45ef359488f5b0a58e3233da5,2,36,100,64,136,0,0,0,3,274,1,2,0.936667382,585,1,2081,15,75,94,19,1998,2408,410,28,29,1,1,99.89337125,NoArch
c77f53d4ba28b31c971a14f178dc29cf3367296f,275,15014,25980,10966,40994,29,49,78,706,572,3,62,5.290683607,95735,1,2019,10,14034,15843,1809,406911,446989,40078,6264,6271,7,0,92.07995474,Arch
d5791943efde533924c410c61c3a6e9349ea3172,1,86,3,83,89,0,0,0,41,0,1,1,0,373,10,2020,11,72,47,25,1871,1349,522,25,24,1,1,100,NoArch
822b37507ebcd02dc559da40b4110acc6ef1e86c,1,3,86,83,89,0,0,0,42,0,1,1,0,456,10,2021,12,47,72,25,1349,1871,522,24,25,1,1,100,NoArch
137815750b59792846e9b260a645b6a450070a89,275,25986,15020,10966,41006,98,10,108,715,768,3,65,5.291565285,84769,3,2082,16,15843,14034,1809,446989,406911,40078,6271,6264,7,1,92.07995474,Arch
663423d28b3796701a2a22f6158b9c2f29512a8f,275,15014,25980,10966,40994,29,49,78,706,566,3,62,5.290683607,95735,1,2022,13,14034,15843,1809,406911,446989,40078,6264,6271,7,1,92.07995474,Arch
5852b0dbd59daf5e1eadd32768f83d0734eff4d8,275,25993,15022,10971,41015,98,10,108,715,763,3,65,5.292730735,84769,3,2083,17,15844,14034,1810,447016,406911,40105,6272,6264,8,1,92.07995474,Arch
96db6e596203154f6a5782671b4762f563f7a4a5,275,15014,25980,10966,40994,29,49,78,706,572,3,62,5.290683607,95740,1,2023,14,14035,15844,1809,406938,447016,40078,6265,6272,7,1,92.07995474,Arch
619d4f36333ee66fda67e85acbd7ede6d2975ac2,523,46322,35105,11217,81427,277,69,346,727,655,3,112,6.790090748,106813,1,2135,18,18682,16849,1833,533178,492565,40613,7835,7824,11,0,79.73807297,Arch
b87c763303b5f2c573764499d8c48838c62042d8,259,10259,10481,222,20740,169,67,236,715,615,2,66,6.410796045,53234,0,550,0,6678,6700,22,194404,194916,512,3544,3547,3,1,87.64996471,Arch
500b8d4da0702498df263f6c389cc2da7da62c69,1,1,1,0,2,0,0,0,4,5,1,1,0,3732,2,551,1,356,356,0,9107,9107,0,199,199,0,0,100,NoArch
cbf54cc240022fb553db02583af43bb37e7b4309,278,15180,26425,11245,41605,29,48,77,705,581,3,63,5.331592181,96195,1,43,0,14102,15918,1816,408710,449047,40337,6272,6298,26,1,92.47853677,Arch
76e4a7016df34cf9dede53f743647ded0af55529,278,26543,15176,11367,41719,98,10,108,716,763,3,66,5.324752103,84950,3,0,0,15930,14102,1828,449351,408710,40641,6302,6272,30,0,92.47853677,Arch
39a5690abda6ed476e6d8a09cacd53124c4921ff,3,586,189,397,775,2,0,2,717,153,1,1,0.630620601,17586,2,2084,12,2094,2047,47,56409,55313,1096,1240,1214,26,1,100,NoArch
d9b90817b86025468de80b8304c0dc5d1285cf85,276,15259,26651,11392,41910,29,48,77,707,574,3,62,5.22592987,96537,1,0,0,14095,15953,1858,408446,449643,41197,6285,6319,34,0,92.07995474,Arch
f8479496e606bab5c1104ac8e1e965b6f3d4b075,2,12,19024,19012,19036,1,0,1,708,224,1,1,0.007611087,19273,5,2024,13,49,2007,1958,1300,54288,52988,17,1022,1005,0,98.65373193,NoArch
69b7bce04afe137f49efa6a19a464dda087da23b,275,37692,7288,30404,44980,99,10,109,717,763,3,65,4.9919161,65872,3,2085,13,15904,12088,3816,448343,354158,94185,6302,5263,1039,1,92.2032006,Arch
3a67e864a00ad2198d42f3264c4b2ccafdb2ee32,274,7282,23786,16504,31068,29,49,78,312,574,3,62,5.932705813,82376,1,2025,14,12088,14224,2136,354158,402543,48385,5263,5281,18,0,92.04374057,Arch
ddb2ad035da5f9f33c92f4b0baec9143e7b6f027,1,7951,2483,5468,10434,0,0,0,710,0,1,1,0,13900,36,2026,15,2001,1680,321,53986,45800,8186,1029,1021,8,0,99.89961855,NoArch
7331e5d15d879f8f9b26510eac07256ab89d584c,275,26318,15239,11079,41557,98,10,108,717,763,3,65,5.25418327,85240,3,535,0,15913,14089,1824,448575,408144,40431,6303,6292,11,1,92.07995474,Arch
9c69938cdcf8e0bd6cf98de61ac6600775a2a63a,1,25,25,0,50,0,0,0,13,204,1,1,0,178,6,45,0,26,29,3,882,871,11,11,12,1,1,100,NoArch
f4a309b65306db0c38cab478ad3ba64bcff5655a,275,15233,26312,11079,41545,29,49,78,710,572,3,62,5.253296925,96319,1,0,0,14089,15913,1824,408144,448575,40431,6292,6303,11,1,92.07995474,Arch
762924186670e40e088c2bbb5bc5a205f7c7118b,275,26318,15239,11079,41557,98,10,108,717,763,3,65,5.25418327,85240,3,536,1,15913,14089,1824,448575,408144,40431,6303,6292,11,0,92.07995474,Arch
30aa25f24db87e7290c160dc2ff0cac87307a7a8,275,15233,26312,11079,41545,29,49,78,710,572,3,62,5.253296925,96319,1,64,0,14089,15913,1824,408144,448575,40431,6292,6303,11,0,92.07995474,Arch
e007accae60aae2a421ce09597bb0e228457e6b9,278,26389,15277,11112,41666,98,10,108,717,757,3,65,5.271263999,85760,3,2086,2,15976,14141,1835,450849,410295,40554,6311,6298,13,1,92.07995474,Arch
73c3eeb4ab66eafd43717000a6797ec5641c2923,1,23,0,23,23,1,0,1,8,0,1,1,0,195,2,2087,3,0,0,0,122,122,0,0,0,0,1,100,NoArch
e4eb5af3611cd7ef4184a0e5191b029007f34de5,278,15271,26383,11112,41654,29,49,78,710,573,3,62,5.27038873,96895,1,2027,3,14141,15976,1835,410295,450849,40554,6298,6311,13,1,92.07995474,Arch
57f81009f037eb3c50376da760f4ee43662f6ef4,278,26391,15277,11114,41668,98,10,108,717,755,3,65,5.27137286,85783,3,537,2,15973,14141,1832,450808,410295,40513,6311,6298,13,1,92.07995474,Arch
f2f5e4b380be3c28310b075f592115800efc8d0b,0,0,0,0,0,0,0,0,0,0,0,0,0,0,0,1268,0,0,0,0,0,0,0,0,0,0,1,100,NoArch
3a0abd4180df4181f4ff0d0d5929d908d6c7a840,1,5,0,5,5,1,0,1,15,1702,1,1,0,314,2,1269,1,84,79,5,1683,1663,20,23,23,0,1,100,NoArch
e5576a1a281048a28c2a3d1c7d9beb90d6c80e96,279,15271,26390,11119,41661,29,49,78,710,578,3,62,5.271601385,97216,1,1129,0,14220,16057,1837,411958,452491,40533,6321,6334,13,1,92.07995474,Arch
83e55cca9e67750e1c34ce89db2bdff1ef2f9dad,1,5,0,5,5,1,0,1,15,1702,1,1,0,314,2,1130,1,84,79,5,1683,1663,20,23,23,0,1,100,NoArch
ba07219640d943f7200a816ff45137f22d42a19f,526,46727,35362,11365,82089,277,69,346,730,646,3,112,6.775689979,107822,1,2140,4,18811,16955,1856,536970,495922,41048,7874,7857,17,0,79.73807297,Arch
6359d395900cf0aab87b05df4430551a2de05e50,258,10230,10481,251,20711,168,67,235,717,616,2,66,6.404476791,49948,0,538,3,6371,6395,24,186399,186934,535,3371,3375,4,0,87.64996471,Arch
bfb9d13a13ae668a43036b8e8c4d87886b999e3d,0,0,0,0,0,0,0,0,0,0,0,0,0,0,0,539,4,0,0,0,0,0,0,0,0,0,0,100,NoArch
b7002e1e7fef4339205ef88c15932862b0497980,258,10481,10230,251,20711,174,64,238,730,617,2,68,6.404476791,49697,1,2141,3,6395,6371,24,186934,186399,535,3375,3371,4,0,87.64996471,Arch
f959aa8fcffb288c19ff26610ddc61585364e307,258,10230,10481,251,20711,168,67,235,717,616,2,66,6.404476791,49948,0,2088,2,6371,6395,24,186399,186934,535,3371,3375,4,0,87.64996471,Arch
5438d99a147b8bc676cb323ad9f1fa9b804b3a6b,258,10481,10230,251,20711,174,64,238,730,617,2,68,6.404476791,49697,1,2143,5,6395,6371,24,186934,186399,535,3375,3371,4,0,87.64996471,Arch
3cdc975151d774419c345894dd1032a3eaade7ab,259,10242,10481,239,20723,169,67,236,717,615,2,67,6.40783062,52700,0,540,5,7143,7166,23,204680,205121,441,3465,3469,4,1,87.64996471,Arch
fd7d3bbd0196a708525499b1e7eb396ce47dcc16,258,10481,10230,251,20711,174,64,238,730,617,2,68,6.404476791,49697,1,556,6,6395,6371,24,186934,186399,535,3375,3371,4,0,87.64996471,Arch
63ab975e1f3e80488f1ebeee097e75aec9d4e429,11,522,21,501,543,8,0,8,185,75,1,5,3.112139708,3287,1,555,5,889,837,52,22274,20509,1765,145,123,22,0,99.68608301,NoArch
689e89fb096e40cb28e41873fa94f5aecf6ee416,2,35,8,27,43,1,0,1,5,686,1,1,0.782444129,53,1,556,5,8,6,2,194,134,60,8,6,2,0,99.94791667,NoArch
63ae24fa661b5cca6a0ac76c41db2e8b323a0c76,2,26,3,23,29,1,0,1,62,55,1,2,0.578794625,1609,4,557,6,444,439,5,8795,8624,171,66,65,1,0,99.98263889,NoArch
0e370fa21cfabcf9d969dfc20c1e4551305a01c6,11,12,548,536,560,1,8,9,60,187,1,5,3.152102241,2142,0,555,4,433,491,58,8341,10371,2030,66,89,23,0,99.66875872,NoArch
21197a20b3384adf320c1b0fadd573dd4e8c918f,1,0,5,5,5,0,0,0,30,384,1,1,0,130,3,556,5,19,20,1,517,543,26,19,20,1,0,100,NoArch
db2f8c9e80754be97e1bb220ccb32ba68e17e448,1,0,5,5,5,0,0,0,7,323,1,1,0,66,5,557,6,5,6,1,183,211,28,4,5,1,0,100,NoArch
a2a5999fb50d48d18a7fea8f60dd72fd02aefea6,0,0,0,0,0,0,0,0,0,0,0,0,0,0,0,558,7,0,0,0,0,0,0,0,0,0,0,100,NoArch
099029e454d7a74385e30ad33f40f44fe41b891e,1,12,0,12,12,1,0,1,186,37,1,1,0,2752,3,561,10,772,771,1,18281,18187,94,94,94,0,0,100,NoArch
a18996f473969ab0088e3a2d487923f3aa3a6b69,262,14461,14727,266,29188,169,68,237,717,627,2,68,5.719852194,50084,0,2089,3,6387,6407,20,186785,187285,500,3382,3386,4,1,87.61904762,Arch
c757cd28d1b55c07a215e3c4bea72bc648d2a42a,278,15271,26397,11126,41668,29,47,76,710,573,3,62,5.270107861,96911,1,2028,1,14145,15978,1833,410336,450943,40607,6298,6311,13,1,92.07995474,Arch
8e512d9a50702afc162201a01c72958ddc16492a,528,46770,35376,11394,82146,278,69,347,730,644,3,112,6.77864897,107877,1,2145,7,18822,16965,1857,537245,496097,41148,7880,7863,17,0,79.70824762,Arch
968c7dfc43fb460bd61dc013bb5ef49945237eaf,10,548,7,541,555,8,0,8,62,10,1,4,3.106232981,1540,1,563,11,486,427,59,10188,8130,2058,85,61,24,0,99.66875872,NoArch
16e5f0ac5081ce11d0374687348344773a5d86ba,1,1,1,0,2,0,0,0,52,9,1,1,0,1102,4,564,12,372,372,0,6274,6274,0,37,37,0,0,100,NoArch
9d8d6d0b8e095fe56ed53eaaba9d996a1bbb5f11,273,10303,11095,792,21398,169,76,245,717,609,2,72,6.517267252,53033,0,1270,2,6932,7017,85,199336,201926,2590,3485,3513,28,0,86.93582511,Arch
2791a111fb940141c0d4d185c0d45b925af7a2d7,273,11190,10345,845,21535,183,64,247,730,591,2,74,6.526519347,52241,1,565,13,7022,6932,90,202271,199336,2935,3514,3485,29,0,86.93582511,Arch
1dc34ece62ab24752b521eae22f14f7d0c8c7df0,0,0,0,0,0,0,0,0,0,0,0,0,0,0,0,568,16,0,0,0,0,0,0,0,0,0,0,100,NoArch
09634f8ba8cd463c749945bbdf318d0f72b8489e,2,11,6,5,17,0,0,0,29,1168,1,2,0.522559375,262,3,569,17,30,25,5,1790,1740,50,7,7,0,0,100,NoArch
9943dde06743dac0357906a4c6893376897afc0e,276,10381,11218,837,21599,169,76,245,717,601,2,72,6.538164002,56117,0,541,3,7732,7824,92,219416,222342,2926,3588,3615,27,1,86.93582511,Arch
f1cf3c6d0b4095ec01eabbcf0943817fb02f0847,1,73,75,2,148,0,0,0,105,482,1,1,0,1037,15,2090,2,113,113,0,2486,2500,14,68,68,0,1,100,NoArch
3208a4b3991d19af9b9bfca5b23591fa27565ffa,279,15281,26437,11156,41718,29,46,75,710,573,3,62,5.276249235,97108,1,2029,1,14155,15989,1834,410717,451392,40675,6303,6318,15,1,91.78497066,Arch
913f23dd4cf14999be5d068b1f49a0c1407d60a4,537,47408,35390,12018,82798,285,69,354,730,634,3,114,6.81139243,108044,1,2147,7,18897,16975,1922,540097,496478,43619,7912,7868,44,0,79.10978119,Arch
feeaf7ab26fd9d55a7138f9c8cadece82fccb181,271,10297,11159,862,21456,169,76,245,717,604,2,72,6.513958104,52232,0,542,4,6814,6902,88,194956,197900,2944,3444,3473,29,0,87.27433628,Arch
970a4e62dc24855230d3845eb814419bb8eabfca,1,1,1,0,2,0,0,0,188,5,1,1,0,2776,3,543,5,776,775,1,18356,18346,10,96,96,0,1,100,NoArch
96576e4b5bdb5dbf302623e5f944373147fda451,2,4,2,2,6,0,0,0,25,371,1,2,0.918295834,371,2,544,6,69,69,0,1530,1516,14,32,32,0,1,100,NoArch
65204f19539c778512134c1c5a543ef23a8b24ac,1,5,2,3,7,0,0,0,8,47,1,1,0,123,2,2091,3,0,0,0,101,101,0,0,0,0,0,100,NoArch
da7794471e53ee8f333338b3ebd3f3e76aa8909b,1,10,3,7,13,0,0,0,62,911,1,1,0,755,3,2092,4,211,205,6,4596,4538,58,57,56,1,1,100,NoArch
0ddc371056264cb801544efda7f89c11d9668455,271,11159,10297,862,21456,183,64,247,730,596,2,74,6.513958104,51377,1,570,17,6908,6820,88,197958,195014,2944,3474,3445,29,0,87.27433628,Arch
c5edd51bfa970cd0b51a12e0bc29458fd6041b31,0,0,0,0,0,0,0,0,0,0,0,0,0,0,0,574,21,0,0,0,0,0,0,0,0,0,0,100,NoArch
ffd13b1a1521ec243374c92f0a22fe0cdf581aae,2,11,6,5,17,0,0,0,29,1168,1,2,0.522559375,262,3,576,23,30,25,5,1790,1740,50,7,7,0,0,100,NoArch
3f01bfbff8b26877da09edd8347cfb14790b6e71,274,10844,11687,843,22531,169,76,245,717,605,2,73,6.532689337,52506,0,2093,5,6848,6938,90,196793,199748,2955,3454,3481,27,1,87.27433628,Arch
f00cbbecf6db89c762505d8919974103940609d4,281,15288,26456,11168,41744,29,47,76,710,574,3,63,5.280878632,98107,1,2030,2,14412,16253,1841,416374,457131,40757,6377,6393,16,1,91.78497066,Arch
72a358f900136b5570e3dd3ebf6efc0c03b17d69,541,48201,36181,12020,84382,285,69,354,730,638,3,115,6.840116641,108819,1,577,22,19056,17124,1932,544411,500635,43776,7971,7927,44,0,79.10978119,Arch
11bf49f80e26f6c052dbd27c843ee4510305ce8f,0,0,0,0,0,0,0,0,0,0,0,0,0,0,0,578,23,0,0,0,0,0,0,0,0,0,0,100,NoArch
abd94ee9c7dff10a8a2dca34ecc988dd94346403,0,0,0,0,0,0,0,0,0,0,0,0,0,0,0,579,24,0,0,0,0,0,0,0,0,0,0,100,NoArch
651953cd60b8dea0b187def4b93233be6ea028b7,0,0,0,0,0,0,0,0,0,0,0,0,0,0,0,580,25,0,0,0,0,0,0,0,0,0,0,100,NoArch
e9dc1918e199af6a66e88389727f3d2710047ee0,0,0,0,0,0,0,0,0,0,0,0,0,0,0,0,581,26,0,0,0,0,0,0,0,0,0,0,100,NoArch
0d5be30dc80d371a5a2684b3fceb6819051b5b42,1,2,0,2,2,1,0,1,7,156,1,1,0,184,3,582,27,24,24,0,1159,1126,33,21,21,0,0,100,NoArch
bfbd15e92b3235476462c014d221d86e4ccbf2a7,2,0,0,0,0,2,0,2,1,0,1,1,0,413,1,583,28,70,70,0,1827,1827,0,32,32,0,0,99.859993,NoArch
481629c25610316addf9a7f22f336d31a50b4d85,0,0,0,0,0,0,0,0,0,0,0,0,0,0,0,584,29,0,0,0,0,0,0,0,0,0,0,100,NoArch
9c1d8e6a97b2ca278802e90a172fa98dd8db2cbd,0,0,0,0,0,0,0,0,0,0,0,0,0,0,0,585,30,0,0,0,0,0,0,0,0,0,0,100,NoArch
f0d832661e4799cb33fa9f2b8b4998655769b492,0,0,0,0,0,0,0,0,0,0,0,0,0,0,0,586,31,0,0,0,0,0,0,0,0,0,0,100,NoArch
b52c55c9e01191e5cf1305f49f1f78945708c08f,0,0,0,0,0,0,0,0,0,0,0,0,0,0,0,587,32,0,0,0,0,0,0,0,0,0,0,100,NoArch
473bec448ae28180d0149492eeb6d618f9059b37,1,9,3,6,12,0,0,0,2,36,1,1,0,90,1,588,33,14,12,2,524,478,46,4,4,0,0,100,NoArch
d8852452f3c39ef3d9efe72e66322d8f3799b669,1,1,1,0,2,0,0,0,4,226,1,1,0,63,2,589,34,3,3,0,271,260,11,3,3,0,0,100,NoArch
acd74d31e5322f54ae20a90fb7dec3404cd43d29,1,1,1,0,2,0,0,0,3,227,1,1,0,336,2,590,35,27,27,0,2330,2330,0,18,18,0,0,100,NoArch
cb87ff1031c7e1b256f63b9270b7835c857f43da,0,0,0,0,0,0,0,0,0,0,0,0,0,0,0,591,36,0,0,0,0,0,0,0,0,0,0,100,NoArch
851257f330e9281373b619296773f37096b8d383,0,0,0,0,0,0,0,0,0,0,0,0,0,0,0,592,37,0,0,0,0,0,0,0,0,0,0,100,NoArch
072052f35580e5211af1982c02f358780321ea44,0,0,0,0,0,0,0,0,0,0,0,0,0,0,0,593,38,0,0,0,0,0,0,0,0,0,0,100,NoArch
6ac264fd9d649224be253381b82e965be71f604c,0,0,0,0,0,0,0,0,0,0,0,0,0,0,0,594,39,0,0,0,0,0,0,0,0,0,0,100,NoArch
b713b42c6165fcfe508383cd4c1b1bf0fda25df1,0,0,0,0,0,0,0,0,0,0,0,0,0,0,0,595,40,0,0,0,0,0,0,0,0,0,0,100,NoArch
ffae4abbc493e1fe5d91604077125ec5ce4109c8,0,0,0,0,0,0,0,0,0,0,0,0,0,0,0,596,41,0,0,0,0,0,0,0,0,0,0,100,NoArch
8d62d63f02c131907eaa4919e997ac1689fbc16c,0,0,0,0,0,0,0,0,0,0,0,0,0,0,0,597,42,0,0,0,0,0,0,0,0,0,0,100,NoArch
592da0fb064ebe278deb200ca35200ba62d3acb8,0,0,0,0,0,0,0,0,0,0,0,0,0,0,0,598,43,0,0,0,0,0,0,0,0,0,0,100,NoArch
8d25573421dee72fe41a9b7619b4b184070a2145,277,10849,11708,859,22557,169,73,242,717,603,2,75,6.538646624,56877,0,1271,1,7879,7972,93,221707,224796,3089,3681,3709,28,1,87.27433628,Arch
f2144a5df6232e88668f5808b9e7be65ba952c37,2,30,11,19,41,1,0,1,63,173,1,1,0.165427034,1555,3,2094,5,409,404,5,9546,9432,114,128,127,1,1,100,NoArch
98433c469bc7616f705126e797802fe6057ff252,282,15289,26457,11168,41746,29,48,77,710,567,3,63,5.28150861,98503,1,2031,3,14494,16334,1840,418327,459092,40765,6393,6409,16,0,91.78497066,Arch
6eaa05e1426af097ae33d8256f0b150fca7c0459,542,48255,36203,12052,84458,285,68,353,730,636,3,115,6.841018039,109216,1,2152,8,19142,17206,1936,546510,502597,43913,7989,7943,46,0,79.10978119,Arch
01c6fc4f7a7925dddf7a0e0d617ea0efcdc497e7,541,36194,48245,12051,84439,200,151,351,710,492,3,112,6.840072598,120890,0,1131,0,17130,19066,1936,500761,544654,43893,7928,7974,46,1,79.10978119,Arch
1dd2f130e2a1775dee702879cd9c4ee4f10f83aa,541,48257,36206,12051,84463,284,100,384,730,638,3,115,6.841044621,108839,1,599,41,19066,17130,1936,544656,500761,43895,7974,7928,46,0,79.10978119,Arch
b494a09647c5653ae8ac2ba40f44f8937c48c7db,0,0,0,0,0,0,0,0,0,0,0,0,0,0,0,600,42,0,0,0,0,0,0,0,0,0,0,100,NoArch
8b4012c5b1bcc1cf676fa6dba42e2bc86aea40a7,0,0,0,0,0,0,0,0,0,0,0,0,0,0,0,601,43,0,0,0,0,0,0,0,0,0,0,100,NoArch
b3020f46aa346647e4b5e94455522aeefc3127a7,1,0,2,2,2,0,0,0,7,0,1,1,0,1161,2,602,44,188,188,0,4466,4482,16,72,72,0,0,100,NoArch
06507f671ebdaf73854bc3389a87255bfc1d95ce,1,0,1,1,1,0,0,0,45,0,1,1,0,376,14,603,45,58,58,0,1965,1972,7,19,19,0,0,100,NoArch
6c877c691f939e8316793af3c17a2ca1ce6b0382,0,0,0,0,0,0,0,0,0,0,0,0,0,0,0,604,46,0,0,0,0,0,0,0,0,0,0,100,NoArch
304810d75fc38e7b1216a150e7d630e607003bc5,0,0,0,0,0,0,0,0,0,0,0,0,0,0,0,2153,9,0,0,0,0,0,0,0,0,0,0,100,NoArch
f8468ab483a116ce2cbba1a7de667dfd980c82e5,0,0,0,0,0,0,0,0,0,0,0,0,0,0,0,605,47,0,0,0,0,0,0,0,0,0,0,100,NoArch
8e4b9f3a8cb36b7aaf2f87a38b4d30f2ca0753d4,0,0,0,0,0,0,0,0,0,0,0,0,0,0,0,606,48,0,0,0,0,0,0,0,0,0,0,100,NoArch
9bfa9d1a69d2f066bcb016f16a174d0c166f4685,0,0,0,0,0,0,0,0,0,0,0,0,0,0,0,554,0,0,0,0,0,0,0,0,0,0,0,100,NoArch
1b5c5860be1749ff6d4a8fff7c82599f7454c38e,276,10311,11192,881,21503,169,76,245,717,601,2,73,6.525024485,56918,0,552,0,7866,7962,96,221951,225078,3127,3686,3716,30,0,87.27433628,Arch
fef9298b6e80d84791cf8ff8978d65ae81e370ef,289,11755,10874,881,22629,195,65,260,730,580,2,77,6.573959114,57816,1,555,1,8207,8111,96,232844,229717,3127,3851,3821,30,0,86.41997167,Arch
4b011956d2457b8363ced81b8fbe8b47e2164fee,8,0,0,0,0,8,0,8,1,0,1,1,0,649,1,556,2,93,93,0,2054,2054,0,65,65,0,0,99.43957968,NoArch
160cbf606c78765cb8f8ae903d94388a605f7a9a,17,1930,1930,0,3860,0,0,0,1,0,1,1,3.68090916,1930,1,557,3,299,299,0,6904,6904,0,142,142,0,0,98.80910683,NoArch
912ba38a2994b563a1825cb55fb852dd1b6c48b9,1,0,0,0,0,1,0,1,1,0,1,1,0,395,1,558,4,90,90,0,2329,2329,0,30,30,0,0,99.92994746,NoArch
6bd1bf7de8d358b21bb6ce31bfbb66be151c6230,0,0,0,0,0,0,0,0,0,0,0,0,0,0,0,559,5,0,0,0,0,0,0,0,0,0,0,100,NoArch
1471143a19591ea94aa6f726c15ffd3e684727a4,1,1,0,1,1,1,0,1,4,7,1,1,0,336,2,607,49,27,27,0,2332,2330,2,18,18,0,0,100,NoArch
55c6243dd32e677f9351dd83e3b175c08823d91c,2,2,2,0,4,0,0,0,2,0,1,1,1,563,2,608,50,78,78,0,2865,2865,0,42,42,0,0,100,NoArch
78391b231069fdbde13ca0c5ceffe02eee379d90,0,0,0,0,0,0,0,0,0,0,0,0,0,0,0,2154,10,0,0,0,0,0,0,0,0,0,0,100,NoArch
8d3e619bd8344ce55ff56262ce7b702704bb911f,0,0,0,0,0,0,0,0,0,0,0,0,0,0,0,2155,11,0,0,0,0,0,0,0,0,0,0,100,NoArch
99e803c68028ef3b25c0e1503bf4b79cb1c5b674,0,0,0,0,0,0,0,0,0,0,0,0,0,0,0,2156,12,0,0,0,0,0,0,0,0,0,0,100,NoArch
696a473c633a4c30ff28773a231595ff567844ac,0,0,0,0,0,0,0,0,0,0,0,0,0,0,0,609,51,0,0,0,0,0,0,0,0,0,0,100,NoArch
710262cd472b225e0891f6986f9cdbf707c80706,0,0,0,0,0,0,0,0,0,0,0,0,0,0,0,610,52,0,0,0,0,0,0,0,0,0,0,100,NoArch
6a847c628e5bf69298c5c2dc111f51538cc11a70,0,0,0,0,0,0,0,0,0,0,0,0,0,0,0,611,46,0,0,0,0,0,0,0,0,0,0,100,NoArch
f840d19f982fa8502c6d45405b675e9feaa86f81,0,0,0,0,0,0,0,0,0,0,0,0,0,0,0,612,47,0,0,0,0,0,0,0,0,0,0,100,NoArch
dddac83a0b255c871e7320dd75a7935ec04f21ef,0,0,0,0,0,0,0,0,0,0,0,0,0,0,0,613,48,0,0,0,0,0,0,0,0,0,0,100,NoArch
de17da6b7b3cac5343277b1a31410405c0c870e9,0,0,0,0,0,0,0,0,0,0,0,0,0,0,0,614,49,0,0,0,0,0,0,0,0,0,0,100,NoArch
7b5b818617d6190e190f06f5866c3d925de14648,0,0,0,0,0,0,0,0,0,0,0,0,0,0,0,615,50,0,0,0,0,0,0,0,0,0,0,100,NoArch
39edbc8c32d28945eabe4e610a7e4c08c701f9e0,0,0,0,0,0,0,0,0,0,0,0,0,0,0,0,616,51,0,0,0,0,0,0,0,0,0,0,100,NoArch
7802df0932957d57e558a5f4efdf47fec23d4797,6,19,15,4,34,0,0,0,11,995,1,2,2.492203107,957,2,2157,13,122,122,0,5883,5931,48,23,23,0,1,100,NoArch
4e7053bcc32605fee31e69910635235269962076,1,1,1,0,2,0,0,0,2,266,1,1,0,2215,1,2158,14,214,214,0,5934,5934,0,120,120,0,0,100,NoArch
9eb497497224d6fd152ea3e227810f753cac3b9a,6,27,27,0,54,0,0,0,9,36,1,1,2.476154634,883,2,2159,13,10,0,10,740,710,30,10,0,10,0,100,NoArch
856ebbfebd256d56400e4e6f7f4151d223ac41e0,343,12288,13174,886,25462,206,75,281,717,575,2,80,6.882380661,66870,0,46,0,9177,9283,106,259789,262888,3099,4306,4346,40,0,84.5786119,Arch
0ccef7f494179cac3c42f4e0be02e5e84217c739,343,13174,12288,886,25462,221,81,302,730,649,2,82,6.882380661,65986,1,46,0,9283,9177,106,262888,259789,3099,4346,4306,40,0,84.5786119,Arch
23b0c910486d7b63e8c9fe0b0227163b826ead60,0,0,0,0,0,0,0,0,0,0,0,0,0,0,0,47,1,0,0,0,0,0,0,0,0,0,0,100,NoArch
9032bc9901cfe0d1142517d6c60e20aa54b0b6b3,0,0,0,0,0,0,0,0,0,0,0,0,0,0,0,48,2,0,0,0,0,0,0,0,0,0,0,100,NoArch
a17908d3d440e1c04ce23b29b76f81b381be36d2,0,0,0,0,0,0,0,0,0,0,0,0,0,0,0,49,3,0,0,0,0,0,0,0,0,0,0,100,NoArch
f3e79377faf248c05c292f68fe330b8c7b4dafe4,0,0,0,0,0,0,0,0,0,0,0,0,0,0,0,50,4,0,0,0,0,0,0,0,0,0,0,100,NoArch
358b1745ecd971e184c2a3c3f3a28e156b0f7c05,0,0,0,0,0,0,0,0,0,0,0,0,0,0,0,51,5,0,0,0,0,0,0,0,0,0,0,100,NoArch
8b7fa5d894eaa103a01c9c95aa10f11ef8fd4fbf,0,0,0,0,0,0,0,0,0,0,0,0,0,0,0,52,6,0,0,0,0,0,0,0,0,0,0,100,NoArch
ac02858dc1b0d51e6c5b1158afab4ffbac66ff18,0,0,0,0,0,0,0,0,0,0,0,0,0,0,0,2160,14,0,0,0,0,0,0,0,0,0,0,100,NoArch
8095617ad9de393daeb17568f44d645486972c8e,0,0,0,0,0,0,0,0,0,0,0,0,0,0,0,617,52,0,0,0,0,0,0,0,0,0,0,100,NoArch
e3320b7b34eb9104b17ed59c7ca5a288b31265f0,343,12288,13174,886,25462,206,93,299,717,575,2,80,6.882380661,66872,0,0,0,9177,9283,106,259789,262888,3099,4306,4346,40,0,84.5786119,Arch
cdd83b628e9f0f577476cb01b14e384ececaeb96,341,13170,12284,886,25454,221,81,302,730,650,2,81,6.88017828,64556,1,618,53,9035,8929,106,256475,253364,3111,4241,4201,40,0,84.5786119,Arch
a71e72a11ca0527aaede5d820388c4499f369d57,0,0,0,0,0,0,0,0,0,0,0,0,0,0,0,619,54,0,0,0,0,0,0,0,0,0,0,100,NoArch
35d3a6dfd4727c549c9bc35a9ed53bf689ed9fe3,4,51,51,0,102,0,0,0,56,82,2,4,0.576158828,1439,3,2161,15,415,415,0,7589,7596,7,46,46,0,0,99.92994746,NoArch
3a382245e193adb86ca58385583250a804c12eb4,2,12,5,7,17,0,0,0,82,398,2,2,0.522559375,758,1,2162,16,99,98,1,2887,2840,47,46,46,0,0,100,NoArch
d748d791b4b27efa5f96840a6c3a776fe06d2def,0,0,0,0,0,0,0,0,0,0,0,0,0,0,0,620,51,0,0,0,0,0,0,0,0,0,0,100,NoArch
2b225ad8ebfacfdf3a4241a7e1fe9e9a57f6f58c,0,0,0,0,0,0,0,0,0,0,0,0,0,0,0,621,52,0,0,0,0,0,0,0,0,0,0,100,NoArch
b6bb9e967d3efb931d8ad328cf017110033fa415,0,0,0,0,0,0,0,0,0,0,0,0,0,0,0,622,53,0,0,0,0,0,0,0,0,0,0,100,NoArch
88e1c51121d39e6f6b52231250a4729000d16490,0,0,0,0,0,0,0,0,0,0,0,0,0,0,0,623,54,0,0,0,0,0,0,0,0,0,0,100,NoArch
8c1c917aecce22d628bc91ec1cfa21b8fe47dfc9,346,12483,13375,892,25858,208,92,300,717,568,2,81,6.918537536,66285,0,1272,1,9046,9153,107,257914,261057,3143,4240,4280,40,1,84.50779037,Arch
c6e369d17dfe9cd150fcb1b5e354bde837442bb7,345,13373,12480,893,25853,222,83,305,730,642,2,83,6.917210724,64695,1,624,54,9045,8938,107,257071,253920,3151,4244,4204,40,0,84.50779037,Arch
f742ebf71859d3894d41f656cd08a65d83ce687e,0,0,0,0,0,0,0,0,0,0,0,0,0,0,0,625,55,0,0,0,0,0,0,0,0,0,0,100,NoArch
6c1bc37633e1f1173fe134c01a45a33f4165deca,0,0,0,0,0,0,0,0,0,0,0,0,0,0,0,626,56,0,0,0,0,0,0,0,0,0,0,100,NoArch
cd16b3b663cd63c32a148442e054a3c3a4c9394d,0,0,0,0,0,0,0,0,0,0,0,0,0,0,0,627,57,0,0,0,0,0,0,0,0,0,0,100,NoArch
c13af9a57bf176c1d68260983420112f7b0e190d,0,0,0,0,0,0,0,0,0,0,0,0,0,0,0,628,57,0,0,0,0,0,0,0,0,0,0,100,NoArch
a972eaa0c3a3996e47b382b5a8b5cd404c0ef7ee,0,0,0,0,0,0,0,0,0,0,0,0,0,0,0,629,58,0,0,0,0,0,0,0,0,0,0,100,NoArch
f4461bb804b575316ca1bf846bc8a12e7a1b1ec6,0,0,0,0,0,0,0,0,0,0,0,0,0,0,0,630,59,0,0,0,0,0,0,0,0,0,0,100,NoArch
e7e46c7c79ee6f5a7ba0714d0a7c75df13ae7ac6,0,0,0,0,0,0,0,0,0,0,0,0,0,0,0,2163,17,0,0,0,0,0,0,0,0,0,0,100,NoArch
ed9b3fda3b973f2f5c83fb531300231f7dd7ff43,0,0,0,0,0,0,0,0,0,0,0,0,0,0,0,631,60,0,0,0,0,0,0,0,0,0,0,100,NoArch
f11d5163287fbcbf2bc0b4743b2b5fa88af44f9c,0,0,0,0,0,0,0,0,0,0,0,0,0,0,0,632,59,0,0,0,0,0,0,0,0,0,0,100,NoArch
281dad585101bc3cb4dae421b1e32d157265f666,0,0,0,0,0,0,0,0,0,0,0,0,0,0,0,633,56,0,0,0,0,0,0,0,0,0,1,100,NoArch
8b5619642d27ba656fa7522546e55b431c4c9097,0,0,0,0,0,0,0,0,0,0,0,0,0,0,0,634,57,0,0,0,0,0,0,0,0,0,1,100,NoArch
f7d1726271b0d47008c6fb4d0cd707e095692f24,0,0,0,0,0,0,0,0,0,0,0,0,0,0,0,635,58,0,0,0,0,0,0,0,0,0,1,100,NoArch
96a6c83883312f782890fd5c87a05cd8cb3b55ac,0,0,0,0,0,0,0,0,0,0,0,0,0,0,0,636,59,0,0,0,0,0,0,0,0,0,0,100,NoArch
d599b5ca82f4f86da6a8f4b514aae81ecc8440e7,0,0,0,0,0,0,0,0,0,0,0,0,0,0,0,636,51,0,0,0,0,0,0,0,0,0,0,100,NoArch
2261957ee28f3f48c685d833ef6b89dfb6f9ac68,0,0,0,0,0,0,0,0,0,0,0,0,0,0,0,638,51,0,0,0,0,0,0,0,0,0,0,100,NoArch
a784d1ab5ba7b4fc5bc64e2247d6ed1fdbab9ccf,0,0,0,0,0,0,0,0,0,0,0,0,0,0,0,11,0,0,0,0,0,0,0,0,0,0,0,100,NoArch
3d19592d95f0587a4c9158875ffe0924289b5d00,0,0,0,0,0,0,0,0,0,0,0,0,0,0,0,12,1,0,0,0,0,0,0,0,0,0,0,100,NoArch
91bdbc024ce6c11b036204d7b4ad6d5eacd0ed9e,1,6,5,1,11,0,0,0,17,1662,1,1,0,174,4,2164,4,38,38,0,1197,1177,20,10,10,0,1,100,NoArch
6811b9a753ebfde8655359cfaea85474455ff25e,1,11,2,9,13,0,0,0,30,193,1,1,0,860,4,2165,5,107,105,2,4502,4426,76,24,24,0,0,100,NoArch
2bdf87a5e0966fbfef7746a9af62d6b5ede2a207,3,135,146,11,281,0,0,0,2,744,2,2,1.139299264,177,1,2166,6,9,9,0,419,478,59,7,7,0,0,99.55947137,NoArch
c1350c7f7f4d37e60072b2816eae3b5d192e251e,0,0,0,0,0,0,0,0,0,0,0,0,0,0,0,2167,7,0,0,0,0,0,0,0,0,0,0,100,NoArch
849ec266cf9f237ca94eb3da36f54fe6151dbf15,0,0,0,0,0,0,0,0,0,0,0,0,0,0,0,2168,8,0,0,0,0,0,0,0,0,0,0,100,NoArch
ca514dda170792c22f2edc139fce0db01d2416e0,1,0,10,10,10,0,0,0,3,0,1,1,0,36,1,2169,9,0,2,2,31,68,37,0,2,2,0,100,NoArch
f5c291af3dc05158bd68484b263590cd9330709f,604,38784,50825,12041,89609,240,145,385,710,488,3,117,7.049658257,125825,0,2032,0,17846,19791,1945,521448,565288,43840,8269,8323,54,0,75.6873823,Arch
2912dac734ba1a551555dbef8ca23b311a0e2333,1,6,5,1,11,0,0,0,17,1662,1,1,0,174,4,2033,1,38,38,0,1197,1177,20,10,10,0,1,100,NoArch
93d45428fd5fb96081a593f227089f19df2cc2e1,603,50836,38786,12050,89622,322,121,443,730,650,3,120,7.048912239,113610,1,639,19,19757,17808,1949,564166,520271,43895,8313,8259,54,1,75.6873823,Arch
d51bc0ebca8adae37e151cf0467630408421ed56,1,9,3,6,12,0,0,0,190,2,1,1,0,2786,3,640,20,783,780,3,18490,18431,59,96,96,0,1,100,NoArch
b5f516f3daba4541a8cbe5e3ae70aa4a7d4c382f,2,14,1,13,15,1,0,1,191,100,1,2,0.566509507,3174,3,641,21,878,874,4,21369,21279,90,113,113,0,1,100,NoArch
fe708bb88442de343ea0d2a08f60b434ba5d7d40,0,0,0,0,0,0,0,0,0,0,0,0,0,0,0,642,22,0,0,0,0,0,0,0,0,0,0,100,NoArch
e10982eec2e0d95ec89536f589d7d52700c4ca77,1,12,7,5,19,0,0,0,192,3,1,1,0,2792,3,643,19,776,783,7,18459,18490,31,96,96,0,1,100,NoArch
33cb232f9c6fdc38f0a863afec3ae4f2481a18de,2,59,10,49,69,1,0,1,57,84,1,2,0.781281209,1522,5,644,18,495,478,17,8658,8391,267,60,59,1,1,100,NoArch
9fbe72b5cb79a57de65f5234df2a95127868b2ff,0,0,0,0,0,0,0,0,0,0,0,0,0,0,0,645,19,0,0,0,0,0,0,0,0,0,0,100,NoArch
2169178f9bbca49056982b33a045d645d771dab3,1,2,2,0,4,0,0,0,193,0,1,1,0,2797,3,646,20,779,776,3,18487,18459,28,96,96,0,1,100,NoArch
c8325a8cb320dbc12bad8b200019d00ec4233256,1,24,0,24,24,1,0,1,194,0,1,1,0,2797,3,647,21,793,779,14,18687,18487,200,96,96,0,1,100,NoArch
02075afe5a8dbd8b2e083d9b08a7e363c7b8cfea,2,3,2,1,5,1,0,1,14,422,1,2,0.721928095,373,1,648,20,51,51,0,2268,2261,7,16,16,0,1,100,NoArch
ebfb63b60189133fbddb4f19e023ca40803f0811,1,14,7,7,21,0,0,0,195,4,1,1,0,2821,3,649,17,795,793,2,18718,18687,31,96,96,0,1,100,NoArch
ef0f53430d199d170103d0261d9f66db045631d4,0,0,0,0,0,0,0,0,0,0,0,0,0,0,0,650,18,0,0,0,0,0,0,0,0,0,0,100,NoArch
1f41b791c7dcd4b19b94486b8e00001ac83ceb75,1,5,0,5,5,1,0,1,196,13,1,1,0,2828,3,651,12,796,795,1,18747,18718,29,96,96,0,1,100,NoArch
442b17cffb178eff8df3bcb51aefb22fb8110872,1,91,63,28,154,0,0,0,197,0,1,1,0,2833,3,652,13,798,796,2,18820,18747,73,97,96,1,1,100,NoArch
b3a05b361a9a38a4f4c270884552bf493ba9dacb,1,21,4,17,25,0,0,0,198,0,1,1,0,2861,3,653,14,801,798,3,18909,18820,89,98,97,1,1,100,NoArch
0d210edba2f73f99a661c35cd46e487869433dce,1,14,4,10,18,0,0,0,199,0,1,1,0,2878,3,654,15,801,801,0,18976,18909,67,98,98,0,1,100,NoArch
941454b73d8f9fe65f7fe1c4d1a8fe43221727a8,1,3,0,3,3,1,0,1,58,17,1,1,0,1173,5,655,16,386,385,1,6748,6732,16,38,38,0,0,100,NoArch
c3665cfa7cd4f2162052ecf793489c381e13e807,1,9,3,6,12,0,0,0,59,0,1,1,0,1176,5,656,17,386,386,0,6794,6748,46,38,38,0,0,100,NoArch
346816730d22a6d4464368023727a2911c0fa163,1,1,1,0,2,0,0,0,60,0,1,1,0,1182,5,657,18,386,386,0,6794,6794,0,38,38,0,1,100,NoArch
e2d4c0d82c85bd5661934d23e4164ea45e822e56,1,17,2,15,19,0,0,0,61,1,1,1,0,1182,5,658,19,391,386,5,6917,6794,123,39,38,1,1,100,NoArch
ea5724b26ff23365cc1526a97a0a9665895facce,0,0,0,0,0,0,0,0,0,0,0,0,0,0,0,2170,6,0,0,0,0,0,0,0,0,0,0,100,NoArch
77e0ac1ec63a525987a2a39052cfdb7d0cab53b5,1,37,20,17,57,0,0,0,200,2,1,1,0,2888,4,1273,0,803,801,2,19054,18976,78,99,98,1,1,100,NoArch
360ffc8d4d97e588347d069bdd6149ed4e0f27df,2,18,1,17,19,1,0,1,201,12,1,2,0.629249224,3300,4,659,20,904,898,6,22060,21933,127,116,116,0,1,100,NoArch
4605c347fc4e83e93cca4ccc56fecb7e4466b9c6,2,5,2,3,7,1,0,1,202,169,1,2,0.985228136,3086,4,660,21,852,851,1,20133,20112,21,104,104,0,1,100,NoArch
4c803cd5e4462d0435b62245a749c7e763593a10,2,203,0,203,203,2,0,2,731,61,1,2,0.754186257,13902,1,2171,7,1697,1680,17,46295,45792,503,1032,1021,11,1,99.96455158,NoArch
67caa8e67aac409e9d67e008845c6d0779123c5a,0,0,0,0,0,0,0,0,0,0,0,0,0,0,0,2172,8,0,0,0,0,0,0,0,0,0,1,100,NoArch
64ae0fb755279b1b6c85f66ab5b21eaad6d4157b,1,4,0,4,4,1,0,1,62,0,1,1,0,1197,5,661,22,393,391,2,6938,6917,21,39,39,0,1,100,NoArch
87042927ed8d3542bdb38ab211c2b0b5d5c7f96b,1,33,1,32,34,0,0,0,25,20,1,1,0,398,5,662,23,121,110,11,2142,1926,216,23,22,1,1,100,NoArch
b8d06ac2f65299e0e032a66f6c24fda3846610c4,3,9,4,5,13,0,0,0,15,284,1,2,1.460484681,497,1,663,24,79,78,1,2702,2650,52,31,31,0,1,100,NoArch
84ee142ddb90bf875269e77460792c62e34e2795,4,103,11,92,114,1,0,1,203,102,1,3,0.894364085,3607,4,664,25,958,951,7,24516,23780,736,132,129,3,1,99.66672514,NoArch
9ec2e1e39feda0a9e7d97c14b3ab2cb101c48750,1,1,1,0,2,0,0,0,11,0,1,1,0,158,1,665,26,25,24,1,595,586,9,13,13,0,1,100,NoArch
a7ceab0c8c3107c716c938873c186ccac9520b79,0,0,0,0,0,0,0,0,0,0,0,0,0,0,0,2173,9,0,0,0,0,0,0,0,0,0,0,100,NoArch
113cd464304bf4f4a25515f56a1f0ae57e7f965e,0,0,0,0,0,0,0,0,0,0,0,0,0,0,0,2174,10,0,0,0,0,0,0,0,0,0,0,100,NoArch
b6686e813062852ead662c45875f49eb99220ed8,0,0,0,0,0,0,0,0,0,0,0,0,0,0,0,2175,11,0,0,0,0,0,0,0,0,0,0,100,NoArch
49c1f975f0d51dd38cd8123e9879a8220aad5e6c,1,85,38,47,123,0,0,0,5,227,1,1,0,103,1,666,27,16,11,5,727,694,33,6,2,4,2,100,NoArch
ce87fd41f20a724f3e82b567a3f0c311c27daee4,2,16,14,2,30,0,0,0,29,179,1,2,0.650022422,974,1,667,28,212,212,0,6814,6755,59,40,40,0,1,100,NoArch
2d64b03bb0feb1dec559cdff4225a22bacde2c2a,2,27,14,13,41,0,0,0,31,127,1,2,0.996134484,1027,1,668,29,133,127,6,5713,5632,81,28,27,1,1,100,NoArch
2ec7e3944eb1c68ddc081cffbcda17e4f73b1ea6,1,6,0,6,6,1,0,1,63,3,1,1,0,1201,5,669,30,397,393,4,6980,6938,42,39,39,0,1,100,NoArch
631ace039705602e7d5057d908e5add97e4479c8,1,2,2,0,4,0,0,0,27,0,1,1,0,494,1,670,31,103,103,0,3689,3689,0,19,19,0,1,100,NoArch
8e39c6909ad225f0eda498b0d9935a35aaf479eb,1,2,1,1,3,0,0,0,204,2,1,1,0,2906,4,671,32,806,805,1,19090,19084,6,99,99,0,1,100,NoArch
3eadd03e5321ee7edd76753c8b890eb9c8580376,1,8,4,4,12,0,0,0,64,0,1,1,0,1207,5,672,33,397,397,0,6987,6980,7,39,39,0,1,100,NoArch
96eb1bfb72f3f3f43c4fa4716f71f97ddb4219fc,0,0,0,0,0,0,0,0,0,0,0,0,0,0,0,673,34,0,0,0,0,0,0,0,0,0,1,100,NoArch
36f39e64cea3552df5ae06c3076b355a45755c4c,0,0,0,0,0,0,0,0,0,0,0,0,0,0,0,674,35,0,0,0,0,0,0,0,0,0,0,100,NoArch
65f98f917df5adad3877756c0cad643ba4240666,604,38796,51468,12672,90264,240,162,402,710,489,3,117,7.045504825,126295,0,1132,0,17811,19869,2058,520323,567251,46928,8262,8338,76,1,75.71242317,Arch
cadfe7b016f36ef4baec3f61876d7cc935bba5f9,1,1,1,0,2,0,0,0,180,406,1,1,0,1425,17,1133,1,274,274,0,9077,9077,0,52,52,0,1,100,NoArch
26ac8413488029475dabe749805cb5ec3158819d,604,51476,38804,12672,90280,323,121,444,731,650,3,120,7.045970009,113623,1,2176,6,19869,17811,2058,567251,520323,46928,8338,8262,76,0,75.71242317,Arch
ab8f9eb8c97af75a9a384f7f2388d3721e2f8085,0,0,0,0,0,0,0,0,0,0,0,0,0,0,0,2177,7,0,0,0,0,0,0,0,0,0,0,100,NoArch
837dc41fe6b8e4c96abaeaa481a52e1d58e9c80f,0,0,0,0,0,0,0,0,0,0,0,0,0,0,0,675,26,0,0,0,0,0,0,0,0,0,0,100,NoArch
