CommitID,NMF,TotalAddLines,TotalDeleteLines,LC,FileAdd,FileDelete,NAD,NDVE,NUC,AGE,NMS,NMD,Entropy ,MLMF,EXP,REXP,CommitComplexity,LastCommitComplexity,CFC,CommitTokenCount,LastCommitTokenCount,NCC,CommitMethodNum,LastCommitMethodNum,NMC,NIR,a2a,Tag
4418d0b9f0aa074bc297df8e82f6940bddbb53d5,0,0,0,0,0,0,0,0,0,0,0,0,0,0,37,4,0,0,0,0,0,0,0,0,0,0,100,NoArch
55e25ed90aff08736a3871ff484d08de8348feda,0,0,0,0,0,0,0,0,0,0,0,0,0,0,38,5,0,0,0,0,0,0,0,0,0,0,100,NoArch
248987badd2efb255495c2afaa2101d2bc72cd0f,0,0,0,0,0,0,0,0,0,0,0,0,0,0,1272,5,0,0,0,0,0,0,0,0,0,0,100,NoArch
f22ecfa54958c7d812c50720dd1ef1bfb7f943b5,1,12,2,10,0,0,0,3,6,118,1,1,0,110,11,4,9,8,1,564,533,31,3,2,1,1,100,NoArch
d1c72b80c67814f670a3d87580f44f913c4eb0e5,5,57,7,50,1,0,1,1,26,31,2,5,1.375165176,2897,14,1,312,310,2,17104,16938,166,149,148,1,1,99.91360691,NoArch
7dd2142065f0348fe9ce89974b4a5751330452e3,0,0,0,0,0,0,0,0,0,0,0,0,0,0,1273,5,0,0,0,0,0,0,0,0,0,1,100,NoArch
05e099f3986e7e52c6213e26e9e9d8044987e9f6,0,0,0,0,0,0,0,0,0,0,0,0,0,0,1274,6,0,0,0,0,0,0,0,0,0,1,100,NoArch
bb333e20519ae6299a8adf235dc1bcc82a1cb9a2,10,30,15,15,0,0,0,9,67,431,3,6,2.957448599,10182,1275,7,905,905,0,41623,41609,14,594,594,0,1,100,NoArch
10830827e9360b7e181fb20993275927469a7d0d,0,0,0,0,0,0,0,0,0,0,0,0,0,0,1276,8,0,0,0,0,0,0,0,0,0,1,100,NoArch
80bbb5bf2a53612be6bf2e6f086141e84c5e9a61,1,3,3,0,0,0,0,1,8,647,1,1,0,600,1277,7,68,68,0,3156,3154,2,27,27,0,1,100,NoArch
19a67e1de28dcb7576589222f79c804a3b81975c,16,203,37,166,1,0,1,2,68,305,1,7,3.162259217,22733,1278,8,2394,2362,32,101203,100469,734,1059,1051,8,1,99.23164485,NoArch
c7809245478a74b3e574f2899589d83dfb27817f,2,75,12,63,0,0,0,10,69,24,1,2,0.157906374,7781,0,0,527,523,4,33194,32792,402,397,394,3,1,100,NoArch
8cd8ad9259bbab48b8794e6033eafddc2d611698,2,4,4,0,0,0,0,2,6,513,1,2,0.811278124,96,1279,9,0,0,0,50,50,0,0,0,0,1,100,NoArch
737846ee992cbeb6513075fdda5d99b42b6cf515,1,5,6,1,0,0,0,4,20,9,1,1,0,4506,0,0,648,648,0,20320,20336,16,174,174,0,1,100,NoArch
4e61eae560f5e2e46ca96a1002522cd1a3317a4e,1,41,0,41,0,0,0,5,27,81,1,1,0,1446,1280,10,181,175,6,3880,3731,149,175,169,6,1,100,NoArch
16478ee19e53bd20c249170de2a5e7e83a68b1d3,5,1130,1031,99,2,0,2,1,70,59,1,2,1.536949253,8565,1281,9,546,544,2,37665,37130,535,415,413,2,0,93.21990533,Arch
3e7efce6e9eafd1c3fcaaac5ce9b1c2e483e8446,4,105,0,105,0,0,0,1,12,309,1,4,1.868140431,2553,1282,10,490,464,26,12939,12253,686,296,283,13,1,96.11226133,Arch
f155666156c26fa43e4191af43ad99a779aad5b0,2,54,2,52,0,0,0,4,19,59,1,2,0.371232327,3467,12,1,437,436,1,16705,16529,176,232,231,1,1,100,NoArch
33f737ea4fe2bc84b5df7c9df024359c9d1178d2,7,143,1,142,1,0,1,8,44,219,1,3,1.583021775,4144,5,0,326,308,18,18224,17611,613,240,231,9,1,99.96615523,NoArch
3e49bc4384ae51732f8b3589c4a0db77001f1890,1,11,7,4,0,0,0,2,2,0,1,1,0,97,39,0,16,16,0,468,482,14,8,7,1,1,100,NoArch
d3c5acd3a95e1926e0985e99a2d802a60e096b32,2,61,0,61,0,0,0,5,19,91,1,2,0.120681014,3049,13,0,336,335,1,14089,13772,317,132,131,1,1,100,NoArch
24b074715c2663d78c0b2a2d42e0711c733b1f40,14,510,138,372,0,0,0,8,45,202,1,5,2.970241367,10916,1283,3,1177,1083,94,47460,45470,1990,655,614,41,1,99.96615905,NoArch
81b487684f9a0781d6e58494cba1b690ff42c028,4,72,39,33,0,0,0,1,20,623,1,2,1.338755522,2787,1284,4,346,341,5,11768,11565,203,102,101,1,1,88.72864744,Arch
3be816f450450e8e43286e6ea208af6e30520146,27,3957,215,3742,2,0,2,4,23,95,2,7,1.644441679,14403,15,0,2854,2213,641,95379,75761,19618,1430,1183,247,1,99.19043238,NoArch
6c35f3b81c0dc9d37897dd7304098204e96ee883,1,62,1,61,0,0,0,3,19,97,1,1,0,6089,1285,5,308,298,10,16126,15704,422,281,280,1,1,100,NoArch
14419d8c360da8bdfa9d29f8c1d2fff357106db0,2,31,11,20,0,0,0,10,71,42,1,2,0.973668065,7928,1286,6,571,566,5,35356,35278,78,369,369,0,1,100,NoArch
d259cad23d396cef213f6e773f2e22e205f4230c,1,15,87,72,0,0,0,7,24,3,1,1,0,3200,16,1,658,675,17,16186,16412,226,205,205,0,1,100,NoArch
cd58fe73f29dd576ac2525f22c34e9b3d4df1913,3,147,14,133,0,0,0,3,25,2,1,3,1.11223902,14576,17,2,2546,2528,18,77977,77485,492,1243,1238,5,1,100,NoArch
b0fa9f379a2ed4426130bc565c55af74becbcd25,1,6,2,4,0,0,0,4,4,8,1,1,0,138,0,0,29,28,1,705,688,17,11,11,0,1,100,NoArch
9be2bdb96a0f40de463ab867ab8232712c544ed8,3,67,5,62,0,0,0,4,18,79,1,3,0.94056624,3952,0,0,520,507,13,19891,19664,227,255,245,10,1,100,NoArch
8281668fbf7b5f1cc5f64796ebe1604ae634510d,4,67,61,6,0,0,0,4,19,224,1,3,1.788957377,4991,1287,4,648,654,6,23599,23556,43,309,315,6,0,100,NoArch
9c86556ff397f2548bffe90e7e338774d329211d,5,18,54,36,0,0,0,2,10,652,3,3,1.348370539,1490,1288,5,99,105,6,3450,3636,186,72,72,0,1,100,NoArch
e9d506021252e1da6c09cebad3f747cd0e627d90,8,259,10,249,0,0,0,3,32,366,1,6,2.18322528,15268,2,0,1157,1133,24,56386,55172,1214,591,576,15,1,100,NoArch
937fc461a375818921e8147c2d23e26b7e8dfca0,6,59,65,6,0,0,0,3,33,0,1,4,1.416487672,14039,1289,6,1092,1093,1,51468,51500,32,545,546,1,1,100,NoArch
de3880298b180a38013c2a748758c863082ac272,10,152,16,136,0,0,0,3,34,181,1,8,2.608484426,14756,13,0,1678,1657,21,71793,70929,864,577,570,7,1,100,NoArch
a850c41e2da262234475ec56383457475e9fabee,2,54,3,51,0,0,0,1,4,803,1,2,0.707669,356,1290,7,30,21,9,2113,1808,305,19,17,2,1,100,NoArch
fa08c46d3f9b1d5bb6f8f2772effb76d02cecb9a,1,4,0,4,0,0,0,4,20,19,1,1,0,6150,0,0,308,308,0,16135,16126,9,281,281,0,1,100,NoArch
a8a8878da1d3f9a1847ca2f39747cd37af890571,3,1431,0,1431,3,0,3,1,1,0,1,2,0.922829407,0,3,0,217,0,217,7636,0,7636,78,0,78,1,99.79846097,NoArch
eedd3dc4cc2c28eb05bc42edeaaeb196920da864,5,130,54,76,0,0,0,5,19,144,1,5,1.015579453,3263,1291,8,407,391,16,16294,15877,417,168,165,3,0,100,NoArch
980d9f811af4e0ff32fc1487e469a51585db48a6,4,858,826,32,1,0,1,1,19,106,1,2,1.511903578,2837,1292,9,464,463,1,16825,16767,58,166,165,1,0,96.01843318,Arch
47e0e7c952aed22dd237529bb459a59580034f91,5,200,1021,821,0,0,0,4,20,11,1,3,1.216132395,3017,1293,10,319,464,145,12389,17499,5110,136,166,30,0,88.77961556,Arch
963ba1b1b3d2ab95989d8383e0a855c3ae5e24cb,3,124,36,88,0,0,0,2,72,27,1,2,1.343417753,9349,72,0,731,723,8,43498,43191,307,450,446,4,1,100,NoArch
83fedf32ff1017a157e983bd94faff3d2a4dc482,11,49,65,16,0,0,0,1,26,81,3,6,2.650655568,7355,1294,11,1123,1123,0,36145,36145,0,361,361,0,0,100,NoArch
352aaeade9c9b1d99710009e0509cfe8ddfdb698,1,8,4,4,0,0,0,4,10,29,1,1,0,830,14,1,102,100,2,3242,3240,2,32,32,0,1,100,NoArch
84b55ef5877f947548bb19ce1133fb0abd9a6d29,3,35,3,32,0,0,0,10,73,305,1,3,1.504379003,6890,15,2,452,444,8,28846,28673,173,327,325,2,1,100,NoArch
8c2bc8f16b7b26fed7a53aa06f940341dea18219,4,20,19,1,0,0,0,10,74,825,1,2,0.863222579,6728,1295,12,411,411,0,27549,27547,2,312,312,0,1,100,NoArch
02e7ad61321f9690b41cc1c93c6b9c92fb925451,0,0,0,0,0,0,0,0,0,0,0,0,0,0,1296,13,0,0,0,0,0,0,0,0,0,1,100,NoArch
d55ff83ff3a45b6adffb840daefac3cd2aea34e5,2,86,45,41,0,0,0,1,46,168,1,1,0.928139351,2157,1297,14,179,175,4,9537,9330,207,174,172,2,1,100,NoArch
5197a714705c7bfaa6a46a0907267b47870b18d1,8,294,34,260,1,0,1,8,75,256,1,5,2.299875506,14134,1298,15,1250,1220,30,61689,60345,1344,677,668,9,1,99.97513675,NoArch
f12aa72ec79f8300be6441c1afd83c908f9fe0be,5,51,2,49,0,0,0,6,76,74,1,3,2.003825763,15551,0,0,1494,1486,8,67354,67141,213,819,816,3,1,100,NoArch
82fd259c64e94eb58bf163183871e1c9d6332b62,6,177,44,133,0,0,0,2,7,290,1,4,2.03747846,3135,4,1,376,356,20,11360,10863,497,151,145,6,1,100,NoArch
322b97300d460cf7c98b6002e4f0d5dab455f188,16,2190,196,1994,1,0,1,8,27,75,3,7,2.278343476,31734,18,3,5429,5110,319,180215,168959,11256,2938,2701,237,1,99.11072144,NoArch
1bbb6a2b97bf3da149c5f878b2d59ceafa737521,1,8,1,7,0,0,0,5,17,184,1,1,0,821,19,3,164,164,0,5588,5535,53,42,42,0,1,100,NoArch
1c5eddd0494f8b292736a4c6e300da4c697235f0,0,0,0,0,0,0,0,0,0,0,0,0,0,0,20,2,0,0,0,0,0,0,0,0,0,1,100,NoArch
eaa35a41b4df6474c50e4b7437d8c1834265661f,17,63,64,1,0,0,0,1,21,486,3,11,3.450331308,14202,1299,10,1928,1928,0,59526,59542,16,831,831,0,1,100,NoArch
e7bbcec8f451dbc2b02434eba6d17138e1d44e6e,0,0,0,0,0,0,0,0,0,0,0,0,0,0,21,3,0,0,0,0,0,0,0,0,0,1,100,NoArch
60b2825c8a49c62ea3caf2212521809ebc545bd8,0,0,0,0,0,0,0,0,0,0,0,0,0,0,22,4,0,0,0,0,0,0,0,0,0,1,100,NoArch
c8709f3874740f198b7423d1acc7d31b423725a3,8,55,56,1,0,0,0,1,77,363,5,7,2.327853602,14898,1300,10,1671,1671,0,68122,68122,0,764,764,0,1,100,NoArch
f0899a69372ed8eddc714c5dfd53d208a935ef23,1,279,834,555,0,0,0,7,29,0,1,1,0,3251,1301,11,497,679,182,14149,16705,2556,234,230,4,1,100,NoArch
05fbd126b469bda718d75a3b3b3e79af819bf8b5,8,91,31,60,0,0,0,4,35,238,1,5,2.347536865,4198,16,0,415,411,4,21139,20868,271,200,197,3,1,100,NoArch
39f505fa9def053be54b548c030acb3e3973aa02,1,3,2,1,0,0,0,2,10,19,1,1,0,438,17,1,66,66,0,2605,2606,1,23,23,0,1,100,NoArch
808d540b3df47d98b25eeb83ee8f407909ba8c3a,3,17,14,3,0,0,0,2,13,155,1,2,0.965527262,1213,1302,0,126,126,0,4967,4936,31,77,77,0,1,100,NoArch
8531ab11715109716215c0006d28014754e566f9,16,230,181,49,0,0,0,4,31,303,1,3,3.397695943,7077,1303,1,519,511,8,23696,23698,2,187,189,2,1,86.60856935,Arch
904c73da60b9f9deec61ea34d89ada3462381f93,5,128,251,123,0,1,1,8,48,80,1,3,1.748687707,6912,1304,2,746,758,12,30273,31054,781,330,333,3,1,100,NoArch
efb668bb58cdc85e85facba3ec2365549778eee8,7,102,15,87,0,0,0,1,46,275,2,7,2.364168005,9511,1305,3,1104,1085,19,46047,45505,542,447,438,9,1,100,NoArch
d4bbf58d6e5f4f67ebae412b5a1aae23769eccb7,18,357,120,237,0,0,0,1,23,417,1,8,3.46850685,12628,1306,4,1975,1937,38,65630,64315,1315,850,837,13,1,85.50157918,Arch
894dd9b522228f43d26eba8fabcf244a33029d19,1,2,1,1,0,0,0,2,4,64,1,1,0,388,1307,5,30,30,0,1283,1267,16,29,29,0,0,100,NoArch
b94a00e335d0378ec912cb029f407abf811aaa12,0,0,0,0,0,0,0,0,0,0,0,0,0,0,23,0,0,0,0,0,0,0,0,0,0,1,100,NoArch
4a29b3ccf64e9a7d1534f540fd7f6d3d813605a0,6,311,16,295,4,0,4,1,6,65,2,2,2.223918083,574,73,0,82,60,22,3566,2289,1277,57,42,15,0,99.83901261,NoArch
ba1eee121c52ab0c2891fd4faa423e0a55f5b5f9,0,0,0,0,0,0,0,0,0,0,0,0,0,0,74,1,0,0,0,0,0,0,0,0,0,0,100,NoArch
b1fdd1280aafc883d7e088d5527621a789f6170d,2,54,1,53,0,0,0,3,14,525,1,2,0.999761525,1701,1308,6,135,129,6,11118,10822,296,82,81,1,0,100,NoArch
970a8ca9130111d9ed3425e6ef74d9c86f43c54a,1,60,0,60,0,0,0,1,5,85,1,1,0,100,1309,7,12,12,0,474,474,0,6,6,0,0,100,NoArch
77e6f49c680cd154195e9e66c19356f0a2251bad,6,20,8,12,0,0,0,1,18,520,4,4,2.128085279,4868,1310,8,454,453,1,17074,17043,31,206,205,1,1,100,NoArch
4ae0298688d402484be7c76610e46c6f610a8bc6,6,71,44,27,0,0,0,2,21,258,2,6,2.028248435,10065,1311,9,912,912,0,41279,41165,114,422,422,0,0,100,NoArch
b5b28f0b2d263a2e2fb6894d67c8666549f4d053,6,27,9,18,0,0,0,4,33,234,1,4,2.526111893,9533,1312,10,1361,1358,3,44818,44768,50,537,536,1,0,100,NoArch
9a52b5eda9fcfb4e6a7ad94fbd4a1c3fa2fb869a,39,404,445,41,0,0,0,6,47,492,1,12,4.590492059,33333,1313,11,4031,4034,3,132708,132222,486,1611,1610,1,1,94.76685251,Arch
8bc5f8538f5c284e93ddc4ecfb59dab9458117f7,1,47,7,40,0,0,0,1,6,307,1,1,0,751,1314,12,96,86,10,2856,2609,247,22,21,1,1,100,NoArch
4762b889699f5fb963749dca8b3106c17f44f2a9,20,372,84,288,0,0,0,5,78,582,1,10,3.474188439,31528,1315,13,2208,2181,27,111534,110142,1392,1390,1374,16,1,99.60582895,NoArch
7837e64c3294aa776ca38cba3f756550af3494ab,12,340,111,229,0,0,0,2,22,336,1,6,2.57632005,9990,1316,14,1166,1110,56,44378,43395,983,471,463,8,0,100,NoArch
c104c75bdf6d663070cf16b5ab0f94f8c269c9b6,5,212,112,100,1,0,1,3,79,14,1,4,1.769611107,9845,1317,15,628,623,5,44998,44459,539,461,457,4,1,99.97625831,NoArch
239babd8fc26bf35be96a77fbfbea379138f3a37,2,51,17,34,0,0,0,1,11,221,1,2,0.478250164,1591,1318,16,230,225,5,9135,8999,136,101,98,3,0,100,NoArch
cd92b77c476f7b095b330507402bfc6c3208e300,3,34,35,1,0,0,0,2,6,472,1,2,1.07801114,1932,1319,17,215,216,1,5469,5502,33,94,94,0,0,100,NoArch
505a9064b96a6c8399735fc2fa4d0ac9d5f3ed87,80,3606,1721,1885,4,0,4,4,80,451,1,22,4.285161172,67395,1320,18,7176,6915,261,295314,284362,10952,3500,3328,172,2,97.226831,Arch
4b519b9882c861bf366e2c9d9928cd6deb5cc8b9,10,232,142,90,1,0,1,4,81,0,1,4,2.379763201,17425,1321,19,1555,1544,11,75035,74470,565,699,693,6,1,97.30726257,Arch
2cef85941359c530e7f0ed40265ce3c6f9db6bf8,2,23,6,17,0,0,0,3,19,99,1,2,0.735508582,2376,1322,20,60,57,3,6720,6658,62,31,30,1,0,100,NoArch
cabdcf44e4aec4d4ceea7f97c8c6fd9e9dbd36b1,124,1919,1571,348,2,0,2,2,82,489,3,24,5.853031666,50560,1323,21,4799,4741,58,229546,225286,4260,2301,2280,21,1,99.88375779,NoArch
ebcba3b5ca98d8f894000494a3858ba5a4a269a9,1,6,1,5,0,0,0,2,2,1192,1,1,0,70,6,0,7,7,0,269,253,16,3,3,0,1,100,NoArch
a67b4a976bef6c104212732c6a8f8ce364c372ba,2,25,3,22,0,0,0,4,16,6,1,2,0.749595257,2654,40,0,297,296,1,14553,14426,127,171,170,1,1,100,NoArch
0045e01f6178df5bcc8caf780040f3cff159bb20,2,20,0,20,0,0,0,2,10,202,1,2,0.992774454,420,14,0,32,31,1,1849,1750,99,21,20,1,1,100,NoArch
361096ba1d0436f588e4c7a3290560059882223f,5,978,75,903,0,0,0,4,27,172,1,4,1.025937347,18272,24,1,2824,2709,115,92845,88733,4112,1481,1432,49,1,99.52355744,NoArch
b4b04d29cb63ceea123ec41dd3247a0555f9c150,3,17,1,16,0,0,0,4,51,113,2,3,1.299736764,6696,0,0,940,937,3,29727,29657,70,257,255,2,1,100,NoArch
e15f89e5823104f0890ee92675cc0da45dcec4ca,0,0,0,0,0,0,0,0,0,0,0,0,0,0,1324,22,0,0,0,0,0,0,0,0,0,0,100,NoArch
5323d8d48baa2d7bc8dea8b03bc0bda93563e0f9,4,27,2,25,0,0,0,3,11,363,1,3,1.376074607,1112,1,0,73,71,2,3753,3636,117,59,57,2,1,100,NoArch
2712d7dafc1b724c33b0c29846666c1903d5afb2,1,9,4,5,0,0,0,3,7,9,1,1,0,318,75,2,45,45,0,1731,1720,11,8,8,0,1,100,NoArch
3cba7055061108ce0e079d8756bcfb020b8628c3,2,341,121,220,0,0,0,1,3,1276,1,2,0.997348798,748,1325,23,128,106,22,5547,4164,1383,35,32,3,1,100,NoArch
ee283cadf17d8add8e8ea2bf1f8dd5735f05dc1d,2,54,0,54,0,0,0,4,17,6,1,2,0.964078765,2676,1326,24,302,297,5,14784,14553,231,174,171,3,1,100,NoArch
898fdfc2720770ec4752fb702ce0aae1521aa07d,1,48,3,45,0,0,0,6,24,13,1,1,0,1028,2,1,139,137,2,5062,5023,39,42,40,2,1,100,NoArch
cecef9d3209cbd092a6e9b578bc063a52007b99f,2,10,2,8,0,0,0,8,50,12,1,2,0.918295834,2587,18,1,224,223,1,11838,11788,50,198,197,1,1,100,NoArch
af77ec861989c50229c55be1889efcb0031cfd32,1,20,7,13,0,0,0,3,10,13,1,1,0,374,19,2,32,29,3,1982,1925,57,22,19,3,1,100,NoArch
62576556abd0467eba7c964a90b9dc2178807f7a,1,4,0,4,0,0,0,2,3,141,1,1,0,392,76,3,39,39,0,2289,2283,6,22,22,0,1,100,NoArch
df5ec6dd286ed436e52b89be36d56ba6ae66051e,0,0,0,0,0,0,0,0,0,0,0,0,0,0,1327,25,0,0,0,0,0,0,0,0,0,0,100,NoArch
c4d346b0a413a1a62e028dd3be40071523203a58,0,0,0,0,0,0,0,0,0,0,0,0,0,0,1328,26,0,0,0,0,0,0,0,0,0,0,100,NoArch
920a6488102747c138cd60064458e5b9c6aa4b29,0,0,0,0,0,0,0,0,0,0,0,0,0,0,1330,22,0,0,0,0,0,0,0,0,0,0,100,NoArch
6201013a9a8fe79c234656ec20c5fe524d68b4d5,3,109,64,45,0,0,0,8,51,63,1,3,1.201432621,3010,1331,23,266,263,3,13223,12789,434,227,224,3,1,100,NoArch
ee52f691b844d97919a8c0ca211a7c78b86165ef,6,150,44,106,0,0,0,2,36,26,1,4,2.227670043,10318,1332,24,1221,1209,12,49227,48671,556,527,522,5,1,100,NoArch
4d58768d35d5accbf7330d10b91f2541b6f1ab38,0,0,0,0,0,0,0,0,0,0,0,0,0,0,1333,25,0,0,0,0,0,0,0,0,0,1,100,NoArch
6acb28d844e336426ef9b541f6260569e19519e1,0,0,0,0,0,0,0,0,0,0,0,0,0,0,1334,26,0,0,0,0,0,0,0,0,0,1,100,NoArch
999021115689521694754d1c766feda6da467e8d,0,0,0,0,0,0,0,0,0,0,0,0,0,0,1335,27,0,0,0,0,0,0,0,0,0,0,100,NoArch
d80e26c016babcb250e41b0abe94b8b0cfadbbe7,6,94,31,63,0,0,0,6,83,429,1,4,2.034039842,16563,1336,11,1536,1526,10,68433,68018,415,777,774,3,2,100,NoArch
82b586040ffbb4a7e46544b39b2dcc165d642430,1,57,45,12,0,0,0,6,33,0,1,1,0,1766,1337,12,216,215,1,5243,5201,42,210,209,1,1,100,NoArch
4ec47270b199cef58c39f6bf07209c5fb40875ef,4,63,15,48,0,0,0,1,27,353,2,4,1.980127481,2284,1338,13,204,201,3,13723,13355,368,107,105,2,1,100,NoArch
f55d10c147746d6299fb713adc184576380a1f49,22,178,255,77,0,0,0,3,53,586,1,12,3.632869769,22991,1339,14,2937,2950,13,103494,103890,396,962,971,9,1,99.96812918,NoArch
05a57992a45f9aa66db31355aa7733cfadafa1e1,51,447,518,71,0,0,0,2,54,423,5,26,4.681150322,44377,25,0,4996,5034,38,182161,183060,899,1923,1919,4,1,100,NoArch
446d1122bda239cc928c8c15cd56edc33c4f30bf,0,0,0,0,0,0,0,0,0,0,0,0,0,0,1340,14,0,0,0,0,0,0,0,0,0,0,100,NoArch
7b944ade81f600e74b43f9ab8ef7ce84f05b3e2a,2,45,5,40,0,0,0,4,9,686,1,2,0.721928095,765,1341,11,116,112,4,4002,3780,222,51,50,1,1,100,NoArch
ecf4d6dcb4b6fdc40828d0c853ae10abc0550a76,67,423,789,366,0,0,0,1,28,798,3,23,4.542956095,24788,1342,12,3376,3497,121,109956,112347,2391,1322,1318,4,1,99.95753715,NoArch
5324a3988c8ca354c7af771b124762be3002c648,0,0,0,0,0,0,0,0,0,0,0,0,0,0,1343,13,0,0,0,0,0,0,0,0,0,1,100,NoArch
7ce2e62133be221e65d67250ad28809324d055c8,4,34,28,6,0,0,0,2,15,86,2,4,1.288227348,6525,0,0,505,505,0,27316,27246,70,230,230,0,1,100,NoArch
7e5710fc7459728a667659ea2b66895812ef839f,56,3116,50,3066,46,0,46,1,28,19,5,13,5.201835583,1786,26,1,369,202,167,20582,9004,11578,251,120,131,1,98.87922908,NoArch
4dfd6dbb232718ca60b0a4885b6e37194cfdf3c7,4,67,10,57,0,0,0,5,17,107,1,2,1.548401012,2202,0,0,186,181,5,10774,10426,348,160,155,5,1,100,NoArch
7e348654e47e2fd7cb60682da8589bfabb2318f4,0,0,0,0,0,0,0,0,0,0,0,0,0,0,1344,8,0,0,0,0,0,0,0,0,0,1,100,NoArch
e0f29dd797229a883d6461e75915cb376dd6b208,0,0,0,0,0,0,0,0,0,0,0,0,0,0,27,2,0,0,0,0,0,0,0,0,0,1,100,NoArch
670fa73e24a7b72d6ddafd69793474083bb4b9f0,22,66,64,2,0,0,0,1,37,66,1,7,4.016480675,16920,1345,5,1978,1978,0,67681,67674,7,708,708,0,1,100,NoArch
c1ceba45e5939be812bbe0bba6ee27586862b8e0,8,276,98,178,0,0,0,6,55,347,1,6,2.173850287,20598,17,0,1701,1679,22,76656,75849,807,779,773,6,1,96.12491452,Arch
72b2cfb799242e0d1d7e6aed8bfe43cceb554c7c,8,282,322,40,0,0,0,12,56,24,1,4,2.061881059,10049,1346,6,950,956,6,36700,36810,110,309,305,4,1,99.96194342,NoArch
de7759112cea3deb8a1c75bcc43753adbe8648de,2,7,3,4,0,0,0,1,2,20,1,2,0.721928095,112,28,2,4,4,0,415,388,27,4,4,0,1,100,NoArch
f650bccd1bcb364fc6be9c92214843499bac6843,2,85,0,85,1,0,1,1,26,17,1,1,0.092277248,1642,1347,6,235,231,4,8363,8068,295,118,116,2,1,99.32775241,NoArch
8bbef2d6fbba8547adc55dcbb7d5b07a7a5437bc,7,150,26,124,0,0,0,4,29,328,3,5,2.093692602,4964,1348,7,614,611,3,25162,24376,786,324,320,4,1,99.19018094,NoArch
95fd04176576958c7766c98945186092ae226764,0,0,0,0,0,0,0,0,0,0,0,0,0,0,29,2,0,0,0,0,0,0,0,0,0,1,100,NoArch
91887366c40310f2435b2677ac0d9616bed842cb,15,1869,0,1869,15,0,15,1,1,0,1,2,3.552908793,0,0,0,193,0,193,9156,0,9156,99,0,99,1,99.31680162,NoArch
d42581d9a56dba377fac5d827c03b5aa12a648b7,0,0,0,0,0,0,0,0,0,0,0,0,0,0,1349,5,0,0,0,0,0,0,0,0,0,0,100,NoArch
20fd6998094bab0ec229cb7749d66fd9d50f2929,0,0,0,0,0,0,0,0,0,0,0,0,0,0,1350,6,0,0,0,0,0,0,0,0,0,0,100,NoArch
19cfde74d726e5307276acb071c84441545b976e,1,66,10,56,0,0,0,1,9,630,1,1,0,519,1351,7,41,41,0,5146,4559,587,37,37,0,0,100,NoArch
5fdc866b72739163a6a418ea7aa1a7f68812761e,4,307,13,294,0,0,0,2,84,308,1,3,1.320687951,8282,0,0,570,563,7,37912,35916,1996,400,396,4,1,100,NoArch
f4b4ee115a53c676b81da5390a39705b0996db0b,0,0,0,0,0,0,0,0,0,0,0,0,0,0,1352,8,0,0,0,0,0,0,0,0,0,0,100,NoArch
cbbaddf5449d7547e7550d08caaadf36537cd7fd,3,65,6,59,0,0,0,3,85,81,1,1,0.949029153,8876,1353,9,689,683,6,38404,38174,230,465,461,4,0,100,NoArch
884f01066fcc31c0fc10b80e3d891101e4f315a3,0,0,0,0,0,0,0,0,0,0,0,0,0,0,1354,10,0,0,0,0,0,0,0,0,0,1,100,NoArch
8cba7fc421488cb27ce0756ecd2d422a71f72650,5,846,1,845,0,0,0,3,24,116,1,4,0.978990856,3453,1355,10,527,335,192,26271,21688,4583,240,185,55,1,100,NoArch
d14040c52f8b0bc351443cff1584e8b587378698,37,1418,198,1220,3,0,3,1,57,112,1,7,3.194714865,17647,1356,9,2175,2029,146,88051,80794,7257,926,868,58,1,96.7308667,Arch
b916a65b9615b8fff377f6b05991f445d43edf6c,1,4,2,2,0,0,0,1,2,2,1,1,0,522,1357,10,56,56,0,3507,3501,6,19,19,0,1,100,NoArch
25d1e42a7fb248d24caaaa949779e06056c9916c,2,12,2,10,0,0,0,7,26,69,1,2,0.985228136,3211,18,0,512,510,2,14742,14696,46,182,181,1,1,100,NoArch
8c90d862179f43ab8855f4ff50cbc1d5968b21a2,2,23,0,23,0,0,0,9,53,239,1,2,0.755375413,2394,5,0,206,204,2,10718,10611,107,196,195,1,1,100,NoArch
1a9be678313267963b82888a00878914d372d01c,4,40,16,24,0,0,0,7,30,212,1,1,1.940285959,2813,30,1,431,428,3,12119,12012,107,250,250,0,1,100,NoArch
ea41b3412f099c8f1051f1b324b1ba03d644962a,2,9,9,0,0,0,0,6,29,156,2,2,0.503258335,1295,31,2,180,180,0,7492,7477,15,85,85,0,1,100,NoArch
0de38aaa38e0dc43d21c0b2dac4278c67c1dc24c,6,262,189,73,0,0,0,2,31,114,1,3,1.363009877,5108,32,3,862,863,1,26349,25768,581,371,372,1,1,99.96202051,NoArch
1d3a26dfac17fea458402a637449007dc095bced,13,578,46,532,5,0,5,1,31,155,2,7,3.001415533,4183,33,4,726,692,34,23846,21841,2005,313,287,26,1,99.83565107,NoArch
aecefef8a4420e780737a8f49b72fd146679f2e2,1,85,46,39,0,0,0,6,25,0,1,1,0,319,34,5,44,42,2,2157,1853,304,26,24,2,1,100,NoArch
d27e642c497d406474fd8b543d74836152e8696c,10,2575,0,2575,10,0,10,1,1,0,1,1,2.703072741,0,35,6,627,0,627,11228,0,11228,627,0,627,1,99.6978852,NoArch
ec3d8d37c9d38a8f041c2b1b3aa68711c085b939,8,324,2,322,4,0,4,1,7,136,1,3,2.269419521,536,36,7,69,55,14,3471,2108,1363,46,37,9,1,99.79939819,NoArch
c7db615fa3432efeaa55bd3962758d48635c9e5c,0,0,0,0,0,0,0,0,0,0,0,0,0,0,0,0,0,0,0,0,0,0,0,0,0,1,100,NoArch
707e72d5c2a03f4ec5994b58109d7421ed938d9f,24,618,119,499,1,0,1,3,86,443,1,11,3.586947405,27079,1358,6,2325,2288,37,116680,113859,2821,1106,1087,19,1,91.1152648,Arch
558e442459215aeb0c4ce9106472679217c27e7c,0,0,0,0,0,0,0,0,0,0,0,0,0,0,1359,7,0,0,0,0,0,0,0,0,0,0,100,NoArch
9cd2f40267d7e4ad385f86cb59e9dc39deefc86d,1,6,5,1,0,0,0,1,4,222,1,1,0,390,1360,8,53,53,0,1206,1214,8,10,10,0,0,100,NoArch
5897dcd9d59d260a7d2b5c2dde257291fba5f9d1,0,0,0,0,0,0,0,0,0,0,0,0,0,0,1361,9,0,0,0,0,0,0,0,0,0,1,100,NoArch
5464f3329ee42106ababde679b005e6eaa6a74e1,0,0,0,0,0,0,0,0,0,0,0,0,0,0,1362,7,0,0,0,0,0,0,0,0,0,1,100,NoArch
5cee486f3ad878275ffe67e67cd8593d6bcfd62d,189,0,0,0,0,0,0,1,1,0,1,24,0,78649,37,7,11495,11495,0,377829,377829,0,6640,6640,0,1,90.48570358,Arch
65f2afa7add341c614cb59fb80f93da5e575e96a,0,0,0,0,0,0,0,0,0,0,0,0,0,0,38,8,0,0,0,0,0,0,0,0,0,1,100,NoArch
749b236c0ec72b02439403e44b29427e837e6704,0,0,0,0,0,0,0,0,0,0,0,0,0,0,39,9,0,0,0,0,0,0,0,0,0,1,100,NoArch
d3f1969cb3bc16c4b1461c32c9238593f6ba6f17,0,0,0,0,0,0,0,0,0,0,0,0,0,0,1363,8,0,0,0,0,0,0,0,0,0,0,100,NoArch
a547222bd331640c38b1ab474085f64f0242db98,0,0,0,0,0,0,0,0,0,0,0,0,0,0,1364,9,0,0,0,0,0,0,0,0,0,0,100,NoArch
9c62adac2a218b428e322e8467263cec0ed9874b,15,42,38,4,0,0,0,1,9,853,1,3,3.260859895,4399,1365,10,652,652,0,17881,17866,15,244,243,1,0,100,NoArch
eead3d21b0ef18f05029cefbb6b4fb888e75c548,0,0,0,0,0,0,0,0,0,0,0,0,0,0,1366,11,0,0,0,0,0,0,0,0,0,0,100,NoArch
cf5d07bde81a7c6a82bdab34ec798d0bf01ac01c,4,52,38,14,0,0,0,4,15,45,2,3,1.736964216,2944,1367,12,358,358,0,13924,13829,95,115,115,0,0,98.01887892,NoArch
0b9ea986b847c325da009376d3b9031c9303090e,5,214,0,214,1,0,1,7,38,52,1,5,2.208871181,20896,0,0,1093,1083,10,65299,64537,762,781,777,4,1,87.39082969,Arch
4ac82a30b8ee7ae1afcd83c6f3ef687761536f2e,10,324,381,57,0,1,1,7,39,145,1,7,2.588520944,26629,1368,13,1594,1596,2,88846,88602,244,974,970,4,1,87.39082969,Arch
50c4b0619af94ae82bc461d9598d24b3b5e0ec21,1,3,4,1,0,0,0,2,5,174,1,1,0,115,0,0,10,10,0,496,509,13,2,2,0,1,99.97828447,NoArch
82c3b293b172364058cc29dada5794659db4e389,2,61,4,57,0,0,0,2,6,269,1,2,0.99982926,890,6,1,137,124,13,5510,5148,362,54,48,6,1,100,NoArch
7901eda051dc756ba5a985d1cf2fed1942459281,0,0,0,0,0,0,0,0,0,0,0,0,0,0,40,10,0,0,0,0,0,0,0,0,0,1,100,NoArch
6b91297893f3cd2bf16431bcc51130f3741c579a,0,0,0,0,0,0,0,0,0,0,0,0,0,0,41,11,0,0,0,0,0,0,0,0,0,1,100,NoArch
83a8e883a9a50b618d5892aa708f55a5dd1bd169,4,0,846,846,0,4,4,1,2,96,1,2,1.356421983,846,42,12,0,50,50,0,4749,4749,0,35,35,1,99.89130435,NoArch
48415a80b8f7f5763cbc3ba4e90c59e3dbeca389,0,0,0,0,0,0,0,0,0,0,0,0,0,0,43,13,0,0,0,0,0,0,0,0,0,1,100,NoArch
d1bbc0abba482986cf27da3d981fe4e37058db70,0,0,0,0,0,0,0,0,0,0,0,0,0,0,44,14,0,0,0,0,0,0,0,0,0,1,100,NoArch
b58200bcfe1eda02c7c73f59adc1ddcc6495075e,0,0,0,0,0,0,0,0,0,0,0,0,0,0,45,15,0,0,0,0,0,0,0,0,0,1,100,NoArch
aacb2375e2e65249d300c847c712f342d93e6d9e,4,137,14,123,0,0,0,1,2,56,1,2,0.861122857,516,1,0,64,54,10,3447,2583,864,30,27,3,1,100,NoArch
816adb1f5b90508d132f9f22941d33a9bc5436bd,0,0,0,0,0,0,0,0,0,0,0,0,0,0,1369,12,0,0,0,0,0,0,0,0,0,1,100,NoArch
47369e33dead25b5530696554cd9d1d7dbb7fb80,0,0,0,0,0,0,0,0,0,0,0,0,0,0,46,16,0,0,0,0,0,0,0,0,0,1,100,NoArch
67d23ba81e57ce2aca86d7d995ed44bddc5f8cc3,0,0,0,0,0,0,0,0,0,0,0,0,0,0,47,17,0,0,0,0,0,0,0,0,0,1,100,NoArch
b30e570fa0f250e0bcaef9cf680af0fa335d3855,0,0,0,0,0,0,0,0,0,0,0,0,0,0,48,18,0,0,0,0,0,0,0,0,0,1,100,NoArch
6c9c3d66f0bf849096d9cf18e348c7369db07eb3,0,0,0,0,0,0,0,0,0,0,0,0,0,0,49,19,0,0,0,0,0,0,0,0,0,1,100,NoArch
39b30bd111154b4b28489a5940e2c88ec4588d3f,0,0,0,0,0,0,0,0,0,0,0,0,0,0,50,20,0,0,0,0,0,0,0,0,0,1,100,NoArch
48b7de5a1e9e0dc9a81f57b084227b0b075cbb65,0,0,0,0,0,0,0,0,0,0,0,0,0,0,51,21,0,0,0,0,0,0,0,0,0,0,100,NoArch
a5d26f8694d6c0c54e0725fd69cc75e5f982bac2,0,0,0,0,0,0,0,0,0,0,0,0,0,0,52,22,0,0,0,0,0,0,0,0,0,0,100,NoArch
7ad5ae26794653b133c0e13c395666c0336b2a45,0,0,0,0,0,0,0,0,0,0,0,0,0,0,53,23,0,0,0,0,0,0,0,0,0,0,100,NoArch
dcfbc4a543a10b902f2a6d15e524953beb76da3e,0,0,0,0,0,0,0,0,0,0,0,0,0,0,54,24,0,0,0,0,0,0,0,0,0,1,100,NoArch
11cb0a895178400289ddd09274ad6569413ae5f9,0,0,0,0,0,0,0,0,0,0,0,0,0,0,55,25,0,0,0,0,0,0,0,0,0,0,100,NoArch
d739a1a259949857d3c9f09e3be4f26906693043,0,0,0,0,0,0,0,0,0,0,0,0,0,0,56,26,0,0,0,0,0,0,0,0,0,0,100,NoArch
ccb4867518bb11cace50cca64bc20aa0a832ce44,2,7,7,0,0,0,0,6,18,28,1,2,0.863120569,6996,1370,12,565,565,0,31261,31261,0,240,240,0,1,100,NoArch
1567ca7abb07d73dc9ba08078d74dc70da61a86e,0,0,0,0,0,0,0,0,0,0,0,0,0,0,1371,13,0,0,0,0,0,0,0,0,0,1,100,NoArch
c2d84abd3877a51bae0d0d5a68fe55f744f2cbcf,0,0,0,0,0,0,0,0,0,0,0,0,0,0,57,21,0,0,0,0,0,0,0,0,0,1,100,NoArch
5e3db15392cc928a0096cfc3d8fd11c0db1f2784,0,0,0,0,0,0,0,0,0,0,0,0,0,0,58,22,0,0,0,0,0,0,0,0,0,1,100,NoArch
caa1cd326f545ee120aa34ae3abb480a30f2a3b4,0,0,0,0,0,0,0,0,0,0,0,0,0,0,1,1,0,0,0,0,0,0,0,0,0,1,100,NoArch
9dd4993ad2ae41e0309eb2631af1a91e64f693e7,1,1,0,1,0,0,0,4,8,278,1,1,0,650,0,0,102,101,1,2344,2341,3,24,24,0,1,100,NoArch
22aa8a8072bd98d4d81d17aad7db5a972e03478e,1,22,2,20,0,0,0,12,87,38,1,1,0,6787,1372,14,422,420,2,28232,28184,48,317,315,2,1,100,NoArch
94f8837c4974edc33e58b16b9ee2f061125b9b60,14,256,155,101,0,0,0,2,54,128,1,5,2.602413899,8481,1373,15,902,892,10,40977,40339,638,577,572,5,1,100,NoArch
3a54e54fadfcf383693555ac753e88edb8f3f5d6,6,384,4,380,0,0,0,3,55,76,1,5,1.870855227,8883,41,0,1080,998,82,40340,38224,2116,541,521,20,1,100,NoArch
0ad58ed624dfad43bfcd26881588a9d3482397c1,0,0,0,0,0,0,0,0,0,0,0,0,0,0,1374,16,0,0,0,0,0,0,0,0,0,0,100,NoArch
68a17fc91bcec738907e980c9ea3f97e44e875cf,1,6,5,1,0,0,0,2,8,202,1,1,0,84,42,1,6,6,0,332,315,17,2,2,0,1,100,NoArch
500e2dc9f916e558a0dfaadde449436c4ed10425,3,4,4,0,0,0,0,1,12,774,1,3,1.5,1217,1375,17,79,79,0,5915,5915,0,51,51,0,0,100,NoArch
cc0d904fdb926c726f38be7c311c282fc43f9da9,0,0,0,0,0,0,0,0,0,0,0,0,0,0,1376,18,0,0,0,0,0,0,0,0,0,0,100,NoArch
8eebfc6d169421509e5d4792a18917fcb6c44efb,0,0,0,0,0,0,0,0,0,0,0,0,0,0,1377,19,0,0,0,0,0,0,0,0,0,0,100,NoArch
00e755db100c4bccfb2976a03c4f75a2adfc69be,0,0,0,0,0,0,0,0,0,0,0,0,0,0,2,1,0,0,0,0,0,0,0,0,0,0,100,NoArch
83266054098220d33be02be38a8a230ca6d6fd38,0,0,0,0,0,0,0,0,0,0,0,0,0,0,1379,10,0,0,0,0,0,0,0,0,0,0,100,NoArch
4b93fa82633da350309d214af52e4606fa18e5ab,0,0,0,0,0,0,0,0,0,0,0,0,0,0,1380,11,0,0,0,0,0,0,0,0,0,1,100,NoArch
b374133361d31ebe8e136668b4a5148ce2cb83b1,0,0,0,0,0,0,0,0,0,0,0,0,0,0,59,16,0,0,0,0,0,0,0,0,0,0,100,NoArch
857c06b6744840daac52f7a3ab7f6e0d32c90e41,0,0,0,0,0,0,0,0,0,0,0,0,0,0,0,0,0,0,0,0,0,0,0,0,0,1,100,NoArch
5dfa3f1ece54d2f95057c5b5097dc0f7fae693ee,19,4603,47,4556,2,0,2,1,2,34,1,7,2.317790459,34647,60,7,6161,5480,681,208736,184292,24444,3442,3077,365,1,99.38478144,NoArch
406372f1274a6a0c9fe2b471ce6d65669e798633,23,1988,41,1947,11,0,11,1,3,20,1,5,3.707725892,4577,61,8,792,657,135,33085,24179,8906,406,330,76,1,99.26850258,NoArch
48d8ebf57fcb9890854dcdec4c26a4bd8ff26a9c,1,5,6,1,0,0,0,1,4,0,1,1,0,3046,62,9,546,545,1,16194,16207,13,257,257,0,1,100,NoArch
0b855b180406cd2b055966f4c832eba46b1c91ee,1,61,45,16,0,0,0,1,2,51,1,1,0,626,63,10,44,44,0,4048,3970,78,27,27,0,1,100,NoArch
3ba595a17832875ffef7ce9c0e374e19b996b53a,1,1,1,0,0,0,0,2,4,1158,1,1,0,115,19,0,17,17,0,438,438,0,5,5,0,1,100,NoArch
87b0eb55b531890ff181996593efa4ab224262a6,0,0,0,0,0,0,0,0,0,0,0,0,0,0,1381,11,0,0,0,0,0,0,0,0,0,0,100,NoArch
ba9783f30398c52e514db06191d5faf631e57490,12,1679,1407,272,2,0,2,1,5,22,1,6,1.483084402,10651,64,11,1522,1502,20,57707,56563,1144,798,794,4,1,99.88126079,NoArch
4140927c99b9dceb15ef4b85059b60e7898de0e7,1,21,0,21,0,0,0,1,4,3,1,1,0,1751,65,8,146,145,1,11295,11140,155,78,77,1,1,100,NoArch
3e25f2ffa0eab11051f6295fd3706d2397f2524c,1,1,1,0,0,0,0,1,3,3,1,1,0,57,66,9,0,0,0,40,40,0,0,0,0,1,100,NoArch
aa9db8a36046b1e812021fa1cf0973906cfffbad,6,261,209,52,0,0,0,1,5,49,1,5,1.898637997,5823,67,8,885,904,19,29790,29547,243,372,368,4,1,99.98921949,NoArch
37ed160f423b6c95cecd1b8f9ab4a2a2d220057f,15,826,102,724,3,0,3,1,6,19,1,4,3.047304129,4515,68,9,720,661,59,25337,21908,3429,364,329,35,1,99.54594595,NoArch
889b9a88b2bff748c4d6a31d369fc03d56ef958d,3,112,1,111,0,0,0,1,6,22,1,2,0.3481704,2731,69,10,313,300,13,16043,15249,794,206,201,5,1,100,NoArch
032e0d9a50a86e1219522eae53aba70672b2ca0a,0,0,0,0,0,0,0,0,0,0,0,0,0,0,70,11,0,0,0,0,0,0,0,0,0,1,100,NoArch
ea71f9295ae3bed9b88046f9a9e426bcc93a0005,1,38,0,38,0,0,0,1,7,0,1,1,0,1904,71,12,160,159,1,12512,12233,279,84,83,1,1,100,NoArch
70829e53f1ea036909f74400454ca6902fa818dc,3,73,24,49,0,0,0,1,4,62,1,3,1.416136902,985,72,13,70,68,2,6298,5941,357,41,39,2,1,100,NoArch
919b31f0ebbd1501b9b2216fcc8534449fa3258e,1,34,1,33,0,0,0,1,8,0,1,1,0,1942,73,14,161,160,1,12741,12512,229,85,84,1,1,100,NoArch
04c5ff9e8ae0627025406c627f8474913ba863a0,1,3,1,2,0,0,0,1,4,2,1,1,0,637,74,15,149,149,0,2818,2805,13,23,23,0,1,100,NoArch
576c1a1eeb138726387e55680f4a1bd2aa7ed023,4,216,55,161,0,0,0,4,28,249,1,3,1.138659216,5713,20,0,736,717,19,27273,26553,720,324,316,8,1,100,NoArch
a5928f04655df08e1680ef508219e957575ac8d1,0,0,0,0,0,0,0,0,0,0,0,0,0,0,75,11,0,0,0,0,0,0,0,0,0,1,100,NoArch
5e1cc5464413904466c357766843cd491b23f646,1,15,11,4,0,0,0,3,5,5,1,1,0,279,21,1,32,32,0,1335,1335,0,13,13,0,1,100,NoArch
7a00d4cca220b86fc41c32d89b8a4e0e660e70c7,0,0,0,0,0,0,0,0,0,0,0,0,0,0,76,9,0,0,0,0,0,0,0,0,0,1,100,NoArch
09df15fed8746ee63a10cce80af54966838f26bc,0,0,0,0,0,0,0,0,0,0,0,0,0,0,77,10,0,0,0,0,0,0,0,0,0,1,100,NoArch
b66d414661926afdb82aea71432fa18022a666e2,0,0,0,0,0,0,0,0,0,0,0,0,0,0,78,11,0,0,0,0,0,0,0,0,0,1,100,NoArch
4df0075f3f58ca0927c53c229ca910778c1e2d38,0,0,0,0,0,0,0,0,0,0,0,0,0,0,79,12,0,0,0,0,0,0,0,0,0,1,100,NoArch
825acf1e4f728e906ced0b17c4d53d71a121c3e6,1,6,6,0,0,0,0,4,6,31,1,1,0,283,80,11,32,32,0,1335,1335,0,13,13,0,1,100,NoArch
e010b1b207d8cfbba9d1ff88c65a489fbdeeba40,4,85,85,0,0,0,0,1,5,60,1,4,0.505026071,19226,81,12,2913,2913,0,91354,91354,0,1501,1501,0,1,100,NoArch
6ddd7821222f1a3e9480c205fdcfa8119b1277c3,0,0,0,0,0,0,0,0,0,0,0,0,0,0,82,12,0,0,0,0,0,0,0,0,0,1,100,NoArch
578fb2cd9bbcfcf38fd0cd900544e17c513f3a24,0,0,0,0,0,0,0,0,0,0,0,0,0,0,1382,0,0,0,0,0,0,0,0,0,0,1,100,NoArch
80f8922bd5ccf77d79b488f5eb8ff08d51d871da,6,371,86,285,2,0,2,2,20,360,2,4,2.1637242,3416,1383,1,498,458,40,21719,19861,1858,224,206,18,0,99.93498754,NoArch
e91c8dcf25e31fccd9299db8123d642ca1e63f0a,15,67,60,7,0,0,0,2,58,421,2,11,3.441132056,13325,1384,2,1406,1405,1,61664,61564,100,473,472,1,0,100,NoArch
d81133fd0e8aee9dcd80eb62046550f65464b377,4,81,45,36,0,0,0,2,8,941,1,2,1.706495384,1004,1385,3,87,85,2,2714,2609,105,51,49,2,1,100,NoArch
b666f72ee03587709f0f2dd8fbcb4ae958df6581,0,0,0,0,0,0,0,0,0,0,0,0,0,0,1386,4,0,0,0,0,0,0,0,0,0,0,100,NoArch
f97cdfbee4f7ccaeaa91328005bf3e3a52e6666a,4,12,10,2,0,0,0,2,5,62,2,2,1.617189573,905,1387,5,104,103,1,3995,4004,9,47,47,0,0,99.85921594,NoArch
dc553607d3c7f2a9baa74f7e059dde09d0df5f3c,3,179,0,179,0,0,0,2,4,104,1,2,1.072754087,406,1388,6,62,43,19,2856,1639,1217,44,29,15,1,99.31885909,NoArch
eadc6766b211eba853dd046f9b79383b31488420,6,685,685,0,0,0,0,9,56,87,2,4,1.829347291,49653,1389,7,7466,7466,0,250255,250255,0,4264,4264,0,0,100,NoArch
dd8d3c5888618d1568db49f0deb8b4a2f7c2b56f,17,2431,12,2419,12,0,12,1,30,150,2,5,2.749253494,2776,1390,8,690,377,313,24808,13112,11696,289,175,114,1,89.75646229,Arch
c07f33ae62fd7b3c91713e3f7a038031fb7db5b9,3,34,10,24,0,0,0,1,3,149,1,2,1.500397731,663,3,0,74,72,2,3536,3406,130,30,29,1,1,100,NoArch
62f9abae4e0c79b02d4a46b4a6aa40aebc6418f9,2,17,1,16,0,0,0,1,4,95,1,2,0.99107606,213,4,1,18,15,3,949,866,83,12,11,1,1,100,NoArch
26a6458903cd13d2a541b59042d178e8177705a9,2,19,6,13,0,0,0,3,3,136,1,1,0.904381458,202,10,0,20,20,0,1039,904,135,10,10,0,2,100,NoArch
26fddf2a641aebf943f18b7da8f81397955f4e59,9,1496,1496,0,1,1,2,1,9,72,1,3,1.17843077,5375,83,7,634,634,0,28464,28464,0,414,414,0,1,99.1622575,NoArch
6baa9c4bed1100012ebf4ef9547cbb077f2edaaf,7,98,30,68,0,0,0,1,5,161,1,2,2.220842498,1068,5,2,108,101,7,5836,5379,457,65,62,3,1,100,NoArch
4255767d9ccc3221963a98d7e2e8ce3b68e156a3,1,6,2,4,0,0,0,1,4,0,1,1,0,244,6,3,25,25,0,1483,1464,19,15,15,0,2,100,NoArch
b7fbb35b3883d5bbead0892c6898711253ddac24,13,708,23,685,3,0,3,1,5,73,1,5,2.1909601,2236,84,8,314,253,61,13445,10325,3120,194,162,32,1,99.70910718,NoArch
a065200ad714ed5f9015e8a00b534c10f9fa6a15,4,204,0,204,2,0,2,5,24,71,1,2,1.466265612,7275,1,0,365,339,26,18220,17525,695,310,290,20,1,99.95507637,NoArch
da875a67fe8718345e567ef9ac40380cf38d043f,4,86,47,39,0,0,0,5,25,0,1,2,1.624356258,7479,1391,9,361,365,4,18317,18220,97,308,310,2,2,100,NoArch
3599cebbcfe52a2ee1c146fe97f75b168800e4f9,4,226,9,217,0,0,0,2,38,869,1,4,1.171450596,4196,11,1,524,500,24,20313,18946,1367,157,151,6,1,98.43298511,NoArch
e4dd6dc765e125b156c2317fbe567f11585ea9f2,2,56,0,56,0,0,0,1,6,42,1,2,0.885612871,806,85,2,171,167,4,4257,3875,382,43,41,2,2,98.64526886,NoArch
af315fbeab178437162ebf3e00c44f6f2b133ba3,2,41,25,16,0,0,0,12,88,213,1,2,0.715825931,11365,1392,9,1083,1081,2,48970,48892,78,493,492,1,1,100,NoArch
4e33eedc2412085a475110101d92c9910930f897,10,132,1,131,1,0,1,8,40,313,1,8,2.143787424,26307,0,0,1961,1952,9,95265,94771,494,1158,1151,7,1,94.80812641,Arch
1be4056b4b5ff4c75bf8f05bd2bc45e5cf01fa10,9,55,30,25,0,0,0,1,41,142,1,5,2.713836295,18976,1393,5,1309,1309,0,69729,69616,113,675,675,0,1,99.9680341,NoArch
1b4209ec973b8b86749fb3cc14262cdd17df0999,6,164,2,162,0,0,0,4,28,441,1,3,1.972042884,5766,0,0,779,764,15,30903,30197,706,317,310,7,1,99.97868713,NoArch
44a6ba67b92c193468f0de9dc3417c218624e69f,3,127,78,49,1,0,1,4,22,114,1,2,0.999486717,1985,1394,6,132,130,2,13866,13805,61,72,70,2,1,99.96804431,NoArch
2b74c79a96a4040b5b44b90ad764aaa9ad169374,3,12,13,1,0,0,0,3,11,134,3,1,1.47293504,1633,1395,7,91,91,0,5609,5609,0,76,76,0,0,100,NoArch
6031b7a477be2e60828df586f4a3542065b97bce,7,52,5,47,0,0,0,8,89,111,1,5,2.180036168,32262,1396,6,2491,2490,1,118381,118168,213,1321,1320,1,1,100,NoArch
354e8240d49de42bd6972d985fea692e4785e8b0,15,360,130,230,0,0,0,2,90,460,2,9,3.402528825,19021,1397,6,2162,2124,38,90871,89395,1476,1020,1003,17,1,99.94675753,NoArch
bf098dd6737bdc78169961e076ba53bb30ba76d7,7,213,59,154,1,0,1,4,38,276,1,6,2.051731418,7665,7,0,1015,993,22,38971,38036,935,441,430,11,1,99.94676887,NoArch
19361b94a4e44601e182f2d2298bc216c017bd81,0,0,0,0,0,0,0,0,0,0,0,0,0,0,1398,7,0,0,0,0,0,0,0,0,0,0,100,NoArch
ebb68dadf64e318025bd3e2d12d1ed6608384fb7,6,142,47,95,0,0,0,12,91,31,1,6,2.09148357,16961,1399,8,1689,1677,12,76019,75550,469,852,849,3,1,100,NoArch
9deff987ba177a6eb1ded2813e770a9233f3f2f4,4,20,16,4,0,0,0,1,3,120,1,3,1.500752023,630,86,3,45,45,0,3419,3385,34,24,24,0,2,100,NoArch
2197f7dc34035f63c50b12eeebf4758d44e09c43,9,922,0,922,9,0,9,1,1,0,1,3,2.673467267,0,87,4,64,0,64,4268,0,4268,24,0,24,1,99.76637995,NoArch
6bc34d03158168d4d8910e04fa33e5189cfc245e,1,1856,0,1856,1,0,1,1,1,0,1,1,0,0,1400,9,12,0,12,3136,0,3136,3,0,3,1,99.97881356,NoArch
40576e716a402647c4b60da14e138f7911658b64,12,96,32,64,0,0,0,9,92,251,1,7,2.984845112,33660,0,0,2695,2682,13,122041,121804,237,1509,1503,6,1,100,NoArch
f8f2af3e16364745e228570a51cf2fa5decbe686,13,128,42,86,0,0,0,1,93,199,1,6,3.351084586,24398,1401,9,1505,1494,11,84023,83603,420,1100,1092,8,1,99.96823044,NoArch
0d2eae5be5adcebcc2dd7df6a7887d70cc961b6d,3,65,4,61,0,0,0,10,45,153,1,3,1.414125106,14240,0,0,686,680,6,39354,39109,245,600,595,5,1,100,NoArch
a15aa88bb2820d8de008375d9033fc5c22fc1775,2,2,0,2,0,0,0,1,4,20,1,1,1,307,88,2,23,23,0,1645,1615,30,12,12,0,1,100,NoArch
720b117ed4c4096b274d636711245f583b3e9826,0,0,0,0,0,0,0,0,0,0,0,0,0,0,0,0,0,0,0,0,0,0,0,0,0,0,100,NoArch
9bd7d7550cfe31b76e3970a532014a8186e1ff5a,20,659,51,608,3,0,3,10,46,540,1,8,3.272635298,19855,15,0,2060,1995,65,76656,74384,2272,1066,1030,36,1,99.6941896,NoArch
987a257ae7cff588ac2f63518a7f75263a9bddb9,7,726,93,633,0,0,0,1,7,152,1,5,1.69973603,20865,89,3,3366,3314,52,112827,110398,2429,1859,1832,27,1,100,NoArch
25bba06974e07f89a36f3ddd2596fe1f2d4d916e,3,113,12,101,0,0,0,1,7,73,1,3,1.131640671,2440,90,4,320,315,5,12336,11586,750,132,127,5,1,99.47196114,NoArch
68350d7ce16a47755c8d70a8833010dba08800eb,0,0,0,0,0,0,0,0,0,0,0,0,0,0,91,5,0,0,0,0,0,0,0,0,0,1,100,NoArch
1072a3cdfd46e0c743733f83a2944fdbbdb01353,0,0,0,0,0,0,0,0,0,0,0,0,0,0,92,6,0,0,0,0,0,0,0,0,0,1,100,NoArch
b8cb7c7c7398cc0d4236f9717111b338a824bc27,0,0,0,0,0,0,0,0,0,0,0,0,0,0,93,7,0,0,0,0,0,0,0,0,0,1,100,NoArch
f3ba5c3352af82db4436453da03176636819b36f,0,0,0,0,0,0,0,0,0,0,0,0,0,0,94,8,0,0,0,0,0,0,0,0,0,1,100,NoArch
d58bf9150bb7e354e4b5980ecee0c96218a0893d,0,0,0,0,0,0,0,0,0,0,0,0,0,0,95,9,0,0,0,0,0,0,0,0,0,1,100,NoArch
4c89dce303f8760e10bde3ab2b387780ae059e31,8,161,41,120,1,0,1,2,7,61,1,2,2.53274075,1163,7,0,127,113,14,6583,5964,619,74,65,9,1,99.81899489,NoArch
10e8c79c63ade367d8354596d23d78945a3100ed,0,0,0,0,0,0,0,0,0,0,0,0,0,0,96,10,0,0,0,0,0,0,0,0,0,1,100,NoArch
6c633cf3db0ace763348e63ca123fbf14893c6de,0,0,0,0,0,0,0,0,0,0,0,0,0,0,97,11,0,0,0,0,0,0,0,0,0,1,100,NoArch
20ba43461564c983557e9d9fd1b3e04d75ef7b18,1,343,0,343,0,0,0,9,31,17,1,1,0,6361,12,0,332,327,5,17780,17037,743,299,297,2,1,100,NoArch
5a697eedf1a6d32fe4b6e504dc0454429949d423,1,466,313,153,0,0,0,9,32,0,1,1,0,6704,1402,2,343,332,11,21052,17780,3272,300,299,1,1,100,NoArch
b6f0e1021b8d8e0dc08e6da49391a76cdb6cfb14,1,3,12,9,0,0,0,2,5,713,1,1,0,339,0,0,15,15,0,1634,1686,52,6,6,0,1,100,NoArch
b0a996b4105c238cd8455741b2fb4b0ba5256a49,4,296,323,27,0,0,0,4,28,651,2,4,1.364616916,4117,1403,3,432,428,4,22419,22547,128,228,222,6,0,95.99236641,Arch
f191a386aedaee05c6ffcc1d4b155193bfa4ca01,32,243,120,123,0,0,0,1,47,912,1,6,3.932611846,23918,1404,4,1965,1958,7,86196,85488,708,969,964,5,1,99.98816568,NoArch
b76affccec5756d7d1f6cf76cf4c2344a28fcfeb,3,68,8,60,0,0,0,5,21,423,1,2,1.344127981,2947,0,0,326,319,7,15852,15586,266,188,183,5,1,100,NoArch
f3caf13b9f1cd92f95dcf27716466bf2133e1ed7,15,1859,0,1859,15,0,15,1,1,0,1,2,3.624588314,0,0,0,188,0,188,9481,0,9481,99,0,99,1,99.57582185,NoArch
2f937c1ba354726a340968a51224131a71017979,3,32,3,29,0,0,0,2,24,175,2,3,1.077252356,2694,1,1,295,291,4,18215,18043,172,124,122,2,1,100,NoArch
d757201f155bd0c900725b3ce2776899668fce4d,8,184,58,126,0,0,0,11,94,100,1,7,2.578361493,17558,0,0,1257,1244,13,66692,65893,799,887,883,4,1,99.96480113,NoArch
48e434263e526dcfa0c367e523cdc83b5989ab16,3,23,5,18,0,0,0,5,22,226,1,2,1.094914318,2993,1405,3,337,335,2,16006,15921,85,205,204,1,1,100,NoArch
08c966b9828f534ba3d8d2ccf052de7d887c70ef,15,232,80,152,1,0,1,1,8,104,1,7,3.28740704,23473,98,9,3758,3741,17,122442,121735,707,2085,2076,9,1,97.34291253,Arch
ea25b7327e734f93acae85dc60f6188f852bed12,0,0,0,0,0,0,0,0,0,0,0,0,0,0,99,10,0,0,0,0,0,0,0,0,0,1,100,NoArch
ddfaf079a8a18be63f042069dd56c50dec4d2066,0,0,0,0,0,0,0,0,0,0,0,0,0,0,100,11,0,0,0,0,0,0,0,0,0,0,100,NoArch
15ad615bd9fb24234d911b132a6e9137c36af03d,0,0,0,0,0,0,0,0,0,0,0,0,0,0,101,12,0,0,0,0,0,0,0,0,0,0,100,NoArch
514154f3b7e98866670d396bc274b0add0b627ba,3,611,666,55,0,0,0,8,57,75,1,2,0.321045165,8928,1406,4,1101,1101,0,38355,37301,1054,594,594,0,0,100,NoArch
918e612bbb4da90ad94b283c1f06cf055102c09e,6,202,10,192,0,0,0,12,62,497,1,4,2.108868954,20030,0,0,1922,1886,36,78025,77310,715,860,847,13,1,100,NoArch
e25ceef6f31f9c0989ef695e6599e2f81f1f3556,7,105,190,85,0,0,0,12,63,0,1,4,2.423268697,22123,1407,5,2124,2151,27,84575,84983,408,1073,1083,10,1,100,NoArch
eb02ac3fcef9deb2b16668f5dc06c9a89c0e658e,6,153,14,139,0,0,0,6,26,588,1,4,1.874382243,2385,1408,6,348,334,14,14591,13774,817,162,157,5,1,99.05292479,NoArch
7fe475a8b135d4c91f521d6f519b13188e28a8bb,16,42,50,8,0,0,0,5,28,416,1,8,3.463491382,12429,1409,7,1439,1440,1,61693,61735,42,651,651,0,1,99.92170898,NoArch
80b05c2a931ecf4134c2c7ff73735f36c8989fbe,10,218,17,201,0,0,0,14,95,497,1,7,2.697073511,8984,1410,8,732,712,20,40474,39269,1205,453,441,12,1,99.92157741,NoArch
97945652197cbc80ce5c4ed05d3fc18ee0061e75,3,557,10,547,0,0,0,8,33,105,1,3,1.289464246,13915,13,1,944,909,35,54375,52617,1758,546,541,5,1,100,NoArch
8f8790cb0e5cc981025d6c52e41edc684b81ad2b,0,0,0,0,0,0,0,0,0,0,0,0,0,0,1411,9,0,0,0,0,0,0,0,0,0,0,100,NoArch
24276d60ae65866018063933d5cb5faca6d202db,1,1,1,0,0,0,0,5,8,453,1,1,0,75,0,0,5,5,0,287,286,1,4,4,0,1,100,NoArch
b5e6663f85f4bed637b406c3590c790845f219d3,1,1,1,0,0,0,0,3,4,1622,1,1,0,139,1,1,5,5,0,446,446,0,2,2,0,1,100,NoArch
fa76779106ce975e9893c7cd38678f0ce98d3f27,3,87,1,86,1,0,1,5,20,299,1,3,0.663275119,337,2,2,29,21,8,1743,1259,484,20,13,7,1,99.0599038,NoArch
251035cc7f701ed2c6dd5ca06704a2f55d891076,0,0,0,0,0,0,0,0,0,0,0,0,0,0,102,4,0,0,0,0,0,0,0,0,0,0,100,NoArch
600f615f86749e9420b20159a3ea6a211eb3bd3e,0,0,0,0,0,0,0,0,0,0,0,0,0,0,103,5,0,0,0,0,0,0,0,0,0,1,100,NoArch
2bee6efda617da09b255546ba327dfd51b87a7dd,0,0,0,0,0,0,0,0,0,0,0,0,0,0,104,6,0,0,0,0,0,0,0,0,0,1,100,NoArch
e77b86638cc85fe58784c447619a8d4bef9f3940,1,3,0,3,0,0,0,1,3,1711,1,1,0,59,1412,7,4,4,0,121,119,2,4,4,0,1,100,NoArch
a4ccb80a91b4592f902e3f34355aa391d6cb4066,5,162,0,162,2,0,2,5,21,169,1,5,1.626266779,2124,3,3,324,314,10,9838,9148,690,91,86,5,1,99.80754838,NoArch
62db4638af9ffbda249d51d1b47e783db9221e1a,0,0,0,0,0,0,0,0,0,0,0,0,0,0,1413,8,0,0,0,0,0,0,0,0,0,0,100,NoArch
063f5788bb2eb29311f43f642660a8d56ed1f40e,3,15,14,1,0,0,0,3,6,848,3,3,1.269920726,780,1414,9,77,77,0,3778,3778,0,28,28,0,2,100,NoArch
a02da271c2be6f5bf3a226698529748b5ee706ba,0,0,0,0,0,0,0,0,0,0,0,0,0,0,1415,10,0,0,0,0,0,0,0,0,0,1,100,NoArch
23c8e4588c2c23703cb90ad66e51b90a8a53d7df,1,2,3,1,0,0,0,2,3,26,1,1,0,819,1416,11,152,152,0,4843,4848,5,48,48,0,1,100,NoArch
435e203028a872933c6d8bd6404ebc445552e599,9,404,117,287,0,0,0,1,13,108,2,4,2.75486231,2707,1417,12,407,369,38,15298,13773,1525,143,132,11,1,100,NoArch
ec49a0fa37195bb4b34945b53ce39b27d558d6ab,3,112,21,91,0,0,0,1,5,0,1,2,1.451481354,1965,1418,13,305,286,19,10397,9892,505,103,101,2,1,99.98926578,NoArch
d18da01ed88c772f62123e8420cdefc9b5d76daf,2,6,5,1,0,0,0,1,9,1084,1,1,0.945660305,526,1419,14,33,33,0,2809,2797,12,27,27,0,1,100,NoArch
4987d54061783ee5c707a60140b3e367baccdd49,0,0,0,0,0,0,0,0,0,0,0,0,0,0,1420,15,0,0,0,0,0,0,0,0,0,0,100,NoArch
aeb6bf146544bf9a4c030df644eda8fe5a370f52,0,0,0,0,0,0,0,0,0,0,0,0,0,0,1421,16,0,0,0,0,0,0,0,0,0,0,100,NoArch
9ef9430c382fb3c3a92898e4990f4b7b909ad2ee,0,0,0,0,0,0,0,0,0,0,0,0,0,0,16,3,0,0,0,0,0,0,0,0,0,1,100,NoArch
cf5ff72b7ee7877c8782a649c21d43c40c9389b2,0,0,0,0,0,0,0,0,0,0,0,0,0,0,1562,8,0,0,0,0,0,0,0,0,0,0,100,NoArch
0209b16c0adca468c3da06ef036e3d06432ea17b,3,111,2,109,0,0,0,6,28,29,1,2,1.045213342,3369,1,0,453,439,14,16951,16457,494,163,157,6,1,100,NoArch
aa0bf32c626db0f3b72f15df5d69f1ae6c0e612d,1,2,1,1,0,0,0,4,16,0,1,1,0,703,1,1,116,116,0,4155,4148,7,27,27,0,1,100,NoArch
370dfdac54de00c883869954cfaaf5e20f0f2519,2,9,1,8,0,0,0,6,29,0,1,2,0.721928095,2775,2,1,338,337,1,12834,12803,31,137,136,1,1,100,NoArch
c231aae494ffd3a587bf4ddd21c71e95813e3daa,0,0,0,0,0,0,0,0,0,0,0,0,0,0,1563,9,0,0,0,0,0,0,0,0,0,0,100,NoArch
8e5766896456eced5a1c9f6e424d90496b7175cd,0,0,0,0,0,0,0,0,0,0,0,0,0,0,1564,10,0,0,0,0,0,0,0,0,0,0,100,NoArch
8a1a287ded230138390f859584fa8f847d9e7a0f,22,1211,167,1044,1,0,1,24,92,62,1,8,3.200858714,41462,3,0,4003,3890,113,169370,164952,4418,2006,1910,96,1,94.65611686,Arch
14ee9f3542d65bccf33c3dd06b7239795e5259d0,2,11,1,10,0,0,0,18,93,2,1,2,0.918295834,7774,0,0,994,993,1,34852,34827,25,490,489,1,1,100,NoArch
5289d343fb9eb2f54233f0bc54b2672023f4de14,231,0,99586,99586,0,231,231,1,14,722,1,27,5.176749487,99586,128,3,0,13906,13906,0,493196,493196,0,8035,8035,1,85.52667957,Arch
4d20d62d4d752ce4de29a002ec313a758a7cee6e,15,753,163,590,0,0,0,24,94,214,1,11,2.83058769,35711,6,0,2927,2887,40,134497,131993,2504,1410,1393,17,1,92.44450978,Arch
95c6918463166b13898cf50868f6d290f8384770,0,0,0,0,0,0,0,0,0,0,0,0,0,0,1565,3,0,0,0,0,0,0,0,0,0,0,100,NoArch
9f87b666976181d7946aa9c6c4fefef01c53858c,1,32,27,5,0,0,0,7,19,112,1,1,0,653,2,1,124,122,2,3745,3700,45,22,22,0,1,100,NoArch
bff34c1a361faef793d4133032153f6956d03bbe,0,0,0,0,0,0,0,0,0,0,0,0,0,0,3,2,0,0,0,0,0,0,0,0,0,1,100,NoArch
ef03b6e4c6dbae800e7c1aaa1deb5bbd7960e911,11,566,80,486,6,0,6,6,30,26,1,2,2.950772533,4439,3,2,689,657,32,23977,22434,1543,212,193,19,1,98.43729307,NoArch
04c0c8b6f212e513aba76a36e62f99e4bde4370e,7,285,260,25,0,0,0,6,31,0,1,2,1.10766411,4175,74,0,567,563,4,20248,20092,156,189,188,1,1,100,NoArch
22fdd88584bfb3a0d77fc8f03cf847d343e5f9a7,3,10,6,4,0,0,0,6,32,36,1,3,1.405639062,3131,4,3,355,354,1,14435,14417,18,147,147,0,1,100,NoArch
2eebca8cff3b8ba7978a64c89f88199ba81cab56,6,52,6,46,0,0,0,2,3,0,1,1,2.201146431,271,75,1,19,19,0,745,745,0,12,12,0,1,100,NoArch
35cd2abc8a53c746eabcd9f273ec2dd3b9dee98e,0,0,0,0,0,0,0,0,0,0,0,0,0,0,1566,3,0,0,0,0,0,0,0,0,0,1,100,NoArch
e76d5ee33a3cda0d9ce495e21681f5bede25f129,3,25,17,8,0,0,0,6,33,3,1,2,1.395929176,3666,76,2,479,477,2,17437,17425,12,167,167,0,1,100,NoArch
b48f634fe0c90f68c7c047a387814557e5701fa7,2,98,32,66,0,0,0,6,34,1,1,2,0.751649946,2409,77,3,210,204,6,10215,9875,340,104,103,1,1,100,NoArch
6543c0fd8b63efb00d035790209f8546668d7aa5,3,6,3,3,0,0,0,4,56,66,3,3,1.584962501,8792,129,1,484,484,0,29236,29215,21,406,406,0,1,100,NoArch
66cdfc6a38da1ba19ac2d1f17554bba632d03701,1,2,0,2,0,0,0,3,4,83,1,1,0,284,130,2,18,18,0,1855,1843,12,16,16,0,1,100,NoArch
9247cb990d697f231ec50a12a8b13aad9e8b2192,1,3,0,3,0,0,0,3,5,0,1,1,0,286,131,3,18,18,0,1870,1855,15,16,16,0,1,100,NoArch
fa8defdd2709489215927362f87da97af1769674,1,0,1,1,0,0,0,5,15,247,1,1,0,421,14,0,83,83,0,2270,2273,3,22,22,0,1,100,NoArch
059142fe5de9519e0289f3ff063cca9b2e7b5f04,3,102,68,34,0,0,0,7,64,33,1,2,1.021501019,10372,4,1,1490,1488,2,48731,48556,175,417,415,2,1,100,NoArch
7c2f5a83c5c4416a6ec91bb8aa043cd60962ed37,7,313,83,230,1,0,1,6,35,17,2,3,1.84162798,4579,5,2,645,627,18,23565,22768,797,208,201,7,1,99.97446374,NoArch
a0a4f3715f2e138e4e5a9b0e4a6d5d4c0877824e,0,0,0,0,0,0,0,0,0,0,0,0,0,0,0,0,0,0,0,0,0,0,0,0,0,0,100,NoArch
cd136985af5b9d0b74751bd65d9669996363786e,6,400,197,203,0,0,0,6,36,14,1,2,1.545002885,4169,6,3,517,506,11,20210,19435,775,196,187,9,1,87.9767379,Arch
0d2d11f3b8ab4a11279b4f73d0cd913902872880,3,13,9,4,0,0,0,4,46,128,1,3,1.572623664,9964,1567,1,1031,1032,1,49674,49657,17,586,586,0,1,100,NoArch
8b69e4da4a94985321b4ed0037255284093f4669,2,185,100,85,0,0,0,2,21,74,2,2,0.940921775,988,1568,2,113,103,10,5466,4914,552,70,62,8,0,100,NoArch
cc839874242c69a8199f92097eaf113e5195e4a3,6,158,8,150,0,0,0,3,38,519,3,5,1.616734718,4142,1,0,516,504,12,25927,25182,745,215,208,7,1,100,NoArch
495fd1dc7b0c1805834964a98fc042e12c76d7a7,3,71,2,69,0,0,0,3,10,78,2,2,1.187461691,996,2,0,138,128,10,6987,6546,441,54,51,3,1,100,NoArch
aed5bca7c5f49d117d7b794395ff4b6ad2d76bde,9,102,19,83,0,0,0,19,95,364,1,6,2.600414941,13929,0,0,1667,1658,9,62033,61697,336,878,875,3,1,100,NoArch
d97c14c5dd62ed55da4d771e585973213affcb6e,6,484,448,36,0,0,0,3,122,51,2,4,0.243477527,28678,2,1,1706,1705,1,98851,97995,856,1469,1469,0,1,100,NoArch
c850e227db583a697c8cc46585b33274b63ed2d0,10,420,46,374,0,0,0,25,96,42,1,8,2.757285724,26813,7,0,1832,1810,22,94261,92947,1314,1129,1112,17,1,100,NoArch
2ce41591be8986359ac7382359f6934be1fc402b,8,276,51,225,0,0,0,5,95,380,1,3,2.318548897,6415,15,1,505,501,4,31702,30232,1470,382,367,15,1,100,NoArch
478de569cf4b7084207b40ce957f47b6e8015fe7,3,24,6,18,0,0,0,4,59,19,3,3,1.368104837,9028,132,0,501,498,3,31009,30924,85,418,417,1,1,100,NoArch
41b05d784fd2e0ae81b09d013ef8a746036ca446,21,2150,27,2123,5,0,5,8,65,147,1,6,2.996052311,13421,78,0,1824,1595,229,72305,58930,13375,705,584,121,1,99.88510699,NoArch
84b49f5b48842708e9f4d912b4f9564745d74bc6,19,2092,131,1961,2,1,3,8,66,99,1,9,2.189147061,17299,79,1,2259,2005,254,96853,87116,9737,923,849,74,1,95.20746626,Arch
1f81e1353605fc2d16de9b4d56821736b0e82464,17,887,211,676,2,0,2,7,123,455,1,8,2.34517869,15764,80,2,1474,1417,57,76679,73840,2839,879,843,36,1,99.83125211,NoArch
27ca3109539eba4324b3bf4fcf4065cb7a5d300c,2,1,377,376,0,1,1,7,30,128,1,2,0.101500336,2138,81,3,111,166,55,6788,9187,2399,105,114,9,1,99.96625422,NoArch
a2bd49c32b6b08f92cf92fd603f8448684044431,2,142,0,142,0,0,0,5,52,2,1,2,0.88470705,4034,82,4,519,507,12,22147,21134,1013,222,220,2,1,100,NoArch
9a691a7db88f96f930a4a4609f8aea6df601a909,2,58,21,37,0,0,0,7,31,0,1,2,0.926504446,3273,83,5,333,328,5,15213,15012,201,147,145,2,1,100,NoArch
e9d0ca6731b2f5ec33b9270b5ffcaaf9e4eb8537,3,75,43,32,0,0,0,2,34,63,1,2,1.109219129,2263,84,6,314,311,3,12653,12374,279,107,104,3,1,100,NoArch
7cec056a0fc3c4c93d6e3b7de0a687ad213c0825,12,67,59,8,0,0,0,7,67,0,1,6,3.045226984,20458,1569,2,1913,1913,0,81309,81309,0,931,931,0,0,100,NoArch
39c22f0c8b7b5b46a152f432e8708ce73ace1ef7,1,44,7,37,0,0,0,3,10,309,1,1,0,109,1570,3,7,6,1,765,601,164,7,6,1,0,100,NoArch
c94a080b3520a568e5452cc33ca3a443cf2f50ab,3,186,166,20,0,0,0,16,47,328,1,3,1.085399332,8503,1571,4,644,629,15,37013,36567,446,292,276,16,0,100,NoArch
feff5964bf36d2e5aa311fcd7777b159aa4a8a1e,10,572,142,430,0,0,0,25,89,224,1,7,2.880798819,31648,1572,5,1738,1710,28,108823,106894,1929,1187,1171,16,1,100,NoArch
d2368327ede5891417e579998c0e30e1ef5c54c5,2,124,55,69,0,0,0,6,37,22,1,2,0.488178247,3353,7,2,373,368,5,15140,14842,298,160,157,3,1,100,NoArch
6f07293a3843c8790af9c028b2962fd8a0512db9,6,255,49,206,0,0,0,8,54,0,1,4,2.142321496,8508,85,7,1015,994,21,44450,43399,1051,511,503,8,1,100,NoArch
a377f8f2826f51c77b639ee711e2bd578f4de822,8,136,142,6,0,1,1,6,38,20,1,2,2.801748035,4825,8,2,606,613,7,22508,22561,53,209,209,0,1,99.88756465,NoArch
1aaa0d6860c7538d62998ec13bcc83763c04720f,8,108,23,85,0,0,0,3,62,230,1,3,2.268784198,13749,0,0,1434,1423,11,60108,59852,256,547,544,3,1,100,NoArch
ef00738a053cbe881f2c840f3e3b5feeb010b6e1,2,16,0,16,0,0,0,6,39,8,1,2,0.811278124,3460,9,3,376,374,2,15254,15195,59,162,161,1,1,100,NoArch
bb74e5a0c6e9d769dcc52bad1a92f810b475f2ee,0,0,0,0,0,0,0,0,0,0,0,0,0,0,1,0,0,0,0,0,0,0,0,0,0,1,100,NoArch
9c10c3da15ee65190cca4767d9a52406ba9ba1b0,3,47,2,45,0,0,0,10,45,307,1,3,1.405332338,2753,1573,6,352,350,2,14403,14099,304,190,188,2,1,99.98876909,NoArch
a11d14054e9c1d2ce22f60e11536f1885faaae7c,8,255,32,223,1,0,1,20,97,156,1,5,2.512101037,11968,1574,7,1289,1259,30,53528,52622,906,660,646,14,2,99.97754827,NoArch
86b9ed7be78d758b4b95b8ec589ceab90927af42,3,165,137,28,1,0,1,25,90,75,1,1,1.022944726,10019,1575,6,474,474,0,29969,29942,27,422,422,0,0,99.92149826,NoArch
fa308a30aee6322fe94ba2e3e6795ad1ac7bc676,6,95,25,70,0,0,0,6,63,246,1,4,2.280113628,9083,1576,7,1088,1077,11,48477,48109,368,353,349,4,1,99.91034405,NoArch
60b4f4eb10a018e7d6ab8ae4f6ac0f4d0b598b1f,1,3,2,1,0,0,0,2,8,109,1,1,0,175,1577,8,19,19,0,978,967,11,9,9,0,0,100,NoArch
6b8e2c3d3e4468206ac974a090fa8e7db6b4e347,5,46,25,21,0,0,0,18,96,112,1,4,2.17857517,7310,1578,9,906,905,1,35624,35590,34,462,460,2,1,99.98879175,NoArch
520c0ccc9b8ec4832f69ebba366e23d80326be5f,2,20,0,20,0,0,0,6,40,25,1,2,0.992774454,2868,10,3,234,230,4,11531,11443,88,124,121,3,1,100,NoArch
5ee895d3021028b5412833b8cd37deda1b5af4ea,1,26,0,26,0,0,0,25,91,18,1,1,0,9702,1579,10,465,464,1,28676,28570,106,413,412,1,1,100,NoArch
e046be23d7364e16648ade5240ad948a04cc814b,10,531,9,522,1,0,1,2,124,19,1,2,2.439927044,25992,2,0,2258,2199,59,99488,97046,2442,1365,1339,26,1,99.78749581,NoArch
ea994131cd6d109ff7edf5e61754104e2b8619be,2,8,7,1,0,0,0,6,41,23,1,2,0.996791632,3487,11,2,377,378,1,15312,15312,0,164,164,0,1,100,NoArch
32cca802ecded64cceff5a3d98cf981e25b6769b,2,4,0,4,0,0,0,3,7,149,1,1,1,540,1580,7,54,54,0,2743,2719,24,36,36,0,1,100,NoArch
7c7e932eb1dbb0d2d759303d37d0e21c8fb24c69,2,5,3,2,0,0,0,3,18,253,1,2,0.811278124,489,0,0,71,71,0,2958,2948,10,31,31,0,1,100,NoArch
868d64140d446cdb33652c0c76c4038b1ca26a14,2,83,0,83,0,0,0,6,42,70,2,2,0.867629312,2769,1581,8,164,161,3,10378,9890,488,124,122,2,4,99.93304319,NoArch
7a56eb63dfbd3310d14c85270f667eb3f8fa6aa3,11,335,26,309,0,0,0,2,98,45,1,10,2.841909459,22977,8,0,2275,2250,25,97434,96092,1342,962,951,11,1,100,NoArch
6689c7536a94dfed760c65f57c987dfeadc6d71b,2,217,5,212,0,0,0,7,34,54,1,2,0.93526914,3365,86,0,359,339,20,16161,15396,765,159,151,8,1,100,NoArch
1342d4cbb8099dc6a1820014a3ccc90a0d57106b,5,466,174,292,0,0,0,5,46,28,1,3,0.882280612,7993,87,1,951,931,20,43191,41930,1261,367,361,6,1,100,NoArch
88da6a18c2f85841cd1466dc99632d9e001da568,3,599,223,376,0,0,0,7,55,23,1,3,0.616229114,6438,88,2,860,814,46,30341,28541,1800,341,333,8,1,100,NoArch
2ddff7a5eceef62b906e9e17820bc0238c2f351a,2,18,3,15,0,0,0,18,97,149,1,2,0.958711883,4257,1582,4,367,365,2,19828,19771,57,282,281,1,1,100,NoArch
ac364e8c8a100e818cfc048bf78a4100f07276d7,1,10,12,2,0,0,0,6,17,1,1,1,0,936,2,0,98,98,0,5200,5200,0,14,14,0,1,100,NoArch
7d8e0528bec568e2abe7f8287510c1e79b178b1d,2,36,8,28,0,0,0,9,20,80,1,2,0.730926378,2705,0,0,320,316,4,12026,11912,114,142,140,2,1,100,NoArch
d619304070bf2874ab760c92ec2573ee6c19f536,8,259,35,224,1,0,1,25,93,320,1,6,1.946910186,25990,1583,5,2126,2097,29,94458,93764,694,1130,1111,19,1,99.95538204,NoArch
e71157bba1ea4eae135d1ddddebe576e72625b3d,0,0,0,0,0,0,0,0,0,0,0,0,0,0,89,3,0,0,0,0,0,0,0,0,0,1,100,NoArch
991784971006ede1caec5f8e8c2452a77dd485c9,1,12,14,2,0,0,0,2,9,9,1,1,0,2148,90,4,291,292,1,11461,11472,11,51,51,0,1,100,NoArch
b6175f807d62ea5be268e1312d9ea52e569f56cb,0,0,0,0,0,0,0,0,0,0,0,0,0,0,91,5,0,0,0,0,0,0,0,0,0,1,100,NoArch
f8ab9078bae8c519ce4c86d741490779ea899a14,3,100,5,95,0,0,0,23,125,684,1,3,0.859840597,8721,2,0,558,538,20,35601,35121,480,431,424,7,1,100,NoArch
4519ef6e599ebe9b1c182016bea62d0ac920ea1a,25,279,97,182,0,0,0,2,57,559,2,12,3.857250487,12164,41,0,1598,1575,23,63037,61930,1107,803,789,14,1,99.96654399,NoArch
e117c10cef192ca4ab10ffec2132b7dbd34319fa,9,281,52,229,0,0,0,23,99,12,1,8,2.575913618,22390,9,1,2282,2264,18,94225,93495,730,960,951,9,1,100,NoArch
f6af061ced056d1935b4173f9901152cbaca318b,2,30,1,29,0,0,0,10,23,2,1,2,0.823811633,2844,1,0,327,323,4,12370,12289,81,146,145,1,1,100,NoArch
c8462e1acb01c0ff1b5d62a1ef318bfcc01301c0,2,122,21,101,0,0,0,7,37,31,1,2,0.779349837,4205,92,5,428,418,10,19463,18932,531,176,172,4,1,100,NoArch
915c218b0fcbff26652071d267903d97875c7b9e,9,16,13,3,0,0,0,2,126,177,3,7,2.908693926,22137,1584,2,1922,1922,0,86002,86007,5,1041,1041,0,2,100,NoArch
205af8134857ba312415b9a5b4a48020fe0ce888,42,1498,1164,334,3,5,8,3,68,687,2,19,4.518925268,41790,1585,3,4948,4800,148,186950,182145,4805,1796,1770,26,1,93.77222159,Arch
946b24f4dc163dee018de90b2dcf7082bb892cfe,2,211,13,198,0,0,0,10,25,13,1,2,0.789352404,1861,3,1,146,117,29,7357,6420,937,109,99,10,1,100,NoArch
f22a9965a4e0f97b4f60c29ad52c0328a6a1e221,0,0,0,0,0,0,0,0,0,0,0,0,0,0,1586,4,0,0,0,0,0,0,0,0,0,0,100,NoArch
83cef58b2b51e3e428fa50e532bf6ce6fa8f201c,2,88,30,58,0,0,0,7,38,0,1,2,0.969950494,4306,93,6,434,428,6,19611,19463,148,178,176,2,1,100,NoArch
d4b0acdd32552360f983013aa1ab7505e19f4a28,1,1,1,0,0,0,0,3,6,378,1,1,0,536,3,0,56,56,0,3609,3609,0,19,19,0,1,100,NoArch
6cb4d45b02b03a71f4fe1ce52844f750e3ec1fd8,3,88,367,279,0,0,0,4,51,77,1,3,1.320141625,9529,1587,5,684,719,35,45668,48339,2671,331,348,17,3,100,NoArch
32747d794bc7dae41b98bf508f350b4be878e67e,3,13,1,12,0,0,0,26,94,90,1,3,1.556656707,16954,1,0,1628,1626,2,62166,62109,57,705,704,1,1,100,NoArch
f164fb8eaa9dbcbb44b0a3e1cd3427d457ebffb8,5,35,3,32,0,0,0,26,95,725,1,3,1.77362113,12103,2,1,845,843,2,39770,39457,313,505,504,1,1,99.9528135,NoArch
4069013f1b49fc1b83f5e1b608be15f1774b2b38,4,54,21,33,0,0,0,2,96,459,1,3,0.980161616,16387,1588,4,1441,1439,2,60143,60043,100,685,682,3,1,100,NoArch
d393cab26e72f3c0de5eebcbeac5d94fff87a997,2,75,120,45,0,0,0,1,30,148,1,2,0.970950594,4581,1589,5,670,674,4,19502,19614,112,214,216,2,1,100,NoArch
91d95762158bb8937fedcd0b9ff334cf049fa92b,1,1,0,1,0,0,0,2,4,66,1,1,0,189,1590,6,17,17,0,1043,1038,5,13,13,0,1,100,NoArch
419b810fe67539cf7a3d653e918352fbaf10e8b0,3,47,58,11,0,0,0,5,20,332,1,3,1.230959563,1606,16,0,285,291,6,8681,8609,72,78,78,0,1,100,NoArch
f5df5dd8cc1c97076fd6a0afc0fddc731b26b34c,0,0,0,0,0,0,0,0,0,0,0,0,0,0,1,0,0,0,0,0,0,0,0,0,0,1,100,NoArch
33873f64931470e868c1735e9eac86707a659d9e,10,254,39,215,0,0,0,22,100,36,1,9,2.928142039,25284,10,0,2642,2613,29,105686,104448,1238,1292,1284,8,1,100,NoArch
56d5261abb893dd92b0a2cc4893292876a2b7880,43,122,75,47,0,0,0,11,68,886,1,11,4.469594453,24704,4,1,2758,2754,4,112243,112033,210,945,942,3,1,100,NoArch
e57c7372aca1679a2178c3a5fb2e71933e6f6908,1,1,1,0,0,0,0,1,6,1181,1,1,0,256,17,0,28,28,0,1541,1543,2,15,15,0,1,100,NoArch
395d379127c7407827246614bd61253152c15805,2,12,1,11,0,0,0,4,6,275,2,2,0.961236605,334,1591,3,21,20,1,2133,2069,64,19,18,1,0,100,NoArch
1855861a1a54b450aa72b5ef098fcbd2ce3d430c,69,260,292,32,0,0,0,1,98,1020,8,35,5.322957578,42648,1592,4,4602,4602,0,178113,178112,1,2025,2025,0,0,100,NoArch
0c0199cf57f1fdc914146c3a2172c746416f8cd9,0,0,0,0,0,0,0,0,0,0,0,0,0,0,1593,5,0,0,0,0,0,0,0,0,0,0,100,NoArch
12e020e0f6e157f9339ecaedeb1570cc46d7f99d,2,62,53,9,0,0,0,6,43,53,1,2,0.072016472,2951,12,0,237,236,1,11939,11889,50,127,126,1,1,100,NoArch
a088aab78655e138353f40b57bebaf3cf3aec939,2,22,15,7,0,0,0,6,44,217,2,2,0.974024864,2715,94,0,193,189,4,10233,10164,69,137,137,0,1,100,NoArch
d47191e8c48932d888cfc79574fe1ca075eb4eeb,2,56,27,29,0,0,0,7,45,55,1,2,0.707232494,3548,0,0,382,380,2,15781,15685,96,169,167,2,1,100,NoArch
86a5cc9a45b28bdc6b60d27d6bb018f441109f66,4,98,2,96,0,0,0,6,57,34,1,3,1.512040273,7398,1,0,817,810,7,42955,42316,639,422,417,5,1,100,NoArch
304eb9c54dd0565fd48006b75c715c944f82f974,5,27,4,23,0,0,0,22,68,79,1,5,2.139409828,15955,11,1,936,936,0,52838,52752,86,838,838,0,1,100,NoArch
bdaa485eecf7e5d6a80b3ee7cc3ccd5579c41794,2,20,6,14,0,0,0,7,46,1,1,2,0.779349837,2965,95,1,239,238,1,12007,11965,42,128,128,0,1,100,NoArch
db95f5ba8247a5c00039719e246d6ee27f04d6cf,2,30,1,29,0,0,0,18,99,365,1,2,0.637387499,3474,8,0,283,281,2,15371,15271,100,272,271,1,1,100,NoArch
f63a65a8c6ffd9a771e27ef0446496c6b67baeea,2,32,1,31,0,0,0,18,100,0,1,2,0.439496987,3503,96,2,285,283,2,15468,15371,97,273,272,1,1,100,NoArch
d5c713c5cd447e261e3ae5cffa728c073f425e28,1,5,5,0,0,0,0,2,3,325,1,1,0,197,0,0,46,46,0,1008,1008,0,19,19,0,1,100,NoArch
43e32fa5a4d5828370dbdf9cffe3bb295ffc475a,1,3,1,2,0,0,0,1,2,1463,1,1,0,113,18,1,19,19,0,581,568,13,6,6,0,1,100,NoArch
03bb2cea517a62c9d7c80295527328e1b5c84ef9,0,0,0,0,0,0,0,0,0,0,0,0,0,0,0,0,0,0,0,0,0,0,0,0,0,1,100,NoArch
898c2d66a18af9f97f8061803a19f211d3d6ed85,4,153,19,134,0,0,0,7,47,108,1,2,1.351243552,4508,1,1,535,520,15,21706,21162,544,215,204,11,1,100,NoArch
8fb885d95adf5aefd28eb7e82593992f625fa5df,0,0,0,0,0,0,0,0,0,0,0,0,0,0,97,3,0,0,0,0,0,0,0,0,0,1,100,NoArch
54b9823e7ca313bf195c19b7d98f1a06b342cf12,0,0,0,0,0,0,0,0,0,0,0,0,0,0,98,4,0,0,0,0,0,0,0,0,0,0,100,NoArch
3530daaa8cad43aad6845b6c79e4bc1ca0e72f5f,0,0,0,0,0,0,0,0,0,0,0,0,0,0,65,5,0,0,0,0,0,0,0,0,0,0,100,NoArch
34758b3ef86d739a89f95912536cde6c19ad951b,0,0,0,0,0,0,0,0,0,0,0,0,0,0,66,6,0,0,0,0,0,0,0,0,0,0,100,NoArch
69c8053cd98ec65c55fa1c3b282b076536ab758f,0,0,0,0,0,0,0,0,0,0,0,0,0,0,67,7,0,0,0,0,0,0,0,0,0,0,100,NoArch
1cc7c3593a9201886afbd4dfc5ebe5b6d422715d,0,0,0,0,0,0,0,0,0,0,0,0,0,0,68,7,0,0,0,0,0,0,0,0,0,0,100,NoArch
6375e24d4a8848e11e776ed6968f3a6f499424ae,2,10,1,9,0,0,0,52,156,98,1,2,0.684038436,17547,14,0,1576,1575,1,67169,67143,26,719,718,1,1,100,NoArch
135daf3b302e7051768eb2bdce9839e75ba13e05,3,31,26,5,0,0,0,4,13,528,1,2,1.234779839,978,39,0,59,59,0,3529,3437,92,47,47,0,1,99.5036075,NoArch
3301a32273ccc325c7b0430d1695d496d5292509,0,0,0,0,0,0,0,0,0,0,0,0,0,0,40,1,0,0,0,0,0,0,0,0,0,1,100,NoArch
bd42d29123c54200b6c3c213d8dbd8e8ec24db79,2,20,2,18,0,0,0,13,61,54,1,2,0.976020648,2892,3,0,228,226,2,11925,11822,103,169,168,1,1,100,NoArch
ccbacf624c60b8b707c9e219a58d3968a9d4b854,1,15,11,4,0,0,0,6,16,225,1,1,0,699,19,0,84,85,1,3177,3168,9,44,44,0,1,100,NoArch
78251a196543a51b67f43b21f484ffcc8a8aa3f9,2,61,2,59,0,0,0,47,174,393,1,2,0.946818832,5810,1,0,429,425,4,26496,26280,216,421,418,3,1,100,NoArch
914e2127b096dd40d6c8a5f5c05ddad89b2e0863,2,61,1,60,0,0,0,47,175,43,1,2,0.597597776,6196,1,0,485,484,1,28925,28559,366,452,451,1,1,100,NoArch
8dd4fed46ff31df8737788847fdd2963944295f9,2,84,6,78,0,0,0,38,86,96,1,2,0.948078244,4269,0,0,347,340,7,18758,18372,386,265,262,3,1,100,NoArch
eb47b375c61aa4b3f6be2acb71e132c7a81c4e53,1,4,4,0,0,0,0,23,44,137,1,1,0,1278,1,0,269,269,0,7594,7594,0,65,65,0,1,100,NoArch
79a4ec63adfa83c6920b9ece5042f65a322ff80f,21,14,569,555,0,4,4,8,33,215,1,8,3.278003789,6394,15,1,794,836,42,30308,32855,2547,275,303,28,1,99.90109379,NoArch
ceb13a134502b950ce1ce1c25d9267aa51ca14b5,3,0,159,159,0,1,1,4,13,58,1,3,0.775868637,486,15,0,25,45,20,1281,1723,442,17,25,8,1,94.07953684,Arch
64a61cda18ada294e74ed6841d714d067bf0cb4e,3,1,109,108,0,1,1,6,9,51,1,1,1.227530533,1964,16,1,144,155,11,7317,7581,264,143,146,3,1,99.39620716,NoArch
d9d79ba69056ff69ab69b4c871ca1d83b0bfff15,2,17,11,6,0,0,0,45,117,97,1,2,0.491237342,10097,16,2,492,492,0,34993,34961,32,439,439,0,1,100,NoArch
adf4cc4dc5cdb9f5e49c85d10f46a2fdcd831ccf,9,220,0,220,1,0,1,53,157,147,1,7,1.978023067,22088,2,0,1745,1731,14,92110,90886,1224,1027,1020,7,1,99.95716978,NoArch
021fabe2a77264b388a3b681b78bc7e51fb2d978,1,31,11,20,0,0,0,45,118,1,1,1,0,9207,17,3,492,492,0,30701,30664,37,439,439,0,1,100,NoArch
0ed54bd64d0beb0849a499e65e872c43f00efce9,2,74,2,72,0,0,0,47,176,544,1,2,0.850382117,5878,18,4,431,427,4,26907,26569,338,422,421,1,1,99.99143542,NoArch
1748f0503e7b626a8d0165f1698adb8b61bbc31e,6,175,0,175,0,0,0,8,108,26,1,6,2.052547155,15858,2,1,1608,1598,10,85772,84857,915,821,813,8,2,100,NoArch
046f9f4e2e3c779e4e2e61946d67a0dc124f7f72,2,49,2,47,0,0,0,21,79,90,1,2,0.57700425,5409,17,2,542,541,1,29463,29175,288,317,316,1,1,100,NoArch
e1875e3f78d91711ba174834cdead500361b19e6,2,49,5,44,0,0,0,47,177,51,1,2,0.796269937,9724,19,5,976,973,3,45286,44976,310,573,572,1,1,100,NoArch
e723ee943f575823db5c8c155236368fc6bb00e2,1,1,1,0,0,0,0,11,41,97,1,1,0,2843,2,0,300,300,0,12958,12957,1,89,89,0,1,100,NoArch
4d4fe4cdab8dd7e03f0062a10884c2ac5ffc0da4,0,0,0,0,0,0,0,0,0,0,0,0,0,0,3,0,0,0,0,0,0,0,0,0,0,1,100,NoArch
cb364ce8109f92c80c17bb37d1cb1a03e6222bbe,5,123,16,107,0,0,0,2,178,64,1,4,1.792553126,10403,20,6,1024,1024,0,48532,48001,531,594,592,2,1,100,NoArch
6abf37a83b71568c3aa6d757913ab871fa15f837,2,14,1,13,0,0,0,13,62,55,1,2,0.566509507,4122,4,1,394,393,1,16823,16790,33,236,235,1,1,100,NoArch
72c52f46eab7fbe57ae5236ecc3831113684ff71,13,432,162,270,0,0,0,43,186,123,1,11,2.488795209,24893,6,0,2240,2220,20,118760,117288,1472,1284,1270,14,1,100,NoArch
fe2b59b82facad4d4e86eb4fa4080513b5dfe541,3,16,17,1,0,0,0,3,14,931,1,2,1.349548553,946,41,2,60,59,1,3516,3536,20,44,44,0,1,100,NoArch
954f27c2a09e019dd22d689ddd770ffb42c1c10c,2,41,19,22,0,0,0,47,179,13,1,2,0.41381685,6067,21,7,436,434,2,27762,27653,109,426,425,1,1,100,NoArch
e5e5809d28f422896147bd9f069f4930f22629ad,4,85,1,84,1,0,1,1,57,1003,1,3,0.66920483,1050,18,3,45,44,1,3619,3281,338,21,20,1,1,99.96574756,NoArch
0732283cab7894ffdce6a22ebe5d31b28d389a4d,3,195,5,190,0,0,0,38,87,118,1,3,1.115337761,5095,157,0,477,454,23,20611,19630,981,334,321,13,1,100,NoArch
bb0bae9c047db0f4bebaa6cd5b149876476e6ebe,12,204,26,178,0,0,0,3,143,190,3,10,2.980534882,22095,2,0,2595,2589,6,105977,104953,1024,1243,1237,6,1,88.03808768,Arch
1c5de1cd27a0251ac28a503e877ef9c21e61b620,6,96,113,17,0,0,0,6,81,239,1,5,2.40580886,6108,1750,0,738,735,3,34584,34784,200,403,400,3,1,100,NoArch
687b7d8cc8c63259138b43745a9e28ef64483839,6,299,3,296,1,0,1,9,180,322,1,5,0.712674431,6978,1751,1,557,512,45,33680,31957,1723,495,486,9,1,99.97643732,NoArch
15e63787a6c2ccaa01582991068d8e74daf93d1f,2,141,8,133,0,0,0,22,82,0,1,2,0.939059902,5518,1752,2,559,546,13,30275,29764,511,332,321,11,3,100,NoArch
ab1f777edb617ed9cf1c2f9b9a99c4dd0202a36b,2,4,4,0,0,0,0,1,92,569,2,2,0.811278124,2727,1753,3,77,77,0,8353,8351,2,41,41,0,0,100,NoArch
0cce229903a845a7b8ed36cf86d6078fd82d73d3,2,65,37,28,0,0,0,22,83,0,1,2,0.995558084,5651,1754,4,562,559,3,30418,30275,143,335,332,3,2,100,NoArch
f7c0b0a18ab72338e0b3afcdfd087aab3572fddb,6,507,153,354,1,0,1,1,93,426,1,4,1.982226637,4728,0,0,242,203,39,16598,15079,1519,131,115,16,1,99.94110025,NoArch
8c0d792dd735eded2bb11be0c7c195b8f302ae90,1,1,1,0,0,0,0,7,15,0,1,1,0,578,22,0,31,31,0,1307,1307,0,28,28,0,0,100,NoArch
0a87daf30d635277b8f1c94355e04ef907fc4002,2,37,5,32,0,0,0,14,63,24,1,2,0.973668065,4135,0,0,400,394,6,16970,16823,147,239,236,3,1,100,NoArch
f43d4f0ba44ae5f9d54e72dd6f071dbdee016d9a,0,0,0,0,0,0,0,0,0,0,0,0,0,0,1,0,0,0,0,0,0,0,0,0,0,1,100,NoArch
6d7eca19bb0a22d059abe4e283d003d2848e55af,2,33,1,32,0,0,0,47,181,23,1,2,0.833764907,6342,1,0,469,465,4,29032,28894,138,438,436,2,1,100,NoArch
58b6ad6135d909c053f15fb902d8b73559d1fa53,2,17,3,14,0,0,0,14,64,213,1,2,0.811278124,2727,1,1,192,191,1,9808,9754,54,180,179,1,1,100,NoArch
ab71c4cae5a5c3c7d979337a2d38ddaf271aa206,8,343,78,265,1,0,1,5,37,1062,2,4,2.756120226,2094,7,1,222,201,21,12067,10794,1273,132,123,9,1,99.91752091,NoArch
9c11efb5aae075f473d7cbfefbac99af1ef31553,7,152,25,127,1,0,1,5,158,496,2,4,2.32160172,18193,22,3,1603,1595,8,71272,70735,537,735,732,3,1,94.01921289,Arch
59c7acd802a885dec1db576974bea6e205d3d955,3,82,4,78,0,0,0,5,12,567,1,3,0.521949079,1287,3,0,89,87,2,5953,5455,498,60,59,1,1,100,NoArch
5754fa95e20fb6a961b01c1c951fc47f21132923,5,36,0,36,0,0,0,44,110,35,1,5,2.102024647,15545,0,0,1585,1583,2,74571,74387,184,802,800,2,1,100,NoArch
2d52dd3f2dc3e6087c034008037e6c47b201c732,3,102,3,99,0,0,0,6,13,1320,1,2,1.051909558,1267,0,0,125,116,9,6181,5690,491,81,72,9,1,91.6098166,Arch
18974ce8a945424a8a3465c03b253e292641f420,7,148,5,143,0,0,0,2,30,2004,2,5,2.709739224,4169,5,0,571,552,19,21168,20323,845,256,249,7,1,99.98290598,NoArch
9ba140ef66ad1e048789532211ddf8b3ca1cf8ec,2,29,2,27,0,0,0,5,5,656,1,2,0.554778163,304,2,2,32,30,2,1370,1237,133,27,25,2,1,100,NoArch
c1c4e31c849c4c9cb73056be95f5694ccd5fc2db,13,105,74,31,0,0,0,10,84,123,2,7,3.253598581,10637,19,1,1063,1058,5,53573,53353,220,597,595,2,1,87.83407285,Arch
3ebaa591c6fa045310252944a292b85908a938f8,1,22,15,7,0,0,0,14,95,152,1,1,0,4595,2,0,260,258,2,15460,15394,66,247,246,1,1,100,NoArch
689a5bbb14614d3f8eef4a4f7e832c6c02029b3c,2,18,27,9,0,0,0,14,96,0,1,1,0.996791632,8553,21,0,491,491,0,28638,28666,28,466,466,0,0,99.18192443,NoArch
a1851b67d56f98e14fbe54a96972104585ae8a61,2,101,27,74,0,0,0,47,182,109,1,2,0.498027887,6600,10,0,486,478,8,31086,30589,497,443,441,2,1,100,NoArch
ccad6f982fc0d6bd45424e602ec0432a1bcecda7,2,58,2,56,0,0,0,44,111,20,1,2,0.566509507,11816,14,0,933,930,3,56719,56567,152,436,436,0,1,100,NoArch
0061b2a172de29acd5859abd7eb93e491d4f4f41,1,42,26,16,0,0,0,4,12,182,1,1,0,386,1,0,21,21,0,1869,1615,254,17,17,0,1,100,NoArch
3309396dbb73d1f2ec2e32e8ffee0f9e68262db1,2,31,0,31,0,0,0,39,88,70,1,2,0.205592508,4995,0,0,520,518,2,21745,21589,156,309,308,1,1,100,NoArch
d98856bf1a5f5c151d004b769e14bdd368a67234,2,12,1,11,0,0,0,5,11,53,1,2,0.89049164,672,3,3,90,88,2,4351,4286,65,36,35,1,1,100,NoArch
fef2133ee6652688de7c6cd7ecb755cf5459cba1,3,7,4,3,0,0,0,8,23,259,1,2,1.539484757,2619,23,0,273,273,0,11740,11755,15,125,125,0,2,100,NoArch
41b00bab339a5f5fd514ab873c926cdede37b544,6,15,30,15,0,0,0,5,183,27,2,6,2.03118259,10759,1755,0,777,777,0,45697,45697,0,718,718,0,0,100,NoArch
f7762b6a7cd85711a8cc6d7c7174dedca22bdcd2,2,39,2,37,0,0,0,16,93,262,1,2,0.872161788,4924,31,0,656,648,8,29552,29429,123,191,189,2,1,100,NoArch
1e999374f3a40c26d1cb3469211f10cd2fdc0622,3,38,1,37,0,0,0,4,94,69,1,3,1.199635709,5399,32,1,741,739,2,32322,32052,270,209,207,2,1,100,NoArch
f82353c80223143673fc78561a05c79d6fd4f364,2,86,1,85,0,0,0,47,184,451,1,2,0.362051252,6562,3,0,476,473,3,30255,29724,531,443,440,3,1,100,NoArch
61b7280ee1167235e3fbd76a6ce379fc83658dbb,5,174,2,172,1,0,1,8,85,191,1,4,1.326881404,5618,0,0,845,831,14,29205,28238,967,322,315,7,1,99.75366265,NoArch
3ab722b5cccf3357f5c6fddf796ccf612d978cc2,3,130,25,105,0,0,0,2,21,461,1,2,1.56246583,2520,1756,1,342,338,4,15279,14712,567,144,140,4,1,100,NoArch
ac06e64fed6865949207aabd4ef839418589b6e3,6,293,55,238,0,0,0,39,90,469,1,5,1.916219808,5841,1757,2,564,543,21,24419,23081,1338,374,359,15,1,100,NoArch
c3108bc1231b2aa4ba25227d225544fef4576508,7,184,38,146,0,0,0,39,91,86,1,4,2.349161754,7922,1758,3,945,928,17,36933,36439,494,469,461,8,1,100,NoArch
357cb741f70f9c9d541dfc77fa0b813ee4dfe959,1,39,23,16,0,0,0,9,24,8,1,1,0,681,11,1,55,56,1,3644,3606,38,16,16,0,2,100,NoArch
b432756e2be9ad0557a56254550eb4438dd0efcf,16,131,149,18,0,0,0,2,95,722,1,7,2.777212486,17906,1759,4,1943,1943,0,90432,90557,125,707,706,1,0,100,NoArch
22817fb34ab0921e6ab6567a9c65819ebd11b9c5,2,25,0,25,0,0,0,3,7,99,2,2,0.989587521,912,0,0,71,69,2,5078,4964,114,41,39,2,1,100,NoArch
4954216c71a6262728ad6ed4792d4ac7b9ec7b71,3,105,24,81,0,0,0,8,21,28,1,2,1.112873481,1469,1,1,158,156,2,9342,8877,465,41,40,1,1,100,NoArch
80cc4253a3a5b0677382725d7471ed1163cc204e,2,242,0,242,1,0,1,48,185,4,1,2,0.902393283,6071,0,0,448,432,16,29131,27947,1184,437,429,8,1,99.97405293,NoArch
3cff43a053abde614e5ab00587d10831197dc6ee,3,19,0,19,0,0,0,53,159,133,1,3,1.461838199,20809,23,0,1072,1069,3,68095,68012,83,930,928,2,1,100,NoArch
979a825fab0757c506363f5df6ed7997674e8726,2,49,0,49,0,0,0,6,14,42,1,2,0.33228663,1096,1,0,95,91,4,5090,4856,234,50,47,3,1,100,NoArch
0bbbae54dbac2bc8f738e091167dd9b027ad4f20,2,52,15,37,0,0,0,48,186,38,1,2,0.48303068,10050,20,0,998,987,11,47186,46931,255,589,587,2,1,100,NoArch
0eab54d28a8a528926ec7074b38d3b4a09befd84,0,0,0,0,0,0,0,0,0,0,0,0,0,0,69,0,0,0,0,0,0,0,0,0,0,0,100,NoArch
f1db14c1b088ba650405c2def3395a1311dc2572,0,0,0,0,0,0,0,0,0,0,0,0,0,0,70,1,0,0,0,0,0,0,0,0,0,0,100,NoArch
7f5b313bbc0f98379c1b03a3fb08f296143d64c2,3,182,3,179,0,0,0,17,187,9,1,2,1.527018792,11151,20,0,1114,1097,17,59022,58255,767,639,629,10,1,100,NoArch
2678eb9a867c6589208b60c2a07446c658d2d8c6,2,43,0,43,0,0,0,23,87,26,1,2,0.583019417,5715,4,1,572,569,3,30912,30654,258,339,337,2,1,100,NoArch
fb797bbf428a0a949a792b3bc01b612049cb22fc,2,10,10,0,0,0,0,18,188,0,1,1,0.970950594,9026,0,0,601,601,0,46777,46777,0,557,557,0,1,100,NoArch
602b2a10e3f81888c0759ca69f7415497124ef82,0,0,0,0,0,0,0,0,0,0,0,0,0,0,15,1,0,0,0,0,0,0,0,0,0,1,100,NoArch
5212d6c47e36995943f4d955a1714bf03eb08e7e,7,316,22,294,2,0,2,2,160,14,1,4,2.522858972,21102,24,1,1094,1076,18,70826,69673,1153,944,933,11,1,99.90926766,NoArch
6f02ecf33318b223f752a3f6f3daa70753149875,2,10,10,0,0,0,0,18,189,0,1,1,0.970950594,9026,21,1,601,601,0,46777,46777,0,557,557,0,1,100,NoArch
e8baf4f4720e07cdce1aa2baabf20042b9353bbb,10,192,62,130,1,0,1,24,75,762,2,6,2.810591352,7076,3,0,873,864,9,30127,29571,556,304,295,9,1,99.97409997,NoArch
a042b6115120cb48079266444a264e16a9ca611b,1,18,14,4,0,0,0,3,6,204,1,1,0,414,1760,5,20,19,1,1119,1111,8,8,8,0,1,100,NoArch
996cdd0249a4e5086fadc27a15ccc23eb9defd8e,1,9,34,25,0,0,0,3,5,981,1,1,0,224,0,0,34,39,5,795,934,139,20,23,3,1,100,NoArch
205fe17eee11b923356e6f297679e43366043043,16,524,36,488,5,0,5,19,74,332,1,10,3.364279927,4935,15,0,644,604,40,29362,26641,2721,359,333,26,1,95.62404423,Arch
2a2de705f93c886cea0996e757348a2493eef737,31,1683,89,1594,6,0,6,2,187,737,2,16,3.885376831,30045,1761,6,3274,3122,152,149106,141108,7998,1815,1723,92,1,97.84222738,Arch
5ec3a2a503dcf26fe1b3cad8a5a9467264213dcf,32,1473,213,1260,7,0,7,3,188,108,3,13,3.912641362,24511,0,0,2323,2193,130,122371,115800,6571,1349,1268,81,1,99.73684211,NoArch
3abb974588194e2e531aa43daa79c4dfd18ef25f,7,80,10,70,0,0,0,50,190,271,1,5,2.509230699,12814,8,0,1109,1101,8,63069,62690,379,844,839,5,1,100,NoArch
f25734a2d27f304a454a310e656ab83a5fa85890,17,619,289,330,2,0,2,3,161,304,2,8,2.927593771,34695,25,2,2374,2339,35,128788,127770,1018,1491,1469,22,1,94.89396035,Arch
5c017135b6b923abbf1b465ac1962bcec7886dfd,3,15,2,13,0,0,0,6,53,944,1,3,1.159554752,2025,6,0,274,273,1,9983,9897,86,110,109,1,1,100,NoArch
7625938f1faa37fe34540d3a7a2257ec7eae5704,2,26,3,23,0,0,0,42,145,53,1,2,0.893571102,9322,16,1,1197,1196,1,41668,41613,55,607,605,2,1,100,NoArch
705be2771f284533a998e941c9dc3b285f1d7351,10,329,100,229,1,0,1,2,162,2,1,4,2.522248536,21730,26,3,1133,1127,6,72832,71930,902,974,965,9,1,99.97862334,NoArch
0a6f53cb828cd39d78d1423361921bf40636943a,2,28,0,28,0,0,0,14,65,45,1,2,0.863120569,4181,5,1,403,401,2,17119,17009,110,241,240,1,1,100,NoArch
a68bfc96bacc95b4b8ab5d185bb5cc1991113769,2,40,0,40,0,0,0,14,66,1263,1,2,0.609840305,2837,6,2,206,200,6,10341,10120,221,178,175,3,1,100,NoArch
6400a509501419beef0d34e1deccdc2beadfbb30,1,4,4,0,0,0,0,6,10,8,1,1,0,325,7,3,38,38,0,1580,1580,0,16,16,0,1,100,NoArch
6b600e4bd13d130a4ea48ab9b8451d81ed095da0,17,132,112,20,1,0,1,5,146,370,2,7,3.495864646,11232,27,4,1389,1398,9,55952,55934,18,474,476,2,1,99.90387696,NoArch
79b97b628ac43e56873029b72a18e7bec0d1e7db,4,74,1,73,0,0,0,54,163,98,1,3,1.693803449,12413,0,0,606,602,4,42398,41990,408,509,505,4,1,84.91068035,Arch
36e3109fb524c13ca0a08e3ad585785aa5abc18b,13,125,191,66,0,0,0,7,191,273,2,5,3.258024419,15680,21,1,1464,1480,16,79524,79835,311,890,895,5,1,99.81261711,NoArch
3f550c3f28d75d0f75b5815a22395dbecf992f03,3,25,10,15,0,0,0,8,20,497,1,3,1.241235472,936,8,4,137,139,2,4706,4719,13,68,68,0,1,100,NoArch
e8b08c490ab4270945c35f31846cd36b5788cc23,5,105,4,101,0,0,0,55,164,71,1,5,1.693476497,13815,1,0,676,673,3,47306,46902,404,554,551,3,1,100,NoArch
a71def51dbf3dc18af2e73418ed30e0f2e6addde,0,0,0,0,0,0,0,0,0,0,0,0,0,0,1762,2,0,0,0,0,0,0,0,0,0,1,100,NoArch
11116f6d03bca7cd97d151033c5d82f24394e229,6,349,175,174,0,0,0,13,192,55,1,4,1.742623517,19703,3,0,2001,1982,19,96897,95513,1384,1116,1103,13,1,99.92181392,NoArch
beeb012c994642e2db46c30e6059f1f1c22287c9,3,9,5,4,0,0,0,43,189,347,1,2,1.287054028,11828,2,0,1002,1002,0,46705,46691,14,819,819,0,1,100,NoArch
5a42812832e51a7551a793ac75160188e06668e6,2,309,6,303,0,0,0,4,11,1492,1,2,0.887034158,1556,0,0,122,85,37,8751,7400,1351,51,46,5,1,100,NoArch
9fd9c822287751ed1f9e6a10adc3f50b0cea0a54,1,11,11,0,0,0,0,17,55,14,1,1,0,1663,9,5,236,236,0,8392,8392,0,80,80,0,1,100,NoArch
1e62d3d64fc217d14016702237b4f8d56b3683f2,7,389,265,124,0,0,0,16,125,252,1,7,1.698088514,10621,0,0,1381,1352,29,48418,47561,857,846,832,14,1,100,NoArch
ab97af39bd9438420cb5b212b95b23d9cb798f0d,1,1,0,1,0,0,0,9,18,440,1,1,0,699,0,0,75,75,0,2552,2538,14,23,23,0,1,100,NoArch
729446005617059c0ce9fef4068087e4ca9ca139,2,29,8,21,0,0,0,14,67,7,1,2,0.99947302,4215,10,6,408,404,4,17259,17153,106,244,242,2,1,100,NoArch
22577e488e04d4056e15af96bac4246fd810f0fa,5,75,10,65,0,0,0,7,70,302,1,5,2.071199844,4724,17,1,336,332,4,26335,25924,411,264,262,2,1,100,NoArch
00ad79b6bc95b68e02129b31be8a3a656517f8a8,6,111,0,111,0,0,0,9,113,54,1,6,2.210112423,16367,2,0,1633,1623,10,88232,87513,719,841,833,8,1,100,NoArch
48c0db1206b17c571d477d912d193d32b5be1eff,2,68,2,66,0,0,0,40,92,370,1,2,0.999411065,3997,0,0,278,270,8,15678,15348,330,261,256,5,1,100,NoArch
a8f9e4ee02c4253e1cbc150cbe3af8791a7beda8,9,900,0,900,3,0,3,5,190,38,2,7,2.428011306,12787,1,0,1109,1040,69,66019,60324,5695,684,655,29,1,99.984375,NoArch
69f9e877c436b6d74fdc712b5bf71819dc090796,5,193,63,130,1,0,1,6,12,350,2,3,1.849274276,995,9,1,143,135,8,6403,5718,685,47,40,7,1,84.37935844,Arch
e863294ccfbed9dd520c999f75ed0bbe03f9fb1d,2,105,0,105,0,0,0,41,93,25,1,2,0.615766705,4688,0,0,378,370,8,20851,20439,412,291,284,7,1,100,NoArch
77e7808fc0aa4e089a992535bc890047724fd900,1,12,0,12,0,0,0,19,55,266,1,1,0,2000,1,1,277,274,3,8986,8915,71,74,74,0,1,100,NoArch
be678e3dc65f5933f85927e53b2811738d124f11,4,25,5,20,0,0,0,5,13,24,3,4,1.926887582,5404,3,1,520,518,2,20691,20572,119,400,398,2,1,100,NoArch
8a3fde56e6931ca8c5a12d22489c6ce0eae4a8bc,1,244,238,6,0,0,0,9,23,11,1,1,0,904,1763,1,60,60,0,9876,9201,675,45,45,0,0,100,NoArch
b039b152d8d2e91ab2ca0232ebddfc998f3bb331,9,280,1,279,1,0,1,9,114,81,1,6,2.721012502,17437,3,1,1672,1638,34,95097,93368,1729,857,846,11,1,99.95730601,NoArch
e5ae1796e8016b0a5e943f458bf31a7e7e8aa75a,42,7139,55,7084,23,0,23,1,123,209,2,16,4.148998498,30206,0,0,4280,3618,662,166480,132544,33936,2097,1790,307,1,91.47075967,Arch
cc169aec313c19bd7749c448c1e8eca014997b77,1,3,3,0,0,0,0,2,2,2,1,1,0,361,22,1,35,35,0,1619,1619,0,13,13,0,1,100,NoArch
70f1453086d67bd6d431d63b93a27baf0cdba06d,2,17,2,15,0,0,0,51,193,20,1,2,0.74248757,9112,4,1,758,757,1,42368,42316,52,537,536,1,1,100,NoArch
97d68952d467540cddddbe8350f706028001dfbf,3,90,4,86,0,0,0,8,22,66,1,2,0.288400914,1550,4,2,162,158,4,9839,9342,497,43,41,2,1,100,NoArch
01477c42ded991aaa7b14cf72a6e4ea1a20edf5e,58,3803,247,3556,8,0,8,3,194,635,3,15,4.114271476,60751,28,2,5838,5357,481,267062,250626,16436,3143,3021,122,1,87.8793851,Arch
c1b042fec9a979bfa39a767f7b04da0a5134053a,3,4,52,48,0,0,0,2,93,4,2,3,1.556363553,6197,1,1,788,793,5,26581,26729,148,335,337,2,1,100,NoArch
6cec81178e6739d9b1f3474dc5dbd7488dda2464,8,705,22,683,1,0,1,7,81,59,2,5,2.384129889,6765,0,0,699,650,49,38306,35022,3284,403,382,21,2,89.83151931,Arch
e2300d297d291514906ca002d045664732ec928c,1,4,0,4,0,0,0,2,2,10,1,1,0,38,22,0,1,1,0,118,92,26,1,1,0,1,100,NoArch
72680df93ef089abd0a7c0ac8cdc6253619c2ebe,0,0,0,0,0,0,0,0,0,0,0,0,0,0,29,2,0,0,0,0,0,0,0,0,0,1,100,NoArch
b8d24a6f7f2b4c7cb8093eea158f1fa00dbc6ffc,2,22,0,22,0,0,0,46,147,18,1,2,0.994030211,9398,11,4,1206,1204,2,41882,41842,40,615,614,1,1,100,NoArch
81c768e60078bcb6c8c78057d80090d27ac86030,2,28,1,27,0,0,0,46,128,27,1,2,0.929363626,4053,30,3,482,478,4,15579,15503,76,453,451,2,1,100,NoArch
55cc3abfbcb906935a703a5cf77b1b0359fca734,4,52,116,64,0,0,0,3,11,18,1,1,1.998977353,1008,23,1,103,105,2,5613,6045,432,34,36,2,1,89.63116575,Arch
48086a76578b96ac961c833075357710bd624d3e,3,471,448,23,1,0,1,1,97,74,1,1,1.263933805,8544,22,0,490,491,1,28897,28638,259,466,466,0,2,99.89206692,NoArch
c9520c35899fe5ac363053e9fb9b292989b1176c,0,0,0,0,0,0,0,0,0,0,0,0,0,0,23,1,0,0,0,0,0,0,0,0,0,1,100,NoArch
955d4ea7b30b85519529c1c77662fa04141bfa89,3,53,10,43,0,0,0,47,191,147,1,2,1.445419945,8722,4,0,552,551,1,36139,35993,146,423,421,2,1,100,NoArch
5c25c386dd70172f98d870ce72455fab897eb70a,1,1,1,0,0,0,0,3,5,1273,1,1,0,47,0,0,2,2,0,166,168,2,2,2,0,0,100,NoArch
faeb6d0ea16c493157a1159c49cb970790c10cc1,1,2,2,0,0,0,0,21,61,23,1,1,0,2596,0,0,198,198,0,17392,17392,0,177,177,0,1,100,NoArch
6fabfd609800824d84fb13703f4d70ac1798c9aa,2,10,1,9,0,0,0,47,124,65,1,2,0.994030211,9442,2,0,509,509,0,31877,31823,54,447,447,0,1,100,NoArch
8c941e03d8443d1e0dae12cb740e7eea09d56ab2,7,77,65,12,0,0,0,13,148,20,1,6,2.06647337,8937,1764,1,1088,1088,0,44005,44005,0,350,350,0,0,100,NoArch
358027602b24c45a6cec686544ef37b3da594e9b,0,0,0,0,0,0,0,0,0,0,0,0,0,0,24,2,0,0,0,0,0,0,0,0,0,1,100,NoArch
adc1532de853060d24fd0129257a3fae306fb55c,0,0,0,0,0,0,0,0,0,0,0,0,0,0,25,3,0,0,0,0,0,0,0,0,0,0,100,NoArch
034bd7942c35d5b6c948dc6863a9a086fb82386c,0,0,0,0,0,0,0,0,0,0,0,0,0,0,2,0,0,0,0,0,0,0,0,0,0,0,100,NoArch
3f7bbae47ad113121d3885ee70d2aa246490a033,0,0,0,0,0,0,0,0,0,0,0,0,0,0,3,1,0,0,0,0,0,0,0,0,0,0,100,NoArch
4ce87bb3ba0b51e8e1853240196a64a4ab575b03,0,0,0,0,0,0,0,0,0,0,0,0,0,0,1765,1,0,0,0,0,0,0,0,0,0,0,100,NoArch
f6aa7a927feaa88bd4076f9098203346b89ae80d,1,39,18,21,0,0,0,5,7,338,1,1,0,94,0,0,6,5,1,553,440,113,3,3,0,1,100,NoArch
d3c718328d4c83fb24007c8349b31b420dddd187,10,130,109,21,0,0,0,55,166,864,1,4,2.86367671,13002,31,3,699,708,9,43411,43297,114,515,514,1,1,89.75191583,Arch
ce8ca6742bf1296af421c8e61f9918734db74cf3,2,14,8,6,0,0,0,52,195,85,1,2,0.945660305,7630,5,0,589,589,0,34372,34343,29,511,510,1,1,99.89309287,NoArch
43b6abcb35ce91aec340e0963072647106ccf229,5,106,1,105,0,0,0,8,43,394,1,4,2.07171794,4031,6,1,572,564,8,19611,18903,708,177,173,4,1,100,NoArch
507d383a0f8db339691bb126d66c58875fd47ef8,3,56,55,1,0,0,0,8,25,146,1,3,0.353012449,1051,7,2,43,44,1,4655,4635,20,30,28,2,1,100,NoArch
f95f74a13a20413bb0074f0a3c94901a7a88305c,3,38,11,27,0,0,0,7,56,590,1,2,1.310178101,3246,2,0,417,412,5,15550,15421,129,134,134,0,1,100,NoArch
f3758a6fa301cbd910ceabeca9075a3772ee4e8b,3,32,0,32,0,0,0,43,95,77,1,3,1.247556249,5697,0,0,508,504,4,22439,22256,183,361,359,2,1,99.92088608,NoArch
bc0f5d231d6e65d6e68aa395e5d7359db9a6459d,5,62,13,49,0,0,0,1,53,284,2,5,1.951787602,6749,1766,2,695,693,2,42407,42155,252,305,302,3,0,100,NoArch
f4dde669631f7fa4f64b42eb1481ba9a8f27bd39,12,389,62,327,3,0,3,6,94,58,2,8,2.777262775,8140,1,0,652,627,25,45206,43691,1515,259,246,13,1,92.78823529,Arch
67fd318ed755ef975cf31262c96c982f0922a975,0,0,0,0,0,0,0,0,0,0,0,0,0,0,13,0,0,0,0,0,0,0,0,0,0,0,100,NoArch
883e19170a45e0badffa5b8fba04cd536e0f2eb2,3,56,12,44,0,0,0,55,167,59,1,2,1.109280021,11944,32,1,570,569,1,38588,38433,155,494,493,1,1,100,NoArch
02a4ced35cb1f9fdc18b16528db1f922365a33c2,7,123,1,122,0,0,0,43,96,992,1,4,2.347306312,7751,1767,2,738,725,13,28762,28286,476,455,446,9,1,100,NoArch
29d8508f591be79683d0efeb3541dc3bdbc36d44,7,218,56,162,0,0,0,4,22,1161,1,3,2.140809967,3125,1768,3,417,397,20,18505,17646,859,185,173,12,1,99.99202425,NoArch
3b26283b61ca5e6be79c8e95c6558c8ab6985952,2,3,3,0,0,0,0,20,57,1146,1,1,0.918295834,2401,12,0,318,318,0,10443,10443,0,85,85,0,1,100,NoArch
9693817df9421fda9a727d03b225f686f5393def,1,3,0,3,0,0,0,6,13,245,1,1,0,214,1,0,44,43,1,1197,1181,16,16,16,0,1,100,NoArch
0115bd102fdbab66a2a7447b96b9f7bf49f14308,3,72,2,70,0,0,0,52,196,212,1,3,1.450202133,7467,8,3,608,602,6,34248,33815,433,525,523,2,1,100,NoArch
64068d69ceee8450e56c4705d26b7a2f944909b9,6,207,149,58,0,0,0,1,7,58,1,3,1.842937847,2469,33,2,343,357,14,12015,11783,232,80,90,10,1,100,NoArch
78c2a007b5b597f673323b80dde21c23d31f23ea,2,108,4,104,0,0,0,5,13,341,1,2,0.838372938,1897,1,0,136,120,16,9569,9002,567,66,58,8,1,100,NoArch
a7a566bb004fd73ee6402652f5572ad0012a97c9,2,48,0,48,0,0,0,43,97,12,1,2,0.918295834,4259,1,0,301,294,7,16804,16500,304,279,275,4,1,100,NoArch
405614f87b75eb515e767b78a2c47481a0efc701,16,8723,9438,715,0,0,0,2,168,384,2,4,1.204671623,37355,1769,4,2256,2244,12,149832,136291,13541,1848,1834,14,1,92.60306457,Arch
be01394210102ea83dc83f95ce5a59c60525b8d3,2,77,5,72,0,0,0,2,11,669,1,2,0.839004061,255,13,1,20,18,2,1602,1089,513,12,11,1,1,83.36933045,Arch
3005ff97ddb6173ac339b45affb0b4da5d406345,4,111,22,89,0,0,0,20,75,291,1,4,1.827842335,3226,3,0,384,374,10,17661,17171,490,206,203,3,1,99.97809419,NoArch
47a626d2687e5efc3e8a281a2e2d2b9985d306ef,0,0,0,0,0,0,0,0,0,0,0,0,0,0,4,2,0,0,0,0,0,0,0,0,0,0,100,NoArch
bb3889e860cc7472e31ba39ac6d3d5a0e3c59463,2,58,13,45,0,0,0,4,10,6,1,2,0.982615429,1631,1770,5,173,168,5,9668,9401,267,78,74,4,1,100,NoArch
0c8cbacd0f30b5df15b7cb93c0ab2be5d0324372,2,85,11,74,0,0,0,44,98,8,1,2,0.998747298,4389,0,0,323,319,4,17416,17123,293,284,283,1,1,99.9890495,NoArch
ed692fd4f2f00261348ecac779cb1a6d544d052e,7,91,11,80,0,0,0,55,169,35,1,4,2.437323446,20120,1,0,1744,1738,6,84485,84051,434,816,812,4,1,100,NoArch
c9adf94b0e07f2e9108ef4d1f2ee28c3e42063b3,2,96,1,95,0,0,0,53,197,562,1,2,0.199023775,6479,14,2,463,460,3,30483,29904,579,451,449,2,1,100,NoArch
2dc97e6723e1b5bf762540f87ffffb5cd1a848a1,2,9,1,8,0,0,0,48,126,1627,1,2,0.721928095,9140,0,0,527,526,1,37111,37046,65,460,459,1,1,100,NoArch
30a0dd0a2edebdc08292b7d59988c60ccf754bed,2,64,0,64,0,0,0,45,99,54,1,2,0.928362072,4323,0,0,307,294,13,17195,16897,298,280,277,3,1,99.95620278,NoArch
87c5bd29364a23ab3c06f289ffce1300e26e8c46,1,146,92,54,0,0,0,54,198,23,1,1,0,6448,1,1,452,452,0,30263,29940,323,449,449,0,1,100,NoArch
c09f293b4666b38e41a0724aab73565f8c61dbac,5,86,1,85,0,0,0,6,63,453,2,4,1.162901281,2919,0,0,82,73,9,9556,9039,517,29,26,3,1,99.86847874,NoArch
3498026cd9819c52198a89e0d06f564b83ba4a8a,2,17,1,16,0,0,0,47,192,113,1,2,0.650022422,8056,9,1,528,526,2,33736,33691,45,384,383,1,1,100,NoArch
64c395754d66e9a2ba6cd14e7ee0cb1eb5075c2c,4,4,4,0,0,0,0,3,10,2278,2,4,2,790,2,2,79,79,0,2973,2971,2,44,44,0,0,100,NoArch
a47492bf8a0a310b49379b45ad2c15243393e094,11,45,39,6,0,0,0,1,46,1256,2,9,2.810548656,4690,1771,2,447,447,0,14639,14639,0,185,185,0,0,100,NoArch
35c5f57d7db2b4745086178602ca69195ffb858e,7,74,39,35,0,0,0,34,117,271,2,4,2.179614113,7601,1772,3,1170,1164,6,36879,36692,187,329,326,3,1,100,NoArch
abf36e4da4884f2c22435384aa55d68f968a784e,1,1,1,0,0,0,0,6,14,43,1,1,0,1643,0,0,54,54,0,7386,7386,0,50,50,0,1,100,NoArch
3f54108b7dcd4d2b89fc42faab145e2f82883791,3,4,10,6,0,0,0,4,15,1952,1,1,1.378783493,948,0,0,112,112,0,5659,5674,15,33,33,0,1,100,NoArch
062c41391170db7f76e1596db72d6ef26694a08f,0,0,0,0,0,0,0,0,0,0,0,0,0,0,71,0,0,0,0,0,0,0,0,0,0,0,100,NoArch
68ceafb7553ffa26cc28fed8389deaa7c0f22833,0,0,0,0,0,0,0,0,0,0,0,0,0,0,27,0,0,0,0,0,0,0,0,0,0,0,100,NoArch
b841a6c7a815d5bc82ce8393e31e2da754efb261,0,0,0,0,0,0,0,0,0,0,0,0,0,0,28,1,0,0,0,0,0,0,0,0,0,1,100,NoArch
e43595482617b1bb991407800c068a0c727e5c17,2,21,8,13,0,0,0,4,19,175,2,2,0.79732651,1418,3,0,142,139,3,6017,5898,119,68,68,0,1,100,NoArch
812bc3bce4eabac6f09fbe02726da1d59bec061e,1,1,2,1,0,0,0,5,16,1,1,1,0,780,23,0,45,45,0,2848,2848,0,38,38,0,1,100,NoArch
1cc65f15bd3d22c7e41d4c8f776b567894fb94f3,7,209,28,181,0,0,0,6,149,660,2,4,1.809845364,9422,34,0,1192,1185,7,48821,47921,900,344,337,7,1,90.35784145,Arch
05a086bc6b453baa5d761c6198d496ffe361aafe,0,0,0,0,0,0,0,0,0,0,0,0,0,0,1773,2,0,0,0,0,0,0,0,0,0,0,100,NoArch
4be2d08e2116234a7df982014f8ae5bc79a7e0bf,7,141,27,114,0,0,0,48,127,631,1,4,1.469483277,11751,1774,3,701,690,11,45785,45180,605,540,534,6,1,100,NoArch
f7ff1c906212b34a41599c5009527639ad2e8718,3,62,0,62,1,0,1,5,13,518,1,2,1.020412481,391,3,3,41,36,5,2183,1929,254,38,34,4,1,99.77061451,NoArch
22c76fb8e0a3ec363332caf7eb8e46071ace798e,6,90,14,76,0,0,0,6,150,34,2,3,1.998847471,7805,35,1,986,982,4,37768,37595,173,278,276,2,1,88.71156092,Arch
c7ab64688f611f599d3b0d07340680e968c7ccf8,2,16,2,14,0,0,0,14,68,155,1,2,0.650022422,2895,15,0,211,208,3,10507,10425,82,182,180,2,1,99.98274771,NoArch
79f6aeb980fe900a33d94e9bb42993f2b2e4e7b1,3,22,3,19,0,0,0,6,95,659,2,3,1.217796812,3016,1,1,107,106,1,10267,10255,12,48,47,1,1,100,NoArch
8f5f251123ee9cc036cada902c4795db3869ffa0,2,112,42,70,0,0,0,54,199,121,1,2,0.887548595,7352,36,2,534,532,2,35036,34622,414,468,464,4,1,99.97123296,NoArch
8da131c08afe67861ced49bc6180a20f66be52fb,3,777,1071,294,0,0,0,10,200,184,1,1,0.518529835,7284,37,3,519,521,2,33190,33888,698,504,506,2,1,100,NoArch
2cde99f7c5627a488e0dbd33ff1acecb56f3aaa2,2,18,3,15,0,0,0,7,15,43,1,2,0.453716339,2001,7,0,137,136,1,9706,9569,137,67,66,1,1,100,NoArch
3cbbafa941128dc5097c2a26711f5751f764e12d,7,11,11,0,0,0,0,16,51,912,1,5,2.55034071,2865,16,1,313,313,0,12584,12562,22,179,179,0,1,100,NoArch
2ac44153c4a521694c4dc975dd37b097184fc998,3,24,5,19,0,0,0,2,5,69,1,2,1.5559472,2129,38,4,316,315,1,11290,11214,76,63,63,0,1,100,NoArch
bfb716aefbb2673eaa3d91a7effdb7cc905546a2,1,90,133,43,0,0,0,5,14,18,1,1,0,306,1775,4,30,25,5,1261,1557,296,27,23,4,0,100,NoArch
ec9947ad8403b6b2d476b3b379f8f52776ebacc4,6,203,4,199,1,0,1,5,21,277,1,2,1.495227943,1848,4,3,267,240,27,10766,9961,805,171,157,14,1,99.98848987,NoArch
2217420fb22a79e3430fde912f0b88650414ae6f,3,58,4,54,0,0,0,13,100,110,1,3,1.313776226,6498,24,1,625,619,6,27893,27511,382,384,382,2,1,100,NoArch
dd9bc946483ce1d41d0552528098ae3a25500fec,1,2,2,0,0,0,0,11,27,199,1,1,0,708,0,0,54,54,0,3570,3570,0,16,16,0,0,100,NoArch
ebc16afa935888578b5befc870c1997f307a6cb5,5,67,67,0,0,0,0,17,62,300,1,4,0.675517202,5344,2,0,408,408,0,30929,30697,232,350,350,0,1,100,NoArch
cd24cae77072e56e4333d10114bf380be79709f1,5,69,16,53,0,0,0,46,101,55,1,4,2.028393436,8200,0,0,942,939,3,37997,37783,214,482,479,3,1,100,NoArch
0d1d4915f6b2ce56a6d4b570d352432f1cb3fe1d,3,237,239,2,0,0,0,4,130,156,1,3,1.37469589,4854,2,0,574,561,13,20927,20652,275,487,479,8,1,100,NoArch
9c5b2d97531d3b2fd8a44d13c0632e381e8c13be,1,29,28,1,0,0,0,1,4,16,1,1,0,695,39,5,156,156,0,3246,3246,0,20,20,0,0,100,NoArch
ff43dcb95caa251e5fc8120980fc70c8fea8ac40,32,175,145,30,0,0,0,3,102,1237,2,4,4.88430765,9771,40,6,796,796,0,37664,37322,342,518,518,0,1,100,NoArch
429c0d0e4cacc76933ae6cc651e5e4164f868383,11,99,59,40,0,0,0,6,193,907,2,5,3.057325776,16374,8,1,1712,1708,4,81417,81351,66,802,801,1,1,100,NoArch
b5ffef1c05bfc35dba349ffe4874de61aa15ae0e,2,15,0,15,0,0,0,47,103,7,1,2,0.996791632,5612,1,0,575,572,3,24460,24381,79,345,344,1,1,100,NoArch
8ba2d8512b8f195bb0866af12308beef2b3eed9f,3,39,3,36,0,0,0,14,26,157,1,3,1.448815636,2007,3,1,267,263,4,10912,10661,251,152,150,2,1,100,NoArch
331e4feef8d6f98b29b331f62c2c109ea3ba7e00,3,13,12,1,0,0,0,30,94,390,1,2,1.224381458,5704,1776,3,787,786,1,29824,29856,32,280,279,1,0,100,NoArch
2a2edbaef2667c9807aa3748be76f217d7b73490,1,65,8,57,0,0,0,11,35,439,1,1,0,933,10,0,58,58,0,3879,3699,180,49,49,0,1,100,NoArch
f9103e6079f75e3d6b3419d01690447ff0a14265,3,218,18,200,0,0,0,54,201,127,1,2,1.360654012,9332,17,2,756,741,15,51103,49590,1513,662,650,12,1,100,NoArch
1745f752561be04ae34d1fa08593c2d3ba4470e8,4,53,50,3,0,0,0,5,131,58,1,4,0.451972371,4596,1777,4,539,539,0,17334,17316,18,468,468,0,1,100,NoArch
d287b0551a189fd1bf1f8a1ae3afb1b446823350,2,10,26,16,0,0,0,1,11,702,1,2,0.918295834,884,41,6,166,168,2,4115,4219,104,28,28,0,1,99.97698107,NoArch
8fd8fcca02240b04b21fa76a8ca8e147dd227ed3,2,75,2,73,0,0,0,47,104,4,1,2,0.990122631,5627,1778,3,583,575,8,24711,24460,251,348,345,3,1,100,NoArch
2c6ccd50ec90e14c1320c8f049a08c4b5de515fa,3,123,16,107,0,0,0,8,28,228,1,3,1.397066929,1048,2,0,105,100,5,6777,5907,870,79,76,3,1,100,NoArch
dfd6a0cdc51b61e88787fcae92839119e868df0e,1,239,215,24,0,0,0,2,7,2259,1,1,0,354,1779,4,40,31,9,1631,1435,196,33,28,5,0,100,NoArch
293059c190d5347438f5bc77a4f844f86ce60226,0,0,0,0,0,0,0,0,0,0,0,0,0,0,1780,5,0,0,0,0,0,0,0,0,0,1,100,NoArch
7273a972e4cc514702f4797bd57ab8af929bc726,0,0,0,0,0,0,0,0,0,0,0,0,0,0,1781,6,0,0,0,0,0,0,0,0,0,1,100,NoArch
8d65a2411f25cca75c1da30b3317b08235161919,2,16,0,16,0,0,0,23,64,183,1,2,0.954434003,2885,3,1,228,226,2,19721,19593,128,205,203,2,1,100,NoArch
76f9847941e737409ea984b750f16aab5f22baf7,2,134,0,134,0,0,0,23,65,226,1,2,0.953048347,3604,18,2,329,314,15,23876,23169,707,230,220,10,1,100,NoArch
93da00b7537527c1457d2f1cdcd3530b61fea207,8,1104,637,467,0,0,0,14,69,307,1,5,1.503906753,5666,19,3,596,549,47,28174,25743,2431,303,286,17,1,92.09194433,Arch
a02155a70a1fe98c8930a0060dc043902ebbd88f,10,55,10,45,0,0,0,3,202,584,4,7,2.705339929,13618,3,0,1142,1138,4,64555,64272,283,814,811,3,1,100,NoArch
08dfd170ae91162ffb082f48c4186952955a73d2,14,62,48,14,0,0,0,2,118,122,1,5,3.270360446,12790,42,5,1781,1781,0,57477,57477,0,472,472,0,0,100,NoArch
1ef2821695ca6e10fbad7b8efe7246c4a20143af,3,19,9,10,0,0,0,6,18,480,1,2,1.442604943,1465,0,0,89,89,0,6416,6385,31,52,52,0,1,100,NoArch
977ea0d96f1f8e4225b6e27f02d86d0ea5aebb9a,6,392,176,216,1,0,1,23,66,357,1,3,2.125413806,5063,43,5,489,481,8,28409,27440,969,314,308,6,1,86.81229773,Arch
e0d869ab8e540dec71b9278f5a3202df4a2dfb5c,10,76,33,43,0,0,0,2,76,148,1,4,2.976009816,7609,25,0,1025,1023,2,37216,37022,194,328,326,2,1,100,NoArch
d3b1d857380972b7ca7fa5b70f9903977054594c,6,56,24,32,0,0,0,10,77,3,1,4,0.94758468,7709,4,0,1037,1031,6,38214,38111,103,287,287,0,1,100,NoArch
ad9058999bdea1329dba2267604512d8e199919f,3,12,11,1,0,0,0,2,78,0,1,2,1.186392934,1667,26,1,209,209,0,9356,9356,0,91,91,0,1,100,NoArch
d51f76c19b4dca8e55d04409ed4af103ac7eca25,4,37,0,37,0,0,0,23,67,918,1,2,1.61657723,3516,4,2,345,340,5,23555,23260,295,249,244,5,1,100,NoArch
464d520148f7106fe580eec9419373276865564e,1,53,0,53,0,0,0,18,47,37,1,1,0,1393,24,0,90,89,1,6952,6681,271,78,77,1,2,100,NoArch
aa98c1575762718b238af8ddd44a390607de7602,0,0,0,0,0,0,0,0,0,0,0,0,0,0,14,0,0,0,0,0,0,0,0,0,0,0,100,NoArch
a5c63c954f91e3502e0eea489fb2f7dab0930aac,1,17,12,5,0,0,0,18,38,41,1,1,0,884,0,0,122,121,1,6132,6122,10,39,38,1,1,100,NoArch
65043f290a7be45a668cf941ab48ee3c30efbe4e,2,32,0,32,0,0,0,48,194,26,1,2,1,10689,9,1,939,935,4,51286,51158,128,518,517,1,1,100,NoArch
2ed1d8891bab4d162ff3e0f3385005fff110e194,0,0,0,0,0,0,0,0,0,0,0,0,0,0,42,0,0,0,0,0,0,0,0,0,0,0,100,NoArch
cae7afbf8e18f839de295ff492cf2cbc4abe1e93,1,9,4,5,0,0,0,7,9,142,1,1,0,114,0,0,8,6,2,608,553,55,3,3,0,1,100,NoArch
4c779b0b89219630869aaacd57716bd54faf71da,3,84,10,74,0,0,0,20,203,99,1,2,1.097076902,11469,27,2,1140,1129,11,60627,60332,295,658,653,5,1,100,NoArch
9dd4e124adb20b4d073afb6902ac4bb3bfc3ed09,2,120,5,115,0,0,0,9,27,150,1,2,0.614822757,1383,11,1,151,142,9,9116,8346,770,43,39,4,1,100,NoArch
b2daea58fd3ca8b1e7bb8ee503078ff7b10e59d5,2,34,10,24,0,0,0,47,105,35,1,2,0.998509099,4478,1,0,316,315,1,17751,17667,84,287,286,1,1,100,NoArch
01043b1d97fbba4c9d23b45f5aca7a19e1086765,3,212,17,195,0,0,0,5,17,659,1,2,1.345856883,1118,5,0,189,155,34,6476,5509,967,108,93,15,1,89.91112413,Arch
e2c8e68f4ac31498a9a41fb45ead2f64f04b1c36,8,35,33,2,0,0,0,11,100,510,1,5,2.271577727,10635,25,0,1364,1363,1,48986,49000,14,435,434,1,1,100,NoArch
4bc45cd12ca53ce902e03de45f144a0ac938fbae,2,75,32,43,0,0,0,8,17,194,1,2,0.994890537,744,20,2,54,52,2,4389,4115,274,36,35,1,1,99.946277,NoArch
4e70e7f3e44832667c2e82e371d6539a68d029fa,2,21,1,20,0,0,0,47,106,6,1,2,0.945660305,4502,2,0,322,316,6,17793,17751,42,287,287,0,1,100,NoArch
4299007f7baff9dbff3c959535f6476c48f924a0,5,76,35,41,0,0,0,7,195,454,1,4,1.247130722,10130,6,1,916,914,2,43559,43380,179,452,450,2,1,100,NoArch
be5238492285ca061d4ddd82262448d3a6cedc5d,15,354,95,259,0,0,0,8,83,2141,2,5,3.377452249,13212,7,2,1271,1241,30,73044,71667,1377,909,883,26,1,100,NoArch
9c04f8733ec8723e641f39a0f036f485d681bec5,2,24,10,14,0,0,0,46,151,63,1,2,0.997502546,9458,44,2,1213,1213,0,42142,42139,3,622,621,1,1,100,NoArch
be571b5ae723cf8699094558a3034e7c22ed9abb,4,92,39,53,0,0,0,49,196,180,1,4,0.769839279,11090,10,1,1195,1190,5,49029,48832,197,748,747,1,1,100,NoArch
2ab44bff3a086acae7b38dcff264060544860147,2,47,33,14,0,0,0,8,23,5,1,2,0.69621226,1289,5,1,140,142,2,6843,6710,133,62,61,1,2,100,NoArch
08c83afb16ba8dde3082735edf693d6914716ada,1,6,0,6,0,0,0,32,73,0,1,1,0,2771,25,1,644,643,1,14408,14381,27,355,354,1,1,100,NoArch
e6f91d2e92acbc8dccd375b777b71265677dea16,5,318,2,316,1,0,1,2,76,530,2,3,1.298947601,3692,0,0,568,551,17,19774,18159,1615,297,285,12,1,100,NoArch
f90e5d7b48848191c1a70e6c0f78eece93433806,4,16,7,9,0,0,0,24,68,23,1,4,1.453850698,5322,6,2,530,529,1,30371,30344,27,299,298,1,1,100,NoArch
6ee48c66c8a51bfd9734b20927e4c2e919575bc4,1,1,1,0,0,0,0,18,58,37,1,1,0,2057,0,0,298,298,0,11042,11042,0,90,90,0,1,100,NoArch
4d1c3e54fc4172c7ff00db3326823c42f237cf04,2,9,5,4,0,0,0,20,52,861,1,2,0.863120569,2422,0,0,253,253,0,9053,9034,19,92,92,0,1,100,NoArch
ed5cfb0bee5b548ae385e936fd222e6075d3fb6a,0,0,0,0,0,0,0,0,0,0,0,0,0,0,15,1,0,0,0,0,0,0,0,0,0,0,100,NoArch
da2b2efa437d0d7d33f99797ffa1f566781f9fa8,2,25,0,25,0,0,0,55,170,1799,1,2,0.634309555,11272,2,0,532,530,2,45286,45041,245,481,479,2,1,100,NoArch
52bc246d5e07510689635f407f4d9dc494b0af4d,49,2323,102,2221,13,0,13,4,152,427,2,19,4.482306742,40822,45,2,4946,4762,184,196644,187848,8796,2013,1900,113,1,87.58642363,Arch
dc34cd0ee7ed704a97242c0153c11d46b21c7b9a,6,206,13,193,1,0,1,1,101,300,1,4,1.896042346,4015,168,0,383,346,37,25441,24350,1091,169,164,5,0,99.9876161,NoArch
fab877bb447a9949fac37b0661acf61ab9f7c6fb,4,15,22,7,0,0,0,1,102,11,1,2,1.434032164,4019,169,1,361,358,3,24127,24099,28,209,209,0,0,100,NoArch
3853118b4d1d48f7d3970b5488baf7ca78d5028e,3,33,12,21,0,0,0,14,70,171,1,3,1.48654941,6722,21,1,732,732,0,27281,27173,108,409,408,1,2,100,NoArch
9c7c3ecaa604b68af4522def10365de1f1bbd2fa,0,0,0,0,0,0,0,0,0,0,0,0,0,0,0,0,0,0,0,0,0,0,0,0,0,0,100,NoArch
47b70d2d8b5d6f44b104a9b372ed848273729f9f,1,0,1,1,0,0,0,4,5,693,1,1,0,325,43,1,42,42,0,1537,1542,5,11,11,0,1,100,NoArch
e6b2df13aa195b63798994019378aa19e8c6e096,2,20,33,13,0,0,0,6,14,317,1,1,0.313812964,751,170,2,64,65,1,3782,3837,55,45,45,0,0,99.9814276,NoArch
ac5ed010e9ba71379a8fa5de41c875de23244419,1,3,0,3,0,0,0,3,3,777,1,1,0,206,171,3,20,20,0,1168,1151,17,12,12,0,0,100,NoArch
472523c4e0eb694f62c1da974d256553e2f33ce2,1,5,2,3,0,0,0,4,11,777,1,1,0,139,172,4,12,10,2,717,684,33,7,7,0,0,100,NoArch
73417080f317fb925cf3978d40af6ba97129e3c8,1,4,0,4,0,0,0,21,62,17,1,1,0,2049,7,2,283,282,1,9131,9116,15,74,74,0,1,100,NoArch
5999578ee833e2d77a635eb2c9b8a63e56cc6f21,1,31,15,16,0,0,0,3,3,559,1,1,0,203,173,5,35,29,6,1345,1269,76,6,5,1,0,100,NoArch
1667c0df5e46d9d6c393c4f855a304e4d1cfa2de,3,74,5,69,0,0,0,5,22,46,1,2,0.763412385,1727,8,3,271,258,13,9239,8964,275,147,137,10,1,100,NoArch
956905b71a6b0178ddb796549b578c3c82e6a223,0,0,0,0,0,0,0,0,0,0,0,0,0,0,1,1,0,0,0,0,0,0,0,0,0,0,100,NoArch
17d0684445b5ce4224e09728d4fd89cf41004d19,2,41,4,37,0,0,0,49,197,20,1,2,0.956457405,10536,11,1,1141,1135,6,46872,46759,113,734,731,3,1,100,NoArch
301bbe9e132346f60587e8c21c474f7c51b236c3,1,2,65,63,0,0,0,21,63,3,1,1,0,2053,8,3,274,283,9,8927,9131,204,73,74,1,1,100,NoArch
ce0118b4149eb303813d0af2537a7185e9945115,3,109,2,107,0,0,0,48,129,40,1,3,1.500260239,14978,46,2,1025,1016,9,60618,60107,511,825,822,3,1,100,NoArch
08bde847c8b0749c7686e66751b4d248cd7c5cb5,1,2,0,2,0,0,0,4,12,14,1,1,0,474,174,6,90,90,0,2726,2716,10,17,17,0,1,100,NoArch
94e6272d57478a5913cb51e7df5c25e67511229a,1,1124,0,1124,1,0,1,1,1,0,1,1,0,0,175,7,193,0,193,4665,0,4665,84,0,84,1,99.97524293,NoArch
66c9cd5e1c88ebe834e6f0f299cfb1e1dffa4296,19,37,83,46,1,1,2,5,38,547,6,12,3.187658604,4449,176,8,581,583,2,22730,22886,156,249,251,2,1,99.93192648,NoArch
33711cae07f0771ac0ad993b72ad3a27bfa4c718,0,0,0,0,0,0,0,0,0,0,0,0,0,0,177,9,0,0,0,0,0,0,0,0,0,1,100,NoArch
080423bc5c1396676f718db65b2ada36eaa70dbc,2,42,7,35,1,0,1,1,9,68,1,2,0.642064289,189,178,10,24,23,1,1088,1046,42,11,10,1,1,99.96286439,NoArch
8a9cb376ad210277b84453cca4a505c7058a2fa6,8,0,0,0,0,0,0,1,1,0,1,2,0,1281,179,11,84,84,0,5636,5636,0,51,51,0,1,99.80183304,NoArch
27055fbc674b22d5d2307c2488b31996c2113485,6,39,24,15,0,0,0,7,98,499,2,3,2.121595577,9313,180,12,526,524,2,32053,31906,147,489,487,2,1,100,NoArch
1ef6a0614cbb048d0c98e46b24662c56688f137f,0,0,0,0,0,0,0,0,0,0,0,0,0,0,181,13,0,0,0,0,0,0,0,0,0,1,100,NoArch
f2b437a337498ac6daece994645f0998f41aea26,0,0,0,0,0,0,0,0,0,0,0,0,0,0,182,14,0,0,0,0,0,0,0,0,0,1,100,NoArch
c7c8ab17c3f4785f81dc02184034ebeb5e1d4ae1,87,0,259,259,0,0,0,1,7,4359,17,86,6.437965333,3273,183,15,0,0,0,915,2195,1280,0,0,0,1,99.94423446,NoArch
000053b23fb43ad03a49ad1d1d22071265202ca5,0,0,0,0,0,0,0,0,0,0,0,0,0,0,184,16,0,0,0,0,0,0,0,0,0,1,100,NoArch
c23abbe90e6142cac9cc93d1a54e4dd30bab0a93,0,0,0,0,0,0,0,0,0,0,0,0,0,0,185,17,0,0,0,0,0,0,0,0,0,0,100,NoArch
0aab80cf5e1af8615acae2dac92943776839ddaf,3,144,126,18,0,0,0,3,153,7,1,3,0.381056462,6602,0,0,864,860,4,32736,32695,41,244,242,2,1,100,NoArch
69a4c12746c42942b8155784c5f3b1658fc8a552,0,0,0,0,0,0,0,0,0,0,0,0,0,0,186,18,0,0,0,0,0,0,0,0,0,0,100,NoArch
472be64cfed80edb7869e4608794f167735dc70b,0,0,0,0,0,0,0,0,0,0,0,0,0,0,187,19,0,0,0,0,0,0,0,0,0,0,100,NoArch
c6cd087e13eb1ac9c4f6f16e02f53485df55aed9,0,0,0,0,0,0,0,0,0,0,0,0,0,0,26,0,0,0,0,0,0,0,0,0,0,0,100,NoArch
1badb69dfe7332a66ec12bb21024e81b3072d691,1,1,1,0,0,0,0,26,76,306,1,1,0,2682,27,1,464,464,0,11658,11660,2,175,175,0,1,100,NoArch
7a2ca26ea2e28ef9d29d01ccb35794142f59eafd,0,0,0,0,0,0,0,0,0,0,0,0,0,0,188,20,0,0,0,0,0,0,0,0,0,0,100,NoArch
935fb66fd8f5a47b2ca6e6e4709fbd95a2a8449a,5,193,72,121,0,0,0,3,154,10,1,4,2.037036094,7917,47,3,1053,1040,13,38526,38241,285,311,308,3,1,100,NoArch
cacc82ce99258abee0fad636d800814a6dcb1b77,4,162,1,161,0,0,0,48,108,189,1,3,1.502421509,7069,1,0,753,742,11,33758,32816,942,413,410,3,1,100,NoArch
620ca17d4e283d58b3ab4c573b911702fd4127c7,2,22,6,16,0,0,0,9,29,168,1,2,0.591672779,1682,12,2,168,165,3,8520,8421,99,99,98,1,1,100,NoArch
cba623512f675001dd07d1b4a22fad202a053394,3,88,22,66,0,0,0,3,5,4,1,3,0.435021896,807,1,1,83,76,7,4316,4001,315,54,48,6,1,100,NoArch
f2f25b3a567ee7ec1c6e8f9f00f581b2dacc3dae,1,2,8,6,0,0,0,2,2,1165,1,1,0,85,189,21,5,5,0,340,362,22,2,2,0,0,100,NoArch
a3c8a1b3c70f3aee0fbfe7de0997743d997877bd,18,222,8,214,0,0,0,24,69,326,1,2,3.398025023,8297,5,0,1053,1024,29,50125,48605,1520,523,495,28,1,100,NoArch
ed4c3cc338f5144360bbc053218c44d23e84bab0,4,24,6,18,0,0,0,55,204,217,1,4,1.689482267,10195,48,3,1032,1030,2,45116,45066,50,691,690,1,1,100,NoArch
07c1efbb2b42a0e27f9d01968d357d9c1e17cd51,8,168,94,74,1,0,1,5,18,92,1,2,2.307781747,1310,49,4,177,173,4,6194,6019,175,78,75,3,1,99.92573338,NoArch
6ad3f9a97b2c68ad9b08e9f6099ce9c5e1fd9a80,6,92,29,63,0,0,0,3,117,474,2,6,1.776363683,10991,29,0,578,574,4,45637,45430,207,363,362,1,2,100,NoArch
eb71946c843b3dc9618a2c128dcaa9bf52afe9c7,14,237,258,21,0,1,1,3,118,211,2,9,3.22261264,24316,30,1,1481,1477,4,116812,116868,56,1104,1089,15,1,99.96290113,NoArch
33157f42f9ec7779b53b807db7b5066c1314fb6e,17,463,308,155,1,0,1,9,93,345,1,8,2.323305003,13138,13,2,1972,1960,12,74222,73708,514,817,809,8,1,95.07901303,Arch
a2ad38359380a196a987d28f9ec378006e86fa08,1,5,2,3,0,0,0,5,9,1,1,1,0,412,28,2,20,20,0,1134,1103,31,8,8,0,1,100,NoArch
ca27fe99b5d1367c2d7ceb20a02ad80c6a2fce63,3,76,17,59,0,0,0,13,28,191,2,3,0.587173384,4514,26,0,535,525,10,23007,22586,421,250,243,7,1,100,NoArch
bb18888c43a3943f5c1265bab5d87830633c465b,3,129,8,121,0,0,0,56,205,198,1,3,1.484217126,10547,2,1,1043,1033,10,50526,49600,926,619,617,2,1,99.97635188,NoArch
ab136b5f76a4cb951e847fcba6b414c5e80dbbe6,2,15,5,10,0,0,0,21,104,43,1,2,0.934068055,5185,18,0,680,679,1,30833,30745,88,203,202,1,1,100,NoArch
7f4899bff3f07566d2039fcf437bb7cfe3659fda,0,0,0,0,0,0,0,0,0,0,0,0,0,0,190,2,0,0,0,0,0,0,0,0,0,0,100,NoArch
f063c40a73566e2cdfe0e1b734e409735c26db2b,0,0,0,0,0,0,0,0,0,0,0,0,0,0,191,3,0,0,0,0,0,0,0,0,0,0,100,NoArch
c92e34949d5396badbaaa10c691483a62cf70024,0,0,0,0,0,0,0,0,0,0,0,0,0,0,192,4,0,0,0,0,0,0,0,0,0,1,100,NoArch
60d27ee3162acead99f2510e36d7591add78e5a6,177,812,793,19,0,0,0,3,206,836,15,41,6.988876137,130252,193,5,9086,9086,0,634566,632701,1865,6926,6926,0,1,100,NoArch
963ab743866ee5f934f65d9c8b3ef2bcb27911bc,17,183,281,98,0,0,0,3,106,0,4,9,3.061984555,13305,194,6,1198,1198,0,79523,79220,303,683,683,0,1,100,NoArch
8f404f19a38b854fcdcfe688cf69cec15feda912,2,0,10,10,0,0,0,7,13,0,2,1,1,569,195,7,28,28,0,3408,3464,56,20,20,0,1,100,NoArch
a180359daca5aa9830a4a220bb8a514e7f0abb1a,8,53,115,62,0,0,0,2,55,405,4,4,2.861294896,3071,196,8,211,218,7,11625,11895,270,145,151,6,1,100,NoArch
e89784c270cab5eafeab839bfd3d4cbea816607f,19,162,427,265,2,3,5,3,172,175,5,8,3.145650244,37560,197,9,2119,2126,7,162693,164031,1338,1654,1655,1,1,99.85018136,NoArch
ed181a4671b9941f2852c581daa043d8a2d6dec2,10,166,36,130,0,0,0,6,73,917,1,7,1.762127657,6484,9,0,673,658,15,38102,37549,553,513,500,13,1,100,NoArch
abe7729fb1d6e9b9cfbe4cf498806f67991b618e,2,31,5,26,0,0,0,55,173,32,1,2,0.811278124,11567,19,1,567,564,3,46825,46652,173,488,488,0,1,100,NoArch
0e16fe375f797e498c0039fc7cffecfd0dc9bc3d,2,62,2,60,1,0,1,1,94,10,1,2,0.337290067,3025,0,0,452,451,1,19331,19158,173,146,145,1,1,99.98422962,NoArch
ecc68aca85f756bb2b29b56dba4322c342f5d693,8,0,0,0,0,0,0,1,1,0,1,2,0,1278,3,0,84,84,0,5621,5621,0,51,51,0,1,99.74771365,NoArch
a0931b784c60683eb6845b3087d79f33160fc868,7,120,20,100,0,0,0,14,84,594,2,5,2.289424237,5579,22,0,565,562,3,32035,31473,562,275,272,3,1,99.99211605,NoArch
11d7916e46509ef7bb0c0632667ec61f5c1008b1,2,23,0,23,0,0,0,16,73,54,1,2,0.755375413,5560,20,2,549,547,2,24048,23956,92,246,245,1,1,100,NoArch
560d8951279fddb305626fd3d188b88fbf88b1f9,2,107,54,53,0,0,0,49,199,160,1,2,0.652420517,8486,10,1,545,539,6,35270,35100,170,405,398,7,1,100,NoArch
0aaf4f628ba145ed7299701ae20f0e723fd37142,2,82,0,82,0,0,0,3,3,150,1,2,0.801469893,573,6,1,47,41,6,3243,2881,362,24,22,2,1,100,NoArch
f1e51e6c310b68d399b360ff374ffc6d46fefdba,3,127,1,126,1,0,1,6,19,49,1,2,1.178609898,545,11,2,78,63,15,3142,2586,556,65,60,5,1,99.98423459,NoArch
67ed322370472dc4403eed485d0b61fe5a40f84f,2,154,96,58,0,0,0,7,17,148,1,2,0.912869919,1957,12,0,141,133,8,9477,9347,130,67,59,8,1,100,NoArch
691108662e61c9561ca1f2372dd7b28e1b8846a7,1,0,16,16,0,1,1,1,2,47,1,1,0,16,198,9,0,0,0,0,0,0,0,0,0,0,99.98423459,NoArch
170bb9bbeb83a412461fb084bf727de8f67b268f,1,135,28,107,0,0,0,14,30,1,1,1,0,3978,27,1,512,493,19,19917,19449,468,218,216,2,1,100,NoArch
3559b3bc0491608d8c5ca9d55b57736df29ae369,5,240,92,148,0,0,0,14,85,79,2,4,1.874904303,5095,28,2,536,530,6,29307,28333,974,235,233,2,1,100,NoArch
ccdc169080a7f68066c317db67729b7df81662f6,12,726,477,249,4,1,5,21,120,118,1,5,2.329490559,13106,50,2,1740,1732,8,65019,64513,506,503,496,7,1,99.90543735,NoArch
9e80eb6ed90b3f053cdbae2431e96dc09cf81211,5,140,28,112,0,0,0,4,16,881,3,4,1.688246582,1115,44,0,207,190,17,6518,5933,585,89,74,15,1,100,NoArch
ff44204dc2899e0c34e94f70c2e0c301170daca3,10,103,11,92,0,0,0,5,28,115,2,8,2.801192968,4347,12,3,573,561,12,23272,22754,518,268,262,6,1,100,NoArch
1268950211c8b1ff3888919b704fddfee58887cd,3,28,7,21,0,0,0,9,29,133,1,2,1.243180398,1800,13,1,175,173,2,11183,11066,117,51,50,1,1,100,NoArch
3a5234b14af3503fc1ec17836383264cbb77cb86,3,38,0,38,0,0,0,49,110,55,1,2,1.402993418,4895,7,2,361,355,6,19609,19437,172,308,302,6,1,100,NoArch
3f340bf9642b19e34be384a4f2b53f8cd4940a67,2,36,11,25,0,0,0,19,50,66,1,2,0.999673426,1858,0,0,135,133,2,9385,9213,172,108,106,2,1,100,NoArch
c0f63cca9c24953a50cb53c2f5c00d7a0b65585c,0,0,0,0,0,0,0,0,0,0,0,0,0,0,31,2,0,0,0,0,0,0,0,0,0,0,100,NoArch
1a3cb8c369b8bf0f7b42043609f60bc00717fad2,0,0,0,0,0,0,0,0,0,0,0,0,0,0,32,3,0,0,0,0,0,0,0,0,0,0,100,NoArch
d934d121077f271331810827ce9cf7ccb5d4768e,3,69,0,69,0,0,0,49,200,146,1,2,0.959340508,8474,14,1,614,606,8,36167,35899,268,404,401,3,1,100,NoArch
4f70978983d664629bb74abf5ac8826ff765ee6c,2,29,10,19,0,0,0,3,13,39,1,1,0.477071306,237,33,4,18,15,3,1865,1769,96,8,5,3,1,100,NoArch
abb4fef8eda2d26cc14f787c5393caac75a35efb,3,10,18,8,0,0,0,3,201,75,1,3,1.413799565,8421,29,1,544,544,0,34897,34936,39,400,400,0,1,100,NoArch
0fd7628438164f538aa91d24c87000e1dc86434b,0,0,0,0,0,0,0,0,0,0,0,0,0,0,4,1,0,0,0,0,0,0,0,0,0,0,100,NoArch
db36758c0c9bfaae5aada3da169d09a5270a8d53,3,18,10,8,0,0,0,3,202,0,1,3,1.413799565,8413,30,2,544,544,0,34936,34897,39,400,400,0,1,100,NoArch
50cfaec7c0e80eeee38caade997b7d473680cb9a,4,98,4,94,0,0,0,50,111,38,1,2,1.840719508,7072,13,4,736,728,8,33752,33217,535,408,402,6,1,100,NoArch
25a2e5a2df6ada03b36102dc5d46f115c8de2547,1,3,3,0,0,0,0,13,47,110,1,1,0,2819,0,0,309,309,0,13258,13258,0,92,92,0,0,100,NoArch
74d027545059d0f6f0813253c87a2fb7cb12c4a6,9,273,156,117,0,0,0,3,155,57,1,5,2.069351999,15047,51,1,1916,1905,11,73881,73429,452,594,587,7,1,100,NoArch
fd92642d8a0b08ed0b1b4ccefd0de58d6239dd03,2,75,0,75,0,0,0,50,112,26,1,2,0.872988294,4725,5,2,347,329,18,19069,18669,400,298,294,4,1,100,NoArch
d951844c464d41fe435977f12df975352d71226f,2,88,2,86,0,0,0,2,14,19,1,2,0.394300238,711,15,1,115,112,3,4130,3625,505,24,23,1,1,100,NoArch
a4d04a35a9aca3ac1f464c231b998cd2808a4b01,9,80,86,6,0,0,0,5,203,193,3,6,2.494191386,15477,29,3,989,994,5,59876,59923,47,818,818,0,1,100,NoArch
073abbe3028395c210dc98241adf80dd553dab83,2,132,0,132,0,0,0,25,95,87,1,2,0.786368018,5906,34,3,594,583,11,32482,31815,667,361,353,8,1,100,NoArch
bf40ad33e7ee85ff426ddc493fe6d9a5bfe6a208,2,29,6,23,0,0,0,46,156,13,1,2,0.775512658,9542,21,3,1228,1224,4,42791,42606,185,625,624,1,1,100,NoArch
28d5f6f4ad770cd505ba0e5506b7559879600b4e,2,2,7,5,0,0,0,17,75,172,1,2,0.918295834,3212,30,3,247,246,1,11650,11648,2,201,201,0,1,100,NoArch
8e9261dc14f1e50563b259dcdb42cd4415065078,1,4,0,4,0,0,0,3,5,1132,1,1,0,92,22,4,11,10,1,223,207,16,8,7,1,1,100,NoArch
ca1bb5e5e87e86c68bbbfcadea0da2184efde9bf,0,0,0,0,0,0,0,0,0,0,0,0,0,0,199,9,0,0,0,0,0,0,0,0,0,0,100,NoArch
9512d73d6652cf663a554ad1636b8f7058e36bab,0,0,0,0,0,0,0,0,0,0,0,0,0,0,200,10,0,0,0,0,0,0,0,0,0,1,100,NoArch
41b9c96a4409f505bae5b17a7c46204b367935a9,17,64,48,16,1,0,1,1,60,664,6,13,3.7374742,7967,201,11,1185,1185,0,40937,40936,1,362,362,0,1,99.98424949,NoArch
571731b80a58eb095ebac7123285c375e7afff90,1961,355,4631,4276,0,0,0,2,207,916,18,132,10.11538825,498154,202,12,50411,50411,0,2195185,2195185,0,25142,25142,0,1,100,NoArch
753ce4ad35b95cc91ad62f96b2bf3ce743f66d1c,9,26,22,4,0,0,0,8,33,0,3,8,3.120781773,7574,203,13,890,890,0,39067,39077,10,258,258,0,1,100,NoArch
52a57078ba081b24b9d086ed363c715485d1a519,4,5,5,0,0,0,0,19,205,0,1,2,1.921928095,11025,204,14,714,714,0,49030,49030,0,548,548,0,1,100,NoArch
0d6bec4140da46af07d58cf07a5e682d61529603,9,30,212,182,0,1,1,1,175,0,1,4,1.973965414,16405,205,15,854,865,11,75415,75811,396,694,705,11,0,99.89761361,NoArch
cce23fa81068b3a03da51d6d42600124f0335f46,31,0,197,197,0,0,0,12,206,0,1,10,4.78780544,59970,206,16,4193,4210,17,267401,267563,162,3013,3030,17,0,100,NoArch
b93ec5a9edb7459696385e6adad67b92b6d406d7,1,0,248,248,0,1,1,5,10,2,1,1,0,248,207,17,0,16,16,0,753,753,0,16,16,0,99.63364253,NoArch
75ac5f705110dbfa1f299043f9858974468fdbae,0,0,0,0,0,0,0,0,0,0,0,0,0,0,1,1,0,0,0,0,0,0,0,0,0,0,100,NoArch
1ddc1c3a0c6185c31bdf5fadde81ce6316b86fd9,9,213,0,213,2,0,2,1,123,0,1,6,2.325638662,14673,1,0,1054,1036,18,75518,74421,1097,504,496,8,1,99.96144653,NoArch
2e23e2616a2567844100d79d974a0f79680bec73,1,1,2,1,0,0,0,2,2,0,1,1,0,76,6,3,5,5,0,363,363,0,4,4,0,1,100,NoArch
5f112a42a1aa62442a9e9306ac4700ed2152ac12,2,0,4,4,0,0,0,3,3,0,1,2,1,143,208,18,12,12,0,691,691,0,6,6,0,0,100,NoArch
0c7c1ec088497c4d21d402ffa2eb6219d777dd73,14,294,132,162,1,1,2,3,158,0,1,8,3.069019534,16099,2,0,2071,2062,9,77833,77434,399,672,668,4,2,99.96917386,NoArch
39e1805e62aac35be454acd3add3b86db777a9bf,2,52,7,45,0,0,0,48,134,10,1,2,0.95285881,9180,52,2,517,518,1,37888,37756,132,456,455,1,1,100,NoArch
a289a75830ff864137777bb809f76fd291902142,0,0,0,0,0,0,0,0,0,0,0,0,0,0,16,0,0,0,0,0,0,0,0,0,0,0,100,NoArch
d616a080af2b86feeb3a0b526bb59bef94f94523,2,130,4,126,0,0,0,6,106,7,1,2,0.780345609,4790,53,3,610,608,2,24400,23645,755,184,183,1,1,100,NoArch
f3020bc59be668b36a131361b486b45064b16f50,4,28,1,27,0,0,0,51,114,12,1,2,1.634295881,5068,0,0,385,382,3,20620,20527,93,319,316,3,1,100,NoArch
edc386d960b12642cdca40abb692beab6f75ce72,1,3,3,0,0,0,0,4,16,15,1,1,0,797,14,1,98,98,0,3006,2987,19,23,23,0,1,100,NoArch
a9b23c736b357a5ea796ff148c221f8120ebb975,4,6,11,5,0,0,0,3,124,12,1,3,1.903967813,10263,2,1,520,520,0,44865,44882,17,319,319,0,1,100,NoArch
4d4afc6edcee93cbe2d15a82e0b2b947ff5b22a2,0,0,0,0,0,0,0,0,0,0,0,0,0,0,209,10,0,0,0,0,0,0,0,0,0,0,100,NoArch
c4d18de778713850f7d00f2ed418dca6922a0bff,4,169,2,167,0,0,0,55,177,24,1,3,1.308240275,21612,23,2,2081,2056,25,92723,91975,748,1186,1175,11,1,100,NoArch
b808886328e99737471e7d1ed2702127e5969461,5,64,30,34,0,0,0,55,178,9,1,5,1.787714358,32944,54,3,2928,2929,1,144534,144479,55,1394,1393,1,1,100,NoArch
1f3b7105fcc5cca45e5cdbb73d59fb51c410d08f,11,68,97,29,0,0,0,6,110,21,3,6,2.915187223,15338,4,0,1847,1846,1,74723,74794,71,686,685,1,1,100,NoArch
a69d24951794f6d3ff67f40b0d117fd0df9a919b,1,2,2,0,0,0,0,18,77,29,1,1,0,2951,28,0,197,197,0,10104,10104,0,188,188,0,1,100,NoArch
5f10de3cd042120d18cb5f3ea7749243d537332d,0,0,0,0,0,0,0,0,0,0,0,0,0,0,210,11,0,0,0,0,0,0,0,0,0,1,100,NoArch
e50f5338fbd1779f0cb41ce66a8f6a8c8f6c3034,3,22,22,0,0,0,0,5,20,23,1,2,1.362792995,975,10,0,59,59,0,3587,3546,41,47,47,0,1,100,NoArch
4415171f52cd31f310bb06604a5781d92ad2105d,8,46,45,1,0,0,0,4,20,32,1,1,2.984063905,2206,11,1,107,107,0,9843,9701,142,76,76,0,1,100,NoArch
1afe1e44fe45045608c04255c0f745f2f9ab0c0f,5,31,27,4,0,0,0,6,8,35,1,1,2.063663614,1278,12,2,96,96,0,5058,4949,109,83,83,0,1,100,NoArch
a52bedeb410824f6dc36b3d668dc194bb0055350,4,52,12,40,0,0,0,3,136,26,1,3,1.417759836,11155,55,3,762,756,6,47139,46943,196,564,563,1,1,100,NoArch
5d6e57d6efc5ff44f0705a348812f89fa5b237f0,6,95,14,81,0,0,0,3,13,24,1,4,2.143255654,1194,3,1,105,100,5,6067,5625,442,76,71,5,1,100,NoArch
673ac49285df0d4e26879c63425950d95596d363,2,24,1,23,0,0,0,51,207,36,1,2,0.40217919,8195,0,0,528,527,1,34556,34498,58,392,391,1,1,100,NoArch
e7fc6977341d0166f110de4218313648de81b336,8,62,8,54,0,0,0,46,125,30,1,7,2.357555894,20099,0,0,1769,1763,6,91373,91107,266,882,880,2,1,100,NoArch
b06fd4094d35c7f61c8e4cb63ce6fc682398d2c7,5,36,6,30,0,0,0,47,138,30,1,4,2.000823899,6201,8,0,784,781,3,27546,27323,223,562,559,3,1,100,NoArch
e7d3f545c34efaaaac4f1e9120ca9227fd557cb6,8,113,0,113,0,0,0,3,126,14,1,6,2.304753139,14600,3,2,1037,1027,10,75037,74328,709,490,485,5,1,100,NoArch
34af9ec1f6066d78a9d8534d8c2531724ac6b127,1,7,6,1,0,0,0,16,53,37,1,1,0,1147,24,2,133,133,0,5484,5470,14,48,48,0,1,100,NoArch
8f35d3af725a9306e70b8ae4beda89a749b13bf5,0,0,0,0,0,0,0,0,0,0,0,0,0,0,211,6,0,0,0,0,0,0,0,0,0,1,100,NoArch
2daa185832f983d11a763d5bbc10454d4c56d7ac,1,1,0,1,0,0,0,5,12,42,1,1,0,229,212,7,16,16,0,791,791,0,14,14,0,1,100,NoArch
0341e97835200e1d2d7cc582ded98d3aaa829c01,3,91,95,4,0,1,1,3,10,42,1,1,0.930603079,561,13,3,61,60,1,3253,3046,207,43,42,1,1,99.96146732,NoArch
8768a235feccd8125108900e386b51f4b33d5372,1,8,6,2,0,0,0,3,8,44,1,1,0,237,213,5,20,20,0,1159,1127,32,10,10,0,1,100,NoArch
5ddded14bf510edec83c007a3bad89cda9ff2935,2,54,1,53,0,0,0,19,78,10,1,2,0.994030211,5009,9,1,500,494,6,21465,21217,248,282,278,4,1,91.93746706,Arch
87f8e34dcedd806a6ef64117caebb5a55f99e3d2,0,0,0,0,0,0,0,0,0,0,0,0,0,0,214,5,0,0,0,0,0,0,0,0,0,1,100,NoArch
fe0a2fe7dde4a4a342cfc50f2f9da983cc60c479,3,27,1,26,0,0,0,16,44,38,1,3,1.332918761,2966,0,0,318,314,4,16002,15828,174,174,173,1,1,100,NoArch
9f29f4628314f38b4719254c5fc9e60e76ae1ae7,5,192,14,178,0,0,0,6,208,34,2,4,1.537094492,12341,16,0,1228,1199,29,60027,58952,1075,605,598,7,1,99.96937838,NoArch
a54cb0a587c32e002ba21b8dba2ceab24cade087,8,220,39,181,0,0,0,3,108,35,1,5,1.871485966,12238,56,4,1558,1540,18,60010,59346,664,608,600,8,1,100,NoArch
9d3862cb1c95f7919e68393a3a6bdf46b3e2f8f0,1,4,1,3,0,0,0,5,13,50,1,1,0,158,215,6,14,14,0,873,844,29,6,6,0,1,100,NoArch
7dcceeedbc9bb28167f3b7497a8eee1429bc51f6,3,165,45,120,0,0,0,25,75,57,1,2,1.383638187,3783,216,7,373,363,10,25707,24868,839,260,247,13,1,100,NoArch
3dd6d850adc6a0d7b14bedac0e431047c63beb3c,2,14,3,11,0,0,0,51,115,26,1,2,0.787126586,5489,15,0,426,425,1,24208,24181,27,328,327,1,1,100,NoArch
06ac187a342f82a4b69e4c752ccdce0c269a350d,9,51,38,13,0,0,0,4,21,22,1,1,2.809213338,2381,217,8,113,115,2,11700,11568,132,82,84,2,1,100,NoArch
bfc0005d0bbaa6a01a3c5810259b97905b563b55,2,40,1,39,0,0,0,8,24,58,1,2,0.759275785,2290,218,9,226,221,5,15069,14856,213,135,133,2,0,100,NoArch
5e4d3967fc2f1c14ccf59c521054cfd4fe1e5b54,14,322,82,240,0,0,0,19,209,35,1,7,3.248512328,41415,57,3,3783,3766,17,178235,177333,902,2161,2157,4,1,100,NoArch
8658804e0a1b5c2fe9c78fa8e40655db06531ac8,1,44,18,26,0,0,0,4,17,48,1,1,0,797,1782,0,105,98,7,3189,3006,183,27,23,4,0,100,NoArch
4e7f92557a240de58cd950dce6ab478c1bc11604,0,0,0,0,0,0,0,0,0,0,0,0,0,0,1783,1,0,0,0,0,0,0,0,0,0,0,100,NoArch
8a49c9fda80c6d81721f0cf1044c83feed57f589,0,0,0,0,0,0,0,0,0,0,0,0,0,0,2,0,0,0,0,0,0,0,0,0,0,0,100,NoArch
61da868ea50fa9fd1584eaafd3fcb0c644e9c953,1,27,56,29,0,0,0,2,3,64,1,1,0,1122,1784,2,189,193,4,4567,4665,98,84,84,0,0,100,NoArch
68eacfc57da7492377797e39ee3e2778be1b1aa4,9,73,77,4,0,0,0,5,140,34,3,8,2.182371831,19635,1785,3,1631,1631,0,88740,88745,5,1093,1093,0,0,100,NoArch
e88809e7288db9b7d33be8a67840e02a71327675,2,819,0,819,2,0,2,1,1,0,1,2,0.997623099,0,1786,4,73,0,73,4440,0,4440,16,0,16,1,99.9489848,NoArch
c416c31fc376868bdd672afd84ec06dc75d56575,26,1811,791,1020,1,0,1,5,137,42,5,12,2.677238064,31142,1787,5,2133,2014,119,130874,126887,3987,1328,1281,47,2,88.63355135,Arch
963a266d7b3859d141964217f4d16cae350b10e1,1,30,0,30,0,0,0,52,117,4,1,1,0,4576,1,0,297,295,2,17704,17596,108,289,287,2,1,100,NoArch
9db466ddb26c472411bc4ce27bf62391381912cb,1,11,0,11,0,0,0,5,16,69,1,1,0,212,219,9,22,19,3,889,841,48,13,12,1,1,100,NoArch
162275be3f4417d1c69f8b244e2f62369bbd6211,7,148,55,93,0,0,0,55,180,39,1,4,2.146772383,21342,25,1,2042,2031,11,90938,90624,314,863,860,3,1,100,NoArch
3302a494767b4d64b5212e21f53d2c8cc49fe1c7,9,215,0,215,1,0,1,3,129,21,1,7,2.288355833,15143,4,1,1070,1046,24,77428,76076,1352,519,506,13,1,99.98440424,NoArch
ee1a70a7b74cb20d3a6dcae145171464ac05b28e,1,7,6,1,0,0,0,47,160,44,1,1,0,5876,2,1,794,794,0,28843,28834,9,197,197,0,1,100,NoArch
40f5a0faaa4c5d974b0815ea2216d91551755e7b,2,244,3,241,0,0,0,53,118,35,1,2,0.567237916,6104,5,0,633,605,28,27807,26534,1273,388,364,24,1,100,NoArch
1c84234201fe2f69bf8e9d495c2b6177069a069f,2,24,0,24,0,0,0,10,47,35,1,2,0.811278124,2345,16,1,334,331,3,12295,12160,135,106,105,1,1,100,NoArch
4558236b2882f5b11a47fa1da289d5d11b219d5b,6,58,1,57,0,0,0,46,130,27,1,5,1.999320912,20085,14,4,1945,1942,3,90892,90649,243,964,961,3,1,100,NoArch
54a6e3a78489e419477f5ca079bb1539ac284d6c,17,1381,0,1381,16,0,16,1,11,4,2,3,3.909835574,413,15,5,135,20,115,7273,1134,6139,74,8,66,1,99.70457903,NoArch
397f4b3c435e9311ea82f66af90df6d29c28bf17,0,0,0,0,0,0,0,0,0,0,0,0,0,0,58,3,0,0,0,0,0,0,0,0,0,0,100,NoArch
763ec429c951acd5fa251c5d4a2b7780fbf648d4,8,559,319,240,2,0,2,4,79,23,1,3,2.336127129,9176,220,10,1385,1363,22,49890,49135,755,489,478,11,1,99.89144762,NoArch
8555e1bc14f0e94a2f1c1e25d56c1a04341e432e,2,35,10,25,0,0,0,12,59,71,1,2,0.99964375,2732,1788,6,214,210,4,22421,22211,210,113,111,2,1,100,NoArch
e63c252c4adfcce6072ebdfba724af89e9b2859d,2,105,8,97,0,0,0,54,119,30,1,2,0.945008765,5091,0,0,382,374,8,20804,20445,359,329,325,4,1,100,NoArch
413fb37906feee119069ae8d99446b7f6d9bc3a1,4,58,11,47,0,0,0,47,161,44,1,3,1.67366487,6313,59,4,825,825,0,30680,30517,163,222,221,1,1,100,NoArch
5cbe435eea5ec0ba8cbc7ddf8c2808936aea476c,2,4,7,3,0,0,0,56,208,36,1,2,0.684038436,9137,60,5,928,929,1,42088,42099,11,635,635,0,1,100,NoArch
2282b952e553a04c1f051e1bc42cd5910eb25f45,8,112,29,83,0,0,0,9,32,59,1,6,2.470199444,3056,221,10,344,323,21,16931,16566,365,163,161,2,2,98.71842635,NoArch
5297b83aa7e1fa6de8ee5745c823d8b501f8414d,7,239,35,204,1,0,1,3,28,23,1,4,1.954782421,2332,61,5,256,241,15,10719,9927,792,128,118,10,1,99.97132822,NoArch
3acb30875525e029be96726a357ee9950cce3310,18,474,76,398,1,0,1,19,79,40,1,9,3.376503049,16301,222,11,1157,1107,50,83385,81521,1864,905,882,23,1,99.97850387,NoArch
1e9b4da0573ec73d332d4e65fb7fd30491b4318d,7,144,49,95,1,0,1,19,80,44,1,6,2.472608323,8894,223,12,913,907,6,37101,36604,497,475,473,2,1,99.98567335,NoArch
3092159056280ab1f3c284394ed99ae8211b3f6d,1,1,0,1,0,0,0,10,29,22,1,1,0,477,224,13,94,93,1,2741,2737,4,24,24,0,0,100,NoArch
820f6ab4965d79946e4144db8e33aeef98c3d2ff,7,20,120,100,0,0,0,14,91,67,2,5,2.289424237,5808,225,14,585,588,3,32086,32648,562,274,277,3,1,99.9856754,NoArch
0af2a9777365e062bab7bf9170aead51ecd43384,5,204,2,202,0,0,0,4,81,63,1,4,1.568950288,4051,226,15,523,515,8,21856,21093,763,258,250,8,1,99.9856754,NoArch
ec9231ad6c5a8764a17f5791a676951a90337015,6,17,12,5,0,0,0,2,209,34,3,5,2.525265806,8022,227,16,666,666,0,39516,39451,65,535,535,0,0,100,NoArch
e96a9aaec6cb75be65cbe509d3001b2533a29706,3,41,9,32,0,0,0,8,22,81,1,3,1.429587521,1247,17,1,112,111,1,6664,6509,155,58,56,2,1,100,NoArch
35caa059a762094c7df0b30e9b51358a19b48ac2,1,16,11,5,0,0,0,9,20,83,1,1,0,698,228,17,76,75,1,2590,2552,38,23,23,0,0,100,NoArch
bbb37fc071ea51d9127aea69a260235ed14f2879,3,15,3,12,0,0,0,3,81,29,1,3,1.34722304,4290,229,18,312,312,0,17606,17546,60,254,254,0,0,100,NoArch
9f67604c60d6ca99fc1cc8eb2182823e8f0a0c08,1,5,5,0,0,0,0,9,21,0,1,1,0,703,230,19,76,76,0,2590,2590,0,23,23,0,0,100,NoArch
0f94bcd2c18fd14c2e30c598bc83dbe9ccdc80cd,0,0,0,0,0,0,0,0,0,0,0,0,0,0,231,20,0,0,0,0,0,0,0,0,0,0,100,NoArch
e387deddb0cce39f5827de8744645286b2cb1d7f,4,36,13,23,0,0,0,3,45,80,1,1,1.742077598,2979,232,21,387,382,5,15950,15795,155,68,66,2,0,100,NoArch
536d5032c8a8a749601d5ff4664e6a2e0b8b7c94,4,45,7,38,0,0,0,48,210,38,1,3,1.607767848,12106,18,2,1004,997,7,49603,49366,237,841,838,3,1,100,NoArch
5cfd8c31cea1bf5411e503b15714cab5fc1c0d0a,46,141,172,31,0,0,0,5,210,38,9,19,4.979697847,17636,62,6,1484,1484,0,88278,87689,589,1097,1097,0,1,100,NoArch
5fc2fda637429d8810692fcab4c2d50c5448288b,1,17,17,0,0,0,0,26,77,8,1,1,0,3151,3,2,243,243,0,21529,21461,68,222,222,0,1,100,NoArch
dfd8da61aad1de003200b3d407dd5b7ac222ba39,2,10,1,9,0,0,0,57,211,44,1,2,0.845350937,6825,4,3,506,504,2,32107,32058,49,472,471,1,1,100,NoArch
315266420ee4113d766af16166a91ac8cb362db0,14,63,36,27,0,0,0,3,212,70,2,7,3.400256153,20793,1789,7,1958,1957,1,108049,107879,170,1060,1060,0,0,100,NoArch
a55e533be5a0adf4537e98d2e7209fe7bd946ddb,2,80,0,80,0,0,0,12,60,53,1,2,0.922406262,3106,1790,8,251,247,4,24587,24043,544,154,152,2,0,100,NoArch
7fafef95272e91f97db2a40189fde352720c16e4,1,122,27,95,0,0,0,3,6,90,1,1,0,165,1791,9,22,15,7,1734,1055,679,12,11,1,0,99.97134876,NoArch
571cf95a1564c925bf73e4dae3a6c63199b17c4e,2,80,18,62,0,0,0,54,120,18,1,2,0.998797921,6401,2,0,641,636,5,28164,27960,204,394,391,3,1,100,NoArch
3621b61ea0bca953652a2e6d1838e5a296c6a007,7,86,24,62,0,0,0,54,121,21,1,5,2.069841818,9333,5,4,1049,1038,11,38572,38327,245,530,528,2,1,100,NoArch
81669c555a96b5dc74e363165b5b882b72d45949,4,37,1,36,0,0,0,19,82,35,1,3,1.658467574,5747,10,0,595,591,4,26585,26380,205,303,301,2,1,100,NoArch
6257609c6be438ba9103666ea41e3191d851abd0,39,477,161,316,0,0,0,5,162,42,5,19,4.270570266,37586,63,6,4173,4158,15,195833,194010,1823,1999,1983,16,1,100,NoArch
b80bb1cbceb11ed31b73e419916b5cc98610503e,18,559,34,525,3,0,3,15,181,27,2,9,3.454158899,50980,7,0,4878,4836,42,228471,226052,2419,2338,2314,24,1,99.95704467,NoArch
7bb120dc074fb20ea5802f2a574dd141efebbcb9,2,79,24,55,0,0,0,58,213,2,1,2,0.8575588,7314,4,0,548,542,6,35334,35017,317,478,475,3,1,100,NoArch
990ed290ccde1344c9277cf88c82df3118a96217,7,138,9,129,0,0,0,3,131,15,1,6,1.945148207,14626,5,1,1028,1013,15,75483,74764,719,496,489,7,1,100,NoArch
30313f34e5ed252b09fb2110d381fc527fb6732e,8,113,53,60,1,0,1,5,110,65,1,5,2.390999913,5494,64,7,709,708,1,24219,24205,14,220,219,1,1,99.97138565,NoArch
2c78bac48bfde94c0c77e6e7bb1f95814c8b23c7,3,129,1,128,1,0,1,1,9,505,1,2,1.323538113,819,1792,10,88,73,15,5018,4440,578,20,16,4,1,99.98569794,NoArch
bfd6d558d3b7b56cc5a8ff13a4e6988f36ace03b,1,946,867,79,0,0,0,19,83,6,1,1,0,2999,1793,11,199,200,1,11722,10285,1437,190,191,1,0,100,NoArch
0ef28f08bc555c518c9d2fec5b6e2aa5ae6620ee,0,0,0,0,0,0,0,0,0,0,0,0,0,0,233,17,0,0,0,0,0,0,0,0,0,1,100,NoArch
0d4d8de7af72ee710a6f458a6c216ff70388c52b,0,0,0,0,0,0,0,0,0,0,0,0,0,0,1794,12,0,0,0,0,0,0,0,0,0,0,100,NoArch
b1c7a0be86498d4c7688c28191416e9a57a17275,2,2,2,0,0,0,0,1,84,2,1,2,1,3531,1795,13,213,213,0,14134,14133,1,196,196,0,0,100,NoArch
44be09dff80768be39784d3bff596d5f6727273d,0,0,0,0,0,0,0,0,0,0,0,0,0,0,234,16,0,0,0,0,0,0,0,0,0,0,100,NoArch
7e57379c0536e60e88164c98642484d2e328541c,2,15,25,10,0,0,0,26,76,59,1,2,0.934068055,3415,65,7,186,186,0,18673,18751,78,154,154,0,1,100,NoArch
8fb5ca9898dc2c39a3b708a29f95a8904423c871,6,21,20,1,0,0,0,2,7,48,1,1,2.058571129,586,66,8,37,37,0,1413,1413,0,25,25,0,0,100,NoArch
34e4a4ff9010b0a25c0a1546f012184a1a72e2e3,0,0,0,0,0,0,0,0,0,0,0,0,0,0,235,16,0,0,0,0,0,0,0,0,0,1,100,NoArch
0196bb67a5255b7b0f9e297c74742c4d7203403d,2,9,11,2,0,0,0,3,22,78,1,1,0.992774454,902,31,0,100,100,0,3214,3222,8,32,32,0,1,100,NoArch
9799c777625a8fdf00594b1edad3c44ad912a488,3,15,6,9,0,0,0,7,18,99,1,2,1.493709546,1412,32,1,129,129,0,6550,6463,87,84,84,0,1,97.76520099,Arch
93372e7de02f567fe6d026a6d28d3b6a254fd571,2,24,0,24,0,0,0,3,6,85,1,2,0.979868757,653,11,1,49,47,2,3404,3266,138,25,24,1,1,100,NoArch
9ab8c41f3d3b64f6d1c0ee309106a0e8e9c258d0,1,15,9,6,0,0,0,22,66,53,1,1,0,1992,16,0,275,274,1,8984,8963,21,73,73,0,1,100,NoArch
2e37b752d5cfd29a4b7b77d0d70a33f52988f726,2,13,1,12,0,0,0,49,164,40,1,2,0.591672779,9654,15,0,1236,1234,2,43295,43243,52,635,633,2,1,100,NoArch
bfd23dbdcdf43f95ef5597244320e5a3c7db582c,0,0,0,0,0,0,0,0,0,0,0,0,0,0,236,3,0,0,0,0,0,0,0,0,0,0,100,NoArch
0b97f45752f111b56aa499b037077d27db82ec47,3,35,22,13,0,0,0,16,46,71,1,3,1.093787975,1776,33,2,163,159,4,6868,6798,70,87,87,0,2,100,NoArch
076780ad3d02bd1483b6713146915c3e43f89e33,0,0,0,0,0,0,0,0,0,0,0,0,0,0,1796,4,0,0,0,0,0,0,0,0,0,0,100,NoArch
3892bcd215724a697814426f26d7b8dcd77a4568,22,238,265,27,0,0,0,7,211,77,7,10,2.343344199,51035,1797,5,3260,3260,0,224098,224098,0,2731,2731,0,0,100,NoArch
78b3d979d1a7ae37f88c0b04484723fb03ec7f18,1,98,20,78,0,0,0,21,82,0,1,1,0,2142,1798,6,310,294,16,11175,10751,424,160,153,7,0,100,NoArch
3c9e156aea4a246318e1fa9ea299adfc9479e20e,5,225,53,172,0,0,0,16,123,31,1,4,1.58491485,9574,1799,7,1020,992,28,44212,43512,700,543,533,10,1,100,NoArch
cf755f27dce1fb9aa902f41528f48a326e31c51a,0,0,0,0,0,0,0,0,0,0,0,0,0,0,237,3,0,0,0,0,0,0,0,0,0,0,100,NoArch
792fbbf51bf576b5530081edebcad5c53ee07f3d,0,0,0,0,0,0,0,0,0,0,0,0,0,0,238,3,0,0,0,0,0,0,0,0,0,0,100,NoArch
1eb22d03c11b9362b50208261b99eecc3de28fe8,5,175,25,150,0,0,0,51,212,71,1,5,1.690596398,17173,19,0,1791,1778,13,83351,82677,674,743,740,3,1,100,NoArch
22c70caba8d1942d3333cde6fcd0039ce71d1525,5,48,0,48,0,0,0,46,132,45,1,5,1.737473385,16290,17,1,1639,1636,3,83464,83233,231,839,836,3,1,100,NoArch
a6f544eb48a87f4f71f76ed422584398c0c9baa3,5,48,0,48,0,0,0,46,133,0,1,5,1.737473385,16338,18,2,1642,1639,3,83695,83464,231,842,839,3,1,100,NoArch
13728c0320dcd2e042e775dcc19b615df5c4a614,1,1,1,0,0,0,0,2,4,60,1,1,0,267,1800,4,41,41,0,1603,1603,0,7,7,0,1,100,NoArch
c086877a8b7f7b47526d55e9e18dcb3576cdbaab,3,94,71,23,0,0,0,26,100,85,1,2,1.186438641,6383,1801,5,628,625,3,34224,34070,154,394,392,2,0,99.97053841,NoArch
d6fa25cd11625ad7b4b74dafbd0211c701b38d49,4,9,16,7,0,0,0,9,67,84,1,2,1.241510189,3094,67,0,381,382,1,12534,12567,33,112,113,1,1,100,NoArch
1baee8524a8daa9c67f08f83080e269fc5938bc5,9,158,106,52,0,0,0,3,78,56,1,3,2.298179191,5745,68,1,459,453,6,29050,28804,246,289,283,6,1,100,NoArch
ea21f7540f58e679cf148848972a441cf06f12e0,1,2,15,13,0,0,0,23,68,3,1,1,0,1990,9,0,272,274,2,8898,8953,55,71,72,1,1,100,NoArch
d1e3a97134e4155b3b76a8d803f88ee3cb6c7312,1,2,3,1,0,0,0,9,17,72,1,1,0,179,31,0,10,10,0,1262,1277,15,7,7,0,1,100,NoArch
5d37a0e990a2b84c6616338490d7451065fdd3e5,8,542,137,405,3,0,3,6,15,82,1,2,2.644488593,1209,3,0,137,135,2,7664,6227,1437,75,61,14,1,97.63277488,Arch
6ea2fd03cbc366b673ac0adfcd246b2e3e7321dc,5,9,42,33,0,0,0,3,39,75,1,4,2.16027994,1219,69,2,60,62,2,4196,4267,71,47,48,1,1,100,NoArch
dac238c1f0617305ab83f0ce0145f92883c7cae9,0,0,0,0,0,0,0,0,0,0,0,0,0,0,239,3,0,0,0,0,0,0,0,0,0,0,100,NoArch
e89e18d110df1859dd28d03262fe39e040b31b68,0,0,0,0,0,0,0,0,0,0,0,0,0,0,240,4,0,0,0,0,0,0,0,0,0,0,100,NoArch
15fe43421f8139cf8d8c305ebc2f1b859f7b657b,0,0,0,0,0,0,0,0,0,0,0,0,0,0,35,0,0,0,0,0,0,0,0,0,0,0,100,NoArch
eaa40cb7589fb59ea820ea1d4a0c2f187ee9e759,6,247,55,192,0,0,0,3,21,52,1,4,1.403246225,2173,70,3,238,219,19,9928,9173,755,146,134,12,1,100,NoArch
10a5b8a89d319e6fed563e7e49518cfc960b93d6,2,256,4,252,0,0,0,58,214,131,1,2,0.318215298,6839,32,1,507,495,12,33720,32203,1517,484,474,10,1,100,NoArch
a09923ff8dcb707c5573b37e182308f90dfb52fe,1,8,7,1,0,0,0,12,21,101,1,1,0,1051,10,1,162,161,1,4586,4592,6,47,48,1,2,100,NoArch
051b6919dfc5b60406e81d5e8b8d5efb263def87,2,193,123,70,0,0,0,32,101,22,1,2,0.980377509,3762,1802,2,468,464,4,18535,18246,289,254,251,3,0,100,NoArch
ceb972952739929c175dfd0895407e8e17e0b502,8,255,51,204,0,0,0,2,213,58,2,4,1.913760741,23274,1803,3,2168,2156,12,108805,107733,1072,1076,1073,3,1,100,NoArch
555da953fe758a7d310aeb3aed463f3f2f3cdc3b,15,259,28,231,0,0,0,4,112,86,2,8,3.241963322,22335,1804,4,2581,2562,19,114569,113443,1126,1111,1099,12,1,96.22563537,Arch
9b2a5592f3852a39225ec0b41b1768f533c825d0,4,252,132,120,1,1,2,1,15,12,1,1,1.506846399,461,45,0,45,27,18,2247,1441,806,32,25,7,1,99.96953077,NoArch
dfdb3354c5f4bca1fe5a53a1aecff6ca4bc1a0c2,4,18,16,2,0,0,0,26,166,67,1,3,1.761094936,9716,71,4,1091,1091,0,52625,52617,8,460,460,0,1,100,NoArch
8a890281761d4cf3073566ba1a7fcb483af4c5b0,3,17,11,6,0,0,0,23,69,10,1,3,1.378783493,3465,72,5,496,495,1,15005,14979,26,157,157,0,1,100,NoArch
c5d43fe57a0998564343e1f8480f8e85cd788bdf,2,18,1,17,0,0,0,2,25,99,1,2,0.74248757,490,73,6,55,53,2,2314,2192,122,25,24,1,1,100,NoArch
6a322f9fff51362744b326246e49590f850449bb,21,116,102,14,0,0,0,5,215,80,2,10,3.768467448,28454,74,7,2168,2172,4,134289,134190,99,1469,1468,1,1,85.66090612,Arch
56d427a3e5dd7acd8eaf256fb3c77b0196f79b24,3,10,13,3,0,0,0,12,40,92,1,3,1.353448505,1374,75,8,98,100,2,6045,6077,32,61,61,0,2,100,NoArch
bf3fb49eba29f4b90b1232f7abaaa32cf7bb73aa,3,17,12,5,0,0,0,7,39,186,1,3,1.543990777,1600,76,9,230,230,0,7993,7986,7,61,61,0,1,100,NoArch
bd92764244a137f551c4671dff20f3407aa40abe,1,1,0,1,0,0,0,6,17,187,1,1,0,319,77,10,21,21,0,1855,1850,5,17,17,0,1,100,NoArch
da1a2dd81a3f681e932039aa0c8569661573e1e5,6,51,27,24,0,0,0,4,104,36,3,6,2.094804201,9173,78,11,883,882,1,47725,47706,19,535,534,1,1,100,NoArch
21c816829e71f2b72ff0f2bf3b130c835678d1e6,1,10,8,2,0,0,0,15,70,119,1,1,0,2395,26,0,530,530,0,12565,12580,15,84,84,0,1,100,NoArch
668792554cf7097d668bf794ef2ba5b1fd4956ee,3,38,6,32,0,0,0,5,28,128,1,2,1.351687126,2104,27,1,299,294,5,8930,8767,163,93,92,1,1,100,NoArch
8cf7b448e5e0fcc45d88f96379ac95b611f38bca,1,2,3,1,0,0,0,13,41,7,1,1,0,988,20,0,58,58,0,3892,3894,2,49,49,0,1,100,NoArch
c395c10b6efa781ecd33f49c6322d60579f78ac5,5,13,28,15,0,0,0,54,167,89,1,4,1.391553521,13158,79,10,1374,1376,2,60849,61012,163,633,633,0,2,88.23698591,Arch
b8deb183e88bc4b22f23b0fe03d1b8fc6603c600,2,23,0,23,0,0,0,56,182,104,1,2,0.932111568,18049,80,11,1633,1630,3,78672,78570,102,745,744,1,1,100,NoArch
2ffd74abb665f4119ff30926f3944070d8a9d0ac,2,5,14,9,0,0,0,3,71,13,1,2,0.899743759,4950,28,2,655,658,3,29157,29171,14,184,184,0,1,100,NoArch
5fa41609cb0fe310a0a11d86319d861423850a36,4,229,36,193,1,0,1,54,125,94,1,3,1.499274285,5241,1,0,378,364,14,21541,20749,792,347,339,8,1,89.35245845,Arch
e1e5898f8975f2478862973c19799c8be45b8d83,3,0,36,36,0,0,0,23,70,143,1,1,0.825724339,3004,11,1,399,404,5,13263,13409,146,110,111,1,1,100,NoArch
2515e9ff12a588a590f408b3660a96c3fa76cc01,11,288,261,27,2,2,4,3,18,28,1,2,3.010414149,1635,81,11,123,133,10,6539,6762,223,92,95,3,1,99.80992608,NoArch
938614cca8c30ed9ff48996ff0ae42e1ed4f1706,2,38,57,19,0,0,0,49,140,117,1,2,0.846701712,9498,82,12,542,551,9,39081,39248,167,472,473,1,1,95.1849677,Arch
3a3b5ccc8b150cda81d3ac54f7baa6197dd7442c,2,5,4,1,0,0,0,32,105,42,1,2,0.918295834,4864,1805,3,788,788,0,25540,25546,6,310,310,0,1,100,NoArch
6d974f1b23bdca566d01cb7cbb1ec46d7ef5e84c,2,129,120,9,0,0,0,54,126,60,1,1,0.067444879,5256,1806,4,342,339,3,20548,20551,3,333,331,2,0,100,NoArch
f8a0f0d503e6844c0ec14423e72e97aaf804d87b,4,90,12,78,0,0,0,54,127,86,1,3,1.359096716,7318,1807,5,772,766,6,32206,31728,478,465,464,1,1,100,NoArch
7c27b147414c64505fa33c947100ece094caa15c,8,171,244,73,1,2,3,3,19,0,1,2,2.309508325,1487,83,13,106,109,3,6019,6097,78,83,86,3,1,99.92702727,NoArch
4b3e406cffb57b1cfc1319c97c5f3ce4cf5d4fa3,0,0,0,0,0,0,0,0,0,0,0,0,0,0,84,13,0,0,0,0,0,0,0,0,0,1,100,NoArch
9148ce92df012396a5e9a22453a2680a7df8f413,0,0,0,0,0,0,0,0,0,0,0,0,0,0,85,14,0,0,0,0,0,0,0,0,0,1,100,NoArch
eaba5e8803a7d5e691af1600c0d31e718d71003d,2,22,0,22,0,0,0,58,216,144,1,2,0.574635698,7125,5,0,531,529,2,33912,33806,106,504,503,1,1,100,NoArch
926478ee7d997a06a63fd6e9926436aafa42ac9f,2,26,6,20,0,0,0,49,144,68,1,2,1,10486,86,7,1550,1549,1,47430,47306,124,706,705,1,1,100,NoArch
e96bf560c685b2bc8d916de42fe908906f43e2ee,16,92,88,4,0,0,0,18,114,162,2,7,3.442261982,8432,87,8,1001,997,4,41376,41633,257,432,429,3,1,99.99087758,NoArch
643f9b589877d557a2a1fd570e037200d078c83e,0,0,0,0,0,0,0,0,0,0,0,0,0,0,88,9,0,0,0,0,0,0,0,0,0,0,100,NoArch
537b8dbb4b58c61b6c573eb07a51b8d38896a1ff,0,0,0,0,0,0,0,0,0,0,0,0,0,0,89,10,0,0,0,0,0,0,0,0,0,1,100,NoArch
ed1470a3ea53a78c667354a5ec066425364eca73,0,0,0,0,0,0,0,0,0,0,0,0,0,0,91,10,0,0,0,0,0,0,0,0,0,0,100,NoArch
aaf162a26943d3f42897f65a9e3fa8e7745bb1c2,1,10,12,2,0,0,0,24,71,39,1,1,0,1942,29,0,265,266,1,8680,8719,39,69,69,0,1,100,NoArch
aeaaca6783f9b4461b6b1fedf19de9a67ba0a96f,4,47,4,43,0,0,0,55,128,192,1,3,1.556901076,5825,12,0,489,481,8,23786,23581,205,360,357,3,1,100,NoArch
5dea67890a1916771e9a335e45969f2a4d4f7d3c,13,2972,2648,324,10,1,11,13,48,11,1,4,2.127032357,3816,158,0,415,765,350,20560,33021,12461,112,168,56,1,93.64788117,Arch
50cd53845e13f870f245bf9b77bb996b6b8d825c,2,21,0,21,0,0,0,58,217,126,1,2,0.985228136,7128,13,1,517,512,5,34046,33932,114,485,484,1,1,100,NoArch
9b7b6316eaceec12762b209acec915262bda37eb,1,4,4,0,0,0,0,13,43,0,1,1,0,992,159,1,58,58,0,3969,3969,0,49,49,0,1,100,NoArch
1653e21f4fa552f160d49a33a659da618c6f0920,5,17,29,12,0,0,0,34,115,146,1,3,1.173185868,5480,12,1,708,714,6,26038,26105,67,264,264,0,1,100,NoArch
4bd13283dbef1718af7a43f3162c588505ca744a,0,0,0,0,0,0,0,0,0,0,0,0,0,0,92,11,0,0,0,0,0,0,0,0,0,0,100,NoArch
ebc5070e27caa2cbe1cf3e3b78f6f93edfc4c6ce,0,0,0,0,0,0,0,0,0,0,0,0,0,0,93,12,0,0,0,0,0,0,0,0,0,0,100,NoArch
e9d302ffe37531c3e8eb5f657f236fe14d79992e,2,3,6,3,0,0,0,58,218,35,1,2,0.764204507,7116,33,0,508,509,1,33809,33823,14,486,486,0,1,100,NoArch
3c70ca47272053a7c1f1f41079b88713da06f29c,2,91,7,84,0,0,0,15,35,107,2,2,0.688047624,4370,34,1,523,522,1,21488,21105,383,226,225,1,1,99.99161636,NoArch
bfde14be1284efc6d4560868fef3724238c35dc3,2,95,25,70,0,0,0,15,36,84,2,2,0.650022422,4593,35,2,553,547,6,23100,22830,270,249,247,2,1,99.95807831,NoArch
200a136dd3b2ca04a1d1283eb5a03a04388b1947,4,33,5,28,0,0,0,3,72,146,1,2,1.679822907,5457,30,1,778,776,2,32141,31908,233,220,219,1,1,100,NoArch
0f7dcfbffdf2e2405c835d22af78dac7124a728f,3,72,8,64,0,0,0,9,72,41,1,1,1.438758681,2715,34,0,374,357,17,12311,11933,378,88,86,2,1,87.43566455,Arch
74536b7045c67004057ca1a01e6bcce33b59f9c3,5,51,0,51,0,0,0,5,20,255,1,1,2.214199116,1222,31,2,249,242,7,6900,6536,364,85,80,5,1,100,NoArch
b632152f5c159334c76245b8816c721edca84fd5,2,31,3,28,0,0,0,26,106,56,1,2,0.936667382,6531,1808,0,624,622,2,34781,34618,163,378,376,2,1,100,NoArch
91f5bb5589ca5b7c08b09969ad21c5e9bd18d293,3,46,13,33,0,0,0,51,215,96,1,3,1.353988848,20445,1809,1,1472,1468,4,93373,93143,230,850,850,0,2,100,NoArch
4208d0ba6f2a749692fe64181a1373af07d55db5,30,122,95,27,0,0,0,5,216,158,5,21,4.355547983,51592,1810,2,5349,5350,1,230553,230039,514,2892,2893,1,1,100,NoArch
80e6b023d4b92b2b25908c52e10f50792787cef8,21,172,842,670,1,0,1,7,217,103,4,9,2.620154578,22436,35,1,1667,1748,81,91095,93627,2532,1107,1126,19,1,99.89860583,NoArch
15fa9bc67a8ed12ec6b8e0d1dbced8760ae307ab,18,78,39,39,1,0,1,9,74,124,1,4,3.601493833,5952,36,2,651,650,1,27179,27026,153,199,199,0,1,99.87322515,NoArch
8d4820f208cd69f4377fca175c8b83ff16b1a912,2,19,0,19,0,0,0,49,145,93,1,2,0.981940787,6627,94,10,759,756,3,27908,27831,77,533,531,2,1,100,NoArch
ad8cf7e0e96137c40103e0e83539b59e43513b17,2,53,0,53,0,0,0,58,219,6,1,2,0.563102824,7880,32,3,615,612,3,38077,37643,434,524,523,1,1,100,NoArch
18b9bc36e8be5b9a038548d9513466a756eeba61,3,36,19,17,0,0,0,20,88,11,1,2,1.524673159,5395,14,2,509,508,1,24350,24250,100,232,231,1,1,100,NoArch
bc2d7e1ce0ff0a2193df2ce6e59d5501766bbca5,1,3,2,1,0,0,0,4,4,266,1,1,0,164,36,3,10,10,0,744,731,13,2,2,0,1,100,NoArch
b5230070e5f495e2c5a7e4baa726a9f7a8877630,4,51,8,43,0,0,0,3,168,153,1,3,1.608939479,9993,95,9,1261,1256,5,45342,45129,213,646,642,4,1,88.23988214,Arch
4c3cef95377ea16efca037012385c40822b4426e,12,18,313,295,0,0,0,5,169,123,2,8,3.007687248,22664,96,10,2056,2097,41,99245,100631,1386,1278,1318,40,1,100,NoArch
1eff60b70a1d71022862cca5e5b3bb1178a84392,5,27,0,27,0,0,0,46,135,54,1,5,1.963841338,16409,19,0,1649,1647,2,84021,83829,192,844,842,2,1,100,NoArch
f11115a2fe9e360f38910f112288581040e0ced5,10,195,6,189,0,0,0,57,183,81,1,7,2.608059281,43425,0,0,2668,2656,12,182124,181073,1051,1957,1947,10,1,100,NoArch
6dfcfb421aec315b50c9b5ca923f3d0d0f3568b8,6,167,5,162,2,0,2,8,184,67,2,4,1.931852439,15299,6,0,1063,1049,14,70782,70078,704,666,657,9,1,98.8710555,NoArch
468f0190bbd1777671916c0adc57c7c6bd23a7a0,5,94,0,94,1,0,1,47,137,1,1,5,1.379582988,13715,7,1,1000,994,6,70558,70132,426,485,482,3,1,99.9859353,NoArch
d234626227954eefffe49f42abec65c649ffe3a6,6,48,1,47,0,0,0,47,138,1,1,5,1.845740914,19183,20,1,1720,1717,3,93107,92876,231,877,874,3,1,100,NoArch
0e345fd8d9eaa4223ada8ecc2987a7c82cb0d2b8,2,26,5,21,0,0,0,20,89,18,1,2,0.999249248,4023,15,3,339,337,2,17670,17590,80,204,203,1,1,100,NoArch
2f507f17ad68ea6fe061db8b4d76f2b34c1af440,3,108,51,57,0,0,0,20,90,157,1,3,0.706646075,5242,12,0,516,510,6,23451,23259,192,292,288,4,1,98.03214661,NoArch
a8aa4390813cd0a04677325d689b75c3ed8dbdc6,3,53,2,51,0,0,0,20,91,22,1,3,1.028020524,8082,33,4,867,859,8,41416,41095,321,380,378,2,1,100,NoArch
f76ddd1f02af2d6d335a82acc92a30ccf6d7379d,6,176,27,149,0,0,0,15,100,72,2,5,1.816582196,5895,37,4,593,586,7,34128,33175,953,275,271,4,1,99.99193938,NoArch
79d5001b945cbb9c47046b1b28b2345f78a72dc8,3,221,5,216,0,0,0,55,130,54,1,2,1.293161875,7759,5,0,837,817,20,37773,36353,1420,463,455,8,1,99.96776533,NoArch
893d41fa4b79dbac6b613f214de6b4fbab9e6773,2,30,2,28,0,0,0,55,131,0,1,2,0.974489403,6935,6,1,695,693,2,30664,30483,181,419,418,1,1,100,NoArch
ee9f35c286b36f6ba131f3797d4d9ab5d36cf3d5,0,0,0,0,0,0,0,0,0,0,0,0,0,0,241,0,0,0,0,0,0,0,0,0,0,0,100,NoArch
4a644e5093cd078b884ecfea5ced72813a4993f5,1,1,0,1,0,0,0,7,14,299,1,1,0,296,242,1,20,20,0,1978,1973,5,17,17,0,1,100,NoArch
ffcfb92247acbc7c50ee7812aad0060b94bafcd9,1,32,11,21,0,0,0,15,38,14,1,1,0,4218,38,2,530,524,6,20475,20375,100,224,222,2,1,100,NoArch
c60f6750ded31f63df57cfb2172d9b44cf0b572e,0,0,0,0,0,0,0,0,0,0,0,0,0,0,243,2,0,0,0,0,0,0,0,0,0,0,100,NoArch
989fc124976a5e701cce06b2f62988c8ccbb5988,1,1,0,1,0,0,0,7,15,5,1,1,0,297,244,3,20,20,0,1983,1978,5,17,17,0,1,100,NoArch
ebbba566fbdbdd0923adda596467090d708cc14b,7,125,11,114,1,0,1,15,82,104,2,4,0.823886213,8984,97,2,1061,1060,1,35151,34993,158,435,434,1,1,99.96777572,NoArch
8a80b72e87ef3b573bc75b99264f406773712f7e,5,78,15,63,0,0,0,15,101,16,2,5,1.947519144,5948,39,2,594,590,4,33931,33530,401,277,275,2,1,100,NoArch
888dd3a7d20ad04b22434f16d96177b7ca2c28aa,6,111,9,102,0,0,0,48,139,71,1,6,1.900042048,17457,3,0,1694,1688,6,88636,88106,530,875,872,3,1,100,NoArch
1c261ebeb65e775b908cb878e905410ce78cda80,1,0,4,4,0,0,0,4,4,312,1,1,0,225,4,1,5,6,1,1144,1175,31,5,6,1,1,100,NoArch
62186610f430996b28295d930a4ac505eed17b81,5,117,4,113,0,0,0,11,32,296,1,4,1.55427429,2078,0,0,227,216,11,13058,12397,661,75,69,6,1,100,NoArch
08f4a9889728f94903ff424ed9c20d940b821af5,5,82,24,58,0,0,0,8,25,55,1,3,1.653389565,1253,37,0,137,128,9,5503,5298,205,37,30,7,1,100,NoArch
7d4c96981d9ef6fa25289af99505e5a15ba51f69,2,13,22,9,0,0,0,9,75,28,1,1,0.999411065,2175,38,1,304,306,2,10026,10088,62,74,74,0,1,100,NoArch
56c4c4258132d1f56214a5b608391a3511cc9d5e,1,39,0,39,0,0,0,11,26,1,1,1,0,326,0,0,39,33,6,1266,1076,190,14,12,2,2,99.94375703,NoArch
a0ef3c9912d25d95f91fb6cf188abcc5b572c8c1,1,2,0,2,0,0,0,7,16,12,1,1,0,298,39,2,20,20,0,1990,1983,7,17,17,0,3,100,NoArch
4a8e105933a7638bb672afca07ac6da380671edc,0,0,0,0,0,0,0,0,0,0,0,0,0,0,0,0,0,0,0,0,0,0,0,0,0,1,100,NoArch
0be29613612a377faab729e40b49962d9e822769,0,0,0,0,0,0,0,0,0,0,0,0,0,0,0,0,0,0,0,0,0,0,0,0,0,0,100,NoArch
b4ad630d1d5674ae3dfc9c85615ffe991797c563,0,0,0,0,0,0,0,0,0,0,0,0,0,0,245,4,0,0,0,0,0,0,0,0,0,0,100,NoArch
8849b62e7baff84dcd4262f47809e87a38be7b10,3,173,1,172,1,0,1,1,43,83,1,3,0.910205883,1313,1,1,158,147,11,7579,6470,1109,43,37,6,1,99.98397436,NoArch
7792d57036ac82958b9a3f53a38855c979f7b36a,1,18,6,12,0,0,0,3,10,332,1,1,0,558,34,0,79,79,0,1893,1846,47,35,35,0,1,100,NoArch
b9a0fac91b78cbc14b9abdaf49ca48c24d005915,0,0,0,0,0,0,0,0,0,0,0,0,0,0,246,5,0,0,0,0,0,0,0,0,0,0,100,NoArch
d0180d160120e5d775b000549b7edac30250a353,0,0,0,0,0,0,0,0,0,0,0,0,0,0,247,6,0,0,0,0,0,0,0,0,0,0,100,NoArch
df3e3c652e3499ec03a224468fb2918752bae461,6,124,11,113,0,0,0,58,220,79,1,5,1.704784964,21769,1811,0,1991,1980,11,103899,103406,493,1244,1238,6,1,100,NoArch
ddda872b4922266c102f474042b4df27ba9a09be,23,555,440,115,1,0,1,5,218,134,2,13,3.629118044,45460,1812,1,4567,4524,43,205120,204950,170,2313,2305,8,1,99.95994873,NoArch
f1b2d3c45f085b71c18a45392337989d0d474136,2,8,5,3,0,0,0,8,25,216,1,2,0.89049164,1477,1813,2,179,179,0,8185,8161,24,129,129,0,1,100,NoArch
9492dd4146f63ddc028010d6c4e86f6a5cb29a8d,196,5908,5925,17,0,0,0,3,221,146,18,45,5.765992451,140734,1814,3,9156,9161,5,672299,678235,5936,7300,7305,5,1,100,NoArch
38e2566178dedf2aafe5700dd8fc45b9b30153da,0,0,0,0,0,0,0,0,0,0,0,0,0,0,248,5,0,0,0,0,0,0,0,0,0,0,100,NoArch
ddafe145b02185761a8ee2a8014b2b2f2af6bf4d,4,129,5,124,0,0,0,4,74,106,1,2,1.577431816,5877,0,0,800,785,15,33427,32834,593,293,283,10,1,100,NoArch
15152b629c784bf7b82efe5bcbe5931ee18682c7,14,77,39,38,0,0,0,8,76,127,1,4,3.196862206,6715,1,1,752,751,1,29273,29236,37,261,259,2,1,100,NoArch
4eaed593c9aee8df6ffe1f4bb7ec3d33a7cd0325,3,88,30,58,0,0,0,17,220,179,1,3,1.406388762,10227,29,0,814,806,8,44078,43733,345,550,547,3,1,100,NoArch
c545ef4e6931d7db4a28bae16f2ba05b62cdb4c2,0,0,0,0,0,0,0,0,0,0,0,0,0,0,8,0,0,0,0,0,0,0,0,0,0,1,100,NoArch
c3147f477f843d283c43d1e858534d58a7174544,2,82,5,77,0,0,0,5,83,19,1,2,0.999904695,5345,160,0,608,600,8,29331,28769,562,282,282,0,1,100,NoArch
5f7c51deb5245043efa9552d81acffdfb1b6692c,0,0,0,0,0,0,0,0,0,0,0,0,0,0,36,0,0,0,0,0,0,0,0,0,0,0,100,NoArch
1e6f78b82b0e200f95452a871ffe4119dd0c2f85,7,11,125,114,0,1,1,15,84,35,2,4,0.823886213,9144,249,4,1070,1071,1,35278,35436,158,435,436,1,1,99.96796155,NoArch
2bdbd95e2bf2685e93a16d80335fad761a58b4ab,0,0,0,0,0,0,0,0,0,0,0,0,0,0,250,5,0,0,0,0,0,0,0,0,0,0,100,NoArch
03fb20d00a9e09c884af1d9205f9bed5e48d030c,0,0,0,0,0,0,0,0,0,0,0,0,0,0,40,3,0,0,0,0,0,0,0,0,0,0,100,NoArch
16c9c36f319b06ebcf1338f0e40e9de2ee912adf,2,37,35,2,0,0,0,58,222,159,1,2,0.788513161,7026,161,1,499,501,2,33271,33271,0,488,487,1,1,100,NoArch
4e9870078fcaa7da9e475c94f43309cc3244fa22,33,372,170,202,0,0,0,7,186,200,1,13,3.459149536,38318,98,0,3983,3980,3,168297,167705,592,1688,1684,4,1,93.97590361,Arch
c9acc5bb03983915084557ac75afeb2866074d90,1,3,1,2,0,0,0,2,3,352,1,1,0,54,251,6,2,2,0,241,228,13,2,2,0,0,100,NoArch
f93fc1db4ed9fbdae01022f29e8178dc58fd68f9,7,263,87,176,0,0,0,15,103,71,2,6,1.633757085,9458,40,1,922,906,16,58417,57392,1025,537,530,7,1,100,NoArch
3755eb5871860f1fd5dc51990129784caa8ac0a4,2,27,2,25,0,0,0,3,11,184,1,2,0.893571102,931,46,0,115,113,2,5274,5106,168,68,67,1,1,100,NoArch
ee1a9d2cacb67da4c5d7e8f0441c94a40dc69d66,2,80,2,78,0,0,0,20,93,43,1,2,0.856114628,5249,16,0,512,508,4,23468,23084,384,288,288,0,1,100,NoArch
f17367e6ae4814c035e234568e212ba23080e9dd,16,187,99,88,0,0,0,6,221,138,3,9,2.590905089,14387,41,1,1211,1191,20,60236,59817,419,727,715,12,1,100,NoArch
e7095a23cf6e082077c887588216df3e3862c20d,4,4,16,12,0,0,0,32,107,206,1,4,1.191760148,3920,42,2,520,523,3,18209,18273,64,253,254,1,2,100,NoArch
8639729ba186e824f4f44846671cdef4c663b363,0,0,0,0,0,0,0,0,0,0,0,0,0,0,252,7,0,0,0,0,0,0,0,0,0,0,100,NoArch
b45799967e0cddf846849af508ccafc3e31e9ca2,3,40,5,35,0,0,0,51,222,240,1,2,1.278286323,8044,43,3,505,503,2,33190,33073,117,389,387,2,4,100,NoArch
147b7a52ee5c3231adf8382989b3702222c20024,3,27,31,4,0,0,0,20,94,184,1,3,1.278203839,3725,44,4,256,256,0,14416,14439,23,211,211,0,1,100,NoArch
933e9c7e5b669f4f4b7355294e416800c48275f4,2,18,1,17,0,0,0,27,83,59,1,2,0.949452015,3346,35,1,279,277,2,22567,22499,68,240,239,1,1,100,NoArch
9262d8d250eebfe126b07863ba89b1d4e6ec6219,2,17,0,17,0,0,0,55,135,71,1,2,0.997502546,5595,17,1,400,398,2,22122,22040,82,354,353,1,1,100,NoArch
f1857aa305c99dca40ee3c940ee689d77f27eaee,1,2,2,0,0,0,0,11,38,365,1,1,0,825,0,0,99,99,0,4907,4905,2,55,55,0,1,100,NoArch
43261e4094a37ce23eb181a6a8f653dabc4db599,3,28,3,25,0,0,0,11,141,36,1,3,1.260440881,13454,2,0,1255,1254,1,66944,66808,136,743,743,0,1,100,NoArch
dfb842e55e1fa7037c8a731341010ed1c0cfb6f7,2,42,13,29,0,0,0,9,13,198,1,2,0.788940657,477,0,0,48,50,2,2479,2057,422,26,24,2,1,100,NoArch
2798d90a8082adb294c3aadbad6d22d9228abf3e,4,39,2,37,0,0,0,3,223,33,1,2,1.698695824,9206,99,1,578,576,2,39485,39389,96,436,434,2,1,100,NoArch
39e58566c1ac02824d99ae9260d3315539efd57e,4,333,1,332,1,0,1,55,136,63,1,3,1.003156937,7150,8,0,705,657,48,30306,28694,1612,452,435,17,1,93.99286409,Arch
fbfb58ebf68c07e15eb5e99b425d113fd3daa451,2,91,8,83,0,0,0,4,9,204,1,2,0.999337504,458,2,2,88,78,10,3093,2552,541,49,44,5,1,100,NoArch
826c1cdd4b2aad0cd39576aaeedbf2053d196770,1,5,1,4,0,0,0,4,10,0,1,1,0,197,253,7,16,16,0,1397,1402,5,13,13,0,0,100,NoArch
33daf827b3b8cfa255dc7018d7fcfc9384a13542,1,2,0,2,0,0,0,5,11,0,1,1,0,201,100,2,16,16,0,1410,1397,13,13,13,0,0,100,NoArch
238cf037ebcd0e0e6f121f2304fa46a61c90632b,4,84,60,24,0,0,0,57,187,168,1,3,1.936270485,13081,101,3,864,861,3,53528,53366,162,523,522,1,1,100,NoArch
5c2b15814b4fbe42a4f1d720ad99719c68c0448b,0,0,0,0,0,0,0,0,0,0,0,0,0,0,102,4,0,0,0,0,0,0,0,0,0,1,100,NoArch
bf0ca495a4690f9f66374e9e67af8760c09719c7,2,37,2,35,0,0,0,8,11,212,1,2,0.552495114,344,0,0,37,35,2,1750,1420,330,32,30,2,1,100,NoArch
eed3d1b408f7720b7dae1c8529a4236895617f67,2,17,8,9,0,0,0,22,145,38,1,2,0.998845536,10836,103,5,590,590,0,43338,43306,32,516,516,0,1,100,NoArch
90f3e98bb7b2de44a7ac0e2bf1d16cfb09888be1,4,28,100,72,0,0,0,25,78,121,1,3,1.702289727,3952,45,5,532,537,5,15950,16182,232,188,191,3,1,100,NoArch
ff71266352df23208a75b9076045e89f30b9bb0b,3,89,6,83,0,0,0,9,25,105,1,2,0.870425609,1500,0,0,151,142,9,7110,6634,476,98,91,7,1,87.0610687,Arch
6da208625bb691fa67bfc7cea86cce4ce10657fd,3,7,4,3,0,0,0,25,79,9,1,1,1.572623664,2820,46,6,402,400,2,12857,12843,14,113,113,0,1,100,NoArch
53bbd2daff8104f3a1113eaaa01bf58ca3361beb,1,2,1,1,0,0,0,10,20,1,1,1,0,436,1,1,65,65,0,1614,1607,7,43,43,0,1,100,NoArch
21777f13d39b112cf226a75334ca9f5bae9303c5,2,344,300,44,1,0,1,25,80,0,1,1,0.997988442,1732,47,7,250,249,1,8217,7998,219,68,67,1,1,87.0610687,Arch
a136dc4884677bca7496a783c854220834440058,2,15,21,6,0,0,0,5,13,258,1,1,0.943601631,157,2,2,12,11,1,548,575,27,9,7,2,1,99.88345635,NoArch
38076961698c5354375be7856944809e71cd5a21,7,101,16,85,1,0,1,2,132,122,1,3,2.214878084,9386,104,6,1380,1379,1,42294,42111,183,311,311,0,1,99.93871525,NoArch
55c58538256119abbac0a260b8ea63f107f2407c,3,41,24,17,0,0,0,11,26,164,1,3,0.87908716,1643,1,1,153,152,1,9247,9142,105,120,119,1,1,100,NoArch
d3286ad4725fa97aae35c70f73ab768fabd409d8,2,42,11,31,0,0,0,11,29,23,1,1,0.979098167,1047,3,3,149,146,3,5125,4968,157,41,39,2,1,99.94986352,NoArch
789a2ae7f4de582c6de16c2bcec747372f941b44,7,122,35,87,0,0,0,5,81,55,1,4,1.856026969,4582,13,0,656,642,14,19991,19348,643,220,212,8,1,100,NoArch
af8c8efdc465435fa095197ff8365d527147ee7a,1,1,2,1,0,0,0,11,22,6,1,1,0,532,48,7,80,80,0,2216,2223,7,51,51,0,1,100,NoArch
f62d6b9a2f3dd877d4e2e5cbd2ff5d0d5f0efff1,3,21,6,15,0,0,0,50,151,179,1,3,1.31056738,8524,105,6,1095,1093,2,43984,43865,119,652,651,1,2,100,NoArch
21290006dd392e0ca1a45e952624abb0e0e66df7,5,9,11,2,0,0,0,10,117,249,1,4,2.121928095,9292,106,7,1470,1469,1,40205,40194,11,474,474,0,1,100,NoArch
e44beba286ea9049c5fd00c3a3b0e4a4f1c03356,19,328,75,253,0,0,0,5,188,237,2,13,3.53162265,31894,3,0,3170,3141,29,139628,138680,948,1683,1672,11,1,100,NoArch
914b6c5d0d58bfdf17d71b6fa37de469e424d969,3,4,7,3,0,0,0,25,82,15,1,1,1.572623664,2535,49,4,350,352,2,10912,10926,14,110,110,0,1,100,NoArch
11c8868d6a0924c12a0d5c0df0ec4db4dadc3e0a,2,17,17,0,0,0,0,5,10,243,1,1,0.908178347,404,50,5,68,68,0,1841,1837,4,31,31,0,1,100,NoArch
650ce466abf63309dcc0452d35a71dc497fb5f3c,7,15,12,3,0,0,0,23,84,150,1,6,2.648562858,4694,1,1,588,588,0,28477,28401,76,236,236,0,1,100,NoArch
0e00d65532251aacc8fdcde703bc1d8ddf8dff16,4,378,26,352,1,0,1,1,7,306,2,2,1.160843823,362,3,1,80,43,37,3662,1601,2061,47,24,23,1,99.9888691,NoArch
9adf4a485c99edbb2c65f2662e47a92551b78f6c,4,38,0,38,0,0,0,50,153,268,1,3,1.390665391,4296,13,0,503,500,3,16830,16518,312,488,485,3,1,100,NoArch
f1c0756f33b79904ca3a429bbff79ebf0103ece9,21,241,210,31,2,0,2,57,189,205,1,10,2.903401376,45982,107,8,2930,2931,1,202085,202264,179,1996,1996,0,1,99.94437955,NoArch
24dd26640db01114c6931d6615b90a63969ffc42,2,125,0,125,1,0,1,1,11,162,1,2,0.671247885,242,0,0,28,24,4,2359,1394,965,8,5,3,1,94.88633236,Arch
f8993e42dc017e3b9364007cc829d5e9b80aed9b,0,0,0,0,0,0,0,0,0,0,0,0,0,0,18,0,0,0,0,0,0,0,0,0,0,0,100,NoArch
0c1f1e8db34953cb494d38552b9a4878bec2264b,0,0,0,0,0,0,0,0,0,0,0,0,0,0,37,0,0,0,0,0,0,0,0,0,0,0,100,NoArch
22bfcf05a74d26efa73594aa3a30bf596bebe8bb,0,0,0,0,0,0,0,0,0,0,0,0,0,0,38,1,0,0,0,0,0,0,0,0,0,0,100,NoArch
4787cba48eb00190f4477b92386db06cd2c7fb63,3,34,0,34,0,0,0,4,11,306,1,2,1.520568918,831,51,6,112,108,4,2894,2724,170,54,51,3,1,100,NoArch
54891749913fb3fbb0ba3ef3e8825546f85986ee,0,0,0,0,0,0,0,0,0,0,0,0,0,0,254,0,0,0,0,0,0,0,0,0,0,0,100,NoArch
d6cc11b51962a38893ffa9e28b826600be289b8f,1,1,0,1,0,0,0,6,19,80,1,1,0,400,52,7,21,21,0,1864,1859,5,17,17,0,0,100,NoArch
69fb7e002de378f5f3bcee13d4b701e9ff0478bb,2,5,1,4,0,0,0,6,20,40,1,2,0.918295834,1339,53,8,54,54,0,4105,4085,20,50,50,0,0,100,NoArch
ac7d2b6b98334b80e2a43ffd9a79f36ea547e410,5,185,2,183,0,0,0,12,35,294,1,4,1.009421723,1631,17,0,91,83,8,9311,8120,1191,58,52,6,1,100,NoArch
eb57665ee1dfff6c1f9529223bafc9e74f54ff42,1,2,0,2,0,0,0,20,67,70,1,1,0,2145,14,1,310,310,0,11579,11579,0,95,95,0,1,100,NoArch
0cdb7a8a520eabdf103519a399c148b0df3ba20b,2,125,14,111,0,0,0,52,224,47,1,2,0.825222696,8837,15,2,610,595,15,38042,37455,587,480,467,13,1,99.994551,NoArch
e7224147916d5a9bf43c322894c04b302b3a545d,4,28,18,10,0,0,0,25,83,32,1,2,1.461577342,2644,54,7,362,361,1,11176,11126,50,121,121,0,1,100,NoArch
d1aae57fad71bf10942d4c53b339363537927c29,2,66,16,50,0,0,0,27,84,246,1,2,0.780975688,3435,16,3,284,279,5,23316,22870,446,239,236,3,1,100,NoArch
cecfece459b0f5f155c0498811985e083813aa20,4,104,2,102,0,0,0,58,223,85,1,3,1.345611472,13832,33,0,1344,1339,5,70369,69655,714,771,768,3,1,100,NoArch
e455734d2eea628e802a463ef18cd107ddb57874,1,6,6,0,0,0,0,5,18,368,1,1,0,823,24,0,105,105,0,3195,3189,6,27,27,0,0,100,NoArch
022016611091fdc021686aaf1a44f5217b4b3d30,1,1,1,0,0,0,0,5,19,0,1,1,0,823,25,1,105,105,0,3194,3195,1,27,27,0,1,100,NoArch
22fca8e43d62ffae12b7d7e1a50438f257ac88b3,2,9,1,8,0,0,0,51,147,194,1,2,0.721928095,9501,0,0,540,540,0,38949,38919,30,466,466,0,1,100,NoArch
e3fe745a4e8e5e15ae5e04345975c98ab737b31b,6,77,10,67,0,0,0,58,224,235,1,4,2.246879586,11020,41,0,719,715,4,55592,55110,482,666,664,2,1,100,NoArch
92eaf5654d4582399d901719be3c2977b279334c,0,0,0,0,0,0,0,0,0,0,0,0,0,0,18,1,0,0,0,0,0,0,0,0,0,0,100,NoArch
e081c5b4227a57defe47246d8ff3e6f7cce838e4,4,60,5,55,0,0,0,49,143,232,1,4,1.612419735,15601,5,0,1037,1032,5,65330,64974,356,704,703,1,1,100,NoArch
40e588de5f999034e5030b12cdbc90f4073808fe,11,313,59,254,2,0,2,57,190,132,1,5,2.894035512,20211,8,0,1498,1474,24,94096,92790,1306,757,741,16,1,95.98693133,Arch
890eb61efcccc486e2192110cefe4cac5aa6f150,10,401,79,322,1,0,1,15,191,55,2,7,2.557427155,27163,9,1,2274,2235,39,123572,121742,1830,1400,1379,21,1,99.9078341,NoArch
2a4779f478fea75c1a7b075b8da50b20b6fda9bb,3,26,21,5,0,0,0,12,84,25,1,1,1.369325224,2271,4,0,312,310,2,9628,9613,15,82,81,1,1,93.06776297,Arch
09b13cf6c61739d3ea15adf80b9dc0bc2b1ad0a0,2,2,3,1,0,0,0,2,2,372,1,1,0.970950594,193,2,1,17,17,0,992,1006,14,11,11,0,1,100,NoArch
9c31d9e83dc718800a36f7719534f9f74633c8a7,23,1247,59,1188,6,0,6,6,85,85,2,10,3.563883772,6948,55,6,812,697,115,35613,30784,4829,444,392,52,1,99.9010041,NoArch
ef28c9b8bfdd59f0a6ab0584ac07c9d362e2c67e,2,150,1,149,0,0,0,3,12,65,1,2,0.80331046,649,56,7,107,85,22,3081,2273,808,50,40,10,1,99.97884643,NoArch
916f1e76da4ef5ee2de80384b4aaa61e5129b3a8,1,2,0,2,0,0,0,6,19,25,1,1,0,942,57,8,33,33,0,2251,2241,10,33,33,0,0,100,NoArch
2730b4b696fcf1651acfa63e088f9c60c9369386,2,98,0,98,0,0,0,2,44,114,1,2,0.969744268,1290,1,1,127,119,8,7280,6644,636,31,27,4,1,100,NoArch
de3bef9b06502886f87b60ab36d8e54ebc55f05c,1,1,37,36,0,0,0,4,6,187,1,1,0,102,162,0,3,4,1,264,411,147,3,4,1,1,99.97883896,NoArch
888e8795598395a72b3ff2f6ecff8e488b21ebde,12,323,70,253,0,0,0,3,86,215,1,7,3.023552963,6353,1,0,900,886,14,27993,25893,2100,401,395,6,1,97.95357781,Arch
2e30293af7373b6c5fbcc5fa6505b49df2fba000,0,0,0,0,0,0,0,0,0,0,0,0,0,0,58,9,0,0,0,0,0,0,0,0,0,0,100,NoArch
ffa22f7e8b94fce1e7c297404453d13f959fd646,2,22,78,56,0,0,0,58,225,21,1,2,0.657704779,8047,34,1,607,619,12,37981,38325,344,528,528,0,1,100,NoArch
7be30db36d449e0a7fcc76b7d4647e141f4bc72d,91,177,97,80,1,0,1,58,226,311,1,4,5.767079444,29678,59,8,2582,2575,7,138968,138609,359,1137,1134,3,2,95.41279001,Arch
05376d6bff11ccef690addb4f9c40ab16dd20bec,1,1,1,0,0,0,0,6,9,2,1,1,0,97,60,9,5,5,0,328,330,2,2,2,0,1,100,NoArch
b708fdc46d4c5fd4c5a6c7a398823318a7b4dce3,0,0,0,0,0,0,0,0,0,0,0,0,0,0,61,9,0,0,0,0,0,0,0,0,0,1,100,NoArch
32c62ca486665dcf9693e26120142bfbdbbcb1e6,0,0,0,0,0,0,0,0,0,0,0,0,0,0,63,3,0,0,0,0,0,0,0,0,0,0,100,NoArch
2391c20bfb10760f770c5c7cd6fc488b8c5a4130,0,0,0,0,0,0,0,0,0,0,0,0,0,0,64,4,0,0,0,0,0,0,0,0,0,0,100,NoArch
36b31baa463679db871b15ada78e290d448c0443,0,0,0,0,0,0,0,0,0,0,0,0,0,0,293,18,0,0,0,0,0,0,0,0,0,1,100,NoArch
66caa54c5e272f8287ca132ca012733898a38768,745,4490,4456,34,0,0,0,2,188,344,18,73,8.201501352,231057,294,19,30418,30418,0,1069109,1060141,8968,13008,13008,0,1,100,NoArch
b5a94de7d270ecd0defbb7475d797d0e48649955,18,47,47,0,0,0,0,2,130,79,3,13,3.329535078,23247,295,20,3212,3212,0,105952,106048,96,999,999,0,1,100,NoArch
d84bb710aed90adbaeae3c65ed3c95c5f68ce749,45,69,69,0,0,0,0,2,73,207,4,18,5.218900138,11512,296,21,1371,1371,0,48676,48676,0,708,708,0,1,100,NoArch
69b12e0bdf85654e2267bb494ad408bd11f8124c,5,4,2,2,0,0,0,2,14,0,2,4,2.251629167,934,297,22,118,118,0,4197,4188,9,60,60,0,1,100,NoArch
1b94f37e888cf2d186362473529e6c147afe0f6e,98,691,55,636,0,0,0,3,189,71,10,39,5.367896404,93831,298,23,14697,14695,2,465901,464589,1312,4612,4610,2,1,100,NoArch
edbd35acf76dbd44cc148f036d0d02cbe2105c81,18,28,8,20,0,0,0,2,115,441,8,14,3.780591323,8490,299,24,1336,1336,0,42877,42775,102,389,389,0,1,100,NoArch
11d75942a76d859738afaf9d8be4b90c9c9a5d4e,79,104,149,45,0,0,0,5,190,83,12,38,5.713560596,74334,300,25,10607,10619,12,370162,370570,408,3857,3863,6,1,100,NoArch
5628311e506e13a567f1bd41e1cfba27a8719d22,6,9,10,1,0,0,0,4,76,312,2,5,2.478999067,5635,301,26,821,821,0,26455,26455,0,206,206,0,1,100,NoArch
1435ed51c6764708b6c9952dca0af9374bf1f329,9,22,19,3,0,0,0,3,77,46,3,9,2.816556652,9468,302,27,1307,1307,0,42902,42811,91,630,630,0,1,100,NoArch
04f8a078589f78aa421e137f6cb8d06ff0c3d458,1,1,1,0,0,0,0,16,52,0,1,1,0,4641,303,28,603,603,0,22472,22469,3,241,241,0,1,100,NoArch
0cdb485ee8d5edfcbf9a2daaf4e09b2c89cd11c8,1,4,4,0,0,0,0,16,53,0,1,1,0,4641,304,29,603,603,0,22472,22472,0,241,241,0,1,100,NoArch
b88bae9905048a777ccccce5eb7819b1b9bf51f5,1,3,3,0,0,0,0,3,8,0,1,1,0,77,305,30,10,10,0,268,268,0,8,8,0,1,100,NoArch
c528771e5c4c9ab6e15e7d4ee5536fdff6fb2019,22,54,44,10,0,0,0,16,133,106,3,12,3.857753989,26999,306,31,3330,3330,0,142622,142576,46,1216,1216,0,1,100,NoArch
2cbb0c4fef8d72224db5a33659fad898a9f0e849,2,2,2,0,0,0,0,4,19,105,2,2,1,788,307,32,125,125,0,2767,2769,2,48,48,0,1,100,NoArch
995b90bdee997d879f69020de06fe4f6e24f49eb,13,22,4,18,0,0,0,15,95,18,2,8,3.51755943,14459,308,33,2577,2577,0,72210,72106,104,740,740,0,1,100,NoArch
042802fc6f78244ca2b5759b9727c77676bed8ae,10,12,12,0,0,0,0,5,191,1,3,9,3.188721876,11208,309,34,1368,1368,0,50254,50242,12,425,425,0,1,100,NoArch
4dd81e98b13b5ff0336bf49330d602cbfde0edc6,1,5,0,5,0,0,0,17,90,0,1,1,0,2789,310,35,611,611,0,14947,14937,10,110,110,0,1,100,NoArch
cff3695264797e292d08302786c074ebe1d1c43c,11,38,34,4,0,0,0,3,125,127,4,9,3.054728831,10516,311,36,1792,1792,0,52864,52866,2,842,842,0,1,100,NoArch
3fa4bf1ef5b83fb0a3e1be451fba1677d19f52e2,14,22,23,1,0,0,0,3,95,141,8,10,2.786332188,9831,312,37,1694,1695,1,46172,46184,12,703,704,1,1,100,NoArch
6917193bd142830461ff15dfe24923369208e148,2,2,0,2,0,0,0,3,18,105,2,2,1,1175,313,38,100,100,0,4294,4284,10,46,46,0,1,100,NoArch
e53724630af60566784e8aa7d8f56fe2932b12cc,2,4,2,2,0,0,0,3,7,0,1,2,1,1182,314,39,189,189,0,5154,5144,10,76,76,0,1,100,NoArch
5be8a9aefcd7219cfe336729d4b1010f3d2c886a,1,1,1,0,0,0,0,39,111,0,1,1,0,2626,315,40,64,64,0,7926,7926,0,25,25,0,1,100,NoArch
122db544ca7b2488dadc88f1eaba54447e4af4b2,6,17,17,0,0,0,0,3,42,70,1,3,1.731360029,1210,316,41,102,102,0,5710,5710,0,48,48,0,1,100,NoArch
cafe7ec3ac54a8b0aa0a145a1e2928e33f1c59e4,4,7,7,0,0,0,0,14,64,104,1,2,1.664497779,4073,317,42,414,414,0,19570,19577,7,127,127,0,1,100,NoArch
fe7c1f5808fa1894e7c1b4a7a2239b188c7c56b4,4,8,11,3,0,0,0,52,192,0,1,4,1.824816986,15054,318,43,2279,2279,0,73050,73071,21,798,798,0,1,100,NoArch
2235149f22ee1302ea45b043191b67bf40c99ec8,1,1,0,1,0,0,0,4,7,0,1,1,0,89,319,44,10,10,0,290,285,5,6,6,0,1,100,NoArch
179ccca2833e919844723ff84ab3a449300b123e,4,4,0,4,0,0,0,2,21,0,1,2,2,1212,320,45,142,142,0,3583,3563,20,80,80,0,1,100,NoArch
c0ee886cc028c1baa40f14f04590f99451920b18,1,0,1,1,0,0,0,52,193,0,1,1,0,6134,321,46,807,807,0,29957,29957,0,201,201,0,1,100,NoArch
13c58ef3f89f55fddfdb65b2480f71c9847e7e6a,1,1,1,0,0,0,0,8,25,0,1,1,0,981,322,47,83,83,0,5780,5780,0,14,14,0,1,100,NoArch
be6fc6f34688d309903af4d76c92fb51eda10350,1,1,1,0,0,0,0,2,4,0,1,1,0,291,323,48,39,39,0,1466,1464,2,9,9,0,1,100,NoArch
0024fdbed652bdd007d7eb1d5b9770b559e909bc,2,4,7,3,0,0,0,15,65,0,1,1,0.684038436,4008,324,49,458,458,0,20119,20142,23,158,158,0,1,100,NoArch
50920958af56217b49d3209a39017574688a8783,1,12,9,3,0,0,0,5,18,210,1,1,0,229,325,50,25,23,2,1250,1257,7,14,12,2,1,100,NoArch
5bf678e2af3cae0f67a3c6e79cadf420f0325926,1,3,3,0,0,0,0,5,12,0,1,1,0,659,326,51,109,109,0,3408,3393,15,28,28,0,1,100,NoArch
155276591288615c4d02d55fb7d77eceb2e24b2d,28,37,20,17,0,0,0,4,97,73,6,18,4.569046154,21548,327,52,3490,3490,0,104735,104667,68,1379,1379,0,1,100,NoArch
69e812ff23b6f23a3737abeea5a8978a02bc2b5d,0,0,0,0,0,0,0,0,0,0,0,0,0,0,50,0,0,0,0,0,0,0,0,0,0,0,100,NoArch
532f903fe495d741053619c13a51537e57dcd619,0,0,0,0,0,0,0,0,0,0,0,0,0,0,328,53,0,0,0,0,0,0,0,0,0,0,100,NoArch
4c3ebf8a4dc04221fc13a53cf09b6da478e08aae,1,37,33,4,0,0,0,4,13,5,1,1,0,448,329,54,81,80,1,2515,2469,46,24,23,1,0,100,NoArch
836202c3f5aa04d56fa2fd2debc3c2024f92357e,2,19,1,18,0,0,0,63,211,13,1,2,0.970950594,12142,330,55,581,578,3,48241,48148,93,508,508,0,1,100,NoArch
e328a33b6f08356396472c9fec83ca00ae951119,2,61,14,47,0,0,0,29,96,28,1,2,0.978217666,4266,65,4,390,385,5,26660,26334,326,276,272,4,1,100,NoArch
5ae3c16153fd81fdf28f8493eb3c0178b860f269,1,12,15,3,0,0,0,4,5,295,1,1,0,233,4,0,12,12,0,727,740,13,12,12,0,1,100,NoArch
8df4df024128da846ccb404487628b413747a2c5,0,0,0,0,0,0,0,0,0,0,0,0,0,0,331,56,0,0,0,0,0,0,0,0,0,1,100,NoArch
3957f2a0e2389a78427953bf49c4448a34526655,0,0,0,0,0,0,0,0,0,0,0,0,0,0,332,57,0,0,0,0,0,0,0,0,0,0,100,NoArch
fcca91431003879e25d5191146b08683d22b0ccb,0,0,0,0,0,0,0,0,0,0,0,0,0,0,3,2,0,0,0,0,0,0,0,0,0,0,100,NoArch
1ba5c3559eb116af11c10d45907faefb5755f546,2,32,19,13,0,0,0,3,19,14,2,2,0.977417818,739,1868,5,111,108,3,3076,3046,30,48,47,1,0,100,NoArch
6f75f8deea4718da9a49d4ec1bb5eab9de0887d1,1,12,14,2,0,0,0,4,12,15,1,1,0,249,1869,6,28,29,1,973,976,3,18,19,1,0,100,NoArch
ebefe52f577da5c744ea863480ed3c98b7ef2e99,24,4213,1,4212,20,0,20,1,43,46,2,6,3.597646974,1368,3,0,478,91,387,24101,4896,19205,299,49,250,1,99.56004868,NoArch
c7fdae22fb0e6b220152f05a7343ce5569283a83,5,110,126,16,0,0,0,15,107,68,2,2,2.183829865,11059,2,0,881,880,1,40590,40723,133,589,590,1,2,100,NoArch
ac96eb8888c5009e781a31503288adf292000b80,4,43,0,43,0,0,0,64,212,76,1,4,1.185916543,22551,1,0,1218,1215,3,93008,92754,254,859,857,2,1,100,NoArch
74785aae40cdb48b02e4b8ef885e897c74bf629f,2,34,9,25,0,0,0,56,180,29,1,2,0.980798365,7175,125,0,819,813,6,30085,29977,108,587,586,1,1,100,NoArch
e2f9296688ff0f99bf2966a481bd87b8fe11b075,5,266,53,213,0,0,0,2,231,186,3,5,1.784055014,20177,12,0,1253,1230,23,85395,84627,768,1007,1003,4,1,100,NoArch
16b22b105dfcb3d95cc7af8eb54105f231d18cc9,7,40,36,4,0,0,0,16,213,64,2,4,2.342585007,32854,11,0,1991,1990,1,132181,132147,34,1426,1425,1,1,100,NoArch
ee5c78444558117c71cc7058a79bc920a52cad59,5,259,54,205,0,0,0,7,101,46,2,5,2.121913155,10050,1870,3,1001,987,14,59125,58034,1091,429,420,9,1,100,NoArch
ffc1e3b05e7f920d95c48f7c75fd48372684b8e7,12,577,484,93,0,0,0,16,214,333,2,4,1.300879516,36384,1871,3,2478,2461,17,145171,144934,237,1848,1846,2,1,100,NoArch
a186f02ab79374dc7a6ff0b2ae0c3cb661fbd86a,7,231,94,137,0,0,0,53,232,97,1,5,2.17539488,22012,126,1,1332,1320,12,92750,92013,737,854,844,10,1,100,NoArch
8e3036609d3896acf0368a5744ae58933adac59d,6,92,100,8,0,0,0,65,247,29,1,2,1.77881226,34057,1872,4,2237,2235,2,141124,141057,67,1933,1932,1,0,100,NoArch
b598ff08cc8ba4f00ddef08fdaf77e4fbb8d972f,8,224,8,216,0,0,0,66,248,12,1,6,1.979882264,35902,4,0,2603,2588,15,164216,162850,1366,1700,1690,10,1,100,NoArch
538f6ae70d82c23f4afb72fbea5bc8b49a81fe52,0,0,0,0,0,0,0,0,0,0,0,0,0,0,333,40,0,0,0,0,0,0,0,0,0,1,100,NoArch
cd922deff8ae3f25546b1d77fb147c3098eb177b,0,0,0,0,0,0,0,0,0,0,0,0,0,0,0,0,0,0,0,0,0,0,0,0,0,0,100,NoArch
fbef7c8fd90e59f6ba2043fe37045eb2590abc8f,0,0,0,0,0,0,0,0,0,0,0,0,0,0,334,41,0,0,0,0,0,0,0,0,0,0,100,NoArch
9f1332585b86be18ececdf15b3f103c9b069c25d,0,0,0,0,0,0,0,0,0,0,0,0,0,0,335,42,0,0,0,0,0,0,0,0,0,0,100,NoArch
bda7fb188b01c0334a7bf1662101e259321893a4,6,146,28,118,0,0,0,58,154,184,1,5,1.553280862,10831,0,0,1211,1199,12,48838,48373,465,683,676,7,1,100,NoArch
645aa1a9561cbf12ac5c24daecc9971a7fcca651,0,0,0,0,0,0,0,0,0,0,0,0,0,0,72,0,0,0,0,0,0,0,0,0,0,0,100,NoArch
13ac507058de07b85a9a4bf00595bd705efb1ac7,0,0,0,0,0,0,0,0,0,0,0,0,0,0,73,1,0,0,0,0,0,0,0,0,0,0,100,NoArch
2c2fa578e238e96368cc1b006a86538ec981c237,0,0,0,0,0,0,0,0,0,0,0,0,0,0,0,0,0,0,0,0,0,0,0,0,0,1,100,NoArch
b5a761e559ca1c1c914e388df4c6a0958dc17fc8,2,2,16,14,0,0,0,7,29,85,2,2,0.852405179,1987,48,0,103,103,0,7071,7158,87,96,96,0,0,99.9906786,NoArch
5cd75b481943cf7c0069c8d17e521dae6a442e37,8,40,43,3,0,0,0,7,78,188,1,5,2.310056308,4218,1873,5,635,637,2,20242,20371,129,251,253,2,0,100,NoArch
3038fb7e87c51740ef733fd4f9bde41b0c25e5b0,26,501,98,403,2,0,2,7,194,122,1,10,3.525312198,37989,1874,6,2945,2905,40,167589,165568,2021,1472,1448,24,1,99.9534147,NoArch
c2527ccf440f7750bfbabd2063c402440c5b32a0,3,92,28,64,0,0,0,66,217,42,1,2,1.198892337,18935,1875,7,1679,1673,6,82537,82224,313,769,767,2,1,100,NoArch
3c7e2e3f3edbf60d93ebf7c8946d1177a02d3e87,1,37,10,27,0,0,0,14,68,36,1,1,0,2965,127,2,328,325,3,14183,14102,81,103,101,2,1,100,NoArch
f9d23a62145e8c490492214836ce9cd7d1dcc35e,5,213,13,200,0,0,0,13,135,96,1,4,2.247616585,8059,49,1,984,966,18,39340,38183,1157,377,368,9,1,100,NoArch
987cb7f7da6ff1cb436718ac93868d50e88e875f,5,69,16,53,0,0,0,67,218,89,1,4,1.789256706,25487,5,0,1866,1856,10,109919,109603,316,1259,1259,0,1,100,NoArch
5f1d8238da504d54a8d4d74252f344c4ebb77318,3,20,0,20,0,0,0,6,30,106,1,2,0.568995594,1753,1876,3,195,193,2,5911,5821,90,64,63,1,0,100,NoArch
1fec052330168e0d0b416ed884b1db03ca76ceff,5,189,113,76,1,1,2,1,113,30,1,2,1.816051483,3476,1877,4,96,91,5,12383,11928,455,54,50,4,0,99.94411847,NoArch
a5801bed0d0d74ad12b6742d64ffb07b4a05f674,6,66,9,57,0,0,0,56,195,12,1,5,2.327031197,20309,0,0,1655,1653,2,89239,88900,339,659,658,1,1,100,NoArch
d03ce47536ddb2aaec6d445b3ea48464081a7ed0,9,268,86,182,0,0,0,27,126,63,1,7,2.272764421,18122,1878,5,2100,2069,31,92170,91192,978,902,890,12,1,99.96272829,NoArch
e7c579ff5bcc88c2ca0173192d9accd5786bca23,1,1,0,1,0,0,0,5,17,79,1,1,0,652,12,0,113,112,1,3370,3364,6,14,14,0,1,100,NoArch
add837afd15e1816e6415387559f51bd04996ef9,3,94,1,93,0,0,0,9,26,448,1,2,1.49726324,1362,0,0,112,104,8,5523,5136,387,85,81,4,1,100,NoArch
c70845687337ac65d00d3680d551549b9bda2b56,2,11,6,5,0,0,0,63,249,171,1,2,0.787126586,7136,13,1,557,559,2,31133,31112,21,520,520,0,1,100,NoArch
30a0f4b6e4c66894580ba42842923794ff4d5d9a,2,14,2,12,0,0,0,8,136,20,1,2,0.811278124,5243,50,2,639,639,0,25729,25729,0,200,200,0,1,100,NoArch
c19da85b32f17fd78ff2fb03298ef66675c1705c,2,23,5,18,0,0,0,7,14,127,1,2,0.749595257,545,13,0,70,69,1,3147,2995,152,31,30,1,1,100,NoArch
2e9edae7fc57ab9c9c7c097008724ac99a1791a3,2,52,0,52,0,0,0,29,97,81,1,2,0.973156035,3827,20,0,312,308,4,25731,25340,391,255,253,2,1,100,NoArch
fdcb195b829fdc4f52d777ae09630ee65eb0a977,4,91,70,21,0,0,0,29,102,136,1,1,0.840240975,2670,51,2,399,399,0,11398,11389,9,128,128,0,0,100,NoArch
d226a9456a8cfdb108a50744d702e915b46c7ffa,3,6,4,2,0,0,0,6,21,280,2,3,1.360964047,1083,336,0,92,92,0,8202,8225,23,53,53,0,0,100,NoArch
59a195f1a566e6724acc8bda246faf2f4ad89dae,0,0,0,0,0,0,0,0,0,0,0,0,0,0,4,0,0,0,0,0,0,0,0,0,0,0,100,NoArch
1e6b7425ec20e2bddc6331a21016475a43f9d995,2,65,3,62,0,0,0,5,80,124,1,2,0.811278124,3753,10,0,430,423,7,17400,17114,286,198,193,5,1,100,NoArch
5e9943aa1f51a97068fc37d53dea1d447570becc,8,244,70,174,0,0,0,17,110,65,2,5,2.262764629,21914,128,0,2082,2054,28,105912,104881,1031,1128,1120,8,1,100,NoArch
0ce7685477d33374ddf0fe7f32b5a2d04040b47c,2,21,1,20,0,0,0,54,169,264,1,2,0.574635698,10277,1,0,603,602,1,42701,42605,96,512,511,1,1,100,NoArch
6f94db067fd7b481f8969edbe5698685719e287a,32,442,192,250,1,0,1,1,196,142,3,16,3.626404805,40317,1879,3,4492,4458,34,193877,192823,1054,1914,1882,32,1,99.66564503,NoArch
54a7bfaf84a2845e8668b62d1be69747e21f4e88,8,123,63,60,0,0,0,3,155,213,3,6,2.272248894,11399,1880,4,867,866,1,47398,47165,233,599,596,3,1,99.9629801,NoArch
e819b4611e883c54708a75f6856300462c92b8ae,16,206,117,89,0,0,0,56,162,169,1,10,3.426745655,34113,1881,5,3541,3526,15,159919,159455,464,1469,1463,6,2,92.42627346,Arch
ff4c16d1ea2192435e543fc9572ae3a44decbf79,8,231,92,139,0,0,0,63,250,28,1,4,2.464843063,35656,1882,6,2979,2967,12,160575,159583,992,1938,1935,3,1,100,NoArch
3ccad7b2bcc962d48c1dee1c9604fd085d82c608,1,3,5,2,0,0,0,7,25,98,1,1,0,403,129,1,21,21,0,1844,1848,4,17,17,0,1,100,NoArch
b973aa4de7502a05ae073719f887fcae109f9163,0,0,0,0,0,0,0,0,0,0,0,0,0,0,66,0,0,0,0,0,0,0,0,0,0,0,100,NoArch
2ddc836dcf600a06e9ec3c8e7a7e61310e7b429d,2,38,13,25,0,0,0,7,43,59,1,2,0.966177351,1945,14,0,366,365,1,8726,8556,170,103,101,2,1,100,NoArch
3846b50ab8897433ec7396d269436149e87d63ce,1,5,1,4,0,0,0,13,36,127,1,1,0,418,14,0,59,57,2,1982,1962,20,6,6,0,1,100,NoArch
61771ccdb9148f6d2e0bb3e36a4e54d614321eb8,3,41,12,29,0,0,0,54,171,52,1,2,1.371636407,10170,130,2,572,569,3,41832,41635,197,498,495,3,1,100,NoArch
f3c173c9220a83be0dfa0c80a39b015f384ffcd1,5,24,10,14,0,0,0,30,98,192,1,3,1.969815782,7988,11,1,747,742,5,38846,38702,144,366,365,1,1,100,NoArch
5a847ea0c33113a3052bed4266700a9bde0eb16b,2,57,0,57,1,0,1,1,19,42,1,2,0.297472249,208,0,0,38,34,4,1165,924,241,19,16,3,1,99.98017053,NoArch
3f0353cecfbdfa3b85e6a4fe11946df912ebd2b1,4,34,4,30,0,0,0,8,100,83,1,3,1.914737636,4749,6,0,761,758,3,23437,23316,121,408,408,0,2,100,NoArch
99251a51842483bc80688364195a159b740bd53f,2,89,19,70,0,0,0,30,99,68,1,2,0.99380674,3697,12,2,298,291,7,25036,24690,346,254,248,6,1,100,NoArch
fbe69824ffb13f847d1db6e26f0030ddec7b0e8c,1,13,4,9,0,0,0,6,21,33,1,1,0,413,67,1,72,72,0,2298,2288,10,26,26,0,1,100,NoArch
fc912eb19d9ebbaee843dc1e9d3b4175e757cb53,2,19,0,19,0,0,0,27,106,94,1,2,0.74248757,4267,68,2,260,258,2,23404,23298,106,207,206,1,1,100,NoArch
b4e399cb35224d8c8d55f02b7cf2b9649a3b28a4,3,101,1,100,1,0,1,1,137,75,1,3,1.016753402,4756,69,3,644,640,4,22607,22180,427,194,191,3,1,99.95046072,NoArch
c9d7f5ed28e898beffe86d68fa7d637adbfbff5f,3,97,1,96,0,0,0,16,251,113,1,2,1.315994565,9114,0,0,760,755,5,40964,40412,552,616,614,2,1,100,NoArch
f3a9f6f34cd8a0fb1475810e9bf7fcba27d90e06,6,130,73,57,0,0,0,6,130,88,2,6,1.948429714,14316,70,4,1830,1822,8,80477,80247,230,856,853,3,1,100,NoArch
b75c549194bcbb1e2c028b28fd1858c4e300bd41,11,0,12,12,0,0,0,5,98,299,3,6,3.418295834,4286,337,0,615,615,0,18987,18987,0,283,283,0,0,100,NoArch
1f14e97060df55f873dd2f124caea90f39511512,9,0,9,9,0,0,0,2,31,462,2,7,3.169925001,990,338,1,45,45,0,1747,1747,0,22,22,0,0,100,NoArch
6e32d03d640dc0c8ed13d064b0088f413d50c607,0,0,0,0,0,0,0,0,0,0,0,0,0,0,339,2,0,0,0,0,0,0,0,0,0,0,100,NoArch
d3cf48514d2f7a93092b2d2a8151d9cf99cca10c,0,0,0,0,0,0,0,0,0,0,0,0,0,0,340,3,0,0,0,0,0,0,0,0,0,0,100,NoArch
b7e90e1aeead1406855030023c7dc1934f821cc6,1,1,1,0,0,0,0,5,15,34,1,1,0,844,341,4,79,79,0,2522,2523,1,43,43,0,1,100,NoArch
2de723745782d692d468b6f1095c34a0dafc9443,1,4,1,3,0,0,0,8,16,10,1,1,0,395,342,5,57,57,0,1368,1351,17,34,34,0,1,100,NoArch
6908d21ddecab8a10d7754800eed8f15b9c32f78,0,0,0,0,0,0,0,0,0,0,0,0,0,0,343,6,0,0,0,0,0,0,0,0,0,1,100,NoArch
2f2fc406f4675a9ca16e3c0a352cfa4f2a1bc047,19,133,0,133,0,0,0,2,9,1045,1,18,4.247927513,609,344,7,0,0,0,1691,171,1520,0,0,0,1,100,NoArch
d9a81b88ad561e7e4cedae93e805e0d7a53a7f1a,1015,13407,8252,5155,3,0,3,3,234,166,17,83,8.87987298,340854,345,8,40982,40709,273,1611606,1568283,43323,18517,18414,103,1,80.91717561,Arch
853fb03c9097ab555a3bcc9a95bc24f0d1965f28,9,67,72,5,0,0,0,2,199,52,1,9,2.214769375,10509,346,9,1093,1094,1,49149,49125,24,324,324,0,1,100,NoArch
3d13846a13398a1ba6c1fa84a7d0c0cc543f23d4,4,106,111,5,0,0,0,4,34,12,1,3,0.428153059,1673,1883,0,204,193,11,5430,5385,45,110,109,1,0,100,NoArch
2c28b5b09865bd48313d07c1f37cf6f6ebc701a4,0,0,0,0,0,0,0,0,0,0,0,0,0,0,347,10,0,0,0,0,0,0,0,0,0,0,100,NoArch
42cd8ca8e511beee3c5b78e872ed4a79ee691f93,2,31,5,26,0,0,0,59,157,31,1,2,1,7845,15,0,765,764,1,34492,34373,119,470,470,0,1,100,NoArch
d9b55b4300eb2959c4ed55e9b692ffb9f12dd1ef,6,128,51,77,0,0,0,5,132,68,1,5,2.266072707,7795,71,4,1292,1284,8,48748,48423,325,649,640,9,1,100,NoArch
0327135376246eb58e1703fc13d555efaf389ada,6,155,6,149,0,0,0,57,163,20,1,5,1.753225677,13255,2,0,833,822,11,61972,60997,975,464,459,5,2,100,NoArch
404f968f6079360621896e6ee20ec12488a40bc2,169,448,440,8,0,0,0,2,200,60,15,42,6.708028611,115758,348,11,16668,16668,0,585237,584823,414,5300,5300,0,1,100,NoArch
79006252a81353880c06f688d9d92c0cdc57026d,0,0,0,0,0,0,0,0,0,0,0,0,0,0,349,12,0,0,0,0,0,0,0,0,0,0,100,NoArch
3311d45bdf95eecac9659443b350080d0b5f4eee,0,0,0,0,0,0,0,0,0,0,0,0,0,0,350,13,0,0,0,0,0,0,0,0,0,0,100,NoArch
280f67bf0a7a0973ee69f3ef9eda6526d6997d0d,3,32,0,32,0,0,0,27,139,19,1,3,1.291100275,12239,52,0,1334,1332,2,62264,62119,145,609,608,1,1,100,NoArch
0ab1fe3118cc5adb8750a5c785e24fa4381afda1,18,632,186,446,0,0,0,57,164,63,1,11,2.49874185,27666,1884,1,2643,2584,59,130719,128832,1887,1270,1251,19,1,99.91836735,NoArch
d54f3a22b5b00f447ab294ddac0bf9af41540670,0,0,0,0,0,0,0,0,0,0,0,0,0,0,52,0,0,0,0,0,0,0,0,0,0,0,100,NoArch
67b41cea21203b1c7541d04dc0ff6ee6b65fbe35,5,44,34,10,0,0,0,8,117,38,1,5,1.883086613,8314,7,0,1037,1033,4,38251,38049,202,499,498,1,1,100,NoArch
ad6d1d907b913bab36d66879d656ae3115aa220e,3,49,2,47,0,0,0,11,19,169,1,2,0.475059145,1055,15,0,85,83,2,6967,6602,365,49,48,1,1,99.9883477,NoArch
d3d157fcf99686d341a104b4763d0424544b904a,1,36,6,30,0,0,0,17,59,106,1,1,0,994,1885,1,55,54,1,3777,3693,84,44,43,1,1,100,NoArch
56a86a032ac05ed522846910eea6f884b31820e3,15,109,96,13,0,0,0,5,252,137,2,10,2.35440461,28003,1886,2,2899,2897,2,148244,148395,151,1570,1569,1,0,100,NoArch
7a75cc6863982aee981c9c03198561f785a35442,0,0,0,0,0,0,0,0,0,0,0,0,0,0,1887,3,0,0,0,0,0,0,0,0,0,0,100,NoArch
e3b8b629f89ce5ffd25b4ef713258d83afd683cc,16,929,39,890,3,0,3,12,219,33,1,9,3.26610212,55475,1888,4,4975,4904,71,259426,255049,4377,2703,2661,42,1,99.94177245,NoArch
6dba0ac4b8085426d67574a094f23eb407b3633d,2,16,0,16,0,0,0,3,11,297,1,2,0.811278124,464,16,1,43,41,2,3037,2957,80,29,27,2,1,100,NoArch
80c4ebc17af928e2f4ee3a475abf9c62bf528faa,1,0,136,136,0,1,1,3,7,94,1,1,0,136,0,0,0,14,14,0,549,549,0,12,12,1,99.9534288,NoArch
1dd27f7ee6eaabd44ecda148bff7db9926dbf201,1,15,0,15,0,0,0,27,72,53,1,1,0,1863,8,0,221,218,3,11297,11148,149,69,69,0,1,100,NoArch
28d1c097e28dbc17f62ac1311755673d65337217,1,42,40,2,0,0,0,59,158,103,1,1,0,5793,1889,0,372,372,0,22611,22611,0,361,361,0,0,100,NoArch
8b9618fdd42daa14524e8baa69124982f409937a,3,60,16,44,0,0,0,59,159,46,1,3,1.059241892,9474,1890,1,1001,997,4,41240,40949,291,568,565,3,1,100,NoArch
5ddd016024eb74fbf769422ea320938a6e3a4cde,0,0,0,0,0,0,0,0,0,0,0,0,0,0,351,0,0,0,0,0,0,0,0,0,0,0,100,NoArch
be649b52eabb33d7252a146c50b769d271241dcd,2,33,6,27,0,0,0,6,18,300,1,2,0.918295834,583,30,0,60,57,3,3110,3003,107,31,28,3,1,100,NoArch
4d413bb21fb0a18882c5066f1d75a02d5b021bac,3,24,0,24,0,0,0,67,220,57,1,2,1.577428773,26306,131,0,1606,1605,1,105036,104933,103,1485,1484,1,1,100,NoArch
1f39ffacb53dc6799edac61f72b23997cb8a88d9,1,4,2,2,0,0,0,8,17,115,1,1,0,173,72,0,11,10,1,1018,1003,15,7,7,0,1,100,NoArch
174a707e1c199c97d7cc3531f0cd2e94745f4366,29,497,107,390,0,0,0,68,221,119,1,16,4.264590281,78296,0,0,7063,7006,57,357444,355417,2027,3692,3666,26,1,99.94179956,NoArch
f41d44a361941e1cd100edad7ebc19f7453ec752,0,0,0,0,0,0,0,0,0,0,0,0,0,0,352,1,0,0,0,0,0,0,0,0,0,0,100,NoArch
d2e7fecb22352e30abe037e91e7efea7f252f553,0,0,0,0,0,0,0,0,0,0,0,0,0,0,53,0,0,0,0,0,0,0,0,0,0,0,100,NoArch
67ece68208af8385c9e06b6b5cc812d6ad36293c,2,51,19,32,0,0,0,56,176,76,1,2,0.881290899,10078,0,0,556,555,1,41568,41485,83,493,492,1,1,89.85292909,Arch
0a4a10dff9dfd11946ae120e0d7d9ae71e1eeb2c,0,0,0,0,0,0,0,0,0,0,0,0,0,0,353,2,0,0,0,0,0,0,0,0,0,1,100,NoArch
f277a2468805999a446e5bcd0ef70aa1e9550562,11,192,22,170,0,0,0,68,222,72,1,7,2.954124022,43713,9,1,2888,2869,19,184866,183961,905,1710,1703,7,1,95.15792309,Arch
2ee4d841312049298840c22d36db6ab980ec5994,2,190,1,189,1,0,1,1,105,67,1,2,0.083900984,1641,0,0,259,240,19,7950,7040,910,89,71,18,1,99.9856713,NoArch
706ecc2e8d8ac93aef707818e21ebaa0a154490e,0,0,0,0,0,0,0,0,0,0,0,0,0,0,54,1,0,0,0,0,0,0,0,0,0,0,100,NoArch
801f33de8050ab7529b8597e2091d07fc5d81f27,0,0,0,0,0,0,0,0,0,0,0,0,0,0,354,1,0,0,0,0,0,0,0,0,0,1,100,NoArch
2bb92274ef5835a81d0ce7dca2a167b5b91c0eab,0,0,0,0,0,0,0,0,0,0,0,0,0,0,355,2,0,0,0,0,0,0,0,0,0,0,100,NoArch
6dace36e7cd0bd85d0bb02d1df6988b542dd6e49,2,8,4,4,0,0,0,4,22,130,1,2,0.650022422,858,356,3,92,92,0,3019,2995,24,21,21,0,0,100,NoArch
12a484a5c364c36e9551e59f4dc33bfb219ecf07,215,556,556,0,0,0,0,2,203,102,8,52,7.286734354,128411,357,4,16834,16834,0,596967,595879,1088,7246,7246,0,1,100,NoArch
a16a47351aa25caf538c1955edd171ec871569f7,2,59,1,58,0,0,0,25,68,100,1,2,0.609840305,2444,0,0,261,253,8,9377,9170,207,94,92,2,1,100,NoArch
039fe493e195416ee40c93b720f304ac9fc3c8c8,2,20,1,19,0,0,0,12,44,63,1,2,0.958711883,1996,132,0,340,337,3,11188,11046,142,70,69,1,1,100,NoArch
1bf6b08a81f471f979e1b52174f225f03ff77a2e,21,76,64,12,0,0,0,3,17,405,1,1,4.340230534,1408,1,1,72,72,0,6478,6244,234,48,48,0,1,99.98567746,NoArch
85f939f922b50aca054e19f21a3c0a55afd4b929,1,8,2,6,0,0,0,8,30,23,1,1,0,1450,16,0,263,263,0,6032,6024,8,89,89,0,1,100,NoArch
126aa842a6fcd04c411348b4b286b22eeee64d36,0,0,0,0,0,0,0,0,0,0,0,0,0,0,358,4,0,0,0,0,0,0,0,0,0,0,100,NoArch
56bc468e9b58bb1739a73ba6d916a3736ed50c77,0,0,0,0,0,0,0,0,0,0,0,0,0,0,359,5,0,0,0,0,0,0,0,0,0,1,100,NoArch
c475124ef8c61eb398ee119f27dfe21a14eca32f,0,0,0,0,0,0,0,0,0,0,0,0,0,0,360,6,0,0,0,0,0,0,0,0,0,0,100,NoArch
d21d540fafce8225b12b032900a8087f8ac33a91,1,3,0,3,0,0,0,5,21,201,1,1,0,714,17,1,110,109,1,2554,2543,11,44,44,0,1,100,NoArch
99aa01a215587a6121f5d0e4dc4c698eb6db6598,0,0,0,0,0,0,0,0,0,0,0,0,0,0,361,7,0,0,0,0,0,0,0,0,0,0,100,NoArch
4cd90f36c3cf9a012e34f14129a907a4ce99c6f5,10,1311,2,1309,4,0,4,1,121,153,2,7,2.310409742,7520,73,0,873,777,96,48326,42001,6325,405,352,53,1,92.56323141,Arch
ea452cf5780e656aaeea277f30816cce4e59659f,0,0,0,0,0,0,0,0,0,0,0,0,0,0,55,0,0,0,0,0,0,0,0,0,0,0,100,NoArch
b3aaaa8f3eb09a5f6a00ccb4ead6daaaf800faa0,2,76,7,69,0,0,0,61,161,75,1,2,0.991501787,7961,0,0,781,775,6,35411,35055,356,481,478,3,1,96.05336298,Arch
8178367ad64f6ed0e7f667122aa9b5d26e7a35f6,5,61,91,30,0,0,0,53,204,84,1,4,1.848331561,9921,1891,0,1262,1266,4,46249,46457,208,356,354,2,0,100,NoArch
513f4d2510a47e8d0b55f35dac56785c16fa7d5f,4,56,12,44,0,0,0,15,68,153,2,4,0.638494237,2574,1892,1,288,276,12,14005,13770,235,101,96,5,0,100,NoArch
02020cb4db92513439d18328af3689a45f9f976d,8,26,13,13,0,0,0,7,113,246,3,7,2.774426558,11015,1893,2,774,773,1,63710,63591,119,543,542,1,0,100,NoArch
a99b0cfc2fa352b75f9ff428543d9366e0162421,2,52,4,48,0,0,0,28,137,25,1,2,0.714727473,7879,1894,3,722,719,3,42270,41998,272,433,431,2,1,100,NoArch
a680abe0528faacf8d284419c76c36bbc1a65aa3,4,25,24,1,0,0,0,4,162,148,1,4,1.779496983,10692,1895,4,931,930,1,48010,47985,25,657,658,1,0,100,NoArch
7b338c043fb76350be518cc71812b83dc089bcca,3,36,0,36,0,0,0,28,139,128,1,3,1.232660257,8053,1896,5,734,731,3,42962,42776,186,441,438,3,0,100,NoArch
f1da65504e598928cf77aa6a7244552692ae2529,48,1092,245,847,2,0,2,15,253,135,2,20,3.888052899,93557,1897,6,8922,8841,81,445171,440872,4299,4764,4738,26,1,99.97254256,NoArch
a7a817a68f49f19f1316a66dee1eb5119b95a46e,4,84,10,74,0,0,0,2,23,847,2,2,1.215069234,764,1,0,53,41,12,2947,2682,265,25,21,4,1,100,NoArch
78cc3e3f739704ec4fa36bee9b465b61a672f873,3,11,4,7,0,0,0,13,48,223,1,2,1.5058231,2103,0,0,283,281,2,10281,10259,22,87,86,1,1,100,NoArch
d815dc1209c3cc0728941e9fc81fce7d9e44c79b,12,138,10,128,0,0,0,69,224,46,1,10,3.046217817,51705,0,0,3687,3677,10,229381,228620,761,2533,2525,8,1,100,NoArch
207bc8a0d731fa40e84309dfea3f8189b383e117,2,8,5,3,0,0,0,70,225,21,1,2,0.779349837,19308,0,0,1708,1707,1,84265,84234,31,787,787,0,1,100,NoArch
48d77026e1f05298e09f0a85a43364f49cc4a4ea,2,2,3,1,0,0,0,2,25,243,1,2,0.970950594,1422,362,0,195,195,0,5382,5382,0,69,69,0,0,100,NoArch
03e356c656c2bc98b1a273352475033545e0928d,20,29,29,0,0,0,0,4,156,206,7,14,4.107812461,21381,363,1,3442,3442,0,106428,106422,6,1191,1191,0,0,100,NoArch
8e7d735da428f9b193e86333ebe11712340dfeda,2,58,37,21,0,0,0,57,187,65,1,2,0.74248757,7271,0,0,824,823,1,30635,30504,131,594,593,1,1,100,NoArch
94502f51e6a12cd53cec88b39d21b4fec6070428,0,0,0,0,0,0,0,0,0,0,0,0,0,0,1898,7,0,0,0,0,0,0,0,0,0,1,100,NoArch
d4e1eeac6e2142d978bfaf216e85aaaf096e9a8d,2,79,18,61,0,0,0,13,106,243,1,2,0.914821009,2720,3,0,317,311,6,12470,12160,310,137,135,2,1,100,NoArch
3cfeba8a4d3f5e0968820ba5a6571ceda191aa7f,2,23,44,21,0,0,0,2,109,331,1,2,0.879458774,3284,74,0,715,715,0,16651,16803,152,411,410,1,1,100,NoArch
0c64a5857dc3f4319c083c64eb6d12027f9034a4,6,169,47,122,0,0,0,4,164,148,1,5,1.742943669,14184,1899,1,1371,1345,26,66479,65667,812,653,647,6,1,100,NoArch
00d1086c7003115a9ed9dcc874051f515b7b5aae,16,498,220,278,0,0,0,7,117,184,2,7,2.979280843,20039,1900,2,2752,2710,42,107610,106054,1556,1066,1051,15,1,99.95883362,NoArch
0fb14d553764f2a993ec56db4a36de2713ac1206,5,225,163,62,0,0,0,5,235,273,1,3,1.012882103,14750,2,0,1282,1283,1,65718,65568,150,766,761,5,1,100,NoArch
b49693d31964657bf5058bd9387e505992cebd51,0,0,0,0,0,0,0,0,0,0,0,0,0,0,364,2,0,0,0,0,0,0,0,0,0,0,100,NoArch
0378a560cc558698b928c9ebc088b905bd2d14c8,0,0,0,0,0,0,0,0,0,0,0,0,0,0,365,3,0,0,0,0,0,0,0,0,0,0,100,NoArch
b61f3ca7ac42c9f0f6ec4d35748bba70f63a4b0c,0,0,0,0,0,0,0,0,0,0,0,0,0,0,366,4,0,0,0,0,0,0,0,0,0,0,100,NoArch
e447ff85a0a7d2037b819b7ced91177261974c7e,2,111,0,111,0,0,0,18,60,186,1,2,0.956888666,1864,0,0,161,155,6,9440,8833,607,103,99,4,1,100,NoArch
39d477d96b90eca05e5af1cec0f8ae0617226b5d,2,25,1,24,0,0,0,59,181,101,1,2,0.930586129,10201,0,0,569,565,4,42063,41927,136,503,501,2,1,100,NoArch
963ef2798990c06c835c28945ff811ec3cbfa7a6,12,88,10,78,0,0,0,64,254,289,1,6,3.175551277,11391,17,0,1107,1092,15,54146,53813,333,698,685,13,1,99.96569939,NoArch
008930a5a0a4310d642ae902365a883208d097cb,2,28,7,21,0,0,0,9,19,494,1,2,0.898058793,1111,2,0,106,105,1,7800,7696,104,34,34,0,1,100,NoArch
93a2263f7af23be34171a6a1e4f5864a85691650,43,267,303,36,1,0,1,4,206,234,4,23,4.232244076,33921,1901,2,4134,4138,4,168479,168707,228,1747,1751,4,1,99.9657135,NoArch
fc6d56f1ac6d590b8a332cb0931a71ecd2367969,6,218,64,154,0,0,0,7,93,168,1,4,1.832313115,4828,1902,3,709,683,26,26042,25057,985,316,304,12,1,100,NoArch
ca9f0053611f54d92852a5c85e369a98bd3f91e7,2,74,31,43,0,0,0,10,33,169,1,1,0.512709142,1053,1903,4,176,160,16,7950,7722,228,39,37,2,0,100,NoArch
084d608c6adbbb82bcbdc2778439dfbeb6d6afdd,10,336,29,307,1,0,1,17,118,254,1,5,2.773391197,7589,1904,5,620,595,25,42127,40494,1633,478,460,18,1,98.10815976,NoArch
4bc916619fd286b2c0cc4d5c653c96a68801d74e,5,60,18,42,1,0,1,12,74,166,1,3,1.53802139,3698,367,3,256,254,2,29560,29514,46,148,146,2,0,99.95241777,NoArch
1721825eabfc4a0f82b33711b159359ee3c4341a,7,87,25,62,0,0,0,11,32,587,1,2,2.134561173,2209,1905,0,260,252,8,12115,11745,370,138,131,7,1,92.98310292,Arch
f4a5512caeaf087147fec82b7d98ea231b134036,7,209,69,140,0,0,0,8,236,182,2,6,1.796386177,16057,1,0,1256,1243,13,74646,74154,492,839,828,11,1,87.77148975,Arch
f30f407654e150679ede6e8d8d4344e6dc26b346,1,0,8,8,0,0,0,14,47,56,1,1,0,909,8,0,103,104,1,5440,5503,63,57,58,1,1,100,NoArch
8581f0a3fe9a4f079cb4d36f02121ae22118714c,4,165,56,109,0,0,0,7,104,84,1,2,1.303171788,9666,1906,1,1472,1445,27,53796,53162,634,490,483,7,1,100,NoArch
029969719980dd0707c9ca51087891b691593b14,5,4,11,7,0,0,0,6,22,295,1,2,2.256564762,784,56,0,73,76,3,3431,3518,87,50,50,0,1,100,NoArch
31bdc5a7c4b66a37162511045215ebb27dc95712,2,3,3,0,0,0,0,6,22,934,1,1,0.918295834,2093,0,0,266,266,0,7019,7019,0,145,145,0,0,100,NoArch
ac454315ea81af0eed1a2a9dca3d70ac729e6b28,0,0,0,0,0,0,0,0,0,0,0,0,0,0,0,0,0,0,0,0,0,0,0,0,0,0,100,NoArch
70d59fedfdb9fc956f3b1d1764833cbded7ae44d,4,94,0,94,0,0,0,31,105,225,1,3,1.864075287,7095,18,0,882,873,9,40831,40118,713,486,483,3,1,100,NoArch
66c0d13a6b2fd4c04f049aace71a64d3d378b0dc,2,55,41,14,0,0,0,9,20,98,1,2,0.79434669,1132,3,0,111,106,5,7869,7800,69,35,34,1,1,100,NoArch
93c305031fb6c152c118390647f2b9b0979109c2,3,188,13,175,0,0,0,65,255,359,1,2,1.173927368,7408,4,1,572,551,21,33121,32121,1000,544,535,9,1,100,NoArch
760714d9ed4a1323d59b4bb2bf2887f030500019,2,28,4,24,0,0,0,6,12,619,1,2,0.988699408,1860,0,0,82,80,2,7005,6839,166,48,47,1,1,100,NoArch
90530a0a0571513d5358a0dd16197390f492633d,2,29,9,20,0,0,0,6,13,285,1,2,0.485460761,2336,1,1,139,138,1,10042,9974,68,77,76,1,1,100,NoArch
296b84cad4406be03f2db35ce6077ad8fed4fef6,1,14,4,10,0,0,0,4,8,383,1,1,0,284,2,2,21,20,1,1356,1302,54,13,12,1,1,100,NoArch
8169246a4ed1f207f62e252a34aff7589754f531,2,36,0,36,0,0,0,6,14,12,1,2,0.183122068,1940,3,3,74,71,3,7038,6878,160,58,56,2,1,100,NoArch
7e3abc5d67e907acd4d99f61380b521c8c1f5856,1,4,1,3,0,0,0,5,15,583,1,1,0,140,18,0,12,12,0,755,727,28,7,7,0,1,100,NoArch
772413b8cf674de926fdf866d458aaf5f13680f8,10,77,66,11,0,0,0,4,51,362,2,4,2.464890071,5983,1907,0,771,768,3,32048,32030,18,284,280,4,0,100,NoArch
b2e9e6cba1e2ce28368d1281f527a9e53f4628ca,26,751,270,481,2,0,2,4,138,214,3,13,3.881602089,21753,1908,1,2629,2610,19,109733,107772,1961,1396,1373,23,1,91.01981982,Arch
126dc7692d8b3261fba20956093681688e44fe4a,2,41,12,29,0,0,0,29,142,127,1,2,0.993570476,8139,19,1,749,746,3,43786,43621,165,444,443,1,1,100,NoArch
df95257f357e67eac330ba4c6d6bc749851e99fb,2,9,14,5,0,0,0,7,15,184,1,2,0.426228657,2346,20,2,139,139,0,9155,9186,31,77,77,0,1,100,NoArch
9c870eef69ff2a0066125517c635f25857106607,2,83,2,81,0,0,0,5,38,646,1,2,0.410416142,756,0,0,104,95,9,4562,4095,467,66,61,5,1,99.98846331,NoArch
de847c38f3544f9c7282984f32dc1093bdb2fb60,9,50,27,23,0,0,0,3,120,566,3,6,2.724282391,6751,1909,2,465,464,1,39401,39308,93,310,309,1,1,100,NoArch
8c2228eaf8ccc05ae58778276e760092557f78cc,3,77,9,68,0,0,0,29,143,84,1,3,0.845480183,8646,57,0,785,775,10,46359,46010,349,474,467,7,1,100,NoArch
d7b3c83e06e4a63e5cb97c6f93b66795556d53db,7,697,5,692,3,0,3,58,256,80,1,5,1.945752462,20363,58,1,1815,1740,75,88587,85192,3395,1526,1491,35,1,99.31571496,NoArch
350802b59fa68ef1ee074b78af17bf1b2c435e13,10,54,15,39,0,0,0,25,168,290,1,7,3.046951097,25490,19,0,2581,2578,3,124778,124543,235,1087,1084,3,1,99.3513386,NoArch
dfb934aba5ca830066a0d683c888070165283de6,3,132,33,99,0,0,0,3,21,504,1,2,1.224809207,1299,1910,1,169,158,11,6061,5347,714,55,50,5,1,99.8561565,NoArch
e193b18ac23cde8bdac41e3864219ff1e9d6e0c5,2,60,10,50,0,0,0,5,70,24,1,2,0.255242113,3782,1911,2,537,528,9,15329,15033,296,193,191,2,0,100,NoArch
f1309fa3af6826e73377e54081160228eb7ab951,2,55,16,39,0,0,0,7,31,259,1,2,0.312733376,746,1912,3,76,72,4,4094,3847,247,66,63,3,1,100,NoArch
0d1e7a8745a88e308f872d3450a333b319ffeea7,1,0,1,1,0,0,0,5,23,1,1,1,0,913,368,0,118,118,0,3742,3753,11,31,31,0,0,100,NoArch
796675c9b33e0461bc45a72780162d474a4b098b,3,134,42,92,0,0,0,17,207,175,1,2,0.745363902,11613,1,0,1447,1437,10,52728,52317,411,786,778,8,1,100,NoArch
f27875f60fc70d5de022835fb26c63068360f8b4,0,0,0,0,0,0,0,0,0,0,0,0,0,0,1913,3,0,0,0,0,0,0,0,0,0,1,100,NoArch
f7e029fa3548d015f6a9ac3bc5da2a9af6357db6,0,0,0,0,0,0,0,0,0,0,0,0,0,0,1914,4,0,0,0,0,0,0,0,0,0,1,100,NoArch
aedb42e041faff73bfb2d88de95563d04871cfbd,1,1,1,0,0,0,0,4,8,1549,1,1,0,72,0,0,0,0,0,39,39,0,0,0,0,1,100,NoArch
61f8faf590aa2b832d8e11b7fa24fd1bd0c4a7a9,4,140,1,139,0,0,0,7,27,736,1,3,1.669550819,1552,15,0,247,225,22,9468,8410,1058,94,85,9,1,96.57762433,Arch
c96d85ccad32cbdc9b52b5e2488887ed14a1b5ec,2,4,4,0,0,0,0,7,22,395,1,2,1,521,1915,5,55,55,0,2742,2751,9,25,25,0,1,100,NoArch
204b5ab42d9e365c55636cd0aca9f750f4d50e5d,2,33,0,33,0,0,0,63,167,131,1,2,0.884963636,8068,1916,3,786,784,2,35780,35631,149,485,484,1,1,100,NoArch
fd6ffc901ef28bf8408cca28b57eba9f8a204749,0,0,0,0,0,0,0,0,0,0,0,0,0,0,59,0,0,0,0,0,0,0,0,0,0,1,100,NoArch
2741cc5ab39f148917a2b53f023acd34975bb9a2,2,7,9,2,0,0,0,3,3,1584,1,1,0.988699408,81,0,0,0,0,0,181,184,3,0,0,0,0,100,NoArch
cac28e95762532538cd3d0dce9e933ef9e4d5228,2,45,4,41,0,0,0,65,257,308,1,2,0.73001663,7397,75,0,569,564,5,32748,32512,236,548,545,3,1,100,NoArch
95be5be867610e4f194872c431a7ed892d0087d7,0,0,0,0,0,0,0,0,0,0,0,0,0,0,60,1,0,0,0,0,0,0,0,0,0,1,100,NoArch
6a9832c14e7c7c02a0176920b87d15dab474300a,8,92,63,29,0,0,0,41,142,279,1,5,2.674837863,14515,1917,2,1903,1898,5,62872,62872,0,624,624,0,0,100,NoArch
af5444ffdfd9e836b052ee58abec9430d55d4139,3,101,115,14,0,0,0,63,168,84,1,2,1.15379703,9142,1918,3,906,919,13,42760,43135,375,533,529,4,4,100,NoArch
241b6db49c3ca88c9cdf25ddd2c0c8457734a130,6,527,168,359,0,0,0,4,208,144,2,6,1.804869071,22224,1919,4,2278,2231,47,109944,108219,1725,1149,1116,33,1,99.97437376,NoArch
f2c33a60e1e696cbfa25a2d80caf7ee81bba9769,0,0,0,0,0,0,0,0,0,0,0,0,0,0,0,0,0,0,0,0,0,0,0,0,0,0,100,NoArch
60f07118f31776462ea35ffdaa1f46c633251f69,0,0,0,0,0,0,0,0,0,0,0,0,0,0,61,2,0,0,0,0,0,0,0,0,0,1,100,NoArch
