NMF,TotalAddLines,TotalDeleteLines,LC,FileAdd,FileDelete,NAD,NDVE,NUC,AGE,NMS,NMD,Entropy ,MLMF,EXP,REXP,CommitComplexity,LastCommitComplexity,CFC,CommitTokenCount,LastCommitTokenCount,NCC,CommitMethodNum,LastCommitMethodNum,NMC,NIR,a2a,Tag
2,29,2,27,0,0,0,5,5,656,1,2,0.554778163,304,2,2,32,30,2,1370,1237,133,27,25,2,1,100.0,NoArch
2,17,2,15,0,0,0,51,193,20,1,2,0.74248757,9112,4,1,758,757,1,42368,42316,52,537,536,1,1,100.0,NoArch
1,9,4,5,0,0,0,7,9,142,1,1,0.0,114,0,0,8,6,2,608,553,55,3,3,0,1,100.0,NoArch
0,0,0,0,0,0,0,0,0,0,0,0,0.0,0,67,7,0,0,0,0,0,0,0,0,0,0,100.0,NoArch
15,1859,0,1859,15,0,15,1,1,0,1,2,3.624588314,0,0,0,188,0,188,9481,0,9481,99,0,99,1,99.57582185,NoArch
1,6,5,1,0,0,0,1,4,222,1,1,0.0,390,1360,8,53,53,0,1206,1214,8,10,10,0,0,100.0,NoArch
13,128,42,86,0,0,0,1,93,199,1,6,3.351084586,24398,1401,9,1505,1494,11,84023,83603,420,1100,1092,8,1,99.96823044,NoArch
4,43,0,43,0,0,0,64,212,76,1,4,1.185916543,22551,1,0,1218,1215,3,93008,92754,254,859,857,2,1,100.0,NoArch
2,9,1,8,0,0,0,6,29,0,1,2,0.721928095,2775,2,1,338,337,1,12834,12803,31,137,136,1,1,100.0,NoArch
1,27,56,29,0,0,0,2,3,64,1,1,0.0,1122,1784,2,189,193,4,4567,4665,98,84,84,0,0,100.0,NoArch
0,0,0,0,0,0,0,0,0,0,0,0,0.0,0,252,7,0,0,0,0,0,0,0,0,0,0,100.0,NoArch
3,471,448,23,1,0,1,1,97,74,1,1,1.263933805,8544,22,0,490,491,1,28897,28638,259,466,466,0,2,99.89206692,NoArch
0,0,0,0,0,0,0,0,0,0,0,0,0.0,0,293,18,0,0,0,0,0,0,0,0,0,1,100.0,NoArch
1,0,8,8,0,0,0,14,47,56,1,1,0.0,909,8,0,103,104,1,5440,5503,63,57,58,1,1,100.0,NoArch
6,384,4,380,0,0,0,3,55,76,1,5,1.870855227,8883,41,0,1080,998,82,40340,38224,2116,541,521,20,1,100.0,NoArch
1,3,3,0,0,0,0,1,8,647,1,1,0.0,600,1277,7,68,68,0,3156,3154,2,27,27,0,1,100.0,NoArch
0,0,0,0,0,0,0,0,0,0,0,0,0.0,0,1913,3,0,0,0,0,0,0,0,0,0,1,100.0,NoArch
2,242,0,242,1,0,1,48,185,4,1,2,0.902393283,6071,0,0,448,432,16,29131,27947,1184,437,429,8,1,99.97405293,NoArch
2,23,44,21,0,0,0,2,109,331,1,2,0.879458774,3284,74,0,715,715,0,16651,16803,152,411,410,1,1,100.0,NoArch
10,254,39,215,0,0,0,22,100,36,1,9,2.928142039,25284,10,0,2642,2613,29,105686,104448,1238,1292,1284,8,1,100.0,NoArch
2,24,10,14,0,0,0,46,151,63,1,2,0.997502546,9458,44,2,1213,1213,0,42142,42139,3,622,621,1,1,100.0,NoArch
21,2150,27,2123,5,0,5,8,65,147,1,6,2.996052311,13421,78,0,1824,1595,229,72305,58930,13375,705,584,121,1,99.88510699,NoArch
2,105,0,105,0,0,0,41,93,25,1,2,0.615766705,4688,0,0,378,370,8,20851,20439,412,291,284,7,1,100.0,NoArch
0,0,0,0,0,0,0,0,0,0,0,0,0.0,0,54,24,0,0,0,0,0,0,0,0,0,1,100.0,NoArch
6,299,3,296,1,0,1,9,180,322,1,5,0.712674431,6978,1751,1,557,512,45,33680,31957,1723,495,486,9,1,99.97643732,NoArch
0,0,0,0,0,0,0,0,0,0,0,0,0.0,0,177,9,0,0,0,0,0,0,0,0,0,1,100.0,NoArch
2,29,2,27,0,0,0,5,5,656,1,2,0.554778163,304,2,2,32,30,2,1370,1237,133,27,25,2,1,100.0,NoArch
1,8,6,2,0,0,0,3,8,44,1,1,0.0,237,213,5,20,20,0,1159,1127,32,10,10,0,1,100.0,NoArch
5,82,24,58,0,0,0,8,25,55,1,3,1.653389565,1253,37,0,137,128,9,5503,5298,205,37,30,7,1,100.0,NoArch
6,39,24,15,0,0,0,7,98,499,2,3,2.121595577,9313,180,12,526,524,2,32053,31906,147,489,487,2,1,100.0,NoArch
1,37,10,27,0,0,0,14,68,36,1,1,0.0,2965,127,2,328,325,3,14183,14102,81,103,101,2,1,100.0,NoArch
0,0,0,0,0,0,0,0,0,0,0,0,0.0,0,340,3,0,0,0,0,0,0,0,0,0,0,100.0,NoArch
6,27,9,18,0,0,0,4,33,234,1,4,2.526111893,9533,1312,10,1361,1358,3,44818,44768,50,537,536,1,0,100.0,NoArch
2,31,11,20,0,0,0,10,71,42,1,2,0.973668065,7928,1286,6,571,566,5,35356,35278,78,369,369,0,1,100.0,NoArch
8,46,45,1,0,0,0,4,20,32,1,1,2.984063905,2206,11,1,107,107,0,9843,9701,142,76,76,0,1,100.0,NoArch
3,65,6,59,0,0,0,3,85,81,1,1,0.949029153,8876,1353,9,689,683,6,38404,38174,230,465,461,4,0,100.0,NoArch
2,85,11,74,0,0,0,44,98,8,1,2,0.998747298,4389,0,0,323,319,4,17416,17123,293,284,283,1,1,99.9890495,NoArch
1,0,136,136,0,1,1,3,7,94,1,1,0.0,136,0,0,0,14,14,0,549,549,0,12,12,1,99.9534288,NoArch
9,102,19,83,0,0,0,19,95,364,1,6,2.600414941,13929,0,0,1667,1658,9,62033,61697,336,878,875,3,1,100.0,NoArch
0,0,0,0,0,0,0,0,0,0,0,0,0.0,0,1381,11,0,0,0,0,0,0,0,0,0,0,100.0,NoArch
3,32,0,32,0,0,0,43,95,77,1,3,1.247556249,5697,0,0,508,504,4,22439,22256,183,361,359,2,1,99.92088608,NoArch
2,17,11,6,0,0,0,45,117,97,1,2,0.491237342,10097,16,2,492,492,0,34993,34961,32,439,439,0,1,100.0,NoArch
0,0,0,0,0,0,0,0,0,0,0,0,0.0,0,93,12,0,0,0,0,0,0,0,0,0,0,100.0,NoArch
6,146,28,118,0,0,0,58,154,184,1,5,1.553280862,10831,0,0,1211,1199,12,48838,48373,465,683,676,7,1,100.0,NoArch
15,826,102,724,3,0,3,1,6,19,1,4,3.047304129,4515,68,9,720,661,59,25337,21908,3429,364,329,35,1,99.54594595,NoArch
3,90,4,86,0,0,0,8,22,66,1,2,0.288400914,1550,4,2,162,158,4,9839,9342,497,43,41,2,1,100.0,NoArch
7,52,5,47,0,0,0,8,89,111,1,5,2.180036168,32262,1396,6,2491,2490,1,118381,118168,213,1321,1320,1,1,100.0,NoArch
6,155,6,149,0,0,0,57,163,20,1,5,1.753225677,13255,2,0,833,822,11,61972,60997,975,464,459,5,2,100.0,NoArch
43,267,303,36,1,0,1,4,206,234,4,23,4.232244076,33921,1901,2,4134,4138,4,168479,168707,228,1747,1751,4,1,99.9657135,NoArch
0,0,0,0,0,0,0,0,0,0,0,0,0.0,0,1363,8,0,0,0,0,0,0,0,0,0,0,100.0,NoArch
1,15,9,6,0,0,0,22,66,53,1,1,0.0,1992,16,0,275,274,1,8984,8963,21,73,73,0,1,100.0,NoArch
2,111,0,111,0,0,0,18,60,186,1,2,0.956888666,1864,0,0,161,155,6,9440,8833,607,103,99,4,1,100.0,NoArch
3,82,4,78,0,0,0,5,12,567,1,3,0.521949079,1287,3,0,89,87,2,5953,5455,498,60,59,1,1,100.0,NoArch
15,67,60,7,0,0,0,2,58,421,2,11,3.441132056,13325,1384,2,1406,1405,1,61664,61564,100,473,472,1,0,100.0,NoArch
1,31,11,20,0,0,0,45,118,1,1,1,0.0,9207,17,3,492,492,0,30701,30664,37,439,439,0,1,100.0,NoArch
3,10,6,4,0,0,0,6,32,36,1,3,1.405639062,3131,4,3,355,354,1,14435,14417,18,147,147,0,1,100.0,NoArch
7,239,35,204,1,0,1,3,28,23,1,4,1.954782421,2332,61,5,256,241,15,10719,9927,792,128,118,10,1,99.97132822,NoArch
1,16,11,5,0,0,0,9,20,83,1,1,0.0,698,228,17,76,75,1,2590,2552,38,23,23,0,0,100.0,NoArch
1,239,215,24,0,0,0,2,7,2259,1,1,0.0,354,1779,4,40,31,9,1631,1435,196,33,28,5,0,100.0,NoArch
2,55,16,39,0,0,0,7,31,259,1,2,0.312733376,746,1912,3,76,72,4,4094,3847,247,66,63,3,1,100.0,NoArch
3,94,1,93,0,0,0,9,26,448,1,2,1.49726324,1362,0,0,112,104,8,5523,5136,387,85,81,4,1,100.0,NoArch
0,0,0,0,0,0,0,0,0,0,0,0,0.0,0,23,1,0,0,0,0,0,0,0,0,0,1,100.0,NoArch
4,86,47,39,0,0,0,5,25,0,1,2,1.624356258,7479,1391,9,361,365,4,18317,18220,97,308,310,2,2,100.0,NoArch
11,68,97,29,0,0,0,6,110,21,3,6,2.915187223,15338,4,0,1847,1846,1,74723,74794,71,686,685,1,1,100.0,NoArch
5,117,4,113,0,0,0,11,32,296,1,4,1.55427429,2078,0,0,227,216,11,13058,12397,661,75,69,6,1,100.0,NoArch
10,30,15,15,0,0,0,9,67,431,3,6,2.957448599,10182,1275,7,905,905,0,41623,41609,14,594,594,0,1,100.0,NoArch
1,66,10,56,0,0,0,1,9,630,1,1,0.0,519,1351,7,41,41,0,5146,4559,587,37,37,0,0,100.0,NoArch
1,0,16,16,0,1,1,1,2,47,1,1,0.0,16,198,9,0,0,0,0,0,0,0,0,0,0,99.98423459,NoArch
10,55,10,45,0,0,0,3,202,584,4,7,2.705339929,13618,3,0,1142,1138,4,64555,64272,283,814,811,3,1,100.0,NoArch
7,184,38,146,0,0,0,39,91,86,1,4,2.349161754,7922,1758,3,945,928,17,36933,36439,494,469,461,8,1,100.0,NoArch
0,0,0,0,0,0,0,0,0,0,0,0,0.0,0,52,22,0,0,0,0,0,0,0,0,0,0,100.0,NoArch
2,42,11,31,0,0,0,11,29,23,1,1,0.979098167,1047,3,3,149,146,3,5125,4968,157,41,39,2,1,99.94986352,NoArch
0,0,0,0,0,0,0,0,0,0,0,0,0.0,0,55,25,0,0,0,0,0,0,0,0,0,0,100.0,NoArch
2,54,1,53,0,0,0,3,14,525,1,2,0.999761525,1701,1308,6,135,129,6,11118,10822,296,82,81,1,0,100.0,NoArch
0,0,0,0,0,0,0,0,0,0,0,0,0.0,0,28,1,0,0,0,0,0,0,0,0,0,1,100.0,NoArch
5,4,11,7,0,0,0,6,22,295,1,2,2.256564762,784,56,0,73,76,3,3431,3518,87,50,50,0,1,100.0,NoArch
0,0,0,0,0,0,0,0,0,0,0,0,0.0,0,50,0,0,0,0,0,0,0,0,0,0,0,100.0,NoArch
1,42,40,2,0,0,0,59,158,103,1,1,0.0,5793,1889,0,372,372,0,22611,22611,0,361,361,0,0,100.0,NoArch
7,726,93,633,0,0,0,1,7,152,1,5,1.69973603,20865,89,3,3366,3314,52,112827,110398,2429,1859,1832,27,1,100.0,NoArch
0,0,0,0,0,0,0,0,0,0,0,0,0.0,0,349,12,0,0,0,0,0,0,0,0,0,0,100.0,NoArch
0,0,0,0,0,0,0,0,0,0,0,0,0.0,0,76,9,0,0,0,0,0,0,0,0,0,1,100.0,NoArch
2,242,0,242,1,0,1,48,185,4,1,2,0.902393283,6071,0,0,448,432,16,29131,27947,1184,437,429,8,1,99.97405293,NoArch
5,1130,1031,99,2,0,2,1,70,59,1,2,1.536949253,8565,1281,9,546,544,2,37665,37130,535,415,413,2,0,93.21990533,Arch
4,105,0,105,0,0,0,1,12,309,1,4,1.868140431,2553,1282,10,490,464,26,12939,12253,686,296,283,13,1,96.11226133,Arch
4,72,39,33,0,0,0,1,20,623,1,2,1.338755522,2787,1284,4,346,341,5,11768,11565,203,102,101,1,1,88.72864744,Arch
4,858,826,32,1,0,1,1,19,106,1,2,1.511903578,2837,1292,9,464,463,1,16825,16767,58,166,165,1,0,96.01843318,Arch
5,200,1021,821,0,0,0,4,20,11,1,3,1.216132395,3017,1293,10,319,464,145,12389,17499,5110,136,166,30,0,88.77961556,Arch
16,230,181,49,0,0,0,4,31,303,1,3,3.397695943,7077,1303,1,519,511,8,23696,23698,2,187,189,2,1,86.60856935,Arch
18,357,120,237,0,0,0,1,23,417,1,8,3.46850685,12628,1306,4,1975,1937,38,65630,64315,1315,850,837,13,1,85.50157918,Arch
39,404,445,41,0,0,0,6,47,492,1,12,4.590492059,33333,1313,11,4031,4034,3,132708,132222,486,1611,1610,1,1,94.76685251,Arch
80,3606,1721,1885,4,0,4,4,80,451,1,22,4.285161172,67395,1320,18,7176,6915,261,295314,284362,10952,3500,3328,172,2,97.226831,Arch
10,232,142,90,1,0,1,4,81,0,1,4,2.379763201,17425,1321,19,1555,1544,11,75035,74470,565,699,693,6,1,97.30726257,Arch
8,276,98,178,0,0,0,6,55,347,1,6,2.173850287,20598,17,0,1701,1679,22,76656,75849,807,779,773,6,1,96.12491452,Arch
37,1418,198,1220,3,0,3,1,57,112,1,7,3.194714865,17647,1356,9,2175,2029,146,88051,80794,7257,926,868,58,1,96.7308667,Arch
24,618,119,499,1,0,1,3,86,443,1,11,3.586947405,27079,1358,6,2325,2288,37,116680,113859,2821,1106,1087,19,1,91.1152648,Arch
189,0,0,0,0,0,0,1,1,0,1,24,0.0,78649,37,7,11495,11495,0,377829,377829,0,6640,6640,0,1,90.48570358,Arch
5,214,0,214,1,0,1,7,38,52,1,5,2.208871181,20896,0,0,1093,1083,10,65299,64537,762,781,777,4,1,87.39082969,Arch
10,324,381,57,0,1,1,7,39,145,1,7,2.588520944,26629,1368,13,1594,1596,2,88846,88602,244,974,970,4,1,87.39082969,Arch
17,2431,12,2419,12,0,12,1,30,150,2,5,2.749253494,2776,1390,8,690,377,313,24808,13112,11696,289,175,114,1,89.75646229,Arch
10,132,1,131,1,0,1,8,40,313,1,8,2.143787424,26307,0,0,1961,1952,9,95265,94771,494,1158,1151,7,1,94.80812641,Arch
4,296,323,27,0,0,0,4,28,651,2,4,1.364616916,4117,1403,3,432,428,4,22419,22547,128,228,222,6,0,95.99236641,Arch
15,232,80,152,1,0,1,1,8,104,1,7,3.28740704,23473,98,9,3758,3741,17,122442,121735,707,2085,2076,9,1,97.34291253,Arch
22,1211,167,1044,1,0,1,24,92,62,1,8,3.200858714,41462,3,0,4003,3890,113,169370,164952,4418,2006,1910,96,1,94.65611686,Arch
231,0,99586,99586,0,231,231,1,14,722,1,27,5.176749487,99586,128,3,0,13906,13906,0,493196,493196,0,8035,8035,1,85.52667957,Arch
15,753,163,590,0,0,0,24,94,214,1,11,2.83058769,35711,6,0,2927,2887,40,134497,131993,2504,1410,1393,17,1,92.44450978,Arch
6,400,197,203,0,0,0,6,36,14,1,2,1.545002885,4169,6,3,517,506,11,20210,19435,775,196,187,9,1,87.9767379,Arch
19,2092,131,1961,2,1,3,8,66,99,1,9,2.189147061,17299,79,1,2259,2005,254,96853,87116,9737,923,849,74,1,95.20746626,Arch
42,1498,1164,334,3,5,8,3,68,687,2,19,4.518925268,41790,1585,3,4948,4800,148,186950,182145,4805,1796,1770,26,1,93.77222159,Arch
3,0,159,159,0,1,1,4,13,58,1,3,0.775868637,486,15,0,25,45,20,1281,1723,442,17,25,8,1,94.07953684,Arch
12,204,26,178,0,0,0,3,143,190,3,10,2.980534882,22095,2,0,2595,2589,6,105977,104953,1024,1243,1237,6,1,88.03808768,Arch
7,152,25,127,1,0,1,5,158,496,2,4,2.32160172,18193,22,3,1603,1595,8,71272,70735,537,735,732,3,1,94.01921289,Arch
3,102,3,99,0,0,0,6,13,1320,1,2,1.051909558,1267,0,0,125,116,9,6181,5690,491,81,72,9,1,91.6098166,Arch
13,105,74,31,0,0,0,10,84,123,2,7,3.253598581,10637,19,1,1063,1058,5,53573,53353,220,597,595,2,1,87.83407285,Arch
16,524,36,488,5,0,5,19,74,332,1,10,3.364279927,4935,15,0,644,604,40,29362,26641,2721,359,333,26,1,95.62404423,Arch
31,1683,89,1594,6,0,6,2,187,737,2,16,3.885376831,30045,1761,6,3274,3122,152,149106,141108,7998,1815,1723,92,1,97.84222738,Arch
17,619,289,330,2,0,2,3,161,304,2,8,2.927593771,34695,25,2,2374,2339,35,128788,127770,1018,1491,1469,22,1,94.89396035,Arch
4,74,1,73,0,0,0,54,163,98,1,3,1.693803449,12413,0,0,606,602,4,42398,41990,408,509,505,4,1,84.91068035,Arch
5,193,63,130,1,0,1,6,12,350,2,3,1.849274276,995,9,1,143,135,8,6403,5718,685,47,40,7,1,84.37935844,Arch
42,7139,55,7084,23,0,23,1,123,209,2,16,4.148998498,30206,0,0,4280,3618,662,166480,132544,33936,2097,1790,307,1,91.47075967,Arch
58,3803,247,3556,8,0,8,3,194,635,3,15,4.114271476,60751,28,2,5838,5357,481,267062,250626,16436,3143,3021,122,1,87.8793851,Arch
8,705,22,683,1,0,1,7,81,59,2,5,2.384129889,6765,0,0,699,650,49,38306,35022,3284,403,382,21,2,89.83151931,Arch
4,52,116,64,0,0,0,3,11,18,1,1,1.998977353,1008,23,1,103,105,2,5613,6045,432,34,36,2,1,89.63116575,Arch
10,130,109,21,0,0,0,55,166,864,1,4,2.86367671,13002,31,3,699,708,9,43411,43297,114,515,514,1,1,89.75191583,Arch
12,389,62,327,3,0,3,6,94,58,2,8,2.777262775,8140,1,0,652,627,25,45206,43691,1515,259,246,13,1,92.78823529,Arch
16,8723,9438,715,0,0,0,2,168,384,2,4,1.204671623,37355,1769,4,2256,2244,12,149832,136291,13541,1848,1834,14,1,92.60306457,Arch
2,77,5,72,0,0,0,2,11,669,1,2,0.839004061,255,13,1,20,18,2,1602,1089,513,12,11,1,1,83.36933045,Arch
7,209,28,181,0,0,0,6,149,660,2,4,1.809845364,9422,34,0,1192,1185,7,48821,47921,900,344,337,7,1,90.35784145,Arch
6,90,14,76,0,0,0,6,150,34,2,3,1.998847471,7805,35,1,986,982,4,37768,37595,173,278,276,2,1,88.71156092,Arch
8,1104,637,467,0,0,0,14,69,307,1,5,1.503906753,5666,19,3,596,549,47,28174,25743,2431,303,286,17,1,92.09194433,Arch
6,392,176,216,1,0,1,23,66,357,1,3,2.125413806,5063,43,5,489,481,8,28409,27440,969,314,308,6,1,86.81229773,Arch
3,212,17,195,0,0,0,5,17,659,1,2,1.345856883,1118,5,0,189,155,34,6476,5509,967,108,93,15,1,89.91112413,Arch
49,2323,102,2221,13,0,13,4,152,427,2,19,4.482306742,40822,45,2,4946,4762,184,196644,187848,8796,2013,1900,113,1,87.58642363,Arch
17,463,308,155,1,0,1,9,93,345,1,8,2.323305003,13138,13,2,1972,1960,12,74222,73708,514,817,809,8,1,95.07901303,Arch
2,54,1,53,0,0,0,19,78,10,1,2,0.994030211,5009,9,1,500,494,6,21465,21217,248,282,278,4,1,91.93746706,Arch
26,1811,791,1020,1,0,1,5,137,42,5,12,2.677238064,31142,1787,5,2133,2014,119,130874,126887,3987,1328,1281,47,2,88.63355135,Arch
3,15,6,9,0,0,0,7,18,99,1,2,1.493709546,1412,32,1,129,129,0,6550,6463,87,84,84,0,1,97.76520099,Arch
8,542,137,405,3,0,3,6,15,82,1,2,2.644488593,1209,3,0,137,135,2,7664,6227,1437,75,61,14,1,97.63277488,Arch
15,259,28,231,0,0,0,4,112,86,2,8,3.241963322,22335,1804,4,2581,2562,19,114569,113443,1126,1111,1099,12,1,96.22563537,Arch
21,116,102,14,0,0,0,5,215,80,2,10,3.768467448,28454,74,7,2168,2172,4,134289,134190,99,1469,1468,1,1,85.66090612,Arch
5,13,28,15,0,0,0,54,167,89,1,4,1.391553521,13158,79,10,1374,1376,2,60849,61012,163,633,633,0,2,88.23698591,Arch
4,229,36,193,1,0,1,54,125,94,1,3,1.499274285,5241,1,0,378,364,14,21541,20749,792,347,339,8,1,89.35245845,Arch
2,38,57,19,0,0,0,49,140,117,1,2,0.846701712,9498,82,12,542,551,9,39081,39248,167,472,473,1,1,95.1849677,Arch
13,2972,2648,324,10,1,11,13,48,11,1,4,2.127032357,3816,158,0,415,765,350,20560,33021,12461,112,168,56,1,93.64788117,Arch
3,72,8,64,0,0,0,9,72,41,1,1,1.438758681,2715,34,0,374,357,17,12311,11933,378,88,86,2,1,87.43566455,Arch
4,51,8,43,0,0,0,3,168,153,1,3,1.608939479,9993,95,9,1261,1256,5,45342,45129,213,646,642,4,1,88.23988214,Arch
33,372,170,202,0,0,0,7,186,200,1,13,3.459149536,38318,98,0,3983,3980,3,168297,167705,592,1688,1684,4,1,93.97590361,Arch
4,333,1,332,1,0,1,55,136,63,1,3,1.003156937,7150,8,0,705,657,48,30306,28694,1612,452,435,17,1,93.99286409,Arch
3,89,6,83,0,0,0,9,25,105,1,2,0.870425609,1500,0,0,151,142,9,7110,6634,476,98,91,7,1,87.0610687,Arch
2,344,300,44,1,0,1,25,80,0,1,1,0.997988442,1732,47,7,250,249,1,8217,7998,219,68,67,1,1,87.0610687,Arch
2,125,0,125,1,0,1,1,11,162,1,2,0.671247885,242,0,0,28,24,4,2359,1394,965,8,5,3,1,94.88633236,Arch
11,313,59,254,2,0,2,57,190,132,1,5,2.894035512,20211,8,0,1498,1474,24,94096,92790,1306,757,741,16,1,95.98693133,Arch
3,26,21,5,0,0,0,12,84,25,1,1,1.369325224,2271,4,0,312,310,2,9628,9613,15,82,81,1,1,93.06776297,Arch
12,323,70,253,0,0,0,3,86,215,1,7,3.023552963,6353,1,0,900,886,14,27993,25893,2100,401,395,6,1,97.95357781,Arch
91,177,97,80,1,0,1,58,226,311,1,4,5.767079444,29678,59,8,2582,2575,7,138968,138609,359,1137,1134,3,2,95.41279001,Arch
16,206,117,89,0,0,0,56,162,169,1,10,3.426745655,34113,1881,5,3541,3526,15,159919,159455,464,1469,1463,6,2,92.42627346,Arch
1015,13407,8252,5155,3,0,3,3,234,166,17,83,8.87987298,340854,345,8,40982,40709,273,1611606,1568283,43323,18517,18414,103,1,80.91717561,Arch
2,51,19,32,0,0,0,56,176,76,1,2,0.881290899,10078,0,0,556,555,1,41568,41485,83,493,492,1,1,89.85292909,Arch
11,192,22,170,0,0,0,68,222,72,1,7,2.954124022,43713,9,1,2888,2869,19,184866,183961,905,1710,1703,7,1,95.15792309,Arch
10,1311,2,1309,4,0,4,1,121,153,2,7,2.310409742,7520,73,0,873,777,96,48326,42001,6325,405,352,53,1,92.56323141,Arch
2,76,7,69,0,0,0,61,161,75,1,2,0.991501787,7961,0,0,781,775,6,35411,35055,356,481,478,3,1,96.05336298,Arch
7,87,25,62,0,0,0,11,32,587,1,2,2.134561173,2209,1905,0,260,252,8,12115,11745,370,138,131,7,1,92.98310292,Arch
7,209,69,140,0,0,0,8,236,182,2,6,1.796386177,16057,1,0,1256,1243,13,74646,74154,492,839,828,11,1,87.77148975,Arch
26,751,270,481,2,0,2,4,138,214,3,13,3.881602089,21753,1908,1,2629,2610,19,109733,107772,1961,1396,1373,23,1,91.01981982,Arch
4,140,1,139,0,0,0,7,27,736,1,3,1.669550819,1552,15,0,247,225,22,9468,8410,1058,94,85,9,1,96.57762433,Arch
