CommitID,NMF,TotalAddLines,TotalDeleteLines,LC,FileAdd,FileDelete,NAD,NDVE,NUC,AGE,NMS,NMD,Entropy ,MLMF,EXP,REXP,CommitComplexity,LastCommitComplexity,CFC,CommitTokenCount,LastCommitTokenCount,NCC,CommitMethodNum,LastCommitMethodNum,NFC,NIR,a2a,Tag
bb46d2b5757bea4e3513ff261f6e1a1d3afeb4e4,0,0,0,0,0,0,0,0,0,0,0,0,0,0,130,19,0,0,0,0,0,0,0,0,0,0,100,NoArch
354338f2d726f7765abe5bc4c6203f29357ffc2f,0,0,0,0,0,0,0,0,0,0,0,0,0,0,131,20,0,0,0,0,0,0,0,0,0,0,100,NoArch
538b01188b9afe8856856aa8fada631e20f7a242,0,0,0,0,0,0,0,0,0,0,0,0,0,0,29,4,0,0,0,0,0,0,0,0,0,0,100,NoArch
cda916fec41ae56597bcab51efa4fa11f23883e7,0,0,0,0,0,0,0,0,0,0,0,0,0,0,132,21,0,0,0,0,0,0,0,0,0,0,100,NoArch
8ce912135a64cda6bea954d271859ba5f0380a38,0,0,0,0,0,0,0,0,0,0,0,0,0,0,133,22,0,0,0,0,0,0,0,0,0,0,100,NoArch
4de5465b83a073c67c2f522da4cd282c9316da43,0,0,0,0,0,0,0,0,0,0,0,0,0,0,159,5,0,0,0,0,0,0,0,0,0,0,100,NoArch
68507effabbb5c0a9134696d84c9241eb788d905,0,0,0,0,0,0,0,0,0,0,0,0,0,0,160,6,0,0,0,0,0,0,0,0,0,0,100,NoArch
550f82fc4e1dd6cfac6893c4f9ae4c82ebde715d,0,0,0,0,0,0,0,0,0,0,0,0,0,0,134,23,0,0,0,0,0,0,0,0,0,0,100,NoArch
95a5998df918babcf4b83160d1309dcc68182788,19,152,210,58,0,0,0,2,9,965,1,14,3.506076496,8633,135,24,818,819,1,27206,27738,532,343,341,2,1,100,NoArch
fbf6150057c99c2835690275f8e83b6c7141809d,30,115,78,37,0,0,0,2,17,617,1,15,3.997108038,14194,136,24,1396,1391,5,42273,42296,23,692,690,2,1,87.41935484,Arch
2fa774c0fd6a2663fb806cf90856d7e2e1131404,1,5,5,0,0,0,0,3,8,38,1,1,0,281,30,5,30,30,0,980,978,2,7,7,0,0,100,NoArch
a304d628fc88a3d897920cd9eded55507dcbbb91,8,136,54,82,0,0,0,1,11,396,1,5,2.218104495,3700,137,21,294,294,0,11613,11261,352,138,138,0,1,91.64196799,Arch
2d19b69231175a3e54f9f83bd23fe558b22216f7,1,61,1,60,0,0,0,3,8,3,1,1,0,496,31,6,64,53,11,1311,1109,202,38,36,2,1,100,NoArch
e3ec64ae9d68067a5083793d0181c70f61aac329,9,92,51,41,0,0,0,2,7,697,1,5,2.590799324,3434,138,21,304,303,1,10656,10390,266,155,154,1,1,100,NoArch
75479bf492f5ab13c2faf45f9acba6f895917c2e,7,33,26,7,0,0,0,1,12,89,1,6,2.461648942,3553,139,22,281,281,0,11372,11394,22,114,114,0,1,100,NoArch
cb884efb305197fb2db2c843bc7561a22739a6b7,2,13,25,12,0,0,0,3,9,43,1,1,0.789749254,739,32,4,78,78,0,3570,3589,19,29,29,0,1,100,NoArch
fb86275eff8440eaf396f76e92094525dbfc7ec2,4,360,0,360,2,0,2,1,20,124,1,4,1.563858285,1142,33,4,83,56,27,4649,3736,913,44,26,18,1,90.26465028,Arch
dbc1949bfef2ce9d5c75e741ddc1291e84d80491,6,152,1,151,0,0,0,2,2,1578,1,1,1.99046939,635,34,4,66,46,20,2406,1620,786,38,28,10,0,100,NoArch
afee2667a0cdeb748c1a862487f60b13665bad83,11,79,43,36,1,0,1,1,11,75,1,8,2.798254271,3755,140,6,342,340,2,11102,11047,55,168,168,0,1,86.24067164,Arch
5afdb2b00213e8784893871ec9ad085c9267cdf5,1,16,4,12,0,0,0,1,4,0,1,1,0,223,141,7,19,19,0,427,427,0,14,14,0,1,100,NoArch
129fb8f99c61424a5d0530f2c791ce228735dccc,2,28,0,28,0,0,0,1,10,13,1,2,0.491237342,1322,142,8,84,82,2,3948,3895,53,40,38,2,1,100,NoArch
83bd53eef62d99bb54b5c5bde04870789f8f13c9,2,34,2,32,0,0,0,4,14,921,1,2,0.811278124,298,161,0,25,22,3,1492,1227,265,10,9,1,1,85.54465669,Arch
b466bf4d456b49163598c64ec95637bbfcd0b4ab,1,8,1,7,0,0,0,2,3,143,1,1,0,307,162,1,36,36,0,1338,1302,36,6,6,0,1,100,NoArch
ec073a47cfb55cff958874b2289982e631c4acd8,1,20,0,20,0,0,0,2,3,38,1,1,0,628,163,2,70,68,2,1872,1831,41,32,30,2,1,100,NoArch
67e02405a8f242c8d9e77c135af57f6716671379,1,20,8,12,0,0,0,4,7,38,1,1,0,1345,164,3,139,135,4,3104,3039,65,85,85,0,1,100,NoArch
f7d880936e73d4432f1b37097d0e3d7ac28acf79,0,0,0,0,0,0,0,0,0,0,0,0,0,0,165,4,0,0,0,0,0,0,0,0,0,1,100,NoArch
27952949ebc4691a0386546bd6250a4e91ddd3ad,12,2005,35,1970,9,0,9,2,3,290,1,4,3.063048698,218,166,5,224,11,213,6310,518,5792,113,9,104,1,92.19108865,Arch
b7452e8f030c4f3ce52d82651ae08736059b12fd,0,0,0,0,0,0,0,0,0,0,0,0,0,0,167,6,0,0,0,0,0,0,0,0,0,1,100,NoArch
d5a655e59a44ee6e18b7734d5dec62718d35bfa4,0,0,0,0,0,0,0,0,0,0,0,0,0,0,168,7,0,0,0,0,0,0,0,0,0,1,100,NoArch
21bdd261315929dabd9ec89e6874cf5bd9ae80ae,1,4,5,1,0,0,0,2,5,47,1,1,0,289,169,8,33,33,0,973,989,16,11,11,0,1,100,NoArch
610896d06864e5e790156d7c301b7c04c8f8735a,3,63,6,57,0,0,0,3,12,229,1,3,1.104505625,1736,170,9,143,137,6,5858,5559,299,47,47,0,1,99.86950848,NoArch
c7531de2afa24f6676bbfe8cec7a97ef844459fe,2,6,9,3,0,0,0,2,12,14,1,2,0.721928095,1362,171,10,84,84,0,3972,3984,12,40,40,0,1,100,NoArch
85da3701723d5a4a2fc92633fddec090130c206c,0,0,0,0,0,0,0,0,0,0,0,0,0,0,172,11,0,0,0,0,0,0,0,0,0,1,100,NoArch
73cba2e223358231aa1d660f654a9724fad4589c,0,0,0,0,0,0,0,0,0,0,0,0,0,0,173,12,0,0,0,0,0,0,0,0,0,1,100,NoArch
ad785a16eaa889fbf381b8154ce3d517edf57ba9,0,0,0,0,0,0,0,0,0,0,0,0,0,0,174,13,0,0,0,0,0,0,0,0,0,1,100,NoArch
e2ab852065f54fe1d1b48c7bdd399c29952be64a,2,48,2,46,0,0,0,4,21,52,1,2,0.327444919,1066,0,0,106,101,5,5046,4752,294,51,50,1,1,98.08035714,NoArch
1c895d4d80cb2a316bc400aea74a041258b9cf9b,0,0,0,0,0,0,0,0,0,0,0,0,0,0,175,14,0,0,0,0,0,0,0,0,0,1,100,NoArch
ef96ff4f7709395c6d555760c8b536176a240080,2,9,1,8,0,0,0,2,3,1088,1,1,0.721928095,715,0,0,74,73,1,1974,1960,14,42,41,1,1,100,NoArch
c674583bb5ae66550a948ca079e6c5c900b76b4f,0,0,0,0,0,0,0,0,0,0,0,0,0,0,35,0,0,0,0,0,0,0,0,0,0,0,100,NoArch
e36246c39a3f2fdcd4da8af314bae581d6216420,26,6639,0,6639,26,0,26,1,1,0,1,4,4.165297071,0,143,0,563,0,563,17052,0,17052,379,0,379,1,96.17633828,Arch
0faacab9509fa0c2b407f8efb4ef018ef7bdd499,63,14422,0,14422,63,0,63,1,1,0,1,11,5.573307169,0,144,1,1311,0,1311,50633,0,50633,751,0,751,1,87.32851986,Arch
200b100383815e85366e2b06caa6ab62c2430633,459,0,0,0,0,0,0,1,1,0,1,58,0,90916,145,2,7645,7645,0,272555,272555,0,3787,3787,0,1,44.33153382,Arch
30c146cbb9e1e56df9694894486f7b7b99861c0c,0,0,0,0,0,0,0,0,0,0,0,0,0,0,146,3,0,0,0,0,0,0,0,0,0,1,100,NoArch
e2fdf8eea57fd2a6eb6685a62e328ec002eab2d4,0,0,0,0,0,0,0,0,0,0,0,0,0,0,147,4,0,0,0,0,0,0,0,0,0,1,100,NoArch
a932c25004508b19b3c9971d96afe2fd84a59a95,0,0,0,0,0,0,0,0,0,0,0,0,0,0,148,5,0,0,0,0,0,0,0,0,0,1,100,NoArch
11b6535639da9c62ea873f4d88f97311e895342f,2,5,4,1,0,0,0,2,2,4,1,1,0.764204507,564,176,13,106,106,0,3112,3122,10,20,20,0,1,100,NoArch
d7cc17b617d5fd6010f074324b6469eb54c78873,1,19,23,4,0,0,0,2,2,14,1,1,0,81,177,11,1,3,2,367,353,14,1,1,0,1,100,NoArch
bbafda62156b87e1d7acdec1d2b7e8d34db4fd64,4,82,37,45,0,0,0,2,2,16,1,2,1.842843286,1930,1,1,160,160,0,5897,5680,217,74,74,0,0,100,NoArch
275ec5f86e7b54d176ed3d55f8725809180dcc5b,3,19,9,10,0,0,0,2,3,10,1,2,1.572245179,1102,2,2,49,49,0,3111,3073,38,27,27,0,0,100,NoArch
2ca477eaa24d215c3ec91299de67d75b0151a2f9,3,40,8,32,0,0,0,2,3,0,1,1,0.74299334,1121,3,3,136,130,6,3483,3402,81,64,63,1,0,100,NoArch
5227ed24dd739c624a2a610ee29f356e5e550bc4,1,1,1,0,0,0,0,2,2,17,1,1,0,174,4,4,17,17,0,413,413,0,12,12,0,0,100,NoArch
7b72921a8c318f5b45c4d5b6f108f057f6f692d9,2,158,0,158,2,0,2,1,1,0,1,1,0.980377509,0,5,5,11,0,11,267,0,267,9,0,9,1,99.83492902,NoArch
b87da2753f107c9135f3e54a711cb2d28f042944,6,843,1,842,4,0,4,1,4,0,1,2,2.379628349,1452,6,6,186,98,88,6912,4242,2670,97,50,47,0,93.7037037,Arch
5540eb2ca119a95f537e0f5fd3cb84bd02f250b4,1,15,4,11,0,0,0,2,3,0,1,1,0,174,7,7,19,17,2,452,413,39,13,12,1,0,100,NoArch
3bb63ca167fa8376e157cbcaf1e81857301b9501,0,0,0,0,0,0,0,0,0,0,0,0,0,0,36,1,0,0,0,0,0,0,0,0,0,2,100,NoArch
103195b61da98bd51eddf400398882745f74309d,4,23,29,6,0,0,0,2,2,16,1,3,1.757004141,1441,178,9,116,116,0,4608,4640,32,69,67,2,1,100,NoArch
94a934f3878e525995d4eeb417370ef3186d539a,2,90,5,85,0,0,0,2,2,16,1,2,0.147310667,199,37,2,18,11,7,746,519,227,14,9,5,1,95.10825982,Arch
0fac5aff64463d96704bd115ade9d9ebabe6ac5f,1,49,4,45,0,0,0,2,2,19,1,1,0,435,1,1,62,54,8,2303,2108,195,10,7,3,1,100,NoArch
812a4291d5a258e50f201a8f18d3300952a068da,0,0,0,0,0,0,0,0,0,0,0,0,0,0,149,6,0,0,0,0,0,0,0,0,0,1,100,NoArch
c270e08575f17f24ed0a80f2307403f4caed545e,0,0,0,0,0,0,0,0,0,0,0,0,0,0,150,7,0,0,0,0,0,0,0,0,0,1,100,NoArch
741c5d4481ea0dfad5a463b909d424885f904da0,0,0,0,0,0,0,0,0,0,0,0,0,0,0,151,8,0,0,0,0,0,0,0,0,0,0,100,NoArch
06e36514a0ca46df425856e3a82ea8a7552bd393,0,0,0,0,0,0,0,0,0,0,0,0,0,0,152,9,0,0,0,0,0,0,0,0,0,1,100,NoArch
a01014caab372b04d6a7e6b1c590392a96e074a0,0,0,0,0,0,0,0,0,0,0,0,0,0,0,153,10,0,0,0,0,0,0,0,0,0,0,100,NoArch
3a018f49d447e69c6db87813b6514f7f6e014241,0,0,0,0,0,0,0,0,0,0,0,0,0,0,154,11,0,0,0,0,0,0,0,0,0,0,100,NoArch
de430884f76584becf47f2ad1b5fb7fd05a380d2,0,0,0,0,0,0,0,0,0,0,0,0,0,0,155,12,0,0,0,0,0,0,0,0,0,0,100,NoArch
f98cccc1322157ba704de80aa794290df43abf49,0,0,0,0,0,0,0,0,0,0,0,0,0,0,179,0,0,0,0,0,0,0,0,0,0,0,100,NoArch
dd6292ed5dbe50457885a0fbf657777f9ca5ec88,632,27593,52765,25172,78,181,259,2,22,144,4,101,7.615329522,113196,159,0,7344,12313,4969,263744,432496,168752,3641,6244,2603,0,16.91331924,Arch
3a9f97708ee5b5328e05133acd44f93992ce89e7,0,0,0,0,0,0,0,0,0,0,0,0,0,0,382,13,0,0,0,0,0,0,0,0,0,0,100,NoArch
3582dda1149b8bd3e4503862bb7b70df3f1cfe42,1,5,0,5,0,0,0,3,13,0,1,1,0,1373,41,0,117,117,0,4066,4055,11,61,61,0,1,100,NoArch
4f454e478da2941fc3f9af59e2db8f0c50679160,1,92,0,92,1,0,1,1,1,0,1,1,0,0,42,1,9,0,9,311,0,311,7,0,7,2,95.00648508,Arch
02b4a23766bdd7d2aa9a34339c936d2f4a2c1b79,0,0,0,0,0,0,0,0,0,0,0,0,0,0,383,14,0,0,0,0,0,0,0,0,0,0,100,NoArch
77efd21c49cdee9fd70e1287f9899d5dc4eb45ee,9,1130,18,1112,6,0,6,2,8,204,1,6,2.03737802,2887,43,2,553,392,161,12954,8527,4427,180,119,61,1,94.87263227,Arch
88d4df8f5193d9b9973d8a4a51e6d82920cdd2d8,0,0,0,0,0,0,0,0,0,0,0,0,0,0,44,3,0,0,0,0,0,0,0,0,0,1,100,NoArch
6b1e0151679f9e1388209bd746f0187475633f56,0,0,0,0,0,0,0,0,0,0,0,0,0,0,384,15,0,0,0,0,0,0,0,0,0,0,100,NoArch
2f5a3237200566c049cd4cead01f403879a04f4b,1,1,1,0,0,0,0,3,6,78,1,1,0,397,385,16,41,41,0,1447,1443,4,17,17,0,1,100,NoArch
5694d51c17ff27343602387d0751fa58a1eba59e,1,8,1,7,0,0,0,3,7,0,1,1,0,397,386,17,42,41,1,1479,1447,32,17,17,0,1,100,NoArch
d59a25fbe1537683f11c6d0f5ff1ada6897ab588,1,25,5,20,0,0,0,2,8,78,1,1,0,114,387,17,12,10,2,576,472,104,3,3,0,1,100,NoArch
73bc2f4a44636e4c345cfe7dfb26d0e59d8ee05b,0,0,0,0,0,0,0,0,0,0,0,0,0,0,388,11,0,0,0,0,0,0,0,0,0,1,100,NoArch
a38f2abcd8e16a0a6a26946d51699b03ff2ae722,1,1,1,0,0,0,0,2,9,51,1,1,0,134,389,1,12,12,0,578,576,2,3,3,0,1,100,NoArch
9193a7de71b2814565d39232666ded05fa11d990,2,21,3,18,0,0,0,2,12,522,1,2,0.811278124,433,390,1,37,35,2,1626,1548,78,7,7,0,1,100,NoArch
6d4fff188a70148945814f747909b37d908ee692,1,0,5,5,0,0,0,2,4,969,1,1,0,275,391,2,2,2,0,1795,1803,8,2,2,0,1,100,NoArch
711c4f2339022e6788a7ac86df5cd7c54d1fcdab,88,17411,0,17411,88,0,88,1,1,0,1,8,5.783026357,0,392,3,1388,0,1388,55699,0,55699,788,0,788,1,86.79302965,Arch
9a4a8ca5bcc0e061a5891973afd89a975d87fdb5,127,21590,0,21590,127,0,127,1,1,0,1,18,6.476301664,0,393,4,2309,0,2309,88172,0,88172,663,0,663,1,86.20598358,Arch
9bbc5ddadaf118d472ce05a0dcc6e68014be3b6f,0,0,0,0,0,0,0,0,0,0,0,0,0,0,394,5,0,0,0,0,0,0,0,0,0,1,100,NoArch
6d6b54bfb71263510b5a5cb519c74ecabb230348,0,0,0,0,0,0,0,0,0,0,0,0,0,0,395,6,0,0,0,0,0,0,0,0,0,1,100,NoArch
db87291d2a20aeb83de2e7af45701c30a762e40c,1,14,6,8,0,0,0,1,2,0,1,1,0,203,396,7,22,21,1,1111,1047,64,15,14,1,1,100,NoArch
769e774461f76577e388b51e12e271d8954c3416,0,0,0,0,0,0,0,0,0,0,0,0,0,0,397,8,0,0,0,0,0,0,0,0,0,1,100,NoArch
be0722713492a4b45efde4b67b2f82825602475e,0,0,0,0,0,0,0,0,0,0,0,0,0,0,398,9,0,0,0,0,0,0,0,0,0,1,100,NoArch
0528e06166cc5a234b11193eb1da58cb59152be8,0,0,0,0,0,0,0,0,0,0,0,0,0,0,399,10,0,0,0,0,0,0,0,0,0,1,100,NoArch
cd139d3c63c62f65de73d61cc17a6ecabc1b40ba,0,0,0,0,0,0,0,0,0,0,0,0,0,0,400,11,0,0,0,0,0,0,0,0,0,1,100,NoArch
6266b33b8bc610b1eb80178256029d3b83e2410d,0,0,0,0,0,0,0,0,0,0,0,0,0,0,401,12,0,0,0,0,0,0,0,0,0,1,100,NoArch
8dd78def97254b2fe5363f07e8715a698f55d287,0,0,0,0,0,0,0,0,0,0,0,0,0,0,402,13,0,0,0,0,0,0,0,0,0,1,100,NoArch
bafb16079e9cb5f6a268defaa6079aa555874958,0,0,0,0,0,0,0,0,0,0,0,0,0,0,403,14,0,0,0,0,0,0,0,0,0,1,100,NoArch
15c785039888c0734106e274ad5942190864c47b,1,19,14,5,0,0,0,1,2,0,1,1,0,168,404,15,20,19,1,970,950,20,5,5,0,1,100,NoArch
8f10dce4e9d040467ea8ee06590d56c689d44a63,0,0,0,0,0,0,0,0,0,0,0,0,0,0,405,16,0,0,0,0,0,0,0,0,0,1,100,NoArch
14b32c34ae24dd9e5b61e681183dde7c8ade38dd,0,0,0,0,0,0,0,0,0,0,0,0,0,0,406,17,0,0,0,0,0,0,0,0,0,1,100,NoArch
d04f3cfe401477fb67ef0bd6c19c097d4b06d5e8,0,0,0,0,0,0,0,0,0,0,0,0,0,0,407,18,0,0,0,0,0,0,0,0,0,1,100,NoArch
fd778ceb2f206bbe558545e5992617ddc27070ee,0,0,0,0,0,0,0,0,0,0,0,0,0,0,408,19,0,0,0,0,0,0,0,0,0,1,100,NoArch
e1496d4178d211b1db86b737861555bcfcec79da,0,0,0,0,0,0,0,0,0,0,0,0,0,0,24,0,0,0,0,0,0,0,0,0,0,0,100,NoArch
833e21c4a35d39b6ec1cb9f91c4c61ef30951e7f,24,1073,998,75,0,0,0,2,24,448,1,9,4.253468457,9877,25,1,1130,1130,0,33563,33587,24,344,344,0,0,100,NoArch
f15c8860846fbf9ac2058e765e82bc436bbf191d,5,323,88,235,2,0,2,2,2,18,1,1,1.950481637,2095,0,0,275,234,41,9750,8572,1178,64,53,11,0,99.7605364,NoArch
2c37ced71dad336a8afa56445359be12d546e9ab,4,123,30,93,0,0,0,2,2,32,1,3,1.16536752,1572,1,1,78,76,2,6263,5535,728,17,16,1,0,100,NoArch
e44853484e2fc756826ba6784445608153f64983,0,0,0,0,0,0,0,0,0,0,0,0,0,0,0,0,0,0,0,0,0,0,0,0,0,1,100,NoArch
2b896ba37c1f4fdef7f1e36d9255161a4ddb4c50,1,2,1,1,0,0,0,2,2,115,1,1,0,216,1,1,21,21,0,968,955,13,10,10,0,1,100,NoArch
97bc338fe909d5f91b7fcc454604dbb9c27e95fc,0,0,0,0,0,0,0,0,0,0,0,0,0,0,2,2,0,0,0,0,0,0,0,0,0,1,100,NoArch
f6300817d39c0f33ce1f872e18e732cc4b4df43f,1,15,22,7,0,0,0,3,6,41,1,1,0,850,409,0,80,81,1,2518,2561,43,43,43,0,1,100,NoArch
a7d6f1bff99049a7e64fc2c877a14482044ea8f9,1,5,6,1,0,0,0,3,7,0,1,1,0,843,26,0,80,80,0,2509,2518,9,43,43,0,0,100,NoArch
f028738d56b62bd71baaf6a066b46e4162657fc7,1,22,20,2,0,0,0,2,2,218,1,1,0,1446,27,1,109,109,0,8122,8128,6,14,14,0,1,100,NoArch
74dbece608c84c360bd0e90e05d06503c1d81fd7,12,1475,62,1413,9,0,9,1,10,29,1,7,3.097029614,927,28,2,222,96,126,9576,4306,5270,92,25,67,1,95.02676182,Arch
05ee4502358a97345ef652e19ce5c08c9f4308a1,1,1,1,0,0,0,0,2,2,1538,1,1,0,281,45,0,30,30,0,980,980,0,7,7,0,1,100,NoArch
81ed9888200d400fdb4af660bfe78e3d2e5f05ff,1,1,1,0,0,0,0,4,14,49,1,1,0,366,46,1,32,32,0,1341,1327,14,5,5,0,1,100,NoArch
b28968ab17fa8cedda2df7230cf5731f25e98aeb,1,8,7,1,0,0,0,3,7,54,1,1,0,354,410,1,53,53,0,1663,1652,11,3,3,0,1,100,NoArch
13894f5b08d37a0400927b2fb64b2848415d83de,0,0,0,0,0,0,0,0,0,0,0,0,0,0,411,2,0,0,0,0,0,0,0,0,0,2,100,NoArch
486091852e02a08db40eed4d250233a6236c9648,3,407,22,385,1,0,1,3,27,346,1,2,0.996675412,1704,412,3,95,61,34,6502,5204,1298,52,26,26,1,89.68058968,Arch
c5a75b558e8bda023ee9607b9853374a11b82d2e,0,0,0,0,0,0,0,0,0,0,0,0,0,0,413,4,0,0,0,0,0,0,0,0,0,1,100,NoArch
0c6defbf81bfa32c569e0b2e78a04a7cf03393f7,1,3,2,1,0,0,0,2,3,27,1,1,0,217,3,3,21,21,0,986,968,18,10,10,0,1,100,NoArch
8da3cc42b849f3ade4c2476b9636d2fa4b9488d9,0,0,0,0,0,0,0,0,0,0,0,0,0,0,4,4,0,0,0,0,0,0,0,0,0,1,100,NoArch
ab4c8cf41eb78be17ff79f96b0f8dd6e4d7e2208,4,357,68,289,2,0,2,1,4,3,1,2,1.620421967,687,414,5,88,65,23,3269,2348,921,55,41,14,1,99.16117436,NoArch
f28ee9f0eaadf2cd45d0b4656a001eae2abbe459,6,160,5,155,2,0,2,1,13,762,1,3,2.221233204,1047,415,6,99,90,9,4310,3731,579,43,39,4,1,89.21617574,Arch
db74b14d0f52e4c4020a1976a4ba24a9f188ac66,2,27,29,2,0,0,0,1,2,6,1,1,0.838372938,421,416,7,38,38,0,1413,1369,44,26,26,0,1,100,NoArch
11983ec4bd0e570165e275c17852630fba8e6e82,6,840,59,781,4,0,4,1,28,8,1,3,2.336608118,1773,417,7,127,66,61,7599,5647,1952,65,28,37,1,97.96007896,Arch
60be6d745fd226f79c4f472b5eecad0d186766f4,1,2,2,0,0,0,0,1,2,0,1,1,0,162,418,8,14,14,0,376,376,0,10,10,0,1,100,NoArch
a8245fa85261aa6a8423fabd733735a85e64b69b,1,134,80,54,0,0,0,2,2,101,1,1,0,376,2,0,64,55,9,1919,1674,245,8,6,2,0,100,NoArch
8933ad8d58084ac690bdc10e7074edefffc2ca76,2,48,39,9,0,0,0,2,4,780,1,1,0.929363626,503,419,9,45,46,1,1505,1533,28,23,23,0,1,100,NoArch
da8f684647550108587beed2060838aff62175e3,1,1,1,0,0,0,0,2,16,783,1,1,0,713,420,6,56,56,0,2360,2360,0,34,34,0,1,100,NoArch
b0b9618ae0a9f9d63381eb159ef55de4990580b4,1,6,2,4,0,0,0,2,10,650,1,1,0,644,421,7,115,114,1,2910,2889,21,14,14,0,1,100,NoArch
bd859b67b5b500bff35658a5c549e5b1d3772217,1,133,127,6,0,0,0,2,2,111,1,1,0,187,3,1,25,20,5,754,651,103,6,5,1,1,100,NoArch
7ca44f8e1dad4eb40cdccb1a62e09d8b6168c58b,4,546,0,546,4,0,4,1,1,0,1,1,1.981404086,0,5,0,50,0,50,2637,0,2637,18,0,18,1,99.79716024,NoArch
8f5361bb6c3775ceb4cbcc6ed908f6eaa418449e,1,100,51,49,0,0,0,2,3,94,1,1,0,1494,4,2,198,187,11,7178,6754,424,30,29,1,1,100,NoArch
3bf76935f45d5395eb31ba7870b26d16a458ea73,3,138,170,32,0,0,0,2,3,121,1,2,0.285219476,840,5,3,88,93,5,3499,3652,153,19,19,0,1,99.97750787,NoArch
2eaf68a4d1a0aabfc016fc48fe5648bc95f5c2d5,1,20,4,16,0,0,0,2,2,1619,1,1,0,680,422,3,68,66,2,1526,1489,37,67,65,2,1,100,NoArch
65542f928d2256d5c788aada808e1ae6bcda2f14,1,18,12,6,0,0,0,4,11,499,1,1,0,485,423,4,67,63,4,2274,2236,38,11,11,0,1,100,NoArch
3b832ee6cf8161729afa523930b39e77443610e2,2,39,28,11,0,0,0,3,5,813,1,1,0.817138776,898,424,2,114,114,0,2583,2596,13,35,35,0,1,100,NoArch
1c0b001c44f843e962f9742d52ff052a12a83dd5,2,85,73,12,0,0,0,2,2,168,1,2,0.387743181,481,6,1,73,72,1,2080,2061,19,9,9,0,1,100,NoArch
faee9255061551658051c35eef9c914b1a4216d5,1,1,0,1,0,0,0,2,3,0,1,1,0,368,7,2,63,63,0,1615,1615,0,7,7,0,1,100,NoArch
96cbbbd1b911717788507b426e489013608609fd,1,42,16,26,0,0,0,2,3,548,1,1,0,208,425,3,30,26,4,942,783,159,6,5,1,1,99.909991,NoArch
c0496be94f85123589bb67324fb14efc45895516,2,21,2,19,0,0,0,3,14,246,1,2,0.755375413,1467,426,4,126,124,2,4524,4428,96,65,64,1,1,100,NoArch
842a6973573b3aedcc90bb87c2642b617e7c3bfa,2,319,29,290,0,0,0,2,29,869,1,2,0.643307129,1828,427,5,67,57,10,5323,4765,558,48,38,10,1,100,NoArch
c789cb9c88a6217217a3e4b849b8bc54757882b1,1,53,5,48,0,0,0,4,15,140,1,1,0,366,428,3,38,32,6,1686,1341,345,5,5,0,1,99.90990991,NoArch
41ac511ff07287e10ac907cc90c36764efff5e37,1,7,11,4,0,0,0,3,8,135,1,1,0,355,429,4,53,53,0,1660,1663,3,3,3,0,1,100,NoArch
4d62717abf9154e264735b486790fc5ff8d73717,3,45,133,88,0,0,0,2,4,1279,1,2,1.581478595,498,430,5,28,42,14,1223,1683,460,17,17,0,1,99.75208474,NoArch
947871aac29fe61d84d69fb8cc6ed9ac8fd7235d,1,35,12,23,0,0,0,3,10,803,1,1,0,339,431,6,37,33,4,1276,1158,118,11,11,0,1,100,NoArch
e93e4e920c91d7fe5b3061443cb2fd36e5370def,3,62,43,19,0,0,0,3,16,290,1,2,1.283901336,920,432,2,82,81,1,3617,3531,86,25,24,1,1,99.17845733,NoArch
cf28691fc3b84d89b41609838439789df36b2701,1,22,20,2,0,0,0,3,5,160,1,1,0,317,433,3,27,27,0,859,865,6,13,13,0,1,100,NoArch
1cf02645c4470dc8166d22e9f23cc861578bfc34,6,782,0,782,5,0,5,1,8,31,2,5,2.125462643,95,226,0,68,3,65,4269,440,3829,34,3,31,1,96.66878846,Arch
2a1e2f9ed1aa3038cca51bdab1c7a950a36ee6c2,0,0,0,0,0,0,0,0,0,0,0,0,0,0,227,1,0,0,0,0,0,0,0,0,0,1,100,NoArch
aec541c078191910bdb2782726c70d9753c2bbf1,0,0,0,0,0,0,0,0,0,0,0,0,0,0,47,0,0,0,0,0,0,0,0,0,0,1,100,NoArch
e00ae21d05dd0f84e5bd7da34d0d257c5af4d809,0,0,0,0,0,0,0,0,0,0,0,0,0,0,228,2,0,0,0,0,0,0,0,0,0,1,100,NoArch
a361cec6cdfed4d56872d870ffa50958c8ef4121,1,3,2,1,0,0,0,1,2,0,1,1,0,44,229,3,1,1,0,143,171,28,1,1,0,1,100,NoArch
fd69676291dddae6768246754ece7b398a609d23,1,37,31,6,0,0,0,3,12,603,1,1,0,450,434,4,55,55,0,1612,1625,13,13,13,0,1,99.8822606,NoArch
18ad95bc17b63abbf8618ecdcc779b34df0db55b,0,0,0,0,0,0,0,0,0,0,0,0,0,0,435,5,0,0,0,0,0,0,0,0,0,1,100,NoArch
d2a293937f82138815c6c3db5afe398d798efff7,0,0,0,0,0,0,0,0,0,0,0,0,0,0,436,6,0,0,0,0,0,0,0,0,0,1,100,NoArch
a94ac3eb33765db07aebbaf63cfb24a1638d98ea,0,0,0,0,0,0,0,0,0,0,0,0,0,0,437,7,0,0,0,0,0,0,0,0,0,1,100,NoArch
8c950348471fafa4ebf89629b067779801d2e278,0,0,0,0,0,0,0,0,0,0,0,0,0,0,438,8,0,0,0,0,0,0,0,0,0,1,100,NoArch
b7100417ec8474269dfb377e249b3bf143d30c83,0,0,0,0,0,0,0,0,0,0,0,0,0,0,439,9,0,0,0,0,0,0,0,0,0,1,100,NoArch
9a39c2b9485673a0f233e1a9d53188c45cfe1b7d,0,0,0,0,0,0,0,0,0,0,0,0,0,0,440,10,0,0,0,0,0,0,0,0,0,0,100,NoArch
74507aa38273fff902e10f777d748bd8cb64ad8b,20,2773,64,2709,16,0,16,1,9,152,1,6,3.806811588,700,29,0,278,49,229,12067,2035,10032,178,34,144,1,93.33742081,Arch
363cf0b76ee7eba0fef34c61ec14150dcf8040a5,1,1,0,1,0,0,0,4,14,177,1,1,0,567,30,1,48,48,0,2169,2169,0,26,26,0,0,100,NoArch
6d5f88cbc8618d84aa38ea4107e37bbedc5a060b,0,0,0,0,0,0,0,0,0,0,0,0,0,0,441,9,0,0,0,0,0,0,0,0,0,0,100,NoArch
6a24ef9c034317c6b55564a6fce47900f2e4a0f4,0,0,0,0,0,0,0,0,0,0,0,0,0,0,442,10,0,0,0,0,0,0,0,0,0,1,100,NoArch
82c6c19dd7baad5fc52d76d6e80d242491d0c03c,1,7,1,6,0,0,0,4,17,32,1,1,0,428,443,11,39,39,0,1795,1787,8,5,5,0,1,100,NoArch
71606cd8d5e66026c92e0a8c13ab5afa8ca4083c,1,102,28,74,0,0,0,3,8,264,1,1,0,375,444,12,41,33,8,2297,1765,532,11,10,1,1,100,NoArch
bfe662fb0016a42b7d3a98dd0b3b332aecf94598,0,0,0,0,0,0,0,0,0,0,0,0,0,0,48,1,0,0,0,0,0,0,0,0,0,1,100,NoArch
672efb927b11201a8ed465fa4959588d1b6c3072,5,49,39,10,0,0,0,3,5,453,1,1,2.106442754,1113,445,13,101,100,1,3717,3783,66,47,46,1,1,97.39311783,Arch
b51f0ab9ae4d7ae5262f577d7844a6dad4e35ea5,1,5,8,3,0,0,0,4,18,3,1,1,0,434,446,14,39,39,0,1754,1795,41,5,5,0,1,99.19753086,NoArch
58af285ece1c5bd8a2446bce2e652a7e3dfa942e,1,69,13,56,0,0,0,3,9,3,1,1,0,449,447,15,48,41,7,2661,2297,364,13,11,2,1,100,NoArch
9ff89fa36f5fbdd24c4d7d6828db13b8c4ad352e,1,10,9,1,0,0,0,2,5,1213,1,1,0,252,448,16,16,16,0,582,580,2,9,9,0,1,100,NoArch
a7b63556220870f73246cee878476dea013ec4e4,1,4,43,39,0,0,0,3,10,23,1,1,0,505,449,8,45,48,3,2536,2661,125,12,13,1,1,100,NoArch
9c1d5e3f86b9f3da019392b554f613abd2578dc5,2,54,18,36,0,0,0,3,30,261,1,2,0.41381685,2896,450,9,175,174,1,9571,9532,39,51,51,0,1,100,NoArch
5f174543b3bc8ada6a378d168581e2642b39d70d,1,5,4,1,0,0,0,2,3,1493,1,1,0,147,451,10,10,10,0,335,327,8,6,6,0,1,100,NoArch
c9b64231d2290918bfd11ff1afd685cf4888096f,2,18,0,18,0,0,0,1,2,44,1,2,0.650022422,382,31,0,55,52,3,1102,1046,56,20,19,1,1,100,NoArch
2e10a24c3ecb21e91eaf87c7eb3666bc72f29928,1,14,7,7,0,0,0,3,11,3,1,1,0,466,452,10,46,45,1,2584,2536,48,12,12,0,1,100,NoArch
1196800389f580650f0a66ebb7221950af48ad9a,3,234,154,80,1,0,1,2,3,1058,1,2,1.434683587,615,453,8,58,52,6,2741,2527,214,22,19,3,1,99.95854063,NoArch
4adb090d3b025d13e9579af26218c1627b9c4051,6,561,26,535,2,0,2,2,3,203,1,4,1.335313136,1466,8,0,250,141,109,6908,4215,2693,167,81,86,1,99.89650176,NoArch
8d849d07ade6f9758832da416c29eb7a5c900801,2,42,0,42,0,0,0,1,2,0,1,2,1,509,9,1,107,107,0,2596,2596,0,84,84,0,0,100,NoArch
9766f9b02c91aeb46618be37a8b4d2e78164ec88,1,184,100,84,0,0,0,2,13,784,1,1,0,1882,454,5,219,221,2,5106,5054,52,90,90,0,1,100,NoArch
b98994e91b120a96a6c077375c29d8b89f6407c1,0,0,0,0,0,0,0,0,0,0,0,0,0,0,230,0,0,0,0,0,0,0,0,0,0,1,100,NoArch
1ad5a58ae5a2921e7dbec66e84e89e0512aef1ae,7,2169,1873,296,4,0,4,1,4,33,1,4,1.281625371,2648,6,0,330,305,25,11968,10559,1409,109,94,15,2,99.73168215,NoArch
ddc9a0f56457a5aeee440dbca48533792d7f56e7,1,4,2,2,0,0,0,2,2,336,1,1,0,172,10,2,17,17,0,478,467,11,11,11,0,1,100,NoArch
bf70dd71961bff2b02778508a94843518d754709,1,21,4,17,0,0,0,3,12,85,1,1,0,473,455,0,49,46,3,2640,2584,56,13,12,1,1,100,NoArch
43327f50c3fb3b270c02e6c6ccf8b65204540c63,1,25,31,6,0,0,0,2,4,215,1,1,0,234,456,1,29,30,1,892,942,50,6,6,0,1,100,NoArch
4a2d2fe9d1038bc07cf8edc51788f452a2548b8e,1,216,216,0,0,0,0,2,5,392,1,1,0,270,457,2,2,2,0,1579,1795,216,2,2,0,0,100,NoArch
7b1ea7708b926518ffa7767cf0bde31169a40416,1,179,107,72,0,0,0,4,10,381,1,1,0,1402,458,3,244,243,1,4988,4998,10,29,29,0,1,100,NoArch
4119bff2b28de98ac25bb6f2cde6d646044893c0,1,129,97,32,0,0,0,4,11,0,1,1,0,1474,459,4,252,244,8,5087,4988,99,30,29,1,1,100,NoArch
4c896fc6e156498ac44062e41824d7cbf137b312,2,142,147,5,0,0,0,2,2,390,1,1,0.059602887,245,7,0,19,19,0,658,741,83,8,8,0,1,100,NoArch
a37de71560e223810a306325e69caaec69b042e5,8,72,312,240,0,0,0,2,3,349,1,1,2.61981595,2261,11,0,305,332,27,8335,9584,1249,62,74,12,1,100,NoArch
fb39814f4c85558e6c24c9b16e618ed07428c1b1,1,10,7,3,0,0,0,2,2,392,1,1,0,553,12,1,72,73,1,2648,2652,4,9,9,0,1,100,NoArch
af083b6043d0e9a8bf7f309af412da3e96967b90,3,39,39,0,0,0,0,3,31,534,1,3,0.67697596,2483,460,5,118,118,0,7181,7173,8,57,57,0,1,100,NoArch
5f93b44ab32e3a6376add51d02357b51b6dbc24d,34,4597,0,4597,34,0,34,1,1,0,1,6,5.040343692,0,8,1,312,0,312,16395,0,16395,124,0,124,1,91.59681926,Arch
b688014755d2f8d866486d022a3779c2e7b637f7,34,0,4597,4597,0,34,34,2,4,1755,1,6,5.040343692,4597,9,2,0,312,312,0,16395,16395,0,124,124,1,92.52095422,Arch
de972997bf2ca9c9d0dcb3aabbbda8a8b150032c,0,0,0,0,0,0,0,0,0,0,0,0,0,0,10,3,0,0,0,0,0,0,0,0,0,1,100,NoArch
836cf16d600a985eecf1d190894f41d7034de8a9,34,0,0,0,34,0,34,2,5,0,1,6,0,0,11,4,0,0,0,0,0,0,0,0,0,1,98.5791893,NoArch
d3384ab3bc9067f88106422f7be24f31ddb4004a,0,0,0,0,0,0,0,0,0,0,0,0,0,0,12,5,0,0,0,0,0,0,0,0,0,1,100,NoArch
da3723a7dd34717386d616a8deb705c062116404,14,2696,2809,113,0,0,0,2,5,310,1,4,2.284838301,6577,13,6,678,688,10,22950,23515,565,255,258,3,1,99.95760916,NoArch
10aded498232bfd9cf78271e47f0c3b679e39f1e,1,1,1,0,0,0,0,2,3,0,1,1,0,243,14,7,33,33,0,1187,1189,2,4,4,0,1,100,NoArch
53b903bef30dad67c88d437c227fe027cbe887c3,2,264,252,12,0,0,0,2,4,338,1,2,0.189705119,1309,13,2,40,40,0,4338,4268,70,9,9,0,0,100,NoArch
82d36af38efab4837095f76c199be44eebe503b7,4,496,469,27,0,0,0,2,5,320,2,4,0.205987044,2097,14,3,122,119,3,7109,7022,87,45,45,0,0,100,NoArch
1c5eef22ba829a04c5ef491e452bf6c11369a711,1,13,2,11,0,0,0,4,19,157,1,1,0,431,461,1,40,39,1,1790,1754,36,5,5,0,1,100,NoArch
dd6211a589129f94b3570fd73af0557c972c201e,3,147,1,146,1,0,1,1,10,103,1,3,0.507591869,289,462,2,33,23,10,1860,1251,609,11,8,3,1,93.98307024,Arch
a2798c93b27da988add1410033ee2d07216f2614,1,26,16,10,0,0,0,4,16,432,1,1,0,892,463,3,106,106,0,3016,3008,8,21,21,0,1,100,NoArch
8956635c1705203d55d688a1bd980cd935bac4d1,0,0,0,0,0,0,0,0,0,0,0,0,0,0,231,0,0,0,0,0,0,0,0,0,0,1,100,NoArch
4da6605a10ee44dc2837a302d8163b7248c8e744,3,297,16,281,0,0,0,1,2,201,1,2,1.488891484,653,232,1,86,60,26,4494,3230,1264,41,28,13,1,99.87571464,NoArch
588ff08ef2d1f41e9bf33b9afea0e6643d41df2f,1,78,7,71,0,0,0,3,7,1119,1,1,0,1355,464,4,122,114,8,5041,4847,194,68,65,3,1,100,NoArch
80cdf3c3ec48c09f256fc915c54bbb5dd3ea212b,1,1,1,0,0,0,0,4,12,54,1,1,0,1506,465,5,252,252,0,5091,5087,4,30,30,0,1,100,NoArch
7f9a46b4d57d233aeacc5942baba9e3cacb3967c,1,15,19,4,0,0,0,4,20,30,1,1,0,442,466,5,39,40,1,1759,1790,31,5,5,0,1,100,NoArch
f91e71492b59a3da7728bf7967be53871c72003e,1,72,28,44,0,0,0,2,2,59,1,1,0,172,467,6,16,12,4,1144,720,424,4,4,0,2,94.09881061,Arch
4371ea0fefc428c5522fd6816eca5c78104bf250,6,138,96,42,1,0,1,2,6,111,1,4,1.495188316,2639,15,1,247,243,4,10060,9989,71,47,45,2,1,93.41486359,Arch
b29c4562713f9d6d7677bf9c033e58c687c4609f,2,100,45,55,0,0,0,4,9,924,1,2,0.839976299,1068,468,7,119,115,4,3501,3351,150,52,52,0,2,100,NoArch
7976bd14f10476d1679035ee9ac4acb80b4d368b,1,21,22,1,0,0,0,2,3,1082,1,1,0,83,233,0,6,6,0,167,229,62,3,3,0,1,92.81524927,Arch
760ccc918ee0dc07750dc362ba26fd6af2f3b9e7,5,50,41,9,0,0,0,3,17,543,1,4,1.932490571,3363,469,3,361,360,1,10895,10888,7,118,117,1,1,100,NoArch
c3c28573ff71cb437326736702e178c6d9a0c1ab,3,12,12,0,0,0,0,1,4,402,1,2,1.188721876,1010,470,4,149,149,0,4630,4645,15,30,30,0,1,100,NoArch
78934ae1b66604411d9f20b6e80e12f22431d314,1,11,5,6,0,0,0,3,9,298,1,1,0,351,471,5,53,53,0,1669,1660,9,3,3,0,1,100,NoArch
cb4176382f242d137df5d36776b19a6529a04733,3,865,850,15,0,0,0,2,7,200,1,3,0.204871425,1768,16,0,108,107,1,6028,5969,59,22,22,0,2,99.41016334,NoArch
61a6b58ef568dca0b6c29bb26ce548cbcfaa8cb3,0,0,0,0,0,0,0,0,0,0,0,0,0,0,472,0,0,0,0,0,0,0,0,0,0,0,100,NoArch
9cef134d802594c936a684c11690adfe370ffd8d,4,374,260,114,0,0,0,2,17,529,1,4,1.373173292,2697,473,1,254,233,21,9679,9626,53,129,124,5,1,99.93204983,NoArch
1c78737df420412911472440a2cb0ec7b8363f12,1,130,18,112,0,0,0,2,2,548,1,1,0,456,17,1,74,54,20,3064,2472,592,13,9,4,1,99.66216216,NoArch
5da37992fccf91e855d8ee1d68378f4e40bf35d3,1,1,6,5,0,0,0,2,3,155,1,1,0,556,18,2,70,72,2,2618,2648,30,9,9,0,0,100,NoArch
4fe8ab3ad87d90dba59673d96e3f15205dff3e8c,1,14,11,3,0,0,0,4,7,636,1,1,0,530,0,0,45,44,1,1788,1780,8,16,16,0,1,100,NoArch
9aed6cb5c74b880c674503ba6fdc4dc1dc3170ae,1,0,7,7,0,0,0,4,10,54,1,1,0,357,1,1,52,53,1,1652,1669,17,3,3,0,1,100,NoArch
7f29584168ecde6751a825f90516b2637ed52983,5,412,68,344,2,0,2,3,15,454,1,3,1.848284784,796,474,2,89,64,25,4197,2743,1454,44,37,7,1,92.97349866,Arch
37c92de39f3dc93b846821c2c5f69cb259c6e5b9,1,16,31,15,0,0,0,1,2,6,1,1,0,236,475,3,16,18,2,927,1143,216,4,4,0,1,100,NoArch
6ea94c9f6ef6808c676233c38831faac952dc9e5,2,208,200,8,0,0,0,3,4,128,2,2,0.282217634,607,19,2,88,84,4,2929,2828,101,14,14,0,1,100,NoArch
0f459654aeeec51f4a45e90dd49e5b37121fd62a,1,1,1,0,0,0,0,3,13,330,1,1,0,456,476,4,55,55,0,1611,1612,1,13,13,0,1,100,NoArch
17bcc9a70d564087268ecd98f3c0e851934e80a6,10,239,54,185,0,0,0,2,16,586,1,5,2.728552991,2183,477,5,215,188,27,8217,7535,682,98,92,6,1,99.28966062,NoArch
e3560a78496fa2d2ad05bdb0ffaf88d7c92cfcb5,4,408,3,405,2,0,2,3,13,46,1,3,0.899747327,712,478,6,106,76,30,5179,3523,1656,31,23,8,2,99.86992716,NoArch
8d6b2cc8acb306d1924de0474a05daef307dadae,1,3,2,1,0,0,0,4,17,3,1,1,0,590,479,7,52,52,0,2325,2285,40,26,26,0,2,99.92211838,NoArch
99ec3d83b8c357a14887ca0f381c140ec87cfcb2,5,493,8,485,4,0,4,1,2,96,1,1,1.859647669,299,480,8,66,28,38,1703,729,974,45,15,30,1,99.45426195,NoArch
399c9498bd74d3c66b3184aa6108eacf9e0dca14,1,12,0,12,0,0,0,5,32,173,1,1,0,1542,481,9,30,30,0,4394,4358,36,11,11,0,1,100,NoArch
37c8c834af9140eeb5c4fdf7c02303c322fcaa3d,2,38,2,36,0,0,0,1,2,498,1,1,1,96,482,10,6,2,4,510,336,174,2,2,0,1,99.97395833,NoArch
badc4ffd3e373488edba69c55e0056d913b68ac8,3,44,17,27,0,0,0,1,21,88,1,2,1.433227887,1131,483,11,113,111,2,5336,5234,102,25,23,2,0,100,NoArch
b51184ec2560ab1a8773de4bedcf333c4ca145d8,2,127,11,116,0,0,0,2,3,1052,1,2,0.999393868,407,484,12,54,35,19,1486,1137,349,18,14,4,1,100,NoArch
fa47b102ab8cb52b3ca9ad46d996444b35320e63,1,26,20,6,0,0,0,3,14,24,1,1,0,456,485,10,56,55,1,1636,1611,25,13,13,0,1,100,NoArch
7659a66ca008316f532d998e3fbbf5e7e962f699,2,20,6,14,0,0,0,1,4,1153,1,2,0.619382195,185,486,8,12,11,1,519,483,36,2,2,0,1,100,NoArch
963d1527f34e78f317e8d61845266612724caea3,1,645,604,41,0,0,0,3,11,516,1,1,0,648,20,0,125,115,10,3198,2910,288,14,14,0,1,100,NoArch
090911fc702fe1b51127816ab6f499390edfc168,2,88,3,85,0,0,0,2,33,638,1,2,0.260145364,1648,487,2,50,37,13,4970,4669,301,17,14,3,1,97.69150052,Arch
b0fd91370f12032b323859c1e44b6be479fc0832,1,4,1,3,0,0,0,4,22,69,1,1,0,439,488,2,39,39,0,1767,1771,4,5,5,0,1,100,NoArch
f32a07dfcec2465f1b57312e72146791d3896aa5,1,1,1,0,0,0,0,2,2,2141,1,1,0,282,15,0,24,24,0,594,594,0,21,21,0,1,100,NoArch
6bb9f1053893d45f2648fd7c4c582cd5ed3ba22f,9,214,86,128,0,0,0,3,25,599,1,3,2.375339383,4348,489,2,475,461,14,15010,14630,380,183,177,6,1,100,NoArch
f2892e5ad9395bd80b5de83dc73a56e6d3f14b5d,1,4,4,0,0,0,0,5,18,193,1,1,0,902,2,0,106,106,0,3016,3016,0,21,21,0,1,100,NoArch
12989319b625d8defea26d40867bf190f1af4de0,3,100,46,54,2,0,2,1,2,722,1,1,1.580489008,94,3,1,0,0,0,147,101,46,0,0,0,1,99.81520591,NoArch
62c5c937a9f39870d8e7e8b7f1e9b074f737c184,1,72,78,6,0,0,0,4,11,138,1,1,0,350,490,2,54,52,2,1662,1652,10,4,3,1,1,100,NoArch
dfd97b669df33c6acc3679d475fa66a3d87e9c40,1,3,2,1,0,0,0,4,12,0,1,1,0,344,491,3,54,54,0,1662,1662,0,4,4,0,1,100,NoArch
a5123b4d7f9ebda5c0dd7238a8fc5ede7bb5993c,1,11,2,9,0,0,0,2,2,641,1,1,0,452,492,4,64,62,2,1624,1560,64,31,30,1,1,100,NoArch
bda1fab6a6da74d7161b1b13078e6f1efc5c2d0c,4,33,22,11,0,0,0,2,26,282,1,1,1.466450427,1924,493,4,218,216,2,6248,6190,58,82,82,0,1,100,NoArch
44bfbefe6510c1288d1bc490d47337e1e6df8550,1,13,13,0,0,0,0,2,2,2181,1,1,0,325,494,5,32,32,0,1137,1107,30,15,15,0,1,100,NoArch
245d27b64f6e737f83216f42305e38fca5c2d238,4,44,14,30,0,0,0,4,27,557,1,1,1.838151365,2122,21,0,236,228,8,8147,7976,171,92,89,3,1,100,NoArch
d1fbdfadbf429d52d6e7435ed67bdfcc5ccfbfc6,7,1476,1468,8,0,0,0,2,6,323,2,6,0.244231004,3951,22,1,554,546,8,18083,17909,174,96,94,2,4,99.92086521,NoArch
4fcd981fd814f44fd5b73d399767687869743185,3,14,59,45,0,0,0,2,3,538,1,2,0.894129834,860,23,2,117,124,7,2863,3002,139,34,37,3,1,100,NoArch
e5669ec44bc6980972b19adb37c8e47ef0826dc8,1,58,6,52,0,0,0,2,3,2183,1,1,0,349,495,2,38,29,9,1305,1084,221,17,17,0,1,97.42226947,Arch
c6495d3838a57c083ab841cbc910ccab3abca5bc,1,1,1,0,0,0,0,4,11,250,1,1,0,656,496,1,69,69,0,1549,1549,0,38,38,0,1,100,NoArch
281dbf5b86b99e6e66acd3f33a8b92460ca5ceee,3,360,340,20,0,0,0,2,4,1262,2,2,0.223004595,735,24,3,89,85,4,2528,2368,160,48,47,1,1,99.9732334,NoArch
0c490eb41f08ee77b8222327e8decc1baba58e0d,3,15,14,1,0,0,0,2,8,342,1,3,1.247424124,1022,25,4,120,118,2,4019,3977,42,27,27,0,1,100,NoArch
3ff58dacf561b3a410f05d07f973e0423f3d61eb,2,263,0,263,1,0,1,1,3,139,1,1,0.576014781,201,4,0,51,22,29,1353,507,846,24,12,12,1,99.89281886,NoArch
94a51dd04336b0720d0d6494821744684f5ed057,1,0,1,1,0,0,0,1,2,0,1,1,0,227,5,1,25,25,0,755,757,2,11,11,0,0,100,NoArch
11b9fabd2a867619f229076f7314cd55c4ff9d75,3,179,121,58,0,0,0,4,8,1262,1,1,0.914684461,1840,6,2,154,152,2,7214,7113,101,41,39,2,1,97.85544083,Arch
d32cb7d46fb02d6c76760e278ae52b455c8f6b05,4,56,56,0,0,0,0,1,2,840,1,3,2,319,45,0,29,29,0,866,866,0,25,25,0,0,100,NoArch
6460019aa5983862d8546b216956b711e4ee2903,2,56,0,56,0,0,0,3,5,526,1,1,0.885612871,386,7,3,38,32,6,1441,1243,198,11,9,2,0,100,NoArch
9fd71d6c210efb445226c49c37cf427d9777606c,1,13,0,13,0,0,0,5,12,34,1,1,0,656,8,4,71,69,2,1573,1549,24,39,38,1,0,100,NoArch
1ab2c481330e31d1dc3ae41056f4782145dfdb4e,1,1184,0,1184,1,0,1,1,1,0,1,1,0,0,9,5,147,0,147,4532,0,4532,27,0,27,1,90.99843645,Arch
de6d7ff10ae1374f0c620ab500d77830a49ebedc,1,19,0,19,0,0,0,4,15,602,1,1,0,1379,10,6,118,117,1,4128,4078,50,62,61,1,0,100,NoArch
97c8ba86d2e5905eb35c5c6fd39cfd55c5316496,7,1021,38,983,5,0,5,2,3,568,1,1,2.503868703,183,497,1,99,9,90,3029,425,2604,57,8,49,1,95.98486441,Arch
7d3163fc029d53c0768d83f7ffdc95941fc3fca6,1,2,2,0,0,0,0,2,4,0,1,1,0,83,498,2,7,7,0,230,234,4,3,3,0,1,100,NoArch
4eb165891974eef7d4ad8fca9f73d36435f8563e,1,22,0,22,0,0,0,2,2,2261,1,1,0,173,499,3,18,16,2,302,263,39,15,13,2,1,100,NoArch
82740c607d524379e5d68a62ff8ee9b2687d56dd,1,4,3,1,0,0,0,1,2,3,1,1,0,1184,11,7,147,147,0,4526,4532,6,27,27,0,1,100,NoArch
2fad51ebdadb044d7823f21d974c5890d2295755,1,1,2,1,0,0,0,2,2,2264,1,1,0,224,500,4,17,17,0,611,611,0,5,5,0,1,100,NoArch
0d28ab556e0503efe003eb9c17c10690ae6d7d75,3,264,250,14,0,0,0,2,6,285,2,2,0.297558122,1230,26,2,154,152,2,5402,5379,23,32,31,1,0,100,NoArch
daa6920ca69e881d4f5e906bc8a46c95deef63c7,4,44,18,26,0,0,0,2,5,16,1,1,1.827723912,651,501,4,69,66,3,2056,2014,42,30,30,0,2,100,NoArch
07694c6a25db7d5cde3522c9d9064ce45059a91d,2,50,27,23,0,0,0,2,34,1221,1,2,0.684038436,2038,502,5,85,83,2,6143,5972,171,39,39,0,1,100,NoArch
4a4518d324bebc1faaba0f3972e46a25138ecb49,2,6,8,2,0,0,0,2,2,2284,1,1,1,99,503,6,2,2,0,205,223,18,2,2,0,1,100,NoArch
6d2a336fb2a10e230bbebbb0cb77f45163324cdd,1,1,1,0,0,0,0,3,7,258,1,1,0,582,504,7,70,70,0,2288,2294,6,26,26,0,1,100,NoArch
c4ab79e9db93664b0758bd19b60e99c704a2dab9,2,206,204,2,0,0,0,2,3,15,1,1,0.044481223,549,27,1,56,55,1,1692,1681,11,30,30,0,2,100,NoArch
25ec224bc118fa6e9a80b2112efa26a8d8155f85,2,86,94,8,0,0,0,2,3,412,1,1,0.732901009,406,28,2,60,58,2,1689,1713,24,11,10,1,0,100,NoArch
d443b40f49d84869fdc174fb3e0ae5d78728a652,3,12,4,8,0,0,0,2,3,793,1,3,1.198192411,1288,29,3,122,121,1,8141,8075,66,27,27,0,0,100,NoArch
c1f21206cdb5a5b60085fb6b03a2368d486d20a9,1,21,23,2,0,0,0,2,5,54,1,1,0,447,30,4,65,71,6,1671,1735,64,13,13,0,1,100,NoArch
9737a662017203923ce60381ded7ac1c8c45efb2,8,86,21,65,0,0,0,2,7,561,2,5,1.631360495,2545,16,0,273,261,12,11087,11032,55,67,63,4,1,92.53404669,Arch
367dcae1a6ba9d02ffb87aa31051f747cae5db88,1,4,0,4,0,0,0,2,5,431,1,1,0,228,505,8,30,29,1,902,892,10,6,6,0,1,100,NoArch
e241bac489d766e73d599f2c67ffb315b8e68eeb,1,2,2,0,0,0,0,1,3,82,1,1,0,226,12,0,25,25,0,753,755,2,11,11,0,1,100,NoArch
5daf7875f3bf9f1ab9847e7fcef3e8c200d2992b,2,8,1,7,0,0,0,3,3,590,1,1,0.918295834,316,17,0,29,29,0,1123,1083,40,10,10,0,1,100,NoArch
fcf817b29446292fa0e7e29ac54c40bd75c32de7,0,0,0,0,0,0,0,0,0,0,0,0,0,0,18,1,0,0,0,0,0,0,0,0,0,1,100,NoArch
627953116caf5770cea4a6475f8a6b21bee10670,1,8,26,18,0,0,0,3,15,296,1,1,0,494,506,0,44,49,5,2491,2658,167,13,13,0,1,100,NoArch
4409873a1ada95dec4851ac3bda295d815f6c446,1,89,11,78,0,0,0,1,3,1091,1,1,0,137,507,1,21,12,9,627,380,247,6,4,2,1,100,NoArch
fa269ca8bc6443a0ac3e8433ce18c655d8d96006,2,5,4,1,0,0,0,2,4,445,1,1,0.764204507,260,19,2,23,23,0,888,855,33,9,9,0,1,92.45237521,Arch
66f1781ba526691822c91d35f5972d4e4d45ab8a,2,18,2,16,0,0,0,3,11,830,1,2,0.468995594,838,508,2,95,92,3,3879,3806,73,23,23,0,1,100,NoArch
83ea65628e6a9d3efea044e410eae65e452f07b4,1,3,3,0,0,0,0,3,8,77,1,1,0,582,509,3,70,70,0,2298,2288,10,26,26,0,1,100,NoArch
293f77cb211abbd78bf026ea1334fd0c6afc125e,1,4,25,21,0,0,0,3,16,3,1,1,0,476,510,4,43,44,1,2363,2491,128,13,13,0,1,100,NoArch
6ba58c98ad7bbb3ee7f547982c4c35b1ee04296c,1,70,30,40,0,0,0,4,23,230,1,1,0,442,511,5,45,39,6,2224,1767,457,7,5,2,1,100,NoArch
39660bb3a1cc1494c9d01228485946c6df6a92b0,1,12,17,5,0,0,0,2,4,152,1,1,0,401,512,6,34,38,4,1249,1305,56,17,17,0,1,100,NoArch
63e0906ef5fd2bafc99d1f6d0495c31b0924cf00,7,1378,1184,194,0,0,0,3,13,649,1,1,0.65035499,3995,513,7,557,557,0,14137,14088,49,88,88,0,0,100,NoArch
7b1f24f8175b67a312a527946a43547287b0e540,2,50,2,48,0,0,0,4,16,55,1,2,0.961236605,2686,514,8,267,265,2,8758,8699,59,91,89,2,1,100,NoArch
ca9122065810dd928dc8712127dbc913773a7615,2,135,69,66,0,0,0,2,4,1472,1,1,0.997502546,817,515,9,77,66,11,3934,3658,276,25,23,2,1,100,NoArch
c769ac607f79f2bb086e40aaf4f5dc49eca4a830,5,165,125,40,0,0,0,1,6,470,1,1,2.27268333,1338,516,10,168,162,6,5127,4947,180,28,29,1,1,100,NoArch
428e5a497435c30f416edc6ba1b4707312323dee,3,109,0,109,1,0,1,1,11,150,1,2,1.065848835,424,517,11,49,42,7,2118,1691,427,10,9,1,1,93.62943024,Arch
8dca46df708073c63f39b19a942ff9fdf6add9cb,3,70,4,66,0,0,0,2,3,298,1,3,0.744866174,736,518,12,57,50,7,3995,3574,421,32,30,2,1,100,NoArch
9dc7501e6326002675a30550b0570ef8ce3c835e,3,152,97,55,0,0,0,2,3,2188,1,2,1.316407194,378,519,13,42,33,9,1198,896,302,16,16,0,1,100,NoArch
20e60a4946cf9e16cde2f1cf654fe64a0e41afba,1,39,19,20,0,0,0,2,3,2091,1,1,0,231,520,14,22,20,2,840,776,64,13,11,2,1,100,NoArch
33309d2d6904217be59955fa41e819325f18ec2b,2,7,6,1,0,0,0,3,24,333,1,1,0.995727452,850,521,15,78,77,1,3190,3184,6,26,26,0,1,100,NoArch
65a33d006701e861749f95f4a944f469a365aa6b,0,0,0,0,0,0,0,0,0,0,0,0,0,0,522,16,0,0,0,0,0,0,0,0,0,1,100,NoArch
4c767c895178f741a2b6118c7669fa99e54c6038,4,52,17,35,0,0,0,4,17,8,1,3,1.935919621,3354,13,0,348,344,4,11246,11190,56,105,103,2,1,100,NoArch
e0df1e79a3cc94776276037b0ad8b3c51737e8e1,1,1,0,1,0,0,0,2,4,1110,1,1,0,190,523,17,22,22,0,650,643,7,4,4,0,1,100,NoArch
54c835e0d2d5575402c89afad501c83c5edf88a9,1,252,0,252,1,0,1,1,1,0,1,1,0,0,524,18,39,0,39,963,0,963,9,0,9,1,96.8831735,Arch
e48a72966249d985b212bc0592117a3d0656ea68,1,4,1,3,0,0,0,2,6,5,1,1,0,1338,14,1,151,150,1,4647,4629,18,29,29,0,1,100,NoArch
ff02984f146a14a79324b33bfd15ebcb0dbf5d4e,1,36,3,33,0,0,0,5,14,17,1,1,0,1504,15,2,258,252,6,5241,5091,150,30,30,0,1,100,NoArch
a5717010b75f44191d93b613ce08c99e927d82b3,1,13,5,8,0,0,0,5,15,0,1,1,0,1537,16,3,256,258,2,5193,5241,48,30,30,0,1,100,NoArch
d79d7cfd809328ea76db9c85bfb68655aa8edbd9,1,5,1,4,0,0,0,2,5,15,1,1,0,420,525,19,37,36,1,1790,1782,8,14,14,0,1,100,NoArch
286b2a9020c95cebe283b55282e2b57d670c0c86,7,1,1130,1129,0,5,5,2,12,264,2,5,2.021437863,1284,234,0,4,102,98,628,6114,5486,4,50,46,1,96.74080599,Arch
6c56d8f4b7542b3c4f5d09e3015b919233d6498f,0,0,0,0,0,0,0,0,0,0,0,0,0,0,235,1,0,0,0,0,0,0,0,0,0,1,100,NoArch
288c0dd318af89c2903af2f02df4a0a8ed4af740,2,31,27,4,0,0,0,3,8,834,1,2,0.29367631,710,17,4,80,79,1,2681,2663,18,21,21,0,1,100,NoArch
8a4dc78c3cd29eec45bcad13050144ff53696eef,0,0,0,0,0,0,0,0,0,0,0,0,0,0,526,20,0,0,0,0,0,0,0,0,0,0,100,NoArch
9c741b9e6160422ae98590cd3f4b6e459e155e6c,0,0,0,0,0,0,0,0,0,0,0,0,0,0,527,21,0,0,0,0,0,0,0,0,0,0,100,NoArch
f8b6dc8c07c798f6360af70412776b48e2b5ca28,0,0,0,0,0,0,0,0,0,0,0,0,0,0,528,22,0,0,0,0,0,0,0,0,0,0,100,NoArch
3b36a1da498c3bab42aea264042aa662eb6b282a,0,0,0,0,0,0,0,0,0,0,0,0,0,0,529,23,0,0,0,0,0,0,0,0,0,0,100,NoArch
97899b0bbfaab4ffa82df4bd67724b7d0aa75094,0,0,0,0,0,0,0,0,0,0,0,0,0,0,530,24,0,0,0,0,0,0,0,0,0,0,100,NoArch
67f41f9ea2ecc6e77c8da85a0c424f69f7d9601b,0,0,0,0,0,0,0,0,0,0,0,0,0,0,531,25,0,0,0,0,0,0,0,0,0,0,100,NoArch
d5373569cc26b96ed93ec2c77137a96fb0e0192a,0,0,0,0,0,0,0,0,0,0,0,0,0,0,532,26,0,0,0,0,0,0,0,0,0,0,100,NoArch
3fae148558a9ffb902d5f82a03ebdb00d1c91b39,0,0,0,0,0,0,0,0,0,0,0,0,0,0,533,27,0,0,0,0,0,0,0,0,0,0,100,NoArch
38e5d4bf45d57592ec4b7c95303d15578527fdaa,0,0,0,0,0,0,0,0,0,0,0,0,0,0,534,28,0,0,0,0,0,0,0,0,0,0,100,NoArch
b6b39530f65204317f285f2b3236c218ee694062,0,0,0,0,0,0,0,0,0,0,0,0,0,0,535,29,0,0,0,0,0,0,0,0,0,0,100,NoArch
88dd1b30ffefa0e03bb33e2cf6b9e491482f4cde,0,0,0,0,0,0,0,0,0,0,0,0,0,0,536,30,0,0,0,0,0,0,0,0,0,0,100,NoArch
6883f68aa97385c0f47baad9311e5e413aa0c001,0,0,0,0,0,0,0,0,0,0,0,0,0,0,537,31,0,0,0,0,0,0,0,0,0,0,100,NoArch
1667eefb7cd1ee75309701ae63bd722cfbb2c3d7,0,0,0,0,0,0,0,0,0,0,0,0,0,0,538,32,0,0,0,0,0,0,0,0,0,0,100,NoArch
556ae1aaec681dd883c09079af304d7e30db1f97,0,0,0,0,0,0,0,0,0,0,0,0,0,0,539,0,0,0,0,0,0,0,0,0,0,0,100,NoArch
0d5e1235f7eaf70afa55eda1cec6a9db381c94ea,440,5420,60178,54758,1,291,292,0,26,46,6,76,7.965615003,102000,383,0,4494,9810,5316,163610,364174,200564,1709,3881,2172,0,73.49365751,Arch
8df8686157af5ac31709ac160d94bf241e15a116,0,0,0,0,0,0,0,0,0,0,0,0,0,0,537,31,0,0,0,0,0,0,0,0,0,0,100,NoArch
88dd1b30ffefa0e03bb33e2cf6b9e491482f4cde,0,0,0,0,0,0,0,0,0,0,0,0,0,0,536,30,0,0,0,0,0,0,0,0,0,0,100,NoArch
6883f68aa97385c0f47baad9311e5e413aa0c001,0,0,0,0,0,0,0,0,0,0,0,0,0,0,537,31,0,0,0,0,0,0,0,0,0,0,100,NoArch
06f23140521efd7ffcb69419431708a20c6ac6bd,0,0,0,0,0,0,0,0,0,0,0,0,0,0,538,32,0,0,0,0,0,0,0,0,0,0,100,NoArch
e3a7c8644530c6c834d0d7e893a16c4e79e057be,1,17,13,4,0,0,0,4,8,210,1,1,0,205,32,0,20,20,0,568,551,17,11,11,0,1,100,NoArch
44254bab778b8239f64baf75e9b585dc154b7ae9,0,0,0,0,0,0,0,0,0,0,0,0,0,0,539,33,0,0,0,0,0,0,0,0,0,0,100,NoArch
ad5ec11b0e995dcec130aedeaf4be493dc3265eb,0,0,0,0,0,0,0,0,0,0,0,0,0,0,33,1,0,0,0,0,0,0,0,0,0,1,100,NoArch
82e6eea523e76750503697c33214891cbd869724,0,0,0,0,0,0,0,0,0,0,0,0,0,0,540,27,0,0,0,0,0,0,0,0,0,0,100,NoArch
c565100d30040174a7e466e97b4c2117ce569efd,1,3,25,22,0,0,0,2,2,2434,1,1,0,61,18,1,1,3,2,29,78,49,1,3,2,1,96.30931459,Arch
cdc4608e12a5a023cf8cf15b7c917a351c6db33b,1,68,1,67,0,0,0,5,16,47,1,1,0,1545,19,2,265,256,9,5471,5193,278,30,30,0,1,100,NoArch
41b640aa5b794638426f6bf3d4f3b39c23910a96,1,5,0,5,0,0,0,3,19,281,1,1,0,718,20,3,56,55,1,2278,2261,17,33,33,0,1,100,NoArch
83b38773a3e066f92d986d5181184b030b4ad502,1,11,7,4,0,0,0,2,2,2452,1,1,0,139,21,3,13,12,1,264,258,6,8,8,0,1,100,NoArch
6c459fc8eea1355b5d1fd3ac70469aa36a1e8834,1,2,1,1,0,0,0,5,13,198,1,1,0,669,22,4,72,71,1,1591,1573,18,39,39,0,1,100,NoArch
f00fea4a61dc0f3a54b114397f5e50c923d8de9b,1,1,1,0,0,0,0,5,10,511,1,1,0,467,23,5,50,50,0,1952,1952,0,14,14,0,1,100,NoArch
1514b1031651fbae023c0e2e7c8c57e8109c8e0c,1,2,1,1,0,0,0,5,14,11,1,1,0,670,541,0,73,72,1,1600,1591,9,39,39,0,1,100,NoArch
5364477965f8f87cb09d3cdeabbaa03d8eec3e70,1,1,1,0,0,0,0,2,2,1008,1,1,0,173,31,0,12,12,0,340,340,0,7,7,0,0,100,NoArch
fa8cbbbcacec08a1a272b9b4c2cd449b6be0ddc1,3,1338,1298,40,0,0,0,3,35,586,1,2,0.039655206,3274,32,1,215,211,4,8822,8713,109,110,107,3,2,100,NoArch
2c677b7af9f7cb6a8dd81a5804d4f150647136fb,3,19,20,1,0,0,0,2,5,520,1,3,0.67697596,655,33,2,95,95,0,2503,2503,0,16,16,0,0,100,NoArch
8ef145c78640974fccbc665cd8e5225a0c9ee326,120,18962,108,18854,119,0,119,1,3,8,1,18,6.353302023,173,34,3,2134,20,2114,80757,970,79787,632,5,627,2,90.064836,Arch
8f13bef79922ed4ef0168e9054ca324f70f17721,1,4,2,2,0,0,0,1,2,0,1,1,0,45,35,4,3,3,0,85,78,7,3,3,0,0,100,NoArch
5de911a98e27083bd21c81f87921b9817912a248,22,1078,493,585,1,0,1,2,3,753,2,10,3.589409624,6499,20,0,756,668,88,25652,23438,2214,450,388,62,1,99.96522949,NoArch
f31add38b6b8de2d961f741cc5cf0ab97e29de6d,1,21,0,21,0,0,0,1,2,0,1,1,0,319,21,1,54,54,0,1573,1573,0,35,35,0,1,100,NoArch
c9e3d3a85f001a75980aabcae672854e401f8a05,8,306,22,284,2,0,2,2,8,212,1,3,1.724392846,3057,22,2,415,380,35,15389,14300,1089,117,92,25,1,99.86111111,NoArch
7834c7466e29824578579eea16d7364bc104a9c9,1,97,51,46,0,0,0,4,13,363,1,1,0,493,542,0,63,67,4,2351,2284,67,13,11,2,1,95.34659201,Arch
2e5838e736025b192fbcd0ee18baa4d56be04189,3,68,22,46,0,0,0,2,4,1582,1,2,0.363485129,681,543,1,47,49,2,3172,2685,487,28,28,0,1,99.86882379,NoArch
7a501fd4396892e553a4d594bbfae70d80f21dd1,1,148,0,148,1,0,1,1,1,0,1,1,0,0,544,2,26,0,26,714,0,714,1,0,1,1,95.77928763,Arch
7e9e5e33e388308cfe360752a67eba12ceb42e1b,2,39,7,32,0,0,0,3,7,1136,1,1,0.910878379,547,36,4,12,7,5,3205,3140,65,6,5,1,1,100,NoArch
e52d346adfa24ac83ec71d79c02d67e14434b1a4,48,2393,3889,1496,14,10,24,1,36,7,2,10,4.528583338,9497,37,1,689,939,250,33555,40958,7403,255,261,6,1,91.3326301,Arch
a9e6db75b48a32d58e35d921779777604388e64b,2,350,30,320,1,0,1,1,8,661,1,2,0.989403593,155,545,3,45,17,28,1723,487,1236,14,9,5,1,99.96784566,NoArch
7bd54565a551d8b6f905df969fa52f3e8d3e390e,1,2,0,2,0,0,0,3,13,162,1,1,0,100,546,4,3,3,0,512,492,20,3,3,0,1,100,NoArch
dc71cfd6fe8f6ece6cc4cd020a8b109adaf7f408,2,6,1,5,0,0,0,4,28,254,1,1,0.863120569,1097,547,5,114,113,1,3194,3182,12,55,55,0,1,100,NoArch
08cfbdd414514dba2f83f1156bc91281a42c87bf,1,1,1,0,0,0,0,3,17,371,1,1,0,496,548,6,66,66,0,1815,1815,0,15,15,0,1,100,NoArch
d863c50b561058c3379f86c39f716fc01804e132,176,2076,21062,18986,0,129,129,1,34,47,4,45,6.564055491,38693,538,0,2015,4092,2077,70339,149684,79345,816,1544,728,0,87.9863997,Arch
a109c555d29873d0e826837580b27844f6003fcd,19,819,160,659,2,0,2,1,28,873,2,12,3.186770177,7164,539,1,834,769,65,28280,25383,2897,260,253,7,14,96.08533099,Arch
ddc5b5cb2be916ca51612521d298b67f1a923990,0,0,0,0,0,0,0,0,0,0,0,0,0,0,540,2,0,0,0,0,0,0,0,0,0,0,100,NoArch
153090950b3f429fc7e4fe2d75031c59b1814784,0,0,0,0,0,0,0,0,0,0,0,0,0,0,541,3,0,0,0,0,0,0,0,0,0,0,100,NoArch
0dd66bee7459fd2dab93415b6071d0b680e345d3,0,0,0,0,0,0,0,0,0,0,0,0,0,0,542,4,0,0,0,0,0,0,0,0,0,0,100,NoArch
0d79079f7e1bda11ddb057b30b7a9b347a63eea5,0,0,0,0,0,0,0,0,0,0,0,0,0,0,543,5,0,0,0,0,0,0,0,0,0,0,100,NoArch
f7a666adfb92489249b9d943a5323d47d2b29498,159,20252,1936,18316,127,0,127,2,36,145,3,36,6.456561183,12763,549,4,3271,1261,2010,122526,46127,76399,1286,565,721,1,88.14611872,Arch
e9a36d18e24973608c7dc244d5ee996f2ca57209,0,0,0,0,0,0,0,0,0,0,0,0,0,0,550,5,0,0,0,0,0,0,0,0,0,0,100,NoArch
441a0107f0b8cd4ceb1bc066003f60e66e6f1cd1,19,158,97,61,0,0,0,1,3,64,1,10,3.246136325,4673,38,1,648,639,9,20650,20276,374,199,194,5,1,99.90362994,NoArch
feebde8980c6fa50da9f32d75175b36a6eee5002,10,330,0,330,10,0,10,1,1,0,1,1,3.321928095,0,23,0,10,0,10,620,0,620,10,0,10,1,99.58393343,NoArch
dd8ada674a1feca517759b25f166bd2ac30b2ba1,5,112,17,95,2,0,2,1,5,371,1,3,1.955173384,1151,24,1,108,103,5,3516,3326,190,65,62,3,1,99.90435198,NoArch
2c33be84c347669991eafc0dc4ae2a816efe58f3,45,3432,3335,97,4,1,5,1,9,564,1,3,3.662666318,12026,25,2,1286,1270,16,37801,37174,627,742,721,21,1,97.46344375,Arch
58a6872e296635d44b9ecddae85c50984c3a794e,24,1594,440,1154,13,1,14,1,4,301,1,4,4.277351377,2369,26,3,246,150,96,18357,12494,5863,157,90,67,1,99.26091201,NoArch
af39e1a60ced75cb54339fcdaae02a222391905b,0,0,0,0,0,0,0,0,0,0,0,0,0,0,27,4,0,0,0,0,0,0,0,0,0,1,100,NoArch
5a39ac63835cadeb8b8e0bce11e7ff8df0157b70,40,156,154,2,0,0,0,1,10,53,2,10,4.139754634,11927,28,5,1306,1306,0,44259,44233,26,694,694,0,1,99.6950797,NoArch
dcdf5c5880f2aa3fd1e0a77dc4a4284a40058771,1,1,1,0,0,0,0,2,2,2591,1,1,0,256,29,6,21,21,0,422,420,2,20,20,0,1,100,NoArch
ca073fd91cc7cf0b74a01ad042f54d78366e5b6f,2,56,60,4,0,0,0,2,11,2,1,2,0.479832024,2021,30,7,235,238,3,7774,7830,56,86,86,0,1,100,NoArch
b4b09eab4408b6ed295c2f3f4144b6cb2ead791f,2,29,10,19,0,0,0,1,4,2,1,2,0.961236605,326,31,8,37,34,3,1379,1260,119,13,10,3,1,100,NoArch
1f6a8b8cc22e032c4d27fa59f24dc2980278a466,2,49,49,0,0,0,0,2,5,2,1,2,0.617448296,528,32,9,36,29,7,2838,2654,184,9,8,1,1,100,NoArch
fb36cac586333511ee618c597599f00efa862318,4,241,189,52,0,0,0,1,9,828,1,1,0.397847193,634,24,0,63,60,3,1970,1913,57,32,29,3,1,100,NoArch
58ed1f6a168c1de646bd949ba52d9782a7acb961,4,105,26,79,0,0,0,1,12,12,1,2,0.815461724,1731,33,10,241,221,20,8531,7976,555,55,52,3,1,100,NoArch
ec508f1e64db2db479aaa5d018200fc0b0f414a0,3,106,16,90,0,0,0,2,7,8,1,3,1.361973548,900,34,11,108,98,10,5630,5183,447,27,24,3,1,100,NoArch
e8421fc0e4c8bf55cab57b67b996f4ad10fa8ea5,32,203,107,96,0,0,0,1,13,225,2,8,4.113026,8499,35,12,786,778,8,37372,36604,768,363,355,8,1,99.70849528,NoArch
b24d78ced19afa23edf9fc67917a780c6f506297,1,9,2,7,0,0,0,4,4,1426,1,1,0,556,551,2,65,64,1,1332,1314,18,38,38,0,1,100,NoArch
838a9346b47906f4d5b2b68c6ac0affdf8cb34da,1,2,2,0,0,0,0,5,15,143,1,1,0,671,552,3,73,73,0,1606,1600,6,39,39,0,1,100,NoArch
f60ab41d3bc6b397f4a21a5a95eabfba67b8c788,0,0,0,0,0,0,0,0,0,0,0,0,0,0,39,1,0,0,0,0,0,0,0,0,0,0,100,NoArch
7d3693b839331442a1f9b6e21458dc5ff68ffc4a,3,6,6,0,0,0,0,1,2,99,1,3,1.459147917,524,40,2,66,66,0,1737,1733,4,25,25,0,0,100,NoArch
c6a471dd311a118ef93cf5b47af040540da44ed2,5,13,6,7,0,0,0,1,3,50,1,2,1.718782892,1451,41,3,181,179,2,9348,9266,82,65,65,0,1,100,NoArch
9e76df424ec18b17f4cc7cfdecfd1dcba10d4f05,1,4,0,4,0,0,0,1,2,115,1,1,0,205,42,4,24,23,1,934,917,17,16,15,1,1,100,NoArch
517e52a20cfe294c8f4028a5e71506ad10679d61,5,26,31,5,0,0,0,1,4,81,1,4,1.717392171,458,43,5,49,49,0,2071,2110,39,13,13,0,0,100,NoArch
318886a6542c7f362d66dd948164fcb805f51ff8,12,1609,7,1602,10,0,10,1,3,14,1,5,2.933504742,266,44,6,150,31,119,8450,1456,6994,69,8,61,1,90.7458789,Arch
840fad1c51162bb7580bfd5a3691b6984e4d0bb1,25,0,2250,2250,0,24,24,2,4,980,1,7,4.461269686,2249,45,7,0,182,182,0,10127,10127,0,91,91,1,91.60927872,Arch
acbeb4ecb4f93abcab994b2a07a683a159f62dae,1,0,578,578,0,1,1,3,4,11,1,1,0,578,46,8,0,29,29,0,2288,2288,0,16,16,1,99.96652159,NoArch
969cfe22feb8763ae156c269131042ab5f95ee77,3,3,3,0,0,0,0,1,3,93,1,3,1.584962501,500,47,9,57,57,0,2054,2048,6,18,18,0,1,100,NoArch
e9a7fcbc94d2327a8107d588b92a62c6d4fa9d31,9,693,0,693,9,0,9,1,1,0,1,1,3.131637819,0,48,10,51,0,51,2937,0,2937,44,0,44,1,92.96138925,Arch
fe83423b6221c8234d0f25a2d236963f7023a8ac,0,0,0,0,0,0,0,0,0,0,0,0,0,0,49,10,0,0,0,0,0,0,0,0,0,1,100,NoArch
ef59bf43ebe18b08a76861c8c32a3b98d2ee5c87,4,0,809,809,0,4,4,2,3,648,1,1,1.458657158,809,50,11,0,82,82,0,2760,2760,0,26,26,1,98.29581317,NoArch
57d996e2018f7516f6ac316ccb12482f57acb950,5,0,1216,1216,0,5,5,2,4,814,1,1,1.805880526,1216,51,12,0,176,176,0,5587,5587,0,34,34,1,96.04081633,Arch
916f5e77226c43ce19488bb4b2b59cdb2f7d0401,12,0,2587,2587,0,11,11,2,9,953,1,1,3.36859209,2586,52,13,0,306,306,0,11095,11095,0,63,63,1,93.72349449,Arch
cf1cfebbab2724e0a1bb8c50a52b9dc6fb3191ae,15,0,2157,2157,0,15,15,2,6,1004,1,2,3.559227744,2157,53,14,0,226,226,0,7529,7529,0,75,75,1,98.53739089,NoArch
97dd12f5d2fb2c5842c26731f7cee58b039a6483,25,0,5873,5873,0,15,15,2,6,841,1,2,3.966886952,5863,54,15,0,735,735,0,29326,29326,0,191,191,1,92.84923622,Arch
291114aaf8430c2aa7eb2a9bf0e25c39065e7dc4,1,0,188,188,0,1,1,3,5,54,1,1,0,188,55,16,0,24,24,0,757,757,0,3,3,1,99.95864351,NoArch
bcc906dd0bb26104fe8a24f6690dde163d7bece3,3,0,757,757,0,3,3,2,6,807,1,1,1.33909163,757,56,17,0,152,152,0,3631,3631,0,24,24,1,99.85492228,NoArch
71de55b2f3bde35f78299574f016732d132dfd1a,15,0,1917,1917,0,14,14,2,2,1155,1,1,3.753163567,1916,57,18,0,220,220,0,7223,7223,0,46,46,1,99.2481203,NoArch
092f11f78dd5be2bb3b9af2c55c83ac0ded7e33e,11,0,1258,1258,0,11,11,2,4,1062,1,1,3.281748369,1258,58,19,0,88,88,0,3804,3804,0,30,30,1,96.16739175,Arch
d7a708f93082b3da573fb130559c8e0963768344,15,0,2587,2587,0,12,12,3,7,872,1,1,3.26580049,2584,59,20,0,138,138,0,7067,7067,0,79,79,1,99.32140654,NoArch
4cae02f5bcfd505be95f4cabab50015063fd65bd,0,0,0,0,0,0,0,0,0,0,0,0,0,0,60,21,0,0,0,0,0,0,0,0,0,1,100,NoArch
ce3858fb97bba46474a9d1e0482e3cabd75ef5be,1,44,4,40,0,0,0,1,4,593,1,1,0,225,553,0,26,25,1,953,907,46,8,7,1,1,100,NoArch
1ee2db2f234b5ea441be87079bc6837db4348b17,1,1,1,0,0,0,0,3,17,294,1,1,0,455,554,1,43,43,0,2369,2363,6,13,13,0,1,100,NoArch
999a62a3dbaa56cddd25a0cb945519deb445db94,1,26,1,25,0,0,0,1,2,163,1,1,0,180,61,12,23,20,3,1089,922,167,8,7,1,1,100,NoArch
2dab31344d10a0c536a3dcfd8018bbdad0293826,1,1,1,0,0,0,0,3,9,306,1,1,0,582,555,2,70,70,0,2292,2298,6,26,26,0,1,100,NoArch
f1e851ffca3565c0b24e44f77eeb0ed0f3d09932,1,10,1,9,0,0,0,2,2,2675,1,1,0,180,556,3,15,14,1,419,370,49,10,10,0,1,100,NoArch
e4feccde80b99525883dc3238a3e35a16e642973,1,121,0,121,1,0,1,1,1,0,1,1,0,0,557,4,10,0,10,464,0,464,3,0,3,1,99.77140482,NoArch
b5c7ddb3e9e7b831b59eda1229096100a0d5e044,1,4,1,3,0,0,0,4,25,363,1,1,0,482,558,0,47,46,1,2241,2233,8,7,7,0,1,100,NoArch
847b358d3d4447013a3fbae13462b8e45cdf8a99,3,317,141,176,1,0,1,1,7,248,1,2,0.988380139,1609,62,0,195,175,20,6099,5376,723,51,38,13,1,98.25242718,NoArch
19078bdd6f3857c5dc461523eb8cdde6a35d5933,9,823,188,635,1,0,1,1,4,174,1,5,1.784264258,2192,63,1,271,157,114,10640,7441,3199,74,58,16,1,93.18035599,Arch
8ad51bfa50e4afb327232c8a63a8d1dde13d5190,1,61,32,29,0,0,0,2,3,2492,1,1,0,305,559,1,47,39,8,1182,1035,147,12,13,1,1,100,NoArch
9eccb80e0fa342b8b5f9fe226f8ffd498feaf052,1,120,26,94,0,0,0,3,18,143,1,1,0,455,560,1,66,43,23,3045,2369,676,16,13,3,1,100,NoArch
9103d63ae2a746a9295c609dd87a647ca41443ef,1,14,0,14,0,0,0,2,14,1017,1,1,0,1966,561,1,220,219,1,5132,5106,26,90,90,0,1,100,NoArch
85c47d019f903e2aff05ecb1a02a8bf486227dae,1,8,0,8,0,0,0,3,7,669,1,1,0,805,562,2,98,96,2,2269,2243,26,33,33,0,1,100,NoArch
c11356ca7c5c16e9938118f5adac89d5670e559c,4,121,29,92,0,0,0,3,29,705,2,3,1.622144018,2564,563,3,270,263,7,7950,7796,154,125,123,2,1,93.77034947,Arch
3b44e01a330b08a5e2bc3b9997c2a6306009d70c,3,3,3,0,0,0,0,3,30,0,1,2,1.584962501,2170,564,4,221,221,0,6833,6833,0,93,93,0,1,100,NoArch
623f47497313d434b653242dda142228b73c98f6,1,5,4,1,0,0,0,3,20,0,1,1,0,549,565,5,72,71,1,1947,1942,5,16,16,0,1,100,NoArch
7a4e7f5ba1c88dac5cde552b13eef57163f1a9b1,1,32,5,27,0,0,0,3,9,938,1,1,0,836,566,6,85,80,5,2582,2496,86,43,43,0,1,100,NoArch
4b44b7d9c7b74eeeca3121b524b0c1d7dbb75bd3,2,28,8,20,0,0,0,2,37,1332,1,2,0.581321499,1690,567,7,45,41,4,4949,4896,53,13,13,0,1,100,NoArch
c190a33c48f4816c849327304c66cbe41b984dd2,1,6,3,3,0,0,0,2,4,839,1,1,0,122,568,1,13,11,2,385,373,12,3,3,0,1,100,NoArch
b46f2a70aa22a4001a42cd08a7a918c07d406406,126,0,21326,21326,0,126,126,1,14,472,1,8,6.286679209,21326,36,0,0,1874,1874,0,73709,73709,0,1106,1106,1,85.07860378,Arch
2a891ae3e5027e601d6ab84376581b0f22153401,93,14906,0,14906,93,0,93,1,8,0,1,8,5.871067783,0,37,1,1486,0,1486,57242,0,57242,911,0,911,1,87.86080388,Arch
d1c764fa8f40cc5e71ade98ecfa490f64657befd,5,59,115,56,0,0,0,2,5,312,1,3,1.64396019,1163,38,2,115,127,12,4965,5390,425,31,31,0,1,99.92977528,NoArch
8e2241ae208ef17a6dd9aee47cd93eea654d206a,1,1,2,1,0,0,0,2,2,247,1,1,0,576,39,3,29,29,0,2261,2277,16,16,16,0,1,100,NoArch
6bd30a5306e36b56ca3b7b75ddb027d40e2de8f3,0,0,0,0,0,0,0,0,0,0,0,0,0,0,40,4,0,0,0,0,0,0,0,0,0,1,100,NoArch
08880695300c6c6c0e09d2edffaf52f97340cfd4,0,0,0,0,0,0,0,0,0,0,0,0,0,0,41,5,0,0,0,0,0,0,0,0,0,1,100,NoArch
4eaa9765cdf95ac11b8cafc58dc6d2e4bf9771b0,0,0,0,0,0,0,0,0,0,0,0,0,0,0,42,6,0,0,0,0,0,0,0,0,0,1,100,NoArch
44cf9d5bf94c188134be659ddf12f2416804d204,1,2,1,1,0,0,0,3,10,54,1,1,0,863,569,1,86,85,1,2586,2582,4,43,43,0,1,100,NoArch
c5c9b5133bd3af867cdda0be8ba9d7bb6892d5f0,0,0,0,0,0,0,0,0,0,0,0,0,0,0,570,2,0,0,0,0,0,0,0,0,0,0,100,NoArch
adc1969ba3f106fd6ac91e9bc4a8af14dc635736,1,47,48,1,0,0,0,2,15,57,1,1,0,1980,571,3,218,220,2,5145,5132,13,90,90,0,1,100,NoArch
ff231c40e8bff118fe711ee494605280f2031128,1,2,5,3,0,0,0,5,17,444,1,1,0,1612,572,4,265,265,0,5464,5471,7,30,30,0,1,100,NoArch
4443bbc3fc72312915a91b91fcbdf64073048a0b,1,240,0,240,1,0,1,1,1,0,1,1,0,0,573,5,34,0,34,1030,0,1030,6,0,6,1,90.65376446,Arch
3f218177a79fd7987bd371a5421ecb9ef24823d8,4,71,52,19,0,0,0,2,18,540,2,3,0.752783062,3308,43,7,523,519,4,12526,12409,117,88,87,1,1,94.25424946,Arch
4c9451158a960b3cb54502b5fa8c621ddb7b9d48,2,51,11,40,0,0,0,3,19,751,1,1,0.987956501,653,574,6,79,72,7,3508,3293,215,19,18,1,1,100,NoArch
90fca9b6680846aa728e4f015ae6ea3dbea11a5f,2,13,4,9,0,0,0,3,20,0,1,1,0.522559375,693,575,7,81,79,2,3548,3508,40,19,19,0,1,100,NoArch
c6c8af4e5042b5a881276a1227fe3e6c543743a8,3,12,6,6,0,0,0,2,10,1561,1,3,0.986426729,1274,64,0,153,151,2,5501,5473,28,47,46,1,1,100,NoArch
ad18bc7f935f13fd89fc8daf37fbeab171fbb698,4,52,21,31,0,0,0,2,19,2112,1,2,0.983037026,765,576,8,60,57,3,2837,2795,42,31,29,2,1,100,NoArch
61c24d046d7f8fd49ff80851b95691de92d17794,2,4,4,0,0,0,0,2,5,87,1,2,1,1672,65,1,128,129,1,5824,5830,6,28,28,0,1,100,NoArch
fa32e5b29abb86497eaed878ecb7d8220e5a6cff,1,1,1,0,0,0,0,4,4,1440,1,1,0,138,25,0,12,12,0,189,189,0,12,12,0,1,100,NoArch
0e8c76566c707c3506e42403cb1ec4320de49bce,4,101,70,31,0,0,0,3,26,332,1,1,1.848499998,2125,577,3,237,231,6,9874,9570,304,66,62,4,1,99.95183044,NoArch
6d5ba4c94f16e8ac79dfb6d08bb44247ab7a98cd,1,2,1,1,0,0,0,3,4,2642,1,1,0,269,26,1,28,29,1,893,895,2,9,9,0,1,100,NoArch
aaf9803756e81f0c174769e29d4c63e89ae37bf3,2,57,14,43,0,0,0,2,38,772,1,2,0.312733376,1672,578,4,39,35,4,5034,4781,253,13,13,0,1,100,NoArch
c192219fe66a5574e30b6533feaf98c92986e95e,5,1176,65,1111,1,0,1,1,5,519,1,2,0.70651894,1423,579,2,234,115,119,11039,4698,6341,124,95,29,1,99.49531363,NoArch
dbc94e487597663f8198ed772b2c36f70e38c563,1,36,1,35,0,0,0,4,14,438,1,1,0,539,580,3,68,63,5,2540,2351,189,14,13,1,1,100,NoArch
7e4dcd35b9ff0906bb803450b0f513194981635f,1,1,0,1,0,0,0,3,3,713,1,1,0,427,581,4,28,28,0,2034,2032,2,7,7,0,1,100,NoArch
c627ff542713c2ac8095e52d74e79052efa98f6d,1,24,19,5,0,0,0,2,2,2311,1,1,0,366,582,5,44,45,1,1302,1298,4,18,18,0,1,100,NoArch
27d8e6390d71e272ad31027eb169227238b4e4a1,2,7,10,3,0,0,0,1,4,420,1,2,0.997502546,209,66,0,22,23,1,670,681,11,13,13,0,1,100,NoArch
c4503ac5e7cfce4d66fee5bbc8fbe5bb0ffa57ef,1,3,1,2,0,0,0,3,22,63,1,1,0,531,583,4,65,65,0,2976,2972,4,16,16,0,1,100,NoArch
67e75586d541dc2a70d8d8826ce9012a82cf4fe4,2,17,8,9,0,0,0,1,2,140,1,1,0.942683189,710,44,0,122,119,3,4563,4551,12,31,31,0,1,100,NoArch
acdba754d0f015d6e70af2b9f9a7599abb78f5ff,1,3,3,0,0,0,0,1,2,146,1,1,0,225,45,1,21,21,0,1303,1303,0,7,7,0,1,100,NoArch
b3af5130f305e4a92a286c371222a5fba2d74b60,2,67,3,64,0,0,0,2,8,76,1,2,0.96197806,917,46,2,142,132,10,5924,5512,412,42,41,1,1,100,NoArch
65865c29cf9b33c31513ee5f49c604e75c52776f,1,3,0,3,0,0,0,2,4,247,1,1,0,177,47,3,22,21,1,1033,1023,10,5,5,0,1,100,NoArch
5e87ce3488952acd7f9aa6b31620efe46591d49f,1,4,0,4,0,0,0,2,2,463,1,1,0,90,48,4,13,12,1,309,299,10,3,3,0,1,100,NoArch
fa81062e9efa9b50a8b18b39069296b6ae23504d,1,5,0,5,0,0,0,2,3,247,1,1,0,394,49,5,64,63,1,1865,1853,12,7,7,0,1,100,NoArch
c64d24d07a9f9d8cb50647322965a2c9725490b5,1,3,0,3,0,0,0,2,2,394,1,1,0,159,50,6,17,16,1,757,747,10,4,4,0,1,100,NoArch
e73268b0809f8eb26fbb15df1c89e2bf40756962,1,1,0,1,0,0,0,2,2,388,1,1,0,119,51,7,12,12,0,544,542,2,5,5,0,1,100,NoArch
aa35407128337055e41844f69b7d2a55d86dbe77,3,101,2,99,1,0,1,1,14,481,1,3,0.425225891,1494,584,1,122,121,1,5928,5291,637,71,70,1,1,99.95206136,NoArch
d861ecae1ccdefa695607b5d0d206e73c68a69e4,0,0,0,0,0,0,0,0,0,0,0,0,0,0,52,8,0,0,0,0,0,0,0,0,0,1,100,NoArch
f0bcbd83c553e97614fd447613c2de0b6e97aa02,1,5,3,2,0,0,0,4,9,764,1,1,0,551,585,2,47,45,2,1832,1818,14,16,16,0,1,100,NoArch
645027540925f6ff90c1709539efcd3508ba0e5e,1,5,0,5,0,0,0,1,4,17,1,1,0,657,53,9,117,114,3,4393,4346,47,24,24,0,1,100,NoArch
2fbc31fff0d88348ea604213eb43c8006f46a760,7,79,57,22,0,0,0,1,3,412,1,2,2.021615263,1574,67,0,199,193,6,8626,8418,208,47,46,1,1,100,NoArch
974257c7506f41f59bb85204bc9c5ee2befcd862,1,18,3,15,0,0,0,4,12,840,1,1,0,617,586,3,77,72,5,3270,3195,75,26,26,0,1,100,NoArch
9625c470b1e256faaf1db8b61680ce814a8be2a0,2,6,0,6,0,0,0,2,6,112,1,2,0.918295834,1672,68,1,129,128,1,5865,5824,41,28,28,0,1,100,NoArch
6058430cd397a132c60e7b98b3305768bee68e99,1,56,6,50,0,0,0,2,5,2159,1,1,0,1197,587,4,169,163,6,6753,6501,252,61,59,2,1,100,NoArch
848b1779c29fe3232f11e1d49153b3bbe90a3e5e,3,7,3,4,0,0,0,4,27,303,1,2,1.370950594,1322,588,4,141,141,0,6119,6123,4,30,30,0,1,100,NoArch
abed1421721418608ad988a54a96f06e856f04be,6,162,110,52,0,0,0,2,5,2086,2,3,1.86016406,1888,589,5,327,308,19,9261,8925,336,107,104,3,1,99.92798848,NoArch
e45cebbe90eaa0a336253b00e255e81f3003151e,1,21,6,15,0,0,0,4,12,855,1,1,0,442,590,6,52,51,1,1814,1787,27,11,11,0,1,100,NoArch
40be8220b155c9f81fd1e8da18a8d464b22fe7c0,1,8,5,3,0,0,0,2,7,40,1,1,0,750,54,0,129,129,0,3988,3960,28,28,28,0,1,100,NoArch
edffee3ecae1d0d2b03189dc2099b4014d18dba4,1,1,1,0,0,0,0,2,8,0,1,1,0,753,55,1,129,129,0,3992,3988,4,28,28,0,1,100,NoArch
eb256b4396bd3eb0d177d9b8448f7edccc22384b,2,48,14,34,0,0,0,1,4,1020,1,1,0.996995427,578,591,3,53,47,6,2701,2497,204,9,9,0,1,99.85587317,NoArch
7254525fb5fb9824d18198a64bd221d712671151,2,90,80,10,0,0,0,3,6,1778,1,2,0.92024415,951,592,4,109,107,2,3131,2956,175,54,54,0,1,100,NoArch
ccd417a3f9a519876852b23af594253f162b10ef,1,24,14,10,0,0,0,3,11,167,1,1,0,442,593,2,44,43,1,1422,1393,29,23,23,0,1,100,NoArch
c796d7ada08a35c6101c6636b6d423d34791708d,2,22,0,22,0,0,0,1,10,524,1,2,0.994030211,482,594,3,49,46,3,1827,1735,92,16,15,1,1,100,NoArch
aa86ced98b099476d0d88b5394218925284e39a5,6,227,70,157,2,0,2,1,28,990,1,3,2.003960977,961,595,4,100,90,10,4403,4009,394,28,22,6,1,99.90412272,NoArch
7c74c2850c8267983f8e4b0a01f587d1ad13f653,1,107,0,107,0,0,0,2,2,3112,1,1,0,49,596,5,12,2,10,510,70,440,4,2,2,1,94.21214269,Arch
6115c35349bf084287d668459b9933ae6a1f072e,2,31,27,4,0,0,0,2,5,80,2,2,0.578794625,1247,69,0,231,231,0,7528,7479,49,68,69,1,1,100,NoArch
e465b99797aa0bd6d8c02b59d0155792a339ff07,2,17,3,14,0,0,0,1,7,287,2,2,0.721928095,680,70,1,94,92,2,2445,2404,41,29,28,1,1,100,NoArch
94160b14461715d23c21d957dcc2f8ae9dd236ca,2,3,18,15,0,0,0,1,8,2,2,2,0.702466551,694,71,2,93,94,1,2412,2445,33,28,29,1,1,100,NoArch
295cede6d690f0516c6bf1b0b50ecbab86ad2df0,1,441,114,327,0,0,0,2,4,2288,1,1,0,343,597,0,152,71,81,3840,2174,1666,24,14,10,1,100,NoArch
bb456d95576b4c5b90e74345b00d5f60050c6127,1,11,3,8,0,0,0,2,5,0,1,1,0,670,598,1,153,152,1,3898,3840,58,24,24,0,1,100,NoArch
c357bc61cc27398828c7cc3b1915b8421f85cd18,1,92,2,90,0,0,0,3,10,156,1,1,0,1392,599,2,141,118,23,5079,4779,300,67,67,0,1,100,NoArch
eace986b8459bcc899e2b89c82ad54ed72c1c805,2,554,541,13,0,0,0,1,5,1390,2,2,0.019247656,665,72,0,100,99,1,2951,2849,102,26,26,0,1,100,NoArch
8f5e6767d2df0575f58d562d74a03da925542d21,1,588,0,588,1,0,1,1,1,0,1,1,0,0,600,3,83,0,83,3093,0,3093,13,0,13,1,96.68384495,Arch
b38239da29813147ab13380023ffdae85e326f85,1,88,24,64,0,0,0,2,4,2577,1,1,0,87,601,4,20,18,2,617,418,199,2,2,0,1,100,NoArch
b926af39624d1511dc38793f35b0bbbc8729b213,1,2,0,2,0,0,0,2,5,823,1,1,0,258,602,5,33,33,0,957,949,8,5,5,0,1,100,NoArch
5faeb6bce3644c2410e6a6d89202ea2cc445bd04,1,1,1,0,0,0,0,1,2,186,1,1,0,96,603,6,1,1,0,615,615,0,1,1,0,1,100,NoArch
a6b00672649dde32fc4ff0408965f851a77740ec,11,1150,589,561,2,0,2,1,5,1300,1,5,1.770748028,3063,604,7,367,318,49,11703,9317,2386,170,162,8,1,98.85007594,NoArch
889664265b4e1afcadd97dbf3f73031d94973c08,11,589,1150,561,0,2,2,1,6,0,1,5,1.770748028,3624,605,8,318,367,49,9317,11703,2386,162,170,8,0,98.85007594,NoArch
8ddba910fb755e3d31b24b8ed0e6126ad53a5a95,5,558,511,47,0,0,0,3,7,0,1,3,0.398258393,2277,606,9,257,254,3,6892,6728,164,136,136,0,1,100,NoArch
df8d4ab5cb6b43e2bcead2d2bafea7d0c3190cb5,1,310,263,47,0,0,0,2,6,195,1,1,0,1247,607,5,170,169,1,6772,6753,19,61,61,0,1,100,NoArch
565b8cb741520c529c340a9298870bb7ef0df8e9,18,2901,305,2596,8,0,8,2,39,832,2,8,3.718390336,8845,608,5,1106,862,244,35142,27429,7713,389,276,113,1,93.82120947,Arch
2848927f4b3a8df1a01635e93f6838f0a5a0249e,1,16,11,5,0,0,0,3,11,360,1,1,0,864,609,6,87,86,1,2618,2586,32,43,43,0,1,100,NoArch
5aa704f3c7109bdbf396c7992ededd5d9e682627,1,4,4,0,0,0,0,2,7,14,1,1,0,1294,610,3,171,170,1,6779,6772,7,61,61,0,1,100,NoArch
0fdd1376eef8d46f99f8fffc8406a5db1d0132b9,2,102,30,72,0,0,0,4,12,171,1,1,0.359101626,1457,611,4,167,158,9,5138,4938,200,70,70,0,1,100,NoArch
5b1705da8f78738fc3a4835dbcdb8f277485afe2,1,6,6,0,0,0,0,2,3,2129,1,1,0,198,612,5,20,20,0,576,585,9,9,9,0,1,100,NoArch
c1941b1ddcd1e6dd225e4942de9d912e999864a7,3,71,45,26,0,0,0,2,6,1853,1,2,0.806772791,766,613,6,71,69,2,2944,2885,59,24,24,0,1,99.9554764,NoArch
a4c8f88f23709e7674bb2df68e3d37439cffa3df,1,1,0,1,0,0,0,2,7,0,1,1,0,431,614,7,38,38,0,1845,1838,7,14,14,0,1,100,NoArch
b231362efe851ec74ed549e5f038ad6be117fe93,0,0,0,0,0,0,0,0,0,0,0,0,0,0,615,8,0,0,0,0,0,0,0,0,0,0,100,NoArch
d76d9cf7ccfa76aaa4aeb36882ce2301acc8a255,102,518,448,70,0,0,0,1,6,33,2,14,6.131817591,17389,616,9,1741,1741,0,67107,67244,137,1003,1003,0,1,86.352657,Arch
9531ae2e150388c162f4ab69e729c29018926156,0,0,0,0,0,0,0,0,0,0,0,0,0,0,617,10,0,0,0,0,0,0,0,0,0,0,100,NoArch
048747bfaf5ef85127095c9bb6baae7a657673f8,0,0,0,0,0,0,0,0,0,0,0,0,0,0,56,0,0,0,0,0,0,0,0,0,0,1,100,NoArch
0063210109f21b0c723d44c663b401f74e20ef1c,93,11520,10279,1241,0,0,0,2,2,0,1,8,5.475447312,15052,57,1,1502,1502,0,56801,57670,869,912,912,0,1,99.41860465,NoArch
a1813d985ac93c52ee36120044bba0f3486a1318,144,15646,13314,2332,0,0,0,2,9,540,1,24,6.346530062,20412,58,2,2181,2181,0,86606,86606,0,759,759,0,1,100,NoArch
1b58a5303f132297577d06cefd2e8178a8ad209d,0,0,0,0,0,0,0,0,0,0,0,0,0,0,618,11,0,0,0,0,0,0,0,0,0,1,100,NoArch
061fcd36bf943658dad5c445b94fe2021c6d7489,0,0,0,0,0,0,0,0,0,0,0,0,0,0,619,12,0,0,0,0,0,0,0,0,0,1,100,NoArch
da7e1be335e89a7ab6e6adb1cf2b071cc1e21295,1,36,15,21,0,0,0,3,3,3249,1,1,0,124,620,13,12,9,3,361,291,70,7,7,0,1,100,NoArch
cd14019b9d5a82db3282685114410ce788f8bcbb,3,277,42,235,1,0,1,1,8,976,1,2,1.265629927,729,621,14,98,74,24,4021,2616,1405,41,32,9,1,99.8678996,NoArch
0cb77da8f1ba43f08231006eaee8635238ebf052,0,0,0,0,0,0,0,0,0,0,0,0,0,0,59,3,0,0,0,0,0,0,0,0,0,1,100,NoArch
1b8ac76ff70357472f2dfb40d38efa27fa928da7,7,154,81,73,0,0,0,2,15,2107,1,5,1.373221927,1168,622,15,114,104,10,4760,4518,242,43,39,4,1,100,NoArch
217c7fda8adc5909770275365fbfcac608c5156e,1,1,1,0,0,0,0,4,8,0,1,1,0,401,623,16,44,44,0,1399,1399,0,19,19,0,1,100,NoArch
2c67a222027dc45bbf9c43267c7dd7768a9a2ead,1,10,5,5,0,0,0,2,2,1379,1,1,0,155,624,17,7,7,0,582,546,36,4,4,0,1,100,NoArch
1d85d92a80f49b5d777eb2dd61b2991806113222,1,32,15,17,0,0,0,1,2,591,1,1,0,121,625,18,13,10,3,549,464,85,4,3,1,1,100,NoArch
c0b1dafed7f86380c0f90a7cfbffef618203d146,1,9,4,5,0,0,0,4,9,3,1,1,0,401,626,18,45,44,1,1407,1399,8,19,19,0,1,100,NoArch
b3f5babbfb34e22feeba56f0beeb34dda67b69a1,0,0,0,0,0,0,0,0,0,0,0,0,0,0,627,9,0,0,0,0,0,0,0,0,0,0,100,NoArch
ad80c4792ed97845cad3d429f63e27cfd541c3a1,0,0,0,0,0,0,0,0,0,0,0,0,0,0,628,10,0,0,0,0,0,0,0,0,0,0,100,NoArch
fa28aa22937ece6dc3be9f923a8717edd1a36e35,0,0,0,0,0,0,0,0,0,0,0,0,0,0,629,11,0,0,0,0,0,0,0,0,0,0,100,NoArch
8c7e701e58822fa535e4cf0c98265b91b189d91c,0,0,0,0,0,0,0,0,0,0,0,0,0,0,630,12,0,0,0,0,0,0,0,0,0,0,100,NoArch
55493cc13e6f045cddd2f85dc84cb4f7d77aee62,0,0,0,0,0,0,0,0,0,0,0,0,0,0,631,13,0,0,0,0,0,0,0,0,0,0,100,NoArch
325e10bfc1a769d3102501383d7aa365b5ae4707,0,0,0,0,0,0,0,0,0,0,0,0,0,0,632,14,0,0,0,0,0,0,0,0,0,0,100,NoArch
3b76fff978c8956f496a5fa5c0546c2844cf0a3a,0,0,0,0,0,0,0,0,0,0,0,0,0,0,633,15,0,0,0,0,0,0,0,0,0,0,100,NoArch
5d8d3d5568acaf2e9e13cad97be43d436b8412d6,0,0,0,0,0,0,0,0,0,0,0,0,0,0,634,16,0,0,0,0,0,0,0,0,0,0,100,NoArch
cc7eeb2147fa787468542bc8a577fe35c19c0473,0,0,0,0,0,0,0,0,0,0,0,0,0,0,635,0,0,0,0,0,0,0,0,0,0,0,100,NoArch
52e12df5c51b0eef320ff731028facf531cf52d2,583,44965,50461,5496,228,254,482,0,34,60,6,95,8.415067024,89501,544,0,8472,9228,756,302534,330021,27487,3304,3762,458,0,71.75393285,Arch
e603efe060dd061310e54135e242589be52b777e,0,0,0,0,0,0,0,0,0,0,0,0,0,0,850,5,0,0,0,0,0,0,0,0,0,0,100,NoArch
e07aad57feedbcd39c9ec390844690738380a43e,0,0,0,0,0,0,0,0,0,0,0,0,0,0,851,6,0,0,0,0,0,0,0,0,0,1,100,NoArch
c948e3dc6e3ca72d2027eaf45af4836716178c9e,1391,115368,114126,1242,447,319,766,3,121,477,9,177,9.46862805,205918,31,3,19534,20985,1451,723960,769191,45231,9307,9572,265,1,68.30783939,Arch
c3f3b81bd88638b19647ee35c3567eecb92b0085,1391,114135,115377,1242,367,447,814,2,64,253,9,177,9.470086194,207208,852,7,18843,21708,2865,694549,798873,104324,8610,10329,1719,1,68.30783939,Arch
c4bc1d9ebe76644f527452225125c1f57da98a19,1391,115368,114126,1242,447,367,814,3,121,477,9,177,9.46862805,205966,1161,2,19534,20985,1451,723960,769191,45231,9307,9572,265,1,68.30783939,Arch
8d405e9d20cd6fc3bf2fe73bee01963f2469500b,6,609,59,550,1,0,1,8,122,66,2,5,1.937793656,2750,32,4,343,280,63,9221,7922,1299,152,124,28,1,99.96940961,NoArch
8debfaeaf8292318c4113b69476d8cc3be49f2ce,7,13,13,0,0,0,0,4,19,345,1,3,2.719294526,1569,33,5,124,124,0,8796,8757,39,37,37,0,1,100,NoArch
ce605229b03112af6373c6f9e546144981b4dde6,1,1,1,0,0,0,0,2,2,3,1,1,0,257,1615,45,32,32,0,470,469,1,16,16,0,1,100,NoArch
e09f706cab252f8d08147c34314ec2b63d8c3fc2,1,19,8,11,0,0,0,4,37,9,1,1,0,551,257,11,49,48,1,2494,2426,68,14,14,0,1,100,NoArch
787a6704fbbccfac85a17ffd3567df779872e66c,2,4,6,2,0,0,0,5,123,99,1,2,0.721928095,1707,1616,46,167,168,1,5143,5155,12,84,84,0,1,100,NoArch
bd1523131062a32f14a94da382ea6a99da95a57d,1,18,10,8,0,0,0,4,38,0,1,1,0,562,258,12,50,49,1,2520,2494,26,14,14,0,1,100,NoArch
df0ae1a9db10a09d95ce75fa83e3069c49a0ccbc,1392,114112,115921,1809,367,448,815,2,64,253,9,177,9.470428262,207775,853,8,18843,21772,2929,694549,800315,105766,8610,10357,1747,1,68.28607837,Arch
d2b22f056ba4ca3edd58e059653055951e5290e2,1392,115910,114101,1809,448,367,815,3,123,476,9,177,9.468783385,205966,1162,3,19598,20985,1387,725381,769191,43810,9335,9572,237,1,68.28607837,Arch
9b329a48d9eab883815e1cc29c5e528a830d10fb,1392,114110,115921,1811,367,448,815,2,64,253,9,177,9.470421154,207775,373,3,18843,21772,2929,694549,800315,105766,8610,10357,1747,1,68.28607837,Arch
68c2b6aba15aad391fa2ca8939ecf37e31384b90,1392,115915,114099,1816,448,367,815,3,123,476,9,177,9.46875847,205964,259,13,19598,20985,1387,725379,769191,43812,9335,9572,237,1,68.28607837,Arch
01f62e999cf0b2937b03b6e4729886dee382f44e,1392,114109,115926,1817,367,448,815,2,64,253,9,177,9.470399724,207780,374,4,18843,21772,2929,694542,800313,105771,8610,10357,1747,1,68.28607837,Arch
8931bbc46405c2c5bf917f7a50e7172492bd99b8,1392,115918,114098,1820,448,367,815,3,123,476,9,177,9.468744051,205963,260,14,19598,20985,1387,725385,769184,43799,9335,9572,237,1,68.28607837,Arch
edf632cd527818ab9de3e3cbfb7c870b17acb352,24,266,924,658,0,2,2,6,124,175,3,17,3.380295779,12599,671,37,1272,1325,53,39463,42528,3065,539,569,30,1,99.81656986,NoArch
e423081a663589fd6eb775a1afd31f32d0ec0200,17,696,414,282,3,0,3,2,92,56,3,7,3.196878107,7504,672,38,1011,990,21,29273,28629,644,224,204,20,1,94.87505968,Arch
27d9387f3cae9312eb238c0f64930b9915917a06,1,5,0,5,0,0,0,5,6,535,1,1,0,248,261,15,21,20,1,1297,1253,44,7,7,0,1,100,NoArch
2d482090e9c40abadff25d3f7ffc11dfef3bab65,1,0,1,1,0,0,0,2,7,2,1,1,0,2055,1617,42,239,239,0,5300,5313,13,106,106,0,1,100,NoArch
8e1df50f5fd88da7bb1c0a72f91034f6915fc2a0,1,1,1,0,0,0,0,3,5,243,1,1,0,95,1618,43,8,8,0,229,229,0,6,6,0,1,100,NoArch
e6a40ae0a87a872e8f12ecfc68c39aee14da272e,1,4,0,4,0,0,0,5,10,21,1,1,0,1260,262,16,153,151,2,3872,3852,20,59,59,0,1,100,NoArch
d95828a80128552867b6f36cac752515a2427bb5,1,4,0,4,0,0,0,2,5,512,1,1,0,113,1619,44,3,3,0,579,552,27,1,1,0,1,100,NoArch
e9a1176a31bea29c40a4ba67567556e195aa94b3,1,17,1,16,0,0,0,3,5,134,1,1,0,67,1620,45,3,3,0,426,280,146,2,2,0,1,99.93355482,NoArch
50cbd48877f3f75ed651cf720b28181cd173bfcd,1,18,6,12,0,0,0,5,7,1,1,1,0,253,263,17,23,21,2,1339,1297,42,7,7,0,1,100,NoArch
280ef34ef631ceec0fcbc1fb956e9f0ff95a5d2f,1,1,1,0,0,0,0,3,6,2,1,1,0,117,264,18,3,3,0,572,579,7,1,1,0,1,100,NoArch
af07b3b313c4df8eea622a06ff5311b1dd54aa60,1394,114567,116041,1474,368,450,818,2,64,253,9,177,9.473533423,207447,375,5,18844,21744,2900,694593,798090,103497,8610,10349,1739,1,65.79690876,Arch
9d62e41def0c5660957a8b8feda579fc307d5c39,1394,116038,114553,1485,450,368,818,3,124,476,9,177,9.471886281,205973,1621,42,19572,20986,1414,723272,769235,45963,9325,9572,247,1,65.79690876,Arch
9242676dbf923681a0fdd0b624eb8d9dc4b7748a,1,8,0,8,0,0,0,6,10,5,1,1,0,304,1622,43,39,38,1,1606,1573,33,6,6,0,1,100,NoArch
72796c9d0290ee8a99bdb614d09f2b6f8f74d73d,1,6,12,6,0,0,0,6,11,0,1,1,0,312,1623,44,39,39,0,1565,1606,41,6,6,0,1,100,NoArch
dd7fa6c0f1af32197c77639bc3fd81b3f64b34ee,1,2,4,2,0,0,0,6,12,2,1,1,0,306,1624,43,39,39,0,1548,1565,17,6,6,0,1,100,NoArch
28fd88453d09388283dc8d67a33af38e52871259,1394,114582,116066,1484,368,450,818,2,64,253,9,177,9.473605596,207458,376,5,18844,21746,2902,694593,798114,103521,8610,10349,1739,1,65.79690876,Arch
044aa666664c13a7839dbebb6cefbdfee7694f8c,1394,116052,114567,1485,450,368,818,3,124,476,9,177,9.472031715,205974,1625,44,19573,20986,1413,723247,769235,45988,9325,9572,247,1,65.79690876,Arch
1afacc5b13405135a85061889e2a5c06928d9692,3,213,72,141,1,0,1,2,47,8,1,2,1.511845496,1326,1626,45,174,156,18,7227,6282,945,47,41,6,2,97.85286871,Arch
0f1bd832a1b4877779c4ec5dd40313d7c9c488c9,1,17,0,17,0,0,0,1,2,0,1,1,0,73,1627,46,4,4,0,428,428,0,3,3,0,1,100,NoArch
c65de821e2bf6c69ed7d4396e51a7314f60ea185,2,42,37,5,0,0,0,2,6,2,1,1,0.957863024,407,1628,46,44,44,0,1918,1869,49,15,16,1,1,100,NoArch
7d5eced96ea5f6a8d58a56237322121745d5f9a5,1395,114580,116229,1649,368,451,819,2,64,253,9,177,9.474676459,207622,377,4,18843,21764,2921,694580,799108,104528,8610,10354,1744,1,64.23164936,Arch
c2d1d2dafe5f69056c797c1071cda8f876a1fbda,1395,116215,114566,1649,451,368,819,3,124,476,9,177,9.473106922,205973,1163,2,19591,20985,1394,724272,769222,44950,9330,9572,242,1,64.23164936,Arch
1ccf9e118032ec836dc6302d31439a0af80ce08d,1,23,38,15,0,0,0,4,49,0,1,1,0,2025,1164,3,276,277,1,7393,7428,35,45,45,0,1,100,NoArch
55447fe5a008ba4c7b8ff9de83cf545cabada398,4,255,85,170,1,0,1,1,48,20,1,4,1.93228201,1280,1629,47,162,141,21,6755,6128,627,56,39,17,1,94.16035354,Arch
02ff81880630446192f377bb16c96f3d24af0810,1,28,0,28,0,0,0,1,2,0,1,1,0,130,1630,48,14,14,0,446,446,0,8,8,0,1,100,NoArch
2d195d3215197621fe28d040d3a961fb21bf1e64,3,30,20,10,0,0,0,1,8,0,1,3,1.478845536,470,1631,49,45,42,3,1774,1771,3,29,27,2,1,100,NoArch
95517eef068522b1ed7fc839a47ad15de051f835,1,39,27,12,0,0,0,2,7,2,1,1,0,321,1632,50,43,41,2,1502,1467,35,14,13,1,1,100,NoArch
dc010e273df60b8ecdd0676522dd28f070c0c38e,5,446,0,446,4,0,4,1,49,0,1,2,2.19849297,1008,1633,51,162,120,42,7002,4984,2018,47,29,18,1,94.60853258,Arch
5eb08d0a5b81ef92c64cccc0cad9a3630389408d,1,1,2,1,0,0,0,4,50,2,1,1,0,2010,1165,4,276,276,0,7393,7393,0,45,45,0,1,100,NoArch
45bb6886337f6a3912b8755874aa41504469becb,1400,114561,116879,2318,368,456,824,2,65,252,9,178,9.483145804,208272,854,9,18842,21831,2989,694570,801787,107217,8610,10392,1782,1,66.99164345,Arch
171e201af150d2a5204bd5152737becc4b6cbfc2,1400,116865,114547,2318,456,368,824,3,124,470,9,178,9.481581096,205954,1634,52,19658,20984,1326,726921,769212,42291,9368,9572,204,1,66.99164345,Arch
4022d1f7b3372d24b11cdcb9e963f63838c025e3,1,2,1,1,0,0,0,8,65,36,1,1,0,1407,1166,5,164,164,0,5767,5761,6,45,45,0,1,100,NoArch
04cbf4c916054a26ba1db424a83ac0b6d8fc7cb6,1,9,2,7,0,0,0,8,66,2,1,1,0,1408,1167,6,165,164,1,5785,5767,18,45,45,0,1,100,NoArch
0cb8d1144ac51a532a90932bc5373ad5f13c4405,3,3,3,0,0,0,0,2,5,4,1,2,1.584962501,380,1635,44,30,30,0,1729,1726,3,18,18,0,1,100,NoArch
caf2c4dac88e1cc552a459e8da84904d269342e3,4,31,8,23,0,0,0,2,82,29,2,3,1.49839172,2298,1636,45,231,229,2,13848,13758,90,68,68,0,1,100,NoArch
4e9cb6b48fd3a19d0c04ffdb4079864f84a409dd,1,8,3,5,0,0,0,2,7,95,1,1,0,229,1637,32,25,24,1,712,696,16,17,17,0,1,100,NoArch
4b22f709c1cab0b083f97389ee5d3c89622f5a58,1,9,12,3,0,0,0,4,101,18,1,1,0,993,1638,33,107,106,1,4448,4468,20,45,44,1,1,100,NoArch
7a4c298108d4f9a1673e12ca219c5a5b776dca17,5,7,10,3,0,0,0,3,125,31,1,5,2.228072225,3137,265,12,369,369,0,9101,9101,0,135,135,0,1,100,NoArch
782179cbf9b81142bb4da1574c8e475bc8001e22,1,6,0,6,0,0,0,3,42,26,1,1,0,992,1639,34,87,87,0,3376,3344,32,50,50,0,1,100,NoArch
02fde2199bb0ed084883d0e8f7ead9a8ff06592a,1,0,12,12,0,0,0,4,102,2,1,1,0,990,1640,35,105,107,2,4406,4448,42,43,45,2,1,100,NoArch
0923ad8e15322a18bfafc184455c69df4db68f66,1,7,3,4,0,0,0,3,13,255,1,1,0,427,1641,36,44,43,1,1200,1184,16,20,20,0,1,100,NoArch
6c341df4ac87166cb17361b46911b35f36ddd6a8,1400,114565,116907,2342,368,456,824,2,65,252,9,178,9.483117875,208300,378,5,18843,21836,2993,694586,801923,107337,8610,10391,1781,1,66.99164345,Arch
82f0a95d39be0d91ba70f8eddda3bec4899611eb,1400,116892,114551,2341,456,368,824,3,125,470,9,178,9.481560288,205958,1642,37,19662,20986,1324,727029,769244,42215,9367,9572,205,1,66.99164345,Arch
3f32252e0ef478e764b942f2bcba43d0e11c3cee,1,0,2,2,0,0,0,3,43,3,1,1,0,998,1168,7,87,87,0,3362,3376,14,50,50,0,1,100,NoArch
aff37af430063452c26d66be89af61df419bdab8,1,11,3,8,0,0,0,4,15,48,1,1,0,678,1169,8,90,89,1,3104,3067,37,19,19,0,1,100,NoArch
fff123e7a1fb32622dac37b47a355dc1f0886f96,1,4,4,0,0,0,0,4,16,0,1,1,0,686,1170,9,90,90,0,3104,3104,0,19,19,0,1,100,NoArch
6e531f34d093b94d3f3237f0b55452b3fec1278a,1400,114566,116912,2346,368,456,824,2,65,252,9,178,9.48309663,208305,855,10,18843,21838,2995,694606,801972,107366,8610,10391,1781,1,66.99164345,Arch
8241e6b751227619bee5521905f281732592c82f,1400,116919,114552,2367,456,368,824,3,125,470,9,178,9.48152409,205959,673,2,19674,20986,1312,727187,769284,42097,9367,9572,205,1,66.99164345,Arch
ac827e3fbc42783023b2ac4cd23ab427571d69b2,1,20,0,20,0,0,0,4,51,18,1,1,0,2009,1171,10,283,276,7,7495,7393,102,45,45,0,1,100,NoArch
9380b50be97fa9b3a19e02f7f751b78e8eda9aef,6,342,13,329,2,0,2,1,51,10,1,5,1.699465095,1529,1643,28,214,175,39,8214,7007,1207,75,61,14,1,99.92695398,NoArch
3a5067733606670045f1d6edadb83f320bb5bd68,6,111,108,3,1,0,1,1,11,0,1,4,1.942159278,804,1644,29,79,84,5,2863,2941,78,40,43,3,1,99.90880905,NoArch
17c93dc9273641074392542a11089f7b4047a915,1,0,8,8,0,0,0,1,2,0,1,1,0,90,1645,30,7,7,0,168,168,0,5,5,0,1,100,NoArch
93d9a690ed8f4c140256af9183f4261684d3c165,1,2,1,1,0,0,0,4,52,0,1,1,0,1054,1646,31,130,130,0,5273,5273,0,32,32,0,1,100,NoArch
0f79e4fe1632b98417e38a10b8d7e35b28e84e43,2,2,2,0,0,0,0,1,6,2,1,1,1,326,1647,32,41,41,0,1030,1028,2,14,14,0,1,100,NoArch
01105469c743f81cba859ff2bda5db282db706dc,1,62,3,59,0,0,0,4,53,2,1,1,0,1055,1648,33,138,130,8,5518,5273,245,33,32,1,1,100,NoArch
f5a4e00062b8cdbfb81ba260ff162880961f9188,3,132,65,67,0,0,0,2,10,41,1,2,0.504450708,565,674,3,80,72,8,2997,2419,578,27,26,1,1,99.92707384,NoArch
170fe0570ed9eb3e6542633e1ab5386c9790769c,1,3,0,3,0,0,0,3,8,345,1,1,0,130,1649,34,11,11,0,416,416,0,4,4,0,1,100,NoArch
8ec0773fa714a2c3dd0fd9ad7c5e42a3745ba16c,4,320,322,2,0,0,0,2,54,29,1,3,1.09272492,1802,675,4,208,209,1,8313,8479,166,81,79,2,1,100,NoArch
649c34530ac7715663f79232e5ca85da12ce4013,63,1274,2072,798,5,5,10,2,126,183,4,30,4.504307241,22454,676,3,2307,2389,82,80210,82404,2194,887,927,40,1,94.63925096,Arch
c5d7bad888dfcdebc3d1e0af948a4b7e40ec579f,1,4,4,0,0,0,0,4,7,1,1,1,0,341,1650,29,38,38,0,1555,1555,0,11,11,0,1,100,NoArch
9d2055da65c471ba4528ea26220a987204541a37,1406,115577,117614,2037,371,462,833,2,65,252,9,178,9.495153266,208000,379,4,18845,21786,2941,694623,800834,106211,8610,10338,1728,1,64.83458778,Arch
9e86795a9127f38ff37ed32dacf4d3267ff22333,1406,117615,115577,2038,462,371,833,3,126,471,9,178,9.493530783,205963,677,4,19648,20952,1304,726894,768150,41256,9342,9546,204,1,64.83458778,Arch
6e620dc582bcffbea094fdf9cba0a23f32c9e23e,1,2,2,0,0,0,0,2,4,10,1,1,0,266,1651,23,36,34,2,1098,1088,10,20,20,0,1,100,NoArch
f3b7db544a454f63015842b43846b5c9deeb5e8d,1,2,2,0,0,0,0,7,27,88,1,1,0,574,1652,23,69,69,0,1862,1862,0,42,42,0,1,100,NoArch
92dc8852d443e17cf29e82d55285a1171258d814,1406,115569,117613,2044,371,462,833,2,65,252,9,178,9.495179205,208001,380,2,18845,21788,2943,694612,800866,106254,8610,10338,1728,1,64.83458778,Arch
6f9791489caae7019f03d194d891aa2e907511ee,1,6,1,5,0,0,0,4,7,1243,1,1,0,389,381,3,53,52,1,1566,1546,20,10,10,0,1,100,NoArch
86313ed69b2082e82169c3f308be3311b513c883,1406,117616,115574,2042,462,371,833,3,126,471,9,178,9.493523489,205962,1653,24,19651,20954,1303,726912,768179,41267,9342,9546,204,1,64.83458778,Arch
6db6bb4e4313ad73111ce80f3c90c93a8a584d19,2,7,13,6,0,0,0,1,3,74,1,1,0.468995594,266,1654,21,35,37,2,1065,1084,19,9,9,0,1,100,NoArch
2efbacb4f122f0e886f3733216c71580db7f139a,1,7,2,5,0,0,0,1,4,0,1,1,0,191,1655,22,29,29,0,842,831,11,7,7,0,1,100,NoArch
dee388d1ccf30e411b0cc5da71d759d87d677423,1406,115583,117615,2032,371,462,833,2,65,252,9,178,9.494990641,208003,382,4,18848,21787,2939,694675,800866,106191,8611,10338,1727,1,64.83458778,Arch
711c2020adff0ca9c2c2e16caf6a8a6fef1126cc,1406,117620,115583,2037,462,371,833,3,126,471,9,178,9.493325855,205971,678,5,19650,20956,1306,726928,768222,41294,9342,9547,205,1,64.83458778,Arch
7a9f88258896366b290ad051c098510aa0d090d8,1,8,2,6,0,0,0,3,9,252,1,1,0,651,1172,6,98,97,1,2574,2510,64,24,24,0,1,100,NoArch
6f4e62ee734eef6be6df0458a0359e2178392aec,2,65,129,64,0,0,0,4,7,527,1,2,0.478723511,555,1656,19,51,61,10,2303,2386,83,11,16,5,1,99.90723562,NoArch
3ca842275895a27e5af44358d7bc00160c7a354e,1,28,7,21,0,0,0,1,2,94,1,1,0,151,679,6,13,12,1,556,481,75,7,7,0,1,100,NoArch
2584644e8c6cd9475ceb3f66213faf184fb7d829,1,33,10,23,0,0,0,3,13,309,1,1,0,93,680,7,10,7,3,357,312,45,8,7,1,1,100,NoArch
f7c8bb3b41580d52728689f39419726afa3481e9,1,1,1,0,0,0,0,5,63,81,1,1,0,446,681,8,61,61,0,1452,1452,0,18,18,0,1,100,NoArch
cb4d1888f53b9eff784ee96ad68859636f29c7f7,2,89,40,49,0,0,0,5,11,369,1,1,0.115390393,685,682,9,107,91,16,3570,3357,213,23,23,0,1,100,NoArch
7ba4b1879764ecb217b6b31f10d7e4211f5ca11b,1,4,1,3,0,0,0,4,14,370,1,1,0,130,683,10,8,8,0,517,503,14,3,3,0,1,100,NoArch
7ca1f853d03081a3747c703e381f7bf2bc715370,1406,115584,117653,2069,371,462,833,2,65,252,9,178,9.495143379,208046,856,1,18849,21799,2950,694739,801218,106479,8611,10334,1723,1,64.74617952,Arch
7637dc01fe62cbbc769f8dd94da044109c9b48e7,1406,117669,115588,2081,462,371,833,3,126,471,9,178,9.493554354,205977,1657,18,19663,20957,1294,727352,768286,40934,9338,9547,209,1,64.74617952,Arch
fed8a29b81b5dda18d857c9bb99b07575c92f332,1,5,1,4,0,0,0,4,104,37,1,1,0,977,684,11,106,105,1,4408,4395,13,43,43,0,1,100,NoArch
eb385bf10f197123eb0979f7319df3b6aa351fbf,1,2,1,1,0,0,0,5,23,68,1,1,0,221,266,0,27,26,1,638,627,11,13,13,0,1,100,NoArch
35332540ceb07dd2e4da9594d613fb20b7f5369a,1,14,13,1,0,0,0,2,12,2,1,1,0,433,1658,16,64,63,1,2321,2293,28,15,15,0,1,100,NoArch
0af687349f21e9d50c16d49fffc603482a05de58,0,0,0,0,0,0,0,0,0,0,0,0,0,0,1173,5,0,0,0,0,0,0,0,0,0,1,100,NoArch
414912d4b0ec3164a2b53758d5dfbd4717a30076,0,0,0,0,0,0,0,0,0,0,0,0,0,0,1174,6,0,0,0,0,0,0,0,0,0,1,100,NoArch
a8db8b734d5b04de1dce097c53c044f7ffdb943a,1,0,108,108,0,1,1,5,27,471,1,1,0,108,1175,7,0,3,3,0,538,538,0,3,3,1,99.32873392,NoArch
cea40a2a6b3d82cb6875c3ec78662e129f3fed40,0,0,0,0,0,0,0,0,0,0,0,0,0,0,1176,8,0,0,0,0,0,0,0,0,0,1,100,NoArch
38d573137ce249977fb1fc85559cad86ba22bb43,1,1,4,3,0,0,0,4,9,269,1,1,0,545,1177,9,50,50,0,2097,2097,0,11,11,0,1,100,NoArch
35c97156ec0f91f1f30066215a4764a508edfbf0,1,4,1,3,0,0,0,2,4,691,1,1,0,180,1659,17,17,17,0,817,799,18,7,7,0,1,100,NoArch
6d38b53a6906d76586a222b1a4a23dcc888a72fb,1,6,0,6,0,0,0,4,105,5,1,1,0,981,1660,17,107,106,1,4435,4408,27,43,43,0,1,100,NoArch
e9be13e80168d207d15113fd439114f834af9530,1,2,1,1,0,0,0,3,3,476,1,1,0,118,1661,18,8,8,0,294,292,2,7,7,0,1,100,NoArch
025d67ff4bb2868d3fe8c719e352e7653596d846,1406,115684,117670,1986,372,462,834,2,65,256,9,178,9.495797158,207963,383,4,18849,21802,2953,694739,800875,106136,8611,10331,1720,1,64.77312698,Arch
3a88e144abd56f0dd8bad24f02606d5ca8d53b28,1406,117674,115688,1986,462,372,834,3,126,468,9,178,9.494229505,205977,1662,19,19664,20957,1293,726923,768286,41363,9335,9547,212,1,64.77312698,Arch
a24e57bbc8b024e68b92fd8dcdec48ca9ace8061,1,4,4,0,0,0,0,6,41,32,1,1,0,378,685,11,34,34,0,1010,1010,0,21,21,0,1,100,NoArch
aa350ae8fc6faf5232962c9f0403161b3493d2b0,1,4,2,2,0,0,0,4,53,34,1,1,0,2045,267,1,283,283,0,7565,7536,29,45,45,0,1,100,NoArch
8a37c9fed36c1a0f7aa1f7d191a496539fb80b33,3,5,5,0,0,0,0,4,43,99,1,1,1.521928095,998,268,2,87,87,0,3604,3604,0,33,33,0,1,99.9253174,NoArch
818a3226dcb20bb04808caf919c0d90131811dbc,1,64,1,63,0,0,0,4,44,0,1,1,0,576,269,3,58,50,8,2825,2504,321,15,14,1,1,99.92527555,NoArch
0627bf4229995334b068110a30f4af2a96bf57b8,0,0,0,0,0,0,0,0,0,0,0,0,0,0,1663,16,0,0,0,0,0,0,0,0,0,1,100,NoArch
e9b451b95aebcbb6edcb2b4cfe33b9a5a5b9c582,1,2,2,0,0,0,0,6,42,2,1,1,0,378,686,12,34,34,0,1010,1010,0,21,21,0,1,100,NoArch
5118a164c59f77227521c4ed85a23a8d0f352df5,1,0,1,1,0,0,0,4,18,40,1,1,0,284,1664,14,29,29,0,1187,1191,4,16,16,0,1,100,NoArch
68f373b5666f52bbc723f9a0e9253732a2c42375,1406,115691,117734,2043,372,462,834,2,65,256,9,178,9.495496013,208027,384,5,18850,21810,2960,694774,801241,106467,8611,10332,1721,1,64.73693472,Arch
632ca487c805cfad581efae2a84aa91566e742a1,1406,117739,115695,2044,462,372,834,3,126,468,9,178,9.49392458,205984,1665,15,19672,20958,1286,727283,768321,41038,9336,9547,211,1,64.73693472,Arch
fc16a73623dd1929fac974732e63e8d356317daa,1,0,1,1,0,0,0,4,45,5,1,1,0,639,1666,16,58,58,0,2810,2825,15,15,15,0,1,99.92527555,NoArch
670f405570bc082360006ac6989f80d123849677,1,89,4,85,0,0,0,4,12,200,1,1,0,258,1667,17,47,36,11,1556,1119,437,11,9,2,1,100,NoArch
9b220d960f6084952be02d4e7dcd46dd04fd2fea,1,9,9,0,0,0,0,5,18,118,1,1,0,306,1668,18,38,38,0,1603,1542,61,8,8,0,1,100,NoArch
11ecf14c6cf08296736cd2eee982155effe844a2,1,4,0,4,0,0,0,4,13,0,1,1,0,343,1669,19,48,47,1,1566,1556,10,11,11,0,1,100,NoArch
42f542db03e7793adc9a907f576ac413b68fa024,2,13,5,8,0,0,0,1,46,3,1,1,0.99107606,816,270,4,77,77,0,3408,3392,16,22,22,0,1,100,NoArch
c3b893dd0e53ec65b178b4193fc108f87005ac5d,3,56,64,8,0,0,0,5,19,894,1,2,1.141141904,697,1670,20,89,89,0,3321,3269,52,21,21,0,1,100,NoArch
a3584fbec49a67bfac97f8bddd04a4797a47a185,9,31,24,7,0,0,0,4,26,451,1,1,3.145874088,1707,271,5,182,182,0,5617,5592,25,65,65,0,1,100,NoArch
d73d0477c8266687d40993c3b0bc25260699be13,1,1,1,0,0,0,0,4,15,2,1,1,0,346,1671,20,48,48,0,1575,1578,3,11,11,0,1,100,NoArch
d3cd7c970bd4a41dcf8119d2f897607e7e6361fc,1,5,0,5,0,0,0,7,51,43,1,1,0,598,1672,21,56,55,1,2019,2002,17,20,20,0,1,100,NoArch
c0175e0c1da9ceec8dd0fcada6d36cbd0adaa982,1407,115700,117839,2139,372,462,834,2,66,255,9,178,9.496493487,208172,385,6,18854,21826,2972,694891,801980,107089,8613,10336,1723,1,64.77312698,Arch
fa600db3041f040b3db4ced999d3b43771335ca4,1407,117843,115704,2139,462,372,834,3,126,468,9,178,9.494925557,206033,687,10,19688,20962,1274,727983,768438,40455,9340,9549,209,1,64.77312698,Arch
ce193c276ecc922d1ce4dd3983fdf794222d4d50,1,7,7,0,0,0,0,4,54,10,1,1,0,2047,272,6,283,283,0,7589,7565,24,45,45,0,1,100,NoArch
04368712958d17baa7b11722d748401d6da9b8f3,1,8,1,7,0,0,0,3,7,733,1,1,0,208,1673,21,23,21,2,656,633,23,9,9,0,1,100,NoArch
a04e535ef61a58b46125cd3e2d1a35ecedef8a01,1407,115704,117847,2143,372,462,834,2,66,252,9,178,9.496612908,208179,30,0,18855,21828,2973,694904,802027,107123,8613,10336,1723,1,64.77312698,Arch
911858223658b46bab904be0057c60472bc3eb8f,1422,119485,115708,3777,477,372,849,3,126,463,9,180,9.512703909,206036,1674,21,19845,20965,1120,734326,768491,34165,9421,9551,130,1,64.4129979,Arch
824691d125f0c760545bc35c82efe97a6b5fca3b,11,26,11,15,0,0,0,3,27,321,1,1,3.167591879,2215,273,7,272,269,3,8612,8583,29,62,59,3,1,100,NoArch
2e32786af1b0292c0007a79d38f80bfbc4eec9ed,20,184,135,49,0,0,0,4,57,64,1,1,3.98651453,5325,274,8,583,583,0,21129,21279,150,168,168,0,1,100,NoArch
a4d69c478d9feb17017f2b2ecc2cf2c5c0634cfa,1,1,1,0,0,0,0,3,9,0,1,1,0,132,275,9,11,11,0,420,420,0,3,3,0,1,100,NoArch
1ecf47dee0cffb2afc05badc3f5542b27c47aa05,1,42,37,5,0,0,0,4,7,0,1,1,0,182,276,10,23,22,1,580,572,8,5,4,1,2,100,NoArch
307d6cc46921bf77260094ba80a5aa819e5fa9a5,1,36,13,23,0,0,0,4,16,2,1,1,0,322,277,11,28,28,0,1352,1289,63,10,10,0,1,100,NoArch
20705bf850740b80a66b807b716ed173befbb557,1,1,1,0,0,0,0,4,17,0,1,1,0,345,278,12,28,28,0,1352,1352,0,10,10,0,1,100,NoArch
7e7a091b2ad927c9dbea9bab131a45b9916cf5f8,2,24,3,21,0,0,0,3,5,84,1,2,0.99107606,254,688,9,19,18,1,1109,1064,45,8,7,1,1,100,NoArch
23fbfdd3f76d6bab5eefb09135edc2a086365731,6,50,9,41,0,0,0,2,2,6,1,1,2.423856932,1047,689,7,106,106,0,4963,4640,323,49,49,0,1,100,NoArch
45ef924b13d8d89a75ef6efbeb12d2713edcede8,1,1,1,0,0,0,0,2,3,0,1,1,0,69,690,8,3,3,0,281,281,0,2,2,0,1,100,NoArch
545511b7ab5e85866899e138677335b8f55cb80c,8,53,61,8,0,0,0,1,3,3,1,2,2.07655702,1339,1675,18,140,140,0,5848,5832,16,69,68,1,1,100,NoArch
c93a3ccb53d74d2bdbd08337a6f34ddf89bb9590,5,15,20,5,0,0,0,2,4,0,1,1,2.292133733,861,691,6,94,94,0,3674,3786,112,45,45,0,1,100,NoArch
3883e3486b0d42f8588d7b84b7dd9c217fe536c2,1,4,3,1,0,0,0,2,5,0,1,1,0,154,692,7,10,10,0,739,718,21,7,7,0,1,100,NoArch
cf24997c969d643bbe900de07a28a21c855ef740,1,70,3,67,0,0,0,5,24,173,1,1,0,304,1676,17,50,40,10,1481,1116,365,23,22,1,1,92.16780986,Arch
736e19ddc6b1defd7cbf9a1bcb359aef22540f50,2,0,2,2,0,0,0,2,5,0,1,1,1,519,1677,18,71,71,0,2310,2324,14,32,32,0,1,100,NoArch
7196c84de4fe3639dd20a2d8a02c599242608d7c,1,1,1,0,0,0,0,2,5,2,1,1,0,118,1678,19,10,10,0,405,401,4,4,4,0,1,100,NoArch
e8b34694cf320960375ebe28c66ad5a2b3ec9f81,1,15,12,3,0,0,0,8,19,69,1,1,0,570,34,0,59,57,2,1764,1750,14,30,30,0,1,100,NoArch
a1480d55fcb8f738131bd660f939d18b395d6747,3,80,136,56,0,0,0,2,14,55,1,2,1.502346693,699,1679,16,75,80,5,3219,3520,301,24,28,4,1,98.90029326,NoArch
695f801b4c761f15cc03039d55280c08ec4989db,1,104,0,104,1,0,1,1,1,0,1,1,0,0,1680,16,3,0,3,627,0,627,3,0,3,1,97.44747082,Arch
67e477ab9859fc142ae42afa9d6acdcce24ebf7f,1,5,2,3,0,0,0,4,22,430,1,1,0,215,693,6,17,17,0,712,692,20,10,10,0,1,100,NoArch
ac7d69934b3f2a3a8208de9c847c08feb3041b28,1423,115713,119751,4038,372,478,850,2,66,237,9,180,9.515279089,210074,386,0,18855,22002,3147,694904,809304,114400,8613,10427,1814,1,66.60720078,Arch
38755b9ca0bd07b1ecca25b5e14ab2e1f7082c37,1423,119758,115717,4041,478,372,850,3,126,462,9,180,9.513745732,206036,694,6,19861,20965,1104,735277,768491,33214,9427,9551,124,1,66.60720078,Arch
bd70ef782c27b8cd0d5b7f6994a2b2ded3e5bdce,1,2,1,1,0,0,0,6,74,88,1,1,0,535,695,7,70,70,0,2341,2328,13,23,23,0,1,100,NoArch
a169b46209087250dcbae5f484ee3d7a71afc75c,1,1,1,0,0,0,0,6,75,0,1,1,0,536,696,8,70,70,0,2341,2341,0,23,23,0,1,100,NoArch
8d9841d703a2dfdd5e92e59fe376f2a1a817b661,4,247,219,28,0,0,0,4,14,265,1,1,0.495234036,650,1681,8,66,62,4,1819,1706,113,30,29,1,1,99.93669884,NoArch
15564b97d355b002946d526cd358aa7a75f5827c,1,15,0,15,0,0,0,5,8,209,1,1,0,838,1682,8,90,87,3,1978,1934,44,69,68,1,1,100,NoArch
b79aecd6e665cea030bdd5f8370255c0f8e652f1,1,1,1,0,0,0,0,5,9,0,1,1,0,853,1683,9,89,90,1,1974,1978,4,69,69,0,1,100,NoArch
e0026885a659aab4468cb55874827e086b555bad,1,49,0,49,0,0,0,1,9,521,1,1,0,179,1684,9,39,31,8,1115,914,201,2,2,0,1,100,NoArch
ae4d1d669688420f77c03510e1baa97eec18d29a,1423,115906,119991,4085,372,478,850,2,66,237,9,180,9.516624995,210170,387,1,18863,22017,3154,695105,809664,114559,8613,10429,1816,1,66.57480953,Arch
8cb2fff00339c9ac6a1769df092a4ca26802cd49,1423,120001,115910,4091,478,372,850,3,126,462,9,180,9.515079665,206085,1685,10,19875,20973,1098,735644,768692,33048,9429,9551,122,1,66.57480953,Arch
0e59ddb582dbca0058aff6cda015bac256187438,2,35,37,2,0,0,0,5,28,43,1,2,0.997772472,1014,1686,11,114,114,0,3262,3272,10,68,68,0,1,99.98418222,NoArch
64306c0ede2871a47c1622496a3eb45f8b535a89,0,0,0,0,0,0,0,0,0,0,0,0,0,0,1687,12,0,0,0,0,0,0,0,0,0,1,100,NoArch
49172dafe9904e66d21b610922f1234be5f963b8,1,3,4,1,0,0,0,1,2,347,1,1,0,70,1688,13,3,3,0,135,135,0,3,3,0,1,100,NoArch
dcf7b94668496a6c10c83d086b0f5dc4f3425312,1,20,2,18,0,0,0,1,3,0,1,1,0,69,1689,14,6,3,3,213,135,78,3,3,0,1,99.98418222,NoArch
99bf0990b7fb9724d4f4fae4ff65e3d57e3248a7,1,2,1,1,0,0,0,4,22,704,1,1,0,268,1690,15,40,40,0,962,962,0,4,4,0,1,100,NoArch
51679d3fc229831af6fd4fa56f68876614fd7330,1,3,3,0,0,0,0,7,69,401,1,1,0,572,1691,16,59,59,0,1753,1753,0,25,25,0,1,100,NoArch
78d8540907a68fcf257f7468a2ca8788949bb6d0,1,1,1,0,0,0,0,6,14,252,1,1,0,655,1692,17,77,77,0,2102,2102,0,38,38,0,1,100,NoArch
673f7986fb6dc016ba877031186f9d7bedd47c9d,1,1,1,0,0,0,0,7,70,1,1,1,0,572,1693,18,59,59,0,1749,1753,4,25,25,0,1,100,NoArch
4b46812c439e0c7c7ad202e5b3f8ef72984ecb8e,1,4,2,2,0,0,0,5,34,177,1,1,0,245,279,2,24,23,1,659,650,9,12,12,0,1,100,NoArch
0a038b949b26585701524ba830e240c507f9c26d,1,1,1,0,0,0,0,5,35,0,1,1,0,247,280,3,24,24,0,657,659,2,12,12,0,1,100,NoArch
a1ed9af2badee9090571bdd13a17866c0398538b,1,1,1,0,0,0,0,5,25,33,1,1,0,371,1694,19,50,50,0,1477,1481,4,23,23,0,1,100,NoArch
d81e8882c99143f513cb71204d5a7a16c9f3e586,1423,115951,120015,4064,372,478,850,2,66,237,9,180,9.516806945,210194,31,0,18868,22021,3153,695221,809731,114510,8614,10429,1815,1,66.59101961,Arch
432d15acec0588400fa8faf340a8a16124783dd5,1423,120065,115986,4079,478,372,850,3,126,462,9,180,9.516035244,206130,1695,20,19879,20978,1099,735889,768808,32919,9431,9552,121,1,66.59101961,Arch
f7c36a4ef800eff69c342a1be2989e20a048add8,1,88,0,88,1,0,1,1,1,0,1,1,0,0,1696,21,2,0,2,1366,0,1366,2,0,2,1,99.96837445,NoArch
43364e5c4549c568165f55771dbebbee0f750efc,1424,115937,120084,4147,372,479,851,2,66,234,9,180,9.517524107,210297,388,2,18868,22023,3155,695388,811275,115887,8616,10433,1817,1,66.56943769,Arch
16709c21d6e443713768d24962d0abdc9bbb736c,1,14,19,5,0,0,0,5,11,5,1,1,0,713,32,1,81,81,0,2138,2114,24,34,34,0,1,100,NoArch
7543427361368ae21f5397588331884e497dede2,1,32,50,18,0,0,0,2,2,6002,1,1,0,168,33,2,14,19,5,420,490,70,8,8,0,1,99.98338318,NoArch
3f79d56eea93f5c911069034fb457fc3c67fa837,3,124,17,107,1,0,1,1,29,123,1,3,0.931486392,538,34,3,54,48,6,2496,2199,297,24,20,4,1,99.96678844,NoArch
66c19ee46bbec1ad99b9443b738014981752ccc8,1425,120109,115966,4143,479,372,851,3,126,457,9,180,9.517371632,206234,281,2,19885,20979,1094,737509,769226,31717,9436,9558,122,1,66.57489879,Arch
043d32e1d1da97d9f8baf85c72dfb0a7353e8f06,1,1,2,1,0,0,0,5,24,0,1,1,0,474,282,3,52,52,0,1416,1418,2,27,27,0,1,100,NoArch
5757290d857a0a3efed55f76ca9841363de9f8a0,1,1,1,0,0,0,0,1,3,43,1,1,0,167,1697,21,26,26,0,603,604,1,13,13,0,1,100,NoArch
3169ffed53ebb36fc22ede45d1f6a238545c47a4,1,7,6,1,0,0,0,1,2,55,1,1,0,54,1698,22,3,3,0,81,83,2,3,3,0,1,100,NoArch
0481a8a9b23a86ccece647dc040d2d7ce65577e7,1,1,1,0,0,0,0,4,58,50,1,1,0,1223,1699,23,152,152,0,5890,5890,0,43,43,0,1,100,NoArch
f06525a408a1696bb582fcffad3668a110103c16,1,2,2,0,0,0,0,2,7,108,1,1,0,294,1700,24,29,29,0,1290,1290,0,10,10,0,1,100,NoArch
fa92d04d5b77d2e4edbf2e9b2a7d3f71c89d50cb,1,2,2,0,0,0,0,2,8,55,1,1,0,231,1701,25,27,27,0,976,976,0,10,10,0,1,100,NoArch
f844ee97ce6bf8f67c5304cac9b94511412b719a,1,1,1,0,0,0,0,1,3,130,1,1,0,104,1702,26,9,9,0,513,513,0,3,3,0,1,100,NoArch
e3d7cad6449ef6cef7d20da6ccaed529d30d438e,5,57,3,54,1,0,1,1,76,90,1,1,1.184718287,2004,1703,24,268,263,5,8155,8020,135,84,82,2,1,99.87361769,NoArch
f424a719847a6628ec6a3c7ec0c7740b1bbc5905,3,3,3,0,0,0,0,3,30,381,1,1,1.584962501,602,1704,25,47,47,0,2986,2986,0,11,11,0,1,100,NoArch
111e74b9d4e742d3bfc23fc4a7fa8e6a7552fab3,4,4,3,1,0,0,0,2,71,83,1,1,1.950212065,1589,1705,26,191,191,0,5343,5343,0,86,86,0,1,100,NoArch
c68f27c9646e9266b1c298745eff4153ba7bfc11,2,3,3,0,0,0,0,2,14,186,1,2,0.918295834,375,1706,27,33,33,0,1128,1128,0,21,21,0,1,100,NoArch
eff7211af6170a23ebaef096eba2048b06a94d0b,2,3,3,0,0,0,0,4,41,130,1,2,0.918295834,962,1707,28,105,105,0,3151,3151,0,60,60,0,1,100,NoArch
7a4ad9d686df455b59d6a0d163c5414a7670b355,2,2,2,0,0,0,0,2,20,308,1,2,1,804,1708,29,98,98,0,3109,3109,0,36,36,0,1,100,NoArch
6fe3601b239ba4eef86baeea7351cfeed87a0769,3,3,3,0,0,0,0,6,41,142,1,1,1.584962501,770,1709,30,119,119,0,2762,2762,0,16,16,0,1,100,NoArch
4430ac8d83bd8de9b7a3261e560ca0d591b30af7,1,3,2,1,0,0,0,8,20,39,1,1,0,573,1710,31,59,59,0,1764,1764,0,30,30,0,1,100,NoArch
3abe0bd587991874e0d78b80a2de04c13bbba5ca,1,1,1,0,0,0,0,7,52,66,1,1,0,603,1711,32,56,56,0,2019,2019,0,20,20,0,1,100,NoArch
7b440e5b6520d17cb46029aa0c44bff355591701,5,5,5,0,0,0,0,6,16,299,1,3,2.321928095,1465,1712,33,160,160,0,6669,6669,0,41,41,0,1,100,NoArch
97708d52867e4c46cb33ace368cae1d180d6a996,1,1,2,1,0,0,0,4,59,1,1,1,0,1223,1713,34,152,152,0,5890,5890,0,43,43,0,1,100,NoArch
ead9b443997087cef75821fbd8fdc363a5368d1b,4,14,10,4,0,0,0,4,15,48,1,1,1.847854814,762,1714,35,92,92,0,2755,2728,27,19,19,0,1,100,NoArch
0e69c32357320b8ce8d256861a157b564c6f83d7,5,8,6,2,0,0,0,4,29,50,1,1,2.235926351,1498,1715,36,151,151,0,6066,6041,25,35,35,0,1,100,NoArch
50d1b60153d3c9474d88ab6c3c91101409a2f721,1,5,3,2,0,0,0,2,9,1,1,1,0,231,1716,37,27,27,0,976,976,0,10,10,0,1,100,NoArch
9251521b39dae2568221757ed4383f50cb088920,1,10,13,3,0,0,0,2,10,0,1,1,0,233,1717,38,26,27,1,968,976,8,10,10,0,1,100,NoArch
1082efea621c012ce7dd1438a0c2dce3ebccf97e,1,10,8,2,0,0,0,2,11,0,1,1,0,230,1718,39,26,26,0,968,968,0,10,10,0,1,100,NoArch
f5e9aa940ea0c854b79c5f1a0c7475f6744f375b,1,4,4,0,0,0,0,2,15,34,1,1,0,487,1719,40,66,66,0,2658,2657,1,16,16,0,1,100,NoArch
d7dd85783ea1ff85331642748a679d20f9aa0b8d,1,0,4,4,0,0,0,3,9,0,1,1,0,145,1720,41,18,18,0,449,474,25,3,3,0,1,100,NoArch
b2e998dfc8d4272167eac5b8b0a6094b93320a2e,1,2,1,1,0,0,0,1,2,136,1,1,0,84,1721,42,6,6,0,354,351,3,4,4,0,1,100,NoArch
6cf473f46d693e5ecedf8816c4d515129b4f896b,1,1,1,0,0,0,0,2,6,42,1,1,0,118,1722,43,10,10,0,406,405,1,4,4,0,1,100,NoArch
67712015f305ee8845fd5f9d010d0c536cbe6ad4,2,3,3,0,0,0,0,1,3,170,1,1,0.918295834,140,1723,44,11,11,0,392,395,3,6,6,0,1,100,NoArch
52f856047470a042bc59e152a2b94b6847efc61d,1,1,1,0,0,0,0,1,3,45,1,1,0,78,1724,45,7,7,0,282,281,1,5,5,0,1,100,NoArch
dba5eea4b5435ac4d1ad33c4169bf2ab4a5090da,1,10,9,1,0,0,0,2,8,151,1,1,0,2054,1725,46,239,239,0,5299,5300,1,106,106,0,1,100,NoArch
1caeb2441cf8ab29204981a265da82c477f99b38,1,0,4,4,0,0,0,7,28,388,1,1,0,500,1726,47,39,39,0,2427,2455,28,9,9,0,1,100,NoArch
38f5849eda875041ea57117642281b1b8952bcd0,1426,115967,120170,4203,372,480,852,2,66,238,9,180,9.519670838,210433,389,3,18869,22031,3162,695611,811678,116067,8620,10438,1818,1,66.53180126,Arch
d9221297cfdf24e8f7161dab24064e3c2a2d94f1,1426,120171,115968,4203,480,372,852,3,126,457,9,180,9.518185754,206230,1727,48,19889,20979,1090,737633,769198,31565,9438,9558,120,1,66.53180126,Arch
8d0fee0c284c9df0301444bfa63129d5f880d122,2,20,6,14,0,0,0,1,60,70,1,2,0.995727452,1300,1728,49,161,159,2,6184,6154,30,45,45,0,1,100,NoArch
840cc97b73867fcbd3f49b1edab08013f3877378,1,61,1,60,0,0,0,5,25,6,1,1,0,473,283,4,61,52,9,1618,1416,202,33,27,6,1,100,NoArch
97453b28f8d51bd1ff857f9b2d9221ab59fb2bc6,2,112,52,60,1,0,1,1,26,0,1,1,0.956652272,533,284,5,65,61,4,1726,1618,108,36,33,3,1,99.93686869,NoArch
61d492e047ab66b6082aec8c6c2d3086f9ed089e,1,2,3,1,0,0,0,5,27,0,1,1,0,491,285,6,54,54,0,1450,1458,8,29,29,0,1,100,NoArch
6296b13a038f78e222f0cc9f36985302c5332a1c,1,3,3,0,0,0,0,1,2,0,1,1,0,102,286,7,11,11,0,268,268,0,7,7,0,1,100,NoArch
d7c17ba810f79a321c82f9cc96a1fd4611b27401,1,19,10,9,0,0,0,4,61,2,1,1,0,1230,1729,50,155,154,1,5937,5920,17,44,43,1,1,100,NoArch
0e708b402ebee80bdf8dc6d08497e1d8db5e550d,1,6,5,1,0,0,0,4,62,0,1,1,0,1239,1730,51,155,155,0,5937,5937,0,44,44,0,1,100,NoArch
22e8898c5ecb8be328ccc5ad4a7fafb34ec0632b,1,1,0,1,0,0,0,2,16,5,1,1,0,487,1731,52,66,66,0,2658,2658,0,16,16,0,1,100,NoArch
099888fdda1ce7a23a3e8c2ade01daf1db5b9e2e,1,1,1,0,0,0,0,2,5,50,1,1,0,65,1732,53,3,3,0,233,231,2,2,2,0,1,100,NoArch
2c26bc73a2c8c90161fc2b535f3ecd268f7edba5,1,20,51,31,0,0,0,4,63,0,1,1,0,1240,1733,54,155,155,0,5813,5937,124,44,44,0,1,100,NoArch
6e209c78ca89a579019fe951665a9756630e9c74,1,29,16,13,0,0,0,3,17,8,1,1,0,488,35,0,67,66,1,2686,2658,28,16,16,0,1,100,NoArch
abc6b14b3b3bb5cb0b495852850b09ad8e9a7847,1,10,1,9,0,0,0,7,34,175,1,1,0,511,36,1,57,56,1,1668,1650,18,26,25,1,1,100,NoArch
e435a15d2921a52dad42712d3fdc99347e5f72ff,1,32,0,32,0,0,0,3,13,166,1,1,0,300,37,2,27,25,2,1364,1216,148,8,7,1,1,100,NoArch
decfb5603be0dedc0664ff3e0ae6bf48dae35e48,1,6,6,0,0,0,0,7,52,202,1,1,0,705,1734,53,90,90,0,2099,2099,0,42,42,0,1,100,NoArch
f0e74c2837ef6580c820725b3a8f5e26320a66d3,8,23,16,7,0,0,0,4,17,660,1,1,2.951157028,1250,1735,54,106,106,0,5311,5270,41,34,34,0,1,100,NoArch
1a4d30d9b6de7bcfaca3ed7c79b3582b51656c23,1,2,2,0,0,0,0,3,4,897,1,1,0,84,1736,55,7,7,0,191,191,0,3,3,0,1,100,NoArch
97de69609a85315eb9f9e0c16e9e678815ccf5d3,5,12,9,3,0,0,0,4,24,446,1,2,2.298309401,631,1737,56,46,46,0,2481,2467,14,18,18,0,1,100,NoArch
fef605af3148b6b34f71a7c99d4f9c0d6fc2ee20,6,14,12,2,0,0,0,4,20,446,1,1,2.57662122,766,1738,57,53,53,0,2954,2940,14,21,21,0,1,100,NoArch
f0caa4f9f3edd9c454816a96819f9b0394ec353f,2,9,2,7,0,0,0,5,8,226,1,1,0.994030211,154,1739,58,5,3,2,694,680,14,4,2,2,1,100,NoArch
9c5a0f46962b9e69b87c629238031d1d507a7e08,10,27,10,17,0,0,0,4,18,154,1,1,3.096458515,1390,1740,59,108,104,4,5982,5948,34,38,34,4,1,100,NoArch
ddc6cde6f9b28af8af200faa7623b882295765d5,8,26,8,18,0,0,0,3,16,175,1,1,2.783859344,745,1741,60,50,46,4,2685,2653,32,20,16,4,1,100,NoArch
39a0025aefb9166331cac22aa2e5cfaa1c8401e3,1,2,1,1,0,0,0,3,12,125,1,1,0,2153,1742,61,241,241,0,6172,6172,0,107,107,0,1,100,NoArch
553dca0b1c526036c8f78c197ff8547f082fd835,1,74,0,74,0,0,0,5,28,11,1,1,0,490,287,8,62,54,8,1793,1450,343,30,29,1,1,96.03531568,Arch
2b425006f18fc828eaa91b3b621405ccc2295e65,1,1,1,0,0,0,0,8,21,16,1,1,0,574,288,9,59,59,0,1764,1764,0,30,30,0,1,100,NoArch
3e39b1205db701971e2ed5589d587d895b8d6eb3,1,2,1,1,0,0,0,2,12,135,1,1,0,178,1743,62,15,15,0,810,803,7,10,10,0,1,100,NoArch
167126afa74aa6fe3f68c5e8831e2aff5abca14d,2,10,2,8,0,0,0,3,13,688,1,1,1,140,1744,63,6,4,2,551,537,14,4,2,2,1,100,NoArch
b9498021f157817d44925fee96d2a7ab9af7f43e,1,5,1,4,0,0,0,2,2,202,1,1,0,143,1745,64,10,9,1,559,552,7,7,6,1,1,100,NoArch
f67a7901a77b13cf97d4ce4374b45ea5ce709989,1,1,1,0,0,0,0,4,9,2,1,1,0,152,1746,65,13,13,0,702,701,1,4,4,0,1,100,NoArch
a5374e4295def2bce6a6c0e67ebe9e069d1c73b5,1,1,1,0,0,0,0,4,9,2,1,1,0,88,1747,66,5,5,0,247,246,1,3,3,0,1,100,NoArch
07d82808320d9beb2d1766dac8bd4b3a848b0041,1,1,1,0,0,0,0,4,13,2,1,1,0,121,1748,67,11,11,0,441,440,1,3,3,0,1,100,NoArch
812dc0a7868e8766b39442a4d20016b69b8e045c,1,63,84,21,0,0,0,1,7,135,1,1,0,156,1749,68,13,19,6,399,478,79,6,7,1,1,100,NoArch
c6546924cd9400d5047ad48f2862ec6b26818738,1,3,1,2,0,0,0,2,4,1064,1,1,0,82,1750,69,7,7,0,138,142,4,3,3,0,1,100,NoArch
3594af1adbece8646f92e8f42fe488e86a16ca68,1,4,2,2,0,0,0,7,53,8,1,1,0,705,1751,67,90,90,0,2093,2099,6,42,42,0,1,100,NoArch
feeeabbe8b2887f3d5832eb3d07cbad56fcb9c70,14,588,25,563,7,0,7,3,8,205,1,1,3.312799425,1066,1752,68,134,85,49,3447,1912,1535,106,66,40,1,99.03778866,NoArch
8290b1d0d2fc96d629c6fc36728ff1733f5a999a,7,118,0,118,0,0,0,1,2,0,1,1,2.807039576,528,1753,69,42,42,0,1254,1254,0,40,40,0,1,100,NoArch
167ec6ef0dde0b1b76f0d63ec192a64830fb9448,1,1,1,0,0,0,0,8,127,138,1,1,0,1469,1754,69,140,140,0,4449,4449,0,71,71,0,1,100,NoArch
5880b28b28aba03ed7c437e47d947453240b70f9,3,5,5,0,0,0,0,5,18,279,1,1,1.521928095,1979,1755,70,245,245,0,6463,6463,0,109,109,0,1,100,NoArch
594945b834925f4fbc6693f28a83ea253fd8f30f,3,3,3,0,0,0,0,5,29,215,1,3,1.584962501,666,1756,71,51,51,0,1427,1427,0,39,39,0,1,100,NoArch
d5832d978be2cfa9ab21a3cdb4e69e6411b912a5,0,0,0,0,0,0,0,0,0,0,0,0,0,0,1757,70,0,0,0,0,0,0,0,0,0,1,100,NoArch
2bf6d29e8c30baf0a5c7e94826be3f4511dde441,1,6,1,5,0,0,0,1,3,24,1,1,0,102,289,10,12,11,1,291,268,23,7,7,0,1,100,NoArch
8038195b031adca3c55adc746f80735bd0dca7f0,2,15,5,10,0,0,0,3,11,113,1,1,0.934068055,434,290,11,44,44,0,1485,1474,11,19,19,0,1,100,NoArch
e2c4dad835d32c9d55831943fa0daa37364b0006,12,102,102,0,0,0,0,5,43,188,1,1,3.164007672,2993,291,12,285,285,0,8125,7927,198,169,169,0,1,100,NoArch
6fbc92badab88b99dc63fa027bc73093fdab9aa6,1,9,41,32,0,0,0,5,29,15,1,1,0,564,292,13,55,62,7,1621,1793,172,30,30,0,1,100,NoArch
87105d37caf0a853fc18c1a366303f2bef4adc0d,4,57,92,35,0,0,0,4,44,60,1,1,1.884949545,790,293,14,71,74,3,2076,2172,96,38,39,1,1,100,NoArch
a82f9d8810929033a584232910fe569704afc242,3,99,191,92,0,0,0,4,45,0,1,1,1.566811398,668,294,13,52,62,10,1593,1898,305,27,31,4,1,100,NoArch
9d5bf470e81dc785eae952ece999f06dbe0670be,1,12,7,5,0,0,0,4,8,836,1,1,0,115,1758,63,13,10,3,344,336,8,9,9,0,1,100,NoArch
91b5c0becacb7bdb86da7aeb760886640b48ca51,2,20,19,1,0,0,0,5,36,100,1,1,0.858230793,538,295,14,56,56,0,1487,1487,0,30,30,0,1,100,NoArch
b885e9e5dfa798c52a91beb55e50cb14f8c92ee5,1,50,0,50,0,0,0,2,10,221,1,1,0,191,296,15,13,11,2,1493,1070,423,13,11,2,1,100,NoArch
0da7d79b0b86551638f6b4c248423685bca0fd51,1,7,1,6,0,0,0,2,3,602,1,1,0,52,1759,62,4,3,1,169,151,18,2,2,0,1,100,NoArch
9f180d86e95f8043aa1ba8e94bc63a30df3a7abd,1434,116072,121160,5088,372,488,860,2,66,232,9,180,9.532278448,211324,390,1,18870,22103,3233,695629,814248,118619,8620,10500,1880,1,64.11605022,Arch
25969ce9e317b2537159683e6d368d4e52ed17f9,1434,121168,116075,5093,488,372,860,3,127,456,9,180,9.53078838,206236,1760,63,19961,20981,1020,740149,769234,29085,9500,9558,58,1,64.11605022,Arch
f570f9a1a07ff50cc56e74363541a75d915888c2,1434,116077,121165,5088,372,488,860,2,66,235,9,180,9.532380637,211329,391,2,18871,22104,3233,695647,814266,118619,8620,10500,1880,1,64.11605022,Arch
845fd6160e5434c9ffcd27e327b250392f12ad40,1434,121178,116080,5098,488,372,860,3,127,456,9,180,9.530924925,206241,1761,64,19963,20982,1019,740185,769252,29067,9500,9558,58,1,64.11605022,Arch
cf6a3d3d6207c6c77c918be3e19c93128cb53d8f,1434,116091,121175,5084,372,488,860,2,66,239,9,180,9.532621013,211339,392,3,18874,22110,3236,695697,814473,118776,8620,10500,1880,1,64.11605022,Arch
40580db56cbd2ef62970250d8ce65b84239f8c6c,1,12,2,10,0,0,0,2,3,1287,1,1,0,69,393,4,5,3,2,322,286,36,1,1,0,1,100,NoArch
ebf604d59e3cd0b89ebdd3a25eca0ed9bf05092f,1434,121188,116104,5084,488,372,860,3,127,456,9,180,9.531260969,206265,1762,65,19965,20991,1026,740221,769567,29346,9500,9559,59,1,64.11605022,Arch
302f1782e3876cdd09a40e3953501755ccf6f8a8,1434,116110,121185,5075,372,488,860,2,66,240,9,180,9.532901235,211349,394,5,18878,22112,3234,695765,814509,118744,8620,10500,1880,1,64.11605022,Arch
39bbf4b43539210d11c95a48e07be58a57ebea29,1434,121193,116113,5080,488,372,860,3,127,456,9,180,9.531404328,206274,1763,66,19966,20996,1030,740239,769732,29493,9500,9560,60,1,64.11605022,Arch
5bd1ce8710bbf9c7979019862f6c0db62a946734,1434,116119,121190,5071,372,488,860,2,66,244,9,180,9.533049397,211354,395,6,18880,22114,3234,695797,814545,118748,8620,10500,1880,1,64.11605022,Arch
5c01773b6350843dbc14915b97048a045fe084e5,1434,121203,116122,5081,488,372,860,3,127,456,9,180,9.531610753,206283,1764,67,19968,21000,1032,740291,769796,29505,9500,9560,60,1,64.11605022,Arch
980e5a0587f26d5fcdc020f15acd639940004d87,1434,116123,121200,5077,372,488,860,2,66,248,9,180,9.533203373,211364,396,7,18881,22118,3237,695811,814649,118838,8620,10500,1880,1,64.11605022,Arch
913791a42cd47c63e0491fda8ec5fd21664ea5c6,1434,121208,116126,5082,488,372,860,3,127,456,9,180,9.531713239,206287,1765,68,19969,21002,1033,740325,769824,29499,9500,9560,60,1,67.66722535,Arch
4730bc7b1e0e2610f19015a159bc27fdfdd451b1,1,233,219,14,0,0,0,3,3,591,1,1,0,279,297,16,5,4,1,1473,1632,159,2,2,0,1,100,NoArch
4f08734244bef6c038119ec2d8bf5aa18bfb6d26,1,2,0,2,0,0,0,3,4,0,1,1,0,293,298,17,5,5,0,1473,1473,0,2,2,0,1,100,NoArch
a0150af53a403aca8b8a435538a21603ad345cdf,1434,116127,121221,5094,372,488,860,2,66,245,9,180,9.533305181,211385,397,8,18882,22121,3239,695825,814558,118733,8620,10500,1880,1,67.66722535,Arch
74a0cb10b961b9d59609d4d344d6a0b7876d32b3,1434,121228,116130,5098,488,372,860,3,127,456,9,180,9.531802181,206291,1766,69,19971,21003,1032,740180,769838,29658,9500,9560,60,1,67.66722535,Arch
d0f574c3faf697fcf3566aa7032ad5dd20be9338,1,10,1,9,0,0,0,2,2,1080,1,1,0,45,1767,70,4,2,2,168,136,32,2,2,0,1,100,NoArch
88c56e5b8fa5f0fbbfb1607aa1971bc5796ce8e3,1,11,1,10,0,0,0,2,2,1080,1,1,0,47,1768,71,4,2,2,188,145,43,2,2,0,1,100,NoArch
f847b6bed4a64d9883cf4a07b8e4bb5d3142cd9d,1434,116136,121244,5108,372,488,860,2,66,249,9,180,9.533659691,211408,398,9,18884,22132,3248,695857,814863,119006,8620,10502,1882,1,67.66722535,Arch
c89dfc9603a8cc01022da0ea00b75df82680ba8d,1,10,1,9,0,0,0,2,2,6041,1,1,0,44,399,10,3,1,2,137,105,32,1,1,0,1,100,NoArch
94fe693cf9d4b1367887e7c1331e913b737e5646,1434,121261,116148,5113,488,372,860,3,127,456,9,180,9.532252931,206309,299,18,19976,21011,1035,740165,769966,29801,9500,9560,60,1,67.66722535,Arch
ac052be55598a0a0a9e1410163508f6a757f4ef3,1,222,209,13,0,0,0,3,3,593,1,1,0,262,300,19,3,2,1,1378,1527,149,2,2,0,1,100,NoArch
905153f98d785c0ad2283f18158f0667204609dc,1,33,16,17,0,0,0,2,2,1081,1,1,0,68,301,20,3,2,1,217,174,43,2,2,0,1,100,NoArch
89e6efdd5ec343338923b60024ab4bfe3d1d306a,1,1,1,0,0,0,0,3,5,202,1,1,0,288,302,21,36,35,1,1028,1024,4,11,11,0,1,100,NoArch
4761cb1068cb3b12b8996fc86f8477a60f8cc1ed,1,269,256,13,0,0,0,4,4,593,1,1,0,301,303,22,3,2,1,1640,2354,714,3,2,1,1,100,NoArch
c2d23268ea07a785a4577157375af6d0ee79211f,1,222,207,15,0,0,0,3,5,3089,1,1,0,246,304,23,2,1,1,1334,1482,148,1,1,0,1,100,NoArch
6daaedcea678e52b0c1c8b2ff849ea0be82650aa,1,161,149,12,0,0,0,2,2,1874,1,1,0,188,305,24,2,1,1,986,1076,90,1,1,0,1,100,NoArch
bd68d28f724e11e3ab5af67a7bbf2263bc8a21be,1,178,166,12,0,0,0,4,4,593,1,1,0,213,306,25,3,2,1,1120,2052,932,3,2,1,1,100,NoArch
29892a7a58a46fa001e6b30a4050bc4ebe5b7fe9,1,1,1,0,0,0,0,4,5,0,1,1,0,225,307,26,3,3,0,1120,1120,0,3,3,0,1,100,NoArch
30a98f46b35daf69d8a364d5b726f56af956d51f,1,100,87,13,0,0,0,4,4,593,1,1,0,135,308,27,3,2,1,646,1104,458,3,2,1,1,100,NoArch
e8b3bfe282904ecaee64d76a96b40b0d92f97835,1,242,230,12,0,0,0,4,4,593,1,1,0,277,309,28,3,2,1,1498,2808,1310,3,2,1,1,100,NoArch
1f281fdfafffb404103e61dfac0f293a037bb785,1,269,257,12,0,0,0,4,4,593,1,1,0,301,310,29,3,2,1,1640,2354,714,3,2,1,1,100,NoArch
9a52255c7f96ef648afc23caa76a04c363e25858,2,4,4,0,0,0,0,4,6,0,1,1,1,373,311,30,6,6,0,1766,1766,0,6,6,0,1,100,NoArch
8267ac941f0fac1902aebcd034b3801b9b47d240,1,1,1,0,0,0,0,5,9,575,1,1,0,202,1769,72,21,21,0,511,510,1,14,14,0,1,100,NoArch
5da6dc7eb013a2f06890333bb201a4b543db57e7,1435,116352,121584,5232,372,488,860,2,66,257,9,180,9.535949513,211787,400,11,18887,22144,3257,697372,810755,113383,8621,10507,1886,1,67.66722535,Arch
a5da0b3bf746f486d551b2cc6693906a5a8ca7c6,1,1,1,0,0,0,0,3,6,0,1,1,0,203,401,12,21,21,0,509,509,0,14,14,0,1,100,NoArch
a3cfeca0edd832d3b24b85a31f758f9c731dafdc,1435,121587,116355,5232,488,372,860,3,127,459,9,180,9.534406588,206555,1770,73,19987,21010,1023,737180,770339,33159,9506,9559,53,1,67.66722535,Arch
36762d0d0f9bf6c55e2d18ac6a53a605e39d51a2,1,1,1,0,0,0,0,5,6,499,1,1,0,208,1771,74,18,18,0,582,582,0,11,11,0,1,100,NoArch
4e2ad0ede4edf93cf61ea657e1fb25a705ea415b,1435,116353,121585,5232,372,488,860,2,66,251,9,180,9.535987491,211787,402,13,18887,22144,3257,697372,810755,113383,8621,10507,1886,1,67.66722535,Arch
907f006bfd49592694c452cba05ce63d83edf12b,1,16,7,9,0,0,0,2,3,1449,1,1,0,232,403,14,33,33,0,851,839,12,8,8,0,1,100,NoArch
1154ff7bd76ed76771324fd91cc17f454549ebe1,1,8,1,7,0,0,0,2,4,1416,1,1,0,340,404,15,44,44,0,1322,1310,12,12,12,0,1,100,NoArch
b328f063d5acb3c0511c60b12c9820e5df4c2bc6,1,4,0,4,0,0,0,5,23,1260,1,1,0,815,405,16,116,115,1,3519,3506,13,19,19,0,1,100,NoArch
eff08165e69df7c5c1f8c991c4dddbeeb199fa73,1435,121587,116376,5211,488,372,860,3,127,459,9,180,9.53441656,206575,1772,75,19987,21011,1024,737169,770376,33207,9506,9559,53,1,67.66722535,Arch
69b59bb21d504c8c0ae5bec9fe65eb63f93bce31,1435,116381,121584,5203,372,488,860,2,66,250,9,180,9.535895931,211786,406,17,18888,22144,3256,697441,810733,113292,8621,10507,1886,1,67.66722535,Arch
56286534bec03e70d3a3d48105ba88e16a1d7adb,1435,121595,116382,5213,488,372,860,3,127,459,9,180,9.534359837,206583,1773,76,19987,21011,1024,737195,770408,33213,9506,9559,53,1,67.66722535,Arch
6feffc2558c4946352dab329454232a8f082128d,1435,116381,121594,5213,372,488,860,2,66,250,9,180,9.535905452,211796,407,18,18888,22144,3256,697441,810759,113318,8621,10507,1886,1,67.66722535,Arch
12a8e72f7079334dd529a7d422ca0af283640b13,1,1,8,7,0,0,0,2,5,0,1,1,0,347,408,19,44,44,0,1310,1322,12,12,12,0,1,100,NoArch
8a248411d736c1e5bba5c38db38538f1618fd451,1,5,4,1,0,0,0,2,4,0,1,1,0,241,409,20,33,33,0,851,851,0,8,8,0,1,100,NoArch
bb6a9e02dc2e9fb52ae6817485df92078c0f23b1,1,2,2,0,0,0,0,2,5,0,1,1,0,242,410,21,33,33,0,851,851,0,8,8,0,1,100,NoArch
a16f6d12a63830c7e3b15575212dbe3388daaddd,1435,121595,116376,5219,488,372,860,3,127,459,9,180,9.534364445,206577,1774,77,19987,21011,1024,737195,770396,33201,9506,9559,53,1,67.66722535,Arch
6eb100972ce9f4d69b2f8061e62f04a21aa180bc,1,17,17,0,0,0,0,4,16,0,1,1,0,303,1775,78,43,43,0,1024,1024,0,12,12,0,1,100,NoArch
4d5f2b2cfdb269961f4d06786690037c184578fe,1435,116375,121594,5219,372,488,860,2,66,249,9,180,9.535910099,211796,411,22,18888,22144,3256,697429,810759,113330,8621,10507,1886,1,67.66722535,Arch
38d53d14e7206a90afbdbbbac4ce5925026a5e9b,1435,121605,116376,5229,488,372,860,3,127,459,9,180,9.534283789,206577,1776,79,19989,21011,1022,737233,770396,33163,9506,9559,53,1,67.66722535,Arch
eb7458f9d29dd3decd9ef52ea0b723c07dfb5f2e,2,293,18,275,1,0,1,1,65,0,1,2,0.344316472,1219,1777,80,177,157,20,7056,5851,1205,54,44,10,1,99.97184685,NoArch
611a58eb0bedf5a6187434ef55a2fd126b259603,1,1,11,10,0,0,0,4,17,0,1,1,0,303,1778,81,43,43,0,998,1024,26,12,12,0,1,100,NoArch
8a7b47ac599e9d9c2704cb6cdf3f62a63a9b4481,1436,116366,121869,5503,372,489,861,2,66,249,9,180,9.537866062,212071,412,23,18888,22166,3278,697408,811976,114568,8621,10517,1896,1,67.64661081,Arch
9b4c75bc5a5a1fbf4487005720d8577e02097cad,1,11,2,9,0,0,0,2,8,0,1,1,0,233,413,24,34,33,1,849,830,19,8,8,0,1,100,NoArch
b9bbd57d86cc31183bbead87e96d360241bfadd9,1436,121880,116376,5504,489,372,861,3,127,455,9,180,9.53634809,206577,1779,82,20010,21012,1002,738436,770394,31958,9516,9559,43,1,67.64661081,Arch
c19e9d465eb0e6eae93003305083f06f5bf81c06,1436,116385,121879,5494,372,489,861,2,66,249,9,180,9.537894906,212081,414,25,18890,22167,3277,697497,812000,114503,8621,10517,1896,1,67.64661081,Arch
77bb8ece2093a06265997a19a4ee395a4f7e6d66,1436,121879,116386,5493,489,372,861,3,127,455,9,180,9.536359163,206587,1780,67,20010,21013,1003,738428,770464,32036,9516,9559,43,1,67.64661081,Arch
11d7bd39b904417f1a1fa575ef52f99137fa5a0a,1,5,4,1,0,0,0,1,2,2,1,1,0,291,1781,68,22,23,1,1286,1278,8,10,10,0,1,100,NoArch
f1d8001332955c9c3cc510ae6fee75cac4b70fab,1,13,1,12,0,0,0,3,18,27,1,1,0,501,1782,69,69,67,2,2738,2686,52,16,16,0,1,100,NoArch
a916f8ca3cc965cee82f281f2e6ca7b342fdb911,1,5,2,3,0,0,0,3,10,119,1,1,0,235,1783,65,30,30,0,1146,1133,13,4,4,0,1,100,NoArch
6b073f7557dd3dfa11e3d6859e2d1834297bf0fe,1,24,0,24,0,0,0,3,6,89,1,1,0,154,1784,66,13,12,1,727,689,38,6,5,1,1,100,NoArch
a0fa3cce7ba8e41c7d8591254663bcca468e4432,1,0,1,1,0,0,0,3,7,0,1,1,0,178,1785,67,13,13,0,720,727,7,6,6,0,1,100,NoArch
5d57e6dc9b44f6c0679a916b88cf23b9772c7cc5,7,7,7,0,0,0,0,2,7,0,1,2,2.807354922,1750,312,29,19,19,0,8864,8864,0,17,17,0,1,100,NoArch
141e151a1d06f3d39feecf73a5eca9e59566cc4d,4,4,4,0,0,0,0,3,5,4,1,1,2,871,313,30,14,14,0,4092,4092,0,8,8,0,1,100,NoArch
af44886f10d5e4c4cd89150c43ae5a390b4878d0,1,276,320,44,0,0,0,3,9,42,1,1,0,2055,314,31,239,239,0,5299,5299,0,106,106,0,1,100,NoArch
60c8866ca3dd8b59566c8d76945acdb64749d90a,1,18,0,18,0,0,0,4,19,503,1,1,0,311,1786,57,34,31,3,1408,1311,97,7,6,1,1,100,NoArch
f5f8cff5be1b7955261da4bc4e1d6e71763389b9,1436,116385,121872,5487,372,489,861,2,66,249,9,180,9.538454818,212093,415,25,18893,21934,3041,697601,806938,109337,8622,10414,1792,1,67.64661081,Arch
001fd2fa610e66b80fa5017c415db26966b057b8,1436,121892,116386,5506,489,372,861,3,127,452,9,180,9.537085846,206606,1787,58,20019,20790,771,738720,765190,26470,9518,9461,57,1,67.64661081,Arch
7383a7b9e3710b525c6415163bbb347d55d8fa06,1436,116394,121891,5497,372,489,861,2,66,249,9,180,9.538662631,212112,416,26,18895,21938,3043,697633,807029,109396,8622,10414,1792,1,67.64661081,Arch
5df2b78ddef25c12c9d61174040d04f400be5940,1,10,1,9,0,0,0,3,4,2549,1,1,0,78,417,27,6,4,2,354,322,32,1,1,0,1,100,NoArch
c6a6a9651b2030e0da54eb1b6b9c0f0ee367e816,1436,121892,116404,5488,489,372,861,3,127,452,9,180,9.537193032,206624,1788,59,20019,20794,775,738720,765254,26534,9518,9461,57,1,67.64661081,Arch
ef2a645206a1be60fe2391de8ff7f0dd473c8aef,1,1,1,0,0,0,0,2,17,432,1,1,0,133,1789,60,10,10,0,611,611,0,3,3,0,1,100,NoArch
ec30c9f6415ff220a8db17f81e8959d31c864baf,1,16,2,14,0,0,0,1,3,2,1,1,0,292,1790,61,22,22,0,1350,1286,64,10,10,0,1,100,NoArch
1a311f4001672ba5eef4d029eac0cc511d4f09f4,1,18,1,17,0,0,0,5,15,479,1,1,0,175,1791,62,20,18,2,433,377,56,12,12,0,1,100,NoArch
3f3d6cfa04d5f2d7bfc26fb28f419c5609af06bd,1436,116402,121904,5502,372,489,861,2,66,251,9,180,9.538719463,212143,418,28,18899,21940,3041,697723,807149,109426,8622,10414,1792,1,67.64661081,Arch
a7892c1357b5b1a480f2b6323828e6d9369a8b6f,1,2,2,0,0,0,0,3,6,0,1,1,0,195,419,29,21,21,0,438,442,4,13,13,0,1,100,NoArch
be28398651ffdf6b2843e8071cb178f923e75baf,1436,121905,116405,5500,489,372,861,3,127,452,9,180,9.537210742,206641,1792,58,20021,20796,775,738825,765308,26483,9518,9461,57,1,67.64661081,Arch
4dc366384361b299355a463a0e53eca9d15ca175,2,9,3,6,0,0,0,1,30,34,1,2,0.918295834,610,315,28,59,58,1,1880,1869,11,34,33,1,1,100,NoArch
e58503978beb851063ef64627e1156da1a192a0d,7,392,323,69,1,0,1,4,106,97,1,7,1.608450682,2442,1793,59,244,239,5,9671,9418,253,115,112,3,2,97.4122807,Arch
928eacbea91ce6723a1e018d9bc05dbb27f16e4e,1,0,2,2,0,0,0,2,19,2,1,1,0,131,1794,60,10,10,0,574,596,22,3,3,0,1,100,NoArch
c97817cd4a20f7c27ccc960b0f0d6ccc287461ce,1,2,0,2,0,0,0,1,3,0,1,1,0,86,316,29,4,4,0,298,280,18,4,4,0,1,100,NoArch
6ea3ad4de87af1d07542148654691cf0a05a51e2,2,7,20,13,0,0,0,1,16,25,1,1,0.876716289,357,1795,61,30,32,2,943,981,38,22,23,1,2,99.93915424,NoArch
4fb0228b40bca36ce8db05577f4b8716f3087a72,1,7,6,1,0,0,0,2,2,1050,1,1,0,113,1796,62,16,16,0,453,450,3,7,7,0,1,100,NoArch
3f4a890ab40406d6087551525cec6e4c1ca47080,73,3,1,2,0,0,0,4,30,0,2,14,1.5,11285,1178,0,1104,1104,0,45155,45127,28,489,489,0,1,95.60006069,Arch
f490a90294a7251ddb68ae37b4386e717599184b,8,789,670,119,2,0,2,6,77,84,1,1,1.402293319,3037,697,0,413,410,3,12361,12212,149,125,126,1,1,99.56040625,NoArch
99ce1058b8c2cea8b38494d03b898d04166fab63,1,1,1,0,0,0,0,1,2,0,1,1,0,54,698,1,3,3,0,79,78,1,2,2,0,1,100,NoArch
df6426d685a4d2bfd1ce38ef5eb0521c1b40c277,1,4,0,4,0,0,0,1,3,0,1,1,0,54,699,2,4,3,1,85,79,6,3,2,1,1,100,NoArch
da190f050a8c250b2fc408dbacdb0d47218b892f,0,0,0,0,0,0,0,0,0,0,0,0,0,0,317,30,0,0,0,0,0,0,0,0,0,1,100,NoArch
3f8d22a89f40c305e73d826f223b5ad1829f140f,1,155,16,139,0,0,0,3,10,12,1,1,0,2011,318,31,254,239,15,5913,5299,614,109,106,3,1,100,NoArch
7c0eb21b5b8f256d00b49c958584e3b863e2dad7,0,0,0,0,0,0,0,0,0,0,0,0,0,0,319,32,0,0,0,0,0,0,0,0,0,1,100,NoArch
5cf4c902802f0c859bde0e505864663ffd4a1c71,1,111,0,111,1,0,1,1,1,0,1,1,0,0,320,33,6,0,6,417,0,417,4,0,4,1,98.96325659,NoArch
b7dd9506d978cb96e25202ef80c368b5abda4fcc,1,7,3,4,0,0,0,1,2,0,1,1,0,111,321,34,6,6,0,453,417,36,4,4,0,1,100,NoArch
3051d1e794292114dc9d4606563932bbb76375a9,0,0,0,0,0,0,0,0,0,0,0,0,0,0,322,35,0,0,0,0,0,0,0,0,0,1,100,NoArch
97902dadaf45c818d168c917af10baca1bbbdf34,9,138,249,111,0,0,0,5,128,238,2,8,1.926801023,3941,38,0,386,395,9,12950,13068,118,150,157,7,1,99.81614831,NoArch
f6f48cc6fd6b106d9f794c2ccb231ba8bd95cdf7,1,7,7,0,0,0,0,4,11,0,1,1,0,506,39,1,59,59,0,1442,1442,0,13,13,0,1,100,NoArch
fc628efabeffa593b06bcb0842e759ea25c9f323,3,18,47,29,0,0,0,5,53,124,1,3,0.965728444,1309,40,2,143,146,3,3364,3406,42,55,57,2,1,100,NoArch
ccdad2989516128e92995cd6f060f99ce6b21086,1,2,1,1,0,0,0,6,9,632,1,1,0,241,41,3,21,21,0,1040,1027,13,14,14,0,1,99.93866912,NoArch
64dd9305a8922fade175def6757b18c746c317e2,1,8,16,8,0,0,0,7,43,130,1,1,0,378,42,4,34,34,0,986,1010,24,21,21,0,1,100,NoArch
95ff70f36ba8cdc8866ddb838f490e3bedefc533,1,26,0,26,0,0,0,3,6,218,1,1,0,492,43,5,50,47,3,1413,1327,86,22,21,1,1,99.95399479,NoArch
fcb76e243ab6b2d308ace8c1de9b78cdee6e4ffa,1,25,3,22,0,0,0,1,2,2,1,1,0,1203,1179,1,157,154,3,5850,5783,67,45,44,1,1,100,NoArch
eb9efd0a6303c22f95cfc7d36a1e46b6499e1779,1,30,15,15,0,0,0,4,10,56,1,1,0,141,1180,2,20,18,2,564,449,115,5,3,2,1,100,NoArch
75ca4b6da407f631485046fd9a329be7b87fb388,1,43,0,43,0,0,0,1,3,0,1,1,0,1225,1181,3,162,157,5,6023,5850,173,46,45,1,1,100,NoArch
1a558a8885cca448922421c9a4ef5e0fb9c19c5a,1,1,0,1,0,0,0,1,4,0,1,1,0,1268,1182,4,162,162,0,6025,6023,2,46,46,0,1,100,NoArch
4fdae6417a9adcb214d901e523e0b72df6873138,1,1,1,0,0,0,0,2,5,0,1,1,0,1269,1797,55,162,162,0,6025,6025,0,46,46,0,1,100,NoArch
e9670b7167801681972ff881a5b4e5adaa61034b,1,5,5,0,0,0,0,3,6,0,1,1,0,1269,700,3,162,162,0,6025,6025,0,46,46,0,1,100,NoArch
697160b40fe3fcdf3e944f7a0389d1b2805dcd98,3,2,19,17,0,0,0,4,29,146,2,2,1.35666952,863,701,4,86,87,1,2813,2864,51,47,48,1,1,100,NoArch
0f4adbaa98113417a44cbb92216006dae190ff22,1,35,21,14,0,0,0,7,44,0,1,1,0,370,44,6,38,34,4,1053,986,67,21,21,0,1,100,NoArch
e59b7f9aad9fa3f96f895d6d6d10797f11444e4d,2,62,77,15,0,0,0,5,26,61,1,1,0.989183154,458,702,5,57,58,1,1634,1730,96,32,31,1,1,95.55903049,Arch
ba0a9488d2586f35c0dd685dadf128dd81fb08da,1,7,6,1,0,0,0,7,54,34,1,1,0,707,703,6,92,90,2,2128,2093,35,42,42,0,1,100,NoArch
26553beed2e9135bfe181375bd8e11f69abe028c,1,12,1,11,0,0,0,5,27,1,1,1,0,297,1798,55,41,40,1,1149,1068,81,22,22,0,1,100,NoArch
c1ed9f5bbe70de37cf38846dc2654bddf4e0ac02,3,0,871,871,0,3,3,3,31,217,1,2,1.097103327,871,1183,5,0,63,63,0,3682,3682,0,30,30,1,99.74465369,NoArch
e1e79f7e83b34b0703a0454c9adfccbeca3c13ee,1438,116498,121455,4957,372,490,862,2,66,249,10,180,9.539065318,211779,420,30,18919,21922,3003,698405,805387,106982,8631,10389,1758,1,65.48917467,Arch
040b64741aab847e3241e0f628b08f0806a5dcfc,1438,121483,116469,5014,490,372,862,3,128,452,10,180,9.537321243,206822,1799,50,20012,20811,799,737595,765698,28103,9503,9465,38,1,65.48917467,Arch
9461ae5eef5659b843b5a668b326be9425c1f44d,2,0,24,24,0,0,0,3,4,689,1,1,0.954434003,217,1800,51,12,12,0,380,380,0,6,6,0,1,100,NoArch
84bc7f7daedc6eb9b8c90509a1c579ac4c4c83fb,1,10,2,8,0,0,0,8,129,6,1,1,0,1344,1801,50,131,130,1,4234,4214,20,64,64,0,1,100,NoArch
31718e3535b4afaf2c75fea586811b457f9a30ee,1,1,3,2,0,0,0,3,12,2,1,1,0,255,1802,51,9,9,0,1245,1238,7,8,8,0,1,100,NoArch
19d42ddcbd24e23fda3e6cb03cbb12bb2cb2f2b3,18,30,32,2,0,0,0,1,7,0,1,5,3.516663317,4184,1184,6,471,471,0,16941,16922,19,168,168,0,1,99.12126538,NoArch
bada3e68f540aab31fb13eb32740f1d522639a3c,4,7,4,3,0,0,0,1,2,6,1,3,1.980825936,1868,1185,7,224,224,0,8595,8587,8,86,86,0,1,99.88808953,NoArch
2acfd53d062ae2a20c39385879730d656129b416,72,117,116,1,0,0,0,1,1,0,1,12,5.402631291,10714,1186,8,1064,1064,0,42275,42507,232,473,473,0,1,95.46619673,Arch
6fa860140fa55a2ccdb62f4860185d043f81e4cd,4,4,4,0,0,0,0,1,4,0,1,2,2,708,1187,9,70,70,0,2878,2870,8,42,42,0,1,99.80738363,NoArch
e97ed44f5bed172c0be18e957a97b3f7d5bf6f9e,4,4,4,0,0,0,0,1,3,0,1,2,2,708,1188,10,70,70,0,2870,2878,8,42,42,0,1,99.80738363,NoArch
6af3eb8016a79a827ca192123ada955bebdcf6a3,1,1,1,0,0,0,0,1,2,0,1,1,0,345,1189,11,54,54,0,1633,1633,0,9,9,0,1,100,NoArch
58e0fee3f191d9348340aa55a22ecfd2a1c8c880,1,17,31,14,0,0,0,4,11,6,1,1,0,156,1190,12,18,20,2,460,564,104,3,5,2,1,99.95185364,NoArch
1a5b0e94d4d99f62fb7161238882fecc8f9f2e18,0,0,0,0,0,0,0,0,0,0,0,0,0,0,1191,13,0,0,0,0,0,0,0,0,0,1,100,NoArch
905127a9d32a2007036577419c503d2de50cceb8,2,59,5,54,0,0,0,2,23,43,1,2,0.448864489,609,1803,49,90,81,9,2553,2255,298,31,30,1,1,100,NoArch
3f270040cdb2f160dbce3c8088d1ff7ca518dad4,1,234,46,188,0,0,0,1,3,11,1,1,0,115,323,34,43,6,37,1272,453,819,7,4,3,1,100,NoArch
14d0671c3bede6efba8d7d582e820756dad23029,1,6,52,46,0,0,0,3,11,12,1,1,0,2150,324,35,245,254,9,5746,5913,167,109,109,0,1,100,NoArch
5dbea7f061444e52ce060326c74e8b134ccec6cc,2,40,49,9,0,0,0,2,24,0,1,2,0.356204804,663,1804,50,85,90,5,2447,2553,106,32,31,1,1,100,NoArch
a296ca8d39230782b4b2a2a58ffc701abfdc0e1b,1,10,3,7,0,0,0,3,7,19,1,1,0,518,45,7,50,50,0,1425,1413,12,22,22,0,1,100,NoArch
db73f3647c73e4d22534e88bb509c9c7fe604c6f,1,2,1,1,0,0,0,5,17,311,1,1,0,903,325,28,129,129,0,4718,4717,1,28,28,0,1,100,NoArch
5a49563468cdf98daaad49a34571ef1d474d003f,1,1,2,1,0,0,0,5,18,0,1,1,0,904,326,29,129,129,0,4720,4718,2,28,28,0,1,100,NoArch
dc206a139acd0647b7a7f48b46d575f9bc8e8ab3,1,2,1,1,0,0,0,3,3,60,1,1,0,147,1192,14,10,10,0,565,559,6,7,7,0,1,100,NoArch
6a9872df986259f67b9f568aded3d9173622368b,1,2,2,0,0,0,0,9,75,24,1,1,0,319,327,15,32,32,0,1031,1031,0,12,12,0,1,100,NoArch
2d0afbdfb7a28d0292c830f2f7d3c70f4eb16c92,1,8,14,6,0,0,0,5,14,324,1,1,0,357,1805,29,55,56,1,1461,1495,34,7,7,0,1,100,NoArch
5fe88ea569cd42917d307c620afb91ad4a5d1457,1,1,1,0,0,0,0,5,16,351,1,1,0,280,1806,30,27,27,0,601,601,0,25,25,0,1,100,NoArch
e002bd6fdfe3984f4d07dde96945a18f2c27206d,1,24,6,18,0,0,0,7,52,233,1,1,0,860,1807,30,118,118,0,3827,3834,7,26,26,0,1,100,NoArch
e6d3a02f81130c03fdb9e4ea21253d8211cad473,1,1,1,0,0,0,0,4,17,360,1,1,0,354,1808,30,38,38,0,1119,1119,0,21,21,0,1,100,NoArch
63276cdfceedcee33d6896c0ccc923ec865b1303,0,0,0,0,0,0,0,0,0,0,0,0,0,0,328,16,0,0,0,0,0,0,0,0,0,1,100,NoArch
ac77beadafe58456c5ad82650ab8d72174412297,1,6,0,6,0,0,0,7,53,2,1,1,0,878,1809,23,118,118,0,3848,3827,21,26,26,0,1,100,NoArch
635bb957ad516ae38a6ce13e4116ca0db4640aca,1,4,4,0,0,0,0,7,54,0,1,1,0,884,1810,24,118,118,0,3848,3848,0,26,26,0,1,100,NoArch
954513906dfb2e1b0dd966305d8ed8cd063e4cb3,1,1,2,1,0,0,0,5,15,27,1,1,0,156,1811,25,13,13,0,448,448,0,6,6,0,1,100,NoArch
0502f543be3d9cb63c69a9c047c89892a8008fd2,1,1,1,0,0,0,0,9,76,2,1,1,0,319,1812,26,32,32,0,1031,1031,0,12,12,0,1,100,NoArch
6e8676d7d46dfca333aba950aefb0e54605d1043,3,7,6,1,0,0,0,3,23,337,1,2,1.57662122,1102,1813,27,132,132,0,5039,5037,2,31,31,0,1,100,NoArch
c2e0be11cae5947a2306dfa7f6ef456351704196,1,17,3,14,0,0,0,2,5,823,1,1,0,50,1814,28,5,2,3,239,166,73,2,2,0,1,100,NoArch
36dffc278ca24f5522e87719bf9b178e5f1f8013,3,11,12,1,0,0,0,5,19,1282,1,1,1.325784781,606,1815,29,80,80,0,2076,2076,0,20,20,0,1,100,NoArch
aa9271056c6904973b9c8d096f41b7e94f82b449,1,40,3,37,0,0,0,2,17,0,1,1,0,578,1816,30,78,69,9,3256,3045,211,16,15,1,1,100,NoArch
c9b4fe63d83bcecc534860ca5251831a4ca6c235,1,1,1,0,0,0,0,2,13,15,1,1,0,385,1817,31,51,51,0,1525,1521,4,28,28,0,1,100,NoArch
a0056ae2782ba541dd8f8ffd5f7fa49a47bc43c9,1,0,5,5,0,0,0,2,14,0,1,1,0,385,1818,32,50,51,1,1506,1525,19,28,28,0,1,100,NoArch
76fcab40b6563b18845b582ae36ec96626248cd3,1,1,5,4,0,0,0,2,18,0,1,1,0,615,1819,33,77,78,1,3241,3256,15,16,16,0,1,100,NoArch
726dd2d781bcc454109d4590fef8ab3acbb10fe4,1,4,2,2,0,0,0,4,25,15,1,1,0,269,1820,34,33,34,1,920,926,6,4,4,0,1,100,NoArch
91bb01ed73e5a1e4563d3fcd6a82348690b13198,1,2,1,1,0,0,0,8,24,665,1,1,0,1459,1821,30,148,148,0,3376,3363,13,97,97,0,1,100,NoArch
e4440e7526663a2e79fab72b68d387217849faf3,1,20,34,14,0,0,0,5,22,615,1,1,0,268,1822,31,14,16,2,1220,1276,56,5,5,0,2,100,NoArch
f54a57b07bf535e5905d90c92c7b1dbdfb6d4c2c,1,17,20,3,0,0,0,5,23,0,1,1,0,254,1823,32,14,14,0,1194,1220,26,5,5,0,1,100,NoArch
d4949ab26a7992bc739270cc1d989e064b41c1fe,4,24,2,22,0,0,0,3,37,50,1,1,1.446464375,1401,329,14,145,144,1,4170,4100,70,80,79,1,1,100,NoArch
73c5070ce90b79a931eca3656e3cbf14291cd17d,8,160,4,156,0,0,0,1,38,94,1,2,1.853084275,2269,330,15,223,214,9,8072,7215,857,143,134,9,1,100,NoArch
f8f6b344819fddc9f652f6c0b3ef3bbf4fecc2fd,1,42,2,40,0,0,0,7,53,34,1,1,0,325,331,16,47,39,8,1479,1289,190,21,20,1,1,98.91926256,NoArch
79a73700c371cf87bd13b385e5e96d702c16782e,0,0,0,0,0,0,0,0,0,0,0,0,0,0,1824,31,0,0,0,0,0,0,0,0,0,1,100,NoArch
f6e3dc9cee81b052b6377ea8f0d4565562b003eb,0,0,0,0,0,0,0,0,0,0,0,0,0,0,1825,32,0,0,0,0,0,0,0,0,0,1,100,NoArch
740819fddd2c8154b3f167796ca774beac5fc0e2,4,174,158,16,1,0,1,2,24,528,1,2,1.880346079,716,1826,33,44,44,0,3143,3194,51,21,18,3,1,99.95278565,NoArch
ad8f556727e7903775855517cd48710d56117ca5,1,42,2,40,0,0,0,5,8,241,1,1,0,265,332,17,28,23,5,1462,1339,123,8,7,1,1,100,NoArch
9e0a7e9727753cdfb574748821fe71d074d1de83,2,93,16,77,0,0,0,2,25,2,1,2,0.132065356,347,1827,31,21,17,4,2053,1539,514,11,10,1,1,100,NoArch
8517a44b8a4ff4e657b97f396dac7ac383b6e45c,1,18,19,1,0,0,0,5,26,0,1,1,0,197,1828,32,12,12,0,885,883,2,6,6,0,1,100,NoArch
44bb570a4d8e34ab1acdb557284b31b8ebe168cd,3,29,9,20,0,0,0,5,27,0,1,1,1.189731917,581,1829,33,43,39,4,2549,2489,60,21,17,4,1,100,NoArch
2368722b94016ddf08b2d387a443aae093cea6ba,0,0,0,0,0,0,0,0,0,0,0,0,0,0,1830,33,0,0,0,0,0,0,0,0,0,1,100,NoArch
fc08b874db3019b99b5fa00f42c1f92399541294,1,1,1,0,0,0,0,3,23,6,1,1,0,278,1831,33,20,20,0,1123,1129,6,9,9,0,1,100,NoArch
0d42cd647408e42337714fdfdcd4420fd066d42e,1,5,5,0,0,0,0,5,18,308,1,1,0,130,1832,34,12,12,0,455,480,25,4,4,0,1,98.47667407,NoArch
6870c83c47cb49920340ac84b05dc308c75efa3f,1,0,1,1,0,0,0,3,24,0,1,1,0,278,1833,35,20,20,0,1116,1123,7,9,9,0,1,100,NoArch
52df61bcdad67bf299797af3b73cea522eb5e662,1,4,4,0,0,0,0,5,28,6,1,1,0,196,1834,36,12,12,0,888,887,1,6,6,0,1,100,NoArch
5115f8b2b23943cc08b3239a48828370e473b719,0,0,0,0,0,0,0,0,0,0,0,0,0,0,1835,37,0,0,0,0,0,0,0,0,0,1,100,NoArch
3d825aa016433695fd467cd6e91cd59c8ae14ea2,1,16,2,14,0,0,0,2,4,6,1,1,0,227,1836,38,9,9,0,1300,1170,130,5,5,0,1,100,NoArch
4d5e0adf420895b0c752cdcc45f8e7caae17d3a2,1,2,1,1,0,0,0,3,7,48,1,1,0,151,1837,39,16,16,0,497,497,0,7,7,0,1,100,NoArch
6475cd018457b79ff9fe8e41b21c2204d49901d1,1,1,1,0,0,0,0,4,107,48,1,1,0,988,1838,40,107,107,0,4450,4450,0,43,43,0,1,100,NoArch
4c52953827e9bd6fc207829b72a77084f2e6b7a7,1,2,2,0,0,0,0,3,45,48,1,1,0,997,1839,41,87,87,0,3377,3377,0,50,50,0,1,100,NoArch
5204dccde882c13716094435f7378ddcc9188d0f,1,0,1,1,0,0,0,3,8,0,1,1,0,152,1840,42,16,16,0,482,497,15,7,7,0,1,100,NoArch
be09acb8c2e63b9059b81eae3b93df6c825225ed,1,6,6,0,0,0,0,2,2,686,1,1,0,226,1841,43,27,27,0,831,833,2,8,8,0,1,100,NoArch
bfe1a12ef98a26dec549660ad72dbbcd6b854fcb,1,0,1,1,0,0,0,4,108,0,1,1,0,988,1842,44,107,107,0,4435,4450,15,43,43,0,1,100,NoArch
f3be67007db7c110a7492b25ae8930e031a1403b,1,3,3,0,0,0,0,5,10,119,1,1,0,853,1843,43,89,89,0,1976,1974,2,69,69,0,1,100,NoArch
fd7411194ba19b665cb76b3c874c889182c2a6ac,1,1,1,0,0,0,0,2,5,2,1,1,0,241,1844,44,9,9,0,1308,1300,8,5,5,0,1,100,NoArch
28366ed5c84caf53e3b880e62afb69ffade568c2,1,7,0,7,0,0,0,3,46,2,1,1,0,997,1845,45,87,87,0,3377,3377,0,50,50,0,1,100,NoArch
192c8b846053015ac92c5e9fc3524c7b7ac5211f,0,0,0,0,0,0,0,0,0,0,0,0,0,0,1846,46,0,0,0,0,0,0,0,0,0,1,100,NoArch
515071aeb07e01961ef856311f996ccfaa10bb09,1440,116531,122144,5613,372,491,863,2,66,248,10,179,9.542969467,212498,421,0,18922,21994,3072,698537,808132,109595,8634,10416,1782,1,65.69426336,Arch
87385011b9ac1a38cea81c9471680f6fadd80147,1440,122120,116504,5616,491,372,863,3,129,450,10,179,9.541830412,206885,1847,47,20084,20813,729,740296,765690,25394,9531,9467,64,1,65.69426336,Arch
07111e0e9adb310c4c600853cd2d14ed0f32dafb,1,7,6,1,0,0,0,5,9,644,1,1,0,507,1848,48,73,73,0,1554,1554,0,16,16,0,1,100,NoArch
af08af67db5cd77a805614bba8da942ada183950,1,80,0,80,0,0,0,2,13,289,1,1,0,438,1849,48,64,54,10,1799,1395,404,26,24,2,1,100,NoArch
5fce7784bc5644c1d5611288d81e53c37e776653,0,0,0,0,0,0,0,0,0,0,0,0,0,0,1850,49,0,0,0,0,0,0,0,0,0,1,100,NoArch
2be7cccbaf8f497ceeb953e4eabb0b69dc071879,0,0,0,0,0,0,0,0,0,0,0,0,0,0,1851,48,0,0,0,0,0,0,0,0,0,1,100,NoArch
03cb93d72785bf1db732e5aac5013738e16e6d25,1,1,1,0,0,0,0,2,4,349,1,1,0,246,1852,49,10,10,0,1256,1262,6,4,4,0,1,100,NoArch
c83be7f3ad435655106b05ec267a077a1fbf3f91,1,9,1,8,0,0,0,3,15,275,1,1,0,625,1853,50,83,82,1,2855,2830,25,27,27,0,1,100,NoArch
37ef300bb1a384a89f234c14f2003541e5727bd8,0,0,0,0,0,0,0,0,0,0,0,0,0,0,1854,51,0,0,0,0,0,0,0,0,0,1,100,NoArch
f7fee1b4116a4719a4ed9edb6373ec0cc7ac9a64,0,0,0,0,0,0,0,0,0,0,0,0,0,0,1855,52,0,0,0,0,0,0,0,0,0,2,100,NoArch
741f1903b883118e16703a5d6f4c507b18629a62,2,262,59,203,1,0,1,1,3,87,1,2,0.778933365,182,333,10,36,19,17,1357,590,767,19,7,12,1,99.80793854,NoArch
77d434c1f7f716a27506eeee94f9d27a0c271274,1,6,6,0,0,0,0,4,5,650,1,1,0,315,334,11,34,32,2,778,764,14,17,17,0,1,100,NoArch
d1de46111aff7d6a2796ab7213a0d7804b44c199,0,0,0,0,0,0,0,0,0,0,0,0,0,0,1193,1,0,0,0,0,0,0,0,0,0,0,100,NoArch
8530111af3bc80c9a1e666560df229bdfba7f3a8,0,0,0,0,0,0,0,0,0,0,0,0,0,0,1194,2,0,0,0,0,0,0,0,0,0,0,100,NoArch
b990ce2ab370b040dee0c29511633dbc2cfd6281,0,0,0,0,0,0,0,0,0,0,0,0,0,0,1195,3,0,0,0,0,0,0,0,0,0,0,100,NoArch
52aeba4cbb7a116de1fd3644d2fb0b045605c8ed,0,0,0,0,0,0,0,0,0,0,0,0,0,0,1196,4,0,0,0,0,0,0,0,0,0,0,100,NoArch
605f4ea41179b0ae901f6692bed56197ae45f4c9,1,0,6,6,0,0,0,5,28,49,1,1,0,308,704,0,41,41,0,1084,1149,65,22,22,0,1,100,NoArch
24610377ecc4d256c68cdce9468c558984f188fb,0,0,0,0,0,0,0,0,0,0,0,0,0,0,1197,5,0,0,0,0,0,0,0,0,0,0,100,NoArch
e7ad7b48344814768e10f65e1d225d21f1a67340,0,0,0,0,0,0,0,0,0,0,0,0,0,0,1198,6,0,0,0,0,0,0,0,0,0,0,100,NoArch
e534c7a536a25557c18afb05b701213b89862c45,0,0,0,0,0,0,0,0,0,0,0,0,0,0,1199,7,0,0,0,0,0,0,0,0,0,0,100,NoArch
934613ed1068b0ea0576d45d422f57160f6c4cc8,1,6,0,6,0,0,0,4,8,219,1,1,0,341,1856,51,41,38,3,1588,1555,33,11,11,0,1,100,NoArch
1638a4f86ca0e38351d98ab84801e7a662fcd1d6,1441,116545,122447,5902,372,492,864,2,66,248,10,179,9.544281571,212793,422,1,18925,22028,3103,698570,809308,110738,8634,10431,1797,1,65.6779661,Arch
c9d137816dec5be1053c1ed961de237e9d367278,1441,122417,116520,5897,492,372,864,3,129,450,10,179,9.543164395,206891,1857,52,20116,20816,700,741449,765723,24274,9545,9467,78,1,65.6779661,Arch
18eea968a5e19cb64594265507b1fb5cbe2f76ca,1,6,2,4,0,0,0,3,4,970,1,1,0,45,1858,53,3,2,1,185,148,37,1,1,0,1,100,NoArch
390fa425c332bbdfd573ebed3c7712a3771facf6,1441,116550,122446,5896,372,492,864,2,66,249,10,179,9.54442973,212792,423,2,18926,22028,3102,698607,809326,110719,8634,10431,1797,1,65.6779661,Arch
e726def7dac5e8cb0082b74c012649b00824a60f,1441,122421,116525,5896,492,372,864,3,129,449,10,179,9.543335039,206896,1859,54,20117,20817,700,741486,765760,24274,9545,9467,78,1,65.6779661,Arch
02c4c170d2cc87565638ab01f278327d4ba68383,1,1,1,0,0,0,0,4,7,97,1,1,0,82,1860,55,6,6,0,209,199,10,3,3,0,1,100,NoArch
a9306b0a1dd5a6cc17a91379b2b0307ff62cfa19,1,1,4,3,0,0,0,4,9,97,1,1,0,124,1861,56,6,6,0,498,490,8,3,3,0,1,100,NoArch
668253a24b2ac46ed77db0066a87a870b4709ae6,1,1,3,2,0,0,0,4,8,97,1,1,0,105,1862,57,7,7,0,365,355,10,3,3,0,1,100,NoArch
3e5bcf50996b858e61e7475493ccb574444d5133,3,1,5,4,0,0,0,5,19,325,1,1,1.584962501,544,1863,58,47,47,0,2490,2480,10,17,17,0,1,100,NoArch
c7c82196dc7e5b7787b7a97e721f332f700b227f,5,5,11,6,0,0,0,4,9,95,1,1,2.25,511,1864,59,37,37,0,1632,1584,48,16,16,0,1,100,NoArch
fc8d6b24c04a96a9e4781eec3713740bf0921159,5,5,11,6,0,0,0,4,25,83,1,2,2.25,630,1865,60,43,43,0,2397,2347,50,21,21,0,1,100,NoArch
bb9018af93268e2a90b6da979fa6a89c0cc5e110,1,0,2,2,0,0,0,4,15,0,1,1,0,108,1866,61,7,7,0,353,353,0,4,4,0,1,100,NoArch
c42754ff4baa4f5d7940ce4839f04e8c68789c43,1,1,1,0,0,0,0,4,15,97,1,1,0,250,1867,62,35,35,0,1030,1020,10,7,7,0,1,100,NoArch
21644785887f587542f5a0db130d2a0c47625d50,1,1,2,1,0,0,0,4,10,95,1,1,0,152,1868,63,13,13,0,710,702,8,4,4,0,1,100,NoArch
8671db146549b00831e9f3aa57a864ca38af073f,1,1,3,2,0,0,0,4,30,55,1,1,0,350,1869,64,45,45,0,1303,1293,10,21,21,0,1,100,NoArch
7336dd7179eec044826e1cbee34ebdfabec3c13f,1,25,6,19,0,0,0,6,23,572,1,1,0,136,1200,8,16,14,2,690,651,39,3,3,0,1,100,NoArch
c57c44d6563e2b91192768db744ba18bfab4e962,1441,116590,122460,5870,372,492,864,2,66,249,10,179,9.545148843,212785,857,0,18928,22030,3102,698651,809529,110878,8634,10431,1797,1,65.6779661,Arch
c56b3c779876923d60e22bb3e593d424308eb1be,1441,122489,116563,5926,492,372,864,3,129,449,10,179,9.543922281,206915,1201,9,20123,20819,696,741879,765804,23925,9548,9467,81,1,65.6779661,Arch
d6eafa53221589372a3e5d5a7747164398a39564,4,251,0,251,4,0,4,1,1,0,1,1,1.858363046,0,335,10,6,0,6,805,0,805,6,0,6,1,99.76038339,NoArch
c626977f6dfbe7be830f5585e2f305515c91dd99,1,1,1,0,0,0,0,1,1,0,1,1,0,66,336,11,3,3,0,196,194,2,2,2,0,1,99.93622449,NoArch
f8f4129efbb8aa51af036b63a21aa8c500d9380b,2,0,118,118,0,2,2,1,8,556,1,1,0.711641289,118,337,12,0,2,2,0,511,511,0,2,2,1,99.93618379,NoArch
097788524af68f792f19e059a6b177657dfa836e,1,3,5,2,0,0,0,1,2,0,1,1,0,66,338,13,3,3,0,186,196,10,2,2,0,1,100,NoArch
5ea151c176082fb10dc360a07f5ebd98602115e8,1,129,0,129,1,0,1,1,1,0,1,1,0,0,339,14,2,0,2,473,0,473,2,0,2,1,99.93616342,NoArch
530b750039b3fa109abe80a18adddae881385747,1,3,0,3,0,0,0,2,2,61,1,1,0,701,1202,10,108,108,0,2847,2841,6,21,21,0,1,100,NoArch
e4878dfc97a33a885d8d787762da6ccf53b34cdb,1,19,0,19,0,0,0,2,2,577,1,1,0,127,1870,65,13,10,3,479,438,41,6,5,1,1,100,NoArch
e601fa7551e94af966b962c9e9c0deef9118d56a,0,0,0,0,0,0,0,0,0,0,0,0,0,0,1871,66,0,0,0,0,0,0,0,0,0,1,100,NoArch
837321d7c4e8b254c8101304b2ffd59d9f342b48,0,0,0,0,0,0,0,0,0,0,0,0,0,0,1872,67,0,0,0,0,0,0,0,0,0,1,100,NoArch
40cb68134b9c4eac69dfcec7fac9c57e5918216a,0,0,0,0,0,0,0,0,0,0,0,0,0,0,1873,68,0,0,0,0,0,0,0,0,0,1,100,NoArch
f80f746d03f4ebca1ee43e782a22e9bdd0fcb7ba,1,17,2,15,0,0,0,2,5,365,1,1,0,177,1874,69,14,13,1,889,853,36,8,7,1,1,100,NoArch
925d7eb37f073601f382e4fedfd2a036dcd32c7f,0,0,0,0,0,0,0,0,0,0,0,0,0,0,1875,70,0,0,0,0,0,0,0,0,0,1,100,NoArch
738c0e4864da6df548729fa5f4829b211ee5009e,0,0,0,0,0,0,0,0,0,0,0,0,0,0,1876,71,0,0,0,0,0,0,0,0,0,1,100,NoArch
43cca3f11e2788bdb04bf0baf345650054b38382,0,0,0,0,0,0,0,0,0,0,0,0,0,0,1877,72,0,0,0,0,0,0,0,0,0,1,100,NoArch
877a0cfb109b5bc1a264c44263c039fe0fd36ed5,0,0,0,0,0,0,0,0,0,0,0,0,0,0,1878,73,0,0,0,0,0,0,0,0,0,1,100,NoArch
08c903ec99741de08498ae90660cf8aba561e022,2,2,2,0,0,0,0,1,1,0,1,1,1,263,340,13,24,24,0,940,936,4,8,8,0,1,99.87236758,NoArch
e772c816a6087de71af915822dddb6a4235d1710,2,3,3,0,0,0,0,1,2,0,1,1,0.918295834,263,341,14,24,24,0,940,940,0,8,8,0,1,100,NoArch
51645e75683f0bb507174180ea56a7cc90916d84,2,74,0,74,1,0,1,2,3,11,1,2,0.179256067,226,1879,70,33,27,6,1154,831,323,10,8,2,1,99.8562989,NoArch
88aa037928a9922e792e28228cfdf7561d2e5dc9,2,33,4,29,0,0,0,7,55,68,1,2,0.84185219,780,1880,71,103,99,4,2485,2395,90,45,44,1,1,99.85634477,NoArch
20653d77b7e6e58db70abecca7aeff1ef203840c,0,0,0,0,0,0,0,0,0,0,0,0,0,0,1881,72,0,0,0,0,0,0,0,0,0,1,100,NoArch
4440cd69f731efc2063efafcf5c28684952a53ea,1,9,1,8,0,0,0,6,78,67,1,1,0,541,1882,73,72,70,2,2440,2361,79,23,23,0,1,100,NoArch
290e77bd9bd293631b49effcc930a56caee2f39c,1,1,1,0,0,0,0,2,5,20,1,1,0,246,1883,62,10,10,0,1254,1256,2,4,4,0,1,100,NoArch
fc6f7675b4f88b3c05af64becec7d01e3c232acf,0,0,0,0,0,0,0,0,0,0,0,0,0,0,1884,63,0,0,0,0,0,0,0,0,0,1,100,NoArch
707ec590cd291275c33b2dbd0a1893908ee1217c,1,17,7,10,0,0,0,6,22,125,1,1,0,179,1885,64,16,15,1,740,723,17,2,2,0,1,100,NoArch
d6eb0a6a8b176a8ccea2842b9ed9d930af48e27e,1447,116788,123122,6334,374,498,872,2,66,249,10,179,9.553374987,213259,424,3,18929,22082,3153,698668,812073,113405,8634,10454,1820,1,65.45217957,Arch
560a0461436ed3385eda98fcd54ca3b18e345727,1447,123103,116769,6334,498,374,872,3,129,423,10,179,9.552284453,206925,1886,65,20146,20844,698,743236,766790,23554,9559,9475,84,1,65.45217957,Arch
147fef61ac2cc552479d9fa5ab121d558b7c98f5,1,1,1,0,0,0,0,3,16,21,1,1,0,633,1887,66,83,83,0,2859,2855,4,27,27,0,1,100,NoArch
6b4674cc62262ede13d0459c6f56ad31582c9b35,1,1,1,0,0,0,0,3,17,0,1,1,0,633,1888,67,84,83,1,2870,2859,11,27,27,0,1,100,NoArch
c488e889f8dc3f0632c55aa3e1bc65d4f6b74e80,1,0,2,2,0,0,0,2,6,2,1,1,0,246,1889,66,10,10,0,1239,1254,15,4,4,0,1,100,NoArch
ab56eb525fe0d005e61fc275182e95ddf7cb9a27,0,0,0,0,0,0,0,0,0,0,0,0,0,0,1890,66,0,0,0,0,0,0,0,0,0,1,100,NoArch
bcca9bd8a789dbb9b702a5296bdf34ab074651c7,1,90,8,82,0,0,0,4,10,215,1,1,0,542,1891,67,58,50,8,2556,2097,459,12,11,1,1,100,NoArch
1e40096a024c967b17fb8b8b75de7ec18cc3c927,0,0,0,0,0,0,0,0,0,0,0,0,0,0,1892,68,0,0,0,0,0,0,0,0,0,1,100,NoArch
fe1dcee9ce884b16a5124fb874d6b214334a4b65,0,0,0,0,0,0,0,0,0,0,0,0,0,0,1893,66,0,0,0,0,0,0,0,0,0,1,100,NoArch
243a28b5796a50481f92639d79b4374c6cda15fe,1,1,1,0,0,0,0,6,17,305,1,1,0,560,1894,65,65,65,0,1324,1325,1,38,38,0,1,100,NoArch
7a676073ce87ab0d5e63529d5173822024eb2477,1447,116788,123202,6414,374,498,872,2,66,251,10,179,9.553075508,213339,425,4,18929,22099,3170,698667,812994,114327,8634,10456,1822,1,65.45217957,Arch
aa8156a81a3144c667628e3b9f4e22b125830afd,1447,123188,116769,6419,498,374,872,3,129,423,10,179,9.551950735,206925,1895,66,20156,20844,688,743711,766789,23078,9560,9475,85,1,65.45217957,Arch
783a57aa47c741df7fc02d103c4855c0a9d368a6,0,0,0,0,0,0,0,0,0,0,0,0,0,0,1896,66,0,0,0,0,0,0,0,0,0,1,100,NoArch
dbeda59b1ee19d954022c20d36e977b7dd222843,0,0,0,0,0,0,0,0,0,0,0,0,0,0,1897,67,0,0,0,0,0,0,0,0,0,1,100,NoArch
cc97e0223c518f5f1d8ab6c63cad7ce080477aa4,1,1,1,0,0,0,0,5,29,26,1,1,0,302,1898,68,41,41,0,1084,1084,0,22,22,0,1,100,NoArch
79eb804b77d48d341f3a3741349e3e25d9abd1fd,1,4,0,4,0,0,0,5,34,362,1,1,0,1416,1899,69,191,190,1,6884,6865,19,69,69,0,1,100,NoArch
a9111d503ad4ad1ffad9d32f12c45588e2e627ed,1,6,2,4,0,0,0,9,77,53,1,1,0,319,1203,10,34,32,2,1068,1031,37,12,12,0,1,100,NoArch
df51154874ae7d0d1e7e09bd1df749fe419ed2dd,1447,116796,123215,6419,374,498,872,2,67,251,10,179,9.552863256,213352,858,1,18931,22103,3172,698708,813067,114359,8634,10456,1822,1,65.45217957,Arch
fb68d03858b171923a1fda1750b9df895cc58e74,1447,123196,116777,6419,498,374,872,3,129,423,10,179,9.551773921,206933,1900,70,20159,20846,687,743767,766830,23063,9560,9475,85,1,65.45217957,Arch
7a805806b57a7741933d859e41013d719b0edf7e,1,8,0,8,0,0,0,4,10,81,1,1,0,122,1901,71,10,9,1,490,450,40,8,7,1,1,99.76076555,NoArch
5e4b74cc4370de94339cbe82c29f24df892570cb,1,2,2,0,0,0,0,5,11,36,1,1,0,853,1902,72,89,89,0,1976,1976,0,69,69,0,1,100,NoArch
84c87be2ac02c09831a8dd0b1d07e727fdff44ed,1,6,1,5,0,0,0,7,72,138,1,1,0,572,1903,73,60,59,1,1762,1749,13,25,25,0,1,100,NoArch
3d8db81d8372b2602e889e5fac093da4a51fb10c,0,0,0,0,0,0,0,0,0,0,0,0,0,0,1904,74,0,0,0,0,0,0,0,0,0,1,100,NoArch
ab54e70956c97844321e8581e3492664e06cb412,2,10,6,4,0,0,0,5,73,0,1,1,1,1430,1905,75,150,149,1,3748,3738,10,95,94,1,1,100,NoArch
7d50726da90eee2d60d6b9fe8cf158db6b778702,1,3,0,3,0,0,0,4,11,7,1,1,0,624,1906,76,58,58,0,2562,2556,6,12,12,0,1,100,NoArch
057502167f9f012fc28c3a19794fdd0185b70228,1,5,0,5,0,0,0,2,20,40,1,1,0,614,1907,64,78,78,0,3276,3230,46,17,17,0,1,95.91500577,Arch
53df314196d2179196f3f753e75b14048ae6ecfc,1,0,3,3,0,0,0,2,21,0,1,1,0,619,1908,65,78,78,0,3258,3276,18,17,17,0,1,100,NoArch
4cb0f3d53f113003f50e02abd37cc0ddd5b9541a,0,0,0,0,0,0,0,0,0,0,0,0,0,0,1909,59,0,0,0,0,0,0,0,0,0,1,100,NoArch
50509e25225c5e4618a9797570792126b4ba2321,0,0,0,0,0,0,0,0,0,0,0,0,0,0,1910,60,0,0,0,0,0,0,0,0,0,1,100,NoArch
3d90794ff9054917b49bb38a2379c1e12b8c70c1,0,0,0,0,0,0,0,0,0,0,0,0,0,0,1911,61,0,0,0,0,0,0,0,0,0,1,100,NoArch
a39dc959bb493e99bd1f6521124ba5d9cd715256,0,0,0,0,0,0,0,0,0,0,0,0,0,0,1912,62,0,0,0,0,0,0,0,0,0,1,100,NoArch
4839e6385cb927f39e93e5604aca1f15c4d7b817,1,1,4,3,0,0,0,2,7,18,1,1,0,244,1913,61,10,10,0,1220,1239,19,4,4,0,1,100,NoArch
3375c2d4d52f6915d9b234c718e7e7a5b3e03a71,0,0,0,0,0,0,0,0,0,0,0,0,0,0,1914,62,0,0,0,0,0,0,0,0,0,1,100,NoArch
84706e4573138c1f9eda19bde5a4d7e7a0014734,1,6,1,5,0,0,0,9,78,9,1,1,0,323,1915,63,35,34,1,1093,1068,25,12,12,0,1,100,NoArch
b1d6f4395792a7cc40da03aafaa9cdaee76799ec,1447,116799,123238,6439,374,498,872,2,68,251,10,179,9.55272573,213376,426,4,18932,22107,3175,698728,813176,114448,8634,10458,1824,1,65.38914103,Arch
a8b932bb4855c1eea18cbca9fc8f9c05dc9abb40,1448,123357,116779,6578,499,374,873,3,129,422,10,179,9.55317751,206937,1916,64,20169,20847,678,744550,766850,22300,9566,9475,91,1,64.3073302,Arch
e2ffa11826529885e5d6297bdfba58c49905bc45,1,15,3,12,0,0,0,2,4,834,1,1,0,103,705,1,0,0,0,129,127,2,0,0,0,1,100,NoArch
80e8b002eb3f959deefe97ac43b9f667eec0bf0e,1,4,20,16,0,0,0,4,23,372,1,1,0,421,706,2,41,43,2,1617,1661,44,15,15,0,1,100,NoArch
3e858c847d85129767dff9e24e9eadba3abe651d,1,4,0,4,0,0,0,1,2,334,1,1,0,213,707,2,18,17,1,869,854,15,6,6,0,1,100,NoArch
90fa250a6c7f5a212d77a5b55ac91b386e3ea52a,2,42,6,36,0,0,0,4,56,46,1,2,0.994984828,1006,1917,61,132,129,3,3213,3152,61,49,47,2,1,100,NoArch
715492bb6e59de1e6df82471b18527e105195af0,0,0,0,0,0,0,0,0,0,0,0,0,0,0,1918,60,0,0,0,0,0,0,0,0,0,1,100,NoArch
83b02813a3905e1f4b0a4fb7f2f7abe4857e3abe,1,15,0,15,0,0,0,4,5,690,1,1,0,73,1919,61,4,3,1,344,303,41,2,1,1,1,100,NoArch
b1d94b71e3d067ff0c1af7cc794b74ce319d2227,1,524,518,6,0,0,0,2,14,51,1,1,0,518,1920,62,65,64,1,1825,1799,26,27,26,1,1,100,NoArch
7b65e328e41e7327fdb2c75e5f7adbd0358812a0,1,7,0,7,0,0,0,9,79,8,1,1,0,328,1921,51,36,35,1,1128,1093,35,12,12,0,1,100,NoArch
b25026ca4da19c0dd621a42ac8ac9b3569610bfd,1,1,2,1,0,0,0,4,6,2,1,1,0,88,1922,52,4,4,0,355,344,11,2,2,0,1,100,NoArch
1d19e7faee5f55f88b798662e25f8d03bbcd2d09,1448,116800,123441,6641,374,499,873,2,68,250,10,179,9.554369484,213578,427,3,18932,22118,3186,698728,814003,115275,8634,10466,1832,1,64.3073302,Arch
a276ace7af2d3d512b8d4eedaf53caf4752d0b3a,1,7,0,7,0,0,0,5,69,8,1,1,0,2261,428,4,288,287,1,8001,7966,35,53,53,0,1,100,NoArch
56dd9e52f681138ece7586e1dbda61185b7e5906,1,13,0,13,0,0,0,3,4,2065,1,1,0,69,429,5,4,3,1,346,292,54,2,1,1,1,100,NoArch
5d2373e8038b5c8ad9bb3c81e883a383380061f2,1448,123405,116786,6619,499,374,873,3,129,422,10,179,9.553160161,206957,1923,53,20174,20849,675,744695,766939,22244,9570,9476,94,1,64.3073302,Arch
b4b8b7c970a435064fbf0cd2e7e0ac071ed20717,1448,116807,123428,6621,374,499,873,2,69,251,10,179,9.554183224,213576,430,6,18934,22118,3184,698815,814001,115186,8635,10466,1831,1,64.3073302,Arch
b2865a9c5acd04aa1a8ac434925795d2bc1045e8,1448,123405,116784,6621,499,374,873,3,129,422,10,179,9.553170079,206955,1924,54,20174,20849,675,744695,766937,22242,9570,9476,94,1,64.3073302,Arch
0359a84786a5228bc1cc1df3bb90a422f530127d,1448,116834,123414,6580,374,499,873,2,69,251,10,179,9.554187256,213576,431,7,18941,22118,3177,699012,814001,114989,8636,10466,1830,1,64.31932773,Arch
2f7253f731088a3c9f9b5e63c1bc52c57afc3e43,1448,123399,116820,6579,499,374,873,3,129,422,10,179,9.553180446,206996,1925,54,20174,20856,682,744695,767134,22439,9570,9477,93,1,64.31932773,Arch
581438a3e0470facc682e5c9fe2a8c8f75c8c2e2,0,0,0,0,0,0,0,0,0,0,0,0,0,0,342,0,0,0,0,0,0,0,0,0,0,1,100,NoArch
2905e8bd8d6e4ee89a282f929fe07674b9f50132,1,0,2,2,0,0,0,8,130,98,1,1,0,1352,343,1,131,131,0,4227,4234,7,64,64,0,2,100,NoArch
522eeb42b80359084624885791b4663413d83ba3,1448,116832,123411,6579,374,499,873,2,69,251,10,179,9.5542379,213573,35,0,18941,22118,3177,699001,813994,114993,8636,10466,1830,2,64.31932773,Arch
728432ceea683f598943b2674a0c63ed5ec61f11,1448,123397,116818,6579,499,374,873,3,130,422,10,179,9.553226405,206994,344,2,20174,20858,684,744688,767191,22503,9570,9479,91,1,64.31932773,Arch
9ee6d9d785ddfd375e026ea0c95f7da71bea335b,1,24,7,17,0,0,0,8,131,0,1,1,0,1350,1926,47,133,131,2,4272,4227,45,64,64,0,1,100,NoArch
edf2af6c3e2cfe8ba15926ab73b70440312c1af0,1,179,0,179,1,0,1,1,1,0,1,1,0,0,1927,48,9,0,9,829,0,829,5,0,5,1,99.96595165,NoArch
43878ec1edbab4022b7b46474b44c290f3e16da7,1,4,0,4,0,0,0,2,8,146,1,1,0,71,1928,49,2,2,0,276,263,13,2,2,0,1,100,NoArch
d0704a32d4d76d3e8a463bd192f12114fd012620,0,0,0,0,0,0,0,0,0,0,0,0,0,0,345,3,0,0,0,0,0,0,0,0,0,1,100,NoArch
32f8f19017426b0ee24986e486dc76638331247b,0,0,0,0,0,0,0,0,0,0,0,0,0,0,346,4,0,0,0,0,0,0,0,0,0,1,100,NoArch
c907c9c9e2ec1c44f06d25efee02e69af8ec42dc,1,30,10,20,0,0,0,2,2,0,1,1,0,179,708,3,10,9,1,898,829,69,5,5,0,1,100,NoArch
3f8d9345c23037768dad2a258f757ec2741faf12,1,0,4,4,0,0,0,2,3,14,1,1,0,217,1929,46,17,18,1,854,869,15,6,6,0,1,100,NoArch
5736b4261d5b90f450e07e5d6241a504924edc78,1,1,1,0,0,0,0,3,48,30,1,1,0,1009,1930,47,88,88,0,3394,3394,0,50,50,0,1,100,NoArch
a75936772691639e8ead0d61e9cd407da5f2aef3,1,3,0,3,0,0,0,3,49,0,1,1,0,1009,1931,48,88,88,0,3394,3394,0,50,50,0,1,100,NoArch
b9418d44e1519c98aac0facb869d8e7bc8191b6a,1,1,1,0,0,0,0,5,19,108,1,1,0,691,1932,49,91,91,0,3138,3137,1,19,19,0,1,100,NoArch
745c40053a846d4429fdcbdd6e6173ecb279b78e,1449,116836,123635,6799,374,500,874,2,69,251,10,179,9.555707537,213792,432,8,18941,22129,3188,698995,814937,115942,8636,10471,1835,1,64.29771505,Arch
84cc351bb7a2bd279c44369305411d79771d4df3,1449,123618,116819,6799,500,374,874,3,132,422,10,179,9.554755807,206993,347,5,20185,20858,673,745625,767179,21554,9575,9479,96,1,64.29771505,Arch
17fbc99e9bee5321cceb5f31d61f0f9205d9ebc4,1,7,0,7,0,0,0,4,15,190,1,1,0,183,1933,43,21,20,1,560,528,32,6,6,0,1,100,NoArch
4e01204920d06ae18881ec4880bd55f4b5e8afa5,1,8,1,7,0,0,0,5,12,259,1,1,0,228,1934,44,37,36,1,1118,1083,35,6,6,0,1,100,NoArch
d923d298418b1c0c9bb70ba926843f78d5c1b9a1,1,7,0,7,0,0,0,3,10,264,1,1,0,657,1935,45,99,98,1,2601,2574,27,24,24,0,1,100,NoArch
efa9829c63fbf8f9356bfe9a60b6ef83ecf12b62,1,1,2,1,0,0,0,2,3,8,1,1,0,199,709,4,10,10,0,892,898,6,5,5,0,1,100,NoArch
637b336e66285928ade5a134b5fbc17ca8e182c9,5,47,13,34,0,0,0,6,79,68,1,1,2.183383098,2416,710,5,333,314,19,10064,9684,380,104,104,0,1,100,NoArch
2f06d7d437f8b6bcf7881f35e1ec8d0150a7f4e5,3,169,60,109,0,0,0,1,18,247,1,1,0.223614431,786,711,6,113,99,14,4016,3277,739,43,41,2,1,100,NoArch
fb9edca31ac797a8745d6189f216915c963e1b29,1,27,4,23,0,0,0,4,16,0,1,1,0,190,1936,46,25,21,4,613,560,53,6,6,0,1,100,NoArch
7a4af5d0a518341db5d6b6e5d372c8b5a610dccf,3,20,34,14,0,0,0,7,83,120,1,2,0.818801106,1686,712,7,165,164,1,9702,9695,7,67,67,0,1,100,NoArch
06a8ddfa84c3fed2350ba4ab1228d4fe0b817f5e,1,0,6,6,0,0,0,4,32,0,1,1,0,460,713,8,59,60,1,1833,1889,56,16,16,0,1,100,NoArch
3496a0f8d83e74e3177c076c2a2292aeb3220a22,2,22,1,21,0,0,0,2,4,133,1,1,0.426228657,385,714,9,33,30,3,1485,1410,75,14,13,1,1,100,NoArch
ba4ddae7b9d10843e4c89c5d78af4237514b7c46,1,23,2,21,0,0,0,2,5,0,1,1,0,234,715,10,22,20,2,978,928,50,8,7,1,1,100,NoArch
24c55c07854e38d10181a5c4bcce3b7ec3a9371b,1,1,1,0,0,0,0,3,19,0,1,1,0,737,716,11,97,97,0,3595,3597,2,28,28,0,1,100,NoArch
99e41e657d6f036f84e9fb62663749321a180b99,1,15,13,2,0,0,0,4,17,2,1,1,0,213,1937,43,26,25,1,620,613,7,6,6,0,1,100,NoArch
79a94a517f92ea5a7dc4709d2a9fb7c6c6151ae0,1,6,5,1,0,0,0,7,48,2,1,1,0,504,717,12,72,73,1,1670,1662,8,39,39,0,1,100,NoArch
16a1db1dd83b8b8faa04b6b6d4dce57e6679b89d,1,3,1,2,0,0,0,4,33,2,1,1,0,454,718,13,59,59,0,1836,1833,3,16,16,0,1,100,NoArch
af734940f254980e493cff264a5a8f4d23a6d5f0,1,9,9,0,0,0,0,1,1,0,1,1,0,288,719,14,37,37,0,1494,1494,0,5,5,0,1,99.93192648,NoArch
ad17e24059b18aef85e25deb40964c693d5eb19f,1,4,0,4,0,0,0,3,20,2,1,1,0,737,720,15,98,97,1,3612,3595,17,28,28,0,1,100,NoArch
bc4458056b31fbbac1e0f60359deac07da486409,1449,116837,123853,7016,374,500,874,2,69,251,10,179,9.555354297,214009,433,7,18941,22175,3234,698995,816301,117306,8636,10475,1839,1,64.29771505,Arch
1964b914d33a309ed9711ea3a4d5ce2db1ea448a,1,16,5,11,0,0,0,3,10,335,1,1,0,545,434,8,52,51,1,2167,2113,54,11,11,0,1,100,NoArch
59141cf29da120a0a9bcd35dc496a8643cbf12ba,1449,123836,116831,7005,500,374,874,3,132,422,10,179,9.554369312,207004,1938,42,20231,20860,629,746994,767287,20293,9579,9479,100,1,64.29771505,Arch
ab41ad92187766fc2e1291bb49877989a93ff922,1449,116848,123853,7005,374,500,874,2,69,251,10,179,9.555318511,214009,435,9,18942,22175,3233,699049,816301,117252,8636,10475,1839,1,64.29771505,Arch
275d5e0b1569ea48b4fdabc775f50c4d396bb87f,1449,123911,116824,7087,500,374,874,3,132,422,10,179,9.554549325,207004,1939,37,20247,20860,613,747495,767287,19792,9580,9479,101,1,64.29771505,Arch
2b5bb39153fcd96d6c3a2f57362f152ea89d3f76,1,11,3,8,0,0,0,7,49,6,1,1,0,505,1940,35,74,72,2,1725,1670,55,39,39,0,1,100,NoArch
6ebe3228baf6d4a868969630a591bd6b2d14be73,1,4,0,4,0,0,0,5,32,3,1,1,0,335,1941,34,50,49,1,1319,1309,10,22,22,0,1,100,NoArch
9282a46b3d68ebb9cdbbf4ded6e883563bba16c6,0,0,0,0,0,0,0,0,0,0,0,0,0,0,1204,0,0,0,0,0,0,0,0,0,0,1,100,NoArch
02525f266452ed2b349d343c81a9ac8b4dd89833,1,1,1,0,0,0,0,4,24,34,1,1,0,405,1942,35,42,41,1,1624,1617,7,15,15,0,1,100,NoArch
1ce866794a3fb3ea80c61e397a10625db43fc786,1,5,3,2,0,0,0,2,22,40,1,1,0,616,1943,36,78,78,0,3283,3258,25,17,17,0,1,100,NoArch
c4a957c191c0eee908c1011116e8291c06791685,1,4,0,4,0,0,0,5,20,347,1,1,0,471,1944,37,65,64,1,1209,1189,20,24,24,0,1,100,NoArch
2a9c687e97b1fc470a08b4bfeb4b4a5898c383c9,2,6,6,0,0,0,0,3,43,350,1,1,1,690,1945,32,80,80,0,2891,2899,8,19,19,0,1,100,NoArch
2fb18cce40233cf59993d0256c73b4ea6e2c10e7,1449,116845,123950,7105,374,500,874,2,69,251,10,179,9.555502092,214109,436,10,18942,22196,3254,699041,816911,117870,8636,10476,1840,1,64.29771505,Arch
e70d2cf3678c5976e55d9b6ba703ae21956c97fa,1449,123925,116820,7105,500,374,874,3,132,422,10,179,9.554557092,207004,1946,33,20252,20860,608,747604,767279,19675,9580,9479,101,1,64.29771505,Arch
d6e03aea1e9f10cefcb672afb41b42dc61d2780f,1,29,5,24,0,0,0,5,20,23,1,1,0,691,348,6,95,91,4,3284,3138,146,20,19,1,1,100,NoArch
3d4d28d81225ab1af48ba1bf8d2ba1b76101b1f6,1,0,28,28,0,0,0,5,21,0,1,1,0,715,349,7,91,95,4,3129,3284,155,19,20,1,1,100,NoArch
94a22a9b824703a74c5ddf2e8d583c8f82b93455,1,13,1,12,0,0,0,4,19,149,1,1,0,303,1947,30,46,44,2,1045,1022,23,12,12,0,1,100,NoArch
947626a7e3b69b34f157736664696d2225ac3b6e,1,19,2,17,0,0,0,5,22,1,1,1,0,687,350,8,93,91,2,3207,3129,78,19,19,0,1,100,NoArch
847d28c89591aa6e8f117aec9606002daddc8849,3,88,4,84,0,0,0,1,35,115,1,2,1.026987472,949,351,9,104,93,11,3172,2896,276,54,50,4,1,100,NoArch
74f5ad1dc97a589ff66be0bbea0a1356686b50b1,1,2,2,0,0,0,0,3,26,301,1,1,0,622,1948,30,80,79,1,2388,2382,6,39,39,0,1,100,NoArch
4031bd49e4289a76eb0c636f0b8f31552fec81f4,1,1,1,0,0,0,0,1,5,0,1,1,0,97,352,10,5,5,0,351,351,0,5,5,0,1,100,NoArch
ba53555172cd495e88bd4c4014286a25035f692f,1,25,1,24,0,0,0,5,33,1,1,1,0,592,353,11,66,64,2,1820,1740,80,33,33,0,1,100,NoArch
9350bfa268e612a6d8d6d76d240932a0bb6e5a29,1,73,84,11,0,0,0,4,18,21,1,1,0,215,1949,31,24,26,2,557,620,63,6,6,0,2,100,NoArch
f4a2210f8409709f8922cf40d9907c9effe9e266,1,25,1,24,0,0,0,2,9,44,1,1,0,239,1950,24,13,10,3,1315,1218,97,4,4,0,1,100,NoArch
a5f80ede589cf44c26705ce0ad8285ebe652100a,1,23,0,23,0,0,0,2,4,30,1,1,0,198,1951,25,11,10,1,1100,892,208,5,5,0,1,100,NoArch
78a63c00c1dac7cc87125c07a63d41232592ab7b,1,21,0,21,0,0,0,3,12,135,1,1,0,2104,1952,26,247,245,2,5903,5746,157,109,109,0,1,100,NoArch
593cec8f8e8f6bbdc28b6ddaa6ba64d82ccc0b77,0,0,0,0,0,0,0,0,0,0,0,0,0,0,1953,24,0,0,0,0,0,0,0,0,0,1,100,NoArch
b7795545d4d5c388f28976a866cc8210a69927c3,1,12,2,10,0,0,0,6,80,32,1,1,0,550,1954,25,78,75,3,2498,2460,38,23,23,0,1,100,NoArch
b17a73583c6a0b31133d1be83f9873a1cd50bbd4,0,0,0,0,0,0,0,0,0,0,0,0,0,0,354,7,0,0,0,0,0,0,0,0,0,1,100,NoArch
ecb1444f0864040ae7a3c3b659cf0bcb7b64bf8d,1,2,0,2,0,0,0,3,21,32,1,1,0,741,1955,22,98,98,0,3646,3612,34,28,28,0,1,100,NoArch
75b71f371076ba2c65b30177111c76f4ad3fdf39,1,1,1,0,0,0,0,6,42,206,1,1,0,700,1956,23,81,81,0,2399,2399,0,43,43,0,1,100,NoArch
b5adf7bae18d047ac98c5ad196855177eaee96c2,1449,116864,124171,7307,374,500,874,2,69,251,10,179,9.555235853,214311,437,4,18942,22223,3281,699041,817905,118864,8636,10480,1844,1,64.29771505,Arch
d2820c6148841f60ae8d39390515a152925a912d,1449,124162,116844,7318,500,374,874,3,132,422,10,179,9.554132283,207004,1957,24,20279,20860,581,748558,767279,18721,9584,9479,105,1,64.29771505,Arch
bf41fc6b3aec0ce9b476bd55f2d02b90ff2994ee,0,0,0,0,0,0,0,0,0,0,0,0,0,0,1958,25,0,0,0,0,0,0,0,0,0,1,100,NoArch
22211426654d216af73cd04c5d1a2974a7dc674f,1449,116897,124182,7285,374,500,874,2,69,251,10,179,9.554743609,214322,438,5,18946,22225,3279,699224,817934,118710,8636,10480,1844,1,64.29771505,Arch
40699bb9e378c68ea4c9e15aa59c13b3bd57e0c5,1449,124166,116881,7285,500,374,874,3,132,422,10,179,9.553932205,207037,1959,26,20279,20864,585,748558,767462,18904,9584,9479,105,1,64.29771505,Arch
f64fc929ff7f731aeb2ca10105f43eb6c380561b,2,807,790,17,0,0,0,3,22,47,2,2,0.354629546,889,1960,27,110,111,1,4152,4125,27,35,34,1,1,100,NoArch
6a08e79b413bc8e799e22af7b5468e0d63d2d7db,1,38,33,5,0,0,0,3,14,2,1,1,0,2136,1961,28,250,249,1,5946,5932,14,110,109,1,1,100,NoArch
6cb184b8ea139695529b4f8ddff6a1f25c71c6f7,1449,116906,124208,7302,374,500,874,2,69,251,10,179,9.554835851,214344,439,6,18947,22225,3278,699238,817975,118737,8637,10482,1845,1,64.29771505,Arch
bf4e160aa40cda0b1788ea8fcb4f44089a32d74b,1449,124188,116886,7302,500,374,874,3,132,422,10,179,9.553857176,207042,1205,1,20279,20865,586,748599,767476,18877,9586,9480,106,0,64.29771505,Arch
273ccb5246df33c004e055cb28748b4609c0c6ea,0,0,0,0,0,0,0,0,0,0,0,0,0,0,1206,2,0,0,0,0,0,0,0,0,0,0,100,NoArch
379cef94a631927168c68b58277bcd83eddc5f12,0,0,0,0,0,0,0,0,0,0,0,0,0,0,1207,3,0,0,0,0,0,0,0,0,0,0,100,NoArch
b778bc67088772db0130a68ac3207d2c9c621017,1,4,0,4,0,0,0,3,3,1339,1,1,0,133,1962,26,21,19,2,374,355,19,8,8,0,1,100,NoArch
2b9ac920400548940c4ef173e24998594e04f6f0,1,5,8,3,0,0,0,2,4,3,1,1,0,159,1963,27,14,14,0,468,484,16,7,7,0,1,100,NoArch
9e0dbcd0778109799cc211011062f88a5466bedd,1,2,1,1,0,0,0,8,133,45,1,1,0,1367,1964,28,133,133,0,4278,4267,11,64,64,0,1,100,NoArch
6cb52d43b92ec7d79474cb611659b2424e430312,1,50,5,45,0,0,0,2,3,1022,1,1,0,47,1965,29,10,2,8,364,156,208,2,2,0,1,100,NoArch
e9f407823626e0be86d46c6f2b4ae090e5d00f5b,1,5,6,1,0,0,0,2,5,0,1,1,0,156,1966,29,14,14,0,447,468,21,7,7,0,1,100,NoArch
3f2048ada8927b21daaccaacbb9e43551170cb3c,1,2,2,0,0,0,0,6,17,440,1,1,0,193,721,1,15,15,0,389,388,1,14,14,0,1,100,NoArch
91d29d6369b4212597cc0d54a47eb0088afc6b6f,1,1,1,0,0,0,0,6,18,0,1,1,0,193,722,2,15,15,0,390,389,1,14,14,0,1,100,NoArch
77db6a14099c67efee617aea6ba8596b847a45a7,1,2,1,1,0,0,0,6,19,0,1,1,0,193,723,3,15,15,0,402,390,12,14,14,0,1,100,NoArch
12a645a42720456617c440b0025cac092c5d9b0e,11,85,11,74,0,0,0,2,4,917,1,2,3.21244139,596,1967,29,40,25,15,2772,2326,446,22,22,0,2,95.96479575,Arch
a3c4170175d2264191d0be3770074f6a5f0cb427,1,19,0,19,0,0,0,2,6,1027,1,1,0,71,1968,29,6,3,3,155,113,42,4,3,1,1,100,NoArch
d6a4c96f4518a3ad198d17aa04ef80ed1798f449,5,20,0,20,0,0,0,2,5,131,1,2,2.321928095,339,1969,30,22,17,5,1707,1627,80,10,10,0,1,100,NoArch
0f0f60837db4e5b3a43ab486b65f70dee32b120f,1,2,2,0,0,0,0,5,36,9,1,1,0,1420,1208,4,191,191,0,6883,6887,4,69,69,0,1,100,NoArch
5de544c40cbb2fda95cc0a812c36417507ef7fac,1,4,2,2,0,0,0,7,74,79,1,1,0,573,1970,31,61,60,1,1769,1755,14,25,25,0,1,100,NoArch
c37d79c1188970019792681d885e98c2fbc23708,1,4,0,4,0,0,0,4,5,774,1,1,0,225,1971,32,17,16,1,596,579,17,11,11,0,1,100,NoArch
9e1e3c7b5d76fceff29050a605417cbf5d32ff6a,1,9,1,8,0,0,0,3,9,759,1,1,0,117,1972,32,11,10,1,285,268,17,1,1,0,1,100,NoArch
e1251dd65da25629895327e5b62178f8c3c6c049,2,36,12,24,0,0,0,8,134,63,1,2,0.337290067,2745,1209,4,295,292,3,9965,9873,92,111,109,2,1,100,NoArch
167ccb2473da6a6cbf1dba15a0742739449aa57f,1,18,2,16,0,0,0,6,23,392,1,1,0,701,1973,28,85,84,1,2055,2026,29,46,45,1,1,100,NoArch
c66692e02fa28bf04634c598e510c5efdbe51aef,1449,116920,124421,7501,374,500,874,2,69,251,10,179,9.556412557,214558,440,4,18948,22262,3314,699267,818568,119301,8638,10481,1843,1,65.62807478,Arch
c083b71f5e0e5b97cfb59b661c7358ec1dc01ab3,1449,124404,116893,7511,500,374,874,3,134,419,10,179,9.555425138,207057,1974,27,20321,20861,540,749575,767218,17643,9590,9477,113,1,65.62807478,Arch
9ec783b58e376604fc3522d967cc1419972b0f6a,1,6,0,6,0,0,0,8,70,3,1,1,0,1402,1975,28,164,162,2,5714,5696,18,47,47,0,1,100,NoArch
1de7a68da83418137812684722f2d2229ee476e3,1,9,1,8,0,0,0,2,10,27,1,1,0,263,1976,29,14,13,1,1358,1315,43,4,4,0,2,100,NoArch
8c039ec1baafb3538923004ac9713563c445ca79,1,1,1,0,0,0,0,2,11,0,1,1,0,271,1977,30,14,14,0,1358,1358,0,4,4,0,2,100,NoArch
31317a0727fcc8eb8f2923d88edcc2a7b67cea9e,6,63,167,104,0,0,0,5,37,253,1,1,1.834584807,2536,1210,5,315,324,9,10235,10366,131,130,138,8,1,99.96756406,NoArch
c2ccf34174306a777655a2f54ecce3cc59e2bca4,1,1,1,0,0,0,0,2,12,1,1,1,0,271,1978,31,14,14,0,1361,1358,3,4,4,0,2,100,NoArch
1324261cc363e38f7c87ff9577a0c29508b36a61,2,372,164,208,1,0,1,3,4,347,1,1,0.950212586,164,1979,30,28,11,17,771,282,489,19,11,8,1,99.9351176,NoArch
68853fb2062144d0817d9605625b5d48a69e41e1,1,2,2,0,0,0,0,4,12,94,1,1,0,627,1980,31,58,58,0,2558,2562,4,12,12,0,1,100,NoArch
27797fde4e86bb8a2210017901d70281ed923705,1,12,0,12,0,0,0,2,13,4,1,1,0,271,1981,32,17,14,3,1416,1361,55,4,4,0,1,100,NoArch
1b2ba303f01afbd70d50ddf44cfea885ecaf00bf,0,0,0,0,0,0,0,0,0,0,0,0,0,0,1982,33,0,0,0,0,0,0,0,0,0,1,100,NoArch
cc8988e9e8444c72df8a6d80e1594ea415f9f92f,0,0,0,0,0,0,0,0,0,0,0,0,0,0,1983,34,0,0,0,0,0,0,0,0,0,1,100,NoArch
5ce76b146c171e86ee9e9016bf7f64717819b08a,2,65,65,0,0,0,0,3,5,2,1,1,0.302515747,372,1984,34,28,28,0,761,771,10,19,19,0,1,100,NoArch
72a34598b9c18581aa8bd45a5bdd29f5b4bcdd7b,1,0,1,1,0,0,0,8,135,14,1,1,0,1367,1985,35,133,133,0,4258,4269,11,64,64,0,1,100,NoArch
f94283e100b8f62b216e1d9993f5057b3a4c3d54,0,0,0,0,0,0,0,0,0,0,0,0,0,0,1986,36,0,0,0,0,0,0,0,0,0,1,100,NoArch
9107c2f0799b1f4412a00836f41be5b2a441fdc0,1,32,92,60,0,0,0,5,38,11,1,1,0,1422,1211,6,187,191,4,6596,6946,350,66,69,3,1,100,NoArch
8c9e850867496d299af566c3778394e397f23070,1,1,1,0,0,0,0,5,39,2,1,1,0,1362,1212,7,187,187,0,6596,6596,0,66,66,0,1,100,NoArch
0676457945082fc6576239e8754b6fbd77d447bc,1,104,92,12,0,0,0,5,40,0,1,1,0,1362,1213,8,189,187,2,6652,6596,56,67,66,1,1,100,NoArch
08a1b685d248feb68afced7c97013053fcb6f1a4,1,4,11,7,0,0,0,3,4,1826,1,1,0,154,1214,9,5,6,1,627,655,28,5,6,1,1,100,NoArch
f663784485b1d4a3a51809e70e230141535a2f86,12,14,14,0,0,0,0,4,55,783,1,8,3.521640636,3239,1215,10,371,371,0,15025,15025,0,88,88,0,1,97.65982703,Arch
5e01607d5b7c5caa9c61018c5f0700db17deef09,1,2,2,0,0,0,0,1,3,243,1,1,0,47,1987,32,5,5,0,98,98,0,2,2,0,1,100,NoArch
ab237449259222081a64785a4aca34521cba6ac1,1,1,0,1,0,0,0,10,84,74,1,1,0,708,1988,33,32,32,0,6163,6151,12,12,12,0,1,100,NoArch
8830074f2527faf4e85fc680b80b2339ecf75870,1,35,0,35,0,0,0,6,24,23,1,1,0,717,1989,30,88,85,3,2170,2055,115,48,46,2,1,100,NoArch
f341b4308790c40cedf2bbd4e56d49fdb8374277,1,74,0,74,0,0,0,4,109,149,1,1,0,987,1990,31,119,107,12,4877,4435,442,44,43,1,1,100,NoArch
af72be9bda013d67ac0aaadfabe4ad2037557ac4,2,4,4,0,0,0,0,1,2,472,1,1,1,108,724,3,6,6,0,181,179,2,6,6,0,1,100,NoArch
f4b2f0dc147b4db629353bf9a8958a1334c13c0c,1,6,0,6,0,0,0,4,110,0,1,1,0,1061,1991,32,119,119,0,4955,4877,78,44,44,0,1,100,NoArch
68bc9cda8e13f822c953f151dac7b7dbaa1bddcd,1,8,8,0,0,0,0,5,41,6,1,1,0,1374,1216,11,189,189,0,6640,6652,12,67,67,0,1,100,NoArch
5f05431b9a74e56a48469327860c26e34984054f,1,0,1,1,0,0,0,5,42,0,1,1,0,1374,1217,12,189,189,0,6633,6640,7,67,67,0,1,100,NoArch
303282c47954915c78ea6d1571c3ca7a9f678565,1,0,20,20,0,0,0,6,21,20,1,1,0,194,725,4,13,15,2,389,417,28,12,14,2,1,100,NoArch
f45f023df3587c24e108c3209db3499c396c3bd1,5,89,6,83,0,0,0,7,56,133,2,3,2.218945967,2416,726,5,323,316,7,10685,10428,257,128,121,7,1,100,NoArch
e8996f90e0461ab976ec9c624477fe0da45a79af,1,35,28,7,0,0,0,3,23,39,1,1,0,747,727,6,97,96,1,3694,3668,26,28,28,0,1,100,NoArch
c3682480a9640ad87d2ddd1b8b1c8de1ca21a31b,1,8,1,7,0,0,0,4,24,461,1,1,0,691,728,7,100,99,1,2089,2073,16,40,40,0,1,100,NoArch
23b492a97a61133e8f8cfc89e62425ca5ae2e798,1,29,0,29,0,0,0,6,10,225,1,1,0,328,1992,25,29,26,3,765,694,71,24,22,2,1,100,NoArch
8fba071cbc0b30255ad5e869928e9f42fa231a64,1,105,26,79,0,0,0,4,111,6,1,1,0,1067,1993,26,132,119,13,5396,4955,441,46,44,2,1,100,NoArch
3c211b239fbabe7690bad6b7ec54f62bac62ff7e,1,19,1,18,0,0,0,7,53,255,1,1,0,603,1994,27,60,56,4,2071,2019,52,20,20,0,1,100,NoArch
ae8c0fc6134a75e796f37ab5d4136c9caaa1f841,1,5,5,0,0,0,0,4,112,2,1,1,0,1146,1995,28,132,132,0,5401,5396,5,46,46,0,1,100,NoArch
3989eff0a51a9bea7292ffc6ac58c2772a1073a5,1,10,8,2,0,0,0,3,12,226,1,1,0,287,355,0,34,33,1,1000,988,12,15,15,0,1,100,NoArch
00dde08fac657c03c089468db46798d9b8320dac,1,2,4,2,0,0,0,3,15,48,1,1,0,2141,1996,28,250,250,0,5937,5946,9,110,110,0,1,100,NoArch
ba7e146a0a61d1fcd891c8675eca004992652057,1,1,1,0,0,0,0,3,27,67,1,1,0,622,1997,29,80,80,0,2393,2388,5,39,39,0,1,100,NoArch
817170788380053b2ae52ed3c235d5dc057e67f3,1,26,0,26,0,0,0,2,21,803,1,1,0,194,1998,25,20,19,1,1414,1188,226,8,7,1,1,97.96450939,Arch
69cda9bcc86fda4669bf224be4d0a5a0001ab119,1,7,7,0,0,0,0,5,22,442,1,1,0,382,1999,25,30,30,0,2117,2117,0,30,30,0,1,100,NoArch
b4f0ac530d27f85d2807b7e4c49b9ad46ee30158,1,2,2,0,0,0,0,6,14,555,1,1,0,150,2000,26,12,12,0,307,307,0,10,10,0,1,100,NoArch
af58ecb6aa8a6c3b5cfb0ee78974f68787a4f557,1,4,2,2,0,0,0,8,136,27,1,1,0,1366,2001,27,133,133,0,4258,4258,0,64,64,0,1,100,NoArch
e4d3bc969ca2de8eca0910e2bbdc9caa5fac5e98,1,5,2,3,0,0,0,5,29,168,1,1,0,196,2002,28,12,12,0,906,888,18,6,6,0,2,100,NoArch
dd775ecdd478deddea1c75de0a41ff85538cac92,1,6,4,2,0,0,0,4,9,1903,1,1,0,208,2003,29,17,17,0,325,325,0,17,17,0,1,100,NoArch
95a4ad61d9fa42b347960c92bf9e6f36ed342464,1,5,2,3,0,0,0,4,7,376,1,1,0,114,2004,30,13,13,0,467,429,38,13,13,0,1,100,NoArch
07ae1b855e5256624294020983695a505f1fcdaf,1453,117202,125137,7935,375,501,876,2,69,251,10,179,9.560984026,215333,441,0,18975,22347,3372,700687,821879,121192,8653,10506,1853,1,64.45864156,Arch
d32cf87378a42e6d4592cd7ed56e67ff8991c9d6,1,27,0,27,0,0,0,1,3,1733,1,1,0,343,442,1,18,17,1,2559,2308,251,12,11,1,1,98.79148936,NoArch
ce847263f10119c6c141113c892598f6fae54170,1453,125098,117190,7908,501,375,876,3,136,424,10,179,9.560010268,207425,2005,27,20403,20887,484,752847,768821,15974,9615,9491,124,1,63.72735116,Arch
7a8efb034c8f99c66de18f036424a7e8a984139b,3,4,4,0,0,0,0,5,24,207,1,1,1.5,1153,2006,28,88,88,0,3939,3939,0,88,88,0,1,100,NoArch
166418a090a89e8fb2905d9699ed0715be916af9,1,10,10,0,0,0,0,5,25,0,1,1,0,382,2007,29,30,30,0,2117,2117,0,30,30,0,1,100,NoArch
a803f81c7e2f795a3c55b4d457ace44ed5546187,5,54,53,1,0,0,0,5,26,82,1,1,1.613739821,1841,2008,30,121,121,0,5259,5270,11,120,120,0,1,100,NoArch
677767a8cf448e037f79929871786d7b74a46612,1,2,3,1,0,0,0,4,16,454,1,1,0,447,1218,7,49,49,0,1050,1059,9,29,29,0,1,100,NoArch
b2ddb47fd456e518a95c37d4f72c5bad4e8477af,1,2,2,0,0,0,0,5,27,0,1,1,0,382,2009,31,30,30,0,2117,2117,0,30,30,0,1,99.98295842,NoArch
9d8c552df365926e42e0c5ddb4b97f8731fca591,1,66,5,61,0,0,0,5,13,0,1,1,0,417,2010,32,37,33,4,953,838,115,36,32,4,1,100,NoArch
c6f21256f08c03c86b911981587e9f446e8d171d,3,8,8,0,0,0,0,5,19,0,1,1,1.061278124,1043,2011,33,58,58,0,2304,2304,0,58,58,0,1,100,NoArch
a80c94269a7160e4d8f7a3afaf6663daebecbcff,1,9,4,5,0,0,0,3,16,14,1,1,0,2139,2012,33,251,250,1,5957,5937,20,111,110,1,1,100,NoArch
524dfdb807d050fe6e55a6ef818562e68282e707,1453,117273,125241,7968,375,501,876,2,69,252,10,179,9.561195582,215399,443,2,18977,22352,3375,700965,821994,121029,8655,10511,1856,1,63.72735116,Arch
2f2a7f43eca4dbb8c1bad6aa873d40152a65e07d,1453,125222,117252,7970,501,375,876,3,137,424,10,179,9.560298999,207431,2013,34,20408,20888,480,752972,768848,15876,9620,9492,128,1,63.72735116,Arch
14ed05908876f8df330a0c1ccbc892d62656bb1a,1,10,3,7,0,0,0,3,17,3,1,1,0,2144,2014,30,252,251,1,5967,5957,10,112,111,1,1,100,NoArch
aaabd3268791623f40155dd57e06686d93bfa7a8,1453,117289,125261,7972,375,501,876,2,69,252,10,179,9.561112218,215408,444,3,18978,22353,3375,700972,822014,121042,8656,10512,1856,1,63.72735116,Arch
adf0ada647ea5fb014578b556bb460fe6c203d7f,1453,125240,117257,7983,501,375,876,3,138,424,10,179,9.560097784,207436,729,5,20409,20889,480,753037,768855,15818,9621,9493,128,1,63.72735116,Arch
3fc9550bfa1d2cdb14e3c9b95a3b1ea02dbc9e92,11,77,31,46,0,0,0,3,81,303,1,2,3.22899819,3221,730,6,330,325,5,13134,13040,94,120,114,6,1,100,NoArch
8e351382de581af0b976f962ea09a4aacd9dafa5,1,4,2,2,0,0,0,2,7,0,1,1,0,176,731,7,18,18,0,584,564,20,8,8,0,1,100,NoArch
f125934876cdd847a647368882a5a33d9ba1ff90,1,19,18,1,0,0,0,8,139,0,1,1,0,1372,2015,30,133,133,0,4249,4260,11,64,64,0,1,100,NoArch
1953f1719f8855cc980099e9e889704ee43aa5f4,1,33,65,32,0,0,0,4,25,98,1,1,0,405,1219,7,40,42,2,1490,1624,134,16,15,1,1,100,NoArch
72142b1a7422683a275c4d8ad43489757be91641,2,20,19,1,0,0,0,4,17,39,1,1,0.858230793,583,1220,8,70,70,0,1421,1424,3,37,37,0,1,100,NoArch
af2352ecca97dedfe1a0ae4d3934bbaa208e6237,2,37,32,5,0,0,0,4,18,0,1,1,0.974240833,584,1221,9,66,70,4,1406,1421,15,38,37,1,1,100,NoArch
0545ebcdb23bfc6aa736f0a4b02ec07f9d76c069,1,8,6,2,0,0,0,4,19,2,1,1,0,458,1222,8,51,51,0,1126,1128,2,29,29,0,1,100,NoArch
05515e82236b99589f3eff8527249b49e6dff4c1,0,0,0,0,0,0,0,0,0,0,0,0,0,0,356,1,0,0,0,0,0,0,0,0,0,2,100,NoArch
cd180f854d7d85c5a17712e706b7521eeb4efec0,1453,117326,125334,8008,375,501,876,2,69,252,10,179,9.561016646,215444,36,0,18978,22354,3376,700972,822026,121054,8656,10523,1867,2,63.72735116,Arch
35da7636b1e8a0fec519d8c3370daeb8c4a5012c,1453,125308,117297,8011,501,375,876,3,139,424,10,179,9.560203601,207436,2016,28,20411,20889,478,752997,768855,15858,9629,9493,136,1,63.72735116,Arch
cf53b2eac143b00ab954bee59e5bed467ac048f3,1,14,1,13,0,0,0,6,18,153,1,1,0,560,2017,29,67,65,2,1357,1324,33,40,38,2,1,100,NoArch
de46b1c03f55fcc542a5c3fe8ad425ba789c5c82,1,8,27,19,0,0,0,8,140,8,1,1,0,1373,2018,30,133,133,0,4137,4249,112,64,64,0,1,100,NoArch
46fca9a3b4a97d9242b53966dead1ebad2e01b4d,1453,117350,125355,8005,375,501,876,2,69,253,10,179,9.56089954,215441,445,4,18978,22359,3381,700972,821958,120986,8656,10525,1869,1,63.72735116,Arch
e2b6ce026d83b767fb60e5375eca9f6013a73153,1,4,3,1,0,0,0,2,3,1006,1,1,0,265,446,5,16,16,0,1201,1185,16,5,5,0,1,100,NoArch
9376a874b108afb5908d89966fc32610b1d1f654,1,14,11,3,0,0,0,6,30,531,1,1,0,1527,447,6,175,172,3,5841,5830,11,40,40,0,1,100,NoArch
4cfa136796ec3c3eb405f85911049c50fe971663,1,1,1,0,0,0,0,4,9,0,1,1,0,116,448,7,8,8,0,203,203,0,7,7,0,1,100,NoArch
d7acc618a3313af32831170f06f4e60a5222e03c,1,2,1,1,0,0,0,2,4,0,1,1,0,266,449,8,16,16,0,1201,1201,0,5,5,0,1,100,NoArch
500bc9c533d91f959bf22666afb09341dfe0d8f9,1453,125326,117303,8023,501,375,876,3,140,424,10,179,9.560714017,207441,2019,30,20417,20892,475,753080,768882,15802,9631,9493,138,1,63.72735116,Arch
e73527e26f82c4840474e8fbed60c8a1080003bd,1,1,0,1,0,0,0,4,5,580,1,1,0,157,2020,31,13,13,0,611,606,5,5,5,0,1,100,NoArch
c3139f91caca08103a13ba38d97250263c10a3a9,1,1,1,0,0,0,0,4,6,0,1,1,0,158,2021,32,13,13,0,612,611,1,5,5,0,1,100,NoArch
3fb6f0670ad4d989d4bab15580f68a0bb07745e0,1,1,1,0,0,0,0,6,11,33,1,1,0,357,2022,33,29,29,0,765,765,0,24,24,0,1,100,NoArch
be68b1bdbfc0d8cb9ce899fee12997b027e270ba,3,7,3,4,0,0,0,6,12,540,1,1,1.521928095,880,2023,34,73,73,0,2196,2188,8,50,50,0,1,100,NoArch
17bd2aa6e24c81a5d0bbbc5b1e2ca254e887d193,1,2,2,0,0,0,0,4,7,559,1,1,0,177,2024,35,19,19,0,635,634,1,8,8,0,1,100,NoArch
ce653c27e3eabe5137ce9a574d01806941a6db61,1,61,2,59,0,0,0,4,5,582,1,1,0,125,2025,36,16,11,5,479,283,196,11,7,4,1,100,NoArch
7299134caff5952b63946f108bd5ecd82f3f4064,9,203,66,137,0,0,0,4,85,351,1,2,2.230557166,2932,2026,34,302,286,16,13995,13418,577,137,126,11,1,100,NoArch
665fab99ed8bc485e7be77f33c5a775a0335e75c,1,0,2,2,0,0,0,8,141,2,1,1,0,1354,2027,35,133,133,0,4111,4137,26,64,64,0,1,100,NoArch
cc13bae8d1c184086de4e5d0b64e787899a8e705,1,8,5,3,0,0,0,4,7,0,1,1,0,310,2028,36,34,32,2,964,949,15,19,19,0,1,100,NoArch
378a620d64606e38e89a06f42fa249f010e20095,1,16,0,16,0,0,0,4,113,36,1,1,0,1146,2029,37,136,132,4,5453,5401,52,46,46,0,1,100,NoArch
3c10e93feb496772f1bfc17090ae7cf06c3dda94,1,15,0,15,0,0,0,4,6,403,1,1,0,282,2030,38,32,31,1,801,763,38,20,19,1,1,100,NoArch
96ab0b2a9af13a3b3b92b990f04c94f07b70999a,2,27,39,12,0,0,0,3,12,539,2,2,0.195909271,1223,1223,5,122,121,1,4680,4793,113,25,25,0,1,100,NoArch
6548d70455976330db24d88c2793de0eedf56034,1,9,12,3,0,0,0,4,5,539,1,1,0,897,1224,6,88,88,0,1535,1526,9,80,80,0,1,100,NoArch
2266ceed3721a07f92997a0309ca94cb2848e1a0,1,22,6,16,0,0,0,8,72,6,1,1,0,1411,13,0,168,167,1,5792,5725,67,48,47,1,1,100,NoArch
e02796f458796805831c16685cda358b670168a6,1,1,1,0,0,0,0,3,3,902,1,1,0,58,1225,7,4,4,0,127,127,0,2,2,0,1,100,NoArch
ccbfb63d8cf6e9d35f221d94e0c6aac1c16b6082,1,8,7,1,0,0,0,4,6,258,1,1,0,288,1226,8,36,36,0,1042,1028,14,11,11,0,1,100,NoArch
d98c9643a07d0d8867caa3b51e170eff11394ea2,1,3,3,0,0,0,0,2,4,17,1,1,0,144,1227,9,12,12,0,379,372,7,7,7,0,1,100,NoArch
ec457fab186b4e3eaa7355cf5e062093b792d54b,1,5,0,5,0,0,0,8,142,5,1,1,0,1352,2031,37,133,133,0,4118,4111,7,64,64,0,1,100,NoArch
01413cb437a877a2af082601997ed5393072cccc,1453,117361,125619,8258,375,501,876,2,69,252,10,179,9.561777877,215704,450,9,18981,22393,3412,700999,822987,121988,8656,10542,1886,1,63.72735116,Arch
6d0f9a42dd9eaec3fdec5edbef654fd604ea2f71,1453,125578,117320,8258,501,375,876,3,142,424,10,179,9.561427447,207446,1228,10,20447,20892,445,753949,768882,14933,9648,9493,155,1,63.72735116,Arch
04d04ce3df74cf16c85cdc76589b0c535d130431,5,36,31,5,0,0,0,4,25,427,1,1,1.533256902,1838,1229,11,237,237,0,6624,6539,85,78,78,0,1,100,NoArch
8a0a5d0ee2469ad42ddd26ff4b1a21e81c6479e5,6,9,10,1,0,0,0,4,76,223,1,3,2.371533595,2899,1230,12,313,313,0,11363,11342,21,127,127,0,1,100,NoArch
abbc2fa6df57a4217af1b9a8563fa2c1a5d4e437,4,49,53,4,0,0,0,3,114,375,1,1,1.569826334,1509,1231,13,169,169,0,6737,6744,7,59,59,0,1,100,NoArch
ebe1ce0c17b47971443b8548f94c950b8287e019,1,1,1,0,0,0,0,4,24,50,1,1,0,754,1232,14,97,97,0,3694,3694,0,28,28,0,1,100,NoArch
e12d7545e70f511f290e025255d2be82dd2b00e6,1,8,1,7,0,0,0,5,20,9,1,1,0,994,2032,35,127,126,1,3431,3407,24,53,53,0,1,100,NoArch
69476af8bef0024b4c7a7aaf239de92f22eb77e2,1,1,1,0,0,0,0,10,86,11,1,1,0,710,1233,15,32,32,0,6176,6175,1,12,12,0,1,100,NoArch
bbf4ac7dafb1ec66dac38dbd1ec1b6a2c28fd67c,1,2,2,0,0,0,0,3,10,411,1,1,0,176,1234,16,9,9,0,899,907,8,6,6,0,1,100,NoArch
23b1dfcc72b4a337ab2732af72646fdb608da691,1,0,1,1,0,0,0,3,11,0,1,1,0,176,1235,17,9,9,0,892,899,7,6,6,0,1,100,NoArch
0b21929a1be9f1be7dcf0149c60bdd16ce36563f,1,10,13,3,0,0,0,4,26,3,1,1,0,702,2033,35,100,100,0,2103,2107,4,40,40,0,1,100,NoArch
9dbee7418c9dc900c068e3c938d572c6defc9b2b,1,2,1,1,0,0,0,3,5,2,1,1,0,170,2034,36,19,20,1,693,699,6,7,7,0,1,100,NoArch
268c6a65ac8577319d23efbdddd870198303d491,1,1,1,0,0,0,0,10,87,0,1,1,0,710,2035,37,32,32,0,6176,6176,0,12,12,0,1,100,NoArch
18c02a003e84ad1fb1106395c562650e6bd6497c,1,1,1,0,0,0,0,6,43,96,1,1,0,700,2036,38,81,81,0,2399,2399,0,43,43,0,1,100,NoArch
100601ac7e7c57b342461331f34f3880888a7477,2,17,19,2,0,0,0,4,13,14,1,1,0.650022422,1938,1236,18,201,200,1,5639,5582,57,97,97,0,1,100,NoArch
a80b2c805f15fd9791ed0c5662420c9dd6a85392,7,88,15,73,1,0,1,1,44,324,1,5,2.188800507,3978,1237,19,526,525,1,16474,16243,231,144,143,1,1,99.94889267,NoArch
9dbff919135400f2ad6ed19cfdba7fd4d53a4b2f,1,3,1,2,0,0,0,2,2,3,1,1,0,48,2037,32,1,0,1,95,88,7,1,0,1,1,100,NoArch
934e81b0a44428c5922e5020443e02ae4c92ff13,1,8,9,1,0,0,0,4,25,11,1,1,0,754,1238,20,97,97,0,3694,3694,0,28,28,0,1,100,NoArch
a51120cb1ec47de5bceb5b962bb4d536bf215cc2,1,85,23,62,0,0,0,5,45,3,1,1,0,1403,1239,21,205,190,15,6867,6704,163,75,68,7,1,100,NoArch
e6470feaf5eafb9de9981cf3a0529a1adb8eea00,1,4,1,3,0,0,0,5,46,0,1,1,0,1465,1240,22,205,205,0,6870,6867,3,75,75,0,1,100,NoArch
f96b8fd58c01d981c922f3ce245ff9be2c7846f4,1,92,63,29,0,0,0,5,47,0,1,1,0,1468,1241,23,211,205,6,6991,6870,121,77,75,2,1,100,NoArch
977b520a0f3915f75c914bda562b138c322af9a6,1,22,12,10,0,0,0,7,54,56,1,1,0,621,2038,29,61,60,1,2110,2071,39,20,20,0,1,100,NoArch
e3aa43237dbf9244896739e90ccdf3d27559cfa3,1454,117383,125811,8428,375,502,877,2,69,255,10,179,9.561688082,215884,451,8,18983,22420,3437,701039,823834,122795,8657,10554,1897,1,63.70536484,Arch
3cd9d3bc7c2cc18b4f3b2b66765d0c4be51fcc43,2,51,39,12,0,0,0,6,70,401,1,2,0.996791632,2933,452,9,348,347,1,10185,10074,111,70,70,0,1,100,NoArch
c0d5c1cc2d117206048c40604ed44930f564da4a,1454,125751,117337,8414,502,375,877,3,142,423,10,179,9.561281905,207468,1242,23,20472,20897,425,754674,769101,14427,9659,9496,163,1,63.70536484,Arch
7ce6e883770d15aefad904a74ba9a7c6406f508a,1,2,1,1,0,0,0,7,55,3,1,1,0,631,2039,25,62,61,1,2124,2110,14,20,20,0,1,100,NoArch
eff94d81374acc7f4157f4d3841be4edf424b6e3,1454,117384,125797,8413,375,502,877,2,71,255,10,179,9.561717719,215883,453,9,18986,22421,3435,701178,823853,122675,8657,10554,1897,1,63.70536484,Arch
3b3d5115c618e8e6254da65f3cad89155b9f9b17,1454,125766,117342,8424,502,375,877,3,142,423,10,179,9.561499514,207470,1243,24,20474,20899,425,754720,769129,14409,9659,9496,163,1,63.70536484,Arch
e70e4c29f8969f4da49ec25446360fc70d9521a2,3,11,36,25,0,0,0,5,48,78,1,1,1.483012313,2019,1244,25,302,302,0,9183,9354,171,91,91,0,1,100,NoArch
4a53f98cfa55c4a07503beb3374137c22758f202,1,4,1,3,0,0,0,6,23,74,1,1,0,190,1245,26,15,15,0,435,424,11,14,14,0,1,100,NoArch
75dca7366465f92f87600c01769323eb89a854d2,1,37,34,3,0,0,0,5,49,5,1,1,0,1491,1246,27,213,211,2,6930,6920,10,78,77,1,1,100,NoArch
80d023412b8d9230e67461e621cddd5ea510ef20,1,1,0,1,0,0,0,3,9,94,1,1,0,234,1247,28,25,25,0,724,722,2,17,17,0,1,100,NoArch
ce9cc470c286f5dccb9db11cae7597d72dfee65d,1,1,0,1,0,0,0,2,8,94,1,1,0,296,1248,29,30,30,0,907,905,2,22,22,0,1,100,NoArch
e2b7e60850e9902b1b68f2920d5349d67e47a41f,1,1,1,0,0,0,0,5,50,0,1,1,0,1494,2040,24,213,213,0,6931,6930,1,78,78,0,1,100,NoArch
b511e092d60590ea5b6513053813eba37560da83,5,41,57,16,0,0,0,5,51,1,1,1,2.089017938,2494,1249,30,335,337,2,10045,10199,154,138,139,1,1,100,NoArch
10ebc87c6fbaab1582194c8493f8046e0940a6ed,2,0,3,3,0,0,0,6,25,2,1,1,0.918295834,491,2041,25,45,45,0,1298,1319,21,36,36,0,1,100,NoArch
b0bc2034937ac900411ed073dc6fd471c68cad7a,1,24,1,23,0,0,0,2,5,133,1,1,0,221,2042,13,16,11,5,1230,1100,130,5,5,0,1,100,NoArch
1e319b56055128ca68c1c4d76fae5be533a2738f,1,9,1,8,0,0,0,2,14,101,1,1,0,283,2043,12,18,17,1,1435,1416,19,4,4,0,3,100,NoArch
b1429879c73281c9970b1dbf201dc095882d7646,1,2,0,2,0,0,0,2,6,2,1,1,0,244,2044,13,16,16,0,1234,1230,4,5,5,0,1,100,NoArch
1d83cc8772d6bfdc54ca37215df47498ee6166bc,1,1,1,0,0,0,0,3,6,493,1,1,0,164,2045,13,13,13,0,566,565,1,8,8,0,1,100,NoArch
deffbfe457cec0b6b1c9da7dbd445e75543ec430,1454,117401,125811,8410,375,502,877,2,71,258,10,179,9.562351542,215891,454,3,18987,22428,3441,701201,823720,122519,8658,10554,1896,1,63.70536484,Arch
3b61eb63f16e84621e4d2d7b1e9e9c4d666ef5e7,1454,125775,117354,8421,502,375,877,3,142,423,10,179,9.561924787,207481,2046,14,20481,20901,420,754577,769175,14598,9660,9498,162,1,63.70536484,Arch
78c3732b2dbb72b07c137243ff55dd092e1469f0,1,4,2,2,0,0,0,7,75,126,1,1,0,575,2047,10,62,61,1,1780,1769,11,25,25,0,1,100,NoArch
7b1dcc6efd08c31754f731d15a4216a99ec07fd3,0,0,0,0,0,0,0,0,0,0,0,0,0,0,2048,11,0,0,0,0,0,0,0,0,0,1,100,NoArch
560b52637633d251846f3d191cfe20e47572370b,1,1,10,9,0,0,0,5,52,24,1,1,0,1476,1250,14,208,211,3,6777,6823,46,76,77,1,1,100,NoArch
6da026e17dab5b49c40b5d343213206078ce9af4,2,35,17,18,0,0,0,3,18,38,1,1,0.569961376,2326,1251,15,268,266,2,6577,6556,21,122,121,1,1,100,NoArch
a61b2b62528992c1ef851663d88bd7e09c116726,1,2,2,0,0,0,0,4,55,412,1,1,0,2047,1252,16,283,283,0,7589,7589,0,45,45,0,1,100,NoArch
962941fda45cb74c5a1270cbe02031df5871bf82,1,6,6,0,0,0,0,2,20,460,1,1,0,261,2049,12,28,28,0,1203,1215,12,5,5,0,1,100,NoArch
af67acd4959de048a8097e156bd47528d3e61ac5,1,9,0,9,0,0,0,4,20,506,1,1,0,378,2050,13,28,28,0,2620,2585,35,9,9,0,1,100,NoArch
d1a1fb233055a940a13f40cd6a4e624ad114aa0c,4,365,5,360,3,0,3,1,28,23,1,2,1.918493789,622,2051,14,105,80,25,3789,2393,1396,48,39,9,1,97.25749111,Arch
983d0f93525a2a5d82b72d7a016857639907c880,0,0,0,0,0,0,0,0,0,0,0,0,0,0,1253,15,0,0,0,0,0,0,0,0,0,1,100,NoArch
a745d885f22357408782e199d8256d94a0bfe94d,0,0,0,0,0,0,0,0,0,0,0,0,0,0,1254,16,0,0,0,0,0,0,0,0,0,1,100,NoArch
006903236ddda899735bf94d517d3c7ddc16ef33,0,0,0,0,0,0,0,0,0,0,0,0,0,0,1255,17,0,0,0,0,0,0,0,0,0,1,100,NoArch
a79400d6eccf93e6405305a6b450bfe3311d366e,1,34,2,32,0,0,0,3,15,17,1,1,0,291,1256,14,24,18,6,1627,1435,192,4,4,0,1,99.98317065,NoArch
79872387ba905fded0b8d135f30a093b74c6c348,1,21,18,3,0,0,0,1,2,1,1,1,0,110,2052,13,4,4,0,769,716,53,2,2,0,1,100,NoArch
a2195d9a2f51b15275bcccc05538c51a7f3c2cce,1,19,2,17,0,0,0,3,7,683,1,1,0,379,2053,14,30,29,1,2394,2190,204,12,11,1,1,99.98317065,NoArch
0cc2fee1ca1b13d40ffad1dc946ac7ee113b69f4,1,4,1,3,0,0,0,4,19,6,1,1,0,2170,2054,15,254,254,0,5995,5995,0,113,113,0,1,100,NoArch
8e1cd50e3441112d855751c169ef565ab693f0c1,1,54,35,19,0,0,0,2,3,300,1,1,0,114,2055,16,14,16,2,550,453,97,7,7,0,1,100,NoArch
a405bfb88f99ec891b3a081a29a41a6b79be0ee4,1457,117397,126253,8856,375,505,880,2,71,256,10,180,9.565585279,216356,455,4,18985,22461,3476,701294,825914,124620,8658,10567,1909,1,63.16872428,Arch
9221da42a70c0553bf2d7fb76d18c6671c89163b,1457,126206,117350,8856,505,375,880,3,142,413,10,180,9.565118018,207500,1257,14,20511,20899,388,756528,769268,12740,9670,9498,172,1,63.16872428,Arch
410d285ab93445932972ef20077b00cc4a8ac3f4,1,47,36,11,0,0,0,3,17,602,1,1,0,678,1258,15,88,87,1,2163,2137,26,30,30,0,1,100,NoArch
82da2037dff083cd4a5f53c5b6b44e338180c97c,1,1,1,0,0,0,0,2,2,1353,1,1,0,83,2056,16,2,2,0,395,395,0,2,2,0,1,100,NoArch
7ab5b8e03b0fabcb52975551fa1a416f4d592a5e,1457,117397,126264,8867,375,505,880,2,71,256,10,180,9.565536167,216367,456,3,18985,22462,3477,701294,825940,124646,8658,10567,1909,1,63.16872428,Arch
f0f98cbf542567b24591f008420d09edb08e22b2,1458,126232,117350,8882,505,375,880,3,142,413,10,180,9.565430039,207583,2057,17,20516,20901,385,757069,769663,12594,9672,9500,172,1,63.16872428,Arch
5e56b89ab0ed39b6e9ecd6fee5f59a1ceeeb5368,1457,117397,126264,8867,375,505,880,2,71,256,10,180,9.565536167,216367,457,4,18985,22462,3477,701294,825940,124646,8658,10567,1909,1,63.16872428,Arch
c99c4b2e7adf080c7f8ed0e4ba94c06ff7b1d7ea,1457,126217,117350,8867,505,375,880,3,142,413,10,180,9.565068883,207500,2058,18,20512,20899,387,756554,769268,12714,9670,9498,172,1,63.16872428,Arch
5a678405aae189f716ca34ba2b00171987f97856,1,1,1,0,0,0,0,3,19,0,1,1,0,689,2059,19,88,88,0,2163,2163,0,30,30,0,1,100,NoArch
ba743913003ee65e5e56cb3d1a12f336cddf514e,3,16,14,2,0,0,0,7,88,525,1,2,0.674679923,1995,2060,20,173,173,0,12177,12160,17,50,49,1,1,100,NoArch
afefcc5069c832f8383aa50913d34c5f323d8b4c,1,1,5,4,0,0,0,3,5,0,1,1,0,112,2061,21,7,7,0,158,167,9,7,7,0,1,100,NoArch
92fa51f4433f7b449afe7dd77159128198d3ec1e,2,51,48,3,0,0,0,7,56,22,1,1,0.907861915,1806,2062,22,196,196,0,7972,7946,26,52,51,1,1,100,NoArch
b153a6f785a6b5099d2d991e4863a74132cee662,1,5,3,2,0,0,0,9,80,205,1,1,0,335,2063,23,36,36,0,1145,1128,17,12,12,0,1,100,NoArch
47adf829452fc0d73e73081997410dea08f60572,1,8,5,3,0,0,0,8,73,65,1,1,0,1427,2064,24,169,168,1,5799,5792,7,48,48,0,1,100,NoArch
96f6e83092d00c570a9fe74cc283ae79721ef634,1,1,1,0,0,0,0,7,57,2,1,1,0,625,2065,25,60,60,0,2122,2122,0,21,21,0,1,100,NoArch
94ea92d281f10e90ec996988c25734df9920856f,1,1,1,0,0,0,0,6,26,36,1,1,0,192,2066,26,15,15,0,417,412,5,14,14,0,1,100,NoArch
77ea51ba98de4b3360a08ce4a494327aa1641f55,1,5,10,5,0,0,0,2,16,83,1,1,0,531,2067,27,65,65,0,1850,1880,30,28,27,1,1,100,NoArch
c117255a3b94f6dcabf48ecb240a9af658778a77,1,2,2,0,0,0,0,6,82,83,1,1,0,567,2068,28,79,79,0,2534,2532,2,23,23,0,1,100,NoArch
4c310d5a1efea0b8fa938fdf6a1eedbde72da1cf,1,3,3,0,0,0,0,7,58,84,1,1,0,390,2069,29,54,54,0,1664,1662,2,22,22,0,1,100,NoArch
1664db2a78f65f6926e38f5c1527f12ea39160b3,1,4,3,1,0,0,0,4,56,15,1,1,0,2047,1259,14,282,283,1,7579,7589,10,45,45,0,1,100,NoArch
06149b5f03c5027d9ba6ba2fc3ff95fc85def43a,0,0,0,0,0,0,0,0,0,0,0,0,0,0,2070,29,0,0,0,0,0,0,0,0,0,1,100,NoArch
79389e55925b1fd8b157a5387a4a817448e682c1,1,0,6,6,0,0,0,6,83,2,1,1,0,567,1260,10,78,79,1,2506,2534,28,23,23,0,1,100,NoArch
478b84fb55c258af81b2f6d3c15f9549d4035cec,1,20,17,3,0,0,0,4,57,2,1,1,0,2048,2071,30,283,282,1,7597,7579,18,45,45,0,1,100,NoArch
f70d5641db2abceca97c9b0b6158d7a3f3e30533,1,7,0,7,0,0,0,4,7,420,1,1,0,144,2072,30,11,10,1,370,353,17,7,7,0,1,100,NoArch
17fa2a16a0f1854812fde33cbfd0c9ec01aa5f46,1,0,1,1,0,0,0,4,7,420,1,1,0,145,2073,31,10,10,0,353,360,7,7,7,0,1,100,NoArch
70d4fa1882b30e76bc6498bdbb136435cc704821,1457,117414,126276,8862,375,505,880,2,71,260,10,180,9.565720902,216372,458,4,18986,22464,3478,701349,825977,124628,8658,10570,1912,1,63.16872428,Arch
cf128f72b313cee290bf6711d4462a7e785d01aa,1,0,1,1,0,0,0,2,2,6373,1,1,0,143,459,5,10,10,0,324,331,7,7,7,0,1,100,NoArch
1d9155376cc2805aae8331f939dd7784b17eee41,1457,126224,117363,8861,505,375,880,3,142,413,10,180,9.565278581,207509,1261,11,20513,20901,388,756577,769364,12787,9673,9498,175,1,63.16872428,Arch
168773309093937ede1fa67cca745d91cd18af20,1457,117413,126274,8861,375,505,880,2,71,264,10,180,9.565714778,216370,859,0,18986,22464,3478,701342,825973,124631,8658,10570,1912,0,63.16872428,Arch
dee3fe8d586227989768176a5ad52978afe7d592,1,0,1,1,0,0,0,2,3,17,1,1,0,132,860,1,14,14,0,541,543,2,7,7,0,0,100,NoArch
e3c8b09cdae84e8dd7d5e8f5504a0e8bece919ad,1457,126241,117363,8878,505,375,880,3,142,413,10,180,9.565252812,207508,1262,12,20516,20901,385,756603,769362,12759,9674,9498,176,1,63.16872428,Arch
e90416e1cfdbb45ed0730b6a11b393c7eb258240,0,0,0,0,0,0,0,0,0,0,0,0,0,0,1263,13,0,0,0,0,0,0,0,0,0,0,100,NoArch
40c14e4e1157684970a422046ebfc574b1454097,0,0,0,0,0,0,0,0,0,0,0,0,0,0,1264,14,0,0,0,0,0,0,0,0,0,0,100,NoArch
f6022b16484132b5be6b07b85c9a5579fd3dddb3,0,0,0,0,0,0,0,0,0,0,0,0,0,0,1265,15,0,0,0,0,0,0,0,0,0,0,100,NoArch
66334010c1c38fb8170c0f24fc715961091e64b2,0,0,0,0,0,0,0,0,0,0,0,0,0,0,1266,16,0,0,0,0,0,0,0,0,0,0,100,NoArch
6b15405201cbba9d933b9cf9b605b9e0bf171a10,0,0,0,0,0,0,0,0,0,0,0,0,0,0,1267,17,0,0,0,0,0,0,0,0,0,0,100,NoArch
9ce6b7a445f043289133efa1764abf4c87870fab,1457,117413,126291,8878,375,505,880,2,71,264,10,180,9.56568903,216386,861,2,18986,22467,3481,701340,825999,124659,8658,10571,1913,0,63.16872428,Arch
5043118001f79586d9ba80b110d699d0a46245cf,0,0,0,0,0,0,0,0,0,0,0,0,0,0,862,3,0,0,0,0,0,0,0,0,0,0,100,NoArch
dcdcd22794c29a71e5779358905615b9f2095cad,1457,126245,117363,8882,505,375,880,3,142,413,10,180,9.565220254,207508,2074,32,20518,20901,383,756619,769362,12743,9674,9498,176,1,63.16872428,Arch
b78e5dc68e78aec033196949d933512864846f5a,1,0,8,8,0,0,0,5,23,184,1,1,0,704,2075,33,91,93,2,3173,3207,34,19,19,0,1,100,NoArch
87b1ab2d56dd0c3e4474d16d62f0aca8b9bcec2c,1,9,1,8,0,0,0,10,93,527,1,1,0,1374,2076,34,238,237,1,4608,4555,53,40,40,0,2,100,NoArch
4fd0f2ce4164ebd54ab24c97be7e06aae235d239,1457,117414,126289,8875,375,505,880,2,71,264,10,180,9.565669681,216390,460,6,18987,22466,3479,701387,826000,124613,8658,10571,1913,1,63.16872428,Arch
11d89a38e3930cca76199a6e02e1e9ba0b5a82fe,1457,126248,117382,8866,505,375,880,3,142,413,10,180,9.565397537,207515,2077,35,20517,20902,385,756624,769409,12785,9674,9498,176,1,63.16872428,Arch
80fd5d965e5878625aba0e9eff45ffbb550c6bae,1457,117423,126290,8867,375,505,880,2,71,261,10,180,9.565734847,216381,461,7,18987,22466,3479,701387,825986,124599,8658,10571,1913,1,63.16872428,Arch
c8241b9cfdaf4e0b8feda2541d9fd96a63a908ff,1,6,1,5,0,0,0,3,3,381,1,1,0,150,462,8,15,14,1,436,420,16,8,8,0,1,100,NoArch
994bc3eb33182e6bc00648857133779fe34b05fe,0,0,0,0,0,0,0,0,0,0,0,0,0,0,863,4,0,0,0,0,0,0,0,0,0,0,100,NoArch
16d132819a8f3e946506c730b97d3aac851a093c,0,0,0,0,0,0,0,0,0,0,0,0,0,0,864,5,0,0,0,0,0,0,0,0,0,0,100,NoArch
6b92d24de5bb3e7179b5ec69a7575300701be954,0,0,0,0,0,0,0,0,0,0,0,0,0,0,865,6,0,0,0,0,0,0,0,0,0,0,100,NoArch
cb04dc395055c18432063dcaa24d3ba021280d53,0,0,0,0,0,0,0,0,0,0,0,0,0,0,866,7,0,0,0,0,0,0,0,0,0,0,100,NoArch
8e2b5a8e006e61c01eb3587947cf317140870de3,0,0,0,0,0,0,0,0,0,0,0,0,0,0,867,8,0,0,0,0,0,0,0,0,0,0,100,NoArch
debc40c2decdd538450826afc5ac878efc2d5c10,0,0,0,0,0,0,0,0,0,0,0,0,0,0,868,9,0,0,0,0,0,0,0,0,0,0,100,NoArch
d42d1a1c5f5d4f097781a508863d5e730171b416,1457,126269,117378,8891,505,375,880,3,142,413,10,180,9.565084745,207519,2078,33,20520,20903,383,756777,769425,12648,9674,9498,176,1,63.16872428,Arch
1853aaf6ec1200e8cd46a9c6b28503b1a57ba894,1457,117428,126319,8891,375,505,880,2,71,257,10,180,9.56552106,216410,869,10,18988,22469,3481,701403,826139,124736,8658,10571,1913,0,63.16872428,Arch
d9139ca181542841f0eef8ed24268d51fe898b9a,1457,126273,117378,8895,505,375,880,3,142,413,10,180,9.565039476,207519,1268,18,20521,20903,382,756791,769425,12634,9674,9498,176,1,63.16872428,Arch
787f4d7b063375364acd2f315c33d23086b4b0eb,0,0,0,0,0,0,0,0,0,0,0,0,0,0,2079,32,0,0,0,0,0,0,0,0,0,1,100,NoArch
8b5425efd90d681f7fcaaca0b3a71da2eb238f1b,1457,117428,126323,8895,375,505,880,2,71,257,10,180,9.565475812,216414,870,11,18988,22470,3482,701403,826153,124750,8658,10571,1913,1,63.16872428,Arch
e09d1a4f5858bfcedbdedfbe33b7fe09d63a94af,0,0,0,0,0,0,0,0,0,0,0,0,0,0,871,12,0,0,0,0,0,0,0,0,0,1,100,NoArch
0afbe9ca73fb801dae305cad7f5dedf083f9a562,0,0,0,0,0,0,0,0,0,0,0,0,0,0,872,13,0,0,0,0,0,0,0,0,0,1,100,NoArch
11adf15e5fc9a259b5f9a09a766f928090a0c031,0,0,0,0,0,0,0,0,0,0,0,0,0,0,873,14,0,0,0,0,0,0,0,0,0,1,100,NoArch
a11d5116b21d81552da196107d8cf53936a95483,1457,126279,117378,8901,505,375,880,3,142,413,10,180,9.565012674,207519,2080,28,20521,20903,382,756823,769425,12602,9674,9498,176,1,63.16872428,Arch
28f170f530f3d45d52067bcce03c44d96b9421e3,2,21,79,58,0,0,0,4,20,112,1,1,0.997401589,591,1269,12,54,66,12,1194,1404,210,38,38,0,1,100,NoArch
a470322a1ee250f2dc98d559f68855829ac40704,1,1,1,0,0,0,0,4,7,2,1,1,0,124,1270,11,13,13,0,260,260,0,9,9,0,1,100,NoArch
0f14312111a302d8da0914d02e52026e6a2315b3,1,1,1,0,0,0,0,3,13,382,1,1,0,2154,2081,24,240,241,1,6160,6172,12,107,107,0,1,100,NoArch
3518c74eb5e31e93f2bab284588a0563ef60e2ae,1,1,1,0,0,0,0,10,94,23,1,1,0,1382,2082,22,238,238,0,4608,4608,0,40,40,0,1,100,NoArch
5eb6d1792095208291bd1050169c5eb1010bc412,1457,117431,126274,8843,375,505,880,2,71,257,10,180,9.565469339,216362,463,5,18988,22457,3469,701403,825963,124560,8658,10571,1913,1,63.16872428,Arch
65a22ac30968dbc0efdda8d0f6075add58c8d64f,1457,126226,117381,8845,505,375,880,3,142,413,10,180,9.565025454,207519,1271,12,20508,20903,395,756603,769425,12822,9674,9498,176,1,63.16872428,Arch
a82fa3bbbf4fed556c0238ed3f6b540e3ccf9fea,1,6,3,3,0,0,0,6,24,285,1,1,0,155,1272,13,16,16,0,698,690,8,3,3,0,1,100,NoArch
311775ab9608e29d9d459b5c8fa88888a8b40a33,1457,117431,126276,8845,375,505,880,2,71,257,10,180,9.565481414,216367,874,15,18988,22457,3469,701411,825973,124562,8658,10571,1913,1,63.16872428,Arch
346b204d082d4dcac334fb10fc5b8a075c2f076a,1457,126228,117383,8845,505,375,880,3,142,413,10,180,9.565049408,207522,1273,14,20508,20903,395,756615,769433,12818,9674,9498,176,1,63.16872428,Arch
6ffba04825e4e8238e77ac85fe153a507326e599,1457,117431,126276,8845,375,505,880,2,71,257,10,180,9.565481414,216367,875,16,18988,22457,3469,701415,825977,124562,8658,10571,1913,1,63.16872428,Arch
02d64236ffbd11d5ad14c956e0f15acc2ff37748,1457,126228,117383,8845,505,375,880,3,142,413,10,180,9.565041098,207522,2083,23,20508,20903,395,756615,769437,12822,9674,9498,176,1,63.16872428,Arch
272e9edcca350ca68c86447bd2d3413ed911a20d,1,1,1,0,0,0,0,3,16,48,1,1,0,323,2084,19,24,24,0,1627,1627,0,4,4,0,1,100,NoArch
2d32b99758b798174a2fe0674d174c142e25b2b3,3,4,9,5,0,0,0,2,26,303,1,1,1.57662122,919,2085,14,115,115,0,4072,4101,29,46,46,0,1,100,NoArch
10cec0c0960ef1a5e985bb8a8237606940a9d315,1,2,2,0,0,0,0,4,115,107,1,1,0,1162,2086,15,136,136,0,5450,5450,0,46,46,0,1,100,NoArch
100bd3b803bf474276b1e2e009ed1774865d3711,1,3,2,1,0,0,0,4,58,41,1,1,0,2051,1274,13,284,283,1,7608,7597,11,45,45,0,1,100,NoArch
961162c13ba76a8634c1e9bd6fd86133481e05a3,2,36,9,27,0,0,0,3,16,275,1,1,0.721928095,317,1275,14,40,31,9,865,718,147,14,13,1,1,100,NoArch
4326c297a71490777129e1add978476aec8e36dc,1,2,2,0,0,0,0,5,17,0,1,1,0,226,1276,15,30,30,0,600,601,1,13,13,0,1,100,NoArch
6afba40fcb80c4d5a8865fbbf844e5e112a72549,1457,117435,126268,8833,375,505,880,2,71,255,10,180,9.565354457,216390,876,17,18998,22467,3469,701580,826105,124525,8659,10572,1913,1,63.16872428,Arch
5eb21f82a46e2193c03e2af14cc1b075dc69fde3,1457,126200,117386,8814,505,375,880,3,142,413,10,180,9.565019025,207557,1277,9,20515,20913,398,756721,769602,12881,9673,9499,174,1,63.16872428,Arch
1bede75c0a5c98a0eea36b2d20d40fcd06000d0a,1457,117440,126249,8809,375,505,880,2,71,255,10,180,9.565438617,216371,464,4,18999,22461,3462,701602,826061,124459,8659,10568,1909,1,63.16872428,Arch
d744550158c69435fcf3e3d186dfb2bbe7afbfb3,1457,126205,117391,8814,505,375,880,3,142,413,10,180,9.564989516,207562,2087,13,20515,20914,399,756721,769624,12903,9673,9499,174,1,63.16872428,Arch
1edfdfbf9a1e3200c825093da6fca93c8327fa96,1,78,12,66,0,0,0,3,14,18,1,1,0,2154,2088,11,246,240,6,6278,6160,118,111,107,4,1,100,NoArch
c792a4829fea47022fee6ec696339b0635051f44,1,3,0,3,0,0,0,8,22,400,1,1,0,574,2089,12,59,59,0,1766,1764,2,30,30,0,1,100,NoArch
742ba637d6cd3c51365ac4a6c21f1e3f344b0f4a,7,23,18,5,0,0,0,4,21,612,1,4,2.683465255,1274,2090,13,59,59,0,7520,7397,123,27,27,0,1,100,NoArch
67b6424d7fa90e550f1810c744647b6ea9228f19,1,2,1,1,0,0,0,4,15,526,1,1,0,186,2091,14,13,13,0,1166,1151,15,2,2,0,1,100,NoArch
efc26f27700dc3ee760d820a33337fb63617fcaa,1,22,22,0,0,0,0,4,7,123,1,1,0,297,2092,15,32,32,0,801,801,0,20,20,0,1,100,NoArch
bffdd33e675d5a078bd98d4c6b33e0ec3df920f2,1,5,3,2,0,0,0,3,11,366,1,1,0,165,2093,15,16,16,0,636,634,2,8,8,0,1,100,NoArch
d409de7886e0441e549e41aefbffe45979bf2b50,1,1,1,0,0,0,0,3,15,0,1,1,0,2220,2094,16,246,246,0,6278,6278,0,111,111,0,1,100,NoArch
6ebeb5e6e204cfb2b558d2aa77dd2860bdb3f915,1,2,2,0,0,0,0,5,19,0,1,1,0,155,2095,17,11,11,0,902,902,0,5,5,0,1,100,NoArch
5647294f5c769cb783292b2b47f65a063a0c3423,1,1,1,0,0,0,0,5,24,42,1,1,0,696,2096,18,91,91,0,3173,3173,0,19,19,0,1,100,NoArch
1a042fe2a47cc4a3e04b4260653fc2b3474d337c,1,4,1,3,0,0,0,3,12,0,1,1,0,167,2097,19,16,16,0,636,636,0,8,8,0,1,100,NoArch
2656a29f813e367f4ce4aefdb4be0d470e94e375,1,27,25,2,0,0,0,3,30,22,1,1,0,687,2098,20,88,88,0,2690,2690,0,40,40,0,1,100,NoArch
735e49cb6fb88675d9175d6f5b52d82a8f8f6467,1,1,1,0,0,0,0,3,6,526,1,1,0,271,2099,21,21,21,0,1332,1332,0,7,7,0,1,100,NoArch
01bc5d367fa896cb4d66b4850657bbeb670bfe64,1,4,4,0,0,0,0,5,9,526,1,1,0,101,2100,22,5,5,0,217,217,0,5,5,0,1,100,NoArch
391b8f367de9a77e85dc8f4db2ac1e0545c9d650,1,8,8,0,0,0,0,3,5,1080,1,1,0,137,2101,23,10,10,0,291,291,0,9,9,0,1,100,NoArch
d5f746a60e36f754429963cbc3b9d532babe4033,1,2,2,0,0,0,0,5,13,810,1,1,0,368,2102,24,34,34,0,956,956,0,17,17,0,1,100,NoArch
630e4ce76ce0f6cd718576ed1ca62d7e6b04e170,3,3,3,0,0,0,0,2,21,321,1,1,1.584962501,975,2103,25,105,105,0,3818,3818,0,25,25,0,1,100,NoArch
1e7f0dd89cdc0b768d388388ac11ccc656831ab8,1,1,1,0,0,0,0,5,28,147,1,1,0,382,2104,26,30,30,0,2117,2117,0,30,30,0,1,100,NoArch
398ae7b473b309da9353e057588910abb3bbe769,1,3,1,2,0,0,0,5,34,223,1,1,0,616,2105,27,66,66,0,1820,1820,0,33,33,0,1,100,NoArch
fb577a119c951a0e89926511f73156b07e3e3754,1,1,1,0,0,0,0,4,47,486,1,1,0,642,2106,28,58,58,0,2818,2818,0,15,15,0,1,100,NoArch
fa6a6c71317346ca90f9de43ad2de74438be8bae,1,14,14,0,0,0,0,4,17,366,1,1,0,262,2107,29,24,24,0,752,752,0,17,17,0,1,100,NoArch
8f1a4750053104cfb0e48e155e0184c38f746d62,1,1,1,0,0,0,0,3,11,303,1,1,0,351,2108,30,33,33,0,1510,1510,0,12,12,0,1,100,NoArch
83f227f4b815f59365123957b8c1462c2dc1a724,1,1,1,0,0,0,0,4,8,150,1,1,0,117,2109,31,13,13,0,467,467,0,13,13,0,1,100,NoArch
d88c1449fa01a535612969ec8f7c151f43769cd9,1,9,9,0,0,0,0,4,21,738,1,1,0,417,2110,32,46,46,0,1566,1566,0,20,20,0,1,100,NoArch
7338dd2440b462116a8c1e25ee7df326304a444a,1,1,1,0,0,0,0,3,14,117,1,1,0,422,2111,33,45,45,0,2075,2075,0,12,12,0,1,100,NoArch
0dce6abf0fceb97171f8784b74baf2b7de3ea9f0,1,1,1,0,0,0,0,6,84,51,1,1,0,561,2112,34,78,78,0,2506,2506,0,23,23,0,1,100,NoArch
d9d3d050af37357d7bfac8a15af8f42d9a49047c,1,16,2,14,0,0,0,2,6,225,1,1,0,97,2113,35,6,5,1,476,351,125,5,5,0,1,99.98317065,NoArch
b945d0a643fda856376a3109ee25697c2ead19c8,0,0,0,0,0,0,0,0,0,0,0,0,0,0,2114,36,0,0,0,0,0,0,0,0,0,1,100,NoArch
64f31944e1764a63ecc5e81da6d9a1af491e311e,1,2,2,0,0,0,0,4,31,304,1,1,0,348,2115,37,45,45,0,1303,1303,0,21,21,0,1,100,NoArch
c2f551b93255d5a5ebb42f9634bcb49b7c47e4ad,1,1,1,0,0,0,0,4,5,1196,1,1,0,47,2116,38,2,2,0,73,73,0,2,2,0,1,100,NoArch
4123edde1a8ee85d971e5cf63cccc06f8f19cd12,1,1,1,0,0,0,0,4,9,994,1,1,0,183,2117,39,19,19,0,775,775,0,8,8,0,1,100,NoArch
5b45523801dc04c841135b84c278c0485465ae8a,1,1,1,0,0,0,0,4,7,1103,1,1,0,182,2118,40,22,22,0,774,774,0,8,8,0,1,100,NoArch
7f655333f2f59b6f8a2369d57223a66a39899274,1,1,1,0,0,0,0,4,21,402,1,1,0,189,2119,41,9,9,0,960,960,0,5,5,0,1,100,NoArch
49a02f4e7c6c51b405cb8809ab512bd4f9f8ed8e,4,4,4,0,0,0,0,4,18,822,1,1,2,424,2120,42,45,45,0,2042,2042,0,15,15,0,1,100,NoArch
35a95424c6641a3b0da368d7c426ed5a2a559188,5,12,7,5,0,0,0,4,17,828,1,1,2.21260991,710,2121,43,38,38,0,3208,3129,79,18,18,0,1,100,NoArch
38b163026ccbeed781b09223dae4b61160438109,1,1,1,0,0,0,0,3,16,2,1,1,0,2220,2122,44,246,246,0,6278,6278,0,111,111,0,1,100,NoArch
16f9c2d76386e0f43c63f45e2af514d95dc91b3e,1,2,2,0,0,0,0,3,13,2,1,1,0,170,2123,45,16,16,0,636,636,0,8,8,0,1,100,NoArch
f56956cbb787c0911c610c8641a4e2821b5e115d,1,3,2,1,0,0,0,8,23,2,1,1,0,577,2124,46,59,59,0,1766,1766,0,30,30,0,1,100,NoArch
2bb30c2e78c4ef138e81c203670326fc83e9e1a8,1,2,2,0,0,0,0,3,12,117,1,1,0,175,2125,47,9,9,0,892,892,0,6,6,0,1,100,NoArch
d6df7b15c905f9a7db2c9de2585e39cb770eff72,1,3,2,1,0,0,0,5,35,2,1,1,0,618,2126,48,66,66,0,1837,1820,17,33,33,0,1,100,NoArch
de6a1a2b6c53a90231d437c9719d1fa816a90e0b,1,2,1,1,0,0,0,3,7,2,1,1,0,271,2127,49,21,21,0,1347,1332,15,7,7,0,1,100,NoArch
e7aac85ef1605099aa2ea6cfd69ea722900216e4,1,4,0,4,0,0,0,4,9,958,1,1,0,308,2128,50,57,56,1,1676,1655,21,9,9,0,1,100,NoArch
afb888cdae97f8ab9489bad65050d4c221e4b035,1457,117487,126407,8920,375,505,880,2,71,255,10,180,9.565578759,216486,465,2,19000,22445,3445,701623,825917,124294,8659,10555,1896,1,63.16872428,Arch
34f41732489688f968f8a439f11e6917e31d23a5,1457,126358,117438,8920,505,375,880,3,142,413,10,180,9.565149954,207566,2129,50,20523,20898,375,757230,768926,11696,9677,9487,190,1,63.16872428,Arch
5cc8a159cffb9afb67632fb970445446e608ae45,1,2,1,1,0,0,0,3,51,123,1,1,0,1012,2130,51,88,88,0,3395,3395,0,50,50,0,1,100,NoArch
5d50a746e3cf7940ff3a643802b4f2f5cc076710,0,0,0,0,0,0,0,0,0,0,0,0,0,0,2131,51,0,0,0,0,0,0,0,0,0,1,100,NoArch
30b2b2eac5995d5b4a4d77f1496efeefa900915d,1,44,6,38,0,0,0,4,59,23,1,1,0,2052,1278,9,293,284,9,7801,7608,193,45,45,0,1,100,NoArch
b832170bc7cdb300fb0bf43e815d248b93c1e611,1,10,3,7,0,0,0,4,60,0,1,1,0,2090,1279,10,294,293,1,7813,7801,12,45,45,0,1,100,NoArch
34bd601c47019100c3e6fd19b22d80e742d9fcde,1,1,0,1,0,0,0,10,89,78,1,1,0,711,2132,51,32,32,0,6200,6188,12,12,12,0,1,100,NoArch
f22e8088f0531640b2d62d63f53def0dc4758688,2,109,2,107,0,0,0,4,26,940,1,1,0.854466918,1179,2133,52,132,119,13,2846,2611,235,99,93,6,1,100,NoArch
4838b655329f67610b7ef36b8531bb05af1f7f04,1,48,0,48,0,0,0,4,116,30,1,1,0,1162,2134,53,142,136,6,5878,5450,428,47,46,1,1,100,NoArch
621c2b146c0139c90bfeb325a682c29798eab208,1,42,7,35,0,0,0,4,117,0,1,1,0,1210,2135,54,145,142,3,6079,5878,201,47,47,0,1,100,NoArch
99dc8e35a7bd0da74a14a52ff3cf0100444805f3,1,17,19,2,0,0,0,4,118,0,1,1,0,1245,2136,55,145,145,0,6036,6079,43,47,47,0,1,100,NoArch
c7c6612daf3b3117b9bbbeabd64bc6d3020e1396,8,63,5,58,0,0,0,5,85,172,1,1,2.841498206,4033,2137,54,579,568,11,16235,16076,159,194,188,6,1,100,NoArch
08e26f0030b1263931b8b4d167c1418a8258142c,1,19,9,10,0,0,0,4,119,2,1,1,0,1243,2138,55,146,145,1,6039,6036,3,47,47,0,1,100,NoArch
e57ff96b47ebfa7da384654ea26909ffbe33cbbc,1,5,0,5,0,0,0,3,12,144,1,1,0,671,1280,6,100,99,1,2695,2685,10,24,24,0,1,100,NoArch
f1403e3f74f834478eed2e1c4dafb014a0ee2b86,1457,117483,126706,9223,375,505,880,2,71,255,10,180,9.563755356,216794,877,1,19001,22503,3502,701633,827350,125717,8659,10574,1915,1,63.16872428,Arch
4600a7ba998819dd25579456a11887f80bc1a0f6,1457,126666,117443,9223,505,375,880,3,142,413,10,180,9.56321276,207571,357,0,20568,20899,331,758441,768936,10495,9690,9487,203,1,63.16872428,Arch
7237cbab2d1a5ebbcbf7192449d7ac7e72abdd15,0,0,0,0,0,0,0,0,0,0,0,0,0,0,2139,54,0,0,0,0,0,0,0,0,0,1,100,NoArch
4a51a3e85242154b321a5e9ddd30a912cf49846c,0,0,0,0,0,0,0,0,0,0,0,0,0,0,2140,55,0,0,0,0,0,0,0,0,0,1,100,NoArch
571acb5f1c954eb857f07b6bb3de4beb866231ca,1,2,2,0,0,0,0,4,36,11,1,1,0,466,1281,4,62,61,1,1872,1869,3,17,17,0,1,100,NoArch
b0626b12c5c19ba725db2ee024e1074323082d36,1,19,2,17,0,0,0,7,58,102,1,1,0,625,2141,11,62,60,2,2220,2122,98,21,21,0,1,100,NoArch
2787c7d453fe144d4c3762aaeb335a32f96b6a9d,1457,117483,126708,9225,375,505,880,2,71,255,10,180,9.563745453,216811,466,0,19003,22506,3503,701720,827452,125732,8659,10574,1915,1,63.16872428,Arch
45a6a7f3907b066c313eb25072a29301a16cc09a,1,6,1,5,0,0,0,5,29,307,1,1,0,729,467,1,59,58,1,2302,2291,11,34,33,1,1,100,NoArch
b8370ccebfcab9afa5c98116686620aa0a7f623d,1,12,4,8,0,0,0,4,8,1976,1,1,0,279,468,2,26,25,1,569,560,9,24,23,1,1,100,NoArch
e6b511a45c0df8c4fb0386001fa08ca172d599e5,1,9,0,9,0,0,0,4,8,562,1,1,0,394,469,3,54,53,1,1587,1566,21,11,10,1,1,100,NoArch
3f332bdf532fa1fcb75733264ee91df590f5436a,0,0,0,0,0,0,0,0,0,0,0,0,0,0,470,4,0,0,0,0,0,0,0,0,0,1,100,NoArch
1ee83e78a813ad4a8a0c5dd2144b34ec001960b4,1,17,19,2,0,0,0,3,7,708,1,1,0,209,471,5,22,22,0,1022,1035,13,5,5,0,1,100,NoArch
a23ee04b849c65ec845bcec853f312dfd474a20e,1,1,6,5,0,0,0,5,30,3,1,1,0,734,472,6,58,59,1,2291,2302,11,33,34,1,1,100,NoArch
82241a89ae4558cd7849ba42b50b03ccf8253525,1,0,8,8,0,0,0,4,9,3,1,1,0,287,473,7,25,26,1,554,569,15,23,24,1,1,100,NoArch
7d1006b1bbcd650566ea5075b72cd5ed28fb886f,1,0,9,9,0,0,0,4,9,3,1,1,0,403,474,8,53,54,1,1566,1587,21,10,11,1,1,100,NoArch
02a5c49b05eebcba77bf9dadd9d811137f138c64,2,10,5,5,0,0,0,3,10,1477,1,2,0.918295834,583,475,9,73,72,1,2180,2161,19,25,24,1,1,100,NoArch
84bd84319f3fe05c517c41f4c7d4e21ff4097ed6,2,27,14,13,0,0,0,3,5,2114,1,2,0.901170196,1192,476,10,148,146,2,6034,5952,82,43,42,1,1,100,NoArch
665abf517f6ca79c16109cb8563eb75e4f1a1216,1457,126739,117461,9278,505,375,880,3,142,413,10,180,9.563947065,207602,2142,10,20576,20904,328,758710,769109,10399,9692,9489,203,1,63.16872428,Arch
68a0d3a1c32c5b85f787f4b9713df8e1237ae533,1457,117495,126706,9211,375,505,880,2,71,260,10,180,9.563789093,216880,477,11,19011,22511,3500,701956,827620,125664,8663,10576,1913,1,63.16872428,Arch
64ca72c255e8a6ec24768698f8b0bd91558ea15e,1458,126733,117522,9211,506,376,882,3,142,413,10,180,9.564723174,207669,358,1,20576,20909,333,758710,769263,10553,9692,9491,201,1,63.39590444,Arch
a7bf1537fb21008d20bf59f4aee8fb7e11c88363,1,2,2,0,0,0,0,1,3,362,1,1,0,130,359,2,12,12,0,457,457,0,4,4,0,1,98.29145729,NoArch
1d58b61260d7768f18fefd1dfa13d2b13736a88f,1458,117554,126768,9214,376,506,882,2,71,264,10,180,9.565243147,216880,478,12,19011,22511,3500,701964,827620,125656,8663,10576,1913,1,63.13443073,Arch
977d1962e8419aa48264d55b35d01a77f295cd07,1458,126729,117514,9215,506,376,882,3,142,413,10,180,9.564704828,207666,2143,4,20576,20909,333,758717,769271,10554,9692,9491,201,1,63.13443073,Arch
4e40144a1d0d7ff04aebccc16dd11b39ad4d4b3e,1,1,1,0,0,0,0,3,52,59,1,1,0,1013,2144,5,90,88,2,3403,3395,8,50,50,0,1,100,NoArch
0aa4d002ff6caa682498e8428100b77eef27f075,1,2,2,0,0,0,0,3,17,65,1,1,0,2220,2145,6,246,246,0,6278,6278,0,111,111,0,1,100,NoArch
57a117fc7e2f3ac5e14623e092cd30fed77c83b0,1,6,1,5,0,0,0,8,143,189,1,1,0,1357,2146,7,133,133,0,4118,4118,0,64,64,0,1,100,NoArch
ad53c40865091b69b7a3ea5d02ca070d15e974e6,1458,117554,126773,9219,376,506,882,2,71,263,10,180,9.565218771,216886,479,13,19011,22513,3502,701971,827635,125664,8663,10576,1913,1,63.13443073,Arch
cf2deaba1e3203f50e7e95f2f5ddd14ca8885825,1458,126734,117514,9220,506,376,882,3,143,413,10,180,9.564674138,207667,2147,8,20578,20909,331,758732,769285,10553,9692,9491,201,1,63.13443073,Arch
691e607e8721aa0f0723338d7776955c80d809f3,1,7,3,4,0,0,0,3,18,0,1,1,0,2220,2148,9,246,246,0,6278,6278,0,111,111,0,1,100,NoArch
10462b0f363c5099ec294bc61ddb0c873209993e,1,1,0,1,0,0,0,7,76,143,1,1,0,577,1282,1,62,62,0,1793,1780,13,25,25,0,1,100,NoArch
6ed60c3351498a28a398880eb2cecb8de692bf6b,1458,117554,126774,9220,376,506,882,2,71,263,10,180,9.565222246,216892,480,14,19011,22513,3502,701971,827662,125691,8663,10576,1913,1,63.13443073,Arch
08701ae0c2bdf6373010bf9e42c8167e0a5a1486,1458,126734,117514,9220,506,376,882,3,143,413,10,180,9.564677441,207672,2149,8,20578,20909,331,758751,769285,10534,9692,9491,201,1,63.13443073,Arch
d265aa0463767ddab86cd8df7cb3b5ec56343d07,1,8,2,6,0,0,0,7,48,0,1,1,0,1184,2150,9,136,136,0,5870,5856,14,31,31,0,1,100,NoArch
b7b5f6f34efcb1f300890f6d787b4eb61327e216,1458,117572,126780,9208,376,506,882,2,71,263,10,180,9.565153186,216898,481,15,19013,22513,3500,701999,827682,125683,8664,10576,1912,1,63.13443073,Arch
e56741fa9b54982b23597aec73752ae17a33467a,1458,126740,117532,9208,506,376,882,3,143,413,10,180,9.564608397,207690,2151,10,20578,20911,333,758771,769313,10542,9692,9492,200,1,63.13443073,Arch
81ee60fecff407d37a74377108f9bfad244dac94,1,34,38,4,0,0,0,3,19,6,1,1,0,2224,2152,11,246,246,0,6280,6278,2,113,111,2,1,100,NoArch
19a20c0f9b3411af1e7b933ba3e47af558576b23,1,70,2,68,0,0,0,3,20,5,1,1,0,2220,2153,12,254,246,8,6388,6280,108,117,113,4,1,100,NoArch
2eb140facf67aa7a5b7bd8964128c9f7c712eaf1,1458,117572,126844,9272,376,506,882,2,71,263,10,180,9.564418474,216962,482,16,19013,22521,3508,701999,827798,125799,8664,10582,1918,1,63.13443073,Arch
8753790162497d4f88bdecda5c949ad87acf9a45,1458,126809,117547,9262,506,376,882,3,143,413,10,180,9.563956778,207690,2154,13,20586,20911,325,758881,769313,10432,9698,9492,206,1,63.13443073,Arch
6da447d3863ca51aff5b9b98b52bde6f53b7a5eb,1,10,6,4,0,0,0,6,13,2,1,1,0,354,2155,13,30,29,1,771,760,11,24,24,0,1,100,NoArch
97aea1429f6747103b33b700c3ce3ce0abfecb3f,1,8,3,5,0,0,0,4,13,201,1,1,0,271,1283,1,31,30,1,1040,1013,27,8,8,0,1,100,NoArch
209a0a4c4a270188d86d6f5a8342db5a9c6f38c0,1,6,1,5,0,0,0,4,27,102,1,1,0,752,2156,14,98,97,1,3710,3683,27,28,28,0,1,100,NoArch
41a207d8f6534f79c6eb68f3c4fd2c6682587637,1,4,0,4,0,0,0,4,14,2,1,1,0,276,2157,15,32,31,1,1056,1040,16,8,8,0,1,100,NoArch
388a8e0c2326423d45d5f75ad6fc8ee8bb2fe3fd,1458,117613,126883,9270,376,506,882,2,71,256,10,180,9.564816807,216970,483,6,19007,22525,3518,702027,827879,125852,8665,10582,1917,1,63.10729614,Arch
fa0125cc411a3c67756f591b75e28611270fe2e7,1458,126857,117571,9286,506,376,882,3,143,413,10,180,9.564257216,207700,1284,2,20592,20905,313,759013,769341,10328,9698,9493,205,1,63.10729614,Arch
aae2dad6db9bbba314ee6235a9c30e3274051776,3,3,3,0,0,0,0,5,57,367,1,3,1.584962501,1157,360,2,132,132,0,3342,3342,0,49,49,0,1,100,NoArch
ab179360e6cbd2cd766fb9e8b9d2eea13e47c05c,1,7,2,5,0,0,0,5,19,441,1,1,0,903,2158,15,130,129,1,4763,4720,43,28,28,0,1,100,NoArch
ba054e681271a6335bbc7d669d48fac82e1667f2,1458,117616,126902,9286,376,506,882,2,71,256,10,180,9.564701855,216991,484,6,19008,22528,3520,702070,827973,125903,8665,10582,1917,1,63.10729614,Arch
ad15c1156a4c3451185353dbc5a45f3cca17d921,1458,126870,117582,9288,506,376,882,3,143,413,10,180,9.564224561,207705,2159,16,20593,20906,313,759058,769384,10326,9698,9493,205,1,63.10729614,Arch
bc938e2fa053f93aa06b585731c079fb0fd68bf3,1458,117620,126891,9271,376,506,882,2,71,254,10,180,9.564575416,216993,485,7,19011,22528,3517,702115,827975,125860,8665,10582,1917,1,63.10729614,Arch
0f650587c6c53cda7806fd36860c116456510d7d,1458,126851,117580,9271,506,376,882,3,143,413,10,180,9.564031894,207722,361,2,20593,20909,316,759058,769429,10371,9698,9493,205,1,63.10729614,Arch
bbded717822e226e8b76189ebaa542686f3e5d36,1458,117620,126891,9271,376,506,882,2,71,255,10,180,9.564575416,216993,486,7,19011,22528,3517,702117,827975,125858,8665,10582,1917,1,63.10729614,Arch
e369daddc7f1cab0e5adcfedebe025b1b46653ee,1,55,1,54,0,0,0,2,2,5813,1,1,0,85,487,8,4,3,1,444,265,179,4,3,1,1,99.94743298,NoArch
1231fae4f014a7618488f1c3bfba5c0b1c6d6797,1458,126925,117634,9291,506,376,882,3,143,414,10,180,9.565359189,207776,2160,15,20594,20910,316,759337,769610,10273,9699,9494,205,1,63.07665924,Arch
6559582fa2b29a8b56a7fbaa01b98e89941dbcc7,1,5,0,5,0,0,0,3,6,714,1,1,0,168,2161,12,14,13,1,304,289,15,7,7,0,1,100,NoArch
5892e9a8b818b7d82bee5e78150c4132ecf03fd2,1458,117674,126965,9291,376,506,882,2,71,260,10,180,9.565902239,217072,488,8,19013,22530,3517,702311,828269,125958,8666,10583,1917,1,63.07665924,Arch
daccae43a86b6d7a63819d86757eed775c6f4f9a,1458,126931,117641,9290,506,376,882,3,143,414,10,180,9.565429094,207781,2162,13,20595,20911,316,759352,769625,10273,9699,9494,205,1,63.07665924,Arch
f0d69caf56906ad1b16beb367267c1b478df6fb6,1,6,1,5,0,0,0,3,15,528,1,1,0,223,2163,14,23,22,1,652,634,18,17,17,0,1,100,NoArch
d710e2174ad773ebef474e1438d99fbfbd571843,1458,117690,126975,9285,376,506,882,2,71,261,10,180,9.566084965,217076,489,9,19014,22531,3517,702357,828287,125930,8666,10583,1917,1,63.07665924,Arch
ef436f3cfc79935e178cebf9a51d1ef8bce01397,1458,126966,117649,9317,506,376,882,3,143,413,10,180,9.565904779,207791,2164,13,20601,20912,311,759450,769671,10221,9700,9494,206,1,63.07665924,Arch
45191cebef1a6bf323e872a2237aa1c468b352fb,1,9,3,6,0,0,0,3,5,5,1,1,0,188,2165,14,6,6,0,772,768,4,6,6,0,1,100,NoArch
294fbc2ec3234b1a70d865f94fe0c629a691e82d,1,1,1,0,0,0,0,3,5,0,1,1,0,136,2166,15,14,14,0,356,356,0,11,11,0,1,100,NoArch
d7901a86eb584d9df49ac61161abb731fa96b9ec,1458,117684,126977,9293,376,506,882,2,71,264,10,180,9.566049337,217114,490,9,19019,22536,3517,702437,828371,125934,8667,10584,1917,1,63.07665924,Arch
a0bba54b10ece8ee74efa9145bbcb91494d03c25,1,81,0,81,0,0,0,3,3,3282,1,1,0,116,491,10,6,5,1,772,489,283,6,5,1,1,99.96494918,NoArch
7e8283eaea1a810b25819e3bdd32c0d0bcc77af8,1458,126857,117645,9212,506,376,882,3,143,412,10,180,9.564495999,207902,2167,12,20601,20918,317,759454,770034,10580,9700,9496,204,1,63.11095867,Arch
87b01bcf46fe3d92d8ad1e9e1d88381a49da7e4c,1458,117685,126897,9212,376,506,882,2,71,266,10,180,9.565039348,217114,492,9,19020,22536,3516,702720,828371,125651,8668,10584,1916,1,63.11095867,Arch
9b1b75d9b0fa88d4e119d7c4447da57d39016c83,1458,126869,117645,9224,506,376,882,3,143,412,10,180,9.564441019,207902,2168,12,20602,20918,316,759474,770034,10560,9701,9496,205,1,63.11095867,Arch
0b3c62781ec39ab46af30f06d75a9744a01adf73,3,92,3,89,1,0,1,2,4,216,1,2,1.056593022,1385,2169,13,184,174,10,6861,6469,392,54,49,5,1,99.84917044,NoArch
ce26c76f0896e9ca48c02466f3732c2451f8ea63,1,1,1,0,0,0,0,2,5,0,1,1,0,1314,2170,14,172,172,0,6234,6229,5,47,47,0,1,100,NoArch
f478d9f01004d0362bc7514ad33a78c5140ddee4,1,11,5,6,0,0,0,10,95,150,1,1,0,1382,1285,2,240,238,2,4642,4608,34,40,40,0,1,100,NoArch
2edc12e3756a8d98a9664a7447b665cfec9ff659,1,0,1,1,0,0,0,1,2,2,1,1,0,70,2171,15,4,4,0,266,278,12,4,4,0,1,100,NoArch
f1b5e559d28206d66d209c9a08f5e82a0d0ef274,1,4,4,0,0,0,0,3,5,827,1,1,0,315,2172,16,29,29,0,1041,1041,0,8,8,0,1,100,NoArch
c14e3226d4e9f34339dfe953965e13caf811ef4a,1,11,8,3,0,0,0,4,10,438,1,1,0,347,1286,2,40,41,1,1646,1588,58,10,11,1,1,100,NoArch
ad71604f87ca730a6f14a924ab8a45c03c46a73e,1,9,1,8,0,0,0,2,7,898,1,1,0,214,2173,16,28,27,1,925,906,19,12,12,0,1,100,NoArch
823951544ed5ad5d9fb6c568e4bc0239d302ea35,1,2,9,7,0,0,0,2,8,2,1,1,0,222,2174,16,27,28,1,912,925,13,12,12,0,1,100,NoArch
556d35d5f508dfb153964e525e77cf69794c876c,2,44,36,8,0,0,0,4,17,140,2,2,0.230709956,825,1287,3,116,114,2,3333,3316,17,37,36,1,1,100,NoArch
9305b63ca95470f16f85d9d31a90b38c133f7172,1,7,11,4,0,0,0,3,15,139,1,1,0,422,1288,4,44,45,1,2091,2075,16,12,12,0,1,100,NoArch
3fd90a14b3979ae2c5aebe8862c7dc16c135660e,1,1,0,1,0,0,0,3,12,143,1,1,0,351,1289,4,33,33,0,1516,1510,6,12,12,0,1,100,NoArch
f29e08c2f25ce23b7191bd682c0a2748fdd927ea,0,0,0,0,0,0,0,0,0,0,0,0,0,0,1290,5,0,0,0,0,0,0,0,0,0,0,100,NoArch
987db121250900cf2596858357c40b4e8a7d7598,0,0,0,0,0,0,0,0,0,0,0,0,0,0,1291,6,0,0,0,0,0,0,0,0,0,0,100,NoArch
5025e867e4b78c4eb2d956e528bc361b4db1153f,0,0,0,0,0,0,0,0,0,0,0,0,0,0,1292,7,0,0,0,0,0,0,0,0,0,0,100,NoArch
8172e6434a60d5208e3a9d76888ecb07c10618a4,0,0,0,0,0,0,0,0,0,0,0,0,0,0,1293,8,0,0,0,0,0,0,0,0,0,0,100,NoArch
4cab21ffb12e4a4de38f46957966aee1f227bf12,0,0,0,0,0,0,0,0,0,0,0,0,0,0,1294,9,0,0,0,0,0,0,0,0,0,0,100,NoArch
8bea7c87bdcc7f4ffbf56d911b6e38bebe5972c0,0,0,0,0,0,0,0,0,0,0,0,0,0,0,1600,7,0,0,0,0,0,0,0,0,0,0,100,NoArch
a177c1ad56b2d46a68ba4065257a9e2e0987ccd3,0,0,0,0,0,0,0,0,0,0,0,0,0,0,1599,6,0,0,0,0,0,0,0,0,0,0,100,NoArch
4b0b49c6a5da43605caf53a0bfc0bd4b19901926,1,4,1,3,0,0,0,3,10,1647,1,1,0,342,4914,28,5,5,0,2286,2286,0,3,3,0,1,100,NoArch
5ed53bad1e1c2064c2039bcf39451413e04cd827,1,6,1,5,0,0,0,2,5,14,1,1,0,230,4915,29,31,30,1,1157,1139,18,7,7,0,1,100,NoArch
713525f7e39286caef64ebae35c59b019a9adcc0,1,1,1,0,0,0,0,5,22,493,1,1,0,371,4916,25,37,36,1,977,969,8,17,17,0,1,100,NoArch
cd14ad83b95ea7e7c5323e7fd34db955156b2d60,3,8,7,1,0,0,0,2,2,184,1,3,1.103307409,98,4917,26,0,0,0,117,123,6,0,0,0,1,100,NoArch
a92d03978a84a1a2fb60eb4a2c715805dfd69a01,1,1,1,0,0,0,0,4,5,1544,1,1,0,69,4918,27,3,3,0,108,109,1,1,1,0,1,100,NoArch
12c9cff16f3020652a71d45842e1b72ff6601aac,5,18,6,12,0,0,0,3,206,975,2,5,1.830557653,3602,4919,28,353,353,0,14187,14187,0,108,108,0,1,100,NoArch
95cae9ae1d30499d688ee46061a22a838dd2f990,1,1,4,3,0,0,0,4,40,29,1,1,0,2186,4920,26,256,257,1,6048,6056,8,113,113,0,1,100,NoArch
af83bc97e8c0421b4f818a63d3f8ea5ce91af521,1,2,2,0,0,0,0,1,15,419,1,1,0,366,4921,27,50,50,0,1703,1725,22,13,13,0,1,100,NoArch
16e6e093e75e08fd503f9c6a9d84c01be430be7d,1,2,1,1,0,0,0,1,16,0,1,1,0,366,4922,28,50,50,0,1707,1703,4,13,13,0,1,100,NoArch
bfa6df0c85c782aa5e525d35e7eb5c530eb7208c,2,14,6,8,0,0,0,3,24,352,1,1,1,327,4923,28,31,31,0,1121,1109,12,20,20,0,1,100,NoArch
e2de9c5899c3ce22e9d2da9f1e2b823fe185a551,1,2,4,2,0,0,0,3,25,0,1,1,0,132,4924,29,11,11,0,330,338,8,9,9,0,1,100,NoArch
d3f9dbb123ba20fdb3651412cf623eee73f1efef,2,123,81,42,0,0,0,2,25,2113,1,1,0.795366199,954,4925,28,128,125,3,4520,4325,195,33,32,1,1,100,NoArch
6ddcb273ee51e4d4d1daebc75fff80d9b022854e,2,10,3,7,0,0,0,2,26,0,1,1,0.89049164,996,4926,29,129,128,1,4571,4520,51,33,33,0,1,100,NoArch
4da3b267ab73a543df5fc89b6269f4ede02f674c,1,1,1,0,0,0,0,4,7,6077,1,1,0,137,4927,20,11,11,0,179,178,1,11,11,0,1,100,NoArch
1e06f6af1580203599e2112c8e7f72d380ee8f76,1,8,6,2,0,0,0,3,13,4700,1,1,0,184,4928,21,19,18,1,499,490,9,8,8,0,1,100,NoArch
3cb01507b7d736a434ef0955d7d87671ae12951d,1,0,13,13,0,0,0,2,13,186,1,1,0,413,4929,22,30,31,1,1256,1282,26,25,26,1,1,100,NoArch
cc9c05a884ec9fa1b1bc4e0013f0945e5d174bd2,1,0,32,32,0,0,0,3,26,11,1,1,0,130,4930,19,8,11,3,260,330,70,8,9,1,1,100,NoArch
05e6e991b0914cd1448ee159a1bb21a0992ba422,1,0,1,1,0,0,0,3,27,0,1,1,0,98,4931,20,8,8,0,251,260,9,8,8,0,1,100,NoArch
e23d973c7fcf257267ec2f881a6bb192bef425ef,1,15,24,9,0,0,0,3,14,2,1,1,0,186,4932,21,17,19,2,432,499,67,8,8,0,1,100,NoArch
0dd1ea71330ccf9199f442b267b5393d2d5e1388,1,6,0,6,0,0,0,7,80,306,1,1,0,783,4933,19,82,81,1,2474,2439,35,32,32,0,1,100,NoArch
3d2e0638e397add1d26ffad3f17f9362c8136b9a,1,2,2,0,0,0,0,4,48,65,1,1,0,658,4934,19,72,72,0,2119,2119,0,32,32,0,1,100,NoArch
ef500ff3c18986b80599b88101dbdfd41a5f73da,1,26,0,26,0,0,0,1,6,386,1,1,0,188,4935,20,12,8,4,1480,1294,186,4,4,0,1,99.98708344,NoArch
bba745633736eaffe89c33d7a04a4720ff26883d,0,0,0,0,0,0,0,0,0,0,0,0,0,0,4936,19,0,0,0,0,0,0,0,0,0,1,100,NoArch
b11cb18755b5d0d29e754d12cdf4ea932b50d5e3,1,5,1,4,0,0,0,6,22,444,1,1,0,397,4937,16,47,46,1,1507,1478,29,16,16,0,1,100,NoArch
2b79eb12258c42549cb217bce2a497bce2a2c239,1,3,3,0,0,0,0,6,24,398,1,1,0,598,4938,13,62,62,0,2337,2342,5,24,24,0,1,100,NoArch
1b414d40c69c4d8006b9bb1b4968eb0b79dcf021,1,1,1,0,0,0,0,4,85,97,1,1,0,882,519,0,111,111,0,4616,4616,0,26,26,0,1,100,NoArch
95602905111b858b5b1e3d20864cf51d941c98c7,1,3,3,0,0,0,0,8,207,69,1,1,0,1770,520,1,162,162,0,5196,5193,3,73,73,0,1,100,NoArch
a5007a34bc781decc5f0a6b26a7506e22513e762,1,2,2,0,0,0,0,8,208,3,1,1,0,1770,4939,3,162,162,0,5212,5196,16,73,73,0,1,100,NoArch
8fa7c70056b5d0b6f3d5517f1aefe0e00239b654,1,2,2,0,0,0,0,3,29,2071,1,1,0,948,4940,4,160,160,0,4411,4411,0,24,24,0,1,100,NoArch
086d54f9129c2a2e3cf4a7cde035060f63aa98db,1,95,0,95,1,0,1,1,1,0,1,1,0,0,4941,5,9,0,9,408,0,408,3,0,3,1,88.3743213,Arch
ec83b68b2943ba385c5764b27c9c2153620349b4,2,3,3,0,0,0,0,1,56,1092,1,1,0.918295834,1026,4942,6,82,82,0,4274,4271,3,24,24,0,1,100,NoArch
51fb1ea5d6b4ca8b647d44a2ec13a27e9a40bae2,1,14,0,14,0,0,0,8,209,2,1,1,0,1770,4943,7,162,162,0,5212,5212,0,73,73,0,1,100,NoArch
217a6ffb0c5d08b672ecb782bb250df14705a869,1,1,0,1,0,0,0,2,2,3,1,1,0,95,1600,0,9,9,0,419,408,11,3,3,0,1,100,NoArch
fafdec6689300d0cf40f27905cea3405d48ddc35,1,3,3,0,0,0,0,3,6,871,1,1,0,204,4944,6,17,17,0,843,843,0,4,4,0,1,100,NoArch
49c36dcf47b44b651d7de7027a0210840f65b4f4,3,14,9,5,0,0,0,1,7,2100,1,1,1.450908284,395,4945,7,27,27,0,1467,1428,39,11,11,0,1,100,NoArch
ad861b4789ca4b93b42096c764f4b787f057c686,1,2,1,1,0,0,0,5,71,113,1,1,0,1563,4946,8,228,228,0,7441,7438,3,80,80,0,1,100,NoArch
f4f6acf21afc11922b5a5ff2126daab4dd65d59d,1,2,2,0,0,0,0,1,24,546,1,1,0,633,4947,9,60,60,0,2297,2297,0,18,18,0,1,100,NoArch
ee3ec5a9300c09116cb192124b9af38a532145ce,1,5,2,3,0,0,0,3,8,0,1,1,0,204,4948,10,17,17,0,847,837,10,4,4,0,1,100,NoArch
ffb7867a33d2082f6fc508f0c8c93da968c0df56,1,16,1,15,0,0,0,3,6,455,1,1,0,138,1601,1,15,13,2,545,483,62,5,4,1,1,100,NoArch
be9fd30734e0e48539670c4f9d75a9acaf05838c,1,1,1,0,0,0,0,1,10,32,1,1,0,584,4949,10,47,47,0,2712,2712,0,12,12,0,1,100,NoArch
de6ac6674752c74d5bd184e1c6b041f32039b8b1,2,40,17,23,0,0,0,3,52,782,1,2,0.669996032,933,1602,2,175,173,2,4260,4188,72,30,30,0,1,100,NoArch
9a7d749ee970ae2536196721b6b93a025c043720,1,3,4,1,0,0,0,3,8,3830,1,1,0,79,1603,3,5,5,0,206,215,9,3,3,0,1,100,NoArch
6e3d1a6fb66a696478d5f34a8ad7609893f19a84,1,2,2,0,0,0,0,6,15,4625,1,1,0,379,1604,4,43,43,0,1920,1919,1,12,12,0,1,100,NoArch
117e970010832ad8232155303c3b1adc58ef9bf6,1,14,0,14,0,0,0,3,20,1,1,1,0,165,1605,5,7,6,1,893,801,92,7,6,1,1,100,NoArch
8da8959c7e6b33443b55d6138c0f5753c4e306f4,1,6,5,1,0,0,0,6,53,2,1,1,0,791,1606,5,169,169,0,3473,3459,14,24,24,0,1,100,NoArch
f52194547a817ecbf1eb9603ad82397ae7592f92,1,31,15,16,0,0,0,3,21,4,1,1,0,179,1607,6,8,7,1,1054,893,161,8,7,1,1,100,NoArch
3fb54e8d7cddce993557083fe192922d8bde9fa7,1,12,2,10,0,0,0,4,241,168,1,1,0,2027,4950,1,257,256,1,9545,9517,28,62,62,0,1,100,NoArch
e7eeb57ebb2c971e7758b71ec1f81695d1765a6c,1,3,1,2,0,0,0,6,93,886,1,1,0,692,1608,7,101,99,2,2676,2653,23,28,28,0,1,100,NoArch
bf4c2282e3ecd1215f71d38960d6e131442e0ca7,1,18,1,17,0,0,0,2,11,2230,1,1,0,317,4951,2,29,28,1,1141,1103,38,13,12,1,1,100,NoArch
8f4624f234ba360c6621c872c953693d93b61c75,1,25,25,0,0,0,0,6,94,6,1,1,0,694,1609,8,98,101,3,2667,2676,9,28,28,0,1,100,NoArch
7b09d771ee372d07679f89ac3f67d69c1f9bb330,0,0,0,0,0,0,0,0,0,0,0,0,0,0,4952,2,0,0,0,0,0,0,0,0,0,1,100,NoArch
546f3629d11125a5540db1204efd289a3913b979,1,2,2,0,0,0,0,5,101,1277,1,1,0,1600,4953,3,220,219,1,6817,6804,13,46,46,0,1,100,NoArch
a259828f45af9a365a4b332baeb516aeee351d4d,4,83,2,81,0,0,0,2,97,955,2,3,1.616464897,1747,4954,3,192,188,4,6496,6058,438,83,80,3,1,100,NoArch
a7d3f728f3b6c00a5d3da43590dffbfbf4ce25ae,1,1,1,0,0,0,0,8,110,363,1,1,0,1532,4955,4,180,180,0,5881,5881,0,51,51,0,1,100,NoArch
5b7b1a171b3449ee5f6996a1b3542a31919f86ec,0,0,0,0,0,0,0,0,0,0,0,0,0,0,4956,5,0,0,0,0,0,0,0,0,0,1,100,NoArch
076d5abdf5481b4548fbda0926127f47ca275717,2,10,1,9,0,0,0,8,210,1872,2,2,0.945660305,1868,4957,5,164,164,0,5575,5568,7,75,75,0,1,100,NoArch
77214056349d23c4a1e2e1fa66d5cdcf7637a31f,1,5,0,5,0,0,0,7,65,468,1,1,0,1179,4958,6,137,136,1,5987,5970,17,31,31,0,1,100,NoArch
865d3a81f5c59bcace84ae465405cfe90c750c9f,1,8,0,8,0,0,0,7,66,0,1,1,0,1184,4959,7,139,137,2,6017,5987,30,31,31,0,1,100,NoArch
7506ff8e4df5f6aaeb3ea1a7468deaf77afac1e7,1,8,0,8,0,0,0,5,20,619,1,1,0,144,4960,8,14,12,2,564,530,34,5,5,0,1,100,NoArch
21e743dccfb70d0f5db4f15718afdb73e2b46653,1,5,0,5,0,0,0,6,29,705,1,1,0,182,4961,9,25,22,3,840,794,46,5,5,0,1,100,NoArch
845b090b4428ea3bea86c20a7bc11c90674f526d,1,7,2,5,0,0,0,7,57,514,1,1,0,420,4962,10,41,39,2,1229,1193,36,22,22,0,1,100,NoArch
5c5a837140fbb4ef78bb5ef9f29ad537c872c83e,6,62,38,24,0,0,0,1,36,2034,1,3,2.527418114,1806,1610,0,177,174,3,6192,6089,103,91,91,0,1,100,NoArch
aff5dd85fe20c5d14b3d7b33258dbdf9791db70c,1,81,86,5,0,0,0,1,7,1346,1,1,0,127,4963,10,18,19,1,519,436,83,9,8,1,1,100,NoArch
112aacc812aa292bf1f35aac55f1dcb943bf1ddd,1,5,11,6,0,0,0,1,8,2,1,1,0,122,4964,10,18,18,0,515,519,4,9,9,0,1,100,NoArch
29c0d0fb6857a8a6ab6414723612d6b6e4d8a874,1,3,2,1,0,0,0,3,13,1264,1,1,0,392,4965,11,75,75,0,2359,2353,6,15,15,0,1,100,NoArch
1163e60edd5452d005ea85cdb0d6abd8fb4e191e,1,3,3,0,0,0,0,5,11,1717,1,1,0,226,4966,12,20,20,0,608,623,15,12,12,0,1,100,NoArch
dc5350d8e9970f95984521a58b8b9fddf5f28358,1,1,0,1,0,0,0,8,211,30,1,1,0,1788,4967,13,162,162,0,5214,5212,2,73,73,0,1,100,NoArch
76beac2fc316475468821087d9505fa2d09ed3d0,1,4,1,3,0,0,0,4,41,484,1,1,0,415,4968,14,52,51,1,1759,1751,8,18,18,0,1,100,NoArch
f34a33824c4363b9b683245cb582328dc92b79ca,1,81,37,44,0,0,0,6,30,19,1,1,0,187,1611,1,31,25,6,1032,840,192,9,5,4,1,100,NoArch
119d24e2f56431e03ddbb211d867ac41da66b755,1,3,3,0,0,0,0,7,27,1154,1,1,0,579,4969,15,67,68,1,1338,1345,7,40,40,0,1,100,NoArch
5d8320dddce05b05295a1ac425c423c767467fed,1,7,4,3,0,0,0,7,58,20,1,1,0,425,4970,16,41,41,0,1237,1229,8,22,22,0,1,100,NoArch
93932f4774ca8d768b23ede3fed805fd5c396ae4,1,1,1,0,0,0,0,8,212,2,1,1,0,1789,4971,17,162,162,0,5214,5214,0,73,73,0,1,100,NoArch
27da4f1a559b8710360963f74629348657c9947f,1,1,1,0,0,0,0,6,59,1330,1,1,0,816,4972,18,95,95,0,2725,2720,5,48,48,0,1,100,NoArch
67359b5d0a3b4911b955d8fc984e7d72abf60959,1,2,2,0,0,0,0,3,10,6588,1,1,0,130,4973,19,8,8,0,557,557,0,3,3,0,1,100,NoArch
d6324a61b161cb8b8828abbdc692be3ff4d4fae8,2,34,8,26,0,0,0,3,30,191,1,1,0.526617066,1426,4974,17,244,239,5,6115,6034,81,35,34,1,1,100,NoArch
0f34f608627d106c2cae4163da22e6f331bfea49,2,11,8,3,0,0,0,4,72,303,1,2,0.998000884,2332,4975,18,317,317,0,9476,9487,11,130,130,0,1,100,NoArch
2d4aa4adf5bc370f2bf6774f87aee891ac83e947,1,20,7,13,0,0,0,4,7,805,1,1,0,239,4976,18,20,19,1,680,644,36,11,11,0,1,100,NoArch
01ba69a9dc036a82022166e134a099504886c33b,1,1,1,0,0,0,0,4,19,771,1,1,0,305,4977,19,21,21,0,731,736,5,13,13,0,1,100,NoArch
4c9c5474411fb08ffb7f9773155bb8f269a4e2e7,1,1,1,0,0,0,0,6,29,761,1,1,0,755,4978,20,93,93,0,2394,2389,5,40,40,0,1,100,NoArch
b3f6d0a2f5e41a3c96c4e1f49217bbfe8dc00b42,1,1,4,3,0,0,0,3,7,1341,1,1,0,139,4979,21,9,10,1,331,339,8,5,5,0,1,100,NoArch
357ff3bfa52a485a1b10c9f5757498bfcb6d9fc0,2,14,14,0,0,0,0,4,14,668,1,2,0.371232327,627,4980,22,72,72,0,2685,2685,0,43,43,0,1,100,NoArch
958eaaad839a4f0871dcd77228ca1d43f826b29a,1,1,1,0,0,0,0,5,29,927,1,1,0,943,4981,23,133,133,0,4906,4906,0,28,28,0,1,100,NoArch
fdaa414e9b02eb3533ac8b6a979b4234bcbd9a2b,1,10,0,10,0,0,0,3,12,5998,1,1,0,71,4982,24,3,3,0,331,259,72,2,2,0,1,99.958159,NoArch
70045fd072250cad35fb902a89d333a939ae40e6,2,37,1,36,0,0,0,3,22,513,1,2,0.297472249,709,4983,25,27,26,1,3869,3643,226,15,14,1,1,100,NoArch
6775fbbc74c7b03013e3da780c901371b1c9b67c,2,3,3,0,0,0,0,3,46,4,1,2,0.918295834,1246,4984,26,168,168,0,3660,3663,3,60,60,0,1,100,NoArch
a55fb8ac7c9a8acfead63d6757279af88c51191a,1,1,2,1,0,0,0,1,27,389,1,1,0,535,4985,27,48,48,0,2129,2135,6,8,8,0,1,100,NoArch
21de89ba9f6b4737abb248934daf980a2d5421fe,1,20,20,0,0,0,0,5,23,1404,1,1,0,1032,4986,28,131,131,0,3414,3531,117,55,55,0,1,100,NoArch
1b94aa1a7b3f87171e1371149126f9a46fc883cb,1,6,6,0,0,0,0,5,24,0,1,1,0,1032,4987,29,131,131,0,3440,3414,26,55,55,0,1,100,NoArch
c6808cc38bae249f0052b1423898f6802adee559,1,1,1,0,0,0,0,5,102,67,1,1,0,1600,4988,30,220,220,0,6822,6817,5,46,46,0,1,100,NoArch
d534a9c04893df339f452bfe041ec8e8cefcbef1,3,5,5,0,0,0,0,4,30,3914,3,3,1.370950594,1211,4989,31,138,138,0,4038,4038,0,54,54,0,1,100,NoArch
0c557f046bf15c190388c6f067b7bfa82dd38c79,3,5,5,0,0,0,0,4,86,749,3,3,1.521928095,2109,4990,32,250,250,0,9426,9426,0,54,54,0,1,100,NoArch
ef53b45f111c4e391faf1c331c4e81a21e24c0b8,3,17,6,11,0,0,0,3,74,254,1,2,1.428194591,1295,4991,33,145,144,1,5600,5532,68,54,54,0,1,100,NoArch
8c47be1011c11dc47300faecffd8ab32fba3646f,1,5,0,5,0,0,0,6,31,15,1,1,0,231,1612,2,32,31,1,1053,1032,21,9,9,0,1,100,NoArch
0333988a35b4d9abb00fc2ce72d652422e8dc327,4,5,5,0,0,0,0,2,47,1673,1,3,1.921928095,1951,4992,34,242,242,0,7531,7506,25,93,93,0,1,100,NoArch
83f7ce1340e01b1834904deec6c995f6aea3e8c1,1,21,2,19,0,0,0,4,48,0,1,1,0,808,4993,35,110,108,2,4041,3982,59,28,28,0,1,100,NoArch
26c4086f34984ea8d535a00a7e04edc04a6a657e,1,5,2,3,0,0,0,6,25,174,1,1,0,598,4994,36,62,62,0,2359,2337,22,24,24,0,1,100,NoArch
a5e47f032d46bdd0feb7c3fd91d60934350b8617,1,6,6,0,0,0,0,6,26,0,1,1,0,601,4995,37,61,62,1,2377,2359,18,24,24,0,1,100,NoArch
8aa10d3d0dbaea9a77e04dff508cb32ed78fbe57,1,1,1,0,0,0,0,2,12,0,1,1,0,197,4996,38,21,21,0,619,618,1,11,11,0,1,100,NoArch
5d27fcee3a95e3002287bd7a9f62710d66da7862,1,12,11,1,0,0,0,4,49,0,1,1,0,827,4997,38,110,110,0,4010,4041,31,28,28,0,1,100,NoArch
7cbc125b5b5f0dcebf83770f0e633f171e8b9a30,1,1,1,0,0,0,0,8,39,282,1,1,0,1600,4998,39,166,166,0,3831,3835,4,103,103,0,1,100,NoArch
7d57f95943627594d9c37f04b28eabd55cc8e08f,1,41,11,30,0,0,0,4,19,802,1,1,0,835,4999,36,75,73,2,1766,1666,100,71,71,0,2,100,NoArch
9bbde91e349d15eb1e60775e00d8ec34009e32c2,1,6,0,6,0,0,0,5,75,9,1,1,0,435,5000,37,63,62,1,1423,1409,14,19,19,0,1,100,NoArch
b6a43e8e57021b99a16082a9a0ea1a0b0889d774,1,7,6,1,0,0,0,5,76,0,1,1,0,441,5001,38,63,63,0,1423,1423,0,19,19,0,1,100,NoArch
8eafb4b50c316e7307c60ca764679a81af15e1ed,1,14,5,9,0,0,0,4,20,1,1,1,0,865,5002,39,76,75,1,1789,1766,23,71,71,0,2,100,NoArch
41caa911de9318da7ac730dc83f2c3fc59a7c6f6,1,5,10,5,0,0,0,3,5,1368,1,1,0,110,5003,39,6,6,0,217,239,22,5,5,0,1,100,NoArch
6a9c8d64bbf7c2c458a13c57454133570f8771bb,0,0,0,0,0,0,0,0,0,0,0,0,0,0,5004,39,0,0,0,0,0,0,0,0,0,1,100,NoArch
cd23b6b2e0e8f003f433903ff280a3ba34b0d49e,1,6,2,4,0,0,0,5,27,462,1,1,0,477,5005,40,42,41,1,1247,1235,12,29,29,0,1,100,NoArch
ea3db8d0257380a2ed86d460865d3acf0e5b855c,1,1,1,0,0,0,0,5,103,20,1,1,0,1600,5006,41,220,220,0,6827,6822,5,46,46,0,1,100,NoArch
c978d742bd64137aacdba346f3afe7238a5ac9a7,1,2,1,1,0,0,0,7,28,32,1,1,0,579,5007,42,66,67,1,1336,1338,2,40,40,0,1,100,NoArch
9b178c2882b7907400005bfa909a1885da1b26ab,1,2,8,6,0,0,0,4,8,5504,1,1,0,219,5008,43,24,26,2,474,492,18,9,9,0,1,100,NoArch
45baabd42386badeb50c25043c7b3a748102022c,1,3,3,0,0,0,0,2,3,6743,1,1,0,119,5009,44,11,11,0,340,331,9,6,6,0,1,100,NoArch
55c4031f9a016073df9bdb515d2c9bb7fef9bff5,2,2,2,0,0,0,0,2,51,354,1,2,1,870,5010,45,67,67,0,3309,3309,0,30,30,0,1,100,NoArch
f1acbdc0ccdaebfb3be1145b5643fcd53efde508,1,3,3,0,0,0,0,8,27,3302,1,1,0,579,5011,46,59,59,0,1773,1762,11,31,31,0,1,100,NoArch
24ea73f5eabbe48ff75283f0d01e06ea5954e9b6,1,3,2,1,0,0,0,5,16,1039,1,1,0,1239,5012,47,153,153,0,3699,3686,13,59,59,0,1,100,NoArch
d54ca428595603d9a73c473344165afce0da1322,1,2,4,2,0,0,0,8,40,15,1,1,0,1600,5013,48,166,166,0,3819,3831,12,103,103,0,1,100,NoArch
d2236396eac1fa9923f5e8c0f05e0ec93730bf39,1,13,13,0,0,0,0,4,21,771,1,1,0,405,5014,49,54,54,0,1908,1918,10,6,6,0,1,100,NoArch
1659149246556570f4a96f30b67487e2db349c7d,1,6,7,1,0,0,0,5,73,28,1,1,0,1566,5015,50,228,228,0,7443,7431,12,80,80,0,1,100,NoArch
9bba7555f4558f5287c10be03a94f8c86e94908d,1,3,2,1,0,0,0,1,2,845,1,1,0,101,5016,51,7,7,0,430,430,0,2,2,0,1,100,NoArch
927a744a56c459f6a684370856fa1078cced61d2,1,7,11,4,0,0,0,6,18,1367,1,1,0,449,5017,52,64,64,0,1847,1858,11,7,7,0,1,100,NoArch
39012b1839d08a5aec5515b4d447ebc9460ed28b,0,0,0,0,0,0,0,0,0,0,0,0,0,0,1613,2,0,0,0,0,0,0,0,0,0,0,100,NoArch
1c78160fd88fff325590c9a5dbcfad9a0df87dad,0,0,0,0,0,0,0,0,0,0,0,0,0,0,1614,3,0,0,0,0,0,0,0,0,0,0,100,NoArch
9722f3dc57a24e421ce1f3c1fbd0298fc43415ad,0,0,0,0,0,0,0,0,0,0,0,0,0,0,1615,4,0,0,0,0,0,0,0,0,0,0,100,NoArch
6106bcb6b31cce0398acc7e2977f52a0886ae827,0,0,0,0,0,0,0,0,0,0,0,0,0,0,1615,4,0,0,0,0,0,0,0,0,0,0,100,NoArch
38bc6cf775a994ab0d0910627806282a58ff4889,1,1,1,0,0,0,0,2,2,5980,1,1,0,82,5018,49,7,7,0,166,166,0,5,5,0,1,100,NoArch
1d3298c28ed000f5f08dae778711f3aa990ee4ef,1,1,1,0,0,0,0,3,13,5164,1,1,0,454,5019,50,32,32,0,1357,1357,0,19,19,0,1,100,NoArch
8e102340173bdad3b2b574611a9b02daa15042d5,2,3,3,0,0,0,0,8,213,24,1,2,0.918295834,2368,5020,51,221,221,0,6987,6987,0,104,104,0,1,100,NoArch
4ee1908893e4f635d2accd506f47ff05cca8ce70,1,2,1,1,0,0,0,2,14,234,1,1,0,400,5021,47,30,30,0,1254,1256,2,25,25,0,1,100,NoArch
84d011e4ca5500469f2247b3b71dc0a77f657a43,2,13,9,4,0,0,0,10,115,481,2,2,0.684038436,1112,5022,48,76,76,0,8451,8397,54,22,22,0,1,100,NoArch
e811f175ee2e7f12fea76c2070473921c37e71d9,1,1,1,0,0,0,0,1,16,1,1,1,0,348,5023,47,44,44,0,1632,1630,2,10,10,0,1,100,NoArch
537e49544764e617c4e252d6260b192de1ca260c,1,6,6,0,0,0,0,2,14,585,1,1,0,588,5024,42,17,17,0,3313,3295,18,16,16,0,1,100,NoArch
edb999fc462e76702d1de69f117752a81f386557,3,41,9,32,0,0,0,4,22,1770,1,1,1.476438254,580,5025,43,62,60,2,1593,1533,60,28,26,2,1,100,NoArch
7afe6b0cbed0baa4ed5b446240c33544ece4f221,2,13,11,2,0,0,0,2,11,1110,1,2,0.918295834,616,5026,37,61,61,0,1959,1949,10,34,34,0,1,100,NoArch
3672a1f60e5ca7fe2d88f0d266d37ab2a817b3e3,2,0,2,2,0,0,0,2,12,0,1,2,1,618,5027,38,61,61,0,1945,1959,14,34,34,0,1,100,NoArch
1f38633278ae6c188b4ac134df42e4a969ed67cf,1,1,1,0,0,0,0,3,8,5144,1,1,0,160,5028,39,12,12,0,422,417,5,9,9,0,1,100,NoArch
37fd049eaaa19855c30bc50aefe571ac350bc45a,1,1,6,5,0,0,0,5,11,2417,1,1,0,187,5029,40,12,13,1,400,417,17,9,9,0,1,100,NoArch
026751fb43575279d244ed6a814c1ae993a8ac40,1,9,4,5,0,0,0,4,242,134,1,1,0,2037,5030,41,257,257,0,9565,9545,20,62,62,0,1,100,NoArch
aa3a96f3e26f2708be985bc972919ea81301d3cf,1,3,3,0,0,0,0,4,18,578,1,1,0,727,5031,42,72,72,0,3108,3090,18,16,16,0,1,100,NoArch
538981987bae2b280729e0317cbcc919750436b6,1,1,6,5,0,0,0,3,11,5733,1,1,0,235,5032,41,24,25,1,700,716,16,17,17,0,1,100,NoArch
744606e66f5c10775d97c75f8a1fa9e68ffc0b31,1,5,1,4,0,0,0,2,10,1286,1,1,0,513,5033,42,67,67,0,2956,2951,5,8,8,0,1,100,NoArch
850a19fd942dd8108e01ab0ab46e2b899e25b8ec,1,7,4,3,0,0,0,4,36,294,1,1,0,265,5034,43,28,28,0,856,858,2,15,15,0,1,100,NoArch
6426900c3eab28b3d2950cca603ce3d9cffff448,2,6,2,4,0,0,0,2,13,0,1,2,1,616,5035,44,61,61,0,1951,1945,6,34,34,0,1,100,NoArch
38981e75f1175f35bbc91fe9dda9bc3a403ad3ea,2,2,2,0,0,0,0,2,14,0,1,2,1,620,5036,45,61,61,0,1951,1951,0,34,34,0,1,100,NoArch
f5ddd138158cc05e6138316a979e53f4d7210b1d,1,24,12,12,0,0,0,4,87,43,1,1,0,882,5037,46,111,111,0,4617,4616,1,26,26,0,1,100,NoArch
65b3e5335b8fc2375fd39ab73098e883ff0f13d7,2,2,2,0,0,0,0,4,41,3328,1,1,1,1781,5038,47,182,182,0,4105,4120,15,116,116,0,1,100,NoArch
e54c989743a70ccefeddc748c43d67becdbe215d,1,40,35,5,0,0,0,8,29,15,1,1,0,579,5039,48,60,59,1,1827,1773,54,31,31,0,1,100,NoArch
bc37dd0b97e1a6aa348efb9c67924b50c9d54a29,1,1,1,0,0,0,0,1,34,703,1,1,0,476,5040,48,43,43,0,1610,1609,1,22,22,0,1,100,NoArch
736b4216a5974571fe9b371b7a2994057b5e6544,1,2,4,2,0,0,0,3,14,1705,1,1,0,168,5041,49,14,14,0,515,520,5,9,9,0,1,100,NoArch
6a5df3945e3950c9f9c942c8658d9e398c22e953,1,1,26,25,0,0,0,3,4,5760,1,1,0,78,1616,3,3,5,2,79,172,93,3,4,1,1,100,NoArch
300ffb64fc18b52366b1becc63b86bebf729de93,1,4,0,4,0,0,0,3,23,1335,1,1,0,192,5042,50,25,24,1,818,808,10,8,8,0,1,100,NoArch
632b9335317f983c7ed11f191ff15f3ec5d810c0,1,10,4,6,0,0,0,3,24,2,1,1,0,196,5043,44,26,25,1,845,818,27,8,8,0,1,100,NoArch
9dfaa4da7621acda7e64bc7a40357d8511300320,2,2,2,0,0,0,0,3,30,699,2,2,1,1542,5044,45,60,60,0,3784,3782,2,31,31,0,1,100,NoArch
ac7ab931069408d03fb9c81e68ee330fcf810f81,1,19,40,21,0,0,0,8,31,0,1,1,0,584,5045,46,55,60,5,1689,1829,140,32,31,1,1,100,NoArch
5a56f2260c6096087d7071dd7974847027290eea,1,1,1,0,0,0,0,3,25,1,1,1,0,202,5046,47,26,26,0,848,845,3,8,8,0,1,100,NoArch
c0168f4bf593481940fc8113d8d8cb03c6a6415c,1,60,0,60,1,0,1,1,1,0,1,1,0,0,5047,48,1,0,1,202,0,202,1,0,1,1,99.958159,NoArch
7405e9d0df07828df030675de0cd195a7b63f90c,1,1,1,0,0,0,0,1,2,0,1,1,0,60,5048,49,1,1,0,202,202,0,1,1,0,1,100,NoArch
8c2a72fa33ce7f2e116e4f529c44ca1aa7ed3e42,1,1,1,0,0,0,0,1,3,0,1,1,0,60,5049,50,1,1,0,202,202,0,1,1,0,1,100,NoArch
b4fc9148e59341f44ce10bdaa86a0b0a87345084,1,4,1,3,0,0,0,4,16,2212,1,1,0,153,5050,51,6,6,0,649,587,62,4,4,0,1,100,NoArch
25f91c4e6d54f89f1d940f8ebea645c109535dcf,1,1,0,1,0,0,0,1,4,0,1,1,0,60,5051,52,1,1,0,212,202,10,1,1,0,1,100,NoArch
cbed0bf12e1bb37844c5f66a968b8f1c0934ded2,1,0,4,4,0,0,0,4,17,0,1,1,0,156,5052,53,6,6,0,587,649,62,4,4,0,1,100,NoArch
17ce50eaa143ad9ba4ad4fc11d5eb579b6135f2e,1,3,7,4,0,0,0,3,16,2993,1,1,0,184,5053,53,19,20,1,589,601,12,6,6,0,1,100,NoArch
53b560b0c5a640a9ddfebc7caf77ce381d823860,1,5,5,0,0,0,0,3,59,437,1,1,0,1526,5054,51,185,185,0,7299,7298,1,50,50,0,1,100,NoArch
1d74eb778d9c8193275d36ce0d5399bc7860381a,1,11,11,0,0,0,0,3,60,0,1,1,0,1526,5055,52,185,185,0,7299,7299,0,50,50,0,1,100,NoArch
5d3618c7f7de3b94bee9092d79eaed5f7939c0ac,1,4,3,1,0,0,0,7,59,66,1,1,0,428,5056,53,41,41,0,1239,1237,2,22,22,0,1,100,NoArch
697b9f072c65bb089d6b1ca025f4f30f7fa521d4,1,2,2,0,0,0,0,3,29,309,1,1,0,1099,5057,54,135,135,0,5768,5776,8,33,33,0,1,100,NoArch
fdec71314d02e0e9ba8747de0ba7dfcde83739d2,1,0,4,4,0,0,0,3,23,469,1,1,0,758,5058,55,122,123,1,3192,3211,19,22,22,0,1,100,NoArch
902fe665a95e717f0b796d9e9fd3712b2d4f1bb4,1,1,2,1,0,0,0,4,49,250,1,1,0,658,5059,56,72,72,0,2119,2119,0,32,32,0,1,100,NoArch
faca1050700e095fa075784453348dee7304f620,1,0,1,1,0,0,0,7,60,1,1,1,0,429,5060,57,41,41,0,1232,1239,7,22,22,0,1,100,NoArch
d1029d1f2ad80a811f580fd71802ac2f00701a7e,1,1,3,2,0,0,0,8,32,5,1,1,0,563,5061,58,55,55,0,1673,1689,16,32,32,0,1,100,NoArch
03546518344d69722f9b65d70d3b100ef1eddb07,1,6,0,6,0,0,0,7,58,662,1,1,0,460,5062,59,111,110,1,1757,1731,26,11,11,0,1,100,NoArch
3231cda8acef0dac17708746b591f0dc6fa91c2f,1,2,2,0,0,0,0,7,59,1,1,1,0,466,5063,60,111,111,0,1757,1757,0,11,11,0,1,100,NoArch
01f80815259c70601c41c19b01455bbe04ca137a,1,1,6,5,0,0,0,7,29,38,1,1,0,580,5064,60,65,66,1,1298,1336,38,40,40,0,1,100,NoArch
41a3975c4846d379a84c808f93ad94cc9e8f2505,1,83,0,83,1,0,1,1,1,0,1,1,0,0,5065,60,4,0,4,325,0,325,4,0,4,1,99.87466054,NoArch
298f43e05c8d7dadf4e13644309d28f62288b252,1,2,1,1,0,0,0,4,25,1752,1,1,0,240,5066,61,27,28,1,977,978,1,4,4,0,1,100,NoArch
213cc43bd68b9857b0300152b8aebc20ada5a820,1,4,0,4,0,0,0,3,24,5,1,1,0,754,5067,62,123,122,1,3211,3192,19,22,22,0,1,100,NoArch
377f9c250848218d9726061050bc976e782c9684,1,6,1,5,0,0,0,6,54,162,1,1,0,792,5068,63,170,169,1,3495,3473,22,24,24,0,1,100,NoArch
5f13308974a797f5c89a8912e6d79bbb470dc71f,1,11,8,3,0,0,0,8,111,115,1,1,0,1532,5069,51,180,180,0,5875,5881,6,51,51,0,1,100,NoArch
825d3ff389479e473fa8becc3a8d06c09b8c776e,1,23,21,2,0,0,0,3,19,632,1,1,0,442,5070,52,41,41,0,1451,1451,0,12,12,0,1,100,NoArch
510bb2caf752568c31a9eac00beba8a177cd6416,1,7,6,1,0,0,0,4,23,1417,1,1,0,237,5071,53,29,30,1,902,894,8,5,5,0,1,100,NoArch
c37523817ee20e0a95560fd4129c519264889089,1,26,28,2,0,0,0,4,62,639,1,1,0,948,5072,50,128,128,0,3677,3685,8,47,47,0,1,100,NoArch
07505e6e88a66c03e4696e67ed4d5dfd7f447499,1,1,1,0,0,0,0,4,63,1,1,1,0,946,5073,51,128,128,0,3670,3677,7,47,47,0,1,100,NoArch
fb05816cf7558faaa86a5a8f5622bcc83a380c6b,1,10,0,10,0,0,0,3,9,208,1,1,0,207,5074,52,19,17,2,893,847,46,4,4,0,1,100,NoArch
c49b0717792b4503a569d21e4eca1681e9fac840,0,0,0,0,0,0,0,0,0,0,0,0,0,0,5075,53,0,0,0,0,0,0,0,0,0,1,100,NoArch
3a7e9df5c8b9059d48a0130743eb0573544b54fe,0,0,0,0,0,0,0,0,0,0,0,0,0,0,5076,52,0,0,0,0,0,0,0,0,0,1,100,NoArch
09ab1dfd2571b7f1238252ffc8234e34f78c1865,15,707,552,155,1,0,1,4,243,4207,1,2,3.267621278,3959,5077,53,437,422,15,17604,16888,716,141,135,6,1,99.47905814,NoArch
90edd89c0962dd2ea5bfe5dac0883b0da2ed7eb0,1,5,0,5,0,0,0,1,6,0,1,1,0,246,5078,54,24,23,1,980,964,16,12,12,0,1,100,NoArch
a6dfd24eb13476d984371a2a734d0410514e1eb8,4,8,6,2,0,0,0,2,26,0,1,1,1.924174352,924,5079,55,94,94,0,4366,4385,19,29,29,0,1,100,NoArch
2873390d838fd2739f74c655afa28c1153c28d4a,1,1,1,0,0,0,0,5,22,80,1,1,0,1019,5080,56,114,114,0,3952,3952,0,17,17,0,1,100,NoArch
77050032fea5f150330c80d78b422c865a745fff,1,10,7,3,0,0,0,4,25,1426,1,1,0,513,5081,57,55,55,0,2063,2063,0,15,15,0,1,100,NoArch
781aec5333633db48b65649f60dc7ca417730e46,1,1,1,0,0,0,0,4,30,138,1,1,0,457,5082,39,47,47,0,1171,1169,2,30,30,0,1,100,NoArch
aaa74f94dd782bafc4eae9a1375278b1d19f74e0,1,7,8,1,0,0,0,3,11,1436,1,1,0,279,5083,40,29,30,1,750,760,10,14,14,0,1,100,NoArch
eac9f8f486650a669907bd6a6fdb408de3c4a5a0,1,6,2,4,0,0,0,4,12,1431,1,1,0,312,5084,41,57,57,0,1690,1674,16,9,9,0,1,100,NoArch
9d6114c96ff460158497c623e109d4f2ec9b9326,1,1,1,0,0,0,0,4,154,789,1,1,0,2971,5085,42,446,446,0,11291,11298,7,61,61,0,1,100,NoArch
ee068f6bd4659f6208c2a0f804d08040bab8ede9,1,16,9,7,0,0,0,4,21,302,1,1,0,203,5086,43,19,20,1,833,783,50,11,11,0,1,100,NoArch
1bf5e6a0b19beb493b5c7b5d9c451e3d3a4ea1b2,1,4,2,2,0,0,0,4,10,6328,1,1,0,554,1617,0,47,47,0,1298,1292,6,45,45,0,1,100,NoArch
c0d0324a8d26610ee99298e008962187aa565b0f,1,2,1,1,0,0,0,3,7,6833,1,1,0,42,5087,27,1,1,0,55,53,2,1,1,0,1,100,NoArch
00ee27113294f3b8eac6d12cb732e75e951a9602,1,1,1,0,0,0,0,10,117,584,1,1,0,1376,5088,25,244,243,1,4766,4762,4,42,42,0,1,100,NoArch
0a2a5f3d6a86a30be76c8d2caeae84690c17c3e6,1,2,1,1,0,0,0,2,9,1481,1,1,0,331,5089,20,35,35,0,1075,1073,2,15,15,0,1,100,NoArch
49fa40717b7f1cb5e1db4ea53b7d956d96e3bbf6,1,5,4,1,0,0,0,3,29,374,1,1,0,484,5090,21,59,59,0,2603,2610,7,21,21,0,1,100,NoArch
6f05e0d67a540527a0de35e320a1f7d85feffe3a,1,4,4,0,0,0,0,3,7,1290,1,1,0,169,5091,22,18,18,0,489,494,5,11,11,0,1,100,NoArch
091c36321665fc80663c1a2c924683986210ffc4,1,18,14,4,0,0,0,3,75,824,1,1,0,1185,5092,23,102,102,0,3720,3725,5,58,58,0,1,100,NoArch
49cb204e9ce0f16e3630f8836a87b11f64d8f7d8,1,1,1,0,0,0,0,3,10,1344,1,1,0,139,5093,24,16,16,0,291,301,10,9,9,0,1,100,NoArch
44b6d4f4c844d94984c902f46c79ec6ce7ee6c8c,1,1,1,0,0,0,0,3,53,503,1,1,0,1005,5094,22,50,50,0,6457,6460,3,17,17,0,1,100,NoArch
484e5bc6d6398109d8e46ee8ed2409db91417556,1,21,0,21,0,0,0,1,37,334,1,1,0,663,5095,23,74,71,3,2964,2820,144,15,15,0,1,100,NoArch
93b6fbbc063eb4ed2e09a66cbf38e57df04e04af,1,8,0,8,0,0,0,3,54,1,1,1,0,1005,5096,24,50,50,0,6524,6457,67,17,17,0,1,100,NoArch
fc2c9ac3c1d421176c452d9f006541ad9fa64c40,1,2,2,0,0,0,0,3,55,0,1,1,0,1013,5097,25,50,50,0,6524,6524,0,17,17,0,1,100,NoArch
aa4f85e6b1b5a50d9e753c6a3c475a11c94387ce,1,8,1,7,0,0,0,3,56,0,1,1,0,1013,5098,26,51,50,1,6548,6524,24,18,17,1,1,100,NoArch
efa8fd76c68a13ced02921148ea81ea40bf795d9,1,10,3,7,0,0,0,10,118,15,1,1,0,1376,1618,1,245,244,1,4782,4766,16,42,42,0,1,100,NoArch
6374e86016d07aabd853d9b5dfdf94306be393e8,1,3,1,2,0,0,0,3,57,0,1,1,0,1020,5099,27,51,51,0,6555,6548,7,18,18,0,1,100,NoArch
537fe2bb11d767998eccb4f426791d3eeca14379,1,3,1,2,0,0,0,3,12,30,1,1,0,278,5100,24,29,29,0,750,750,0,14,14,0,1,100,NoArch
dbaaa2a583c926261319881f052c1ad2893b9854,1,3,3,0,0,0,0,5,74,94,1,1,0,1565,5101,25,228,228,0,7441,7443,2,80,80,0,1,100,NoArch
be652a1d3c3279b5ccd783ea776dce649e3f5e7a,1,0,5,5,0,0,0,3,6,4008,1,1,0,164,5102,26,15,16,1,594,617,23,9,9,0,1,100,NoArch
9bc4131aa3f2fc31ca5260d7985270c626c7cac7,1,21,18,3,0,0,0,6,55,57,1,1,0,797,5103,27,167,170,3,3487,3495,8,24,24,0,1,100,NoArch
9ae2ecf8547d732f9ba8a0724f6ede25bc5371b4,1,6,0,6,0,0,0,10,116,88,1,1,0,768,5104,22,32,32,0,6893,6821,72,12,12,0,1,100,NoArch
6aea95e09203e1294f0b9fb33fa810de0e675caa,1,2,1,1,0,0,0,4,244,45,1,1,0,2055,5105,23,258,258,0,9693,9686,7,62,62,0,1,100,NoArch
3ae21a4c93922a57d71d35be2d6253fd2808db38,2,20,8,12,0,0,0,4,245,1093,1,2,0.811278124,2149,5106,24,268,268,0,10089,10072,17,64,64,0,1,100,NoArch
1217879623298e634f0f62d3b7120c34466ade61,1,21,22,1,0,0,0,4,246,0,1,1,0,2075,5107,25,262,260,2,9768,9747,21,62,62,0,1,100,NoArch
d4a5d9215ec5366c5e4e2ac753ff7f37c8fa5dfc,1,8,1,7,0,0,0,4,247,0,1,1,0,2074,5108,26,262,262,0,9781,9768,13,62,62,0,1,100,NoArch
f7f77270f656d20a59f75e799642fbe3fbe4f660,1,1,1,0,0,0,0,4,248,0,1,1,0,2081,5109,27,262,262,0,9782,9781,1,62,62,0,1,100,NoArch
deded15bb9d8c47184090fae37d46c623d540878,1,2,1,1,0,0,0,2,8,1324,1,1,0,1662,5110,28,202,202,0,4930,4930,0,83,83,0,1,100,NoArch
5cd32e1fc956de4055f455d35fa002cf47ca6d96,1,27,18,9,0,0,0,4,249,2,1,1,0,2081,5111,29,264,262,2,9808,9782,26,63,62,1,1,100,NoArch
38a7d1125aadf78ddf80120880c539d1a7fdb006,1,13,16,3,0,0,0,4,250,0,1,1,0,2090,5112,30,264,264,0,9810,9808,2,63,63,0,1,100,NoArch
2e6a1651a6452f210044fb223fee5390496d4e0b,5,6,45,39,0,0,0,3,76,1012,1,5,2.269128295,2693,1619,2,331,339,8,10085,10329,244,103,103,0,1,100,NoArch
f0f681bbbd737c8a4b72d1b7cdf6d464ea0a142a,1,210,0,210,1,0,1,1,1,0,1,1,0,0,5113,26,5,0,5,1236,0,1236,4,0,4,1,99.95840266,NoArch
2d02d78e0d8e90bfc7bc725b2932442e317ca221,1,16,0,16,0,0,0,1,2,0,1,1,0,210,5114,27,5,5,0,1236,1236,0,4,4,0,1,100,NoArch
2bc8c3896630418c1d21b1a3bbf3e6c1e3bc62d9,1,1,0,1,0,0,0,4,18,83,1,1,0,152,5115,28,6,6,0,594,587,7,4,4,0,1,100,NoArch
23d483ab2046131a6a6340ac3b39deacdd0a27ac,1,3,3,0,0,0,0,1,3,1,1,1,0,226,5116,29,5,5,0,1238,1236,2,4,4,0,1,99.79205656,NoArch
503d712ad1fb8505c7f6c660fbc59748debbc4f1,1,4,2,2,0,0,0,6,23,314,1,1,0,401,5117,29,47,47,0,1507,1507,0,16,16,0,1,100,NoArch
79d33519f20ae71d433ec32c41aee6762c122da7,1,4,2,2,0,0,0,3,22,619,1,1,0,354,5118,30,43,43,0,1385,1385,0,14,14,0,1,100,NoArch
d4ae408d798c5937f3763b4e67dc6a896e2576ef,1,1,1,0,0,0,0,4,62,1335,1,1,0,2680,5119,31,294,294,0,7435,7435,0,135,135,0,1,100,NoArch
428cb5cfa50f21e12136ffda9bc31142e4ddf2e3,1,12,21,9,0,0,0,4,155,54,1,1,0,2971,1620,2,443,446,3,11250,11291,41,61,61,0,1,100,NoArch
002eada2f367bc6c151314f22abdac554cf7db72,1,1,1,0,0,0,0,7,81,345,1,1,0,789,1621,3,82,82,0,2473,2474,1,32,32,0,1,100,NoArch
25b28d4439b9b10cafca917ba813ce16cbb8ed9d,1,3,1,2,0,0,0,2,19,199,1,1,0,303,5120,28,11,11,0,1656,1645,11,9,9,0,1,100,NoArch
cd17a19e9ab1028dc662e972dd8dbb3fa68b4a33,1,7,1,6,0,0,0,5,21,184,1,1,0,152,1622,4,15,14,1,595,564,31,5,5,0,1,100,NoArch
93a66ab75399e17843b13ca752c9cd17ced2d5a0,1,10,4,6,0,0,0,1,2,906,1,1,0,46,1623,5,1,1,0,260,198,62,1,1,0,1,100,NoArch
d7f78545dfabbe24cd8a68c0c75d2c7f64648bc9,1,16,0,16,0,0,0,5,35,720,1,1,0,358,5121,26,49,47,2,1302,1244,58,7,7,0,1,100,NoArch
d55e9929dd739eb20348d0857f276429b4c14658,1,10,7,3,0,0,0,2,3,2046,1,1,0,73,5122,22,6,5,1,244,224,20,2,2,0,1,100,NoArch
5c54ade87829db60e73edffde22042dcba1388e6,1,15,8,7,0,0,0,2,5,2011,1,1,0,101,5123,22,8,8,0,540,474,66,4,4,0,1,100,NoArch
0d079827cf6384a6e42cdc1ed969444bfac0ff23,0,0,0,0,0,0,0,0,0,0,0,0,0,0,1624,5,0,0,0,0,0,0,0,0,0,1,100,NoArch
a7d911865a76176f4f2a68c7e6aa5307fe91c503,2,83,3,80,1,0,1,1,15,81,1,2,0.36505519,477,5124,20,88,79,9,2133,1615,518,12,10,2,1,99.85453034,NoArch
c682f73503e78332c14fec5f88f2003ba4a04328,1,2,2,0,0,0,0,4,156,20,1,1,0,2962,1625,6,443,443,0,11254,11250,4,61,61,0,1,100,NoArch
d3915392a268d537bba1b0417f6e7c8f4244ea04,1,2,1,1,0,0,0,3,31,172,1,1,0,975,5125,18,165,165,0,4497,4497,0,25,25,0,1,100,NoArch
f3ee2a26c29bc5151ef9cba1371e0198394a8554,1,1,0,1,0,0,0,1,6,3931,1,1,0,210,5126,16,20,20,0,931,925,6,7,7,0,1,100,NoArch
37eebb8c1fe4f0bc86abec560c2a02c741e90abb,1,3,1,2,0,0,0,3,11,407,1,1,0,345,5127,15,5,5,0,2287,2286,1,3,3,0,1,100,NoArch
13c22a088319df95f62f1aa7d5d69ab6d9467852,2,34,20,14,0,0,0,4,157,34,1,2,0.228538144,3101,1626,6,461,459,2,11633,11545,88,70,70,0,1,100,NoArch
e0ea546aa7ab7b0d64bbf633df35c7ff9c0507eb,1,6,5,1,0,0,0,8,214,141,1,1,0,1789,5128,15,162,162,0,5205,5214,9,73,73,0,1,100,NoArch
f6e8a0dd3439c3efdd99b24e48b6e751c3d0b8de,3,20,48,28,0,0,0,5,8,4508,1,1,0.640206433,2200,5129,16,174,177,3,4667,4842,175,122,122,0,1,100,NoArch
0c4eb4510e1fcb30d599bbc54cad08dd04387834,1,2,2,0,0,0,0,4,7,677,1,1,0,113,5130,17,7,7,0,156,156,0,7,7,0,1,100,NoArch
b36410e46bfe1a746215ffdd8bed5e9404e17c45,1,1,1,0,0,0,0,3,16,120,1,1,0,958,5131,18,0,0,0,1955,1955,0,0,0,0,1,100,NoArch
d81378f5eaf0d403ddb14a132605b9ec13316183,1,5,0,5,0,0,0,5,15,2796,1,1,0,175,5132,19,18,18,0,461,461,0,12,12,0,1,100,NoArch
3ecff3ad054f4028c5632905bfa6aaa13a334e43,1,9,11,2,0,0,0,4,251,42,1,1,0,2087,5133,20,263,264,1,9800,9810,10,63,63,0,1,100,NoArch
f81a0a9ee66c9bf5cf0f2434aee3722c3674b385,1,4,4,0,0,0,0,6,27,5824,1,1,0,193,5134,21,15,15,0,417,417,0,14,14,0,1,100,NoArch
16b035d1f40f46eaf23d37b34d72b82c786a6a24,1,23,1,22,0,0,0,2,8,1104,1,1,0,231,5135,22,29,27,2,889,865,24,10,8,2,1,100,NoArch
721626ec9e8a475cecdb5024c06dd9e47d4494a3,1,35,0,35,0,0,0,4,18,2297,1,1,0,451,5136,23,13,11,2,2711,2478,233,6,5,1,1,87.8992919,Arch
2c8cd14237084b33d39cae94656af9dc43359667,0,0,0,0,0,0,0,0,0,0,0,0,0,0,5137,24,0,0,0,0,0,0,0,0,0,1,100,NoArch
8dffc8492a4b31267ae49061904f6db213616872,3,9,3,6,0,0,0,3,47,2285,1,1,1.584962501,832,5138,25,86,86,0,3553,3523,30,24,24,0,1,100,NoArch
b5a29fa427f551e6e93ae911b5aee6dd432e4783,3,3,9,6,0,0,0,3,48,0,1,1,1.584962501,838,5139,26,86,86,0,3523,3553,30,24,24,0,1,100,NoArch
9f5aca115bc6c856b94eb8259bff703228e92179,2,6,2,4,0,0,0,3,49,0,1,1,1,666,5140,27,68,68,0,2823,2803,20,19,19,0,1,100,NoArch
6256dafa0e1976d2d4e61194a67ad00977fdf04d,1,12,7,5,0,0,0,3,28,0,1,1,0,166,5141,28,18,18,0,739,720,19,5,5,0,1,100,NoArch
3c3464ff491d2cc8fa6ca010f4ff0bd3e4d5f7ff,1,1,1,0,0,0,0,3,29,0,1,1,0,171,5142,29,18,18,0,739,739,0,5,5,0,1,100,NoArch
d573703b980e0421c13bedc017ccd78d7d90982c,2,59,10,49,1,0,1,1,17,794,1,2,0.666578358,240,5143,27,8,5,3,1408,1248,160,4,3,1,1,99.80945122,NoArch
6aed84e5919eaa25dc83b1a2138cc9f634b9ea6a,2,3,3,0,0,0,0,1,10,726,1,1,0.918295834,314,5144,28,28,28,0,1767,1743,24,10,10,0,1,100,NoArch
40bd3e62474a4f27b56519485bfe0058823a8f0a,1,1,0,1,0,0,0,7,98,228,1,1,0,636,5145,29,76,76,0,2054,2047,7,28,28,0,1,100,NoArch
991c9e4260e68df82a191094be4ee2d160ea45fb,1,11,3,8,0,0,0,2,7,1,1,1,0,108,5146,29,9,8,1,578,552,26,4,4,0,1,100,NoArch
ddc8ad74c9ff5e786a358222bc6368cb88b46211,1,2,1,1,0,0,0,5,23,405,1,1,0,371,5147,27,37,37,0,977,977,0,17,17,0,1,100,NoArch
9d9f9b2028e793a26ca7ca990f5155b87ec258d7,1,6,4,2,0,0,0,4,16,747,1,1,0,262,5148,28,24,24,0,1036,1030,6,16,16,0,1,100,NoArch
263442810a0f9e72f0a21e38c02e10c132957a8b,1,2,6,4,0,0,0,2,32,1592,1,1,0,483,5149,29,46,47,1,1918,1930,12,14,14,0,1,100,NoArch
de14af9140705db0e94fb49d74f5080d16296829,1,1,8,7,0,0,0,4,22,158,1,1,0,405,5150,30,53,54,1,1889,1908,19,6,6,0,1,100,NoArch
30fa743b19012f4e0a324c3db86d72c5368c1c58,1,6,7,1,0,0,0,3,33,1564,1,1,0,894,5151,31,111,111,0,2719,2727,8,37,37,0,1,100,NoArch
d946a734216d9e4de424edc3f8714c7d1d400093,1,1,1,0,0,0,0,4,17,1,1,1,0,264,5152,32,24,24,0,1036,1036,0,16,16,0,1,100,NoArch
0bcc860c58ec4e6ddaa7e64488ed3902f78adff7,1,2,0,2,0,0,0,3,22,1618,1,1,0,242,5153,33,13,13,0,1151,1137,14,8,8,0,1,100,NoArch
ee66e93a33e7e2714a017a119ebc369cf8afd93f,1,6,5,1,0,0,0,5,25,1240,1,1,0,397,5154,34,37,38,1,1783,1773,10,9,9,0,1,100,NoArch
15172d0c461ac9e55ed5bda71d294bb815a6244b,2,4,2,2,0,0,0,2,5,1485,2,2,0.918295834,463,5155,35,28,28,0,2978,2958,20,19,19,0,1,100,NoArch
f37bb7adfe390c78c7b8926929d9a130311ce6a9,1,4,2,2,0,0,0,4,18,1,1,1,0,264,5156,36,24,24,0,1038,1036,2,16,16,0,1,100,NoArch
434d53822bd6fa85133a844e305cb2e5cd1bf32b,1,9,14,5,0,0,0,1,2,7001,1,1,0,169,5157,37,14,15,1,528,551,23,8,8,0,1,100,NoArch
29018d4c4b33f11888f0252314ce85ffdbcda071,1,2,2,0,0,0,0,3,43,756,1,1,0,824,5158,38,112,112,0,3908,3908,0,12,12,0,1,100,NoArch
e34e4326611ff411ea6f8d90cb5935637ea86d84,2,10,2,8,0,0,0,5,26,622,1,2,1,580,5159,39,54,54,0,2461,2448,13,17,17,0,1,100,NoArch
8925d919bd918ab017ebb2b2fa8c105d575148f4,1,5,5,0,0,0,0,5,104,164,1,1,0,1600,5160,40,220,220,0,6827,6827,0,46,46,0,1,100,NoArch
c541a20bd86446b07ee0f59b45fd9e10ada35121,1,8,4,4,0,0,0,5,105,0,1,1,0,1600,5161,41,219,220,1,6828,6827,1,46,46,0,1,100,NoArch
6912a9c1b33cbe2c90fdaf92540e46bbb5625d71,3,3,5,2,0,0,0,1,10,3251,1,1,1.5,723,5162,42,97,97,0,3977,3986,9,28,28,0,1,100,NoArch
9de3738b2a1998490254a6a590614967c4341817,1,4,0,4,0,0,0,2,5,3093,1,1,0,180,5163,43,14,13,1,551,537,14,6,6,0,1,100,NoArch
87512a21869e952f86d6e40ed72d0f5e8fc2d571,1,3,1,2,0,0,0,3,10,113,1,1,0,217,5164,44,19,19,0,891,893,2,4,4,0,1,100,NoArch
b59ef2836920d8e73c87aa16a86eb1e8179d1a05,1,13,9,4,0,0,0,3,23,5,1,1,0,244,5165,45,14,13,1,1157,1151,6,8,8,0,1,100,NoArch
a8cc0f1b51dbfaa9094407169779a9a645fdf522,1,1,1,0,0,0,0,2,6,0,1,1,0,184,5166,46,14,14,0,551,551,0,6,6,0,1,100,NoArch
795ff45a0b57d6d7febc11bd6622ad930745dca6,2,6,1,5,0,0,0,10,119,69,1,2,0.863120569,2157,1627,6,279,277,2,11706,11675,31,54,54,0,1,100,NoArch
2a948e7bc49993fe422e1d9bb3b382c8357a75f1,1,10,0,10,0,0,0,2,2,3605,1,1,0,50,1628,7,2,1,1,238,204,34,2,1,1,1,100,NoArch
6bd2d33898f835e695f0044b4c17258d51972536,1,9,6,3,0,0,0,5,25,3084,1,1,0,433,5167,47,44,44,0,1536,1538,2,18,18,0,1,100,NoArch
423c04895678c56de617287f7f6e68555c058761,1,3,3,0,0,0,0,3,32,816,1,1,0,761,5168,48,100,100,0,2931,2931,0,36,36,0,1,100,NoArch
b29e59c80850ad5bb1780dd6006c7d190b711b20,1,3,4,1,0,0,0,2,2,5725,1,1,0,123,5169,48,10,10,0,299,305,6,6,6,0,1,100,NoArch
4b98ceb05c4360c5799e8ac3d4f442251a4e558b,1,0,15,15,0,0,0,10,120,2,1,1,0,1388,1629,6,244,246,2,4751,4806,55,42,42,0,1,100,NoArch
3e6cd42ae13f629996408bfc685b1eb14c8fdf99,1,20,23,3,0,0,0,10,121,0,1,1,0,1373,1630,7,244,244,0,4748,4751,3,42,42,0,1,100,NoArch
7c47a75a8692d134394494bbc6a8990fd97f1e98,1,1,11,10,0,0,0,10,122,0,1,1,0,1370,1631,8,244,244,0,4731,4748,17,42,42,0,1,100,NoArch
45fb9d2fb1cb13bbbf637badbf1feffce6e95167,1,4,1,3,0,0,0,1,8,1535,1,1,0,269,5170,49,26,26,0,1549,1498,51,11,11,0,1,100,NoArch
1e0e0268a0be3074bcbc4886fe873d077c5244d0,1,1,1,0,0,0,0,10,118,5,1,1,0,774,1632,8,32,33,1,6893,6900,7,12,12,0,1,100,NoArch
9e4a1e45bff1552e8f11c163110be4e5356c228d,1,1,2,1,0,0,0,2,35,115,1,1,0,87,5171,49,5,5,0,248,263,15,4,4,0,1,100,NoArch
dcd36e97ea375a6e6425e88a2ac6b94dfa99e9dc,1,2,6,4,0,0,0,3,10,3248,1,1,0,274,5172,50,29,29,0,1271,1291,20,6,6,0,1,100,NoArch
9ce22324af6e0a16f10ef0363e94454ee64171f0,1,0,7,7,0,0,0,2,3,7,1,1,0,60,1633,9,1,2,1,214,238,24,1,2,1,1,100,NoArch
e97bc3a30e47594ddb0db50154ff009ea0c2ef71,1,10,10,0,0,0,0,10,123,5,1,1,0,1360,1634,10,245,244,1,4728,4731,3,42,42,0,1,100,NoArch
e2ffe53792930488826c23e406cb4f54860009f0,1,3,5,2,0,0,0,1,9,6,1,1,0,272,5173,50,26,26,0,1498,1549,51,11,11,0,1,100,NoArch
a4e14cdf4188e6a4784295243d570c9de90112b5,1,6,6,0,0,0,0,7,68,1061,1,1,0,853,5174,50,123,117,6,2624,2600,24,45,45,0,1,100,NoArch
9a6b2bf0dfedca3658d11db6caf38040698c3dd6,1,4,2,2,0,0,0,1,8,17,1,1,0,230,5175,51,23,23,0,1048,1045,3,9,9,0,1,100,NoArch
673777f7d9ac653845fd44682cec74970810818d,1,3,3,0,0,0,0,1,9,2346,1,1,0,131,5176,52,15,15,0,508,509,1,3,3,0,1,100,NoArch
c6189ccc36f7779df103589fa9f13da8db47522e,1,3,1,2,0,0,0,1,3,3143,1,1,0,728,5177,53,100,100,0,3618,3605,13,74,74,0,1,100,NoArch
557216e58ed73619bc831153560f12d3cb5cec45,3,23,23,0,0,0,0,3,13,123,1,1,1.066615217,651,5178,54,64,64,0,3274,3228,46,16,16,0,1,100,NoArch
f18e563be64683b163a4ed563d4b3f9a53223b9b,1,2,6,4,0,0,0,4,252,32,1,1,0,2085,5179,55,263,263,0,9800,9800,0,63,63,0,1,100,NoArch
6267430111e2e5ba44b7c4cf22910fa043e01b8a,2,7,4,3,0,0,0,4,63,70,1,1,0.994030211,4343,5180,56,496,496,0,12370,12365,5,218,218,0,1,100,NoArch
b5e508f926ef9e96756b30f78ab5b274ba55c4d7,1,3,5,2,0,0,0,2,8,779,1,1,0,957,5181,57,127,127,0,3997,4001,4,24,24,0,1,100,NoArch
90f8fb1f6a1c669560a414aef628c4e39b3d8536,1,13,4,9,0,0,0,5,31,198,1,1,0,824,5182,58,103,103,0,2632,2592,40,47,47,0,1,100,NoArch
f5dfe22753dcee4614f17c26c7490d0210ee2a72,1,1,1,0,0,0,0,7,37,232,1,1,0,522,5183,59,57,57,0,1681,1681,0,26,26,0,1,100,NoArch
807d143f14c4e21e0b1df8c15de6f46b25e5f9b2,1,0,1,1,0,0,0,1,3,22,1,1,0,164,5184,59,14,14,0,517,528,11,8,8,0,1,99.98726115,NoArch
38cf2f665ed8039d4370e8084787e8b564c8eda5,2,123,3,120,0,0,0,2,33,523,1,2,0.309543429,709,5185,60,54,51,3,3939,3436,503,23,20,3,1,99.94906405,NoArch
c1621fe25d793ff4d81843f6c943cbd4bda1aa24,1,6,1,5,0,0,0,3,12,166,1,1,0,227,5186,61,25,25,0,707,692,15,10,10,0,1,100,NoArch
1fa4b90d34ca1677ee84ef9c95b314169a2aa998,4,60,7,53,0,0,0,2,124,683,1,3,1.512803499,1815,1635,9,288,282,6,6090,5838,252,60,58,2,1,100,NoArch
6dc0acacf3cfc75bf98a385365e14ae2d2c78a95,1,6,11,5,0,0,0,3,61,157,1,1,0,1526,5187,59,181,185,4,7251,7299,48,50,50,0,1,100,NoArch
eef31a9d0de2db32305894d2cd86701710918064,1,5,4,1,0,0,0,3,5,6607,1,1,0,323,5188,60,32,32,0,687,687,0,24,24,0,1,100,NoArch
7d26106c6cbe022ec54b8dbed61a68ca9de99f3f,1,16,20,4,0,0,0,1,7,414,1,1,0,214,5189,43,11,12,1,1438,1480,42,4,4,0,1,100,NoArch
5c1eb14bb397ee3534feaf968dafe9922e04de06,1,10,10,0,0,0,0,4,50,219,1,1,0,828,5190,31,110,110,0,4010,4010,0,28,28,0,1,100,NoArch
02b1a246ddea6352e1e8e472bfa96712a68d42cd,1,3,3,0,0,0,0,2,33,46,1,1,0,479,5191,29,46,46,0,1918,1918,0,14,14,0,2,100,NoArch
138bea8a3d16d40afca052c26e4ef29d57b022d8,0,0,0,0,0,0,0,0,0,0,0,0,0,0,5192,30,0,0,0,0,0,0,0,0,0,2,100,NoArch
05db77830f2f37dde6ea087a76643110708d6844,1,24,0,24,0,0,0,2,24,1721,1,1,0,279,5193,31,29,28,1,1912,1797,115,11,10,1,2,100,NoArch
2a68432e7074c62c7a0812f91dfed2adbdaad7bb,1,8,2,6,0,0,0,8,33,175,1,1,0,561,5194,25,55,55,0,1679,1673,6,32,32,0,1,100,NoArch
4b5c3126520a169e9a6784f2b3ac3ee3d0bb712e,1,0,2,2,0,0,0,2,27,440,1,1,0,162,5195,26,18,18,0,762,774,12,4,4,0,1,100,NoArch
5e607bddeaaf2cf29e0b3de5cdd35e7b1834322a,1,0,6,6,0,0,0,4,158,60,1,1,0,2974,5196,27,444,445,1,11312,11342,30,61,61,0,1,100,NoArch
1f5e41f2124e39fff6b356dee2b02f49cd22b2a8,1,6,7,1,0,0,0,3,58,118,1,1,0,1022,5197,28,51,51,0,6544,6555,11,18,18,0,1,100,NoArch
6bd7fdda969edafc23d6544083d85d8a025d2f50,1,1,4,3,0,0,0,8,34,3,1,1,0,567,5198,27,54,55,1,1671,1679,8,32,32,0,1,100,NoArch
819f5fd828f7d0724bf4e3ddce7de41ef62f96d4,1,1,17,16,0,0,0,4,159,5,1,1,0,2968,5199,28,441,444,3,11228,11312,84,61,61,0,1,100,NoArch
9b6fd7c7764c1b0af8b8f67219f900217ef28fdc,1,41,69,28,0,0,0,4,160,0,1,1,0,2952,1636,3,436,441,5,11022,11228,206,61,61,0,1,100,NoArch
32f5cbb7a93fc384395934c07f80c9bedac7a1cf,1,5,4,1,0,0,0,2,12,324,1,1,0,334,5200,27,29,29,0,1156,1141,15,13,13,0,1,99.97452878,NoArch
7083a9ae9ebe16c17c95eec1524bb17ef27aead9,1,7,1,6,0,0,0,4,51,11,1,1,0,828,5201,28,110,110,0,4042,4010,32,28,28,0,1,100,NoArch
600b6f550e8b0aee2deeb0e974f47a59e418202b,1,1,1,0,0,0,0,4,52,0,1,1,0,834,5202,29,110,110,0,4046,4042,4,28,28,0,1,100,NoArch
a94f6f631aff6e0b9e4b11902126fa13f1257a7d,1,1,1,0,0,0,0,3,48,779,1,1,0,916,5203,29,69,69,0,5312,5306,6,28,28,0,1,100,NoArch
8fc59fe57d1f1d43562769775df7c38be53abc5f,0,0,0,0,0,0,0,0,0,0,0,0,0,0,5204,30,0,0,0,0,0,0,0,0,0,1,100,NoArch
a40013000629272a86bd877aca264cf7a83a8805,1,4,0,4,0,0,0,10,119,52,1,1,0,774,5205,21,32,32,0,6941,6893,48,12,12,0,1,100,NoArch
498cdc12298731100fb27c1e30bbd3edf3211308,1,1,0,1,0,0,0,10,120,0,1,1,0,778,5206,22,32,32,0,6953,6941,12,12,12,0,1,100,NoArch
31ea0e291a6fab0d025cd01a97d0e9ab2b543851,1,4,2,2,0,0,0,2,6,485,1,1,0,235,5207,20,32,31,1,1165,1157,8,7,7,0,1,100,NoArch
345320cf03051efc324f1b37ab2d3578c8b6b0c2,0,0,0,0,0,0,0,0,0,0,0,0,0,0,5208,21,0,0,0,0,0,0,0,0,0,1,100,NoArch
fcee4ed9d2583b6ea96e16b4cfdcac0ded6eb265,1,95,37,58,0,0,0,5,106,64,1,1,0,1604,5209,22,233,219,14,7127,6828,299,47,46,1,1,100,NoArch
1a0c6436deb843b6090ea9d545da2e76d365107c,0,0,0,0,0,0,0,0,0,0,0,0,0,0,5210,23,0,0,0,0,0,0,0,0,0,1,100,NoArch
95bcf98404035c53e366d0a32da1055a0e0e83e4,1,59,0,59,0,0,0,3,49,10,1,1,0,916,5211,24,73,69,4,5649,5312,337,31,28,3,1,100,NoArch
5d39fc49fb5c616454978937f224df7a5ba26574,1,2,2,0,0,0,0,3,13,50,1,1,0,232,5212,23,25,25,0,709,707,2,10,10,0,1,100,NoArch
f390c871c52d64191513573f324b578f7425d291,1,3,1,2,0,0,0,3,59,28,1,1,0,1021,5213,24,51,51,0,6560,6544,16,18,18,0,1,100,NoArch
82311475464a6f917b9dfecde76d49f2643a7b71,1,28,0,28,0,0,0,2,3,1973,1,1,0,125,5214,24,16,14,2,733,474,259,6,6,0,1,100,NoArch
2ac935b615b0abb1376655360ce227a9db644acf,1,8,6,2,0,0,0,3,60,4,1,1,0,1023,5215,25,51,51,0,6507,6560,53,18,18,0,1,100,NoArch
afe04e5797deb4552b8f503a6b01069eff274190,1,2,2,0,0,0,0,4,53,28,1,1,0,834,5216,26,110,110,0,4042,4046,4,28,28,0,1,100,NoArch
86cbddd9e5d3eaa237b1a0cf2e24ae737e9a2039,1,1,1,0,0,0,0,5,107,16,1,1,0,1662,5217,27,233,233,0,7121,7127,6,47,47,0,1,100,NoArch
d7d92490d4c40a8c91c19a0a3477ac5fb514b3d9,1,43,5,38,0,0,0,4,161,30,1,1,0,2924,1637,1,446,436,10,11202,11022,180,62,61,1,1,100,NoArch
66f8551b78db3a1d8ae5c51d2a04a1a35ee1fd32,1,9,6,3,0,0,0,1,28,266,1,1,0,534,5218,28,49,48,1,2161,2129,32,9,8,1,1,100,NoArch
e5317c6a0cf753cac9e7b450366b1ce93d0b7cfa,2,8,0,8,0,0,0,3,8,1889,1,1,1,109,5219,28,8,6,2,442,418,24,4,4,0,1,100,NoArch
d2b74de3dd1024efb589e680e07c8cf57fb2093f,1,9,3,6,0,0,0,4,253,66,1,1,0,2081,5220,26,263,263,0,9799,9800,1,63,63,0,1,100,NoArch
6326ec7421bd5855391e69ec1828335ac04048b8,1,2,2,0,0,0,0,4,41,489,1,1,0,2183,5221,27,256,256,0,6042,6048,6,113,113,0,1,100,NoArch
dec337500b45453a3496cbb8e06b5cde347e1a1c,1,1,1,0,0,0,0,3,9,2228,1,1,0,462,5222,28,48,48,0,840,842,2,28,28,0,1,100,NoArch
c8a5b179f9f721430d9af4b3a44ffba52f8d59bc,1,3,4,1,0,0,0,2,9,96,1,1,0,253,5223,29,29,29,0,884,889,5,10,10,0,1,100,NoArch
f266c39525ebd3488caa1423ee478779591359c7,2,5,5,0,0,0,0,3,21,875,1,1,0.970950594,908,5224,30,144,144,0,4903,4903,0,32,32,0,1,100,NoArch
cba5b69c1af628293a318124bcc9265011440d02,1,1,1,0,0,0,0,4,162,4,1,1,0,2962,5225,31,446,446,0,11196,11202,6,62,62,0,1,100,NoArch
e146af246ea1ccb9cbc9fce2ee546a2424a18d53,1,1,1,0,0,0,0,3,34,91,1,1,0,893,5226,32,111,111,0,2713,2719,6,37,37,0,1,100,NoArch
a0dee41d2774b5e5e43f485897a40b95eca6fff9,1,2,1,1,0,0,0,3,77,143,1,1,0,1184,5227,31,101,101,0,3696,3684,12,58,58,0,1,100,NoArch
9fd42fb30d15f199e7dfde463345c76c7eb438cb,1,4,2,2,0,0,0,10,125,62,1,1,0,1364,5228,32,247,247,0,4783,4762,21,42,42,0,1,100,NoArch
d75dcd5418785b49fa85d0be56e495397f1ff07b,1,5,3,2,0,0,0,2,7,2583,1,1,0,223,5229,31,17,17,0,631,626,5,11,11,0,1,100,NoArch
dbbd08d350f8d44c6f9ab20dfceae7293da17c28,1,3,3,0,0,0,0,3,5,6552,1,1,0,127,5230,32,8,8,0,294,294,0,7,7,0,1,100,NoArch
6a6fe7be91a81f1ebd0bd8eb6a8c22916f3907a1,1,4,3,1,0,0,0,5,26,84,1,1,0,436,5231,33,44,44,0,1538,1536,2,18,18,0,1,100,NoArch
4d8766704385d8a7412614d517cb227826b88ee8,1,5,2,3,0,0,0,3,33,84,1,1,0,761,5232,34,100,100,0,2952,2931,21,36,36,0,1,99.96176883,NoArch
d7d562d9a35dc38d1ab6c98ea0e86d0757630f13,1,17,5,12,0,0,0,4,254,3,1,1,0,2087,5233,35,263,263,0,9801,9799,2,63,63,0,1,100,NoArch
cf0aed45f983edcf39b82f96287c4df2a14f6bd7,1,25,21,4,0,0,0,5,86,524,1,1,0,790,5234,36,90,90,0,2552,2548,4,41,41,0,1,100,NoArch
9ab66c97c40e16c1af97831fd4924701e95c2b2e,2,2,2,0,0,0,0,3,7,4891,1,1,1,161,1638,2,18,18,0,391,389,2,18,18,0,1,100,NoArch
5ead5d31ff60fe6f53a605b4d6e1d85d2f8d0548,0,0,0,0,0,0,0,0,0,0,0,0,0,0,1639,2,0,0,0,0,0,0,0,0,0,0,100,NoArch
9b6d49b371691983620abbab65b029779da24dfe,0,0,0,0,0,0,0,0,0,0,0,0,0,0,1640,3,0,0,0,0,0,0,0,0,0,0,100,NoArch
8876e8e1a0adbf619cef4638cc3cea073e3ca484,0,0,0,0,0,0,0,0,0,0,0,0,0,0,1641,4,0,0,0,0,0,0,0,0,0,0,100,NoArch
