CommitID,NMF,TotalAddLines,TotalDeleteLines,LC,FileAdd,FileDelete,NAD,NDVE,NUC,AGE,NMS,NMD,Entropy ,MLMF,EXP,REXP,CommitComplexity,LastCommitComplexity,CFC,CommitTokenCount,LastCommitTokenCount,NCC,CommitMethodNum,LastCommitMethodNum,NFC,NIR,a2a,Tag
6a49038d774a76e44d97f3c02c08609e8bdfc6ca,8,57,7,50,0,0,0,1,12,172,1,2,2.606145033,1007,117,17,131,109,22,5549,5167,382,66,59,7,1,100,NoArch
2dcef0b214d8248f1ce2cb35db89dacf78f28df3,1,3,1,2,0,0,0,5,32,21,1,1,0,235,36,4,28,27,1,1426,1411,15,6,6,0,1,100,NoArch
4351c65ffc92ca747bbd8639697194fd74ee670c,0,0,0,0,0,0,0,0,0,0,0,0,0,0,54,6,0,0,0,0,0,0,0,0,0,0,100,NoArch
5cfe4cb58d1886b75bccf9f16a335f18338fa739,0,0,0,0,0,0,0,0,0,0,0,0,0,0,65,5,0,0,0,0,0,0,0,0,0,1,100,NoArch
e2a84f90e4a746f5f62e79a9214010f8c50ccb42,3,60,22,38,0,0,0,4,16,214,1,3,1.187039885,775,135,2,91,87,4,3087,2877,210,29,27,2,1,100,NoArch
1f694d8b3a602d8de1216cded8c5b0a6f3bb8088,1,2,0,2,0,0,0,5,14,128,1,1,0,603,113,3,99,99,0,4623,4610,13,19,19,0,1,100,NoArch
efeaf59e52ba67971558c2697cdaad4c60c55333,2,260,0,260,2,0,2,1,1,0,1,2,0.758760421,0,120,0,28,0,28,1017,0,1017,8,0,8,1,99.68414403,NoArch
d6bcefd926dffb02d8f6ebfebad8adeea31e8f50,3,47,79,32,0,0,0,3,13,543,1,2,1.058757828,995,212,0,82,83,1,4647,4737,90,19,19,0,1,100,NoArch
a9babcad4bf83717edb5e6a24955f37b034fc958,0,0,0,0,0,0,0,0,0,0,0,0,0,0,39,1,0,0,0,0,0,0,0,0,0,0,100,NoArch
1f1ee03468f93d58181b8ccc568b455450384c08,3,3,2,1,0,0,0,5,29,166,1,2,1.521928095,862,19,6,142,142,0,5073,5060,13,50,50,0,1,100,NoArch
13f6eebad5303b6074d7239e82af5ff6d3178889,1,8,1,7,0,0,0,6,22,2,1,1,0,289,41,2,35,34,1,1818,1797,21,8,8,0,1,100,NoArch
c5fc4f3a80b11319288df28ae9a2e41a4a604f99,0,0,0,0,0,0,0,0,0,0,0,0,0,0,59,10,0,0,0,0,0,0,0,0,0,0,100,NoArch
8859cb5d63da7196fa72887e6022ba6d1d69bf82,0,0,0,0,0,0,0,0,0,0,0,0,0,0,67,4,0,0,0,0,0,0,0,0,0,0,100,NoArch
3ffaa8fb0a6716ba569e2ee1b658e0efb2e6be53,0,0,0,0,0,0,0,0,0,0,0,0,0,0,202,2,0,0,0,0,0,0,0,0,0,1,100,NoArch
41e9fa5e644f6cf8260f93bd7b5c0e18091c902b,0,0,0,0,0,0,0,0,0,0,0,0,0,0,130,11,0,0,0,0,0,0,0,0,0,0,100,NoArch
2ea95cd34ae2ef1bc173fcf3f7142b5cd3ed7401,1,4,3,1,0,0,0,3,24,38,1,1,0,404,70,7,58,58,0,2245,2241,4,16,16,0,0,100,NoArch
88bc670e47936339febd479d692c9049262aaeb9,1,30,15,15,0,0,0,2,2,1133,1,1,0,126,17,1,21,19,2,630,579,51,4,3,1,1,100,NoArch
fa94bbb537421401a6c3fc19ae376e90bd50e69e,0,0,0,0,0,0,0,0,0,0,0,0,0,0,105,9,0,0,0,0,0,0,0,0,0,1,100,NoArch
027c5313bab0f3e82f910129eb48199041fa2a5c,1,111,3,108,0,0,0,3,11,31,1,1,0,275,64,3,57,44,13,2909,2117,792,20,13,7,0,100,NoArch
7e7805092d93a87c46618f1d6b598939a09bf126,1,2,1,1,0,0,0,6,26,55,1,1,0,626,4,4,118,118,0,4804,4802,2,17,17,0,1,100,NoArch
6bcd6e013c9132421966f5b5ee1ae02103df2235,9,64,42,22,0,0,0,8,34,1528,1,6,2.122409827,1617,55,4,151,150,1,7555,7564,9,50,50,0,1,100,NoArch
d0d711310f08726ab44c767fbe6448ac07f428a0,1,1,1,0,0,0,0,5,6,1337,1,1,0,202,130,3,26,26,0,761,757,4,6,6,0,1,100,NoArch
301022d0f0859aa20d45d8c7c1d574ce939db905,1,1,1,0,0,0,0,1,2,6,1,1,0,242,5,5,22,22,0,1180,1180,0,13,13,0,0,100,NoArch
5c39b8d4106202f06f7b5782452493f77314ddb8,0,0,0,0,0,0,0,0,0,0,0,0,0,0,68,5,0,0,0,0,0,0,0,0,0,0,100,NoArch
95e7fe003129edb5230d698912a1b262299d46e1,2,2,2,0,0,0,0,6,26,144,1,2,1,979,49,5,163,163,0,6117,6115,2,63,63,0,1,100,NoArch
aa84ab48dd36684f1fc987471af246eb9c9c33ad,14,42,287,245,0,0,0,3,22,0,1,7,3.771206336,3651,126,8,417,462,45,19584,20671,1087,163,178,15,0,100,NoArch
16b73c1b8be276d596f4f084804435bd93801dc9,3,113,15,98,1,0,1,1,6,60,1,2,1.070036715,242,165,1,28,19,9,1766,1269,497,21,15,6,1,99.85380117,NoArch
3a63fe35fb5c1e07d061a33980070110b30660cd,3,29,5,24,0,0,0,6,23,762,1,3,1.579863401,778,121,0,94,94,0,4849,4632,217,28,28,0,1,100,NoArch
db72053488171849fd9563232fa2ec2643b63cc6,0,0,0,0,0,0,0,0,0,0,0,0,0,0,182,4,0,0,0,0,0,0,0,0,0,0,100,NoArch
2081ef617969f42727b1dcf8b5539a4b34ab8bee,0,0,0,0,0,0,0,0,0,0,0,0,0,0,162,3,0,0,0,0,0,0,0,0,0,0,100,NoArch
d61c0b6bf0c56820efdfa1190a66557ca9a0e79e,0,0,0,0,0,0,0,0,0,0,0,0,0,0,149,2,0,0,0,0,0,0,0,0,0,0,100,NoArch
0d08e885cfa90583172a03dcc1cdf1e92b2f9f0d,0,0,0,0,0,0,0,0,0,0,0,0,0,0,75,25,0,0,0,0,0,0,0,0,0,1,100,NoArch
fa94bbb537421401a6c3fc19ae376e90bd50e69e,0,0,0,0,0,0,0,0,0,0,0,0,0,0,105,9,0,0,0,0,0,0,0,0,0,1,100,NoArch
6a7965ebc6c53fb82f0c096a3e87d1382b1cf67b,0,0,0,0,0,0,0,0,0,0,0,0,0,0,62,0,0,0,0,0,0,0,0,0,0,0,100,NoArch
f41ffc03a5cc7f7722fe80e1d01cf82df571be47,1,161,0,161,1,0,1,1,1,0,1,1,0,0,3,3,16,0,16,573,0,573,8,0,8,1,99.87804878,NoArch
8ed07ed014a5cc9d05f80307c84c15c13459f380,6,92,34,58,1,0,1,5,12,216,1,2,1.707602613,1064,35,7,137,135,2,6311,6064,247,56,55,1,2,99.50946041,NoArch
6e81e6f6f4fc78ccb4c91068da42108b2a927e19,1,5,1,4,0,0,0,6,18,836,1,1,0,193,66,1,23,21,2,1238,1189,49,9,9,0,1,100,NoArch
0a0ddff8f33df9999156f43b70a8a7c423ed8cc9,1,7,1,6,0,0,0,8,21,2203,1,1,0,126,72,5,17,17,0,701,701,0,3,3,0,1,100,NoArch
dd91a83c884a954bd82de7dddededa5a83f320a1,0,0,0,0,0,0,0,0,0,0,0,0,0,0,105,15,0,0,0,0,0,0,0,0,0,1,100,NoArch
e2a84f90e4a746f5f62e79a9214010f8c50ccb42,3,60,22,38,0,0,0,4,16,214,1,3,1.187039885,775,135,2,91,87,4,3087,2877,210,29,27,2,1,100,NoArch
75b7b510d7416936504547f537081b4f2bca23ad,0,0,0,0,0,0,0,0,0,0,0,0,0,0,114,0,0,0,0,0,0,0,0,0,0,0,100,NoArch
ce45896b42e1a13f788461439a9cb3b197a4ec27,2,5,5,0,0,0,0,2,9,582,1,2,0.721928095,825,81,10,78,78,0,2556,2556,0,24,24,0,0,100,NoArch
22a24ab776e5ad901e11a5c622b77cffe5d29606,0,0,0,0,0,0,0,0,0,0,0,0,0,0,265,10,0,0,0,0,0,0,0,0,0,0,100,NoArch
8151e5e24f5fc7e1ee9fb7af1ee549837faf6e1e,0,0,0,0,0,0,0,0,0,0,0,0,0,0,65,4,0,0,0,0,0,0,0,0,0,1,100,NoArch
8db809bba136a7bf601b7702c7688efc12193e08,1,5,11,6,0,0,0,6,12,666,1,1,0,126,39,1,16,19,3,660,706,46,2,2,0,1,100,NoArch
4e33781584bcf5d57182ff22835b9a949dd87e6b,0,0,0,0,0,0,0,0,0,0,0,0,0,0,99,15,0,0,0,0,0,0,0,0,0,0,100,NoArch
188962e1328a579597b62b2da9193ed60864620a,0,0,0,0,0,0,0,0,0,0,0,0,0,0,80,2,0,0,0,0,0,0,0,0,0,1,100,NoArch
62bf2c2e5c2f3be04e47af5213cb6cd180e95ab4,0,0,0,0,0,0,0,0,0,0,0,0,0,0,9,3,0,0,0,0,0,0,0,0,0,0,100,NoArch
23182b9ec3ff2a3a3e61c30bad4fc78a30a999c9,1,1,0,1,0,0,0,3,8,9,1,1,0,128,71,8,28,27,1,582,577,5,3,3,0,0,100,NoArch
c5fc4f3a80b11319288df28ae9a2e41a4a604f99,0,0,0,0,0,0,0,0,0,0,0,0,0,0,59,10,0,0,0,0,0,0,0,0,0,0,100,NoArch
8397611b49de4aac408806765191fc796ba4b15f,3,172,0,172,2,0,2,1,7,1,1,3,0.989019754,219,167,3,38,21,17,1885,1216,669,25,16,9,1,99.75810353,NoArch
ce423d71bd15ec1e3abec0883db27249d7f27d9a,5,15,18,3,0,0,0,2,24,102,1,4,2.246251803,1388,0,0,172,172,0,8005,8060,55,46,46,0,1,100,NoArch
1f666a3276c8ea51ef3267b61144c3da95f850a1,1,5,1,4,0,0,0,6,7,146,1,1,0,694,82,0,57,57,0,3525,3489,36,25,25,0,1,100,NoArch
e27a0c1d48294e48514ccc007fc3617278570ad8,0,0,0,0,0,0,0,0,0,0,0,0,0,0,132,5,0,0,0,0,0,0,0,0,0,0,100,NoArch
7dcd4f94c7adc53cf66efd7ac995348bad2ba970,3,41,9,32,0,0,0,1,3,0,1,2,1.569025574,268,15,8,23,23,0,1448,1448,0,8,8,0,0,100,NoArch
216e8d4b88b82818a285537ffe836f95183233fe,0,0,0,0,0,0,0,0,0,0,0,0,0,0,62,2,0,0,0,0,0,0,0,0,0,0,100,NoArch
9e009d4e10c2bc45b2add0336826663cb430269a,1,1,1,0,0,0,0,6,32,3,1,1,0,313,84,5,69,69,0,1764,1764,0,5,5,0,1,100,NoArch
b25055e9bfb5edd6df4a705a8664ae97c7cce503,0,0,0,0,0,0,0,0,0,0,0,0,0,0,196,6,0,0,0,0,0,0,0,0,0,1,100,NoArch
c83f319845986290f876b326c43eb21ddb7a1dfb,6,482,120,362,2,0,2,1,21,284,1,5,1.731816671,951,40,1,174,130,44,6955,5096,1859,48,30,18,3,99.82363316,NoArch
9538868c98beb351c64222f24d9755fd6a97d3b3,1,0,3,3,0,0,0,5,6,223,1,1,0,152,40,7,11,11,0,649,671,22,5,5,0,1,100,NoArch
d4be397adf3567307a878e0fb8cbcb347a541feb,0,0,0,0,0,0,0,0,0,0,0,0,0,0,5,1,0,0,0,0,0,0,0,0,0,1,100,NoArch
1f694d8b3a602d8de1216cded8c5b0a6f3bb8088,1,2,0,2,0,0,0,5,14,128,1,1,0,603,113,3,99,99,0,4623,4610,13,19,19,0,1,100,NoArch
063a250741ecaebc4b3fa7a14d971d95ea29431d,0,0,0,0,0,0,0,0,0,0,0,0,0,0,124,6,0,0,0,0,0,0,0,0,0,0,100,NoArch
1e2d53117c6fbfd5ec8027253ddf29f2fa0a6f22,1,6,0,6,0,0,0,3,5,270,1,1,0,38,36,8,0,0,0,124,94,30,0,0,0,1,100,NoArch
083b25cdbe4139341fe55037e5b6ad4718f93e91,1,5,2,3,0,0,0,3,3,1378,1,1,0,177,31,4,29,29,0,1169,1123,46,8,8,0,1,100,NoArch
c3d1c1d787eb8287e37c035daee70005538f8854,6,188,106,82,0,0,0,2,5,139,1,2,1.895228065,1727,1,1,207,205,2,7774,7679,95,72,71,1,0,100,NoArch
7a6ddd70c23836ea2295f12b936ed61de34623fa,0,0,0,0,0,0,0,0,0,0,0,0,0,0,9,0,0,0,0,0,0,0,0,0,0,1,100,NoArch
d8325971d65bd7dd90ded1118831ac5eb25e5d39,4,17,14,3,0,0,0,5,19,89,1,4,1.632700917,1207,28,5,204,205,1,6223,6221,2,84,83,1,1,100,NoArch
cfc850d1e213a80583229abcdcf87d7ae2753b16,0,0,0,0,0,0,0,0,0,0,0,0,0,0,205,1,0,0,0,0,0,0,0,0,0,1,100,NoArch
1f8f06523c37b939a6669539f867dfffa6af769a,0,0,0,0,0,0,0,0,0,0,0,0,0,0,238,1,0,0,0,0,0,0,0,0,0,0,100,NoArch
d2dad5d346d3ddc3dc6617133135f8e8bbc3ebb5,1,6,2,4,0,0,0,12,42,201,1,1,0,579,186,2,98,97,1,2875,2851,24,24,24,0,1,100,NoArch
09d83f0a06872a270bcd504ecab46310be6ae73f,0,0,0,0,0,0,0,0,0,0,0,0,0,0,79,5,0,0,0,0,0,0,0,0,0,0,100,NoArch
f3d1202d3932c5cb92485c799ef8d591b8abf8cb,0,0,0,0,0,0,0,0,0,0,0,0,0,0,83,9,0,0,0,0,0,0,0,0,0,0,100,NoArch
b5126db974cee684af1763aac5d03933376c4523,1,26,0,26,0,0,0,3,6,135,1,1,0,285,16,9,44,40,4,1662,1537,125,9,8,1,0,100,NoArch
d4deef989ffc41b9dd5e77683e73286d81e1178b,1,10,0,10,0,0,0,9,20,300,1,1,0,198,10,1,25,22,3,978,901,77,8,8,0,1,100,NoArch
50738f9d8dec622d9f73899ab8f7fbba3d378143,2,106,2,104,1,0,1,1,3,70,1,2,0.183122068,96,39,3,22,10,12,727,255,472,8,4,4,1,99.71459151,NoArch
d4778aa03495a1bf056716d53559e2265ae85e69,1,8,2,6,0,0,0,1,5,8,1,1,0,172,86,4,25,24,1,896,877,19,5,5,0,0,100,NoArch
586c221a5660f57d199e44d47be602f6a9679063,3,9,0,9,0,0,0,1,2,81,1,2,1.392147224,444,189,0,70,68,2,2218,2180,38,15,14,1,1,100,NoArch
870d868f0ba7a572ce556e90f557b9c946442312,0,0,0,0,0,0,0,0,0,0,0,0,0,0,65,0,0,0,0,0,0,0,0,0,0,1,100,NoArch
943aed79faeec1759a3f617b14f9023ec8b84214,1,0,1,1,0,0,0,9,24,305,1,1,0,115,110,11,14,14,0,557,566,9,3,3,0,1,100,NoArch
337843d6e363b39b2e563561e4eb28192542c74d,0,0,0,0,0,0,0,0,0,0,0,0,0,0,10,1,0,0,0,0,0,0,0,0,0,1,100,NoArch
ff8b30881135b73133b1386605050d6c1445cad8,1,71,0,71,0,0,0,1,2,0,1,1,0,71,172,2,12,12,0,443,443,0,10,10,0,0,100,NoArch
0efeb7317d97d25356ef74fdbf303608f6cc7e97,0,0,0,0,0,0,0,0,0,0,0,0,0,0,49,7,0,0,0,0,0,0,0,0,0,0,100,NoArch
1dcb7bc41ebb7cdb24d2333835398eb37aab3e5a,0,0,0,0,0,0,0,0,0,0,0,0,0,0,31,0,0,0,0,0,0,0,0,0,0,1,100,NoArch
5d2ecf81998fddb5cd61da64efe83607ed89a3ca,1,14,1,13,0,0,0,4,18,343,1,1,0,406,16,0,83,79,4,1929,1832,97,13,13,0,1,100,NoArch
35f0d6d4685f292b1ada890e1cbfa71714ede407,0,0,0,0,0,0,0,0,0,0,0,0,0,0,70,3,0,0,0,0,0,0,0,0,0,0,100,NoArch
908378bd140fc2b8ba61117121c6a26d74376877,1,4,3,1,0,0,0,3,4,382,1,1,0,749,77,0,117,117,0,4407,4400,7,12,12,0,1,100,NoArch
38aa2dc51a869215aac52ead46274da582635a37,2,1,3,2,0,0,0,5,8,1683,1,2,1,293,123,1,37,37,0,1601,1627,26,16,16,0,1,100,NoArch
2a38a4b420ddb225452f4df451cb5b4f57a66a81,4,47,34,13,0,0,0,5,8,1461,1,2,1.374775681,314,63,3,36,34,2,1561,1602,41,11,9,2,1,100,NoArch
dfbda722d168c90ee9a25cdf2294bb63bfc8619d,1,25,8,17,0,0,0,5,8,45,1,1,0,304,1,0,33,31,2,1260,1185,75,11,11,0,1,100,NoArch
e779b1cb0d8445e9a6f092c6f149417f16fcf4d7,0,0,0,0,0,0,0,0,0,0,0,0,0,0,63,0,0,0,0,0,0,0,0,0,0,1,100,NoArch
ed6e143b4c57b33dae6f41677d2689a2a65004b7,0,0,0,0,0,0,0,0,0,0,0,0,0,0,27,6,0,0,0,0,0,0,0,0,0,0,100,NoArch
eff9ccb4a47effd3602a0c08fa8ca43d77ddd28e,6,270,2,268,3,0,3,1,5,25,1,4,2.251183473,1013,161,2,177,141,36,7039,5981,1058,59,29,30,1,99.65736662,NoArch
6fe59f89d7a56caf5b88a8152df77b6010c52f87,1,39,24,15,0,0,0,10,30,297,1,1,0,557,180,9,60,60,0,2519,2496,23,11,11,0,1,100,NoArch
c5e2236f36a881ee7fec97aff3baf9bb32b40200,4,164,192,28,0,0,0,6,25,161,1,3,1.466635105,1675,70,2,259,266,7,9636,9849,213,56,56,0,1,100,NoArch
b70bf357fbe85a3be9379380eee71225d95f31b3,1,5,7,2,0,0,0,1,2,42,1,1,0,203,126,4,26,26,0,761,757,4,6,6,0,1,100,NoArch
4dd40032ae99fa8c0c36958064a66eae5c2f0606,0,0,0,0,0,0,0,0,0,0,0,0,0,0,274,15,0,0,0,0,0,0,0,0,0,0,100,NoArch
68e6d42ace0244c422f14f71430f450c44f1a5db,2,22,13,9,0,0,0,6,24,147,1,1,0.591672779,586,61,1,82,80,2,3436,3388,48,18,18,0,1,100,NoArch
4f0a4e0b85b1303407c38b7e7f234ac14143016c,1,35,2,33,0,0,0,5,7,1099,1,1,0,88,47,10,21,10,11,661,455,206,4,3,1,1,100,NoArch
7156531aa1b76df05c9f720ac2706321f7e2abb9,0,0,0,0,0,0,0,0,0,0,0,0,0,0,18,3,0,0,0,0,0,0,0,0,0,1,100,NoArch
107508477a6485161eed8ca2d5a3d67a51fa16d0,1,5,5,0,0,0,0,6,19,515,1,1,0,105,258,1,11,11,0,538,522,16,3,3,0,1,100,NoArch
acf73dc6366a5dabe3bfb5be3173395e54d236b3,1,1,1,0,0,0,0,6,38,182,1,1,0,347,55,0,49,49,0,2099,2099,0,14,14,0,1,100,NoArch
8533ffbb9008f17522afef3ae4d0c212c77f62e2,0,0,0,0,0,0,0,0,0,0,0,0,0,0,34,3,0,0,0,0,0,0,0,0,0,1,100,NoArch
3130c36343ebc74cea57f7b57aeea23338bd2c21,1,1,1,0,0,0,0,2,9,33,1,1,0,225,144,2,22,22,0,1254,1254,0,17,17,0,1,100,NoArch
a03fb73bb733c3c885cfd91acaade8c1db52a1d2,2,55,52,3,0,0,0,6,8,9,1,1,0.90192559,227,49,12,20,19,1,1260,1312,52,7,7,0,1,99.72253052,NoArch
2207380d9524ae4885c1896b1161167ed6a711b8,5,287,71,216,1,1,2,1,18,734,1,3,1.522160423,701,23,11,94,83,11,4993,3976,1017,40,29,11,1,99.05857741,NoArch
a1a4ee9effb583af4b3d4a69540062aa917175e2,0,0,0,0,0,0,0,0,0,0,0,0,0,0,17,10,0,0,0,0,0,0,0,0,0,0,100,NoArch
0edfbc611c7a8e9e3a5ea66b0112c8f6718e399a,1,96,5,91,0,0,0,2,2,4,1,1,0,160,255,2,34,22,12,2040,1332,708,9,4,5,0,100,NoArch
fd671323313228523c9c04fa60e6e9adb167197a,1,3,0,3,0,0,0,3,17,0,1,1,0,396,56,7,58,58,0,2201,2158,43,16,16,0,0,100,NoArch
7e9a2d535805d59f5ad529b1f9e94d4468bd1546,1,16,1,15,0,0,0,7,46,528,1,1,0,611,12,1,91,87,4,3846,3733,113,26,26,0,1,100,NoArch
5b90bc36922c9e604bc7a0df7209ce4d16b7b2d7,1,2,0,2,0,0,0,1,2,33,1,1,0,81,193,3,17,16,1,269,263,6,10,9,1,1,100,NoArch
8397611b49de4aac408806765191fc796ba4b15f,3,172,0,172,2,0,2,1,7,1,1,3,0.989019754,219,167,3,38,21,17,1885,1216,669,25,16,9,1,99.75810353,NoArch
8bf393f510d8cf4f7afbc40e19b4f864d71b08b4,0,0,0,0,0,0,0,0,0,0,0,0,0,0,66,6,0,0,0,0,0,0,0,0,0,1,100,NoArch
0e03daf1139a1a8465d6e2a6b54490e2dfc2a9ef,1,1,1,0,0,0,0,6,8,181,1,1,0,768,92,1,121,121,0,4519,4519,0,12,12,0,0,100,NoArch
60ffdbbe57ec4863562cc2d88eac3349156aef3f,0,0,0,0,0,0,0,0,0,0,0,0,0,0,95,9,0,0,0,0,0,0,0,0,0,1,100,NoArch
760edfb88fe6b8c3e10ccdacb00cb65f3f73d55a,1,49,42,7,0,0,0,6,42,80,1,1,0,588,29,2,87,88,1,3561,3567,6,26,26,0,1,100,NoArch
21be23120e8a0c789c809706dd3368f4f4442c05,1,5,0,5,0,0,0,4,20,63,1,1,0,430,156,3,47,46,1,2007,1984,23,3,3,0,1,100,NoArch
dd4f990e1fbc603e40a6050ecfbb9948d2b2e11d,0,0,0,0,0,0,0,0,0,0,0,0,0,0,208,0,0,0,0,0,0,0,0,0,0,1,100,NoArch
ef14edda93c1eacbb0a2985c2c79eb8f09d15a5d,17,197,203,6,0,0,0,2,56,391,1,7,3.829127382,4606,196,11,630,626,4,26287,25829,458,217,215,2,1,100,NoArch
f4778c17c8282abaf0c958e3d01b6048b34bfda6,0,0,0,0,0,0,0,0,0,0,0,0,0,0,71,9,0,0,0,0,0,0,0,0,0,1,100,NoArch
04b2910620aa1e8998b38a060c62e692e278a574,3,53,7,46,0,0,0,5,22,498,1,3,1.300202946,925,32,1,96,88,8,4105,3851,254,32,31,1,4,100,NoArch
8db809bba136a7bf601b7702c7688efc12193e08,1,5,11,6,0,0,0,6,12,666,1,1,0,126,39,1,16,19,3,660,706,46,2,2,0,1,100,NoArch
b3a6fb3d950d1128fe2caf26faf557cef3d3b615,1,1,1,0,0,0,0,2,2,667,1,1,0,456,242,7,13,13,0,1745,1745,0,11,11,0,1,100,NoArch
5b90bc36922c9e604bc7a0df7209ce4d16b7b2d7,1,2,0,2,0,0,0,1,2,33,1,1,0,81,193,3,17,16,1,269,263,6,10,9,1,1,100,NoArch
401433e3742bdd88298b0f7e19a5b1bf47f8aa85,5,15,10,5,0,0,0,1,3,99,1,2,2.13366069,590,200,3,80,80,0,2764,2764,0,19,19,0,1,100,NoArch
0bbb1fae9620780f367cd60a507dab7308747578,1,1,1,0,0,0,0,7,16,1658,1,1,0,112,159,2,11,11,0,519,519,0,4,4,0,1,100,NoArch
d3d753677a5389aca236887a8b82e8ebbec33de0,1,8,0,8,0,0,0,5,15,697,1,1,0,428,9,2,90,90,0,2576,2576,0,34,34,0,0,100,NoArch
4e31a10f999e0cd35749415d8d14bf209d79addf,0,0,0,0,0,0,0,0,0,0,0,0,0,0,259,4,0,0,0,0,0,0,0,0,0,1,100,NoArch
6365dfaf4f341c995b7da351f017775e3ad4a561,3,8,2,6,0,0,0,5,28,404,1,1,1.485475297,480,173,3,56,54,2,2673,2656,17,12,12,0,1,100,NoArch
b80945ed43bc24db252b3d109cd7d75b2e639cf0,1,0,589,589,0,1,1,5,10,442,1,1,0,589,72,1,0,96,96,0,3250,3250,0,18,18,1,99.90592662,NoArch
459f74df3bbacacead9753194c944387e8359062,1,1,1,0,0,0,0,2,2,1166,1,1,0,1858,51,3,219,219,0,8420,8414,6,67,67,0,1,100,NoArch
cec69a899581757039b1de4ff9eb087816c22cdb,3,65,12,53,0,0,0,8,22,3124,1,1,1.443698674,656,31,0,90,77,13,2746,2427,319,32,29,3,1,100,NoArch
3e960180336a2c8bf9c745186835735c86a1008c,2,2,4,2,0,0,0,6,19,550,1,2,0.918295834,646,59,13,99,99,0,3130,3130,0,19,19,0,1,100,NoArch
469461c2ed395cf9f868e4ea759f707d4a4477eb,2,1,12,11,0,0,0,3,17,1050,1,2,0.619382195,211,8,2,10,10,0,1039,1147,108,5,5,0,3,99.78177851,NoArch
af65aac660e70ce6f4646421334965c876a95f34,1,57,41,16,0,0,0,3,16,33,1,1,0,356,148,1,38,37,1,1651,1595,56,3,3,0,1,100,NoArch
c7f29f9def6b3fa540b13d09341cdf914c2dae16,3,114,124,10,0,0,0,5,49,34,1,2,1.288043334,1781,16,0,305,304,1,10249,10302,53,71,71,0,1,100,NoArch
7344ba9358eb58067e8164f50ea84a531884b9db,0,0,0,0,0,0,0,0,0,0,0,0,0,0,56,10,0,0,0,0,0,0,0,0,0,1,100,NoArch
9e37db6a2ea512b00a99e056554e1733632d8566,1,2,1,1,0,0,0,6,34,100,1,1,0,342,25,6,48,47,1,2025,2015,10,14,14,0,1,100,NoArch
f2b977b670aefff850597e68d964d33a738ac57d,1,1,1,0,0,0,0,1,6,0,1,1,0,178,89,7,25,25,0,896,896,0,5,5,0,0,100,NoArch
8392ef63df8f2a038169e0f645a3d482294e0202,1,1,2,1,0,0,0,4,5,1577,1,1,0,39,245,0,2,2,0,104,134,30,1,1,0,1,100,NoArch
9669fa70b378d9c87dee6e1ca1cc2704e13e371d,0,0,0,0,0,0,0,0,0,0,0,0,0,0,88,6,0,0,0,0,0,0,0,0,0,1,100,NoArch
81d840ca7f5e9127b2bf7846a3a81d85dc2869ce,0,0,0,0,0,0,0,0,0,0,0,0,0,0,0,0,0,0,0,0,0,0,0,0,0,0,100,NoArch
47c4a85bebb6563f1405dad49f434e61fc854d77,0,0,0,0,0,0,0,0,0,0,0,0,0,0,163,2,0,0,0,0,0,0,0,0,0,1,100,NoArch
1fdab8292b7e0acf2f83adec49ec7b4369a771d7,17,220,215,5,0,0,0,4,10,59,1,14,2.383733839,2665,74,24,223,210,13,11681,11499,182,80,78,2,1,99.64961458,NoArch
c2fe21190d4b18cc491f78432f337fac46f555be,2,13,1,12,0,0,0,5,9,264,1,1,0.749595257,349,58,6,47,46,1,2169,2138,31,17,16,1,1,100,NoArch
fba0f11762112f456b3df4b749462dad9c1067a6,1,0,4,4,0,0,0,6,12,298,1,1,0,210,26,0,17,21,4,675,733,58,11,11,0,1,100,NoArch
f3f08f3c3a9a8c0e049a8c37b3d38ef7377f5069,1,1,2,1,0,0,0,1,2,60,1,1,0,653,87,5,81,81,0,2646,2648,2,32,32,0,1,100,NoArch
1fdab8292b7e0acf2f83adec49ec7b4369a771d7,17,220,215,5,0,0,0,4,10,59,1,14,2.383733839,2665,74,24,223,210,13,11681,11499,182,80,78,2,1,99.64961458,NoArch
8d211bd5637fb1065dab086d6b0565a07124b39b,0,0,0,0,0,0,0,0,0,0,0,0,0,0,93,8,0,0,0,0,0,0,0,0,0,0,100,NoArch
b63097ebc35d87579023eec6785e328c3ffb3d91,1,1,4,3,0,0,0,11,36,536,1,1,0,398,129,3,76,77,1,2157,2184,27,20,20,0,1,100,NoArch
a194c418c362412b46f4d8a8904079fcfeac2252,0,0,0,0,0,0,0,0,0,0,0,0,0,0,266,11,0,0,0,0,0,0,0,0,0,0,100,NoArch
04db6ec142f9e7460f2e9787de9274a67f061aa1,0,0,0,0,0,0,0,0,0,0,0,0,0,0,68,1,0,0,0,0,0,0,0,0,0,0,100,NoArch
167ba46cf545f5e1eed089f11c1c19e948c0baa6,1,4,11,7,0,0,0,10,32,941,1,1,0,355,83,4,46,47,1,1982,2006,24,8,8,0,1,100,NoArch
848014c3e17939018a7ad2529002047109120505,1,3,2,1,0,0,0,4,12,33,1,1,0,177,22,5,23,23,0,1147,1132,15,10,10,0,1,100,NoArch
d0d711310f08726ab44c767fbe6448ac07f428a0,1,1,1,0,0,0,0,5,6,1337,1,1,0,202,130,3,26,26,0,761,757,4,6,6,0,1,100,NoArch
9b68fcfcbfe6623637cfbc17fd24197adad99ddf,1,2,1,1,0,0,0,5,24,195,1,1,0,456,27,2,70,70,0,2791,2779,12,29,29,0,1,100,NoArch
47c4a85bebb6563f1405dad49f434e61fc854d77,0,0,0,0,0,0,0,0,0,0,0,0,0,0,163,2,0,0,0,0,0,0,0,0,0,1,100,NoArch
ae0608d14e9f7cb56f4b4064ededd8cb1c8c9bea,1,2,4,2,0,0,0,2,2,1513,1,1,0,145,14,5,23,23,0,888,894,6,9,9,0,1,99.71160779,NoArch
b7f45e64fd7fec3ba29c0876196f7d36f960bb66,1,1,1,0,0,0,0,2,3,14,1,1,0,349,82,0,44,43,1,1788,1782,6,22,22,0,0,100,NoArch
71f0471b8e20774f241560440359b8b4702fbac4,0,0,0,0,0,0,0,0,0,0,0,0,0,0,217,3,0,0,0,0,0,0,0,0,0,1,100,NoArch
5921853252e171438579fd4c0b7c4aa2020ed92f,1,8,9,1,0,0,0,2,4,537,1,1,0,93,227,0,10,10,0,359,344,15,1,1,0,1,100,NoArch
212c4a127d1e5d1abbe654082c9e166817c73b79,0,0,0,0,0,0,0,0,0,0,0,0,0,0,78,28,0,0,0,0,0,0,0,0,0,0,100,NoArch
dfbda722d168c90ee9a25cdf2294bb63bfc8619d,1,25,8,17,0,0,0,5,8,45,1,1,0,304,1,0,33,31,2,1260,1185,75,11,11,0,1,100,NoArch
ce295cf454274fcf4f8a0a5a5cbc886a078332ec,0,0,0,0,0,0,0,0,0,0,0,0,0,0,162,0,0,0,0,0,0,0,0,0,0,1,100,NoArch
0efeb7317d97d25356ef74fdbf303608f6cc7e97,0,0,0,0,0,0,0,0,0,0,0,0,0,0,49,7,0,0,0,0,0,0,0,0,0,0,100,NoArch
b754b90761743e07cd63dd9e8d8713e631d08371,2,93,2,91,0,0,0,1,6,118,1,2,0.147310667,272,168,4,42,28,14,2262,1690,572,12,11,1,1,100,NoArch
6b630462e73129f397b1f43301a2aa9001d60ed8,0,0,0,0,0,0,0,0,0,0,0,0,0,0,112,13,0,0,0,0,0,0,0,0,0,0,100,NoArch
d37dea1649860a67b8e31b66be1465bbc7d75d6e,0,0,0,0,0,0,0,0,0,0,0,0,0,0,171,2,0,0,0,0,0,0,0,0,0,0,100,NoArch
6b630462e73129f397b1f43301a2aa9001d60ed8,0,0,0,0,0,0,0,0,0,0,0,0,0,0,112,13,0,0,0,0,0,0,0,0,0,0,100,NoArch
13977461205dac54c26089d81cf5e7afe54d8571,2,7,0,7,0,0,0,9,23,889,1,1,0.985228136,744,23,3,110,108,2,3759,3711,48,27,27,0,1,100,NoArch
5327e966d2a52513206466844018a78dea0f8de0,1,1,1,0,0,0,0,11,54,144,1,1,0,713,86,4,96,96,0,4291,4291,0,29,29,0,1,100,NoArch
5327e966d2a52513206466844018a78dea0f8de0,1,1,1,0,0,0,0,11,54,144,1,1,0,713,86,4,96,96,0,4291,4291,0,29,29,0,1,100,NoArch
f3f08f3c3a9a8c0e049a8c37b3d38ef7377f5069,1,1,2,1,0,0,0,1,2,60,1,1,0,653,87,5,81,81,0,2646,2648,2,32,32,0,1,100,NoArch
a67c6703843853b50b5b8783bd1a8f7059ddd5ca,0,0,0,0,0,0,0,0,0,0,0,0,0,0,61,9,0,0,0,0,0,0,0,0,0,0,100,NoArch
b4a1cd9b02f383ea93fb207293bb567d6eb12222,1,34,22,12,0,0,0,1,2,932,1,1,0,289,91,9,48,47,1,1172,1136,36,20,19,1,1,100,NoArch
cc7373e27dd34b4b50a0f800fbfb97f5b1ace87b,2,34,0,34,0,0,0,1,2,0,1,1,1,234,3,3,20,20,0,1347,1347,0,6,6,0,1,100,NoArch
5d26a98a748a4b75850a189d06cfae6b150d87ff,0,0,0,0,0,0,0,0,0,0,0,0,0,0,3,2,0,0,0,0,0,0,0,0,0,1,100,NoArch
f7ef04dca1b763e86502a3b23064520ded39181e,1,3,2,1,0,0,0,1,2,89,1,1,0,161,68,0,18,17,1,854,839,15,4,4,0,1,100,NoArch
1b15606816bf76dca22df7ff644e36db0e145eb6,6,55,14,41,0,0,0,4,25,661,1,5,1.881072147,2124,137,5,283,279,4,9110,8970,140,60,60,0,1,100,NoArch
ea4da6200b79a1c62ebc3b9c8fb2e452f3fcb31b,1,5,1,4,0,0,0,4,11,41,1,1,0,381,54,2,43,42,1,1447,1400,47,10,10,0,0,100,NoArch
511fab9370828fee4bbc5b28027792738d7f9f15,11,52,769,717,0,3,3,0,4,108,1,9,2.346110031,1913,19,6,130,179,49,5606,8356,2750,21,48,27,0,99.12383178,NoArch
7da4d6e4e488dffb0a29b61b975d8ddf513a1311,0,0,0,0,0,0,0,0,0,0,0,0,0,0,55,8,0,0,0,0,0,0,0,0,0,2,100,NoArch
e04680d5cb78396eec44a9826609b23c3be08428,1,1,0,1,0,0,0,9,38,194,1,1,0,388,71,0,66,66,0,2535,2526,9,13,13,0,1,100,NoArch
3a2e9130cbd2dbb361666bd7f21c9885e4ddbef5,0,0,0,0,0,0,0,0,0,0,0,0,0,0,25,3,0,0,0,0,0,0,0,0,0,0,100,NoArch
c88b191c84d5d8fbad32b29eb77234dbd440c1b2,7,320,7,313,2,0,2,1,5,184,1,7,1.280557524,597,6,6,65,53,12,3374,2573,801,18,10,8,0,99.70811442,NoArch
870d866b4fa62004f552ad7c38467b6d21b25462,1,1,1,0,0,0,0,11,96,14,1,1,0,1398,122,2,237,237,0,8026,8025,1,56,56,0,1,100,NoArch
ea98496e33d2da78068aeecd6c52370858d348c1,0,0,0,0,0,0,0,0,0,0,0,0,0,0,14,4,0,0,0,0,0,0,0,0,0,0,100,NoArch
f77ca03400f0630f4757f859e321a7e4d5c52831,0,0,0,0,0,0,0,0,0,0,0,0,0,0,11,0,0,0,0,0,0,0,0,0,0,0,100,NoArch
0a0ddff8f33df9999156f43b70a8a7c423ed8cc9,1,7,1,6,0,0,0,8,21,2203,1,1,0,126,72,5,17,17,0,701,701,0,3,3,0,1,100,NoArch
ce45896b42e1a13f788461439a9cb3b197a4ec27,2,5,5,0,0,0,0,2,9,582,1,2,0.721928095,825,81,10,78,78,0,2556,2556,0,24,24,0,0,100,NoArch
5de25972c7715167fc7fe5f355abb7c40124b7b4,2,14,2,12,0,0,0,3,7,664,1,1,0.811278124,558,176,0,93,90,3,2809,2765,44,58,55,3,0,100,NoArch
0e948a52a97bee8ce303fe032fd8b0e326adc8bd,1,54,28,26,0,0,0,9,78,65,1,1,0,1194,91,4,212,204,8,7000,6805,195,52,52,0,1,100,NoArch
2bc07749bf3ec41971bb3df46b22245bd09af549,1,2,2,0,0,0,0,13,67,308,1,1,0,812,187,3,110,108,2,4799,4767,32,30,30,0,1,100,NoArch
590ad02aea95c1dcb9c6ad25de1e38a815c7fa82,0,0,0,0,0,0,0,0,0,0,0,0,0,0,78,4,0,0,0,0,0,0,0,0,0,1,100,NoArch
72ad76184d212a07842fc06d555a631e849a038d,0,0,0,0,0,0,0,0,0,0,0,0,0,0,234,3,0,0,0,0,0,0,0,0,0,1,100,NoArch
f3f08f3c3a9a8c0e049a8c37b3d38ef7377f5069,1,1,2,1,0,0,0,1,2,60,1,1,0,653,87,5,81,81,0,2646,2648,2,32,32,0,1,100,NoArch
13d2eb8e5d23910ad5f6490dd7bc697db3e0fc54,3,268,0,268,3,0,3,1,1,0,1,1,1.289906727,0,64,4,24,0,24,1321,0,1321,8,0,8,1,99.22394678,NoArch
c96a55308d639de95083f090494f0a4a36be54e0,0,0,0,0,0,0,0,0,0,0,0,0,0,0,11,0,0,0,0,0,0,0,0,0,0,1,100,NoArch
3db93dba6186d49750021fc4278a7813935f32fb,0,0,0,0,0,0,0,0,0,0,0,0,0,0,161,0,0,0,0,0,0,0,0,0,0,1,100,NoArch
b5126db974cee684af1763aac5d03933376c4523,1,26,0,26,0,0,0,3,6,135,1,1,0,285,16,9,44,40,4,1662,1537,125,9,8,1,0,100,NoArch
f5e430e557cc3768261ab86617b1b1589e120d92,1,1,1,0,0,0,0,3,6,0,1,1,0,145,90,4,9,9,0,733,733,0,5,5,0,0,100,NoArch
a67c6703843853b50b5b8783bd1a8f7059ddd5ca,0,0,0,0,0,0,0,0,0,0,0,0,0,0,61,9,0,0,0,0,0,0,0,0,0,0,100,NoArch
4ae4e35d2e5bd656e7d172eead542d7f844a5766,0,0,0,0,0,0,0,0,0,0,0,0,0,0,29,1,0,0,0,0,0,0,0,0,0,0,100,NoArch
529d32f9a330beff573570a8995e90711bd7395d,2,21,0,21,0,0,0,2,49,76,1,2,0.958711883,410,163,4,54,51,3,2248,2142,106,14,13,1,2,100,NoArch
4536555cf7b33ab14f066b7553ce7cd6acf05f65,5,97,104,7,0,0,0,5,11,2127,1,4,1.268748587,922,45,12,108,110,2,3681,3640,41,35,35,0,1,100,NoArch
5aea6674041f34b5042291175bcc8c07e0955c47,0,0,0,0,0,0,0,0,0,0,0,0,0,0,78,0,0,0,0,0,0,0,0,0,0,1,100,NoArch
14e43b4a71dd38365c343ac81f27608dda63dcf8,1,19,17,2,0,0,0,2,4,0,1,1,0,88,2,2,7,7,0,581,552,29,5,5,0,1,100,NoArch
d0dec0295666de457c8dce871c7637f1b3ebe766,3,25,25,0,0,0,0,3,9,114,1,2,1.478845536,547,37,3,36,36,0,1339,1339,0,21,21,0,1,100,NoArch
23c7761aff830db82a1e44b84bf81265639c9a26,11,1236,583,653,2,0,2,10,33,364,1,2,2.154391938,2106,1,0,352,267,85,12994,9549,3445,129,95,34,1,99.41520468,NoArch
ddcdad641a90c01eab6471efa623efe36d6c7a51,3,49,2,47,0,0,0,3,11,2,1,3,0.783613882,576,46,5,77,72,5,3133,2832,301,26,25,1,0,100,NoArch
a14c6ea415ca18a0bc72ad393585103d7f7d52d6,0,0,0,0,0,0,0,0,0,0,0,0,0,0,72,1,0,0,0,0,0,0,0,0,0,0,100,NoArch
1add0135722361358e4827e4166f3770dc4df3ac,1,1,1,0,0,0,0,2,2,123,1,1,0,192,32,5,12,12,0,609,609,0,12,12,0,1,100,NoArch
122f3cc3402d5edf158a6f3d7264346674cad4c6,0,0,0,0,0,0,0,0,0,0,0,0,0,0,143,0,0,0,0,0,0,0,0,0,0,1,100,NoArch
32f7cafad67f096f25f01140614ab8906334bef4,2,19,4,15,0,0,0,6,40,2313,1,2,0.987692509,395,78,0,57,51,6,2517,2418,99,8,8,0,1,100,NoArch
d4778aa03495a1bf056716d53559e2265ae85e69,1,8,2,6,0,0,0,1,5,8,1,1,0,172,86,4,25,24,1,896,877,19,5,5,0,0,100,NoArch
8979a442d68415e0b0aa2d61c54561167dbc5612,0,0,0,0,0,0,0,0,0,0,0,0,0,0,260,5,0,0,0,0,0,0,0,0,0,0,100,NoArch
8d7c9dc134d3cd7029d2ff8ba03a46718d31adb8,4,30,18,12,0,0,0,5,12,3232,1,3,1.06556624,616,244,7,82,79,3,2476,2359,117,13,11,2,1,100,NoArch
7764803091a5880997b4d9308db82ce46242747d,0,0,0,0,0,0,0,0,0,0,0,0,0,0,131,12,0,0,0,0,0,0,0,0,0,0,100,NoArch
8443fb7ddf68f6a2c7b0803b86d64658d1a56a8c,1,18,1,17,0,0,0,8,28,1087,1,1,0,882,16,1,160,154,6,5454,5299,155,36,36,0,1,100,NoArch
0a613b7693a7d2e15cfd381bcea69491ce1b695a,0,0,0,0,0,0,0,0,0,0,0,0,0,0,25,4,0,0,0,0,0,0,0,0,0,1,100,NoArch
292902a434fac911894b578ba8f5eb41fbb7abc0,0,0,0,0,0,0,0,0,0,0,0,0,0,0,53,5,0,0,0,0,0,0,0,0,0,0,100,NoArch
f5c146f70738528cf3000c052df8bd499e8cad6d,5,0,5,5,0,0,0,3,7,0,1,3,2.321928095,1249,13,7,203,203,0,7113,7170,57,67,67,0,0,100,NoArch
20efa46b66005d84bf007cd1731f46e331dbabd6,1,4,0,4,0,0,0,5,19,1388,1,1,0,327,33,6,58,56,2,2069,2039,30,8,8,0,1,100,NoArch
0508944f9bfbbf5f6b6898a95d156d2977ab3137,1,1,1,0,0,0,0,5,21,156,1,1,0,619,130,0,102,102,0,4720,4720,0,19,19,0,1,100,NoArch
72954c64209f0eba5eb01cb995e5c6e1eb32ce04,11,28,4,24,0,0,0,3,16,8,1,5,3.316428032,2432,108,10,310,294,16,13936,13824,112,122,106,16,0,100,NoArch
85f295ffecf7bf6986f468b391303a6674334ccd,1,1,1,0,0,0,0,5,7,933,1,1,0,90,19,4,11,11,0,478,478,0,4,4,0,1,100,NoArch
4e33781584bcf5d57182ff22835b9a949dd87e6b,0,0,0,0,0,0,0,0,0,0,0,0,0,0,99,15,0,0,0,0,0,0,0,0,0,0,100,NoArch
7232641bba876a1b423061331bb047be2c4cbf2a,1,1,0,1,0,0,0,12,39,487,1,1,0,286,139,0,27,27,0,1176,1169,7,12,12,0,1,100,NoArch
d6e2d0cb3a175f395bf576ef8e074a854bf92434,2,798,0,798,2,0,2,1,1,0,1,2,0.540920114,0,47,5,118,0,118,3713,0,3713,79,0,79,0,99.39637827,NoArch
ff5a122af20bbcafa8b770fbc72113c4a17e4da2,0,0,0,0,0,0,0,0,0,0,0,0,0,0,20,14,0,0,0,0,0,0,0,0,0,0,100,NoArch
f8b9f42560d0fa7987da5a8cda3e4ad5f7f78241,0,0,0,0,0,0,0,0,0,0,0,0,0,0,153,0,0,0,0,0,0,0,0,0,0,1,100,NoArch
9ab5c1a5ccf03b461afbda220cc864cb94f7ce2a,0,0,0,0,0,0,0,0,0,0,0,0,0,0,255,7,0,0,0,0,0,0,0,0,0,0,100,NoArch
6b8586a47ef0ee52ad220f2763d5d9082e69070f,0,0,0,0,0,0,0,0,0,0,0,0,0,0,219,5,0,0,0,0,0,0,0,0,0,1,100,NoArch
a14c6ea415ca18a0bc72ad393585103d7f7d52d6,0,0,0,0,0,0,0,0,0,0,0,0,0,0,72,1,0,0,0,0,0,0,0,0,0,0,100,NoArch
2c4b01b74b0275169b42384fa32594543fb5082f,2,217,0,217,2,0,2,1,1,0,1,2,0.699248942,0,48,0,26,0,26,963,0,963,8,0,8,1,99.54285714,NoArch
797e70361364ec51825c16d6bdf844fc5f1fc834,0,0,0,0,0,0,0,0,0,0,0,0,0,0,258,8,0,0,0,0,0,0,0,0,0,0,100,NoArch
3988e7cf047fb862264c670979eb52d99c83fbed,2,65,13,52,0,0,0,5,24,138,1,1,0.98285869,1215,15,5,226,226,0,8967,8437,530,28,28,0,0,99.96044304,NoArch
ecb86f4de0209c73e5b00fa0df8d4c6f58c592bf,1,13,0,13,0,0,0,6,23,50,1,1,0,864,74,2,152,149,3,5234,5151,83,36,36,0,1,100,NoArch
01bb1b68f3cff31255073c0574363cff00732665,13,1868,0,1868,13,0,13,1,1,0,1,2,3.388217745,0,12,7,138,0,138,5855,0,5855,55,0,55,1,96.18834081,Arch
e79930a8e82dc7fb70ff37ef79fa18623a74cb88,3,283,0,283,3,0,3,1,1,0,1,2,1.538540544,0,13,6,43,0,43,1649,0,1649,8,0,8,1,94.43207127,Arch
b37151c29db91e7f0809fd7402cebe853f9b386d,1,68,83,15,0,0,0,1,2,0,1,1,0,119,14,7,9,29,20,626,827,201,2,2,0,0,95.69835369,Arch
ed0feca27cc05904c41ea66ba73eca939c65080c,6,4,252,248,0,1,1,1,2,6,1,1,0.632275043,1083,18,11,76,86,10,3151,3652,501,17,23,6,0,97.3354232,Arch
da11a28cf6a27471eae8fc9acaae4e5bd77881b7,30,222,2582,2360,0,21,21,0,5,46,1,11,4.471276196,4635,22,0,256,449,193,9827,18148,8321,89,165,76,0,94.82273495,Arch
7695a1e3d961df823d9cbb3bc7979d20df6c8dba,30,2584,224,2360,21,0,21,1,7,41,1,11,4.47044029,2275,27,0,449,256,193,18148,9827,8321,165,89,76,0,94.82273495,Arch
2f183846607a13ae7925a65a8ca4a865a9d76684,30,222,2582,2360,0,21,21,0,5,46,1,11,4.471276196,4635,27,0,256,449,193,9827,18148,8321,89,165,76,0,94.82273495,Arch
33c59b111f6082f1840d7fe9ad587cc5b389ffa6,30,2584,224,2360,21,0,21,1,7,41,1,11,4.47044029,2275,28,1,449,256,193,18148,9827,8321,165,89,76,1,94.82273495,Arch
680ebf3774832e878707dbcc159a7c804c3b56a2,30,222,2582,2360,0,21,21,0,5,46,1,11,4.471276196,4635,28,1,256,449,193,9827,18148,8321,89,165,76,1,94.82273495,Arch
945af32004c63e23419d23fa3ccd9ab67d23226e,31,2599,241,2358,21,0,21,1,7,43,1,12,4.509153208,2503,23,0,465,270,195,19212,10831,8381,167,91,76,1,94.82273495,Arch
168abf4fe36a48fac75d363e23fdd8e03b9b450f,30,222,2582,2360,0,21,21,0,5,46,1,11,4.471276196,4635,23,1,256,449,193,9827,18148,8321,89,165,76,1,94.82273495,Arch
7552778047107b1c75a40c370fad7ae17a25ea30,33,2587,228,2359,21,0,21,1,7,75,1,14,4.488291361,3558,12,0,616,423,193,24196,15884,8312,220,144,76,0,94.82273495,Arch
79d4202995ef90f91334635db220d28b72a2a428,34,231,2594,2363,0,21,21,0,5,49,1,14,4.511974883,6522,24,2,492,685,193,18764,27076,8312,166,242,76,0,94.82273495,Arch
4cc66e2f0d443be24888ada8747eaef3c251a2b0,38,3005,307,2698,24,0,24,1,7,77,1,16,4.711144501,4289,30,0,729,512,217,28665,19277,9388,262,172,90,1,94.05496354,Arch
bea5ce35ae3c18e4eddeee4d39e7ed2a1959f2d3,38,311,3009,2698,0,24,24,0,5,55,1,16,4.710133103,6987,26,3,512,729,217,19277,28665,9388,172,262,90,0,94.05496354,Arch
aec754c4149453dc1111eac4825bee5337226794,38,3005,307,2698,24,0,24,1,7,77,1,16,4.711144501,4289,24,1,729,512,217,28665,19277,9388,262,172,90,0,94.05496354,Arch
158a2095e2ff7d2075330c7b351bdf1682fdbb72,38,311,3317,3006,0,24,24,0,5,55,1,16,4.653340365,7295,27,4,512,757,245,19277,29838,10561,172,268,96,0,94.05496354,Arch
0ec4c9559cf2d722c248259fcf929025da0d942a,38,3317,311,3006,24,0,24,1,7,72,1,16,4.654467842,4289,25,2,757,512,245,29838,19277,10561,268,172,96,0,94.05496354,Arch
f01227157f85993bab9a50957eebecf668fee462,38,311,3292,2981,0,24,24,0,5,55,1,16,4.652962116,7270,32,9,512,753,241,19277,29729,10452,172,267,95,0,94.05496354,Arch
38e7f0a824b87c66cb414ca2bda94b9ecdd54175,38,3293,312,2981,24,0,24,1,7,65,1,16,4.656969318,4289,26,2,753,512,241,29725,19277,10448,267,172,95,0,94.05496354,Arch
5165c046762ddff50ef8edbdecc865a21d8b4d6a,38,311,3292,2981,0,24,24,0,6,64,1,16,4.652962116,7270,33,7,512,753,241,19273,29725,10452,172,267,95,0,94.05496354,Arch
6338fe23060c5c90285a3f11592901a78245109b,38,3292,311,2981,24,0,24,1,7,65,1,16,4.654097416,4289,27,3,753,512,241,29725,19273,10452,267,172,95,1,94.05496354,Arch
21523b7fe722f0500c7107429ed3cee89541c602,28,164,57,107,1,0,1,3,8,310,1,24,3.715988687,5881,39,3,729,721,8,29043,28625,418,215,207,8,1,94.33471933,Arch
21139383acf4bdb4338f6c2a21f1fd490fc5aabe,75,553,3823,3270,0,26,26,2,6,80,1,43,5.230960833,14057,35,0,1310,1574,264,49559,60760,11201,436,551,115,1,92.49732047,Arch
eb291f39348598403db03f9fc97f1dd8abb6ba5f,75,3823,553,3270,26,0,26,3,8,162,1,43,5.23201255,10787,28,0,1574,1310,264,60760,49559,11201,551,436,115,1,92.49732047,Arch
05ddf3977beb48335659330c62368c5622a9d8bf,75,553,3823,3270,0,26,26,2,6,80,1,43,5.230960833,14057,36,1,1310,1574,264,49559,60760,11201,436,551,115,0,92.49732047,Arch
5943b9f1d6f17c0c95ca169ac67b7da379d2bef8,221,15402,5391,10011,71,13,84,3,8,179,1,58,6.689871287,31404,81,0,5004,4008,996,184892,142756,42136,1998,1596,402,0,75.65656566,Arch
efaf6597287b5ffde32b6794ef4ac3f83918ba6d,222,5321,15737,10416,13,80,93,2,7,35,1,58,6.712641761,41572,37,2,3882,5194,1312,138589,191222,52633,1518,2098,580,0,75.60225525,Arch
2860bf1440cb2875a91b5af30662e70ed28368f6,222,15583,5402,10181,72,13,85,3,8,179,1,58,6.702660309,31404,43,7,5032,4008,1024,185734,142756,42978,2006,1596,410,1,75.52483359,Arch
b8bd3f133b29d794833bdcffc1bfd0d41d421066,80,681,17258,16577,0,46,46,2,9,443,1,22,5.143717247,24188,31,2,993,3154,2161,38041,114999,76958,279,936,657,0,83.94055609,Arch
b11775690d5c4741e719fd9bfa4da799e3db52a0,15,798,20,778,6,0,6,2,10,66,1,7,3.093820497,1847,32,3,385,265,120,13907,9314,4593,125,92,33,1,92.6221336,Arch
a0c57403359e34039a589596fdeadbc6ef105215,275,21646,16409,5237,52,82,134,2,7,32,1,63,6.94497628,39812,38,0,5756,5028,728,204517,184834,19683,2037,1996,41,1,72.01492537,Arch
46295b22a4184301a1b16c33fe2aae78b1a76ae7,273,16192,21724,5532,74,53,127,3,10,254,1,63,6.932761468,45241,35,6,4859,5885,1026,178940,208773,29833,1901,2118,217,0,72.01492537,Arch
37d3a9764c7da33c96657e83c3978f191ecdf603,14,24,1378,1354,0,7,7,4,6,542,1,11,2.115127301,2121,30,0,51,194,143,2950,10010,7060,29,63,34,0,94.7761194,Arch
2582191cd2e82f9cab2fc9eabe9a28ee4442d64a,297,23758,17414,6344,61,84,145,2,7,24,1,71,7.072805311,41509,39,0,6055,5118,937,216339,187990,28349,2139,2071,68,1,71.3283208,Arch
7ab2f64165224219f1b9c864893f7bd9b5856b3f,295,17167,24321,7154,76,64,140,3,12,244,1,71,7.068927569,48059,42,1,4950,6186,1236,182107,220661,38554,1975,2222,247,1,71.3283208,Arch
329ff64e9d7295aff108f85e9a8103f5e5f8f398,183,2796,1809,987,0,0,0,2,13,225,1,70,6.769224331,39013,44,3,5242,5113,129,190804,184573,6231,1969,1890,79,1,93.62400375,Arch
b6b05637e2124152b77917985734bfa9e3305af9,20,1668,625,1043,3,0,3,1,4,28,1,3,2.512866074,4182,0,0,676,538,138,23328,19062,4266,327,293,34,1,93.8253012,Arch
1d47935e78072239bffc39c9436ade75f8e273b6,75,0,158,158,0,0,0,2,11,86,1,19,5.888737765,14250,10,4,1866,1866,0,65393,66711,1318,798,798,0,0,92.30769231,Arch
25437bc825d50715dcc9a289a1b4c8fbbc6aced1,292,1400,23979,22579,2,132,134,1,14,78,1,74,6.875979139,51511,100,2,3758,6641,2883,137127,234535,97408,1393,2717,1324,1,75.47062179,Arch
105207a94a66cd59b0611c539daa361de03ac9f6,28,0,53,53,0,0,0,4,11,108,1,21,4.336437323,5129,16,10,559,559,0,23273,23746,473,154,154,0,0,89.79278588,Arch
085acccad98278fd1187f24be59822f07671e4ad,50,1326,660,666,7,2,9,4,15,41,1,31,4.598484456,8692,54,5,1103,1079,24,44147,41324,2823,395,382,13,1,89.84007526,Arch
d6b9755fa599b0036210b38d4a36fe97c7fb106c,14,57,15,42,1,0,1,1,18,2,1,6,3.069647413,2680,109,11,317,315,2,15670,15499,171,132,130,2,1,92.21824687,Arch
712191fb5392773d0710ae2087836f39459f30b5,4,438,0,438,4,0,4,1,1,0,1,2,1.951920093,0,60,11,50,0,50,2009,0,2009,14,0,14,1,95.16949153,Arch
c1fcc22f319ec83407b9d43752836c0b810ae9aa,1,23,15,8,0,0,0,1,2,2,1,1,0,64,61,12,3,5,2,342,293,49,2,4,2,0,95.34883721,Arch
9d6a3f1b808a8778f18c53e0a3e8120d1aac104a,379,39405,14637,24768,158,68,226,2,7,35,1,92,7.559217848,36339,40,0,7996,4551,3445,274538,163122,111416,2939,1722,1217,0,59.287183,Arch
998778cdf98335caa88ce27226a1779312e958ab,379,14513,39976,25463,65,163,228,3,20,253,1,92,7.565284251,61217,71,22,4546,8002,3456,162823,274846,112023,1717,2945,1228,0,58.73452545,Arch
8b4cd29a23eb209b0b1973d1d035bbd248c0c5c1,3,96,74,22,0,0,0,2,4,152,1,2,1.297419344,375,73,24,39,40,1,2101,1865,236,20,21,1,0,92.47889486,Arch
dedac6457c9b875812898c0a7664805ddaa43e84,385,39557,15216,24341,158,71,229,2,7,35,1,93,7.599333683,37551,42,0,8067,4676,3391,276840,167539,109301,2969,1769,1200,0,61.26182965,Arch
6b8b7add2863045589e100f6c8d8550a0eb98da4,390,15858,40812,24954,76,168,244,3,22,265,1,94,7.635202427,61892,128,10,4671,8162,3491,167205,280364,113159,1764,3001,1237,0,61.26182965,Arch
14c119d8db79e2ccb78006b648033d6aad708cb0,390,40812,15891,24921,168,76,244,2,7,34,1,94,7.634871343,36971,44,2,8067,4776,3291,276840,170999,105841,2969,1803,1166,0,61.11111111,Arch
9fd371ca329e1baee2e4a3b3e8558fd71f216679,390,15892,40813,24921,76,168,244,3,22,265,1,94,7.635910371,61892,32,0,4680,8164,3484,167434,280387,112953,1768,3001,1233,1,61.11111111,Arch
ea9eb16576ed00871e573907e2592d960500f32e,390,40812,15900,24912,168,76,244,2,7,36,1,94,7.635528178,36980,47,5,8069,4779,3290,276863,171107,105756,2969,1804,1165,0,61.11111111,Arch
449ae6a2af59f6ea889996ce5aeee365d34d66ba,390,15901,40813,24912,76,168,244,3,22,263,1,94,7.636567026,61892,86,7,4681,8164,3483,167519,280387,112868,1769,3001,1232,1,61.11111111,Arch
3e305c55d3a562b1fadbc441f3ccfb45346e1f96,390,40814,15914,24900,168,76,244,2,7,36,1,94,7.635768682,36992,79,0,8069,4785,3284,276863,171231,105632,2969,1804,1165,0,61.11111111,Arch
a75c525658758134920e8dadd38c9287951d19b3,390,15925,40815,24890,76,168,244,3,22,263,1,94,7.637010894,61892,59,5,4690,8164,3474,167739,280387,112648,1769,3001,1232,1,61.11111111,Arch
928d6739bd7489aedf4efb76d43c33d4168315ca,3,22,14,8,0,0,0,2,8,86,1,1,1.251629167,432,61,7,60,59,1,2492,2489,3,27,27,0,1,91.75891759,Arch
5a326cd4e94820cdcae586074bba8f78f12d82f1,399,41037,16790,24247,168,82,250,2,7,37,1,100,7.676591575,37889,49,2,8088,4861,3227,277507,174145,103362,2973,1851,1122,0,65.36193029,Arch
1f2af77496abc0879e09e7adf52ee1b8472736d4,397,16813,41030,24217,82,168,250,3,23,267,1,100,7.676527295,61947,98,9,4745,8164,3419,169857,280237,110380,1802,2992,1190,1,65.36193029,Arch
08438d51db849e84db78307ad9b8751397993f77,12,38,13,25,0,0,0,1,1,0,1,9,3.530610648,1523,107,17,185,185,0,6459,6223,236,77,77,0,0,95.64823209,Arch
3fb3f84e62a3bbb536ba0a85ee0dc0347f2227e4,404,41809,17639,24170,174,88,262,2,7,38,1,104,7.727058231,37808,52,4,8069,4958,3111,276763,177993,98770,2960,1871,1089,0,66.16577799,Arch
7280aa5f13e3c21325b17e81922a340c60f93adb,404,17640,41810,24170,88,174,262,3,23,266,1,104,7.728048438,61978,108,18,4746,8273,3527,170344,284231,113887,1803,3025,1222,0,66.16577799,Arch
ba372da378d8b7067e5799445c5023f4f07d2937,10,93,16,77,1,0,1,3,7,280,1,9,3.082764057,346,110,20,0,0,0,755,624,131,0,0,0,0,95.63965446,Arch
1ec2b4554ed831f69a99b52694573bc096b1ae2b,407,41811,17720,24091,174,89,263,2,7,34,1,104,7.733967118,38657,54,5,8133,5025,3108,278282,179661,98621,2990,1901,1089,0,66.36363636,Arch
0c10d8be5c8ef28c9fade453e93b03d9b413533e,407,17721,41812,24091,89,174,263,3,23,269,1,104,7.734963257,62748,133,3,4813,8337,3524,172012,285750,113738,1833,3055,1222,0,66.36363636,Arch
f12d0442ebcf6a028f7ff007bbf9cbca312945f1,40,365,217,148,0,0,0,5,47,449,1,29,4.333935623,7150,170,0,890,873,17,36768,35549,1219,301,297,4,1,93.62786746,Arch
8275b66cd93a60dc628dd4b79aad41f68b853795,1,71,0,71,1,0,1,1,1,0,1,1,0,0,171,1,12,0,12,443,0,443,10,0,10,0,92.6653883,Arch
16e0ceca8e061eedd73acf717bb66de98a42dbe3,7,70,22,48,0,0,0,5,16,420,1,5,2.570624679,1198,2,2,167,165,2,6175,5963,212,44,43,1,1,94.13156649,Arch
367b7e05c7c5d4ba9105c519149822deee8c2f89,5,676,1,675,4,0,4,1,10,121,1,4,1.670795361,243,17,1,97,36,61,4216,1038,3178,29,15,14,1,92.78350515,Arch
404a40e7f3a7376f54abaed4e9c6f057c9714106,4,262,153,109,1,0,1,6,17,87,1,4,1.433595064,786,13,0,134,131,3,4062,3842,220,30,26,4,1,96.44286349,Arch
0e098169657166dc791aa501f6fe72ea0f93e5b8,9,150,31,119,2,0,2,1,51,92,1,6,2.681163988,3256,10,10,564,552,12,20798,20132,666,121,111,10,1,96.32451815,Arch
159b3c4fb02c4c9ca6812dc90f9c3bc348e40b4a,2,68,81,13,0,0,0,4,25,434,1,1,0.992676976,493,11,11,78,83,5,3039,3106,67,21,21,0,1,92.33830846,Arch
339fc078890c06c2904b5527fc047d2f6c704410,3,7,3,4,0,0,0,3,23,270,1,3,1.521928095,678,29,6,81,80,1,2920,2896,24,24,24,0,1,95.12548263,Arch
5a30e60153b65fee98b7a5ade651eaf0ac33cf00,55,284,337,53,0,0,0,4,39,627,1,15,5.039057179,13472,30,7,2173,2187,14,68020,68041,21,580,586,6,1,90.64885496,Arch
2865e0e16f3ff8d2f817a727098bf7c85ba4baa2,8,882,0,882,8,0,8,1,1,0,1,5,2.896247758,0,31,3,84,0,84,3772,0,3772,54,0,54,1,94.87179487,Arch
40aa24ff6de299b56ffb522b5b8b53c808a19798,12,75,1282,1207,0,6,6,3,21,458,1,8,2.784294893,2745,18,0,164,353,189,6917,11742,4825,50,134,84,1,95.36679537,Arch
ef9765d13709a4621d245d88cfe95f9bf82b315b,9,270,99,171,0,0,0,6,52,344,1,7,2.272883426,2963,45,1,468,457,11,16997,16257,740,133,130,3,1,97.9990905,Arch
251a2b45818456f073d67b367f52f50ef738b034,13,86,56,30,1,0,1,2,53,477,1,6,2.96366595,4542,234,0,733,737,4,27720,27567,153,187,185,2,1,90.12833169,Arch
db83035b2448e5869b54821efaea3d907efa3804,5,170,4,166,1,0,1,5,23,996,1,4,0.964711152,1613,203,0,259,239,20,8410,7698,712,57,52,5,1,94.71057884,Arch
7d0a6c697f45193144a88df5b60cb1edd2424379,1,94,0,94,1,0,1,1,1,0,1,1,0,0,40,5,10,0,10,436,0,436,9,0,9,1,90.49462366,Arch
80f77888b58c6e581ae07e488305a3d016a42bcc,16,3903,62,3841,13,0,13,2,10,163,1,6,3.515404261,560,42,7,452,62,390,22144,2727,19417,201,25,176,1,93.37623013,Arch
dd0563795271449ab2e65080f8edbf48d1f89d7c,13,2586,0,2586,13,0,13,1,1,0,1,4,3.018066024,0,44,9,295,0,295,13959,0,13959,110,0,110,1,97.86504003,Arch
21acba4c11659490ce4f957bb298a4aa208a88f0,61,2594,1216,1378,18,0,18,2,40,1024,1,26,4.62177767,8424,63,1,1265,1085,180,51219,43119,8100,500,434,66,1,90.7550077,Arch
de1ea50abc0e0e011f48bfa49b3cb5e3b5ab8be0,6,49,247,198,0,1,1,5,16,701,1,3,1.014063714,1788,69,7,232,250,18,9179,10535,1356,85,91,6,1,97.82251438,Arch
4de08e67a204e99513e6158510921b99c5f155ff,58,0,7433,7433,0,58,58,1,16,2396,1,20,5.295273972,7433,246,9,0,688,688,0,28603,28603,0,315,315,0,91.99084668,Arch
fc37cf3733d24f54cef02338fc7e143bccfa37bf,4,606,1174,568,0,1,1,6,61,111,1,3,1.029096539,1957,254,15,210,307,97,7897,11135,3238,53,71,18,1,92.27895392,Arch
e9ffa7f9d437f9f3c5cf8dc89b380dd9772391bf,1,4,0,4,0,0,0,3,3,42,1,1,0,55,211,3,4,4,0,244,235,9,1,1,0,1,93.27698809,Arch
6bee302e4b61012a75eb4815786782c89f27a1a1,2,380,0,380,1,0,1,1,3,29,1,1,0.175565026,26,77,0,40,0,40,1916,44,1872,26,0,26,1,97.79411765,Arch
1742e5a8eee6e30faad250c29be4f1ae138e741c,351,14422,22013,7591,72,97,169,2,46,194,2,122,7.524487669,54774,0,0,6173,6906,733,223662,269342,45680,2138,2401,263,0,81.49680331,Arch
cc2ace2f540f23303f9c115e48dab973f0e479dd,40,16,5786,5770,0,32,32,6,24,3142,1,18,4.75478267,6256,28,1,61,667,606,2997,24840,21843,15,187,172,1,90.43478261,Arch
1b4ed9dc73b97ebc4d28395c53834fed8bbf33f4,143,123,19827,19704,1,122,123,1,41,1723,1,49,6.497697465,22105,247,2,242,2798,2556,11072,107431,96359,114,1071,957,1,81.24014714,Arch
3bf7de69a6abfb5e7c8e25b2aaa13414d68257a1,23,255,81,174,1,0,1,2,71,1057,1,9,4.267148488,8259,49,16,1029,1029,0,47136,45381,1755,352,351,1,1,95.52033081,Arch
fd7758bdb963f08a7f184bb2981e5a02e1c91ef6,182,25673,136,25537,161,1,162,1,41,1143,1,66,6.870689521,2572,51,18,3409,249,3160,130953,12037,118916,1249,120,1129,1,76.79683079,Arch
9b699860a915e3142798445b31067891dfdd4488,182,136,25673,25537,1,161,162,1,41,1981,1,66,6.870689521,28109,248,3,249,3409,3160,12037,130953,118916,120,1249,1129,0,76.79683079,Arch
89986ead459e95e8aadac55952115ea3d976ed88,184,25847,298,25549,161,1,162,1,41,1146,1,67,6.885707799,3548,27,0,3525,364,3161,135217,16218,118999,1304,174,1130,1,76.79683079,Arch
6e7b5eaef543fc5c591af97eab159497619953c9,184,296,25839,25543,1,161,162,1,41,1991,1,67,6.883631815,29097,36,9,365,3525,3160,16258,135217,118959,175,1304,1129,1,76.79683079,Arch
7ca12b1f2710d0fbfa65d2814eaf1803dbe307b8,189,25933,420,25513,161,1,162,1,41,1128,1,71,6.9091867,4641,52,1,3638,485,3153,139911,21190,118721,1346,224,1122,1,76.79683079,Arch
5463a41dc4d3e61841a98b5bc142b7b5d22cd6ee,192,421,25931,25510,1,161,162,1,41,1961,1,71,6.910993166,30553,51,2,527,3679,3152,22740,141442,118702,238,1360,1122,1,76.79683079,Arch
10871906f907bfc84b73079de707efef6949229d,189,25933,420,25513,161,1,162,1,41,1128,1,71,6.9091867,4641,53,2,3638,485,3153,139911,21190,118721,1346,224,1122,1,76.79683079,Arch
50e2b3f81b33c097a62246f714d8d6a104aa658e,189,416,25929,25513,1,161,162,1,41,2000,1,71,6.908876443,30154,52,2,485,3638,3153,21190,139911,118721,224,1346,1122,0,76.79683079,Arch
cac66cbbded786d4528be9847233ea30a6149540,3,143,1,142,2,0,2,7,25,88,1,1,1.274901004,676,53,3,122,110,12,5088,4480,608,13,11,2,1,95.12525389,Arch
0777aa58df6b7213e867728caa559851ed66d2d7,189,25933,420,25513,161,1,162,1,41,1128,1,71,6.9091867,4641,54,2,3638,485,3153,139911,21190,118721,1346,224,1122,1,75.92900721,Arch
8c5e258367454af34b0a3adeb07ac862866dc163,2,312,0,312,2,0,2,1,1,0,1,2,0.990374836,0,55,3,40,0,40,1063,0,1063,14,0,14,1,96.7396367,Arch
e53ece0350b85e6ef6df2919c9d2234fa20530b4,191,416,26241,25825,1,163,164,1,41,1954,1,73,6.931495385,30466,41,5,485,3678,3193,21190,140974,119784,224,1360,1136,1,76.72786177,Arch
85fe3b8bb8726ec114e76080e2de2ffa149d8eae,191,26239,420,25819,163,1,164,1,41,1127,1,73,6.931886785,4641,54,0,3676,485,3191,140944,21190,119754,1360,224,1136,1,76.72786177,Arch
e60eb6e911cd3712ae04f7d4a197cb3ffbb3186c,199,1249,26235,24986,9,163,172,1,41,1923,1,75,7.000417782,30460,253,0,575,3676,3101,26478,140979,114501,248,1360,1112,1,66.28398792,Arch
7d23d361b1e25738f9edd34fc2ed0fc15901f256,200,26240,1264,24976,163,9,172,0,41,1091,1,76,7.001257233,5624,28,0,3692,594,3098,141442,27239,114203,1363,252,1111,1,66.38503319,Arch
6a0c40419bc498d47a9b52db6c26533d9c0c1f6b,201,1321,26244,24923,10,163,173,1,41,1863,1,76,7.010600983,30600,43,2,600,3692,3092,27414,141477,114063,254,1363,1109,1,66.30500301,Arch
1de50533d5fcef41dde2bc1a8edb2c13874e88dc,200,26240,1264,24976,163,9,172,0,41,1075,1,76,7.001257233,5657,29,1,3697,599,3098,141663,27460,114203,1364,253,1111,1,65.6838143,Arch
141d057643e664734faae4839d9457400ddf09f9,200,1260,26236,24976,9,163,172,1,41,1857,1,76,7.000968805,30634,54,2,598,3697,3099,27328,141700,114372,252,1364,1112,1,65.6838143,Arch
e2030edd4b5dbf9c519c25897a6b0b0f4c33932a,1,1,7,6,0,0,0,2,3,12,1,1,0,166,55,3,22,22,0,1332,1398,66,4,4,0,1,89.9917287,Arch
576c15961a95286706f4c7e39912cda4c7efee66,8,0,0,0,0,0,0,1,1,0,1,2,0,838,56,4,92,92,0,5351,5351,0,24,24,0,1,89.09090909,Arch
bb4f191f36b08a096c2c766a9eeca9acc488328d,200,26240,1258,24982,163,9,172,1,41,1082,1,75,7.001170545,5652,30,2,3697,599,3098,141665,27396,114269,1364,253,1111,1,71.98863636,Arch
6f41716323e00ce88d9897f2b821ea899f1c2d27,196,1302,23868,22566,9,156,165,1,41,1817,1,75,6.963534639,29216,44,3,726,3538,2812,31818,137161,105343,277,1321,1044,1,76.33756205,Arch
1b1153ed47caad551fda072e33f87263c8821905,196,23871,1396,22475,156,9,165,1,41,1075,1,75,6.963293392,6741,246,0,3538,739,2799,137126,32660,104466,1321,283,1038,1,76.33756205,Arch
ab915fb2f8944e07a21c8480ed67b0a977ab4be9,193,1294,23830,22536,8,156,164,1,41,1808,1,74,6.946441153,29034,59,7,699,3507,2808,31387,136258,104871,254,1302,1048,1,76.4738292,Arch
2a461083d9093f30c5561cfa5664fc98cb89d7a4,192,23821,1288,22533,156,8,164,1,41,1083,1,74,6.942529205,6242,59,5,3472,665,2807,134705,30012,104693,1291,244,1047,1,76.4738292,Arch
fec778d7c7ca0f2de93720b5d768b3ac4436ff08,192,1284,23817,22533,8,156,164,1,41,1808,1,74,6.942236435,28775,60,8,664,3472,2808,29878,134740,104862,243,1291,1048,0,76.4738292,Arch
868b4dd60d08cfe711ce70919b92ff02eb1c1dde,192,23821,1288,22533,156,8,164,1,41,1083,1,74,6.942529205,6242,60,6,3472,665,2807,134705,30012,104693,1291,244,1047,0,76.4738292,Arch
08b38ce79c6384b6b087202a5d96851c3166487b,197,1303,23840,22537,8,156,164,1,41,1824,1,78,6.951266654,29725,256,0,779,3588,2809,34463,139354,104891,290,1338,1048,1,76.4738292,Arch
4771aae62075996672f8dc5f19c5d276293689f6,197,23872,1307,22565,156,8,164,1,41,1122,1,78,6.953113298,7188,249,1,3592,780,2812,139399,34597,104802,1340,291,1049,1,76.4738292,Arch
c4acc8e0651afca49eb52149f1ba86f8bd8506d4,198,1326,23906,22580,8,156,164,1,41,1832,1,79,6.959218149,29859,0,0,787,3602,2815,35032,140070,105038,295,1345,1050,1,76.4738292,Arch
f73648c4efbbd29df93382f3fa76de2a6b45da11,2,312,0,312,2,0,2,1,1,0,1,2,0.990374836,0,50,5,40,0,40,1063,0,1063,14,0,14,1,94.37971213,Arch
c3b52bb27d76b96ba153b0e4e5643b1c3e9f28e2,2,1,201,200,0,0,0,6,26,1056,1,2,0.167350845,1013,260,1,116,149,33,3838,4834,996,29,35,6,1,95.30831099,Arch
7acb6c8798618a198de9a1ccc40282ccacfb1115,1,190,0,190,1,0,1,1,1,0,1,1,0,0,8,1,20,0,20,1065,0,1065,11,0,11,1,95.18072289,Arch
341fba280bf308d704a2c67adf00ecd2a4209f0f,6,130,825,695,1,5,6,1,15,3814,1,4,2.547833288,825,67,0,8,57,49,506,2287,1781,2,29,27,1,95.78488372,Arch
2c230ddf1a0084273613f5d4a3e247784383273c,6,1307,1083,224,5,0,5,1,113,8,1,1,1.997372317,1669,133,3,266,263,3,10050,8981,1069,63,60,3,1,97.68674699,Arch
9b181be7dd929b32575d43e4d9c55b8359b10d2e,7,1168,0,1168,7,0,7,1,1,0,1,4,2.183977538,0,183,4,90,0,90,4485,0,4485,31,0,31,1,97.15234931,Arch
40f2218d772b9c14feab8f377bb49fbaa1fffc65,54,3647,0,3647,52,0,52,1,3,1,1,17,5.503477814,162,145,3,331,32,299,16694,534,16160,250,18,232,1,95.10012782,Arch
0484768da1263db2d9229213254d3b7bb2ee9b28,7,1612,1,1611,6,0,6,1,13,134,1,2,2.510751807,65,231,8,202,3,199,9098,383,8715,64,3,61,1,97.55301794,Arch
a39868de6e07be65584643d027e47df88731c518,14,555,421,134,7,5,12,1,33,321,1,4,3.375983975,1037,7,0,145,142,3,5510,5175,335,38,38,0,1,94.28090833,Arch
5784b64a5d75559e6e909d0a661feeb0ae089a9f,2,82,4,78,1,0,1,6,16,0,1,1,0.854180205,270,237,4,35,29,6,1996,1640,356,4,3,1,1,94.20056383,Arch
3c691eb2823cb85c9ffe95e9212ce7ac0e564709,2,371,269,102,0,0,0,12,42,478,1,1,0.192822257,756,86,0,104,102,2,5026,4451,575,24,21,3,1,97.9008947,Arch
2015703cfd32cae98b14d2fd6af5ac4396237c48,15,525,522,3,4,1,5,10,52,285,1,8,2.183342222,3565,0,0,438,437,1,18964,19477,513,92,93,1,1,97.10095498,Arch
906237ab6136a9118278430490a7e6914d69b286,8,520,277,243,1,0,1,11,43,413,1,3,1.033433282,2047,208,0,246,233,13,12301,11032,1269,64,57,7,1,97.61023225,Arch
0c3d3bfa8eef4aa0f3380c6bab6c24ea4e5863eb,1,127,0,127,1,0,1,1,1,0,1,1,0,0,33,8,14,0,14,713,0,713,5,0,5,1,97.49103943,Arch
9470803a72d861bb3e3dca8f46475bca2b6003dc,1,1,1,0,0,0,0,1,2,108,1,1,0,127,44,3,14,14,0,712,713,1,5,5,0,1,94.20617005,Arch
b45a9aaf8e3abcc143cd92cff064391f184f5aa6,7,326,1780,1454,0,4,4,5,16,1672,1,2,2.282036497,2051,87,2,79,234,155,2816,9290,6474,20,85,65,1,94.39754413,Arch
b9c41ebcc44bdf5e69ac46dfdba32c8ff0315438,240,15945,21587,5642,64,68,132,3,63,598,1,66,7.171483995,35456,75,0,3568,4462,894,143428,176540,33112,1218,1448,230,0,74.88931056,Arch
0460d89188ec5302f78fa8aef3ab94af54d7cde4,240,21552,15986,5566,68,66,134,0,80,788,1,66,7.170819777,29814,83,0,4451,3573,878,176286,143636,32650,1438,1223,215,0,74.88931056,Arch
02e371c24e6a511669d0d0d1c3fbe16f20022a2f,3,0,0,0,0,0,0,1,1,0,1,2,0,597,17,4,79,79,0,2816,2816,0,20,20,0,1,94.53183521,Arch
c2433d301c5606589eabd597da01a61b3ce5192d,242,16057,21699,5642,66,70,136,3,63,595,1,67,7.193231301,35456,108,0,3568,4469,901,143428,176809,33381,1218,1452,234,1,74.62121212,Arch
03cfcea850fa52e7278f52170cc070c0c4235d5e,242,21668,16102,5566,70,68,138,0,80,772,1,67,7.192494946,29814,281,0,4451,3582,869,176286,143994,32292,1438,1229,209,1,74.62121212,Arch
a4e1fcec276d04d3c7a4af42788ccfc05f7cc61c,242,16057,21699,5642,66,70,136,3,63,595,1,67,7.193231301,35456,109,1,3568,4469,901,143428,176809,33381,1218,1452,234,1,74.62121212,Arch
8d78bd326003cb33534875e512d31b2bccf45068,242,21668,16102,5566,70,68,138,0,80,772,1,67,7.192494946,29814,18,2,4451,3582,869,176286,143994,32292,1438,1229,209,1,74.62121212,Arch
a4566c0a5ceb04d82da4e6a763b5ea7aab36e69f,242,16053,21695,5642,66,70,136,3,63,595,1,67,7.192117619,35456,23,0,3568,4468,900,143428,176811,33383,1218,1452,234,1,74.62121212,Arch
14b1087609cbf7da94093f1afa0e564955bcab89,242,21664,16098,5566,70,68,138,0,81,745,1,67,7.191381408,29814,21,4,4450,3582,868,176288,143994,32294,1438,1229,209,1,74.62121212,Arch
2ae9d555688620bb483a94a665a815d01133773c,242,16053,21695,5642,66,70,136,3,63,595,1,67,7.192117619,35456,7,1,3568,4468,900,143428,176811,33383,1218,1452,234,1,74.62121212,Arch
1a94dd0db7aa7d94a21d6890a57bf3da8a33492c,242,21664,16098,5566,70,68,138,0,81,745,1,67,7.191381408,29814,297,0,4450,3582,868,176288,143994,32294,1438,1229,209,1,74.62121212,Arch
8b53cc099734078c5be10a2f5f6b5ba518f28cc0,244,16143,21835,5692,66,70,136,2,63,598,1,67,7.209039804,36074,290,0,3615,4515,900,145517,179076,33559,1235,1471,236,1,74.62121212,Arch
0a8dace9503fcef464f0bc4a473b5263ee507f82,242,21696,16072,5624,68,66,134,3,81,762,1,66,7.187052168,30381,23,5,4498,3621,877,178585,145456,33129,1458,1241,217,1,75.36231884,Arch
715fcede94b082e8d0d7fe3bc40fc38c045a95ff,242,16031,21731,5700,64,68,132,2,63,611,1,66,7.18771352,36081,12,6,3616,4509,893,145248,178839,33591,1236,1468,232,1,75.36231884,Arch
ca8dd6d9dff645ebf9818ec0f12dc103c9619d40,242,21696,16039,5657,68,66,134,3,81,762,1,66,7.186881545,30348,24,2,4498,3600,898,178585,144823,33762,1458,1238,220,1,74.92043285,Arch
ccb70fb0475d5d6f3cb4150eb472f2aa49378faa,242,15998,21731,5733,64,68,132,2,63,611,1,66,7.187543648,36081,15,7,3595,4509,914,144615,178839,34224,1233,1468,235,0,74.92043285,Arch
d06f84acb8dc4c5d11aaa98f721c2e908d7df2be,242,21696,16039,5657,68,66,134,3,81,762,1,66,7.186881545,30348,84,0,4498,3600,898,178585,144823,33762,1458,1238,220,1,74.92043285,Arch
6aba123faf17bc2fff290476a1ebde6d724a2be9,242,15998,21731,5733,64,68,132,2,63,611,1,66,7.187543648,36081,16,3,3595,4509,914,144615,178839,34224,1233,1468,235,1,74.92043285,Arch
f81c46becca010b310aea7e8bceb8686692dc95f,242,21696,16020,5676,68,66,134,3,81,762,1,66,7.186853208,30329,25,1,4498,3594,904,178585,144688,33897,1458,1238,220,0,74.92043285,Arch
89394d3f075c3a552707bd41d9c43781978bc146,242,15979,21731,5752,64,68,132,2,63,622,1,66,7.187515757,36081,3,3,3589,4509,920,144478,178839,34361,1233,1468,235,2,74.92043285,Arch
0c18b61c41729a9949db2ac7eeb6c76b9376631a,242,21696,16020,5676,68,66,134,3,81,762,1,66,7.186853208,30329,0,0,4498,3594,904,178585,144686,33899,1458,1238,220,1,74.92043285,Arch
659e0c48b6089815196c00f5ff25d6b2d4b4add9,242,15979,21731,5752,64,68,132,2,63,622,1,66,7.187515757,36081,4,4,3589,4509,920,144478,178839,34361,1233,1468,235,1,74.92043285,Arch
5cb699b1c42207aa29be65d64d7681c7ffc81741,242,21696,16007,5689,68,66,134,3,81,762,1,66,7.186239751,30316,26,2,4498,3594,904,178585,144568,34017,1458,1238,220,0,75.42426147,Arch
c06999625e4eb1c94dd1afd329dc8832334755b6,242,15966,21731,5765,64,68,132,2,63,618,1,66,7.186902509,36081,17,1,3589,4509,920,144360,178839,34479,1233,1468,235,0,75.42426147,Arch
09fc49a48ef91dc63cc402cfe90aaa7de17208c2,242,21696,16007,5689,68,66,134,3,81,762,1,66,7.186239751,30316,29,4,4498,3594,904,178585,144568,34017,1458,1238,220,0,75.42426147,Arch
d7370ae82bad7b22706539a9e2793e472860f795,242,15967,21836,5869,64,68,132,2,63,618,1,66,7.18398028,36185,24,0,3589,4522,933,144360,179293,34933,1233,1470,237,1,75.56532663,Arch
8b04a0c17a479c2a3c08e0d8899148bc1002804f,242,21801,16008,5793,68,66,134,3,81,760,1,66,7.183350127,30316,90,8,4511,3594,917,179039,144568,34471,1460,1238,222,1,75.56532663,Arch
937177a351009952aa491c886f0f854525348f4b,243,15967,21852,5885,64,68,132,2,63,621,1,66,7.184631611,36279,19,2,3602,4537,935,144652,179667,35015,1243,1481,238,0,75.56532663,Arch
25847b0e570f8514cccc12e02d39037f4cf83bd0,245,21829,16416,5413,68,68,136,3,81,768,1,66,7.20411856,30796,94,12,4526,3638,888,179479,146932,32547,1471,1274,197,1,78.0883175,Arch
62f885553694b460b785b309b92de57ed9b5a484,246,16376,21911,5535,66,68,134,2,63,625,1,66,7.207393084,36464,21,0,3648,4560,912,147318,180658,33340,1272,1487,215,1,78.0883175,Arch
e367ff207e3ec105c97e47baf9dde0769c2100ee,246,21845,16402,5443,68,68,136,3,81,784,1,66,7.207110852,30929,96,0,4548,3654,894,180360,147541,32819,1475,1278,197,1,78.0883175,Arch
75355b93d38a7649cac2ca2a1c78a90ab779501d,1,44,55,11,0,0,0,5,5,264,1,1,0,190,98,2,19,21,2,1008,1040,32,6,9,3,1,97.83722254,Arch
d38e6c9863be94658e243a6dde51464acea170e7,246,16361,22003,5642,66,68,134,2,63,625,1,66,7.200642117,36571,22,0,3648,4576,928,147318,181414,34096,1272,1487,215,1,79.14379802,Arch
a8664eb055fff5dc40ec91c93f17706d740b0933,246,21979,16402,5577,68,68,136,3,83,779,1,66,7.200162937,30929,103,7,4567,3654,913,181192,147541,33651,1480,1278,202,0,78.0883175,Arch
98d14efe8c22934db03aa12d28b31ece46a46c67,22,45,194,149,0,1,1,4,84,786,1,15,3.126582241,8450,32,1,1227,1241,14,42534,43585,1051,329,337,8,1,94.86521181,Arch
533ac7f9416972a8f6d8e064bfe7ae8f151b9a0c,254,16545,22112,5567,67,68,135,2,63,657,1,69,7.220632406,38324,23,1,3873,4797,924,154728,188133,33405,1375,1585,210,1,76.32552404,Arch
f083ee6339d8941794e9928b8061a23563d2986b,254,22140,16591,5549,68,69,137,3,85,771,1,69,7.218552126,32757,111,8,4798,3879,919,188238,154951,33287,1578,1381,197,1,76.32552404,Arch
8caa2a1a2db00dea750d500d0de5e892ae02f7c3,6,141,17,124,1,0,1,6,14,1144,1,2,2.262382355,585,112,5,86,71,15,4013,3423,590,23,18,5,1,97.76574137,Arch
9eeb52325088e39ebf2c43df1287d1410a0954f9,254,16410,22296,5886,66,69,135,2,63,644,1,69,7.217186968,38506,24,1,3859,4827,968,153877,189250,35373,1367,1596,229,1,77.45830937,Arch
be48024cb91d6d61120941c07df690a97672426a,254,22266,16456,5810,69,68,137,3,85,796,1,69,7.216769295,32620,160,2,4813,3871,942,188828,154355,34473,1583,1379,204,0,77.45830937,Arch
5623c32e12edca9769538bff21b5942cc03078f0,10,106,55,51,0,0,0,5,14,2221,1,6,2.168661137,1859,35,1,178,178,0,6138,6128,10,80,80,0,1,95.63591022,Arch
2228658a38c1add6a4236d46986b72d701372865,1,1,1,0,0,0,0,5,8,0,1,1,0,262,36,2,32,32,0,772,771,1,6,6,0,0,95.63591022,Arch
d5d9e8708e759c6f49c880b50df04060e0167639,260,16442,22391,5949,66,69,135,2,63,647,1,70,7.223996374,39423,26,2,3939,4911,972,156426,191904,35478,1403,1632,229,0,77.45830937,Arch
ddcbf82c1c75f8cf2bd1fa0c0e5cbf60efa0a785,260,22361,16488,5873,69,68,137,3,85,823,1,70,7.223579207,33474,1,0,4897,3951,946,191482,156904,34578,1619,1415,204,1,77.45830937,Arch
833d052080dccb213fcfeeed9fa93f24244eda5e,263,16441,22806,6365,66,71,137,2,63,665,1,72,7.240509049,40061,10,0,3958,4990,1032,157065,194499,37434,1416,1659,243,1,77.26231386,Arch
37058885ba8b9f82acb17dc11a6e21334a384da9,263,22776,16487,6289,71,68,139,3,88,809,1,72,7.240095786,33696,38,0,4976,3970,1006,194077,157543,36534,1646,1428,218,0,77.26231386,Arch
fb2a50852a154f2f875a2f8893c34646df43cae0,263,16441,22806,6365,66,71,137,2,63,665,1,72,7.240509049,40061,27,0,3958,4990,1032,157065,194494,37429,1416,1659,243,1,77.26231386,Arch
afe6852199cbfa74d4e60759dd9e3503a5a89d0d,265,22782,16487,6295,71,68,139,3,88,812,1,73,7.240738152,33987,41,3,4992,3986,1006,194683,158144,36539,1654,1436,218,1,77.26231386,Arch
280912d0b66cc8b49d70c6fd7e01f221833290de,263,16442,22809,6367,66,71,137,2,63,670,1,72,7.24049906,40064,29,2,3958,4990,1032,157067,194498,37431,1416,1659,243,1,77.26231386,Arch
09e3cfb2f53bd774f8e27c9d087e54619064b37a,263,22781,16495,6286,71,68,139,3,89,793,1,72,7.239808604,33704,42,4,4976,3971,1005,194088,157576,36512,1646,1428,218,0,77.26231386,Arch
3435b59901ae676d4810bdbb4781d5fb56ea84b7,263,16451,22811,6360,66,71,137,2,63,670,1,72,7.240179625,40066,30,3,3959,4990,1031,157108,194510,37402,1416,1659,243,0,77.26231386,Arch
b1522f36f78decf18a99b2be2fbf2c185c5ce144,263,22779,16497,6282,71,68,139,3,90,793,1,72,7.239860528,33706,43,5,4976,3971,1005,194076,157586,36490,1646,1428,218,0,77.26231386,Arch
37f3040acaf833123f26b7b959c3d8fcd821e635,263,16449,22809,6360,66,71,137,2,63,667,1,72,7.240309448,40064,31,4,3959,4990,1031,157098,194498,37400,1416,1659,243,0,77.26231386,Arch
1065a5f80a987bfdd4f2fa3c64deb90ef11bdf69,263,22842,16554,6288,71,68,139,3,91,793,1,72,7.239520262,33763,2,0,4987,3981,1006,194523,157889,36634,1647,1429,218,1,77.26231386,Arch
ef7088745115fe7326501a92616182ce2fc927ac,263,16506,22872,6366,66,71,137,2,63,666,1,72,7.24000704,40127,14,4,3970,5001,1031,157412,194946,37534,1417,1660,243,1,77.26231386,Arch
6893fd2477e96fb73b556606b6f97bd6e2a29a97,263,22847,16553,6294,71,68,139,3,93,793,1,72,7.239594834,33762,4,2,4989,3983,1006,194555,157893,36662,1647,1429,218,1,77.26231386,Arch
141de37cdc293ddaa0c832e1363d6c4d21c6a3d1,265,16449,23069,6620,66,73,139,2,63,664,1,74,7.254811788,40324,16,6,3959,5018,1059,157098,195515,38417,1416,1667,251,1,77.15591091,Arch
b405e4625b92c1fa8ce41704ea7f15f68a1b5be6,265,23091,16553,6538,73,68,141,3,95,787,1,74,7.254070823,33762,6,4,5017,3983,1034,195385,157893,37492,1655,1429,226,1,77.15591091,Arch
213e3ce41887b944aa167f00b05387cd0e661f82,265,16507,23121,6614,66,73,139,2,63,664,1,74,7.254477295,40376,18,7,3971,5031,1060,157415,195808,38393,1417,1668,251,1,77.15591091,Arch
78ce9a6cc378cb477900dd721f80f7b121905884,265,23095,16553,6542,73,68,141,3,96,788,1,74,7.254172684,33762,123,3,5018,3983,1035,195434,157893,37541,1655,1429,226,1,77.15591091,Arch
fddd48871648167754d2cf82b39fc931049b1418,265,16507,23134,6627,66,73,139,2,63,664,1,74,7.254592071,40389,19,8,3971,5033,1062,157415,195913,38498,1417,1668,251,1,77.15591091,Arch
1f6c25eec590b90c17335b243643b882efb649f6,265,23126,16825,6301,73,68,141,3,96,789,1,74,7.263542386,34022,125,5,5021,3995,1026,195520,158852,36668,1655,1438,217,1,77.64436821,Arch
01306ff537a1f39364d969dc8cdb435b95bebf4a,265,16779,23154,6375,66,73,139,2,63,672,1,74,7.263926879,40397,32,0,3989,5024,1035,158629,195692,37063,1432,1658,226,1,77.64436821,Arch
1e4090ca77a450b54e0555ac0c255f327f4f8509,265,23124,16825,6299,73,68,141,3,96,789,1,74,7.263524155,34022,44,0,5021,3995,1026,195524,158852,36672,1655,1438,217,1,77.64436821,Arch
7337544e587fc11a93fff8896391c538bfb979f9,265,16780,23154,6374,66,73,139,2,63,674,1,74,7.26396192,40397,33,1,3989,5024,1035,158631,195692,37061,1432,1658,226,1,77.64436821,Arch
2a1da06519a3c90941950abb76d75fe7f680b826,265,23128,16830,6298,73,68,141,3,96,789,1,74,7.263510304,34023,127,4,5021,3995,1026,195524,158854,36670,1655,1438,217,1,77.64436821,Arch
0b26f0c11deb103fb0f234b47d6542f69c75692e,265,16793,23158,6365,66,73,139,2,63,679,1,74,7.264858084,40397,29,6,3991,5024,1033,158699,195692,36993,1432,1658,226,1,77.64436821,Arch
2563a054ba4511992ec3186d048e0a2d2d0e0318,265,23137,16836,6301,73,68,141,3,96,787,1,74,7.264544039,34032,128,3,5022,3997,1025,195589,158922,36667,1656,1438,218,1,77.64436821,Arch
85da88497781762182075ddd000b79d4b45f04a3,265,16797,23161,6364,66,73,139,2,63,673,1,74,7.265012988,40409,30,7,3992,5025,1033,158764,195757,36993,1433,1659,226,1,77.64436821,Arch
29b2ead2095ca3047d4bc9cb1bd1081db5d16e78,265,23131,16843,6288,73,68,141,3,96,787,1,74,7.264607415,34045,45,1,5022,3998,1024,195589,158987,36602,1656,1439,217,0,77.64436821,Arch
347afb77cd00b2f25d75f45606e8ee401fa6c8fa,265,16797,23161,6364,66,73,139,2,63,673,1,74,7.265012988,40409,36,4,3992,5025,1033,158764,195757,36993,1433,1659,226,0,77.64436821,Arch
95c21405416ed2f864e139f0e772a9cca19376c1,265,23131,16843,6288,73,68,141,3,96,787,1,74,7.264607415,34045,46,2,5022,3998,1024,195589,158987,36602,1656,1439,217,0,77.64436821,Arch
0541f4605c6af12097b56d2f6bb8286c6aaee0c1,266,16808,23180,6372,66,73,139,2,63,683,1,74,7.267922839,40780,37,5,4029,5062,1033,159864,196877,37013,1460,1686,226,1,77.64436821,Arch
d18d434a7ad8a1e7f59a1acd8ec3bfcdc024ab99,269,23336,16855,6481,75,68,143,3,96,761,1,76,7.281494049,34704,165,0,5120,4080,1040,199195,161666,37529,1698,1476,222,1,77.22317843,Arch
7f44cdc998117eacc04609008fdac4ce1e2bb387,2,6,256,250,0,0,0,4,7,1379,1,1,0.251319262,473,166,1,24,63,39,1334,2501,1167,3,21,18,1,95.19890261,Arch
878802b50f4a6e84e574871c6cad30a272f376fe,270,17068,23369,6301,67,75,142,2,63,653,1,77,7.291304853,41214,31,0,4079,5110,1031,160780,198957,38177,1468,1689,221,0,75.36764706,Arch
c84bbb199a466099765e37e4bc646f53a83b0086,270,23339,17114,6225,75,69,144,3,96,767,1,77,7.290900482,34913,106,0,5107,4085,1022,198789,161003,37786,1686,1474,212,0,75.36764706,Arch
f8acfd20552b74d78c6b9055d286e72d3b5b71f6,270,17068,23369,6301,67,75,142,2,63,653,1,77,7.291304853,41214,32,1,4079,5110,1031,160780,198957,38177,1468,1689,221,0,75.36764706,Arch
0522b37f453811962c61c7bb99c82862a04e4fa0,270,23339,17114,6225,75,69,144,3,96,767,1,77,7.290900482,34913,168,0,5107,4085,1022,198789,161003,37786,1686,1474,212,0,75.36764706,Arch
6db445bf25b881231ef9e691f3dd1e72b6373590,270,17083,23369,6286,67,75,142,2,63,653,1,77,7.292023606,41214,33,1,4082,5110,1028,160828,198957,38129,1469,1689,220,1,75.36764706,Arch
799a403104e4c6959cce904a720ed12065381817,13,1004,20,984,7,0,7,3,18,486,1,6,3.127877244,1435,34,2,333,203,130,13832,8295,5537,128,64,64,1,96.24261943,Arch
0fa7f8dc278a2b1c95e381d5d3ec701d41fa2997,280,23419,18262,5157,75,76,151,3,96,748,1,80,7.355742827,36468,48,0,5171,4314,857,200912,169845,31067,1706,1566,140,0,73.64735837,Arch
57998748595b5c1aa8be30dd032d3a31420de28e,280,18241,23454,5213,74,75,149,2,63,664,1,80,7.356535939,41701,43,3,4299,5182,883,169085,201700,32615,1556,1715,159,1,73.64735837,Arch
a78903091a6d7ae6c42af74f22d1fee12e4bb87f,280,23422,18299,5123,75,76,151,3,96,748,1,80,7.356910482,36502,169,0,5171,4320,851,200912,170051,30861,1706,1567,139,0,73.64735837,Arch
a748da8ae658b0fc571f659801d82dc7cc760ca3,280,18271,23454,5183,74,75,149,2,63,658,1,80,7.357230423,41701,47,6,4303,5182,879,169179,201700,32521,1556,1715,159,0,73.64735837,Arch
e0bf5aad9104bba3f8899c69d5a676ac79ade266,280,23422,18315,5107,75,76,151,3,96,748,1,80,7.357171,36518,51,3,5171,4320,851,200912,170051,30861,1706,1567,139,0,73.64735837,Arch
dfc9482dca07067c914e8b122e0fe589e45b6846,280,18271,23454,5183,74,75,149,2,63,658,1,80,7.357230423,41701,48,6,4303,5182,879,169179,201700,32521,1556,1715,159,0,73.64735837,Arch
7a39871fe94b21859322e67045fd9aeaf38d4924,280,23422,18315,5107,75,76,151,3,96,748,1,80,7.357171,36518,53,5,5171,4320,851,200912,170051,30861,1706,1567,139,0,73.64735837,Arch
7d8b5e5b5d930e0f31ce28c725d53a275d971e22,592,66903,23582,43321,388,77,465,2,63,245,2,169,8.593402442,41742,50,0,9726,5265,4461,380762,204803,175959,3605,1760,1845,0,48.95785086,Arch
7d8b5e5b5d930e0f31ce28c725d53a275d971e22,312,48547,7,48540,310,0,310,7,22,1,2,91,7.797081861,423,50,0,5473,51,5422,213785,2226,211559,2061,12,2049,0,63.93305439,Arch
fb3584aa02401aabefa886dddfbfd634d78c1909,312,7,48547,48540,0,310,310,7,23,0,2,91,7.797081861,48963,52,2,51,5473,5422,2226,213785,211559,12,2061,2049,0,63.93305439,Arch
33bed204bb922e9d5b3f3d67f2b61757ce3fdd9e,1,63,20,43,0,0,0,8,15,1772,1,1,0,393,9,2,72,65,7,2142,1816,326,16,16,0,1,93.51381839,Arch
25d97ee80cf5815bba35ff929619e5f00f74d39b,2,285,6,279,1,0,1,1,4,240,1,2,0.144899618,59,132,0,21,1,20,2113,273,1840,5,1,4,1,96.33375474,Arch
724543bff09951b33835073975cf6fb5dfe81fa8,20,754,830,76,5,8,13,1,13,741,1,5,3.881378477,1888,146,4,230,216,14,9749,10075,326,102,97,5,1,97.43926461,Arch
be41ee6c85c828785e970095c05492e248cf6a36,4,449,2,447,3,0,3,4,6,223,1,4,1.524626576,104,154,1,53,3,50,2843,491,2352,18,3,15,1,97.77211967,Arch
5423096d1ba553df4fe22e5dbc8da17b5a262a68,1,2,0,2,0,0,0,2,5,1001,1,1,0,166,13,1,18,18,0,919,890,29,5,5,0,1,94.12435824,Arch
0a36d8f818a7fb2f0a8a63108d9e842870342b1c,77,3912,1322,2590,0,0,0,3,40,906,1,42,3.530802037,14853,131,1,2253,1889,364,88582,78145,10437,884,604,280,1,95.82124202,Arch
a59d1044b631b6f40682cf8f44b7d8f9ed7f6fc8,36,733,5,728,33,0,33,1,11,51,1,34,5.123691642,573,20,2,60,60,0,3241,2840,401,15,15,0,1,95.95628415,Arch
44e275766f7f8017c688b12ba6394abedab08275,32,1699,1150,549,18,8,26,1,10,558,1,7,4.772371971,1478,166,1,229,181,48,9341,8365,976,140,60,80,1,96.19145651,Arch
7051d4d924a81fa771a6d226c766203d28e56857,66,4353,1,4352,63,0,63,1,11,12,1,23,5.797281091,484,170,2,409,51,358,22094,2350,19744,302,30,272,1,93.43955014,Arch
