CommitID,NMF,TotalAddLines,TotalDeleteLines,LC,FileAdd,FileDelete,NAD,NDVE,NUC,AGE,NMS,NMD,Entropy ,MLMF,EXP,REXP,CommitComplexity,LastCommitComplexity,CFC,CommitTokenCount,LastCommitTokenCount,NCC,CommitMethodNum,LastCommitMethodNum,NFC,NIR,a2a,Tag
a3228d9f4a43f7a15a68d5b96d36579fa719097f,107,4764,628,4136,38,0,38,2,23,147,2,36,5.76508068,11410,154,16,1893,1515,378,85749,63394,22355,887,686,201,0,95.65813528,Arch
56840d66ec7e29033395f8440f509d469e1d59a3,0,0,0,0,0,0,0,0,0,0,0,0,0,0,155,16,0,0,0,0,0,0,0,0,0,0,100,NoArch
4f0f8e077f67bbc1c33c82d873a6b262ad6785f8,0,0,0,0,0,0,0,0,0,0,0,0,0,0,155,17,0,0,0,0,0,0,0,0,0,0,100,NoArch
3ecf83f6af209815c876494c4b60049e0e96a550,0,0,0,0,0,0,0,0,0,0,0,0,0,0,137,0,0,0,0,0,0,0,0,0,0,1,100,NoArch
897e904b75a26ab9578cca5b0c9824121846c028,0,0,0,0,0,0,0,0,0,0,0,0,0,0,138,1,0,0,0,0,0,0,0,0,0,0,100,NoArch
f89f04389ca317f9d6c3975b6b0d59d965873662,0,0,0,0,0,0,0,0,0,0,0,0,0,0,139,2,0,0,0,0,0,0,0,0,0,0,100,NoArch
5f6b134ab8e79204fef6b05f741bb3ab577b54eb,10,12,11,1,0,0,0,2,15,106,1,6,3.149229762,1609,140,3,146,146,0,6570,6631,61,83,83,0,0,100,NoArch
6b1176dc2e26a7c64fdfd72c7708bfdb97eccc84,7,738,6,732,6,0,6,1,12,39,1,3,2.503070326,328,141,4,124,45,79,5495,1899,3596,47,21,26,1,99.39262473,NoArch
9d613083770a7f28920b6ed65be862c2f7318f24,8,390,36,354,3,0,3,1,12,46,2,6,2.164399436,869,16,0,142,101,41,5867,4181,1686,72,59,13,0,98.79166667,NoArch
0d94cc31bd242cd284a66ed94e0bcc77a0b3eed6,2,266,0,266,1,0,1,1,8,167,1,2,0.473744354,145,142,5,78,31,47,2357,899,1458,25,4,21,0,98.84,NoArch
7f4aade6993e832fd6dcb3a079365014661f5fbe,1,1,1,0,0,0,0,5,13,3,1,1,0,320,9,0,36,36,0,1204,1204,0,21,21,0,0,100,NoArch
55f131e571bdb0128ef22e08054b504e665dc869,1,17,16,1,0,0,0,2,2,284,1,1,0,254,10,1,31,34,3,1209,1265,56,21,22,1,0,100,NoArch
806e42d710befde918c11f5742a7dbd568c782e0,1,2,3,1,0,0,0,1,9,0,1,1,0,172,143,6,39,37,2,1123,1103,20,5,5,0,0,100,NoArch
21ec19b3a86bc6ade4a3433fa22de5573f0ac864,1,12,1,11,0,0,0,2,24,100,1,1,0,423,144,7,60,57,3,2019,1910,109,30,30,0,0,99.84108065,NoArch
b12b3493cceace6f5d04e7d7e801f00a572cae1a,7,19,8,11,0,0,0,2,11,128,2,7,2.397526743,1175,145,8,118,116,2,7746,7710,36,57,56,1,0,100,NoArch
14a5d584243d39f70d3590d699c01956d4a5627c,1,1,27,26,0,0,0,2,3,1,1,1,0,255,11,2,31,31,0,1159,1209,50,21,21,0,0,100,NoArch
92385547a6c26ae57e7a8818c113769584baa20d,1,1,0,1,0,0,0,3,25,0,1,1,0,434,12,3,60,60,0,2032,2019,13,30,30,0,0,100,NoArch
c84f4a16e16a0cdad1d42c0bd01c17192eeb4643,2,2,3,1,0,0,0,1,2,4,1,2,0.970950594,314,17,1,39,39,0,1492,1505,13,11,11,0,0,99.80166601,NoArch
4df33688b9aa49c1b19a4a7a551ec72e40a49b82,2,8,4,4,0,0,0,3,26,0,1,1,1,664,13,4,95,91,4,3223,3191,32,51,51,0,0,100,NoArch
d2aad3a9b0060d387eb97450f06d25f781320b77,1,14,1,13,0,0,0,2,5,140,1,1,0,92,14,5,14,14,0,412,385,27,6,6,0,0,100,NoArch
c7626983d918ee0fe1b6c4adf7142475cf5102c6,5,350,11,339,2,0,2,1,11,52,2,3,1.594815931,1055,18,2,162,115,47,6546,4609,1937,80,67,13,0,98.98125509,NoArch
ff8a5ffa2c97528dcada15b6a4de94eaa90129bb,1,2,4,2,0,0,0,3,11,0,1,1,0,417,19,3,46,46,0,1584,1600,16,26,26,0,0,100,NoArch
bd96a63b8f64a44a1d18c5ffffc36a75af628dac,1,14,10,4,0,0,0,1,2,289,1,1,0,104,146,9,18,16,2,439,366,73,12,11,1,0,99.91603694,NoArch
ab30512333c848befd5c1c8064e190ebb919c0c6,2,3,1,2,0,0,0,3,27,1,1,2,1,545,147,10,80,80,0,2507,2487,20,42,42,0,0,99.83200336,NoArch
c4115cefe758a88503f8a9b4243b621cb288fb6b,1,17,4,13,0,0,0,2,6,3,1,1,0,105,148,11,14,14,0,412,412,0,6,6,0,0,100,NoArch
96bd5a3b13d939a82ba1aaaf2607378129bef3b4,42,54,49,5,0,0,0,3,16,223,2,25,5.293452532,7015,20,4,564,564,0,39502,39179,323,211,211,0,1,100,NoArch
fe501e2b9f2942f1e0751e37f99d8de58d58a2b2,5,20,390,370,0,0,0,2,5,58,2,5,1.42161145,899,149,10,63,115,52,3228,5027,1799,25,61,36,0,99.40978078,NoArch
2bbffd59d897e443a8b9a99d7d97bf9a1310792e,7,117,26,91,0,0,0,2,28,322,1,5,2.670524873,1274,150,11,174,164,10,6631,6151,480,97,90,7,0,100,NoArch
d23cf1a126732a659c16673b7c82c64a5f4f793a,1,8,2,6,0,0,0,2,8,5,1,1,0,190,151,12,18,16,2,1239,1208,31,11,11,0,0,100,NoArch
1b9c5349ee77a32f1b269aef883e7718dc07c1aa,2,14,2,12,0,0,0,3,29,28,1,2,0.988699408,673,152,3,97,96,1,3425,3349,76,45,45,0,0,100,NoArch
369c86fb2bb00026ca8f5feee272c61786776a5f,5,140,11,129,2,0,2,2,15,182,1,2,1.647008963,317,153,4,42,31,11,1659,1263,396,24,16,8,0,99.66230477,NoArch
43b810ea022387cd97b8fc07d68bf00fadd1b08b,3,46,53,7,0,0,0,1,13,318,1,1,1.58190828,641,154,5,100,104,4,3338,3379,41,29,29,0,0,97.54428341,Arch
61bfdee84c3d32af3f389279da56d6a60e3cebdd,1,1,5,4,0,0,0,2,3,312,1,1,0,88,15,0,8,10,2,376,395,19,5,5,0,0,100,NoArch
cdf74895119d5429cd30d5757a2c06e5ccb3ecef,1,1,3,2,0,0,0,2,3,334,1,1,0,256,155,4,40,40,0,1648,1667,19,15,15,0,0,100,NoArch
40ee01bc95f337c5f7eec4ceb423c4c40f14f4f8,2,11,6,5,0,0,0,2,8,54,1,1,0.787126586,221,156,5,13,13,0,1107,1107,0,5,5,0,0,100,NoArch
86a3ccf8cf660e4f9b8669c068474862f6006ee5,2,17,11,6,0,0,0,1,12,187,1,1,0.905928216,480,157,5,70,72,2,2971,3004,33,29,29,0,0,100,NoArch
906d2ecc0749d34fecb393d033ae5a0a9bcb7237,3,12,21,9,0,0,0,2,30,82,1,3,1.095795255,872,158,6,135,138,3,3877,3926,49,62,62,0,0,100,NoArch
4c0f0e04f6d0b10c52c7dc4e9651ce591d1e386e,2,147,0,147,2,0,2,1,1,0,1,2,0.975525951,0,21,0,13,0,13,762,0,762,6,0,6,1,99.80761831,NoArch
18e90285f9b79c1ccbcee9fa9493fa4c99188da3,3,120,18,102,0,0,0,3,15,196,1,2,1.092331702,376,22,1,81,62,19,2721,1976,745,41,36,5,1,100,NoArch
c433d1cd0b58e986466bd26af8ae7c145578ac7e,1,7,4,3,0,0,0,1,7,226,1,1,0,107,159,7,17,15,2,314,302,12,7,7,0,0,100,NoArch
a3d6c426d8c1aacec2321a393dc4bd1794b9952a,1,4,1,3,0,0,0,1,15,230,1,1,0,731,160,5,86,86,0,3188,3180,8,38,38,0,0,100,NoArch
1605504a8dd31e03f048ae33c491daebfc08770b,1,3,0,3,0,0,0,1,16,242,1,1,0,329,161,2,52,51,1,1917,1898,19,13,13,0,0,100,NoArch
766cd3d7e3e19a83075fc95a75eb3e747d0e701f,1,4,3,1,0,0,0,3,31,48,1,1,0,445,162,3,61,61,0,2077,2077,0,30,30,0,0,100,NoArch
b1bb1c7524f67fc699bd14e4618b5447c2cca2fb,4,11,23,12,0,0,0,4,17,149,2,3,1.422658167,879,23,0,87,87,0,5211,5241,30,25,25,0,0,100,NoArch
e9a5145d2277ad1f365870d60dfb081ce08fa986,24,18,30,12,0,0,0,2,15,341,2,15,4.277235419,4367,163,2,502,502,0,22981,23058,77,209,209,0,1,100,NoArch
c24581008b0681c5577519e136329c94323684a4,26,59,59,0,0,0,0,2,16,161,2,8,4.344591043,3732,164,3,377,377,0,18558,18526,32,173,173,0,0,99.46029298,NoArch
05ccf2c38c5eed0460b2cd45cb20f4439aa655d6,1,1,1,0,0,0,0,2,7,4,1,1,0,58,165,4,5,5,0,256,257,1,4,4,0,1,100,NoArch
ffc036cdb90d3e03ce6d2a7c6c83af75903cf17d,1,20,19,1,0,0,0,3,9,258,1,1,0,144,166,5,17,17,0,759,754,5,7,7,0,0,100,NoArch
9551dbdfcf8d0cb1988e976672f0e9600b855e42,0,0,0,0,0,0,0,0,0,0,0,0,0,0,167,6,0,0,0,0,0,0,0,0,0,0,100,NoArch
7f6829635ebadb2041835e8f96db71da6b954121,0,0,0,0,0,0,0,0,0,0,0,0,0,0,168,7,0,0,0,0,0,0,0,0,0,0,100,NoArch
cbe629418a70ca2ad9736e40a4ff92c1a7eb3d32,0,0,0,0,0,0,0,0,0,0,0,0,0,0,156,0,0,0,0,0,0,0,0,0,0,1,100,NoArch
de25169a4b6ca09cab875713bc3fb2eb60b55b1b,3,6,6,0,0,0,0,1,16,156,1,2,1.251629167,883,169,8,138,138,0,5322,5321,1,38,38,0,0,100,NoArch
34c357ffb0499fad4613b8500e9a2f10ac6fde7f,2,113,18,95,1,0,1,1,2,85,1,2,0.97356684,210,170,9,35,24,11,1558,1151,407,18,12,6,0,99.76807112,NoArch
cc1ac9178d30a86c89336ef7ea46f9ecdf276d5c,3,163,9,154,0,0,0,4,11,329,1,2,1.453670478,760,157,1,89,71,18,3358,2483,875,40,35,5,1,100,NoArch
429c226a71f91343b36b45eba6bfb4e3d4798e98,1,13,2,11,0,0,0,2,10,31,1,1,0,139,158,2,10,8,2,909,806,103,2,2,0,0,100,NoArch
9fdf7c789bad91ff6772301b6eb3494b17f7f539,1,1,1,0,0,0,0,1,13,122,1,1,0,238,171,10,36,35,1,1354,1333,21,15,15,0,0,100,NoArch
6ecc0a0f69df52ec26604a2dc1bfc3b5f6da88a0,1,1,1,0,0,0,0,4,10,36,1,1,0,86,24,1,5,5,0,403,403,0,3,3,0,0,100,NoArch
1437684155d8506541a756d8d6f62e0051c5bcde,4,21,78,57,0,1,1,3,12,334,1,2,1.480286588,1014,25,2,95,98,3,6009,6451,442,38,39,1,0,99.92272025,NoArch
52b70867964d2867ba135e5955463ad5b731128d,8,26,36,10,0,0,0,4,13,207,1,6,2.583679326,1509,172,9,181,182,1,6842,6871,29,86,86,0,0,100,NoArch
0df97e3106743bbdc8ae913b3027e7c0360e0c0f,6,147,9,138,0,0,0,4,16,225,1,2,2.167852387,1637,159,3,317,300,17,9927,8947,980,167,161,6,1,100,NoArch
af7140eeaeab155f580f66cae6d756e8060ac0e3,1,2,1,1,0,0,0,2,6,39,1,1,0,122,26,2,10,10,0,710,699,11,5,5,0,0,100,NoArch
efd2643a0ed67e540aa54097846c47610a6bb96c,10,92,24,68,1,0,1,4,18,221,2,7,3.037326301,795,160,4,47,47,0,4011,3808,203,28,28,0,1,99.80687524,NoArch
e80a99dc680f9cb6fe528cdd96a0f139b3b403ef,1,1,1,0,0,0,0,2,4,45,1,1,0,267,27,3,28,28,0,1111,1111,0,12,12,0,0,100,NoArch
cfbf06228de52ca2f12d16238b2c2ce46a97d9ce,1,23,14,9,0,0,0,5,14,187,1,1,0,320,161,5,37,36,1,1251,1204,47,21,21,0,1,100,NoArch
ca7f6d9a13535e619394ec04588e143f602a8b8d,40,794,607,187,3,1,4,2,17,206,2,9,4.316656024,8774,28,4,1397,1408,11,50436,49281,1155,662,660,2,1,98.36001562,NoArch
3e7c67bd6121919ca4d19f746b07d6575ff413c3,2,19,8,11,0,0,0,4,15,0,1,2,0.691289869,739,29,5,108,104,4,4536,4575,39,49,49,0,1,96.73873214,Arch
50629d68e03c26080cbe1800f6f7a07f39b3489a,3,44,0,44,0,0,0,4,16,0,1,2,1.448575666,1139,30,6,111,108,3,5070,4892,178,51,49,2,1,100,NoArch
9b10f7f6d5f8b6419dc633e1efefdea0bacb1d48,2,11,8,3,0,0,0,2,2,0,1,1,0.998000884,151,162,6,6,6,0,911,883,28,4,4,0,0,100,NoArch
3aced6c72cf44d71d209c55c90abd19302f8815a,5,156,9,147,0,0,0,4,18,0,1,2,2.102790109,1661,163,7,240,202,38,7838,7224,614,113,102,11,1,100,NoArch
1a0efb0e5d31d700fd909e6bba92042b803428f6,1,4,0,4,0,0,0,4,19,5,1,1,0,188,164,8,12,12,0,890,890,0,6,6,0,0,100,NoArch
b01005ae9a393cacd9393b45f0082038426f6175,2,6,4,2,0,0,0,3,3,0,1,1,1,154,173,4,6,6,0,921,911,10,4,4,0,0,100,NoArch
032fff5eb2d8d7245acdc2773c459ea1acc06bd1,3,0,15,15,0,0,0,2,5,0,1,1,1.584962501,90,174,5,0,0,0,48,72,24,0,0,0,0,100,NoArch
db362c22307a9cdb51bdb81fe7db6e380a7b12bc,11,781,0,781,11,0,11,1,1,0,1,3,3.133254403,0,165,9,54,0,54,3672,0,3672,25,0,25,1,99.15340332,NoArch
f0c89957e530d2429c8fce291c5eba0569680d08,4,268,33,235,0,0,0,3,7,108,1,2,1.591415395,1172,31,7,223,196,27,7804,6489,1315,84,72,12,1,100,NoArch
bfba4bc22fdaa570c27e6ef8328ac157cc1ccaa3,1,9,1,8,0,0,0,3,32,60,1,1,0,446,175,6,63,61,2,2100,2077,23,30,30,0,0,100,NoArch
206cee03ceea35d36720aacefd411eda5172dc32,2,14,9,5,0,0,0,1,2,0,1,2,0.666578358,335,166,10,32,30,2,2203,2171,32,9,9,0,1,100,NoArch
98a79f4765cb4a905c38872a617df17a90195f5e,2,52,2,50,1,0,1,1,3,0,1,1,0.935711051,207,167,11,22,18,4,1887,1697,190,3,2,1,1,99.89932886,NoArch
26cb05dd177009b4c41a50ec8427ca4d62e20890,1,3,1,2,0,0,0,1,4,0,1,1,0,222,168,12,21,21,0,1834,1824,10,2,2,0,1,100,NoArch
4319ae37d5e973f71b60789107f452e58c4d9ea5,1,2,1,1,0,0,0,1,2,2,1,1,0,77,169,13,7,6,1,326,320,6,6,6,0,0,100,NoArch
0d2afee5251d2116c7a4872a1b810562c5b15f1f,1,1,0,1,0,0,0,3,33,3,1,1,0,454,170,13,63,63,0,2100,2100,0,30,30,0,0,100,NoArch
c5f77f735ec22905339dd731d1b935c743b800ba,5,10,10,0,0,0,0,4,14,41,1,3,2.121928095,1911,32,8,373,373,0,12066,12094,28,175,175,0,1,100,NoArch
40aa3e89f5ef0e82844c602615f5c54184574b9d,40,655,484,171,2,0,2,2,19,84,3,13,4.323046347,10158,176,7,1560,1546,14,55365,54577,788,729,721,8,1,98.45731916,NoArch
c4efb9f45815bf28b3286f4e7593767e88753f35,2,26,1,25,0,0,0,2,34,85,1,2,0.975119065,651,177,8,84,81,3,3499,3339,160,43,41,2,1,100,NoArch
8eb6d1df1e4420365a63dd6bb2d28c4fcd1b5cb5,11,28,99,71,0,0,0,3,20,0,1,2,3.075662084,2913,33,9,448,453,5,11933,12248,315,210,218,8,1,100,NoArch
3172bd1bb1bf533b614e0311c3e5375205cc6037,12,413,149,264,0,0,0,3,19,0,1,2,3.324116402,3412,34,10,699,674,25,20552,18838,1714,297,283,14,1,98.94660371,NoArch
b80b5bbf6d354a1f522c25def3ca2139364ee075,9,122,230,108,0,2,2,3,21,182,2,4,2.832398619,1808,35,11,193,195,2,9209,9753,544,87,91,4,1,99.73574934,NoArch
fdd56b559e99ad77cdbe39e9926d4515e0ee9565,1,2,1,1,0,0,0,4,16,2,1,1,0,821,171,14,88,88,0,5504,5491,13,32,32,0,0,100,NoArch
85de9d46518d60d657cc4acfe0fc44f41412b0ae,2,16,4,12,0,0,0,4,20,8,1,1,0.721928095,962,36,12,216,216,0,5288,5288,0,74,74,0,1,100,NoArch
781d81bf74b066208e45eadfd40e48757a9ed2cd,1,11,2,9,0,0,0,4,21,0,1,1,0,534,37,13,104,103,1,2403,2372,31,42,42,0,1,100,NoArch
0ddd8cc06d6c110869b517e0b922fc98df5ae0eb,1,1,1,0,0,0,0,4,16,9,1,1,0,397,178,7,0,0,0,361,359,2,0,0,0,0,100,NoArch
075ea19c17260ac3e7bff82792a604b690259c5a,42,1278,713,565,9,0,9,1,20,86,3,13,4.610175404,5835,172,13,564,503,61,32293,29724,2569,244,202,42,1,98.0231257,NoArch
4d2a7f4b34661faac4b5316f556c749dd1b061e0,2,0,103,103,0,2,2,3,6,285,1,1,0.988478323,103,173,14,0,4,4,0,510,510,0,4,4,1,99.81543005,NoArch
917cca0f238b6c33fbe7527a17cb619ae4451858,7,123,183,60,0,0,0,3,18,2,1,5,1.55485178,2226,38,14,266,270,4,10725,11225,500,111,112,1,1,99.96301775,NoArch
69e6ced726f5e516f85e6bcd9620acf474b794e2,1,126,103,23,0,0,0,4,16,1,1,1,0,329,174,15,48,46,2,2292,2034,258,11,11,0,0,100,NoArch
17d937ade65d164b0151186e2feedc2bd9d07c23,1,3,3,0,0,0,0,1,6,2,1,1,0,227,175,16,20,20,0,1881,1879,2,3,3,0,0,100,NoArch
63e11c0028e5338410f21dd0458d59751a2d4b4d,4,140,5,135,2,0,2,1,2,0,1,3,1.760564731,65,176,17,18,6,12,882,263,619,13,4,9,0,99.59304477,NoArch
3db6c9e31c5858600f673699a5c8fcf1d0ec513c,3,111,1,110,2,0,2,1,7,0,1,2,1.137884076,227,177,18,31,20,11,2494,1881,613,10,3,7,0,99.81502035,NoArch
83402dc91a76de4e80ad5f86607ed71d29c1f1e1,1,99,0,99,1,0,1,1,1,0,1,1,0,0,178,19,8,0,8,766,0,766,2,0,2,0,99.77884261,NoArch
b19a51e05eb5cea29cb7cd84a67612192cebdb92,2,2,1,1,0,0,0,1,8,0,1,1,0.918295834,327,179,20,28,28,0,2671,2661,10,5,5,0,0,100,NoArch
be42fe00ae95b3d750f1f95f451db445d4a47f6e,12,233,361,128,0,1,1,3,17,309,2,3,2.705915502,1520,39,15,130,142,12,6721,7407,686,64,66,2,1,99.9263623,NoArch
2afb63115c63adfb7206e3f2abdf33da2dfce147,1,5,1,4,0,0,0,1,2,0,1,1,0,62,180,21,9,9,0,257,257,0,6,6,0,0,100,NoArch
93798790e3ad53ab13ebdcda28eaac5089eafbf3,1,9,8,1,0,0,0,1,3,0,1,1,0,100,181,22,8,8,0,770,777,7,2,2,0,0,100,NoArch
abcb7f5bea440c59ae9d3e194d5323d847d62101,12,292,255,37,0,1,1,1,7,61,2,5,2.549388659,1506,40,16,139,138,1,8980,8936,44,77,75,2,1,99.22680412,NoArch
1145c455a5316c04cdbc18917bb4b0c461af64ec,0,0,0,0,0,0,0,0,0,0,0,0,0,0,182,23,0,0,0,0,0,0,0,0,0,0,100,NoArch
11a21dcf5e2968829930cc0810f72e77dd423bba,25,862,284,578,2,0,2,1,22,12,2,9,4.078495604,4727,183,24,733,694,39,26508,23452,3056,376,342,34,2,99.85315712,NoArch
2ce1755e34b739bbe754805aa146206b1809d2d3,1,17,4,13,0,0,0,1,9,2,1,1,0,228,184,25,22,20,2,2078,1894,184,3,3,0,0,100,NoArch
cfa2ed7a9d27753e39248bb1ce8c0be35bba628d,1,10,7,3,0,0,0,2,2,2,1,1,0,67,41,15,6,6,0,181,181,0,6,6,0,0,100,NoArch
8fdd78ccbb513df5aa4399a90039cf2e7bbce8d6,8,38,53,15,0,0,0,3,20,0,1,3,1.99578521,1425,42,16,143,142,1,5627,5747,120,86,85,1,0,98.99892742,NoArch
298eee07f074a7a56f3232ba73bd7a450c1c6338,14,297,70,227,1,0,1,3,23,39,1,4,3.071034652,2473,185,26,305,273,32,9270,8251,1019,178,160,18,1,99.89532449,NoArch
ef99043f9b20dbd10c44c25f3d1721284f8d49ff,1,2,2,0,0,0,0,3,10,6,1,1,0,83,186,27,5,5,0,371,370,1,3,3,0,0,100,NoArch
cbc4347fa5fc2fc5690705ab969cc035aff9957e,1,1,1,0,0,0,0,4,13,6,1,1,0,98,187,28,5,5,0,513,513,0,3,3,0,0,100,NoArch
43585266cc110b0023d69945ed84980e8f024a48,1,0,1,1,0,0,0,4,11,0,1,1,0,65,188,29,4,4,0,268,283,15,3,3,0,0,100,NoArch
fad901ea214d6138061cfaebca7582255ed8f8b9,1,1,1,0,0,0,0,4,21,6,1,1,0,207,189,30,12,12,0,1019,1019,0,6,6,0,0,100,NoArch
e74ae9b4119f6807a79a2b937849ec4b2460fb08,1,20,14,6,0,0,0,4,14,0,1,1,0,98,43,17,5,5,0,530,513,17,3,3,0,0,99.89583333,NoArch
3ae4c54bfe46ac08b2a9f132de6b58c1b9b330ab,1,1,1,0,0,0,0,4,22,1,1,1,0,207,190,31,12,12,0,1019,1019,0,6,6,0,0,100,NoArch
e9ecfe16e2689554c63224cde26c3b8bae74c242,1,19,0,19,1,0,1,1,1,0,1,1,0,0,191,32,1,0,1,69,0,69,1,0,1,0,99.9308915,NoArch
d87b7a37608fa8ceb51bbbea96d59d642d37db70,1,4,7,3,0,0,0,1,10,3,1,1,0,241,192,33,21,22,1,2062,2078,16,2,3,1,0,99.86192613,NoArch
addeb36841bb43a80c53fc748e29fb0a1e6fa021,1,12,2,10,0,0,0,3,8,5,1,1,0,107,193,34,12,10,2,598,526,72,2,2,0,0,100,NoArch
ad88a2fef2c3e26176cbe18755e7928ccfe12ad9,5,200,106,94,1,1,2,4,23,1,2,3,1.677056866,882,194,35,98,82,16,6518,5203,1315,24,24,0,1,99.37565036,NoArch
a7fc9bf00e408e57a22507198cc0e509392d1107,1,3,0,3,0,0,0,1,2,0,1,1,0,65,195,36,8,7,1,489,466,23,1,1,0,0,100,NoArch
9d0b2199b44347c8a5fce00fdface750da9810a2,1,2,2,0,0,0,0,1,11,0,1,1,0,238,196,37,21,21,0,2062,2062,0,2,2,0,0,100,NoArch
7c2ec2012c961e4fa82d48cf7e3814d854790f19,1,1,1,0,0,0,0,4,16,0,1,1,0,104,44,18,5,5,0,532,532,0,3,3,0,0,100,NoArch
75e76eb0289bf752de84ed1eca27fe3341fc9df4,4,68,56,12,0,0,0,4,24,0,2,3,0.479672146,979,197,38,100,99,1,6576,6541,35,24,24,0,0,100,NoArch
5ba24cb62939b35f5336ad3aa24119c0a74313f2,4,248,29,219,0,0,0,4,25,5,1,2,1.712829246,592,198,39,50,38,12,5768,3585,2183,17,17,0,1,96.7765043,Arch
d2d9d85abcc2f26449cff850c1e8a52de5f5fca5,1,3,1,2,0,0,0,1,4,0,1,1,0,68,199,40,8,8,0,503,491,12,1,1,0,0,100,NoArch
d6db69f2b5a86113538cae86099820726faedb69,1,3,1,2,0,0,0,1,2,6,1,1,0,107,200,41,8,8,0,891,869,22,2,2,0,0,100,NoArch
76c06269d745e27247c410f357d9e43598c3eb5b,1,14,7,7,0,0,0,1,3,1,1,1,0,109,201,41,9,8,1,987,891,96,2,2,0,0,99.55406912,NoArch
09b74e67d69a00b9a488aa9c608bfe954fa7c888,1,5,0,5,0,0,0,4,26,1,1,1,0,331,202,42,28,27,1,2325,2270,55,8,8,0,0,100,NoArch
40cf7d3b9c0f67fa274b3a3a650d4c7fc6a5cc71,1,112,0,112,1,0,1,1,1,0,1,1,0,0,203,43,9,0,9,923,0,923,2,0,2,0,99.92503748,NoArch
4fb3040df537e536f87b84402e105bfe027c23f8,1,2,2,0,0,0,0,4,19,8,1,1,0,489,204,43,60,60,0,3294,3290,4,12,12,0,0,100,NoArch
c7d3f6da3c4fcedd001a6587c8194cac356aff46,2,2,2,0,0,0,0,4,22,6,1,2,1,834,45,17,99,99,0,4634,4634,0,34,34,0,1,100,NoArch
9acbff2a8c8b09ca713a562a738d6849c0268abf,6,257,115,142,1,0,1,4,27,8,1,4,1.41857529,1283,205,42,133,122,11,9336,7993,1343,28,30,2,0,97.55914382,Arch
089d1329cff0a8412470b897cdc6bcd09f7a9793,5,9,7,2,0,0,0,3,28,7,1,3,2.173794941,1549,206,40,151,151,0,9915,9891,24,29,29,0,1,100,NoArch
25166b2453e4b588460b509e461191056416cc68,34,220,176,44,0,0,0,2,29,18,2,11,4.513603705,6435,179,1,799,800,1,31093,31417,324,374,374,0,0,98.99065421,NoArch
f55276b6465b5c91c7b5c2b7bc201be2eb937bf1,21,353,102,251,0,0,0,2,7,72,2,12,4.287920855,1184,180,2,108,107,1,5213,5126,87,67,67,0,0,100,NoArch
83637d70dd569b4cdf7d32616728ec9b7a5b8760,11,84,72,12,0,0,0,4,25,16,1,1,3.116950332,3086,181,2,635,628,7,15714,15382,332,284,282,2,1,100,NoArch
d023be63369a9bf9bce6426442ea1d6c92428142,10,31,33,2,0,0,0,3,22,112,1,6,3.12343651,2804,182,3,468,467,1,19543,19599,56,192,191,1,0,100,NoArch
f08dae3d162d0861183d60098134b49055cae168,2,17,0,17,0,0,0,1,5,474,1,2,0.873981048,138,183,4,27,22,5,610,503,107,14,12,2,0,100,NoArch
8535e20f0675c7b605fa6789194beb10577d364e,4,456,3,453,2,0,2,1,17,63,1,2,1.169811894,920,184,5,156,115,41,6263,4375,1888,58,42,16,0,99.59274343,NoArch
e02a166a1b61abb857832ee19bdc996333a38515,4,59,43,16,0,0,0,1,18,0,1,2,1.367100791,1373,185,6,155,156,1,6474,6263,211,60,58,2,0,100,NoArch
39bfe7c3eda44bbeb3434c0365efec608814690f,3,144,32,112,1,0,1,2,7,336,1,1,1.480805535,213,186,7,45,30,15,1771,1099,672,21,13,8,0,99.55719557,NoArch
00a6c61392fff55edc17ad3339931563730a1410,3,23,13,10,0,0,0,1,18,135,1,1,1.251629167,1041,187,8,96,94,2,3982,3925,57,48,48,0,0,100,NoArch
aa1bf8f5be6428b33936202f4995647b71ce0876,6,132,16,116,1,0,1,1,19,218,1,2,2.448235195,1341,188,9,175,149,26,6157,5705,452,74,69,5,0,99.670812,NoArch
20bb0d9afc78dcfeccef2c88e901ae76a89c5ec6,4,62,12,50,0,0,0,1,20,0,1,1,1.815949724,1405,189,10,153,144,9,6048,5729,319,67,63,4,0,100,NoArch
a9ec40f287e1d189a0b935c622eb5d98c152e259,1,19,1,18,0,0,0,1,21,0,1,1,0,799,190,11,100,98,2,3766,3642,124,44,42,2,0,99.34450109,NoArch
b25ad9d2dadf961fb79ac37a2d4f26a9135ee3ce,321,4464,4929,465,1,0,1,2,35,245,1,60,7.453187035,42769,191,12,4752,4748,4,214373,212947,1426,2280,2279,1,0,99.78062157,NoArch
15ff4830d7430b12c54b81a3556f7dc9a402c5a3,1,16,55,39,0,0,0,1,5,0,1,1,0,130,192,13,10,16,6,373,464,91,9,15,6,0,100,NoArch
57db294a83b2097c7ce8a87c2ae18aadbb8e04a5,3,5,20,15,0,0,0,1,23,0,1,1,1.426960814,1231,193,14,149,149,0,5664,5789,125,66,66,0,0,100,NoArch
68640a4d9ce7f8716e7e99e7cf3da9df0ff6fa30,4,46,21,25,0,0,0,1,24,0,1,2,1.78519317,1594,194,15,176,174,2,8045,7841,204,77,75,2,0,100,NoArch
810a5d2b30d4dd7de448802a945ba91a773e1207,4,8,10,2,0,0,0,1,25,8,1,1,1.99107606,1436,195,16,155,155,0,6042,6054,12,69,69,0,0,100,NoArch
1c1e2785caafb4c22a641ec110c63ad4c9f8fd01,6,358,60,298,3,0,3,1,26,1,1,4,2.240430732,1336,196,17,160,142,18,7278,6170,1108,80,67,13,0,97.00920245,Arch
3581c4ffdf2a98da970d959d6c32be825704e131,2,14,2,12,0,0,0,1,2,0,1,1,0.811278124,242,197,18,18,16,2,894,864,30,13,13,0,0,100,NoArch
3e3f96792d0c01ea1b8378d4e00197614259d79e,2,18,4,14,0,0,0,1,11,0,1,1,0.439496987,499,198,19,47,47,0,1991,2007,16,19,19,0,0,100,NoArch
7df0ef08b59770f0ca81bd411a8d9532a2b1121a,1,103,95,8,0,0,0,4,31,9,1,1,0,316,46,1,27,25,2,2258,2213,45,6,6,0,0,100,NoArch
31e36443aa0f58a27dc6c2ad1f99e7bf6aeaaa7f,0,0,0,0,0,0,0,0,0,0,0,0,0,0,207,2,0,0,0,0,0,0,0,0,0,0,100,NoArch
d228006ff98143babe4a49bd1a8a8af8d7ebbad8,1,4,4,0,0,0,0,1,5,383,1,1,0,46,199,20,1,1,0,275,275,0,1,1,0,0,100,NoArch
e290c8e9edfa6126dd0a2a62dbd14c4412df82bb,1,4,2,2,0,0,0,4,32,3,1,1,0,324,47,1,28,27,1,2272,2258,14,6,6,0,0,100,NoArch
2d97d9387b83998ef24738c14174b4babb925bb1,8,180,170,10,1,0,1,1,9,346,1,1,2.788401289,531,200,21,30,28,2,2833,2578,255,15,14,1,0,99.9194847,NoArch
dfdd58a01a4ceb935eefaa8a9c75ee34feeebb4e,1,2,3,1,0,0,0,2,8,413,1,1,0,122,208,1,14,15,1,712,710,2,4,4,0,0,100,NoArch
7cb1bd97d34439b21408c36586ca577ba6b0a7cc,0,0,0,0,0,0,0,0,0,0,0,0,0,0,209,2,0,0,0,0,0,0,0,0,0,1,100,NoArch
112116128251bea5face03c720949613064ffe4c,9,80,34,46,0,0,0,1,27,14,1,5,2.777660477,2247,201,21,275,258,17,11252,10864,388,105,104,1,0,100,NoArch
3f0e5bbbf11a0b2c16c5199a8f68825cba18e476,5,134,125,9,0,1,1,2,17,140,1,1,1.841847411,610,210,3,43,38,5,4013,3782,231,13,15,2,1,99.67767929,NoArch
cc1b29280664b1210a00c34a5c3a6eb99cb6486f,1,1,1,0,0,0,0,1,7,29,1,1,0,95,202,21,10,10,0,403,403,0,9,9,0,0,100,NoArch
90366ccdd83d0020546dffbee852176611a3964d,2,161,1,160,1,0,1,1,21,4,1,2,0.309543429,222,203,20,61,37,24,2276,1501,775,19,4,15,0,99.87903226,NoArch
b747675a040732515bd361b1b21da2909f42a071,1,1,1,0,0,0,0,1,2,100,1,1,0,78,211,4,10,10,0,386,386,0,4,4,0,0,100,NoArch
9fff6c35b5942f3e592ee77e5b2c26d189add4cc,2,16,10,6,0,0,0,1,15,20,1,1,0.995727452,387,204,17,59,59,0,2130,2086,44,30,30,0,0,100,NoArch
fec65570175a4e6b04d26bad702fefedf01696e3,1,29,14,15,0,0,0,2,3,57,1,1,0,127,212,5,13,10,3,1062,910,152,3,3,0,0,100,NoArch
57139241cd217b6e910ffefd5743e8103086262c,7,159,75,84,1,0,1,2,14,37,2,5,2.296518907,1036,213,6,113,100,13,7263,6617,646,27,25,2,1,99.79879276,NoArch
7a96c08b5612a49109523d25680261ad1cf2c7cf,2,27,9,18,0,0,0,3,18,26,2,2,0.918295834,302,214,7,19,17,2,2056,1919,137,7,7,0,0,100,NoArch
794d025c7b14d798bb747528ad943f287c5e54fe,1,2,3,1,0,0,0,1,2,3,1,1,0,42,215,8,3,3,0,207,214,7,3,3,0,0,100,NoArch
0a949d84fff3d1592b27676e04ca6bb889c0920a,102,987,1704,717,0,5,5,2,36,83,3,32,6.082503724,14548,205,10,1561,1646,85,72116,76386,4270,753,794,41,2,97.60940032,Arch
4d1b7231f462d8d4a7a61566c081e6b3bae53217,1,1,1,0,0,0,0,2,3,49,1,1,0,88,216,9,10,10,0,368,368,0,6,6,0,1,100,NoArch
a29296c7e31e9e994447737303ab31b9cddb2a96,3,88,26,62,1,0,1,1,5,31,1,3,0.926902207,274,217,9,31,23,8,2634,2048,586,6,6,0,0,99.79591837,NoArch
9768420548fdcd149e5e663f37207a5b6024712d,1,1,3,2,0,0,0,1,14,17,1,1,0,370,206,5,32,32,0,2137,2143,6,16,16,0,1,100,NoArch
02ba74191839b5d8cdaee35dddb9213358d4a572,1,19,15,4,0,0,0,1,10,38,1,1,0,131,207,6,3,3,0,654,652,2,3,3,0,0,100,NoArch
bf710b538bd7ec4aae06a242de331205610adba3,1,8,9,1,0,0,0,1,1,0,1,1,0,238,218,7,21,21,0,2043,2062,19,2,2,0,0,99.83686786,NoArch
ee4a2614f4644ff8571ae32de59908d37428e5fe,9,930,10,920,6,0,6,2,3,14,1,4,2.457804168,450,219,8,128,39,89,7810,3010,4800,54,11,43,1,99.06693712,NoArch
3bad4df1265c82d201923e9c9ff5860e273e9ceb,5,54,37,17,0,0,0,1,2,0,1,2,2.19592358,901,220,9,86,86,0,4803,4696,107,40,40,0,0,99.71740008,NoArch
20faad6330614d077d5a567aa7b6ebdd6bad5d60,6,141,54,87,0,0,0,1,3,0,1,2,1.556976519,938,221,10,93,89,4,5663,4907,756,44,43,1,1,100,NoArch
d86c96740b02cb7651991984d6a3b4d80f7fbb2b,142,3325,3641,316,6,9,15,2,37,20,3,36,6.181474429,17680,208,4,1994,2022,28,86813,89759,2946,999,1000,1,0,95.94813614,Arch
d7b9ef38320b6b2e44e287fff4c4ad9f3cd31fc9,1,167,50,117,0,0,0,2,6,25,1,1,0,181,222,7,37,18,19,2254,1463,791,6,3,3,1,100,NoArch
65be0f0afce788f735f44588e37cb4ee54fc8bb1,2,15,0,15,0,0,0,2,11,47,1,1,0.918295834,191,16,0,24,22,2,687,641,46,14,12,2,0,100,NoArch
9e9182dca02ec2b83f25c07f5d834ea7ab818534,4,15,22,7,0,0,0,4,27,72,1,4,1.608726039,1219,223,7,218,218,0,6620,6605,15,110,110,0,1,100,NoArch
31a30f043a69164157fb255d82fe498042baead1,2,5,3,2,0,0,0,4,28,45,1,1,0.954434003,660,224,8,119,119,0,2755,2745,10,71,71,0,1,100,NoArch
4a28bda3481b8ba3140c0602eb5f2d5b3bc7031a,3,4,6,2,0,0,0,4,29,29,1,2,1.370950594,1079,225,9,206,206,0,5702,5694,8,118,118,0,1,100,NoArch
f5062921d65ae46431c4595d56f27b44058d2f41,2,26,8,18,0,0,0,4,26,90,1,1,0.989992792,924,226,10,103,102,1,3000,2989,11,39,38,1,1,100,NoArch
ead7576445a6d8629f3ceb8d90f92ac67387e034,1,3,2,1,0,0,0,4,27,1,1,1,0,532,227,10,103,103,0,2606,2597,9,39,39,0,0,100,NoArch
a66f1a87253050d54ff081efb59fa32a1fa489fd,143,3064,2284,780,8,0,8,2,38,27,3,37,6.13715127,17467,209,3,2111,2067,44,87309,88684,1375,1089,1053,36,1,98.39098954,NoArch
accdbdbd5c33500cce48d3c72707d5f8ff9ce837,2,13,12,1,0,0,0,1,5,0,1,2,0.942683189,286,210,4,43,43,0,1488,1483,5,21,21,0,1,100,NoArch
995c003e124bf6351606f444a7f533806063aa02,10,1448,0,1448,10,0,10,1,1,0,1,2,3.019259786,0,228,6,140,0,140,8173,0,8173,58,0,58,1,99.05250691,NoArch
00dee57638092d89b37d447da7b662bce5f3fef7,6,320,14,306,5,0,5,1,11,3,1,3,2.431542071,122,211,3,37,21,16,1340,428,912,21,10,11,1,99.53234606,NoArch
66764adcf988176006f4ced03bf83bda5d80b1f9,8,27,4,23,0,0,0,1,31,16,1,4,2.735035423,2147,212,4,307,303,4,9506,9409,97,183,183,0,0,100,NoArch
f499b17bd7e496a4185e5bcbec20c18de39b7997,1,7,2,5,0,0,0,3,39,18,1,1,0,405,213,5,64,62,2,2043,2000,43,25,25,0,0,100,NoArch
1a6d9c63efb4ca396073c33318220ae109d70b42,1,5,4,1,0,0,0,1,3,21,1,1,0,258,214,5,40,40,0,1388,1393,5,17,17,0,0,100,NoArch
1d1145c6918885f0306a0310592668bb6d1382df,1,19,4,15,0,0,0,3,40,3,1,1,0,410,215,6,67,64,3,2129,2043,86,25,25,0,0,100,NoArch
f3e63ce6ae465f9e34345e0c729ce2a087b082ed,19,78,32,46,0,0,0,1,32,13,1,9,3.81523279,4654,216,7,764,748,16,21953,21672,281,365,361,4,0,100,NoArch
af8c8b5384b52bedee814a0f9b21deed07a18bfe,1,2,1,1,0,0,0,3,41,2,1,1,0,425,217,8,67,67,0,2133,2129,4,25,25,0,0,100,NoArch
481b440d929971309f96a0043c1c294e08c99b9b,4,14,90,76,0,0,0,1,8,34,1,3,0.684310151,518,218,9,52,70,18,2384,2880,496,28,30,2,0,99.84435798,NoArch
90d12eb7eba53eceae1263b798ec3658a0ae2058,3,13,3,10,0,0,0,1,14,24,1,1,1.5,275,219,10,35,33,2,1619,1557,62,7,7,0,0,100,NoArch
b3ad106ae67ef13482f641351f8d190790d62347,4,37,29,8,0,0,0,1,6,182,1,1,1.656105103,251,220,11,21,20,1,1190,1124,66,16,17,1,0,99.96096799,NoArch
94e8d0da0f416ff8c199862b8d349245d03ae8dc,4,22,4,18,0,0,0,1,42,6,2,3,1.49563213,811,221,12,121,119,2,4341,4174,167,49,48,1,0,99.84435798,NoArch
553291ba1fffd4bf0c9de8d7624577e4c174b7d6,1,10,2,8,0,0,0,2,4,27,1,1,0,50,222,13,3,2,1,230,173,57,2,2,0,0,100,NoArch
172ffcdad38045580e8859c4daacefad230cf186,14,84,90,6,0,0,0,2,30,40,1,4,3.319769988,3122,223,14,446,437,9,15303,15292,11,219,216,3,1,100,NoArch
7a387ddb1c4196b25554f7fadd56a69749d79867,1,1,1,0,0,0,0,1,33,6,1,1,0,724,224,15,80,80,0,3624,3624,0,34,34,0,0,100,NoArch
88b40a5aa99131f16b40761d460712f7746fbe60,1,28,19,9,0,0,0,1,10,21,1,1,0,296,225,16,42,38,4,1168,1128,40,20,19,1,0,100,NoArch
758cc1bb5abdfb11484d0f3397886a4e7ef80d5c,85,533,511,22,0,0,0,2,24,160,3,38,5.807154851,9851,226,17,976,977,1,50780,51070,290,446,443,3,1,98.31838565,NoArch
98c32ab4a436eeb0ddf90d8d3ce88a23aec720e7,1,8,1,7,0,0,0,1,17,41,1,1,0,308,227,17,41,41,0,1720,1714,6,22,22,0,0,100,NoArch
26ac2a57ba86b53851dc14d24503d112bda07b5b,6,22,13,9,0,0,0,1,16,50,1,5,2.397411836,746,228,18,38,38,0,2253,2253,0,23,23,0,0,100,NoArch
00fd47486821e36b4b356e785a5350349e9158c2,1,6,5,1,0,0,0,1,11,41,1,1,0,212,229,19,14,14,0,1983,1964,19,10,10,0,0,100,NoArch
49697cc46f876b06feaa538b2165890b00dcbf5d,3,288,1,287,2,0,2,1,12,2,1,2,0.980639541,213,230,19,57,14,43,3067,1983,1084,30,10,20,0,99.82007917,NoArch
fbe90e6ff946a96674284d1effc2178dd299090a,1,5,1,4,0,0,0,3,13,8,1,1,0,102,231,20,10,10,0,518,485,33,5,5,0,0,100,NoArch
9125a01281b9e90412e362da9758f6b361eabb91,63,2944,1529,1415,23,9,32,3,19,40,2,18,5.377473062,4361,0,0,472,323,149,30750,22926,7824,203,125,78,1,94.10929737,Arch
7587515d345eb0d9f0aaa96a6a70465d4c2df9e4,3,62,24,38,0,0,0,1,43,29,1,2,1.21132135,1259,232,21,156,152,4,6273,6199,74,66,62,4,0,100,NoArch
5fc2f1b8690b247e0b8f451caec0ba1dc13d4132,2,20,0,20,0,0,0,1,5,26,1,1,1,461,233,22,84,78,6,1958,1858,100,56,56,0,0,100,NoArch
67fafe27cc285fe0cf17a147224a059d6271a886,2,26,30,4,0,0,0,1,12,26,1,2,0.591672779,546,234,23,81,81,0,2587,2573,14,29,29,0,0,100,NoArch
2835555933a8bbaa78b85589471b8040bdcd981a,5,94,20,74,0,0,0,4,31,54,1,3,1.733067614,2073,229,0,317,311,6,11866,11215,651,140,139,1,1,99.96491228,NoArch
af5885061e0760ade8b973485502c4f447704fac,25,155,65,90,0,0,0,2,16,25,1,15,4.059180695,3316,235,10,358,359,1,18389,18266,123,143,143,0,0,100,NoArch
6f08ad76e861bc6711e9861e2f4cb94b9434d95c,1,10,4,6,0,0,0,1,9,104,1,1,0,95,236,10,10,10,0,438,403,35,9,9,0,0,100,NoArch
da03b2302af2f51253685da4030a59f5144a2ba4,68,208,269,61,0,1,1,2,25,65,3,29,4.616001518,11724,237,10,1500,1515,15,61076,61237,161,678,683,5,1,96.85512367,Arch
5df646ece7ffe0cdb922a04eb8485aa1d7340fa3,2,2,2,0,0,0,0,1,8,82,1,1,1,86,238,11,2,2,0,438,438,0,2,2,0,1,100,NoArch
a4664320567a2627bd3c1f23faca84729a5962a5,12,70,84,14,0,0,0,1,21,42,1,4,3.235967929,2889,239,9,400,404,4,15453,15608,155,147,147,0,0,99.27614911,NoArch
543213bfe62095487237be3bc07535fadabb971f,7,152,24,128,2,0,2,1,4,17,1,3,2.062414223,1060,240,10,227,214,13,4932,4330,602,94,88,6,0,99.0964944,NoArch
095f4356f145696ef9d887357dbee09aca28ce6b,0,0,0,0,0,0,0,0,0,0,0,0,0,0,230,1,0,0,0,0,0,0,0,0,0,0,100,NoArch
90fe0a203290e1ceded177d7b354e68e9637fc2a,9,38,21,17,0,0,0,1,6,69,1,6,2.638905348,816,231,2,85,84,1,3624,3436,188,43,42,1,1,99.54014857,NoArch
9416447d0aeb84b2c4c08833d2914c377fe26700,36,213,293,80,0,0,0,2,44,68,3,26,4.42745663,7600,241,11,825,826,1,43665,44103,438,313,310,3,1,98.15284317,NoArch
e6f27f1171b408932a5915eaf2925ea57402c60d,2,15,34,19,0,1,1,2,4,32,1,2,0.997294382,151,232,3,14,14,0,495,540,45,7,7,0,0,99.92553984,NoArch
5ca50f3b8975b84425a4b4fb90d5fe272dedfb93,1,1,1,0,0,0,0,2,4,57,1,1,0,232,233,4,22,22,0,2035,2034,1,3,3,0,0,100,NoArch
217b964e9b54c0ed18c24d423ee4472e38ee034d,1,2,2,0,0,0,0,3,4,19,1,1,0,346,2,0,30,30,0,2381,2381,0,7,7,0,1,100,NoArch
4b6a029226adaed6549439553f8983bd5bbd34b6,1,4,1,3,0,0,0,1,6,104,1,1,0,39,242,7,1,1,0,192,170,22,1,1,0,0,100,NoArch
18d1a48178dee6d930c29e444c5352b6e9a548f2,1,90,25,65,0,0,0,3,10,209,1,1,0,95,3,1,6,6,0,1323,426,897,3,4,1,1,97.58897819,Arch
4020e68ad11893642913dcdf44cf824970d867bc,1,67,7,60,0,0,0,3,4,209,1,1,0,67,4,2,6,4,2,933,275,658,3,3,0,1,99.9606609,NoArch
89607ffb61c19068b1f06ea4804ebfed835acc92,89,174,155,19,0,0,0,2,34,78,3,36,6.084268011,13228,243,8,1286,1286,0,75057,75040,17,522,522,0,1,93.70574351,Arch
42f986b32a3b8b65e79bcbfe345903a5708f538b,1,69,9,60,0,0,0,3,6,209,1,1,0,200,5,3,13,11,2,1818,1120,698,7,7,0,1,100,NoArch
b11989c85e8afe871e0c2b595968f2e319f44cde,1,1,1,0,0,0,0,3,7,0,1,1,0,260,6,4,13,13,0,1818,1818,0,7,7,0,1,97.2027972,Arch
0a26e036d0337a22bbc2eb6050dd54d3ab033ae0,8,36,41,5,0,0,0,3,12,124,1,8,2.494600002,1336,244,9,165,166,1,6677,6687,10,69,69,0,0,100,NoArch
b530d4dc9204d42beb2197055db461b22a48d80c,1,20,16,4,0,0,0,6,27,0,1,1,0,327,7,5,40,39,1,1393,1363,30,22,22,0,1,100,NoArch
4dd7df6be7d1f459b58885f7041e4cc073b2d975,6,243,75,168,1,0,1,1,12,70,1,4,2.357844451,732,8,6,46,35,11,5954,4962,992,26,19,7,1,98.27262486,NoArch
72929a6e3250829fc7e0d27798a057ed05a2ec40,1,2,3,1,0,0,0,2,8,9,1,1,0,218,245,8,27,27,0,862,875,13,20,20,0,0,100,NoArch
286addc849ba11b5333d8a04d37e085f96734116,0,0,0,0,0,0,0,0,0,0,0,0,0,0,246,4,0,0,0,0,0,0,0,0,0,0,100,NoArch
1ad8a29cabe4947cea06e4d96de5d7e3c145046e,0,0,0,0,0,0,0,0,0,0,0,0,0,0,247,5,0,0,0,0,0,0,0,0,0,0,100,NoArch
d9d3e15732f2a6e2ad499e412ea3739e9cf31844,1,4,4,0,0,0,0,2,6,232,1,1,0,68,248,6,6,6,0,334,325,9,2,2,0,0,100,NoArch
cc453b494aab9adad6c0039a9ddb432a23aba86a,7,13,16,3,0,0,0,2,12,584,1,2,2.319515777,933,249,7,63,66,3,4195,4197,2,28,28,0,0,100,NoArch
7d4e73d039940b73571ec8d9cb347b169a0aee95,0,0,0,0,0,0,0,0,0,0,0,0,0,0,250,8,0,0,0,0,0,0,0,0,0,0,100,NoArch
8c37a844c7dc2f67c7dc88ea42604efe324aa8be,44,5294,0,5294,44,0,44,1,1,0,2,13,5.100242017,0,0,0,522,0,522,21665,0,21665,222,0,222,1,96.45365169,Arch
a8f9f8875ecb1fc61738cbd35357b1daf6bfc15b,15,2438,0,2438,15,0,15,1,1,0,1,6,3.71962162,0,1,1,247,0,247,9665,0,9665,138,0,138,1,98.29773031,NoArch
287b72b3d6358a24cb725627461aa06c1fa3f0ff,30,5494,0,5494,30,0,30,1,1,0,2,6,4.793520318,0,2,2,374,0,374,27054,0,27054,175,0,175,1,97.03776042,Arch
8547de7acdd06df851a3445f59279ad30543822c,83,656,595,61,1,0,1,2,2,0,1,24,5.967497481,12391,251,6,1158,1120,38,54084,53904,180,544,520,24,1,99.52320407,NoArch
5820585d1fbef5cf715236ef62a988bdcf49dc39,12,204,109,95,2,0,2,4,15,84,2,4,3.329495513,1252,9,0,55,60,5,7262,6587,675,24,31,7,1,99.74739501,NoArch
e89736f921bd11ff0128f1d58c516b3ca312ab9e,1,1,1,0,0,0,0,1,2,2,1,1,0,77,10,1,3,3,0,422,420,2,1,1,0,1,100,NoArch
c4072b06d611145eb6a60b674e9df0db59bc3c7f,1,3,2,1,0,0,0,2,13,77,1,1,0,147,252,7,10,10,0,904,901,3,2,2,0,1,100,NoArch
acafdc0f0fe155b3063e65fca4f935304822b437,54,195,221,26,0,0,0,2,35,35,2,29,5.206731942,10768,253,8,1186,1188,2,49452,49467,15,522,520,2,1,100,NoArch
abe21371c50c697196798d1b3cb0c2f71375aa9e,0,0,0,0,0,0,0,0,0,0,0,0,0,0,3,3,0,0,0,0,0,0,0,0,0,1,100,NoArch
a2d1b8050942e0213828d2bc7f1e782cbe51128b,4,159,21,138,0,0,0,1,11,157,1,2,1.688327013,371,11,2,25,19,6,3315,2055,1260,16,16,0,1,97.62137504,Arch
8a86b759b428f0f111a589814812088f23409521,5,38,15,23,0,0,0,2,6,140,1,4,2.269253902,324,12,3,27,26,1,1839,1637,202,12,12,0,1,100,NoArch
1970d8829a0290533db5d03c75c40e5c84c0d269,1,60,0,60,1,0,1,1,1,0,1,1,0,0,13,4,2,0,2,350,0,350,1,0,1,1,97.38323948,Arch
254af094d6a7dc7fcc63a0bf4a991bd8894aa60d,51,168,184,16,0,0,0,2,29,89,3,29,4.479238101,8977,254,6,945,946,1,52609,52776,167,418,416,2,0,97.07738293,Arch
efcd32d0cc235897f4cf180f7743c7064b443a5f,1,1,1,0,0,0,0,3,10,1,1,1,0,251,4,4,21,21,0,1515,1513,2,14,14,0,0,100,NoArch
c7ed48699d97618399044cea050ecb4405469194,2,146,44,102,0,0,0,4,13,53,1,2,0.945273297,398,5,5,31,25,6,3166,2058,1108,11,11,0,1,96.67994688,Arch
e75b077728353cc75dfcea5d5105dae876f9b1c0,2,4,4,0,0,0,0,3,9,2,1,1,1,242,255,4,12,12,0,1681,1681,0,6,6,0,0,100,NoArch
d50182061f416656b763abcda8fb0a2e01a22bda,36,736,1105,369,2,6,8,4,22,45,2,8,4.684254881,3918,256,5,298,297,1,20052,22128,2076,101,102,1,1,98.76663421,NoArch
9a23b72c87ae9b41aa99f3a9e177026ed585d29b,1,95,48,47,0,0,0,4,13,68,1,1,0,210,6,6,32,27,5,1403,1236,167,7,7,0,1,100,NoArch
c145861f0e9e7585366bf6ba062251b7cfd603bc,1,0,3,3,0,0,0,1,26,103,1,1,0,208,257,6,31,32,1,1323,1343,20,4,4,0,0,100,NoArch
3af7201cb7478913993507db6cf85e41bc94f05c,4,62,69,7,0,0,0,2,3,60,1,2,1.373792394,335,234,0,34,29,5,1646,1605,41,16,15,1,1,100,NoArch
0b8a660387cee5bb573892efeeec2c31ff3cbfbb,17,455,129,326,0,0,0,4,19,107,2,10,3.330612122,2008,14,5,113,103,10,15936,12320,3616,60,60,0,1,97.98746288,Arch
11e92a3c2fba0ba9fe1ac3a8b61020a4f04567e1,2,8,8,0,0,0,0,5,11,0,1,2,0.543564443,247,15,6,11,11,0,1739,1717,22,6,6,0,1,100,NoArch
d6b8130f2ccdb7a656a03ac066b942cbe99d1fbe,0,0,0,0,0,0,0,0,0,0,0,0,0,0,258,7,0,0,0,0,0,0,0,0,0,0,100,NoArch
4139a9a8358fbe9cba42362d2e1d0614339ea652,6,13,17,4,0,0,0,2,7,18,1,5,2.160964047,407,259,8,30,29,1,2143,2189,46,14,13,1,0,100,NoArch
1dc91b27b74f6a625632a6da9fde57996a5bc9ac,2,26,13,13,0,0,0,3,45,142,1,2,0.89049164,504,260,9,75,74,1,2551,2481,70,29,29,0,0,100,NoArch
e18ba10ebe5af534d8a65f3532faed958e3b3203,0,0,0,0,0,0,0,0,0,0,0,0,0,0,261,10,0,0,0,0,0,0,0,0,0,0,100,NoArch
1429d48ecf37c5e8427cd8872a2ef20dd82a157f,0,0,0,0,0,0,0,0,0,0,0,0,0,0,262,11,0,0,0,0,0,0,0,0,0,1,100,NoArch
de680d0396ec6900ed8bf9d9a6cb75007016dbaa,1,11,3,8,0,0,0,1,7,0,1,1,0,60,263,12,6,5,1,379,332,47,3,2,1,0,100,NoArch
90ba2a1ce84581b03b04678bcc0019a87b6f4bf0,1,2,1,1,0,0,0,3,11,35,1,1,0,121,7,4,10,10,0,696,680,16,5,5,0,1,100,NoArch
d0ef5126194fbe80054cfa3833730f13c206b1f1,40,165,182,17,0,0,0,4,46,41,1,25,3.274218251,7347,264,13,755,753,2,38742,38962,220,349,348,1,0,99.89909183,NoArch
1c87313a36d374fb4bba754b7d9ba42dce25d6f4,3,0,7,7,0,0,0,2,5,0,1,3,1.556656707,806,8,5,75,75,0,4371,4396,25,28,28,0,0,100,NoArch
0bff77cf53372dcdcf680881ec972cf8313a0704,0,0,0,0,0,0,0,0,0,0,0,0,0,0,265,13,0,0,0,0,0,0,0,0,0,0,100,NoArch
288156fb37e851730047230ab8a040193981b17a,27,3563,0,3563,27,0,27,1,1,0,2,8,4.224814771,0,1,0,387,0,387,18362,0,18362,160,0,160,1,96.31306598,Arch
7cd7e7e53537de8947446722943101816f9c12fd,0,0,0,0,0,0,0,0,0,0,0,0,0,0,2,1,0,0,0,0,0,0,0,0,0,1,100,NoArch
cad7b5ad6baf9fbbc51e7ee32cec3c4b87dfd269,3,54,43,11,0,0,0,1,3,84,1,2,1.537220503,307,3,2,35,33,2,1738,1667,71,13,14,1,1,99.78267619,NoArch
5651a1c97fe9dbbbbffd00a0764182ddae56cd73,3,5,5,0,0,0,0,1,2,0,1,2,1.521928095,341,4,3,41,41,0,1680,1682,2,18,18,0,0,100,NoArch
7f8418365775dbfac768e5cf2371b00bd9976581,0,0,0,0,0,0,0,0,0,0,0,0,0,0,16,5,0,0,0,0,0,0,0,0,0,1,100,NoArch
f3a3d400fe8d049a4dced93bcfbb0598028c802e,8,230,138,92,0,0,0,4,23,12,2,5,1.792382368,1316,5,4,142,132,10,8738,8249,489,52,52,0,1,99.75224528,NoArch
914a86d5d5966bee469f9d7dfd70f86d8c8d6f34,0,0,0,0,0,0,0,0,0,0,0,0,0,0,17,6,0,0,0,0,0,0,0,0,0,1,100,NoArch
fe5698ba95b792237353670155207db2434d5996,17,787,792,5,0,0,0,1,3,1,1,6,2.209884435,2583,6,5,315,314,1,13361,13352,9,120,119,1,0,100,NoArch
937e64ecdc9255b52f8d177cd15f369c48c2fab2,1,69,15,54,0,0,0,3,13,14,1,1,0,159,266,12,6,6,0,1169,1128,41,3,3,0,0,100,NoArch
d951f3ea72af3675c1c757ae15a7d6fef285aa53,1,5,5,0,0,0,0,1,3,0,1,1,0,612,7,6,82,82,0,3437,3437,0,12,12,0,0,100,NoArch
b5bbe2ed4004d7145c5db2934137e080915a33be,80,343,369,26,0,0,0,2,24,81,3,39,5.319324889,12486,267,13,1271,1270,1,64227,64493,266,569,567,2,0,100,NoArch
f483d0e0f5f3fd6f1de748dcf244c867b9f69291,0,0,0,0,0,0,0,0,0,0,0,0,0,0,268,14,0,0,0,0,0,0,0,0,0,0,100,NoArch
1073c721d41fe36c355765753e8ab4280cc1ab41,0,0,0,0,0,0,0,0,0,0,0,0,0,0,269,15,0,0,0,0,0,0,0,0,0,0,100,NoArch
f92849f8334724e0e619bbaeeec724c07c5f2973,3,6,7,1,0,0,0,1,16,167,1,1,1.314320487,285,270,16,35,35,0,1600,1613,13,7,7,0,0,100,NoArch
c4d5b16c52110491e8e690cc963a8d6c186be301,0,0,0,0,0,0,0,0,0,0,0,0,0,0,271,17,0,0,0,0,0,0,0,0,0,0,100,NoArch
7bacea948155a19cdcf1eed989cacc4a97e30c6f,0,0,0,0,0,0,0,0,0,0,0,0,0,0,272,18,0,0,0,0,0,0,0,0,0,0,100,NoArch
48eb62267e5952ced1d2c54602eb683f529cedca,0,0,0,0,0,0,0,0,0,0,0,0,0,0,273,19,0,0,0,0,0,0,0,0,0,0,100,NoArch
4c4d94e8c43b68981b5434d011309d5c2c7a7393,0,0,0,0,0,0,0,0,0,0,0,0,0,0,274,20,0,0,0,0,0,0,0,0,0,0,100,NoArch
5ed200f6e138050f04943c400f512694064f6ea5,0,0,0,0,0,0,0,0,0,0,0,0,0,0,275,21,0,0,0,0,0,0,0,0,0,0,100,NoArch
d82296bf4c7085761652105ee4b42a333cf561d1,0,0,0,0,0,0,0,0,0,0,0,0,0,0,276,22,0,0,0,0,0,0,0,0,0,0,100,NoArch
40b1c16e26349e722c818ba6151823e6e1eaafdb,1,4,2,2,0,0,0,2,5,7,1,1,0,604,8,7,81,81,0,3342,3337,5,12,12,0,0,100,NoArch
d8e70442b4e3d9d1de331ee309a156be561a419a,0,0,0,0,0,0,0,0,0,0,0,0,0,0,235,1,0,0,0,0,0,0,0,0,0,0,100,NoArch
a03bb1167293d98a0a0048d5e9c1545b3b82d48d,0,0,0,0,0,0,0,0,0,0,0,0,0,0,236,2,0,0,0,0,0,0,0,0,0,0,100,NoArch
ef9062cff748a220351fb9ea7f49853d136382ba,0,0,0,0,0,0,0,0,0,0,0,0,0,0,237,3,0,0,0,0,0,0,0,0,0,0,100,NoArch
3d8f73e6af09d93a5430494263783f6ade06a1cc,0,0,0,0,0,0,0,0,0,0,0,0,0,0,238,4,0,0,0,0,0,0,0,0,0,0,100,NoArch
a829d8ca3acc0f96b7dc61bbbe67371b098e6117,0,0,0,0,0,0,0,0,0,0,0,0,0,0,239,5,0,0,0,0,0,0,0,0,0,0,100,NoArch
8c3742cbd84d7cc8a78ac039c32eb87cfa2c3b6e,0,0,0,0,0,0,0,0,0,0,0,0,0,0,240,6,0,0,0,0,0,0,0,0,0,0,100,NoArch
37cb1bea8aca0dc09dadc1a3ccb680c44fa6a872,0,0,0,0,0,0,0,0,0,0,0,0,0,0,277,20,0,0,0,0,0,0,0,0,0,0,100,NoArch
93d60a05297c364410307d0c5b934e77140d49c0,0,0,0,0,0,0,0,0,0,0,0,0,0,0,278,21,0,0,0,0,0,0,0,0,0,0,100,NoArch
ea615061e8605aacc2cb787d4f7c8ff272a255a8,0,0,0,0,0,0,0,0,0,0,0,0,0,0,279,22,0,0,0,0,0,0,0,0,0,0,100,NoArch
0d511716a299e8cbd21429616f01d5a4f2c88ca4,0,0,0,0,0,0,0,0,0,0,0,0,0,0,280,23,0,0,0,0,0,0,0,0,0,0,100,NoArch
64c19ef74360a4ebb91a58811dfd1fdcaf1a0fb3,1,6,0,6,0,0,0,2,5,323,1,1,0,63,281,24,10,9,1,203,192,11,6,5,1,0,100,NoArch
70bfd52f198895485b9910d6123d64eb52dd1aa0,5,130,66,64,3,0,3,1,7,6,1,1,2.007078059,395,282,25,46,45,1,1290,1295,5,27,26,1,0,99.78388391,NoArch
f1bb02fc00fa605c0c4a119536a72c70fe6df79d,0,0,0,0,0,0,0,0,0,0,0,0,0,0,283,26,0,0,0,0,0,0,0,0,0,0,100,NoArch
b6f37a5cf89037a4aa6c0fa9f635aeb75f2e2340,0,0,0,0,0,0,0,0,0,0,0,0,0,0,241,7,0,0,0,0,0,0,0,0,0,0,100,NoArch
79694a950f85f2f3b169e1c039a52b12fab3abc6,0,0,0,0,0,0,0,0,0,0,0,0,0,0,242,8,0,0,0,0,0,0,0,0,0,0,100,NoArch
8d369480bad4813d97932484b6c63d61bee4519c,0,0,0,0,0,0,0,0,0,0,0,0,0,0,243,9,0,0,0,0,0,0,0,0,0,0,100,NoArch
98946e8022476c8e83e4f4aa474fefc80e0b551a,0,0,0,0,0,0,0,0,0,0,0,0,0,0,244,10,0,0,0,0,0,0,0,0,0,0,100,NoArch
6d5ffcd250d6ff7f552aaf999f435dff07227d46,0,0,0,0,0,0,0,0,0,0,0,0,0,0,245,11,0,0,0,0,0,0,0,0,0,0,100,NoArch
e01672cacfa361300316a3b8bd7ef497f33a958f,0,0,0,0,0,0,0,0,0,0,0,0,0,0,246,12,0,0,0,0,0,0,0,0,0,0,100,NoArch
bef33c44c6165c5c96c6cbae7e8d6f14bc088609,0,0,0,0,0,0,0,0,0,0,0,0,0,0,247,13,0,0,0,0,0,0,0,0,0,0,100,NoArch
ffee40634d9e2b2fa04e3d797cfceeb2985640a9,0,0,0,0,0,0,0,0,0,0,0,0,0,0,248,14,0,0,0,0,0,0,0,0,0,0,100,NoArch
e5202fa398606c92c3b05dc540ed2ebc4dec6f88,0,0,0,0,0,0,0,0,0,0,0,0,0,0,249,15,0,0,0,0,0,0,0,0,0,0,100,NoArch
29b61e9780999460580ae680c1b5b3c24cf69af1,0,0,0,0,0,0,0,0,0,0,0,0,0,0,250,16,0,0,0,0,0,0,0,0,0,0,100,NoArch
37e61f4344b03aab294bc7e5dfb4bbe4de8b9ba0,0,0,0,0,0,0,0,0,0,0,0,0,0,0,250,16,0,0,0,0,0,0,0,0,0,0,100,NoArch
0336ea5f348d5f0d76223962d4f85f19dd61e594,0,0,0,0,0,0,0,0,0,0,0,0,0,0,251,17,0,0,0,0,0,0,0,0,0,0,100,NoArch
ac9d92936130f8162cf224e21b3e4a8748be6fe2,0,0,0,0,0,0,0,0,0,0,0,0,0,0,252,18,0,0,0,0,0,0,0,0,0,0,100,NoArch
8763f92b9fc0ed1cba20b94a194b21d3bf5d27d2,0,0,0,0,0,0,0,0,0,0,0,0,0,0,253,19,0,0,0,0,0,0,0,0,0,0,100,NoArch
f9f7a6c62c4fc0e2439a930a2f77b3453852cbc9,0,0,0,0,0,0,0,0,0,0,0,0,0,0,254,20,0,0,0,0,0,0,0,0,0,0,100,NoArch
94ef0871ae6f70d8304f82f1fd17d00a818363f4,0,0,0,0,0,0,0,0,0,0,0,0,0,0,255,21,0,0,0,0,0,0,0,0,0,0,100,NoArch
7bcfb13f086d6764f980e95c4cdb7a60de607c10,1,3,0,3,0,0,0,1,10,24,1,1,0,74,284,26,8,7,1,404,369,35,2,2,0,1,100,NoArch
0c785b2787ef089f88ffdea1823a78924df23b38,1,1,1,0,0,0,0,1,4,225,1,1,0,259,285,19,40,40,0,1388,1388,0,17,17,0,0,100,NoArch
7f0d7748f209281a6446b85e90b55e3f2345bed6,28,147,51,96,0,0,0,2,32,90,2,15,4.609364934,4691,286,20,605,558,47,21708,21311,397,257,257,0,1,100,NoArch
21388ac0b782811a4dcfcafaf3b1aaf470b6ad66,0,0,0,0,0,0,0,0,0,0,0,0,0,0,256,21,0,0,0,0,0,0,0,0,0,0,100,NoArch
a9d47369e106eed077f342f638fdb5e50a2a57ab,0,0,0,0,0,0,0,0,0,0,0,0,0,0,257,22,0,0,0,0,0,0,0,0,0,0,100,NoArch
09ddad525bfa22ab2dfe6800a56867042ad46832,0,0,0,0,0,0,0,0,0,0,0,0,0,0,258,23,0,0,0,0,0,0,0,0,0,0,100,NoArch
a20fc52a0062d4f8cbb8760f494f26b3296ea5cf,0,0,0,0,0,0,0,0,0,0,0,0,0,0,259,24,0,0,0,0,0,0,0,0,0,0,100,NoArch
def063ca691d74a599e7e790662a8097ab8613e0,0,0,0,0,0,0,0,0,0,0,0,0,0,0,260,25,0,0,0,0,0,0,0,0,0,0,100,NoArch
6ebe4f4b82e23a8544e348ba1fe75255a3f011f3,37,310,139,171,0,0,0,4,13,121,2,12,4.587111697,4976,287,17,430,396,34,28764,28160,604,241,207,34,1,97.46223565,Arch
b19c3b95d36279476da846a738f592c027705413,8,227,60,167,0,0,0,1,19,244,1,4,2.706030841,1787,288,18,332,315,17,7552,7318,234,210,196,14,0,99.88119988,NoArch
220c529f8db7552b2d1ee16163d686dd9fe8883d,1,22,4,18,0,0,0,1,11,231,1,1,0,116,289,19,20,17,3,632,560,72,4,4,0,0,100,NoArch
91ca078c6e1f0f2aaea449db505c8cbc87ab8541,1,5,2,3,0,0,0,1,27,69,1,1,0,205,290,20,32,31,1,1342,1323,19,4,4,0,0,100,NoArch
8be8b5e820eedc76b6a3bfc0ab218f429a1c5489,1,1,1,0,0,0,0,1,6,4,1,1,0,167,291,14,33,33,0,841,833,8,14,14,0,0,100,NoArch
ae78fc3ded0f6bea3e98218fdf94b6435f81ce1d,2,10,9,1,0,0,0,1,22,246,1,2,0.485460761,450,292,15,50,51,1,2052,2065,13,13,13,0,1,100,NoArch
d28be5211dad13db16dbdc5654f3b14b7d5f91bc,0,0,0,0,0,0,0,0,0,0,0,0,0,0,293,16,0,0,0,0,0,0,0,0,0,0,100,NoArch
b646b177737ffb8a2cd05ff67b4d49affa14f9f9,0,0,0,0,0,0,0,0,0,0,0,0,0,0,18,0,0,0,0,0,0,0,0,0,0,0,100,NoArch
24d6e96f23b29894d4e3441049a2f2f8a307d499,4,68,6,62,0,0,0,1,17,96,1,2,1.144305676,356,294,17,43,36,7,1852,1704,148,12,7,5,1,100,NoArch
db58aa5f495596e9ecf9459d163e39e39b803806,1,1,0,1,0,0,0,3,47,63,1,1,0,457,295,14,70,70,0,2223,2219,4,27,27,0,0,100,NoArch
7d214cd60fd56476b4c52192673ad926c54e1ae0,8,128,79,49,0,0,0,1,18,225,1,2,2.279219417,735,296,15,101,96,5,3330,3120,210,59,51,8,0,100,NoArch
faccaf27eee8c9f393cdcbc1d9bc6ca8cbb22e64,1,33,10,23,0,0,0,1,8,68,1,1,0,68,297,16,6,6,0,500,379,121,5,3,2,0,100,NoArch
df73dbca9bea7c5be04e1d6f1ba5a6cb02dbff37,23,112,0,112,0,0,0,4,11,70,1,8,4.343519262,3120,9,0,252,235,17,16006,15557,449,122,105,17,0,99.97029115,NoArch
2e2c4aa8aa1f542d50e440f5518dc733808aa95c,3,6,4,2,0,0,0,1,23,127,1,2,1.521928095,645,298,14,86,86,0,3575,3557,18,33,33,0,0,100,NoArch
12abbc0fee5ba28c6c622b7f618dba9ff75b2fa7,3,5,9,4,0,0,0,1,24,90,1,3,1.431560284,674,299,15,83,84,1,4092,4096,4,32,33,1,0,100,NoArch
fc74924ecccd7cccb19f4f68961e1be55f22c41e,70,424,295,129,0,0,0,2,33,83,2,31,5.159870667,12796,300,16,1562,1530,32,59466,58716,750,810,778,32,1,100,NoArch
db394ce9527db1a043c998e67eeb53ac35687cb8,0,0,0,0,0,0,0,0,0,0,0,0,0,0,261,18,0,0,0,0,0,0,0,0,0,0,100,NoArch
90e6dcf339b8bf27903c79fa41b4abcdef9df6af,0,0,0,0,0,0,0,0,0,0,0,0,0,0,262,18,0,0,0,0,0,0,0,0,0,0,100,NoArch
5f157b2e398c94d1b89f520e5d1e16a8a728e1fb,0,0,0,0,0,0,0,0,0,0,0,0,0,0,263,19,0,0,0,0,0,0,0,0,0,0,100,NoArch
8678ef0fae80b6ed9d75488653057c63199e9c18,1,1,1,0,0,0,0,2,7,0,1,1,0,133,301,17,20,20,0,499,499,0,14,14,0,0,100,NoArch
95503705da3ea00c99cb71088687599d0d4189d3,0,0,0,0,0,0,0,0,0,0,0,0,0,0,264,13,0,0,0,0,0,0,0,0,0,0,100,NoArch
bb48e9d64982993e4b85d96a16b67f6631367969,0,0,0,0,0,0,0,0,0,0,0,0,0,0,265,14,0,0,0,0,0,0,0,0,0,0,100,NoArch
0d662e03f16bc5fcd1955c4d76f538c00456240d,0,0,0,0,0,0,0,0,0,0,0,0,0,0,266,10,0,0,0,0,0,0,0,0,0,0,100,NoArch
00ee52c04c833f2893aefc63bd734d9489454915,0,0,0,0,0,0,0,0,0,0,0,0,0,0,267,11,0,0,0,0,0,0,0,0,0,0,100,NoArch
f6f2db83fea8cbb39a52c1cca782ed5842981eef,0,0,0,0,0,0,0,0,0,0,0,0,0,0,268,12,0,0,0,0,0,0,0,0,0,0,100,NoArch
e1e410a02de825a00ce2d174133988106cae1cc2,0,0,0,0,0,0,0,0,0,0,0,0,0,0,269,13,0,0,0,0,0,0,0,0,0,0,100,NoArch
37aff7c88b0647c5b51bc52f5deea7f63c812202,0,0,0,0,0,0,0,0,0,0,0,0,0,0,270,14,0,0,0,0,0,0,0,0,0,0,100,NoArch
2d5a87a73a0b1b57b73c18aea76f082265c000e4,0,0,0,0,0,0,0,0,0,0,0,0,0,0,271,15,0,0,0,0,0,0,0,0,0,0,100,NoArch
13aaad6b0671a5599aba98eace7f3ebe81c7a695,0,0,0,0,0,0,0,0,0,0,0,0,0,0,272,16,0,0,0,0,0,0,0,0,0,0,100,NoArch
a5d11b9b60499ab6229ba3ae68dedab6f527fb18,0,0,0,0,0,0,0,0,0,0,0,0,0,0,273,17,0,0,0,0,0,0,0,0,0,0,100,NoArch
252a83d0991a8dbcb7490658ba450ed230077ba2,0,0,0,0,0,0,0,0,0,0,0,0,0,0,274,18,0,0,0,0,0,0,0,0,0,0,100,NoArch
7a44135725ad69ead8896c0d7bd7f2f1f059c112,0,0,0,0,0,0,0,0,0,0,0,0,0,0,275,19,0,0,0,0,0,0,0,0,0,0,100,NoArch
4eb4e7593c1eb6deaa23cb5e8d762efbc98ad4a0,0,0,0,0,0,0,0,0,0,0,0,0,0,0,276,20,0,0,0,0,0,0,0,0,0,0,100,NoArch
32d1134d09b73a573518d00af1a55a18db864722,0,0,0,0,0,0,0,0,0,0,0,0,0,0,277,21,0,0,0,0,0,0,0,0,0,0,100,NoArch
9d2b6511351e6e7c2b94703269a0638d03905ab6,0,0,0,0,0,0,0,0,0,0,0,0,0,0,278,22,0,0,0,0,0,0,0,0,0,0,100,NoArch
76eac2cddcfbdea532f63abd4898156e0246a164,0,0,0,0,0,0,0,0,0,0,0,0,0,0,279,23,0,0,0,0,0,0,0,0,0,0,100,NoArch
01ee1f8bb59e9e2e910b3eea3107814f7f07384d,0,0,0,0,0,0,0,0,0,0,0,0,0,0,280,24,0,0,0,0,0,0,0,0,0,0,100,NoArch
4928fe3b0c94e331712ab9a19ccb0d9389481820,0,0,0,0,0,0,0,0,0,0,0,0,0,0,281,25,0,0,0,0,0,0,0,0,0,0,100,NoArch
1b8aaccf3338124f07b8644dc8e4fbdf261e8da2,0,0,0,0,0,0,0,0,0,0,0,0,0,0,282,26,0,0,0,0,0,0,0,0,0,0,100,NoArch
9e9bcdc13fbff9b821f199f24d4f8050e0e2bde8,0,0,0,0,0,0,0,0,0,0,0,0,0,0,283,27,0,0,0,0,0,0,0,0,0,0,100,NoArch
29830dea0f477f50390563d4480dac517323c2ba,0,0,0,0,0,0,0,0,0,0,0,0,0,0,284,28,0,0,0,0,0,0,0,0,0,0,100,NoArch
7e632b7aad89e40ea1c007e40baac094560d7d04,0,0,0,0,0,0,0,0,0,0,0,0,0,0,285,29,0,0,0,0,0,0,0,0,0,0,100,NoArch
3db0fde074e290415873abeed4445c60b24a6acd,0,0,0,0,0,0,0,0,0,0,0,0,0,0,286,30,0,0,0,0,0,0,0,0,0,0,100,NoArch
b68ed1a23061177dd3bcbcf871ec71aef0829616,0,0,0,0,0,0,0,0,0,0,0,0,0,0,287,31,0,0,0,0,0,0,0,0,0,0,100,NoArch
f5dbb8525d5d7e6012b6dea9662c5bfe649f539d,0,0,0,0,0,0,0,0,0,0,0,0,0,0,288,32,0,0,0,0,0,0,0,0,0,0,100,NoArch
07f6b703fe11088e57de3f43a0203dd3327097ca,0,0,0,0,0,0,0,0,0,0,0,0,0,0,289,33,0,0,0,0,0,0,0,0,0,0,100,NoArch
5934fc00ebef4f475d7b58d6153703cff7d4cbe7,0,0,0,0,0,0,0,0,0,0,0,0,0,0,290,34,0,0,0,0,0,0,0,0,0,0,100,NoArch
9b4c1693d9ecfd00a59d83a8952dd5ce04959396,0,0,0,0,0,0,0,0,0,0,0,0,0,0,291,35,0,0,0,0,0,0,0,0,0,0,100,NoArch
1a7841f59ba0a37212a134c6b2f3274dcbc6c454,0,0,0,0,0,0,0,0,0,0,0,0,0,0,292,36,0,0,0,0,0,0,0,0,0,0,100,NoArch
fccd9b79234d1042eab21dca76c90ef731c46a86,0,0,0,0,0,0,0,0,0,0,0,0,0,0,293,37,0,0,0,0,0,0,0,0,0,0,100,NoArch
dafcde0f4ff3b5feffc9ed41019b3a34895af6ee,0,0,0,0,0,0,0,0,0,0,0,0,0,0,294,38,0,0,0,0,0,0,0,0,0,0,100,NoArch
10535a2cffa99d956cca1a9be5d29b5ddd96fefd,0,0,0,0,0,0,0,0,0,0,0,0,0,0,295,39,0,0,0,0,0,0,0,0,0,0,100,NoArch
4cbe27e143b15104261d7f98c8380ca5a0b695e8,0,0,0,0,0,0,0,0,0,0,0,0,0,0,296,40,0,0,0,0,0,0,0,0,0,0,100,NoArch
1a676633f7331818cbc748ac16a4415a1a815ee4,0,0,0,0,0,0,0,0,0,0,0,0,0,0,297,41,0,0,0,0,0,0,0,0,0,0,100,NoArch
645ebf318a461256183ed68daea0a0745f8fd1c3,0,0,0,0,0,0,0,0,0,0,0,0,0,0,298,42,0,0,0,0,0,0,0,0,0,0,100,NoArch
acb473baaacf11fd22d0b4ca346d3cc138ab0269,0,0,0,0,0,0,0,0,0,0,0,0,0,0,299,43,0,0,0,0,0,0,0,0,0,0,100,NoArch
8f6fa7291a1ea74926c36b199e051da176c9b180,0,0,0,0,0,0,0,0,0,0,0,0,0,0,300,44,0,0,0,0,0,0,0,0,0,0,100,NoArch
160068d2f6e7308c956c02f804ca52a0a1af7575,0,0,0,0,0,0,0,0,0,0,0,0,0,0,301,45,0,0,0,0,0,0,0,0,0,0,100,NoArch
6faea8b79042ef00327445a62327af1a367fb356,0,0,0,0,0,0,0,0,0,0,0,0,0,0,302,46,0,0,0,0,0,0,0,0,0,0,100,NoArch
a5f9b42aeaaa022a59a3405e7362f21101deb74b,0,0,0,0,0,0,0,0,0,0,0,0,0,0,303,47,0,0,0,0,0,0,0,0,0,0,100,NoArch
df651b191283d1e171b3359a0ae86078e1eec23f,0,0,0,0,0,0,0,0,0,0,0,0,0,0,304,48,0,0,0,0,0,0,0,0,0,1,100,NoArch
ff7ab7ce3d274f200e8cc664ebf9b0b2e8c59b77,0,0,0,0,0,0,0,0,0,0,0,0,0,0,305,49,0,0,0,0,0,0,0,0,0,1,100,NoArch
edf852edb6e025c98268a147f324cd7c06ec5f94,0,0,0,0,0,0,0,0,0,0,0,0,0,0,306,50,0,0,0,0,0,0,0,0,0,0,100,NoArch
6be329fae9a57d23f64a74dde6e9f4ff99be8c9a,0,0,0,0,0,0,0,0,0,0,0,0,0,0,307,51,0,0,0,0,0,0,0,0,0,0,100,NoArch
a1ef3043709a8ab2d919de7656465fdcec1c84b3,0,0,0,0,0,0,0,0,0,0,0,0,0,0,308,52,0,0,0,0,0,0,0,0,0,0,100,NoArch
11082155ed7f2967e11c43b38369fdf698eeb9a8,0,0,0,0,0,0,0,0,0,0,0,0,0,0,309,53,0,0,0,0,0,0,0,0,0,1,100,NoArch
561d4e9470dab6b732f35c8063c7514328a7d490,0,0,0,0,0,0,0,0,0,0,0,0,0,0,310,54,0,0,0,0,0,0,0,0,0,0,100,NoArch
205296876dd21ef387d92843b3052c54bdeef972,0,0,0,0,0,0,0,0,0,0,0,0,0,0,312,55,0,0,0,0,0,0,0,0,0,0,100,NoArch
7a786023136ab3c6443f6aca4556a71e093b5ff2,0,0,0,0,0,0,0,0,0,0,0,0,0,0,0,0,0,0,0,0,0,0,0,0,0,0,100,NoArch
bee952edafdfb517191d3013d8d29a7d574c6a51,730,18725,49522,30797,97,300,397,0,23,2,4,139,8.934434455,80564,0,0,5288,8745,3457,242157,409780,167623,2633,4256,1623,0,64.33368682,Arch
e24c20fca7a7e1683c384c52d6d1e4bae21e0266,0,0,0,0,0,0,0,0,0,0,0,0,0,0,305,14,0,0,0,0,0,0,0,0,0,0,100,NoArch
7d5c17f7e91b2df7112369d69827ae1327ea7278,28,132,63,69,1,0,1,1,28,229,2,12,4.266557893,4183,306,10,524,521,3,21340,21264,76,239,235,4,0,99.88095238,NoArch
b119249f379db1045cfaf738ac920d319851e4bc,5,150,9,141,1,0,1,4,19,209,1,2,2.199228309,1689,312,51,296,281,15,10002,9315,687,113,105,8,1,99.85105749,NoArch
e4cbc9ad12450f293d9fc48d587b5f90baff49a3,1,117,0,117,1,0,1,1,1,0,1,1,0,0,307,9,10,0,10,515,0,515,9,0,9,0,99.9405116,NoArch
5a2b3aef94fac986134da5bb01fa7a30e8ec2341,26,51,76,25,0,0,0,2,25,78,2,17,3.787866479,5576,308,10,656,656,0,29048,29128,80,332,332,0,0,99.28550164,NoArch
4ce88a0181451d3c6ed5558032edf124e66f38e7,1,16,1,15,0,0,0,1,2,2,1,1,0,117,309,9,11,10,1,537,515,22,9,9,0,0,100,NoArch
7550a10b3725cf97dcfb9206499e854473520510,266,78807,0,78807,266,0,266,1,1,0,1,19,7.357542888,0,313,49,8871,0,8871,288059,0,288059,3200,0,3200,1,78.72016252,Arch
bd5593f8d027fff0c8d0e4d879d35c9876dd649f,37,0,0,0,0,0,0,1,1,0,1,2,0,7724,314,50,1235,1235,0,41099,41099,0,576,576,0,1,95.70338059,Arch
f49424ede69e469aed8f9822e76c22142ef73852,225,1360,1292,68,0,0,0,1,2,0,1,20,6.909960084,71628,315,50,8196,8189,7,257773,257499,274,3072,3064,8,2,97.89055973,Arch
a857ed5cba52fc4430271297de41cf321966e2ea,11,33,22,11,0,0,0,4,21,76,2,6,3.459431619,1507,310,8,69,69,0,10369,10314,55,35,35,0,0,100,NoArch
05078f9c7ccb401c7c265bce51c881584d95f379,1,10,2,8,0,0,0,1,3,4,1,1,0,132,311,9,12,11,1,613,537,76,9,9,0,0,100,NoArch
7a9ecf45a7ea742cab56c2bd87f29e096fb8bb9f,63,8303,8391,88,0,0,0,2,3,0,1,6,5.230212434,16671,312,10,1901,1901,0,68533,68533,0,711,711,0,1,100,NoArch
fcbc54a719bdc7446d0150bbc69383e7aca25d52,77,10515,10581,66,0,0,0,2,3,0,1,7,5.303141667,27130,313,11,3344,3344,0,92029,92029,0,1208,1208,0,1,100,NoArch
eb2e0a8d196e9cb40719b32d8c0cfb1fa607c935,83,14500,14526,26,0,0,0,2,3,0,1,6,5.672254153,33701,314,12,3619,3619,0,126159,126159,0,1274,1274,0,1,100,NoArch
a597bcae1aeee70090f7b163e4f926f19342e17b,0,0,0,0,0,0,0,0,0,0,0,0,0,0,315,13,0,0,0,0,0,0,0,0,0,0,100,NoArch
7926fcb8893243e21c4e5add781d953a18454e23,280,72711,67569,5142,0,0,0,2,4,0,1,20,7.248055504,83682,316,14,9640,9647,7,318036,314032,4004,3565,3564,1,0,99.87827145,NoArch
e50fbd587f11650518aa304f595b20e410e8cb5a,47,129,1894,1765,0,5,5,2,5,0,1,6,3.682816246,14786,317,14,1502,1623,121,49951,56067,6116,554,617,63,1,99.24443537,NoArch
a90e57e6faa40a74edacf8ab078174e8641c06b9,28,133,476,343,0,2,2,2,5,0,1,5,3.4813983,13593,318,15,1725,1754,29,47730,49601,1871,541,549,8,1,99.44455873,NoArch
eba097da79dfc33502becdbd84a8070666ae0bd4,52,148,4046,3898,0,5,5,2,5,0,1,5,2.839223981,22639,319,16,1834,2057,223,59318,78027,18709,757,845,88,1,97.99239222,Arch
496ccd066f5e8fe5e41acc0a658ece18d0089bd9,1,1,1,0,0,0,0,2,5,3,1,1,0,1155,320,17,105,105,0,6577,6577,0,34,34,0,1,100,NoArch
2f0cdab7cedc393342998f67d02ba20be33e43a4,19,65,67,2,0,0,0,2,20,120,1,14,3.806738693,2479,321,18,329,327,2,10378,10385,7,158,156,2,0,100,NoArch
7627de6a15c3e7bd9b674dca521e6d99ac6392ed,172,1364,3610,2246,0,4,4,2,6,0,1,18,5.81581859,70091,322,19,7592,7789,197,230493,240044,9551,2856,2936,80,1,99.33533448,NoArch
86b25164d41a708e6bd852172e19f46ef762861b,2,1,13,12,0,0,0,2,7,2,1,2,0.591672779,914,323,19,82,83,1,3300,3390,90,18,19,1,1,100,NoArch
a28cf138b3c6ff0f4ad5bd4d2f363f3b67241d8b,8,149,105,44,0,0,0,1,15,193,1,1,2.904161491,738,324,19,36,36,0,4570,4183,387,15,15,0,1,100,NoArch
638c387fad9091c5f754a207eeda937326a3586c,7,49,70,21,0,1,1,3,16,57,1,1,2.395489255,830,325,19,60,59,1,4580,4600,20,30,30,0,0,99.95762712,NoArch
0b59227b2034892e65e208ae223feef365cf27d3,5,345,16,329,1,0,1,1,48,29,1,4,0.738754545,894,326,20,182,133,49,6172,4354,1818,65,53,12,0,99.76694915,NoArch
bccccbcbee9a924187b8305270257bac4a1e04e9,17,487,308,179,5,0,5,2,15,0,2,6,3.164458913,1560,327,21,170,161,9,8998,8987,11,73,71,2,0,97.39168877,Arch
db6d401455f769fccc6d83b188206151ffa0f465,5,218,249,31,1,0,1,2,6,29,1,5,1.820609605,545,328,22,21,23,2,2297,3011,714,16,16,0,0,99.83833718,NoArch
c9fe2f958a8d905fc39931944d80b3b48bcff6b7,3,63,5,58,0,0,0,1,3,0,1,3,0.370479202,497,329,23,58,58,0,3182,2833,349,16,16,0,0,99.83844911,NoArch
56c4f4cde61be04df5e4b978e3b4ff3d2391fed1,1,58,0,58,1,0,1,1,1,0,1,1,0,0,330,24,7,0,7,297,0,297,3,0,3,0,99.67838272,NoArch
f80b6ccfe48b6b25122cb42637adf48e987acbd0,1,10,0,10,0,0,0,1,21,37,1,1,0,636,331,25,129,126,3,2780,2696,84,70,70,0,0,100,NoArch
c076e7bf93da590a04be560f4af4293cb4522a21,5,22,16,6,0,0,0,1,4,0,1,3,1.929092965,534,332,26,24,24,0,2629,2576,53,10,10,0,0,100,NoArch
757f2a75886aadfa351fb5b0981752c0c40f9ebd,10,211,39,172,2,0,2,1,5,0,1,4,3.052581719,723,333,26,43,31,12,4561,3613,948,20,14,6,0,99.8857926,NoArch
0302c0602914b4c10232d7d9c4b0e782b0a0f330,19,80,90,10,0,0,0,4,26,70,2,14,3.715461756,3084,334,25,171,171,0,20246,20424,178,73,73,0,0,100,NoArch
29d428a442ed968320f6fb4bac85e7ec7eb85778,8,40,44,4,0,0,0,1,6,0,1,4,2.479685872,792,335,26,36,37,1,4104,4103,1,17,17,0,0,99.86310746,NoArch
b80c48bf44f08e3cb2b841c930a29cd9fa46e4e2,3,44,34,10,0,0,0,1,7,0,1,2,1.543022494,390,336,27,17,15,2,1983,1917,66,7,7,0,0,100,NoArch
4a888f0ffca6e97571f36ab423099f074a3bd86f,1,3,3,0,0,0,0,4,7,106,1,1,0,354,0,0,34,34,0,2426,2417,9,7,7,0,1,100,NoArch
cb030aa49c7bd866727ff471615f7a697fa1065f,3,17,4,13,0,0,0,2,6,193,1,2,1.409975019,280,337,28,32,29,3,1066,1027,39,19,18,1,1,100,NoArch
0f07461185a608a9121a385346c46f0133d1f96a,8,139,49,90,1,0,1,1,8,3,1,3,2.494429521,737,338,28,63,53,10,4316,3825,491,23,20,3,0,99.86320109,NoArch
c054f041527a82d35958c118fc8487fc40a78032,3,9,0,9,0,0,0,1,8,2,1,3,1.584962501,347,339,29,6,6,0,1600,1477,123,6,6,0,0,100,NoArch
a240c224a1f54f8319bd1449d2b257929930fed4,4,34,8,26,0,0,0,1,4,318,1,2,1.941835529,265,340,30,16,16,0,855,864,9,10,10,0,1,100,NoArch
26bca69231fa8be2b3e4dc4d1bd1e085196ad7a3,2,1,7,6,0,0,0,2,6,163,1,2,0.543564443,167,341,24,11,12,1,787,806,19,8,9,1,1,100,NoArch
a73bdd42ab31a989e041f0ffe057b8bd3cfacacf,34,550,903,353,0,0,0,4,36,184,2,10,4.096351243,6529,19,0,628,676,48,36198,37223,1025,238,263,25,1,99.68160109,NoArch
d1801d2a4585ed7e8c4a41d172b3543d5bf081a8,9,762,0,762,9,0,9,1,1,0,1,5,2.596209161,0,20,1,89,0,89,3541,0,3541,37,0,37,1,98.84641484,NoArch
5a58194a49120e6c39bd7a8a762102eeeda68a86,20,463,72,391,5,0,5,1,14,8,1,3,3.253734101,1328,342,22,207,150,57,6641,4536,2105,120,81,39,1,98.69779973,NoArch
3db2d4cda8c6047539fa1aceea145b15d69d6446,2,6,0,6,0,0,0,2,7,33,1,1,1,715,343,22,131,131,0,3017,2975,42,78,78,0,1,100,NoArch
c1887540c284479da56777c5e5449f533306aa71,9,215,115,100,1,0,1,1,9,48,1,2,2.348474008,698,344,23,62,56,6,3840,3482,358,30,27,3,0,99.91061453,NoArch
d224470bba06177cc4839cab1fc7a7ccabdea7f2,0,0,0,0,0,0,0,0,0,0,0,0,0,0,345,24,0,0,0,0,0,0,0,0,0,1,100,NoArch
9167d2dd14f694e8bec6c2a11f774a4d74517d4c,1,2,12,10,0,0,0,2,2,161,1,1,0,94,346,25,2,3,1,552,604,52,2,3,1,0,100,NoArch
5ce2e7d052931ef99affd50af7bd2bd6108f92e7,1,97,0,97,1,0,1,1,1,0,1,1,0,0,347,26,13,0,13,460,0,460,8,0,8,1,99.25060613,NoArch
2ea6173a34ed75afddb655cfc04fa97ec4a52cdb,1,1,1,0,0,0,0,1,2,0,1,1,0,97,348,27,13,13,0,475,460,15,8,8,0,0,100,NoArch
9a7e7927fda2bcf0a9176a2a9333e5baa4c93d40,1,1,1,0,0,0,0,1,3,0,1,1,0,97,349,28,13,13,0,495,475,20,8,8,0,0,100,NoArch
baa0d69142727c3d778f4f800901b17095ab9b5d,1,2,2,0,0,0,0,2,2,56,1,1,0,212,350,28,44,44,0,1189,1189,0,18,18,0,1,100,NoArch
a502b40a1d1fcdf0a702439bc16079891fa73568,1,5,2,3,0,0,0,2,8,4,1,1,0,386,351,29,67,66,1,1662,1649,13,40,40,0,0,100,NoArch
b349fe9539e99038fad395c282b60b9d6af86e35,3,60,10,50,0,0,0,1,8,8,1,1,0.694805364,269,352,30,30,21,9,1867,1541,326,8,6,2,0,99.89123341,NoArch
885812f604ea95399efe5f595b6958c116f2455f,1,1,5,4,0,0,0,2,4,53,1,1,0,470,353,30,111,113,2,3450,3486,36,47,47,0,0,100,NoArch
7b04b10076761beceb95dd7e51e2a73079fe5aa0,5,82,33,49,0,0,0,1,10,9,1,4,2.060773259,677,354,31,39,30,9,4025,3777,248,19,16,3,0,100,NoArch
c40fd0785ee56f231436610eed56c9913738b4e5,43,151,108,43,0,0,0,2,37,60,1,28,4.50193945,7722,355,32,910,914,4,37439,37801,362,383,383,0,0,99.76066144,NoArch
5a0ee2da1b697bcdf69d8df7782b846cceba947a,3,29,3,26,0,0,0,1,11,0,1,2,1.321884787,396,356,33,19,15,4,2050,1864,186,6,6,0,0,99.8910438,NoArch
13f56eacac037a5ec679211d9715ad4d51532b0a,2,7,3,4,0,0,0,1,12,8,1,1,1,185,357,34,5,3,2,693,665,28,3,3,0,0,100,NoArch
fad1e48c8bffa45f2877aa4727b461c546c95991,1,1,1,0,0,0,0,1,4,15,1,1,0,69,358,35,7,7,0,261,263,2,4,4,0,0,100,NoArch
2563b6ee1742674a54344f6a9610e88be15121c9,6,648,7,641,3,0,3,1,5,72,1,3,1.761965689,632,10,0,142,83,59,6297,2725,3572,61,33,28,1,99.60818459,NoArch
7404f7085219149fa84ece099764b73680a8d97d,1,5,0,5,0,0,0,2,5,0,1,1,0,84,11,1,10,9,1,410,396,14,2,2,0,0,100,NoArch
7369cd51b31a9601c434af773ebab458e0b3463d,5,51,27,24,1,0,1,1,7,38,1,4,1.744615683,446,359,35,28,30,2,1438,1458,20,17,19,2,1,99.95657838,NoArch
aecf48587ee77971a9651220a665f9e8a81f8eb0,1,1,1,0,0,0,0,1,13,6,1,1,0,141,360,36,3,3,0,486,484,2,2,2,0,0,100,NoArch
2bc819ef3974ed538774b506ad974ab869a36d22,44,349,277,72,0,0,0,2,33,76,1,20,3.53221716,7129,361,36,704,702,2,35963,35688,275,348,342,6,0,99.97829861,NoArch
97033e3b1964ad1da319f72fe8874333dc487245,0,0,0,0,0,0,0,0,0,0,0,0,0,0,21,2,0,0,0,0,0,0,0,0,0,1,100,NoArch
3955f7b2c44b15b335ca41ad57045e4457ae641c,0,0,0,0,0,0,0,0,0,0,0,0,0,0,22,3,0,0,0,0,0,0,0,0,0,1,100,NoArch
3957076bec1e80b22750a79c3de15012bea69bc9,0,0,0,0,0,0,0,0,0,0,0,0,0,0,23,4,0,0,0,0,0,0,0,0,0,1,100,NoArch
8ea0c13a5cc6aae0465606db7308d6620a30249c,0,0,0,0,0,0,0,0,0,0,0,0,0,0,24,5,0,0,0,0,0,0,0,0,0,1,100,NoArch
89653f9f373aae95cf04c32b4ba343bfacce5c2c,0,0,0,0,0,0,0,0,0,0,0,0,0,0,25,6,0,0,0,0,0,0,0,0,0,1,100,NoArch
a435efb1a63b8530bdf120ba9965f33fda9db92f,692,81487,83647,2160,290,288,578,2,37,0,5,72,8.494343908,99525,316,0,11094,20630,9536,390479,686509,296030,4215,7758,3543,1,75.21035599,Arch
7360fad39479220dcb1618321fa6aac34885740b,0,0,0,0,0,0,0,0,0,0,0,0,0,0,0,0,0,0,0,0,0,0,0,0,0,0,100,NoArch
8f767d8514a57b50eee8966b4c610ca8afdea711,1,6,7,1,0,0,0,2,6,128,1,1,0,228,12,2,7,7,0,1492,1485,7,3,3,0,0,100,NoArch
07515446dd3ef8fe5f98e4fe3e5a430c4c5bfb23,15,0,147,147,0,0,0,2,2,0,1,2,3.80609523,5425,362,21,889,918,29,28750,29491,741,435,454,19,1,100,NoArch
fdd8ca2a2afc84395abaaaeeea16515b58e52f5c,6,244,140,104,2,4,6,2,2,8,2,3,2.135353605,140,363,22,23,0,23,930,140,790,3,0,3,1,97.70672547,Arch
e73641946409e00a6680fb079b3a70904647e0e1,0,0,0,0,0,0,0,0,0,0,0,0,0,0,364,23,0,0,0,0,0,0,0,0,0,1,100,NoArch
10c79a3d1ba65f6b99a330e36c110bbf2f2f1b98,0,0,0,0,0,0,0,0,0,0,0,0,0,0,365,24,0,0,0,0,0,0,0,0,0,1,100,NoArch
c86ef1458a615f5598ee6807f545fca92f9c1deb,1,4,5,1,0,0,0,3,49,59,1,1,0,458,366,25,70,70,0,2232,2232,0,27,27,0,0,100,NoArch
49bb59b3654d4e4803f966bd162d20f0f5d720ff,0,0,0,0,0,0,0,0,0,0,0,0,0,0,367,26,0,0,0,0,0,0,0,0,0,1,100,NoArch
c00a70c1f63ee46c9680bd9253096f241dc2a6f5,6,1133,0,1133,6,0,6,1,1,0,1,1,2.564891799,0,368,26,129,0,129,6672,0,6672,66,0,66,1,99.68340118,NoArch
c2976b2b77cc7aaa7a32ecd182598bbdb1ee231c,0,0,0,0,0,0,0,0,0,0,0,0,0,0,369,27,0,0,0,0,0,0,0,0,0,1,100,NoArch
f3c16c2dca2431ec1ef5fc99808241501f11c801,1,1,1,0,0,0,0,3,5,26,1,1,0,96,9,0,11,11,0,483,483,0,5,5,0,0,100,NoArch
a51dd9e2e16a6286aa894a9f5be23f5c046b60e3,60,1843,12384,10541,4,30,34,1,2,0,2,16,4.771820873,20396,10,1,1258,2365,1107,39381,66114,26733,419,874,455,1,95.45869466,Arch
b5b5d40367d6236e415058bcc6f4dc53003541b0,1,2231,2264,33,0,0,0,2,3,2,1,1,0,2402,317,1,462,468,6,14152,12830,1322,78,88,10,1,100,NoArch
73e17cfc4e178c81e47b689426aaa87aebac2985,2,579,78,501,1,0,1,1,11,19,1,2,0.936823869,296,318,2,96,37,59,5222,2248,2974,31,6,25,1,98.55603942,NoArch
2d857d59170a947427e7c353c8e57dff5492b927,1,6,3,3,0,0,0,1,2,2,1,1,0,425,319,3,44,44,0,2651,2600,51,16,16,0,1,100,NoArch
f4596a6a9a6ec9839b99c747d00e16c26ef814bd,1,3,1,2,0,0,0,2,12,2,1,1,0,372,320,4,52,52,0,2636,2622,14,15,15,0,1,100,NoArch
ae92fd670708da5dfab8068e4c766c4dba668cf3,1,3,2,1,0,0,0,1,3,0,1,1,0,428,321,5,44,44,0,2669,2651,18,16,16,0,1,100,NoArch
f9d039d562a49d766b899fa989ffa27ec4057691,0,0,0,0,0,0,0,0,0,0,0,0,0,0,370,8,0,0,0,0,0,0,0,0,0,0,100,NoArch
85d756f00159d92e570a3412fc0e195377998683,1,3,1,2,0,0,0,3,4,47,1,1,0,98,322,5,12,11,1,418,408,10,3,3,0,0,100,NoArch
d106e8479867fef1d315e66c7e63fdc1ecbc2be0,2,124,37,87,1,0,1,1,13,3,1,2,0.937622086,374,323,6,60,52,8,2950,2636,314,18,15,3,0,98.55769231,NoArch
4931ade7dc8ce32f02d33a876a8737175dcd1b92,1,18,4,14,0,0,0,2,8,47,1,1,0,137,324,7,13,10,3,1112,927,185,3,3,0,0,98.5812357,NoArch
bc440feeeef9ffe7e85ef432981db1f2e8e1fedf,1,3,2,1,0,0,0,2,6,50,1,1,0,57,371,9,6,6,0,180,168,12,4,4,0,1,100,NoArch
f17cc37c0a07a873811424a47f84c95e2555a5ed,1,3,2,1,0,0,0,2,4,50,1,1,0,55,325,8,5,5,0,225,222,3,2,2,0,0,100,NoArch
c21e773c0c8c3b6aa46415fb8a7bcbef6c4885f3,3,139,25,114,2,0,2,1,4,4,2,3,1.480615277,429,326,9,47,44,3,2946,2669,277,18,16,2,1,98.51394604,NoArch
cebf8bfe53fddd78e80ae24b38e468a16f576c2a,15,477,1171,694,1,2,3,2,4,35,1,8,2.729000166,8723,372,6,1127,1199,72,37474,39496,2022,282,318,36,1,99.51812758,NoArch
2f85f29f82b9b44509ff76de96321ace572dbb7c,55,2249,1895,354,0,0,0,3,27,224,2,14,5.395156376,6474,11,2,532,532,0,35299,35393,94,207,207,0,1,100,NoArch
b35b030a3d817675e6c5d0d445608b51ec8072c2,34,2066,729,1337,12,0,12,1,8,93,2,9,4.259096737,3202,12,3,484,342,142,25351,16951,8400,185,135,50,1,99.1810737,NoArch
b597523c39fdc4844f7623c1b2a7ea086179e7e2,0,0,0,0,0,0,0,0,0,0,0,0,0,0,373,3,0,0,0,0,0,0,0,0,0,1,100,NoArch
65ea79f03dc80e2c55906e1544118b4ec1c3d1a5,2,133,0,133,2,0,2,1,1,0,2,2,0.995060047,0,13,4,16,0,16,676,0,676,4,0,4,1,99.90962494,NoArch
d63012f869c355b014b4fd9bb0866621e89b3baf,4,61,12,49,0,0,0,2,6,126,1,3,1.277504914,799,13,0,54,51,3,4748,4640,108,24,22,2,1,100,NoArch
2308cccf783b15fe2a0f9eca94f43e3cb0e271ea,27,95,101,6,0,0,0,2,22,32,1,16,4.382213946,5516,374,4,677,678,1,29999,30024,25,295,297,2,0,100,NoArch
cfe7f01fbccc1e6aee4ccdc5ae2b435f1a6efff9,5,22,13,9,0,0,0,2,2,51,1,3,2.001175063,1837,375,5,165,162,3,6010,5958,52,83,82,1,1,100,NoArch
2b19ed54115a1d6184eab860e5af24712fd14a0d,9,575,0,575,9,0,9,1,1,0,1,2,2.941528113,0,26,0,43,0,43,2698,0,2698,26,0,26,1,98.90722569,NoArch
0a06799a12b30425e7c4df86cd0030785d78988c,1,25,25,0,0,0,0,2,8,209,1,1,0,235,327,10,31,31,0,1620,1620,0,10,10,0,0,100,NoArch
fb1f1c257f924be1fb4a444dc42b5c94c8f1ab9d,1,2,1,1,0,0,0,2,9,0,1,1,0,235,328,11,31,31,0,1626,1620,6,10,10,0,0,100,NoArch
250ed3d84da6edebf2257d8020f1230a416ab66e,1,50,50,0,0,0,0,4,9,71,1,1,0,354,329,12,34,34,0,2426,2426,0,7,7,0,0,100,NoArch
41f1c0445cdee15b437b94742c8dbdaa7b5ecdea,1,0,23,23,0,1,1,1,2,0,1,1,0,23,27,1,0,1,1,0,90,90,0,1,1,2,99.95590829,NoArch
166b331defd0203bbf63569918dc1b777dac6ac5,2,990,0,990,2,0,2,1,1,0,1,2,0.962749043,0,376,6,94,0,94,5785,0,5785,43,0,43,1,100,NoArch
0ac661821f43a4a08a684d8b4af773c2da0ee6d7,3,0,1763,1763,0,3,3,2,2,72,1,1,1.581811679,1763,14,4,0,221,221,0,5919,5919,0,71,71,0,99.73498233,NoArch
48989a4e0740ef1a25c40e37b7716e0b505a9aea,10,1586,0,1586,10,0,10,1,1,0,2,3,3.0480972,0,377,7,111,0,111,8089,0,8089,39,0,39,1,99.27424676,NoArch
67fbb78b3ea4845b54050d9c5eac487b6df0bb8b,1,0,1,1,0,0,0,2,2,0,1,1,0,135,15,4,14,14,0,847,862,15,2,2,0,1,100,NoArch
135a84023a208a1c9de9bcb79da6b5ae8c3381e8,77,707,907,200,0,0,0,2,38,60,4,24,5.541093669,15429,1,0,1779,1815,36,86009,86888,879,780,802,22,1,99.73804846,NoArch
251a4768a8f7b4480ece8f477ec4c0b8bfe4fcbe,1,0,68,68,0,1,1,2,2,79,1,1,0,68,2,1,0,5,5,0,366,366,0,2,2,0,99.91279704,NoArch
eeaafa6217c9d763b7cc2bbd578aa040f7ed432a,7,477,0,477,7,0,7,1,1,0,2,2,2.732655664,0,3,2,67,0,67,2766,0,2766,32,0,32,0,99.41214892,NoArch
a9cf7d817aa327399ecd3f08d6174248c3807bf5,12,659,1337,678,2,5,7,2,3,24,1,6,2.671332273,3581,0,0,257,340,83,14547,14224,323,121,141,20,1,99.39037666,NoArch
66f844a404bea947abf27fbabe28643253fe8aad,3,137,37,100,0,0,0,2,7,197,2,3,1.327029984,422,14,1,44,27,17,2875,2427,448,11,9,2,1,99.912759,NoArch
6214879061a9dd71cf9ff6027c712edcb4c45874,2,30,2,28,0,0,0,2,2,26,1,2,0.811278124,137,28,2,11,9,2,559,436,123,6,4,2,1,100,NoArch
b3f68574c107dffea09362cabc84e4432778f60d,60,997,686,311,3,3,6,2,39,18,4,26,4.392868338,11926,378,8,1361,1295,66,71737,70779,958,579,540,39,1,98.12236287,NoArch
7fd0c4110ee2f415041367bfde1bcf0fb5388412,1,13,2,11,0,0,0,1,38,96,1,1,0,743,379,9,84,82,2,3678,3644,34,37,36,1,1,100,NoArch
b19e36aaac7648c3e1a932f4ad7330317301e5ae,1,14,2,12,0,0,0,1,16,161,1,1,0,176,380,10,41,39,2,1201,1143,58,5,5,0,1,100,NoArch
c3b4adadcd40e11b037bf8670411147d1b9edbc1,5,1535,2,1533,4,0,4,1,2,0,1,3,1.748511282,565,1,1,201,69,132,9395,2043,7352,89,23,66,1,100,NoArch
6adea873190067b9c3fae521fc2b68a2316ced97,1,49,0,49,1,0,1,1,1,0,1,1,0,0,2,2,0,0,0,37,0,37,0,0,0,1,100,NoArch
824dc51f90da44ce6d71cab7e4012d351bbf562a,1,0,49,49,0,1,1,1,2,3,1,1,0,49,3,3,0,0,0,0,37,37,0,0,0,0,100,NoArch
7ea6efce2294c55869d4b0441158cb5c35a855c1,10,658,35,623,2,0,2,1,4,8,1,5,1.621569831,2999,4,4,275,213,62,18678,16553,2125,163,140,23,1,99.91826727,NoArch
44127950c4c50cd2e73050856373bb33f66b4b17,8,202,128,74,1,0,1,3,5,4,2,3,2.701608532,1263,16,5,93,90,3,6829,6486,343,30,28,2,1,99.85705534,NoArch
0935b073a7d2d2c02dccbd621369ac2960f9c091,1,177,0,177,1,0,1,1,1,0,1,1,0,0,5,5,9,0,9,1264,0,1264,9,0,9,1,100,NoArch
434cdff2176906edf5d6bfd8c66980b423fa0c47,95,343,542,199,1,0,1,3,32,124,4,37,6.26437223,15132,381,9,1513,1541,28,88182,88771,589,647,675,28,0,96.83683684,Arch
d7351ccd19765f564a4155937024c83a99e3d23b,8,1836,148,1688,5,0,5,1,3,0,1,7,2.300303165,1185,6,6,289,116,173,13443,6145,7298,140,60,80,1,99.78431373,NoArch
7a61938f2c90c0876f6d0075adf316b246c76424,8,240,304,64,0,2,2,3,5,24,1,5,2.001317494,6550,7,7,1020,1021,1,32727,32835,108,229,230,1,1,99.90205681,NoArch
6a253e35677ae3872fbf2064db5367016025fd48,0,0,0,0,0,0,0,0,0,0,0,0,0,0,382,10,0,0,0,0,0,0,0,0,0,0,100,NoArch
d911fcefc434638513808e298fb7562705e21b2a,43,138,148,10,0,0,0,2,33,42,1,22,4.972566156,7473,383,11,678,679,1,42659,42703,44,277,278,1,0,100,NoArch
d673a78f9ac7423a5868f42f57bc827f6124737a,1,0,6,6,0,0,0,1,4,0,1,1,0,148,384,12,22,23,1,687,725,38,12,13,1,0,100,NoArch
20dd0a1bcc17d08089ef132114034345796b5925,19,479,1029,550,0,3,3,2,3,74,2,5,3.280585839,5473,8,8,422,531,109,12842,15302,2460,199,232,33,1,99.84310649,NoArch
0308bb821691c00d8cbbf4dce01e489745463a41,18,504,666,162,1,4,5,4,17,82,2,4,3.470052175,2226,48,0,185,182,3,13198,14502,1304,99,101,2,1,96.12891276,Arch
1d47c52246dce73f900bb91de3dacee23cb54712,2,0,104,104,0,2,2,2,8,0,1,1,0.961236605,104,49,1,0,7,7,0,461,461,0,7,7,1,99.91220369,NoArch
4233591fad46d89f01068fddf77a013d538792b9,1,1,1,0,0,0,0,1,3,0,1,1,0,59,385,13,5,5,0,257,258,1,4,4,0,0,100,NoArch
14a584464a1da38cb5e40e3be1106922b52e2052,4,9,6,3,0,0,0,4,18,6,2,1,1.96559623,812,386,14,67,67,0,5023,4998,25,34,34,0,0,100,NoArch
a7e552ae4a386dc6c6331a2b907ac6f1a1747e0a,1,9,4,5,0,0,0,4,10,15,1,1,0,116,387,15,14,14,0,729,708,21,7,7,0,0,100,NoArch
27632def50fc555e351c7c9d2efa3fcdf8c87337,23,0,7166,7166,0,23,23,3,4,40,1,3,4.15989297,7166,9,9,0,637,637,0,20669,20669,0,294,294,1,98.98702683,NoArch
a47e23ebbd96de785fd1397931ad231c291ae948,6,91,3,88,0,0,0,1,5,2,1,2,2.563683832,2891,10,10,262,252,10,15209,14508,701,128,122,6,1,100,NoArch
435c42923b389bb434484c6d68c7951c98c323a6,13,66,40,26,0,0,0,2,36,13,3,4,2.836768866,1784,50,2,169,169,0,10020,9626,394,101,101,0,1,100,NoArch
1b91a877acbd48141da6b1ec0f55039d0b9e7988,3,201,6,195,2,0,2,1,13,0,1,2,1.249427046,153,51,3,47,19,28,1917,725,1192,23,13,10,1,99.56981538,NoArch
66174ac4f0ca1882d1c6ba2538ea32de859c25e8,5,260,148,112,2,1,3,1,14,2,1,2,1.922107918,348,52,4,58,47,11,2537,1917,620,32,23,9,1,99.67834167,NoArch
93443ba1fb1718ddf5cd82751e14fd6732a3b896,1,16,2,14,0,0,0,1,2,0,1,1,0,89,53,5,14,14,0,443,463,20,10,10,0,1,100,NoArch
2badc2d4df05a8f4409a23ab3e48f770ccab6941,2,221,155,66,1,1,2,1,2,0,2,1,0.97765867,155,54,6,30,34,4,1639,2126,487,11,10,1,1,99.67828418,NoArch
ecb08e8dd4c79d51ea8a7fcf065ce2a5f978fd5a,17,1485,20,1465,12,0,12,1,5,5,1,6,3.445384536,1267,4,3,427,279,148,12599,6675,5924,196,115,81,2,98.52683269,NoArch
e98c2ec601e4ec241847c9ad6a7c73c648d53348,17,20,1485,1465,0,12,12,1,6,0,1,6,3.445384536,2732,5,4,279,427,148,6675,12599,5924,115,196,81,0,98.52683269,NoArch
504c1677cb19a97c6a9f15526cd509bb75ab7366,5,149,20,129,0,0,0,3,7,0,1,1,1.227753898,1267,6,5,297,279,18,7066,6675,391,129,115,14,1,98.80260609,NoArch
993e608eb65378b6536b9469f13996d6fbd0a492,1,1,1,0,0,0,0,3,4,8,1,1,0,600,7,6,71,71,0,2169,2177,8,24,24,0,0,100,NoArch
a258fa20ca77654baeb205864d697606cea2e267,1,1,1,0,0,0,0,2,2,10,1,1,0,668,8,7,78,78,0,2473,2481,8,31,31,0,0,100,NoArch
08f8923c1a4ebd9b13f93e34a22af6fd0ccc6363,1,5,2,3,0,0,0,2,6,0,1,1,0,585,9,8,130,129,1,3434,3422,12,46,46,0,0,100,NoArch
a01238bb99c948dcaeec536b546f7af4c6a37d0b,1,20,0,20,0,0,0,3,8,0,1,1,0,318,10,9,69,62,7,1411,1249,162,37,36,1,0,99.10147992,NoArch
0821d4271ff44e18ac504a9e8859b8fe9ecbd73b,1,14,0,14,0,0,0,2,2,20,1,1,0,297,11,10,56,52,4,1300,1204,96,35,34,1,0,100,NoArch
ab2d63e79fc379beb751bba13159842de6b771ad,1,1,1,0,0,0,0,2,7,0,1,1,0,588,12,11,130,130,0,3433,3434,1,46,46,0,0,100,NoArch
ba1198e91f793d7a527bc3520586cb7ffa7ff781,1,33,15,18,0,0,0,3,8,0,1,1,0,177,13,12,41,35,6,934,838,96,17,15,2,0,100,NoArch
506d84d80dbcd4eb703ec6fb0370fad06fc9d13f,12,1330,0,1330,12,0,12,1,3,0,1,5,3.143079585,0,14,13,130,0,130,5533,0,5533,67,0,67,1,99.03491841,NoArch
6e3509bb26e2bbc7a5b3b2a78cf4ba0dfe1e921b,3,24,31,7,0,0,0,2,18,34,3,3,1.445903376,596,29,3,48,48,0,2989,3044,55,14,14,0,1,99.98279422,NoArch
ea6519794d19f11cd2540b6e46f56f765cec74c8,158,647,1071,424,0,7,7,3,50,24,5,71,6.563677728,47875,388,14,5712,5717,5,223881,224611,730,1981,1981,0,1,95.50411326,Arch
885e4d7bbc76963566b6d9580e6864524f3822dc,2,25,15,10,0,0,0,1,4,517,1,1,1,239,389,15,25,25,0,1030,990,40,2,2,0,0,100,NoArch
089dbf2633a6427852354881f75acecd8aa7cb54,1,2,1,1,0,0,0,3,9,0,1,1,0,232,15,14,22,22,0,2044,2033,11,3,3,0,1,100,NoArch
b78c9af0fb7e57b05b7cd003a72e95a013f57b74,2,14,12,2,0,0,0,1,5,0,1,1,0.391243564,249,390,16,27,25,2,1064,1030,34,2,2,0,0,100,NoArch
e3fd6a4d1459d7a4893945d8cdf405d97d5a4663,1,14,2,12,0,0,0,3,15,48,1,1,0,176,391,17,11,10,1,994,915,79,2,2,0,1,100,NoArch
c184e663bfb63164ff8217f5fbdf2c0d220ab206,1,40,11,29,0,0,0,3,16,1,1,1,0,188,392,18,13,11,2,1252,994,258,2,2,0,1,100,NoArch
af5cf6c3ed0224ca611adbd9ab20485f8cf1633d,0,0,0,0,0,0,0,0,0,0,0,0,0,0,393,19,0,0,0,0,0,0,0,0,0,1,100,NoArch
f518dba33d7c6116a5e65be9160fc48f61b989a4,1,15,2,13,0,0,0,3,17,0,1,1,0,217,394,20,14,13,1,1305,1252,53,2,2,0,1,100,NoArch
96e6ed2248fdcdbfa263dfd55af7ee0785b2264e,2,87,9,78,1,0,1,1,2,11,1,1,0.625262405,76,395,21,19,8,11,665,341,324,12,4,8,1,99.9138859,NoArch
e244bcaa2ff6ddf4aced9f7645abaa88400a197a,2,74,14,60,0,0,0,4,7,38,1,1,0.860965256,3294,396,22,598,591,7,18150,17793,357,121,114,7,1,99.80699121,NoArch
39945ad3a0c48c20b1c8d01235178329bdc04488,0,0,0,0,0,0,0,0,0,0,0,0,0,0,397,20,0,0,0,0,0,0,0,0,0,1,100,NoArch
18bf66395622980fc4796a0506aa12af484ed7f4,26,34,48,14,0,0,0,2,17,26,1,15,4.492764085,3459,398,21,333,334,1,16830,16887,57,136,136,0,0,100,NoArch
a576dc786efa69f44e396bd61b59fd412e5806d3,2,341,6,335,1,0,1,1,8,4,1,2,0.173585586,2692,399,22,523,518,5,18007,15530,2477,88,86,2,1,99.95726496,NoArch
5a677d48c6ae50254ef8d72e4b9900f84e84efbe,47,179,214,35,0,0,0,2,14,18,5,31,4.699672435,16473,400,23,1960,1960,0,87466,87629,163,617,616,1,0,100,NoArch
81702b74f959aa0699f55c2745e52ed53bf354db,1,2,2,0,0,0,0,1,4,133,1,1,0,76,401,24,0,0,0,73,73,0,0,0,0,0,100,NoArch
e4e6d107ae7bebc26f333ddafc11edcf20cb39f2,2,66,12,54,0,0,0,1,6,189,1,1,0.9923985,809,402,24,193,183,10,3850,3616,234,76,74,2,0,100,NoArch
4f91f4458bef5854c6af5a051c0ef788c0e0f774,71,801,682,119,2,4,6,3,37,21,4,21,5.090078189,24013,16,12,3210,3199,11,104352,103343,1009,1295,1287,8,8,95.75205895,Arch
fdc5ca5a41df2b95e71c2575decd84be2bcc1c77,2,5,9,4,0,0,0,3,6,0,2,2,0.749595257,668,17,13,133,134,1,3392,3426,34,50,50,0,0,100,NoArch
ed761b730105d83a0393265dabaf46dd7dafe9c3,1,2,1,1,0,0,0,3,7,0,1,1,0,605,18,14,128,128,0,3227,3212,15,45,45,0,0,100,NoArch
b162d9e28f2afab911cdac589b36b4931c1cca04,0,0,0,0,0,0,0,0,0,0,0,0,0,0,19,15,0,0,0,0,0,0,0,0,0,1,100,NoArch
7f224686b57e45c5d0bb5aa63166513ef7d61c76,3,10,1,9,0,0,0,1,15,109,1,3,1.539484757,370,403,22,10,7,3,1677,1641,36,6,6,0,0,100,NoArch
c1ee809929102246c80d39ee1fcb886c475afc89,1,1,1,0,0,0,0,7,34,41,1,1,0,492,17,0,60,60,0,3462,3462,0,12,12,0,0,100,NoArch
bba929eb403b1de6edb2e6c45bb053bb31069e38,1,15,9,6,0,0,0,7,35,1,1,1,0,492,18,1,60,60,0,3464,3462,2,12,12,0,0,100,NoArch
9c457637ab87bdcd31441d8c7618a0862a820f9d,0,0,0,0,0,0,0,0,0,0,0,0,0,0,19,2,0,0,0,0,0,0,0,0,0,0,100,NoArch
bf717650b7d3abbbf65ce31423e8e019fa0ebc94,0,0,0,0,0,0,0,0,0,0,0,0,0,0,20,16,0,0,0,0,0,0,0,0,0,1,100,NoArch
31007bced7d8f424dd69e406938f1eea617cd9f0,3,14,0,14,0,0,0,2,11,18,1,1,1.577406283,930,21,17,186,181,5,4093,3986,107,106,103,3,0,100,NoArch
f89fd9a53ba114de0582c9a2e1b3667137273633,1,34,19,15,0,0,0,5,15,39,1,1,0,103,20,3,12,9,3,731,637,94,2,2,0,1,100,NoArch
9a8c2331b4056bf204ec6fd6787449c6df42c5c9,5,14,15,1,0,0,0,2,13,62,1,4,1.268067353,1238,404,16,150,150,0,7108,7109,1,42,42,0,0,100,NoArch
251f0e920403f47e83764e6d6cb7816f91985afb,18,1110,371,739,6,1,7,3,15,29,3,9,3.534807479,1662,21,4,205,157,48,12783,9027,3756,73,59,14,1,96.21527018,Arch
1be812e19977fe5410bd39ea2a1561006c4e260f,32,1237,953,284,0,0,0,2,14,66,2,7,3.998175111,4204,22,5,467,467,0,23067,23122,55,179,179,0,1,99.73890339,NoArch
2e38f55bff6e5b5080d57ab37ad79255cdb47346,0,0,0,0,0,0,0,0,0,0,0,0,0,0,405,9,0,0,0,0,0,0,0,0,0,1,100,NoArch
f401530f6f32160d1d5f46b9f6642777ccf63265,2,6,6,0,0,0,0,2,4,44,1,1,1,1556,23,6,173,173,0,5106,5106,0,69,69,0,0,100,NoArch
ecf6999d99cfd771105ee362700590fba6ab340c,4,218,54,164,0,0,0,1,51,234,2,3,0.514625027,1064,406,9,191,161,30,6288,5582,706,70,66,4,0,100,NoArch
753f43e4ccfa6b719edca9c52cfdd333087b2613,4,98,147,49,0,0,0,3,6,49,1,2,1.989868103,2171,24,7,262,262,0,7563,7849,286,88,88,0,0,100,NoArch
838ad263b117205bde49096cd376e6f323be89d6,2,8,2,6,0,0,0,6,16,38,1,2,1,194,25,8,23,21,2,1073,1033,40,8,8,0,0,100,NoArch
98aeb713ff6ecc06c4c1cfa50f5b387e03c675df,5,99,13,86,1,0,1,1,36,62,1,5,1.296530284,1527,26,9,199,188,11,10695,10263,432,45,38,7,0,99.91302457,NoArch
54aef6529b95851faa34e5bfb236a101a326ffab,1,1,1,0,0,0,0,3,6,13,1,1,0,338,27,10,63,63,0,1513,1512,1,36,36,0,0,100,NoArch
7eac96d5dd658a7168d0548747fbd205d3c918ca,2,24,24,0,0,0,0,1,8,6,1,2,0.979868757,422,28,11,25,25,0,2135,2151,16,8,8,0,1,100,NoArch
595157bc194375fbc2f72a4279bfb9bc3ea34ef5,3,356,202,154,0,0,0,3,16,30,1,2,1.414019018,607,29,12,84,74,10,4641,4048,593,23,22,1,1,99.93481095,NoArch
fa9b2b1b24568176255b9406ac17ef0708d9dd42,83,18796,14,18782,82,0,82,4,4,0,2,20,5.344588387,259,11,0,2090,22,2068,78799,429,78370,806,12,794,1,95.8289446,Arch
b879eb29ca15ef44c7be85685a5b399d113b5d32,0,0,0,0,0,0,0,0,0,0,0,0,0,0,12,1,0,0,0,0,0,0,0,0,0,1,100,NoArch
ebf9a4d9c26c182c26d5fdb3ea4b1f12ed19a7bb,61,0,11531,11531,0,61,61,1,9,45,2,11,4.624776457,11531,13,2,0,1415,1415,0,45625,45625,0,498,498,1,95.40059347,Arch
56079f0ddc932eb8f62839da7a5245d1f953af11,0,0,0,0,0,0,0,0,0,0,0,0,0,0,30,13,0,0,0,0,0,0,0,0,0,0,100,NoArch
1b028058317526221b1124612c7dd468b77030f7,0,0,0,0,0,0,0,0,0,0,0,0,0,0,31,14,0,0,0,0,0,0,0,0,0,0,100,NoArch
b38e82489b33d4999113a09ff1964581565fea2c,10,50,48,2,0,0,0,1,9,4,3,7,2.378906635,1660,32,15,134,134,0,8650,8667,17,41,41,0,0,100,NoArch
00777adafbab69e23488a867ecf61c65d1fadb34,1,2,2,0,0,0,0,1,2,9,1,1,0,113,33,16,11,11,0,737,739,2,2,2,0,0,100,NoArch
520918395bcc10bdcdbe05e25708b353ffe21716,3,24,30,6,0,0,0,3,20,115,1,1,1.330264331,541,55,0,63,65,2,2579,2577,2,30,32,2,1,100,NoArch
290e76ff0b67306dfa21062aad3a1c8b20e0b843,46,130,464,334,0,0,0,3,12,27,1,14,4.392602758,15559,407,6,2160,2160,0,62432,63411,979,856,856,0,0,100,NoArch
e4ad6b16f3fa2cebf7c2c0baf36c346fb7599f17,0,0,0,0,0,0,0,0,0,0,0,0,0,0,34,17,0,0,0,0,0,0,0,0,0,1,100,NoArch
a276c6ddc72ce12b8a78b9a50f80e36a4e1267fc,11,1473,0,1473,11,0,11,1,1,0,1,2,3.349609713,0,35,18,107,0,107,6840,0,6840,46,0,46,1,99.38744257,NoArch
1db8ad4c4f0426fbb7973384cff41df6844abd56,0,0,0,0,0,0,0,0,0,0,0,0,0,0,408,7,0,0,0,0,0,0,0,0,0,1,100,NoArch
8555d67ad27df9bf664eaaa87f6dd704d9fbaaff,3,0,1,1,0,0,0,2,5,4,2,2,0,677,36,19,47,47,0,4438,4453,15,10,10,0,0,99.82601131,NoArch
6980b95dce04af3545fb3b75c11836b0988bb98a,6,9,9,0,0,0,0,1,1,0,2,2,2.419381946,624,37,20,39,39,0,3752,3764,12,11,11,0,0,99.43441375,NoArch
382b4470c54285194dc9a722f88dcaf2cc2528a3,6,138,81,57,0,0,0,1,3,0,1,2,1.986887971,841,38,21,78,73,5,4059,3759,300,31,30,1,0,100,NoArch
611c3a7753cdacef3f168a8dddd4786226445bfa,13,704,67,637,4,0,4,1,38,76,1,5,2.899810888,1111,56,1,175,130,45,8819,4521,4298,137,93,44,1,99.71769815,NoArch
2c005ed09a80889b83bbcf09972804a6c4278302,2,2,2,0,0,0,0,1,10,0,1,2,1,353,57,2,30,30,0,2675,2675,0,29,29,0,1,100,NoArch
2e77bf8c7fcacf9ad7252b2b9e0d8a758fc60d32,50,151,166,15,0,0,0,2,41,38,3,30,5.106849015,10994,409,7,901,905,4,62139,62749,610,356,355,1,0,99.74014725,NoArch
ed6770439adef1c609f40907acc69081c9d658e8,1,3,1,2,0,0,0,6,17,0,1,1,0,251,39,22,21,21,0,1553,1531,22,14,14,0,0,100,NoArch
1769809395eb3383f97dd3f696290abfdbfd8208,3,5,601,596,0,2,2,4,8,21,1,1,1.021823245,1627,40,23,109,193,84,3557,6322,2765,42,76,34,0,99.60826986,NoArch
1c2d22d06acbd0a975311b36ceb8bd24bf28d952,16,703,507,196,1,2,3,3,10,2,1,5,3.407710855,2144,41,24,179,160,19,11779,10889,890,64,67,3,1,99.6933859,NoArch
1186b5a77f952c90e763b098a2704923d1df246b,1,1,1,0,0,0,0,3,14,81,1,1,0,182,410,7,19,19,0,1286,1286,0,5,5,0,0,100,NoArch
951224a86989e4c75b92d6ff21607a50caa8e433,1,76,3,73,0,0,0,2,7,3,1,1,0,187,42,25,19,13,6,1710,1219,491,2,2,0,1,99.89042297,NoArch
5e41ea67c5a2233a3f085ad2ee494c06d27236be,1,0,0,0,0,0,0,1,1,0,1,1,0,260,43,26,19,19,0,1710,1710,0,2,2,0,1,99.78074984,NoArch
a54904160693310346489178b15c8d4eacc2d9e7,9,369,57,312,2,0,2,1,11,1,1,5,2.2372028,1587,44,27,106,88,18,9457,8080,1377,30,23,7,0,99.89047097,NoArch
fd7975f809dd543c633db145e1fde3377f867f46,3,216,186,30,0,0,0,1,3,0,1,3,1.425255796,627,45,28,52,42,10,3849,3531,318,11,11,0,1,100,NoArch
87f1d33718c3fd0e75d46d6fa22999b711863be7,1,38,33,5,0,0,0,4,6,7,1,1,0,165,46,29,38,38,0,883,912,29,15,15,0,0,100,NoArch
4bd4d8d09b54981ef7b20d44d43f789e27f7ede8,9,349,288,61,0,0,0,3,13,99,1,6,2.614183344,1210,47,30,96,96,0,7099,6740,359,40,43,3,0,99.75935244,NoArch
da1b0acfa7ecf1027af50f622733607726bee0c0,0,0,0,0,0,0,0,0,0,0,0,0,0,0,330,0,0,0,0,0,0,0,0,0,0,1,100,NoArch
3a39b0bb82c65e74bec2b88dbbd5d3df9132d6d2,1,158,119,39,0,0,0,1,2,8,1,1,0,213,48,31,14,13,1,1648,1613,35,3,3,0,0,100,NoArch
49c9b9903a554830bbe8c2aacf9597d3248a37b0,32,127,133,6,0,0,0,2,42,30,1,15,4.137924286,5746,411,8,495,498,3,29783,29801,18,307,308,1,0,100,NoArch
ed8a04fb29dd9aeadc15a5e6d89a0ae505a7c6fd,0,0,0,0,0,0,0,0,0,0,0,0,0,0,412,9,0,0,0,0,0,0,0,0,0,1,100,NoArch
f41017d00d89068b960a1fac82eae7297c1fa6a9,1,5,4,1,0,0,0,2,16,7,1,1,0,736,49,32,90,90,0,3849,3859,10,13,13,0,0,100,NoArch
95cc48a65eac18a3c4a91d3be9461dbe55b3880d,1,9,7,2,0,0,0,1,3,102,1,1,0,191,413,10,19,19,0,1312,1292,20,7,7,0,0,99.97812773,NoArch
933e150126a6935bccb45da403e21c990fa0cd46,3,15,11,4,0,0,0,3,17,87,2,3,1.497863726,647,50,33,72,71,1,3924,3866,58,24,24,0,1,99.71484975,NoArch
bbbebdac003341dae4cb23c1443a2c70eb06359b,7,75,29,46,0,0,0,3,12,7,1,5,2.370022655,1255,22,2,92,90,2,6704,6431,273,28,28,0,0,100,NoArch
9d4b21512ae6213d1381d2686b5a69ae9a6c590d,1,12,2,10,0,0,0,1,4,4,1,1,0,268,51,34,21,20,1,1798,1740,58,2,2,0,0,100,NoArch
e26711c75d1c82d968686fa9eec84ca3822805d6,0,0,0,0,0,0,0,0,0,0,0,0,0,0,331,1,0,0,0,0,0,0,0,0,0,1,100,NoArch
a6d8cd609dd774c37a3637fb57a7bacca8ddb57c,1,94,79,15,0,0,0,1,1,0,1,1,0,236,52,35,31,31,0,1671,1623,48,9,10,1,0,99.86801584,NoArch
ab794986d5a4ad30b5a99c69b4c7bdc625b9d83e,1,2,1,1,0,0,0,3,7,67,1,1,0,143,53,36,13,13,0,1122,1117,5,3,3,0,0,100,NoArch
9ebf9127b3a16ce6c6e58b4e2b0e62e2a931f3f3,1,39,23,16,0,0,0,3,5,11,1,1,0,224,332,2,20,18,2,1370,1244,126,9,9,0,0,100,NoArch
905bee382ef7039f278df955fdb89db4af23f625,1,5,5,0,0,0,0,3,6,0,1,1,0,240,333,3,20,20,0,1370,1370,0,9,9,0,1,100,NoArch
2939520a476e10369e035f61f0bc251aefac18a1,1,2,2,0,0,0,0,2,5,2,1,1,0,278,334,4,21,21,0,1798,1798,0,2,2,0,1,100,NoArch
233d93d401d813ae7e5de852fe7a2b7cce14e305,58,1690,1855,165,0,0,0,3,18,95,1,21,5.174838542,8206,54,37,697,697,0,44396,43832,564,260,260,0,1,100,NoArch
833d96f4b96739118941c0a890d07c65807d35bc,1,1,1,0,0,0,0,3,7,0,1,1,0,240,335,5,20,20,0,1370,1370,0,9,9,0,1,100,NoArch
42ae840390ea2453e6ee53ff466cf631bbf2edb7,101,3537,3627,90,0,0,0,2,26,349,1,28,5.993753546,11563,55,38,947,945,2,59002,58189,813,459,459,0,1,100,NoArch
d581a9e5a482283a0019bb5667dec4594c124b3b,5,32,24,8,0,0,0,2,10,0,1,1,2.044293385,338,56,39,20,20,0,1058,1058,0,12,12,0,1,100,NoArch
b82d989933132c9807007147b1ef7239f00d6eb0,119,1935,2202,267,0,0,0,2,20,72,1,24,6.350045292,13358,57,40,1291,1287,4,63061,62364,697,599,599,0,1,100,NoArch
ad11134046ff704007aab4f3d0ebb912b833edd3,59,2285,2135,150,0,0,0,3,9,207,1,15,5.435205525,8801,58,41,924,924,0,36058,35452,606,442,442,0,1,100,NoArch
67b36047481fd9dcf85fbbd5ec15bc39c5f8c6b0,6,147,135,12,0,0,0,3,13,424,1,1,2.245553526,486,59,42,32,32,0,1906,1896,10,17,17,0,1,100,NoArch
1b4e01f075d3e7d7148898c0d4127b590bc0458c,155,5864,5079,785,0,0,0,2,52,284,1,29,6.74937024,20152,60,43,2379,2379,0,89575,88456,1119,1125,1125,0,1,100,NoArch
53de8dcfa25980a395af03309cfed029798efb99,69,2700,2403,297,0,0,0,7,43,72,1,9,5.485857086,9169,61,44,838,838,0,48681,48303,378,420,420,0,1,99.8901823,NoArch
f254e9c08c8b6ffe832a5da389243974fe62f452,1,6,6,0,0,0,0,7,29,0,1,1,0,723,62,45,78,78,0,5505,5487,18,27,27,0,1,100,NoArch
f64d9c4ec850d6f17c0165d0a8e81b39dfa5ec0b,1,1,1,0,0,0,0,7,30,0,1,1,0,723,63,46,78,78,0,5508,5505,3,27,27,0,0,100,NoArch
04f2a221f69bd4beeaadc3a4963ba2bf82ffaf19,1,5,1,4,0,0,0,2,2,174,1,1,0,23,23,3,2,0,2,44,16,28,2,0,2,0,100,NoArch
87e3a11f35eff0e0969c247345bb15b022425e0c,1,1,1,0,0,0,0,3,9,14,1,1,0,571,24,4,128,128,0,3168,3159,9,45,45,0,0,100,NoArch
119d7bdf856443b9afacfed076d16b429c7ab1ee,2,31,15,16,0,0,0,2,7,35,1,2,0.713146749,311,25,5,46,40,6,1979,1835,144,16,14,2,0,100,NoArch
35b33a489c92e291225f35a4f0505e1fc2946d01,4,13,8,5,0,0,0,7,31,0,1,2,1.684185737,1179,64,47,117,117,0,8006,7970,36,42,42,0,0,100,NoArch
380e609abdb94c83f81c5f12298d71b67cc196cd,1,74,52,22,0,0,0,3,19,3,1,1,0,385,65,47,56,54,2,2920,2721,199,17,15,2,0,100,NoArch
8aacfc32f6fdd74dae8011305a0e8d3f299f350f,0,0,0,0,0,0,0,0,0,0,0,0,0,0,336,6,0,0,0,0,0,0,0,0,0,0,100,NoArch
51c9f4c819a79fbf599e6bc10e418cdcac1b8936,0,0,0,0,0,0,0,0,0,0,0,0,0,0,337,7,0,0,0,0,0,0,0,0,0,0,100,NoArch
a29b210b067688a03fcbebd69c91342e59355f0f,1,21,1,20,0,0,0,2,6,17,1,1,0,256,26,6,56,56,0,1158,1158,0,33,33,0,0,100,NoArch
297bef58c48087d8ee321cf457f155cfd1b5a260,200,1227,1187,40,0,0,0,1,53,3,3,81,6.824032853,39118,66,46,3988,3987,1,211594,213232,1638,1581,1581,0,1,100,NoArch
e4d6877dd99b667c6fda57a6f5b914a3e03912cb,3,285,5,280,2,0,2,1,11,0,1,3,1.17835771,129,67,47,31,9,22,2587,865,1722,9,3,6,1,99.75898335,NoArch
d2ef57c1fe2213ada9433960dbc4e21bface75d8,15,166,74,92,0,0,0,2,54,0,2,7,3.625633761,3676,414,10,444,428,16,16019,15896,123,191,182,9,0,100,NoArch
210fac329f44feaf54944b97a0848a9b8827b45c,143,458,461,3,0,0,0,3,33,0,3,66,6.544216895,24933,415,11,2555,2556,1,127826,128741,915,1113,1114,1,0,100,NoArch
a0a39da35a85bbccd5764f99fd5a4944f3b5a974,1,3,3,0,0,0,0,2,9,2,1,1,0,509,416,12,104,104,0,2291,2285,6,46,46,0,0,100,NoArch
2dc63b9dc2eda7825b92653a6f3b0ef80075da65,6,13,12,1,0,0,0,3,10,1,1,5,2.519079571,893,417,13,65,64,1,4425,4412,13,28,28,0,0,100,NoArch
46e266a9bbe91e9003b1b67cef4f33d9b1411ba7,2,305,4,301,1,0,1,1,5,5,2,2,0.173341595,111,68,48,65,19,46,2792,425,2367,21,13,8,0,99.71665214,NoArch
8b39361586ee71eb53125ba38b0dd498e2b8a7e2,1,6,5,1,0,0,0,2,6,10,1,1,0,105,418,14,15,15,0,351,339,12,8,8,0,0,100,NoArch
1c3cf6d7eb6da71e35b5aa38970400479395fe03,1,104,23,81,0,0,0,1,2,0,1,1,0,301,69,49,62,46,16,3088,2367,721,10,8,2,0,100,NoArch
18736b68f4de63ebf6b5716d198c9600ccf76dbd,1,1,1,0,0,0,0,1,3,0,1,1,0,382,70,50,62,62,0,3088,3088,0,10,10,0,0,100,NoArch
f33ffab2f139011af961672c5f3ea9248be3e1ab,1,58,39,19,0,0,0,2,4,0,1,1,0,382,419,15,62,62,0,3106,3088,18,10,10,0,0,100,NoArch
6a0a2bdaaa7a1e300a1bacdc7775c758df4858d2,2,17,10,7,0,0,0,2,55,6,2,2,0.605186577,723,420,16,106,106,0,3394,3377,17,35,35,0,0,100,NoArch
6958a7fe17994d1435246ea1bf232fcf33dd241a,1,16,8,8,0,0,0,2,6,6,1,1,0,279,71,50,27,24,3,2196,2212,16,4,4,0,1,100,NoArch
9bcb6affd525cb9a971091e5d33c5bc549629d73,1,12,9,3,0,0,0,2,7,0,1,1,0,287,72,51,28,27,1,2202,2196,6,4,4,0,1,100,NoArch
2b5810e51c0241f5ba3abe0a38ccd8ced0751af0,1,2,1,1,0,0,0,2,7,9,1,1,0,336,27,5,22,22,0,1719,1704,15,6,6,0,0,100,NoArch
1b4185175a2dbb08603c0b9e4a258dd3830c80b1,1,8,12,4,0,0,0,3,11,7,1,1,0,179,28,6,14,14,0,1128,1155,27,8,8,0,0,100,NoArch
be17264524e2379bd960c25741336820b1bd3cbb,17,1014,22,992,13,0,13,2,15,43,2,7,3.828257041,546,421,16,152,66,86,7713,2378,5335,107,42,65,0,98.04729876,NoArch
dad5997b7e8a04eab9183288e5e8ac948916615c,2,108,4,104,0,0,0,3,7,41,1,2,0.543564443,925,29,7,98,91,7,6352,5577,775,61,58,3,0,100,NoArch
5a32a902bad5b56bd39193bc7dfd2b86ef11e769,19,1053,43,1010,8,0,8,2,33,17,3,12,3.224141302,1941,30,8,297,193,104,17041,10691,6350,147,88,59,1,98.10274995,NoArch
0083108dea189e391496e21571c3cbce225a8755,11,301,535,234,0,2,2,2,8,11,1,2,2.594121982,1637,0,0,115,141,26,7174,7990,816,44,49,5,1,99.89511223,NoArch
18d25de94848b039e9e5e759b63d2e22b5362682,1,1,1,0,0,0,0,2,5,13,1,1,0,59,73,47,4,4,0,254,255,1,2,2,0,0,100,NoArch
44b4ed70b77bdae5b6ec336a57371038d77ef87c,42,216,229,13,0,0,0,3,28,0,3,27,4.730290158,7132,422,15,593,596,3,40540,40697,157,258,257,1,0,100,NoArch
3305f4fff3e2a0e45ab7c4b9a7750fd624ca45a2,4,18,28,10,0,0,0,3,9,23,1,1,1.574614881,334,74,40,34,37,3,1224,1328,104,20,20,0,0,100,NoArch
ca5d17cb9a63eea4d4d975856cbf763e2e074a01,1,1,2,1,0,0,0,2,3,0,1,1,0,220,423,16,22,21,1,1391,1383,8,10,10,0,0,100,NoArch
8c68b31cf5d346d001cffef9cf28b4b819c06e90,8,394,116,278,0,0,0,2,13,24,3,4,2.321679576,3209,75,41,602,546,56,21576,19294,2282,250,247,3,1,100,NoArch
05f0c82f93f41122cfb14aec7f8cb8a3d05cc71d,2,16,14,2,0,0,0,8,42,19,1,2,0.918295834,384,76,42,39,39,0,1547,1481,66,31,31,0,1,99.97900042,NoArch
ef044f501e5629fe0ac46f29b82ee4cc65b35c5b,1,1,1,0,0,0,0,3,9,0,1,1,0,296,77,43,61,62,1,1413,1417,4,34,34,0,1,100,NoArch
9a9f6eb7574babe36103c4f743c14f0ba2d18fa4,1,2,2,0,0,0,0,4,14,0,1,1,0,341,78,44,73,73,0,1530,1528,2,38,38,0,1,100,NoArch
43a96876a6ba242db43090fec3bbdad1ba6e5bef,1,3,2,1,0,0,0,3,10,0,1,1,0,296,79,45,61,61,0,1417,1413,4,34,34,0,1,100,NoArch
5b965dfcfd697faa04175f312da8bf516d5e5f0f,1,2,2,0,0,0,0,3,11,0,1,1,0,297,80,46,61,61,0,1431,1417,14,34,34,0,1,100,NoArch
4c6ba6ffe40ad41812149d1f8a1210e68532789d,1,2,2,0,0,0,0,3,5,0,1,1,0,103,81,47,11,11,0,429,429,0,6,6,0,0,100,NoArch
d7b0b37570f64dd7ddbafbd51b72648a31afe95b,1,118,7,111,0,0,0,3,6,0,1,1,0,551,31,9,113,89,24,5306,4444,862,12,12,0,0,100,NoArch
2152f095f4088e9996114b9f8a9acd76234a7e9e,0,0,0,0,0,0,0,0,0,0,0,0,0,0,1,1,0,0,0,0,0,0,0,0,0,0,100,NoArch
0f033b2774fca4146484c8e134f2c3ad612e88f6,61,100,136,36,0,0,0,3,56,6,5,32,5.645666327,12687,424,15,1463,1463,0,49686,49686,0,617,617,0,0,100,NoArch
9e64aa69ec78bfe8a32422a561de13595c57ddaf,1,0,6,6,0,0,0,2,3,3,1,1,0,156,32,10,11,11,0,891,944,53,10,10,0,0,100,NoArch
c0a999bc4859f6c2c19f70d932cdec5fbf9156b9,1,1,2,1,0,0,0,2,4,1,1,1,0,150,33,11,11,11,0,889,891,2,10,10,0,0,100,NoArch
07b148e26df4cc712749673344de1be4009b906f,0,0,0,0,0,0,0,0,0,0,0,0,0,0,34,12,0,0,0,0,0,0,0,0,0,0,100,NoArch
452f13bd8a3a7adee0792067d4af8484c2d4bad9,3,24,1,23,0,0,0,4,11,31,1,2,1.320924277,1491,82,37,339,335,4,10070,9832,238,136,136,0,0,100,NoArch
8abc960f2830891bf43a706d1dc19ab60626a382,28,1302,1315,13,1,0,1,5,43,28,2,11,3.966952863,6608,83,17,663,668,5,39010,38621,389,270,271,1,3,98.85398981,NoArch
5d4cee37074351dae6fa9f7ec2b3357127cc8143,1,28,48,20,0,0,0,2,4,39,1,1,0,249,84,16,31,31,0,1649,1649,0,9,9,0,0,100,NoArch
eb92397738d7c4fee90e82506c21baa151822a26,1,122,105,17,0,0,0,2,5,0,1,1,0,229,85,17,36,31,5,1785,1649,136,11,9,2,0,100,NoArch
0f2cc3a60771f81e7f5f02ae70eb3b300874d627,2,13,14,1,0,0,0,4,13,42,1,1,0.825626526,618,86,18,56,55,1,3828,3826,2,17,17,0,0,100,NoArch
073255d3fe33ee0bc365d595129cf612585283e5,1,14,2,12,0,0,0,4,11,1,1,1,0,251,87,19,25,22,3,1455,1390,65,11,10,1,0,100,NoArch
43982ceb748327b4dcc2854e62478f59de720b6a,1,43,37,6,0,0,0,4,12,16,1,1,0,619,425,7,137,141,4,3497,3482,15,46,46,0,0,100,NoArch
8ccc7fda37c8b75066a545e52e6b92b30cfcb929,1,198,0,198,1,0,1,1,1,0,1,1,0,0,35,8,37,0,37,1133,0,1133,5,0,5,1,99.95711835,NoArch
e689607f5502b1ecb524417edd68cfe38cf4793a,0,0,0,0,0,0,0,0,0,0,0,0,0,0,36,9,0,0,0,0,0,0,0,0,0,1,100,NoArch
36e0f3726c61835290885b19e667923e39bfb1bc,1,2,3,1,0,0,0,2,2,0,1,1,0,198,2,2,38,37,1,1142,1133,9,5,5,0,0,100,NoArch
b697110ddacea6ac31362195a6bb3e03447c5a08,0,0,0,0,0,0,0,0,0,0,0,0,0,0,3,3,0,0,0,0,0,0,0,0,0,0,100,NoArch
cf27d49d261cc7fd72e6666868110e305c6dc16b,1,7,7,0,0,0,0,4,12,25,1,1,0,144,4,4,15,15,0,847,847,0,7,7,0,0,100,NoArch
e0ade2e91745dd3175b2779bb1de57f18d3e58e3,5,61,32,29,0,0,0,4,15,62,1,3,1.695141504,1834,88,17,317,310,7,8591,8386,205,185,181,4,0,99.24018573,NoArch
1115e3b4e438702cfb75c81aa3a420e9d2524e8c,1,9,7,2,0,0,0,4,16,0,1,1,0,359,89,18,77,77,0,1655,1648,7,40,40,0,0,100,NoArch
5854423a402d08048242f39d90fe2a8647a9773d,8,423,210,213,2,1,3,1,14,25,1,4,2.376430306,1045,90,19,134,107,27,7095,5937,1158,61,42,19,1,99.85453034,NoArch
e6569c6f9e11e2f4cdf2e12c44d1d4e6bc7b1b6e,1,3,2,1,0,0,0,2,6,7,1,1,0,246,91,20,36,36,0,1796,1785,11,11,11,0,1,99.9376947,NoArch
6d454c927086e60257f325923a42e44a6f62cdb8,1,2,2,0,0,0,0,2,3,27,1,1,0,569,426,5,71,71,0,2035,2035,0,24,24,0,0,100,NoArch
b469a98d8d29ac9762eae46ece6dfef0dcc7bc20,45,710,185,525,0,0,0,3,20,99,5,19,5.249908587,6320,427,6,596,596,0,24771,24861,90,277,277,0,0,99.83385254,NoArch
064567e18b9a72f421a605fec6f39c86e65591f9,0,0,0,0,0,0,0,0,0,0,0,0,0,0,5,5,0,0,0,0,0,0,0,0,0,0,100,NoArch
40d13893127859367b9be568af7a2e444f3114eb,2,108,53,55,0,0,0,2,2,2,1,2,0.52362052,329,428,6,54,48,6,1900,1753,147,36,32,4,1,99.89611469,NoArch
25a1880085f73a8885cf637bed35199c9d39cef8,48,162,235,73,0,0,0,3,45,37,5,27,4.418361831,17391,429,7,2392,2395,3,96831,97072,241,791,791,0,0,100,NoArch
a8ba0591a6cc12a354c6705eabc0388c151730f8,1,6,0,6,0,0,0,2,2,233,1,1,0,23,37,8,2,0,2,46,16,30,2,0,2,0,100,NoArch
cb6f86a80e2d3a060301e880a5a20b0a917b0e88,3,3,3,0,0,0,0,3,13,27,1,1,1.584962501,1508,38,9,332,332,0,8459,8436,23,130,130,0,0,100,NoArch
36e4fc18e027beffdb85e65a2b0e1f34e9c7e4e1,2,4,6,2,0,0,0,4,14,27,1,1,0.970950594,318,39,10,31,31,0,1957,1952,5,8,8,0,1,100,NoArch
fb4bb1a95a4c5dc8ffac34a0c33828eabc5db538,1,67,0,67,1,0,1,1,1,0,1,1,0,0,40,10,4,0,4,499,0,499,2,0,2,0,99.95845451,NoArch
3edb1a7ef4c6a2a9e7b7bb8cca1d5cf132a6c5a9,4,49,19,30,0,0,0,1,9,32,1,4,1.561357799,591,41,11,61,55,6,2893,2646,247,27,25,2,1,100,NoArch
235b944133bc4c44ff168bd8659d62ba652a47f1,5,642,20,622,3,0,3,1,5,0,1,2,2.255944995,403,42,12,111,45,66,6415,2113,4302,63,25,38,3,99.81339415,NoArch
c035a02d11ade06996f21f4d6f6231e324336ebb,3,48,57,9,0,0,0,2,11,23,1,3,1.377910032,311,43,13,27,23,4,1608,1743,135,18,17,1,1,98.95506792,NoArch
e7ae8b7326f3a3dd8d0efd20ffcf533e5493b895,14,709,116,593,6,0,6,3,10,10,1,2,3.488468606,1378,6,5,145,104,41,10082,7170,2912,66,41,25,1,99.66351209,NoArch
2798555d67cac9fc3628e38a20b24b7740a07f99,2,73,74,1,0,0,0,2,12,69,1,2,0.871950473,259,430,5,34,33,1,1465,1472,7,14,14,0,0,99.93709373,NoArch
cd19bd1d31acdd27b7a8de9c81d484c00999b93d,1,1,1,0,0,0,0,7,46,12,1,1,0,370,431,6,27,27,0,2224,2224,0,6,6,0,1,100,NoArch
bf9b8e8ba7645f60fe6e4e89522e56f033bff0d9,4,11,7,4,0,0,0,3,13,67,1,2,1.877640283,283,432,7,22,22,0,1501,1456,45,18,18,0,0,100,NoArch
f71908acc53c4988e85f03eed0556090fa11e62e,1,5,5,0,0,0,0,2,10,0,1,1,0,91,433,8,9,9,0,506,506,0,9,9,0,0,100,NoArch
5dfbb0c5283fd2a9596e5c30e6fa49f4a5caf786,7,238,9,229,4,0,4,3,11,9,1,1,2.266786466,234,434,9,36,20,16,2196,1152,1044,28,15,13,0,99.74874372,NoArch
12deb551775a682db0ea7cb687886d75cc31cb8b,0,0,0,0,0,0,0,0,0,0,0,0,0,0,7,5,0,0,0,0,0,0,0,0,0,0,100,NoArch
74ab3098c996d3499e299a7adb55e81ed60a4a32,23,139,122,17,0,0,0,2,12,39,3,16,3.962471997,3897,435,10,422,424,2,20100,20140,40,216,217,1,0,99.91637048,NoArch
5220c6f2a8b5dd0204d5c2263534eafb477fef1a,3,23,23,0,0,0,0,2,13,1,1,3,1.186392934,430,92,9,50,50,0,2566,2554,12,19,19,0,0,100,NoArch
8e8c6e27a7cab08500df85a336033d82b5083ba8,1,3,3,0,0,0,0,1,2,2,1,1,0,91,436,11,9,9,0,485,485,0,9,9,0,0,99.89541937,NoArch
e7f3d3e20113b337b976b43e1e28bc719749975f,0,0,0,0,0,0,0,0,0,0,0,0,0,0,14,0,0,0,0,0,0,0,0,0,0,0,100,NoArch
e87e186a8af217058b57d81060fb8fb802911fda,0,0,0,0,0,0,0,0,0,0,0,0,0,0,15,1,0,0,0,0,0,0,0,0,0,0,100,NoArch
a58444269456415255c83f2a13020a4c21671cf8,0,0,0,0,0,0,0,0,0,0,0,0,0,0,16,2,0,0,0,0,0,0,0,0,0,0,100,NoArch
d8f384e5971a6f67f952ee008a9a75eaff71c4c1,0,0,0,0,0,0,0,0,0,0,0,0,0,0,17,3,0,0,0,0,0,0,0,0,0,0,100,NoArch
514cb7c8deb753f9fb36c70f9dc8302a04cb67a8,0,0,0,0,0,0,0,0,0,0,0,0,0,0,18,4,0,0,0,0,0,0,0,0,0,0,100,NoArch
f73d4002aec1844622829f2c2822ea4765ec73b9,0,0,0,0,0,0,0,0,0,0,0,0,0,0,0,0,0,0,0,0,0,0,0,0,0,0,100,NoArch
7a786023136ab3c6443f6aca4556a71e093b5ff2,1062,30136,115970,85834,72,437,509,0,47,7,7,197,9.184625451,164777,0,0,8269,18909,10640,382577,800760,418183,3950,8038,4088,0,68.57353302,Arch
c57cb54f95f58df6c7cb45144a529f414eb66b15,0,0,0,0,0,0,0,0,0,0,0,0,0,0,18,4,0,0,0,0,0,0,0,0,0,0,100,NoArch
1a7b47aca1fdc8ce360bb96a44f6f91af33ae801,6,267,24,243,1,0,1,1,10,59,2,4,1.694100598,742,15,0,82,65,17,5234,3653,1581,39,32,7,1,99.79088248,NoArch
12d0d2bee2f78680ff685415d0c1f5e4a13537ba,1,47,7,40,0,0,0,1,2,0,1,1,0,184,16,1,19,10,9,1499,1220,279,3,3,0,1,100,NoArch
a1c2a058867a3fb1ae9cf0591471227f0219050d,1,9,3,6,0,0,0,1,3,0,1,1,0,224,17,2,20,19,1,1518,1499,19,3,3,0,1,100,NoArch
d9d9948419868e9929f25132cc830936f2e2e34b,0,0,0,0,0,0,0,0,0,0,0,0,0,0,19,5,0,0,0,0,0,0,0,0,0,0,100,NoArch
3dca4b59148654d617ad580a2ba7641a95d9d1a1,20,361,69,292,2,0,2,2,57,99,2,10,3.846429507,4508,437,10,520,486,34,22430,21380,1050,257,238,19,1,99.14154104,NoArch
6872e91043f803099453c1f21345ef08d969f7f0,7,58,59,1,0,0,0,1,58,131,1,6,2.605830241,1400,438,10,170,170,0,6928,6974,46,74,74,0,0,100,NoArch
0b499309aa7072f7e007e1413d26a2f5b19df6d5,0,0,0,0,0,0,0,0,0,0,0,0,0,0,20,6,0,0,0,0,0,0,0,0,0,0,100,NoArch
4226bec4d17550cb3358175b3a23059153ad700c,0,0,0,0,0,0,0,0,0,0,0,0,0,0,21,7,0,0,0,0,0,0,0,0,0,1,100,NoArch
1b16a94949af5564cd35a530b06ded5f6234fc28,0,0,0,0,0,0,0,0,0,0,0,0,0,0,22,8,0,0,0,0,0,0,0,0,0,1,100,NoArch
c0b74781eb165ff410e953d844da9c00dabac235,0,0,0,0,0,0,0,0,0,0,0,0,0,0,23,9,0,0,0,0,0,0,0,0,0,0,100,NoArch
16e39847c982df48ee710dac8c620767192039c7,0,0,0,0,0,0,0,0,0,0,0,0,0,0,8,1,0,0,0,0,0,0,0,0,0,0,100,NoArch
6eb3e85b64716c36fbba472a4e0a9b2cfd62fba1,1,1,1,0,0,0,0,2,16,113,1,1,0,144,439,9,4,4,0,508,508,0,2,2,0,0,100,NoArch
d9d24d35952292a9fb4761676192ea7fa4a8fdc9,0,0,0,0,0,0,0,0,0,0,0,0,0,0,24,10,0,0,0,0,0,0,0,0,0,0,100,NoArch
cd81660d4f5bdf536ababe20da0ed63272172be4,0,0,0,0,0,0,0,0,0,0,0,0,0,0,25,11,0,0,0,0,0,0,0,0,0,0,100,NoArch
bd7d5540bf900f6d5e23e78ded0dea4a1171ad26,2,31,26,5,0,0,0,2,6,57,2,2,0.127418512,569,26,12,52,51,1,3280,3259,21,21,20,1,0,100,NoArch
95b26428b0deb9e58991cc5efbf26b5275799706,1,1,1,0,0,0,0,2,5,115,1,1,0,50,440,3,2,2,0,251,249,2,2,2,0,1,100,NoArch
ad32b57995762e36a26edb4ab43ef10d3df841a8,1,52,17,35,0,0,0,1,4,40,1,1,0,230,18,3,26,20,6,1742,1518,224,5,3,2,1,100,NoArch
382f209783e3be32a6341fb6a8689b8843868fe8,4,68,0,68,0,0,0,2,9,120,1,1,1.997502546,954,441,4,172,160,12,3984,3550,434,122,118,4,0,100,NoArch
37d97270e61ca93c0aa694789535bc893c2adf85,15,32,37,5,0,0,0,2,59,61,5,12,3.308519247,2769,442,5,289,289,0,14179,14281,102,104,104,0,0,100,NoArch
5ec20d543d1ed8668396f4c57a152579ea997795,4,172,60,112,2,0,2,2,20,62,1,2,1.969560106,531,443,6,39,35,4,2984,2763,221,23,19,4,0,99.89524408,NoArch
53d3cc8acccf0fea554d0a197f09207b22c1adec,1,1,1,0,0,0,0,2,6,7,1,1,0,50,444,7,2,2,0,253,251,2,2,2,0,0,100,NoArch
2ebfee75b9e21e8819fe8782fe978dc3ad3b0539,1,3,1,2,0,0,0,4,17,133,1,1,0,120,445,8,4,3,1,740,732,8,2,2,0,0,100,NoArch
bad696f525d524170087a01dadcdee0ff829d411,1,6,2,4,0,0,0,4,17,128,1,1,0,181,446,9,20,19,1,1304,1288,16,5,5,0,1,100,NoArch
2bdf8e34206d8937c066bd6388d504cdc6ee8cef,3,7,4,3,0,0,0,2,18,88,1,3,1.494918848,280,447,10,28,27,1,1675,1650,25,8,8,0,0,100,NoArch
b3a9c4f08c44f842f5efd0e2039682021889b4a3,1,9,1,8,0,0,0,2,4,129,1,1,0,87,448,11,11,11,0,445,384,61,4,4,0,0,100,NoArch
b1376583d1bd4ec255080c4a92279a264dcbfb4b,5,26,48,22,0,0,0,2,18,70,2,5,1.304536311,599,449,12,29,32,3,3158,3284,126,15,17,2,0,100,NoArch
f618163c42a65c18c30faf6f9cbb4801ce0da3d0,9,121,58,63,0,0,0,2,19,33,2,8,2.826614258,1204,450,12,77,75,2,7206,7155,51,42,42,0,1,100,NoArch
56a7423020a6f258afefbca5fb5cdbcbd2768ae1,2,128,101,27,0,0,0,2,20,99,1,2,0.523305613,823,451,13,93,91,2,4747,4543,204,15,14,1,1,100,NoArch
34c48fe4f5c540153feb70c18aaf8e745e85cf00,4,13,14,1,0,0,0,2,19,27,1,3,1.912113891,420,452,14,40,38,2,2003,1988,15,15,15,0,1,100,NoArch
a92b4ed0d24262b40beaa1c66d4fa0c4cd13d19e,5,0,346,346,0,5,5,3,11,140,1,1,2.136271582,346,453,15,0,20,20,0,1058,1058,0,12,12,0,99.74821653,NoArch
477a95f84dac37242156a9a46c2a3e7088143916,10,13,13,0,0,0,0,2,20,6,2,8,3.085055103,1438,454,15,88,88,0,8251,8296,45,48,48,0,1,99.91586033,NoArch
3c36df26cc04affc269bb081740f81c1acd83950,3,21,8,13,0,0,0,1,21,0,1,3,1.113043276,450,455,16,22,22,0,2307,2307,0,10,10,0,1,100,NoArch
03b916413c94c7e97e4176a278341b7b634ea554,1,6,8,2,0,0,0,2,11,142,1,1,0,112,456,17,14,16,2,465,472,7,7,7,0,1,100,NoArch
ba43564e2f1b7bdddbd49bbba9a838b206c56860,1,3,2,1,0,0,0,2,4,142,1,1,0,65,457,18,2,1,1,240,230,10,1,1,0,1,100,NoArch
100fc63108740d576f3fd68687955f1a422f45c2,6,129,26,103,1,0,1,3,22,46,1,2,2.321343036,558,458,19,58,45,13,3473,3028,445,26,18,8,1,99.91600168,NoArch
3e150062d1511229a6fff47b1705498f036244d4,1,12,0,12,0,0,0,4,14,84,1,1,0,625,459,20,141,137,4,3562,3502,60,46,46,0,0,100,NoArch
c9c9b5be0b3e24f31ba0ff950bd2746e4b65050b,2,63,41,22,0,0,0,6,20,107,2,2,0.137099479,300,58,0,16,14,2,2022,1961,61,7,6,1,1,100,NoArch
9de8cc75b731823945df61201cf80b6387badfb6,1,0,9,9,0,0,0,2,3,89,1,1,0,182,460,21,8,8,0,752,831,79,3,3,0,1,100,NoArch
5cef385e23a72350880c0d72d8f4cb2b9de5c20d,3,315,22,293,1,0,1,2,9,10,2,2,1.143190218,461,19,1,81,56,25,3916,2437,1479,29,18,11,1,99.95808885,NoArch
306b4d04e304bb63b6a50cc17af229a3865a5ec6,11,22,224,202,0,0,0,2,11,158,1,8,2.716054299,3883,461,22,388,415,27,14216,15586,1370,103,107,4,1,100,NoArch
775626f0a292f7d67313d271a1f50abb05967a67,2,50,5,45,0,0,0,2,12,0,1,2,0.756833632,509,462,23,63,57,6,2794,2372,422,21,21,0,0,100,NoArch
4d434adfdc9c8742ce73ceee66c55b26920be4ad,16,1305,4,1301,14,0,14,1,10,0,1,4,3.58781112,128,463,24,123,14,109,6370,377,5993,84,14,70,1,98.05503828,NoArch
60b60918451bcb914c44f5148bd38478e9fe86d2,3,3,15,12,0,0,0,1,2,0,1,1,1.392147224,174,464,25,19,21,2,462,577,115,16,16,0,0,100,NoArch
dd8ed02c858a2195d89268addc225636426c7698,18,145,307,162,0,2,2,1,23,15,1,6,3.570654901,1660,465,26,103,124,21,7381,8047,666,55,71,16,1,99.5908347,NoArch
a16ed788407400b1863dc5c9d9b707293a4ff133,13,89,93,4,0,0,0,1,14,11,1,5,3.236242718,1204,466,27,93,94,1,5588,5637,49,60,60,0,1,99.77482088,NoArch
1ac13fa7f87f6c81816b53f29d048df48a55bd25,18,309,390,81,2,2,4,1,24,0,1,4,3.459898012,1553,467,28,105,118,13,6409,7205,796,62,72,10,1,99.48833402,NoArch
69f7b592116354a30de7db4fb9f979deafdfef4c,1,5,2,3,0,0,0,1,4,2,1,1,0,311,468,29,25,24,1,1811,1790,21,10,10,0,1,100,NoArch
992f6b80321467d5114ff752b5aa31820a2d0d66,1,1,2,1,0,0,0,1,5,0,1,1,0,314,469,30,25,25,0,1808,1811,3,10,10,0,1,100,NoArch
b148f217bbf19bf1f0d0d3d8536023d0c310aba1,10,23,11,12,0,0,0,3,22,128,2,9,3.296467165,1820,470,30,208,208,0,8474,8360,114,121,121,0,0,100,NoArch
b7c7c42f726945eb4069887e50e1801171c6f4b3,1,1,6,5,0,0,0,2,12,12,1,1,0,110,471,31,14,14,0,421,465,44,7,7,0,0,100,NoArch
34bf3badcffa171524cd343e81827134076b8911,0,0,0,0,0,0,0,0,0,0,0,0,0,0,27,3,0,0,0,0,0,0,0,0,0,0,100,NoArch
7d41e5e404de9a5a8f85602be142b36c7d4fcae8,0,0,0,0,0,0,0,0,0,0,0,0,0,0,28,4,0,0,0,0,0,0,0,0,0,0,100,NoArch
10b09ef1c72a2c5527387b2c3ef89119750c437b,0,0,0,0,0,0,0,0,0,0,0,0,0,0,29,5,0,0,0,0,0,0,0,0,0,0,100,NoArch
71293910aea8e5ab3264c7f9b66180a5b67e75de,0,0,0,0,0,0,0,0,0,0,0,0,0,0,30,6,0,0,0,0,0,0,0,0,0,0,100,NoArch
3bb27ad15a39f576711fe6d7f8233616b19f7650,0,0,0,0,0,0,0,0,0,0,0,0,0,0,31,7,0,0,0,0,0,0,0,0,0,0,100,NoArch
9c61d6438182ca633bc69abd696b4ba43a0bd87b,0,0,0,0,0,0,0,0,0,0,0,0,0,0,32,8,0,0,0,0,0,0,0,0,0,0,100,NoArch
c61b83c037090a238609a790f6b62fd6f2d8cb14,0,0,0,0,0,0,0,0,0,0,0,0,0,0,33,9,0,0,0,0,0,0,0,0,0,0,100,NoArch
6cda6440aa16aeb4ccd66f58d2240158597c122a,0,0,0,0,0,0,0,0,0,0,0,0,0,0,34,10,0,0,0,0,0,0,0,0,0,0,100,NoArch
d5c160bdcda99c85eec5b72f61a560cd50cfd707,0,0,0,0,0,0,0,0,0,0,0,0,0,0,35,11,0,0,0,0,0,0,0,0,0,0,100,NoArch
6f12cb313e15eed63e5c5cb26c8c18ac726323ae,0,0,0,0,0,0,0,0,0,0,0,0,0,0,36,12,0,0,0,0,0,0,0,0,0,0,100,NoArch
8b8b85aa0ae824b1a04e80076ae612ef27a5f1bf,6,73,47,26,1,0,1,2,21,57,1,4,2.129174851,521,472,32,59,59,0,2623,2513,110,24,23,1,1,99.95908347,NoArch
22e5cce8c07082a3b1ef039bdd445edf5c508632,4,24,20,4,0,0,0,2,10,32,1,1,2,1022,473,33,172,172,0,4008,3984,24,122,122,0,1,100,NoArch
ca33bc32551eb20d6480cfb544092f5acd5b33cd,1,1,1,0,0,0,0,2,20,150,1,1,0,209,474,34,44,44,0,1282,1276,6,5,5,0,1,100,NoArch
892fb11ea0ae7ef0bea23dd782410aacd59ba8f8,1,2,2,0,0,0,0,2,21,0,1,1,0,209,475,35,44,44,0,1287,1282,5,5,5,0,1,100,NoArch
9891a79717e0463f5df8802789a7ef42bcc755e1,1,7,5,2,0,0,0,4,22,0,1,1,0,193,476,36,25,24,1,1367,1356,11,5,5,0,0,100,NoArch
3a70a1066390b3e10c75799d915630f29a3e4126,10,363,97,266,1,0,1,1,23,77,2,5,2.702754063,1583,59,1,202,175,27,10548,9164,1384,130,112,18,1,98.69619205,NoArch
c6ad3c2984b79faa707a80cfab14c5b81c7e30ba,1,0,0,0,0,0,0,1,1,0,1,1,0,295,60,2,24,24,0,2513,2513,0,24,24,0,0,99.9161777,NoArch
994f73fdba06abfe7adde577d6d111fa4433356f,1,1,1,0,0,0,0,1,2,0,1,1,0,295,61,3,24,24,0,2513,2513,0,24,24,0,0,100,NoArch
bc97f11b88e1465788cad6f9f629fcba4521557f,1,5,2,3,0,0,0,2,21,30,1,1,0,340,477,37,28,26,2,2063,2049,14,10,10,0,0,100,NoArch
279c2bcc8015aaa1d192e01274d5066b496a39ac,0,0,0,0,0,0,0,0,0,0,0,0,0,0,37,10,0,0,0,0,0,0,0,0,0,0,100,NoArch
3f973d6460fc0ec239d13b6ebfb1f7054f359fe2,0,0,0,0,0,0,0,0,0,0,0,0,0,0,38,11,0,0,0,0,0,0,0,0,0,0,100,NoArch
20f2c1ec0d90d14b02f1f8c15e32667c496b8b31,0,0,0,0,0,0,0,0,0,0,0,0,0,0,39,12,0,0,0,0,0,0,0,0,0,0,100,NoArch
6111d5ca30fbc93fa16c2198b5926777fd088921,0,0,0,0,0,0,0,0,0,0,0,0,0,0,40,13,0,0,0,0,0,0,0,0,0,0,100,NoArch
edcbd3d58bae9c908c735eb91e19c8dfca9539a4,0,0,0,0,0,0,0,0,0,0,0,0,0,0,41,14,0,0,0,0,0,0,0,0,0,0,100,NoArch
d2ab9478b80c36337b749754685a2137e35fef9d,0,0,0,0,0,0,0,0,0,0,0,0,0,0,42,15,0,0,0,0,0,0,0,0,0,0,100,NoArch
b447d1cb8d116f68326f91947393b15262742005,0,0,0,0,0,0,0,0,0,0,0,0,0,0,43,16,0,0,0,0,0,0,0,0,0,0,100,NoArch
40561f911879f3d914738ecb296d62258cb8a5fc,0,0,0,0,0,0,0,0,0,0,0,0,0,0,44,17,0,0,0,0,0,0,0,0,0,0,100,NoArch
8438f10d3f8dd639850890ed994f86953a2d907d,0,0,0,0,0,0,0,0,0,0,0,0,0,0,45,18,0,0,0,0,0,0,0,0,0,0,100,NoArch
005bb1e9b189f4a276e2d87ce1d255de3317a0f5,0,0,0,0,0,0,0,0,0,0,0,0,0,0,46,19,0,0,0,0,0,0,0,0,0,0,100,NoArch
fb33e5adacee649660af6862ec06a755e17ed814,0,0,0,0,0,0,0,0,0,0,0,0,0,0,47,20,0,0,0,0,0,0,0,0,0,0,100,NoArch
0db81653d8bb6c4775464c951ba6ce85ddbe9100,0,0,0,0,0,0,0,0,0,0,0,0,0,0,48,21,0,0,0,0,0,0,0,0,0,0,100,NoArch
68a241f6dab3971c7c00b114307b2ffe5d3f97e3,1,0,1,1,0,0,0,2,3,113,1,1,0,418,478,33,51,51,0,1175,1175,0,27,27,0,1,100,NoArch
2f55c85f23c6ef8829db225740f9d5f935cf500a,2,9,3,6,0,0,0,2,20,120,1,1,1,275,479,21,16,16,0,889,879,10,12,12,0,1,100,NoArch
ae491e0cf2bde89565221b3490caba772987282b,0,0,0,0,0,0,0,0,0,0,0,0,0,0,9,0,0,0,0,0,0,0,0,0,0,0,100,NoArch
6bed65ae0c31d50c5c7d58ac237cb6e9815ca253,0,0,0,0,0,0,0,0,0,0,0,0,0,0,10,1,0,0,0,0,0,0,0,0,0,0,100,NoArch
ff3da8cd8522a90122b3ba833991e6f5d32717a6,45,173,156,17,0,0,0,3,44,118,6,35,5.060249263,10124,480,13,1065,1072,7,54422,54551,129,418,418,0,0,100,NoArch
d1e33585986d4f199d06e4469fc204151c3cc091,0,0,0,0,0,0,0,0,0,0,0,0,0,0,49,22,0,0,0,0,0,0,0,0,0,0,100,NoArch
5244107f93fd1339c3d8d3861e3028165f44eb55,1,6,3,3,0,0,0,2,6,98,1,1,0,222,481,11,34,33,1,899,891,8,17,17,0,0,100,NoArch
b4d9cc8be1c7440bbfba8473ec1dd7feaf207daa,51,1461,1660,199,5,0,5,3,39,119,4,22,4.388276934,11016,482,10,1405,1509,104,61148,63722,2574,656,650,6,1,98.39662447,NoArch
44ce35b3e71e795862f2ba6719fed45b2ab3e9bd,12,121,125,4,0,0,0,3,10,185,2,4,3.234797389,2386,483,11,447,459,12,14563,14302,261,204,206,2,1,100,NoArch
9a47bc15ce60ac09df8a0470493fcb175258e9e8,44,1380,502,878,7,0,7,1,47,88,3,21,4.509812654,7391,62,3,790,701,89,49906,44436,5470,324,289,35,1,99.34447029,NoArch
e6494ad3461266e9f7a86b1f37214a610698f621,0,0,0,0,0,0,0,0,0,0,0,0,0,0,50,13,0,0,0,0,0,0,0,0,0,0,100,NoArch
fb7be38a0a27d5f0dfac48cbe150f1f479d1dc11,24,147,121,26,0,0,0,1,48,50,3,13,4.137867911,5925,63,1,544,542,2,36561,36380,181,240,238,2,1,99.33040385,NoArch
680648282c980320eeb204db428a4b01e8cde68c,20,802,316,486,8,0,8,2,25,25,1,5,3.775469266,1321,484,6,179,149,30,8715,6633,2082,103,76,27,0,97.58986079,Arch
b58c9e3473a4368e5a6dc5ac58dace0ca71feef0,2,16,27,11,0,0,0,1,8,490,1,2,0.884115122,288,485,6,22,24,2,1639,1697,58,20,20,0,0,100,NoArch
6dd87dbab4623a4fa35f52c13ec979c791044e38,2,2,23,21,0,0,0,2,21,142,1,1,0.242292189,289,486,7,15,19,4,1220,1382,162,4,4,0,1,98.75125881,NoArch
e9aaf30b941e696f7c0c5bf3c0b89007c4b02914,16,170,574,404,0,4,4,4,18,15,2,2,3.794390697,4897,487,8,743,783,40,24583,26531,1948,383,411,28,1,98.24324324,NoArch
a496859f3623a36697175888f30e4af1a8e80b3b,21,407,1314,907,2,5,7,1,26,52,1,4,3.803523237,2397,488,9,147,222,75,7706,13295,5589,64,101,37,2,98.67587795,NoArch
722355d56edd370827d15e7cfd974f76668256e3,17,708,350,358,1,0,1,1,46,15,3,9,2.697931633,3395,64,2,427,373,54,21995,19573,2422,167,153,14,1,99.63355834,NoArch
28f38a05b24156652183f01ff9bcac5510291629,4,99,35,64,1,0,1,1,16,102,1,1,1.570725178,511,489,10,67,63,4,2307,2107,200,23,21,2,1,99.94226328,NoArch
38a66416e9a1153f11c4e09f46c6377a387036a1,2,6,6,0,0,0,0,8,47,0,1,2,1,394,65,3,40,40,0,1602,1588,14,31,31,0,0,100,NoArch
08a9bba83172802d3192c3a61be9705369c2fc0a,1,38,37,1,0,0,0,6,33,0,1,1,0,262,66,4,31,32,1,1037,1028,9,21,21,0,0,100,NoArch
cba4ea758c612ebe9b4b056e82c89bb9de6091b4,3,3,3,0,0,0,0,1,10,0,1,1,1.584962501,219,490,11,16,16,0,563,563,0,9,9,0,1,100,NoArch
2cea87aae8731be7b061c4030810b4032c491b2c,21,202,213,11,0,0,0,1,49,6,3,10,3.813139906,5005,67,5,470,466,4,30812,30592,220,142,142,0,1,98.23963657,NoArch
124f28161b4e08867f5f7db3458675882da21ea2,2,29,16,13,0,0,0,3,5,237,1,2,0.836640742,149,491,12,14,12,2,635,564,71,8,7,1,0,100,NoArch
1ad2373fc111098b95ea9d2717f9380628aed007,12,210,216,6,0,0,0,2,39,7,2,9,2.28434439,3334,68,6,346,345,1,20266,20174,92,135,135,0,1,98.89118587,NoArch
2951ca4f74fcb3636baf57d5b3599f3aa1bdea61,27,686,1147,461,0,4,4,1,50,46,3,16,3.734552696,6602,69,7,549,552,3,39990,42286,2296,197,202,5,1,97.07959534,Arch
3aec9dc08ec9aa779de2c7058079f1c67021cb70,12,277,397,120,0,1,1,1,51,7,3,11,2.582390072,3015,70,8,228,230,2,20090,20582,492,74,77,3,1,99.01563405,NoArch
5f29b068fe0956341b1232d11fda196b78fbead6,1,113,3,110,0,0,0,3,8,173,1,1,0,661,93,0,127,113,14,6150,5293,857,14,12,2,0,100,NoArch
d8dbba553d3e79d5407310b11323db84a5866fb4,2,0,106,106,0,1,1,4,13,123,1,2,0.846561846,342,71,9,25,41,16,917,1362,445,10,18,8,0,99.90300679,NoArch
4091520729308f48c95c0213dcc16942db593b03,1,23,11,12,0,0,0,3,11,19,1,1,0,111,492,10,15,13,2,710,619,91,3,3,0,0,100,NoArch
16937e1fd3cbf15109ecc68a34e36b95df0a8d94,94,763,1055,292,1,0,1,3,52,106,4,52,5.883660972,18294,493,9,1571,1653,82,108893,110342,1449,677,693,16,1,95.78926753,Arch
2ea96a14bc5fc6a76f7d1db4cf9e70c4505f398c,1,7,3,4,0,0,0,4,27,25,1,1,0,188,494,10,14,13,1,1192,1166,26,3,3,0,0,100,NoArch
cdb8e6d9c9e049ff9b16ee93e745d20f59ec3b00,15,586,166,420,6,1,7,1,6,35,1,4,3.719467838,921,495,11,103,67,36,5820,4234,1586,63,41,22,1,99.41049322,NoArch
ae7e1a0040667767163631d012f24e986435f3fb,1,1,2,1,0,0,0,6,34,1,1,1,0,386,496,12,20,20,0,2428,2441,13,8,8,0,1,100,NoArch
60c12f9e0fbe40e9dce58a6fa5e7c6c98d402957,10,161,195,34,0,0,0,4,27,29,1,9,2.941928587,2787,497,12,253,262,9,18071,18116,45,84,86,2,1,100,NoArch
f4c378aa4211427ba0c1b3f7b2b861d4404b5b40,21,100,130,30,0,0,0,2,47,43,1,18,2.054966971,4898,498,13,479,480,1,27923,28195,272,173,173,0,0,99.9022865,NoArch
355a5171cfc251b15fb6491851b52223a59fbbfb,11,47,46,1,0,0,0,4,33,78,1,9,3.123713758,1957,499,14,127,127,0,11309,11189,120,50,50,0,1,100,NoArch
d9e9db0c32f9c89612af72095617cfcdbfaadc0b,1,6,6,0,0,0,0,3,19,1,1,1,0,322,500,15,14,14,0,1574,1570,4,5,5,0,1,100,NoArch
059bc651196ac77a1b97ee95d001530365ba0df9,1,10,3,7,0,0,0,1,2,97,1,1,0,70,501,16,6,6,0,382,358,24,3,3,0,0,100,NoArch
6d867a23552fd97d01263900069dd7b0cf0d3d56,4,27,0,27,0,0,0,3,19,28,1,1,1.974937501,1248,502,17,166,166,0,4281,4281,0,104,104,0,0,100,NoArch
f8516295afd8734badef7ffc1cf3049067d415a3,1,39,8,31,0,0,0,2,8,30,1,1,0,126,503,18,27,20,7,780,648,132,9,7,2,0,100,NoArch
115bfeaa4004f065dcc531171c0d5ff810f8032e,29,157,133,24,0,0,0,1,28,46,1,7,4.607558663,2973,504,19,241,239,2,14762,14589,173,113,113,0,0,100,NoArch
ae7df11dd9aaeccefcf0987a5bda711a89bcd972,22,949,100,849,14,1,15,1,8,0,1,4,4.228705193,918,505,20,115,66,49,7583,4802,2781,59,31,28,1,99.08542518,NoArch
d13e2acaa45de3408231e8252820c30e958f4bab,0,0,0,0,0,0,0,0,0,0,0,0,0,0,72,8,0,0,0,0,0,0,0,0,0,0,100,NoArch
01bdb8e60f696819e4298b3e45c0685b6e530580,0,0,0,0,0,0,0,0,0,0,0,0,0,0,73,9,0,0,0,0,0,0,0,0,0,0,100,NoArch
ba3c70cde5315abc5c33926bfec4bbc7cea7a79b,1,1,1,0,0,0,0,2,6,13,1,1,0,99,506,20,2,2,0,403,403,0,2,2,0,1,100,NoArch
e55e36da81c26e625ba64463d79f10a125182c8f,8,42,12,30,1,0,1,4,15,74,2,6,2.156091704,1354,11,0,113,112,1,8407,8353,54,41,40,1,1,99.94199536,NoArch
b4297270718a3f4dd3cbbafd3aca03b910016d95,3,114,76,38,0,0,0,3,13,3,1,1,1.068392036,350,507,20,41,33,8,2292,2056,236,8,7,1,0,100,NoArch
babecbcc62a453961c7d4f305c3b8605b75ac09b,7,69,27,42,0,0,0,3,17,7,2,2,2.776974328,1147,508,21,175,169,6,5776,5503,273,91,89,2,0,100,NoArch
8b63e8fcf692af00384be5ae1aa646f105da2746,1,4,5,1,0,0,0,1,3,0,1,1,0,102,509,22,18,18,0,366,383,17,13,13,0,0,100,NoArch
01ce805e5c923e4bfd04f5e7c41c7728d5848aab,3,423,20,403,2,0,2,1,9,3,1,2,1.444891988,157,510,23,88,27,61,3015,780,2235,27,9,18,1,99.90360517,NoArch
c8f60cd566688992b044c4b97390543b9451e4bb,0,0,0,0,0,0,0,0,0,0,0,0,0,0,0,0,0,0,0,0,0,0,0,0,0,0,100,NoArch
f73d4002aec1844622829f2c2822ea4765ec73b9,369,9153,12584,3431,23,67,90,4,56,10,6,125,7.555566818,59512,0,0,5999,6270,271,296324,313167,16843,2613,2815,202,0,89.57079824,Arch
3d4bfb1e08e36491cfb04a54742131709988a659,370,12529,9325,3204,64,24,88,4,59,6,7,126,7.559825716,56287,74,9,6221,6039,182,311115,298136,12979,2782,2641,141,0,89.57079824,Arch
06bc65709052fa88eebb07032cf3db0b2765f1d5,64,0,18443,18443,0,64,64,2,8,227,2,21,5.188541187,18443,51,0,0,2090,2090,0,78812,78812,0,785,785,0,95.63845583,Arch
ac6f7580a59d9a44ac8f919ffd75d1c98621aef3,1,9,8,1,0,0,0,8,53,25,1,1,0,360,12,1,29,29,0,2299,2292,7,6,6,0,1,100,NoArch
e068ce739ad5857e15a6e65d22a1664e3ed79392,13,339,470,131,0,0,0,2,54,37,3,13,2.632269553,3337,75,3,215,217,2,21874,23031,1157,105,91,14,0,100,NoArch
4097e10dcf621bcc12c69d209006a2add83fcd81,3,131,149,18,0,0,0,4,38,31,1,3,0.977616046,711,76,4,67,69,2,4136,4346,210,44,41,3,2,100,NoArch
53369972e5337bf1a2dd23cd700fac87d125b37c,0,0,0,0,0,0,0,0,0,0,0,0,0,0,77,5,0,0,0,0,0,0,0,0,0,0,100,NoArch
ed5ef48601e132b973a90168b3cdce5aac9eab0e,0,0,0,0,0,0,0,0,0,0,0,0,0,0,78,6,0,0,0,0,0,0,0,0,0,0,100,NoArch
5b8274eb5f268798416d234e5105ba83a1675c80,2,2,8,6,0,0,0,4,28,130,1,2,0.721928095,657,79,7,91,91,0,4681,4713,32,28,28,0,0,100,NoArch
5dde0ca5287cf6003a2948b5940119edda932012,0,0,0,0,0,0,0,0,0,0,0,0,0,0,13,2,0,0,0,0,0,0,0,0,0,0,100,NoArch
530cfbfa496e29e3d939ede323fa4def2fe766d5,4,53,2,51,0,0,0,3,6,241,1,3,1.803409275,167,511,7,11,11,0,629,629,0,6,6,0,0,100,NoArch
96d5647f79c723715fc1f276346a56b487268a81,9,38,27,11,0,0,0,5,37,58,3,8,2.737797862,2233,80,8,162,163,1,13377,13356,21,70,70,0,3,100,NoArch
71ec577800d2700b46cbb7482577deb074e137e7,1,1,1,0,0,0,0,2,4,52,1,1,0,462,81,9,99,99,0,3558,3557,1,43,43,0,0,100,NoArch
a7c50b83956774709a02ce56b023e60a73c04571,1,9,1,8,0,0,0,4,8,242,1,1,0,100,82,10,9,8,1,549,522,27,4,4,0,0,100,NoArch
48332a4260d85693d84c07105e7dbefe835bff47,43,771,616,155,5,3,8,2,29,35,2,8,4.648242878,3899,512,5,385,358,27,18815,18218,597,215,188,27,0,99.32480455,NoArch
1e7d5eec0f736d703a73228aecf3db50b9b3720e,0,0,0,0,0,0,0,0,0,0,0,0,0,0,94,0,0,0,0,0,0,0,0,0,0,1,100,NoArch
4228fa47002df629b540b872daf0c03a88fb244e,0,0,0,0,0,0,0,0,0,0,0,0,0,0,95,1,0,0,0,0,0,0,0,0,0,1,100,NoArch
00dc9346a4cbb936e0a6a564d5cd556e931cf4da,1,5,2,3,0,0,0,2,14,780,1,1,0,149,96,2,16,15,1,1020,1012,8,9,9,0,1,100,NoArch
2e49d08ca4c49eda82eb68cf04563707e80d7476,0,0,0,0,0,0,0,0,0,0,0,0,0,0,97,3,0,0,0,0,0,0,0,0,0,1,100,NoArch
7e14bc6d22fe6bf2916615b1f0722931711d68eb,0,0,0,0,0,0,0,0,0,0,0,0,0,0,98,4,0,0,0,0,0,0,0,0,0,1,100,NoArch
0357f87ef42f892640f3c020980b34d5424f7ce8,3,4,4,0,0,0,0,3,10,274,1,2,1.5,177,99,5,9,9,0,943,891,52,4,4,0,0,100,NoArch
de75a29fc4849dd5a700410aaa40674eaa724575,1,0,152,152,0,1,1,2,15,0,1,1,0,152,513,2,0,16,16,0,1020,1020,0,9,9,0,97.01519868,Arch
db9e80cf4be0694f76477736d02e6cf5b5290637,6,7,5,2,0,0,0,5,55,18,1,6,2.221251836,1764,83,8,116,116,0,10809,10819,10,37,37,0,0,100,NoArch
0d4077c53a79a61bea50dc0bc139887fdfe672d8,0,0,0,0,0,0,0,0,0,0,0,0,0,0,100,6,0,0,0,0,0,0,0,0,0,1,100,NoArch
95ab66ffc698968dfc7e8910e37d138f5ea2f243,42,625,782,157,0,1,1,2,30,17,2,10,4.756979597,3766,514,3,265,274,9,16760,17861,1101,101,115,14,0,99.7704228,NoArch
c92666f3a7c0ea647fb94606f45ce9b108440a44,3,227,24,203,1,0,1,1,3,240,1,2,0.996596624,1472,515,4,176,171,5,9264,6047,3217,34,31,3,1,99.96158279,NoArch
4d270caf64e8aa53684ce637ac89824dc6efe6f4,1,1,1,0,0,0,0,1,2,5,1,1,0,85,516,5,14,14,0,260,260,0,11,11,0,0,100,NoArch
c8fecd2f3dbbc092a8f61510ddc0204f05d9603c,1,24,21,3,0,0,0,4,6,59,1,1,0,207,338,0,38,38,0,1062,1062,0,6,6,0,0,100,NoArch
e970c0bf3293730da363416e9251930a8bae88eb,1,0,0,0,0,0,0,1,1,0,1,1,0,212,339,1,19,19,0,1357,1357,0,9,9,0,1,99.92319508,NoArch
891782dbb4005f0e158d1f155918c71cc14a0ec4,1,5,3,2,0,0,0,3,7,63,1,1,0,137,340,2,10,10,0,1004,1004,0,4,4,0,0,100,NoArch
4ef4dc725dea6f8a9f1b3f72f3e82cd8254354ce,130,435,509,74,0,0,0,4,60,88,4,62,6.053401919,23021,517,6,2586,2590,4,117096,118166,1070,1051,1051,0,0,99.17184265,NoArch
0e1fcf6cf220576c1ed87dca7663087815a76a21,0,0,0,0,0,0,0,0,0,0,0,0,0,0,518,7,0,0,0,0,0,0,0,0,0,1,100,NoArch
48eac3d6ba656554da5274431505f60f1f796531,1,6,1,5,0,0,0,2,7,5,1,1,0,218,341,3,23,22,1,1246,1213,33,8,7,1,0,100,NoArch
f824f90d5eb76383e5e38227958bc1b0388259ed,182,1388,1216,172,0,0,0,2,57,78,2,72,6.752435118,29891,519,8,3100,3096,4,146860,146910,50,1524,1514,10,0,98.69085468,NoArch
aa861a5018495d48ddd16f95b4e715747db06fe4,1,1,1,0,0,0,0,5,13,22,1,1,0,235,14,1,21,21,0,1808,1816,8,2,2,0,1,100,NoArch
3a1cc8a7de554d108f0fa5c61fcb9eeb43308d8d,2,13,16,3,0,0,0,2,8,305,1,1,0.992266639,107,520,9,0,0,0,131,131,0,0,0,0,1,100,NoArch
7d55afa1222190ce01b893c3355e355e51b6840d,1,6,10,4,0,0,0,2,9,314,1,1,0,153,521,10,13,13,0,655,679,24,8,8,0,1,99.98104625,NoArch
641a6993653e3f920724761ae504bd4428c9a06d,4,51,18,33,0,0,0,3,32,10,1,1,1.779878161,567,522,11,60,59,1,3608,3418,190,14,13,1,1,99.96212121,NoArch
625ea72a7aea8e20f8f82665567a7b4d12672e4b,20,763,555,208,1,3,4,1,6,258,1,3,2.102270437,2308,0,0,121,119,2,14688,4848,9840,89,93,4,1,99.82951317,NoArch
bf9e2556131bc8a4d00462691f716920121af9c8,16,203,52,151,0,0,0,2,25,120,1,7,3.36436671,2902,523,12,386,364,22,12360,11526,834,231,217,14,0,100,NoArch
ad2817beb235f8f24b7e73feac2ad717346bcd6f,63,491,552,61,0,0,0,3,45,91,4,32,5.239085213,11836,524,13,1332,1336,4,62861,63240,379,533,532,1,0,98.41889881,NoArch
db1208973c21061f2af548ec3407ff11656d9e37,6,9,0,9,0,0,0,5,15,9,3,4,2.281036113,1152,15,1,92,91,1,7553,7507,46,32,32,0,1,100,NoArch
2eb0fdea836e077efb5350d41edef797903b2ed2,0,0,0,0,0,0,0,0,0,0,0,0,0,0,525,14,0,0,0,0,0,0,0,0,0,0,100,NoArch
69e9aa7bede6877cd792793c72c6a9b6b240eb20,5,20,23,3,0,0,0,3,5,156,3,5,2.221558853,923,1,1,146,146,0,4565,4582,17,64,64,0,1,100,NoArch
9d5bf2d5e6bcfb4cea7eb259fbe73ca740584e31,1,2,0,2,0,0,0,4,61,32,1,1,0,647,526,14,99,99,0,2916,2908,8,30,30,0,1,100,NoArch
5ce11fb7735a24894cc07e0c8545e98f29b90e11,14,412,301,111,0,0,0,5,33,45,2,11,2.409141808,2729,16,2,190,176,14,15357,15626,269,80,71,9,1,99.94517544,NoArch
3a445f7fdedb0b025d1a311b22ed63e1fd1345be,2,33,66,33,0,0,0,1,2,82,1,2,0.99107606,380,527,14,42,55,13,2040,2085,45,17,18,1,0,100,NoArch
db4c0c4a57f87671bdaccf9756cf97bf7378d209,22,366,273,93,3,0,3,4,42,121,3,9,3.716057307,2585,84,1,252,238,14,15117,14479,638,128,117,11,1,99.01557186,NoArch
611e74f8207eec4f84f77cb9357c1b261c054885,1,13,11,2,0,0,0,1,3,1,1,1,0,167,528,15,15,15,0,506,508,2,9,9,0,0,100,NoArch
b5707dda706b8e4be4c941f4bdc9fa06e7489116,11,315,332,17,0,0,0,6,41,37,2,5,2.934074252,2022,85,2,148,150,2,12223,12253,30,64,64,0,1,97.04267753,Arch
7c1f5dfc55524542aebbd9958793f36585f7380f,2,138,103,35,0,0,0,2,62,52,1,2,0.54210657,822,529,13,114,111,3,4173,3980,193,41,39,2,1,100,NoArch
69ee3e552f9319f5fb6a8475ab55e80534146d8e,10,270,295,25,0,0,0,7,58,79,2,4,2.936175918,2044,86,2,169,171,2,11737,11664,73,53,53,0,1,97.21877768,Arch
964db4a8ae51fb0d896dcd03836c6056ff317898,7,260,260,0,0,0,0,6,35,52,1,2,2.704463026,1570,87,3,152,148,4,9142,8829,313,42,42,0,1,100,NoArch
88c5af99ce20151ca2a8f4fb476db9db0f8a1708,2,15,3,12,0,0,0,3,12,8,1,2,0.650022422,315,44,0,25,23,2,1990,1940,50,17,16,1,0,100,NoArch
fae0f2d40cbbf027c303bb130fc8b48596946890,12,244,431,187,0,2,2,5,35,132,2,3,3.259740804,1598,88,4,128,139,11,7848,8892,1044,46,51,5,1,98.88988362,NoArch
0497f91ce4e03a7855d500cfad0dccddd2f61d21,13,74,106,32,0,0,0,3,34,14,2,10,3.385734877,2850,530,12,232,230,2,14917,15239,322,124,124,0,1,99.94515539,NoArch
8fba6529a1a4beafe6e43bd8300f7a1594c5c14f,2,30,22,8,0,0,0,2,14,73,1,2,0.569961376,793,531,13,160,157,3,5066,4980,86,80,79,1,0,100,NoArch
d99b6780a5c58ee7fd4c54b2a1caa763f76c28e1,4,360,26,334,2,0,2,1,20,109,1,4,1.487569436,274,532,14,53,23,30,3244,1682,1562,35,14,21,1,99.83600583,NoArch
32f5f0940dabce67113be97b15a87cbb52e5ce5c,1,13,0,13,0,0,0,2,3,109,1,1,0,27,2,2,2,1,1,126,33,93,2,1,1,1,100,NoArch
daa77420b2c5a83be1fca5d584c414e189f2a446,1,5,5,0,0,0,0,2,5,351,1,1,0,66,533,13,2,2,0,99,99,0,2,2,0,0,100,NoArch
71850f26e96311afcf9d1029a62ac47d07cdf0d8,36,166,3629,3463,2,19,21,3,43,119,2,13,4.423673058,5649,534,9,174,460,286,11200,26833,15633,78,227,149,0,93.99529752,Arch
6cb5b69946c6ed51c53051656d78f2736aa7d8db,24,1044,734,310,2,0,2,3,23,143,1,8,4.102327259,2926,89,5,285,259,26,16421,15256,1165,115,107,8,1,99.65598407,NoArch
a604dad3013fbce19c3f0ea63f8bbb27d945cf4f,1,12,0,12,0,0,0,1,2,1,1,1,0,70,535,10,8,7,1,452,355,97,7,6,1,0,100,NoArch
7455cab2a8cc433836f800c25d0bc3628f87fccd,6,97,47,50,1,0,1,1,43,11,1,4,1.817123282,810,90,6,84,80,4,6022,5847,175,47,43,4,1,96.70170352,Arch
6be26c7f4a04d63be6d8831ca8501ed954970042,1,4,6,2,0,0,0,3,12,16,1,1,0,399,536,11,40,41,1,1566,1577,11,16,16,0,0,100,NoArch
6ce1a40c38c7ed565093913fc64dad27af19cccd,7,577,8,569,5,0,5,1,15,11,1,2,2.625406276,613,537,12,87,36,51,5947,3413,2534,49,16,33,1,99.80205147,NoArch
88652b9b2188d9df14c434663128d5b077617bba,2,5,2,3,0,0,0,4,63,159,1,2,0.985228136,709,538,12,105,105,0,3083,3065,18,35,35,0,0,100,NoArch
2462a10ee707940b10a7fc602ffa2dfa958d0d7c,1,15,11,4,0,0,0,2,18,59,1,1,0,366,539,12,54,53,1,1842,1816,26,15,15,0,1,100,NoArch
dcf2924e4f645dfc6048c48b3cdb973ee10474b4,13,293,10,283,1,0,1,1,64,129,1,5,3.036600617,4063,540,12,765,690,75,18625,17055,1570,360,345,15,0,99.49685535,NoArch
f77d59d3d850cd43be4b5257378bd9cda747c767,3,45,30,15,0,0,0,2,29,0,1,2,1.448322687,771,541,13,90,90,0,3177,3213,36,38,38,0,1,100,NoArch
639f2dee3e127c737f3e47c821b6238bcec9fd34,58,2710,2090,620,26,25,51,1,16,33,1,11,5.355023857,2677,542,8,239,239,0,15060,13098,1962,141,143,2,1,95.74028898,Arch
5d0f8fbc99042d55bd39bb5222769d51d2609565,1,2,1,1,0,0,0,4,65,18,1,1,0,656,543,9,100,100,0,2951,2947,4,30,30,0,0,100,NoArch
f63257710f2caeb697f47522abe70b67296d4b2d,2,57,9,48,0,0,0,1,19,492,1,2,0.967294779,590,544,10,76,71,5,3555,3298,257,33,32,1,1,100,NoArch
74735db0c1b9f01eb7fc39376e9de26278b3d5b6,1,1,1,0,0,0,0,2,10,403,1,1,0,106,101,0,9,9,0,564,556,8,3,3,0,1,100,NoArch
1ec084c1bff93440ce33bd1460260b36373399a9,2,18,5,13,0,0,0,3,16,243,1,2,0.666578358,216,342,0,19,18,1,1056,899,157,9,9,0,1,97.49359678,Arch
95e5e49d678e9c9f90fb3877746bc2e93e293d57,1,8,1,7,0,0,0,3,9,133,1,1,0,202,343,1,17,16,1,1569,1533,36,8,8,0,1,100,NoArch
45cebc427d31070ef01e9d660da10dea81f40604,95,329,596,267,0,0,0,1,59,75,1,41,5.766695777,15861,545,7,1621,1621,0,79204,79537,333,716,712,4,0,100,NoArch
7097e25f0f864e6e708243191e2d5b78203ecbab,1,2,1,1,0,0,0,4,5,215,1,1,0,72,17,0,5,5,0,375,354,21,2,2,0,1,100,NoArch
c40f860ad3b3526e882c84b7fa18e1752ae24ddc,2,43,9,34,0,0,0,5,35,86,1,1,0.569961376,342,546,7,34,28,6,2370,2157,213,6,6,0,0,99.10282954,NoArch
59ce155dfe66a8611de87fdd0b035bbad40a130c,1,5,0,5,0,0,0,4,10,99,1,1,0,210,344,2,39,38,1,1106,1063,43,6,6,0,0,100,NoArch
ecc4cc76e84a3ea80b28cbeba58e05f6e637bdab,2,17,4,13,0,0,0,3,17,14,1,2,0.791858353,229,345,3,20,19,1,1158,1056,102,9,9,0,1,100,NoArch
5698bdd64e0c2107924d15f930497f7766682d19,1,1,1,0,0,0,0,4,17,100,1,1,0,168,346,4,14,14,0,1199,1199,0,3,3,0,0,100,NoArch
508f7815fb67a6520bf4e4d7781d98a4b05dbc66,1,61,45,16,0,0,0,4,18,0,1,1,0,168,347,5,16,14,2,1347,1199,148,3,3,0,0,100,NoArch
0acff21d032d4e12545b84cf2d0aa92b16500fb9,1,1,0,1,0,0,0,9,60,14,1,1,0,305,3,0,22,22,0,1744,1735,9,6,6,0,1,100,NoArch
a7f82c97696625a5f0add0d2b22540141987ef29,32,999,1007,8,1,0,1,5,31,135,2,14,4.506547416,4587,91,0,383,378,5,25338,25525,187,117,119,2,1,99.89579715,NoArch
44dbc4f2acb9c5ae6fc7ae481c18bddf187dc19e,2,0,0,0,0,0,0,1,1,0,1,1,0,278,92,1,19,19,0,938,938,0,8,8,0,1,99.86111111,NoArch
97f9beb0ee587d0fa9843c3d1d79cfc5f5ad5f2b,9,289,243,46,0,2,2,3,50,41,2,8,2.598818112,1998,93,2,212,218,6,14857,15227,370,58,64,6,0,99.22050927,NoArch
d701a675ff403aeca46f1268c7d12414ae49da92,5,103,91,12,0,0,0,4,17,19,1,2,1.644841608,711,18,1,43,44,1,4332,4450,118,17,15,2,2,99.86175912,NoArch
cb4a14acebd7a8d0f5fb5b14b5abea4db218a47c,2,303,12,291,1,0,1,1,13,31,1,2,0.709046469,397,19,2,52,40,12,3179,1566,1613,19,16,3,1,99.96545769,NoArch
644abbf6daecf009704964ac85c1bfa79f96331a,1,3,1,2,0,0,0,4,18,0,1,1,0,274,20,3,15,15,0,1455,1444,11,6,6,0,2,100,NoArch
4f0ddbda9efb1b3e9dfbea9f2103cebd828e685d,14,41,56,15,0,0,0,1,45,47,1,6,2.938966141,1998,94,3,200,201,1,10689,10695,6,115,116,1,1,99.93093923,NoArch
1a03fe87d166440650ab32cd60a2a407c42d5b8f,0,0,0,0,0,0,0,0,0,0,0,0,0,0,21,4,0,0,0,0,0,0,0,0,0,1,100,NoArch
d3226b811fc8ce6b00fc6594e383df79251ba0eb,1,1,1,0,0,0,0,1,1,0,1,1,0,73,102,1,5,5,0,338,338,0,5,5,0,0,98.24164345,NoArch
bedb0216ed3e4d50b247a3228d06bc4a57df0e8b,4,57,64,7,0,0,0,6,38,57,2,2,1.446171651,899,95,4,105,105,0,4680,4647,33,44,45,1,0,100,NoArch
93a672ca0d1d7e0cb1cf53fcba9999c167830f50,21,1293,481,812,4,3,7,1,36,44,1,9,3.149195648,2169,547,5,230,183,47,15913,11326,4587,100,78,22,1,97.13990351,Arch
e7566a06a3d86782336eaeed7004630731b690a9,11,146,136,10,0,0,0,6,22,99,1,5,2.984771279,1135,96,5,116,116,0,6706,6678,28,58,58,0,0,99.88175676,NoArch
571a6e9a0117726b5d15f83d7bcd46ff0cc580a9,14,335,761,426,3,8,11,6,19,0,1,4,3.673729294,1145,97,6,65,134,69,4232,7684,3452,31,64,33,0,94.60573141,Arch
c81292ec7522e829c85fed1df5ae17e4849d18f1,10,51,6,45,0,0,0,7,50,73,1,7,3.28360357,1821,98,7,214,206,8,7653,7523,130,155,147,8,0,100,NoArch
6fa7225686f34c8f77e843e115e2bda08f70996b,1,8,2,6,0,0,0,4,12,441,1,1,0,99,4,1,7,6,1,738,689,49,2,2,0,1,100,NoArch
f798e278b2589dea5f79c43d653beb65dfe88913,4,145,16,129,0,0,0,5,18,180,1,2,1.427554412,1801,5,2,218,205,13,9821,9080,741,114,109,5,1,100,NoArch
1084b172cadd9f83860c8e9682af5a3703939cac,2,5,5,0,0,0,0,4,15,50,1,2,0.721928095,701,548,6,72,72,0,3238,3238,0,41,41,0,2,100,NoArch
4799a594388ac2fd70c417b736f0f8542ee32409,4,73,28,45,1,0,1,1,18,16,1,3,1.604753895,912,549,6,55,52,3,5192,5046,146,25,23,2,1,98.70889651,NoArch
0971a5397dd848f5ca34e9e65e6addefd2b7fd3f,1,12,12,0,0,0,0,6,22,79,1,1,0,198,22,5,11,11,0,1264,1264,0,3,3,0,1,100,NoArch
2b4f74cd17260e67093e77047814160634a53392,7,18,9,9,0,0,0,5,61,44,2,7,1.958229169,1661,99,8,94,94,0,9457,9376,81,37,37,0,1,100,NoArch
ab87ea2805946b5e3c5d380b10b57bf7d11e84bd,2,21,5,16,0,0,0,2,46,192,1,2,0.961236605,1054,550,5,129,125,4,5044,4951,93,57,57,0,0,100,NoArch
0ffe1b1fd3da1ba87b1c4957907ee5d3a3e2fbda,1,0,1,1,0,0,0,2,47,0,1,1,0,835,551,6,92,92,0,4091,4096,5,40,40,0,0,100,NoArch
a14c9cb094b7b5745ecd82110fc759c6466d41c0,21,1577,1234,343,1,0,1,2,62,49,3,20,3.648872696,6037,100,9,519,507,12,41123,41168,45,200,190,10,1,95.5268216,Arch
808ea0425edd408293700054706052ecb6865985,5,40,24,16,0,0,0,3,39,99,3,4,0.711332331,1097,101,10,98,97,1,7460,7242,218,34,33,1,1,100,NoArch
4a734131d3b064b1821a3bb25c0346e0bc30d145,4,18,35,17,0,0,0,5,48,0,1,4,1.820295192,1545,102,11,85,85,0,7210,7727,517,35,35,0,1,100,NoArch
a3f65c88044dd3d8bbb94e84cf32ca44562d2469,8,294,35,259,3,0,3,1,7,282,1,5,2.313049057,353,552,6,41,19,22,2196,1071,1125,25,13,12,1,99.84114376,NoArch
a69d7b38727078309a3d630def4ee2f87337a19e,22,468,534,66,0,0,0,4,63,4,3,21,3.72160204,6934,103,12,601,602,1,41052,42213,1161,227,219,8,1,100,NoArch
cfdebc84619d3df3cf52bca79dab98269d4e8899,7,342,157,185,1,0,1,1,5,378,1,4,2.444393888,2110,6,2,252,237,15,9841,8752,1089,66,63,3,1,99.95245642,NoArch
5a5a0c48342577696ba72d84ae41bb3d640d187f,2,292,0,292,2,0,2,1,1,0,1,2,0.98642108,0,7,3,40,0,40,1467,0,1467,16,0,16,1,99.9208485,NoArch
f7dd64cedc905f6941bdb3bd794140d070d6d893,23,1427,618,809,0,0,0,2,64,15,3,15,3.483323526,5482,104,9,462,417,45,36365,32667,3698,209,187,22,1,97.02680747,Arch
f41456bf87a9852ad18a3a97d1494fe3336f31c5,1,11,10,1,0,0,0,1,2,1,1,1,0,126,8,4,14,14,0,676,750,74,7,7,0,1,100,NoArch
d01c26a4b7e2845668bc0873aa9f95137cdd5c95,15,1233,248,985,0,0,0,2,65,12,3,11,3.135959776,4221,105,9,457,372,85,30248,24866,5382,148,121,27,1,98.4423676,NoArch
a69d070e85313ea33c91fe9eed72e9e23bba6822,5,1267,0,1267,5,0,5,1,1,0,2,4,1.820445605,0,23,1,198,0,198,8399,0,8399,39,0,39,1,98.45264728,NoArch
5a06fc07904e6770abc315e7640d284598f18307,8,15,3,12,0,0,0,5,39,43,3,7,2.591793226,2167,24,2,118,118,0,10743,10653,90,46,46,0,2,100,NoArch
f7a66839cbf2b2531699d326a855a4d84564a233,1,1,0,1,0,0,0,5,16,0,1,1,0,341,25,3,19,19,0,1596,1587,9,5,5,0,2,100,NoArch
b64eb1cc7459f94a0140304e658e6faf97191b7f,4,5,0,5,0,0,0,6,23,92,2,4,1.921928095,796,26,4,46,46,0,4249,4213,36,22,22,0,2,100,NoArch
b7ef42cb0afc1ecc8ca280e10c6d84be4e1d42f3,1,1,0,1,0,0,0,5,34,12,1,1,0,354,27,5,50,50,0,2154,2150,4,19,19,0,2,100,NoArch
b3ba49c381d8fb155b887d4eb89c828b8c0bd722,49,972,1197,225,3,3,6,2,66,51,3,14,4.63124168,10034,106,7,949,970,21,56893,56589,304,439,457,18,1,98.69856459,NoArch
5a986a3cf882927eb65f59066161989c97ab5f36,1,9,1,8,0,0,0,4,13,39,1,1,0,105,9,5,10,7,3,790,738,52,2,2,0,1,100,NoArch
91456bb2aab251b8512b41b48726fe0550d25cfa,44,5089,336,4753,42,0,42,1,5,0,3,9,4.937803861,859,10,5,523,107,416,26555,4068,22487,226,20,206,1,94.49898129,Arch
f4c8f73fce2f184612db3a837a180c9c2689b889,44,336,5089,4753,0,42,42,1,6,0,3,9,4.937803861,5612,11,6,107,523,416,4068,26555,22487,20,226,206,0,94.49898129,Arch
1d47b6f7b71812bba4ef8dd2ba09410dade0d063,8,334,175,159,2,0,2,1,7,142,1,4,2.536988718,2330,12,6,284,263,21,11685,9875,1810,65,58,7,1,99.81096408,NoArch
622a9045889e73beaaad1d23d7e7dc63fefe7780,12,453,24,429,7,0,7,1,26,93,1,6,3.245197059,1127,553,1,168,152,16,7795,5680,2115,93,80,13,1,98.70689655,NoArch
5eb9b167bdaf83b2199e42e0b30576c6160629ec,1,6,1,5,0,0,0,2,16,177,1,1,0,127,554,2,16,16,0,751,751,0,11,11,0,1,100,NoArch
c09306664f27c222f21c1528bb65848cc676dcd3,7,259,68,191,0,0,0,4,19,241,2,3,1.994417052,2997,13,7,563,539,24,18309,17119,1190,235,220,15,1,100,NoArch
a6f25769c57d27be81ff030704fdff22071790f3,3,253,0,253,3,0,3,1,1,0,1,2,1.211490423,0,14,8,21,0,21,758,0,758,16,0,16,1,99.79591837,NoArch
5deeadd52fd9d781619c96fe1d93df666f2a8109,1,21,2,19,0,0,0,3,15,166,1,1,0,332,45,0,64,60,4,1579,1450,129,37,36,1,1,100,NoArch
4b8c14bdb7c5efe3f97aedb485233d6669da5a97,1,1,1,0,0,0,0,2,11,105,1,1,0,324,46,1,48,48,0,1515,1515,0,29,29,0,0,100,NoArch
f30de5ca80829958171b3102f678ed831eaa46fe,13,528,13,515,4,0,4,1,15,232,1,6,2.850468639,847,28,0,108,42,66,7279,4497,2782,34,16,18,1,99.51985226,NoArch
3fb713293baa218477bda020daa9f867f70dd4fb,5,97,106,9,0,0,0,2,37,122,1,3,2.28261494,868,29,1,87,89,2,5059,5220,161,20,19,1,1,99.98159057,NoArch
25d94c3e7ff7c37b5ec65f476c331ce92f39988b,0,0,0,0,0,0,0,0,0,0,0,0,0,0,30,2,0,0,0,0,0,0,0,0,0,0,100,NoArch
d9b6358bb1f0730038e3683552b2d3812cbd22ec,44,223,437,214,0,0,0,1,67,107,1,24,4.173041771,9350,555,2,887,893,6,42904,42986,82,415,421,6,0,100,NoArch
2dbcb6df9e0ee6db81ba82e35fa2e2de6763e405,2,4,5,1,0,0,0,2,53,0,1,2,0.503258335,393,556,3,41,41,0,2025,2039,14,25,25,0,0,100,NoArch
0a8908e73d282173a713fd2d1f81e80fe0edfc05,1,12,29,17,0,0,0,3,23,224,1,1,0,139,557,4,11,10,1,470,449,21,7,7,0,1,100,NoArch
d07a964f1fbe4923ab2cec1775eab85a9f3437ce,3,8,6,2,0,0,0,4,11,228,1,2,1.577406283,177,31,3,9,9,0,958,943,15,4,4,0,0,100,NoArch
0ead4c80b56f9f96c8f3f07b2dc95f2eeef98a55,3,14,8,6,0,0,0,4,12,0,1,2,1.435371391,179,32,4,9,9,0,975,958,17,4,4,0,0,100,NoArch
aa84f9b8135fce4dc0131c01e6e04f86a496114c,2,38,5,33,0,0,0,5,20,60,1,2,0.952265625,1336,15,2,179,174,5,8937,8691,246,71,70,1,0,100,NoArch
2b14be2eb134d16be0cf20704af38122a3f68232,4,418,3,415,2,0,2,1,5,100,1,2,1.067438375,100,16,3,49,11,38,2899,383,2516,18,4,14,1,99.15874177,NoArch
29af4d71dcaa2d95a492d5676fb6dc7a75e4fac5,14,191,219,28,0,0,0,2,16,332,2,7,3.159030998,3984,17,4,594,593,1,22235,22240,5,165,165,0,1,98.13458856,NoArch
8a4161be2d63acc80cacf990aadface9134a84f0,3,28,13,15,0,0,0,1,38,39,1,2,1.221104104,411,558,5,28,27,1,2278,2138,140,9,8,1,1,99.89924433,NoArch
f5f286e074aafb513ae51bf8a06cb0398cc739e9,2,2,2,0,0,0,0,3,8,0,1,1,1,553,47,2,113,113,0,3956,3952,4,51,51,0,0,100,NoArch
f85173cbdefb26974165b4f229006d4b35e2f739,1,1,1,0,0,0,0,4,8,0,1,1,0,131,48,3,18,18,0,533,531,2,9,9,0,0,100,NoArch
024261a3f609d4d40f090369d80fd1cda3d5ef9e,84,456,662,206,0,0,0,5,43,166,2,39,5.5919806,12947,559,6,1155,1171,16,71252,72428,1176,427,423,4,0,97.83399757,Arch
bfa4da7277221d064cb00ba3af370171fef72caa,6,94,7,87,0,0,0,1,39,73,1,4,1.97972728,1860,560,7,126,118,8,11425,10811,614,46,43,3,1,99.96428571,NoArch
6de4710d460494ed9d4ab20766f93c609373844c,14,492,239,253,0,0,0,2,66,269,2,7,2.54029951,3986,561,8,490,463,27,18004,17100,904,218,206,12,1,100,NoArch
dda346445586dc52ea4a7f2888d2c09da7f05e5b,1,9,7,2,0,0,0,2,4,0,1,1,0,109,562,9,11,11,0,622,621,1,5,5,0,0,100,NoArch
b0d9fb594cc3619a4644709e91baf95d569c229d,2,2,11,9,0,0,0,1,5,52,1,1,0.779349837,490,563,10,52,53,1,2405,2461,56,26,27,1,1,98.37750135,NoArch
a492d4a7c60712e003f25752d84e7ed4a8eb4cc4,0,0,0,0,0,0,0,0,0,0,0,0,0,0,564,11,0,0,0,0,0,0,0,0,0,1,100,NoArch
d9a3043b0459271e7bebee3ad9a0033e537acfe6,2,837,0,837,2,0,2,1,1,0,1,2,0.864470605,0,33,5,108,0,108,3980,0,3980,42,0,42,1,99.48282231,NoArch
aec18185d718dc04d4c5e53ddb3cc3e5825db386,61,364,454,90,0,0,0,2,21,357,1,14,5.064061483,22593,565,10,3095,3099,4,101289,101825,536,913,913,0,0,100,NoArch
719772b4d8ce5d160f12048f2f2c0382ae63d078,2,479,499,20,0,0,0,3,3,343,1,1,0.997799734,1338,18,5,108,108,0,6579,6700,121,29,29,0,0,100,NoArch
e67810fed1958e7dd966539bdbcc9c3c6fa72bfe,1,1,1,0,0,0,0,6,40,3,1,1,0,299,0,0,19,19,0,1948,1948,0,3,3,0,0,100,NoArch
611d287e8da9e5023a0bea99a66b50734a6d6027,1,130,127,3,0,0,0,3,7,1,1,1,0,804,19,6,74,74,0,2422,2454,32,20,20,0,0,100,NoArch
bb9ed914abc456aba8fc14af5ab03edcc017fb9b,1,79,82,3,0,0,0,3,6,1,1,1,0,424,20,7,88,88,0,3010,3078,68,10,10,0,0,100,NoArch
803b893527b56f5dcbe4316a3e51daf05f08de50,1,10,0,10,0,0,0,4,67,6,1,1,0,732,566,11,113,111,2,3271,3239,32,36,34,2,0,100,NoArch
555f1f636b608d7d72ad79ad91f56f29d3c6dc43,1,318,367,49,0,0,0,5,10,5,1,1,0,1119,21,8,204,205,1,5069,5258,189,42,42,0,0,100,NoArch
dca7cbbd88b5f53ae435b6a32653898221150af5,1,130,145,15,0,0,0,3,4,5,1,1,0,642,22,9,63,63,0,2409,2423,14,8,8,0,0,100,NoArch
078cde25dd55be6a57476ed438bb21d4f64dbfcf,1,65,67,2,0,0,0,3,10,5,1,1,0,680,23,10,95,95,0,3520,3546,26,11,11,0,0,100,NoArch
4c96b79ae7196ba48c36c8ae59018f061b91e9ee,2,210,0,210,2,0,2,1,1,0,1,1,0.822404226,0,24,11,13,0,13,566,0,566,6,0,6,1,97.7443609,Arch
0c98400219fa906e1daf9e49fc35fc8d080df1e3,1,1,1,0,0,0,0,6,20,119,1,1,0,180,1,1,16,16,0,1305,1305,0,3,3,0,1,100,NoArch
bd927c9fa965fcdca99cc0f525b3f3e439fbbe66,29,2819,0,2819,29,0,29,1,3,48,2,6,4.516142734,0,25,12,245,0,245,12705,0,12705,143,0,143,1,96.54403567,Arch
4f16e3cbfee813278904f38b50011b4ea4f90bc4,0,0,0,0,0,0,0,0,0,0,0,0,0,0,26,13,0,0,0,0,0,0,0,0,0,1,100,NoArch
d17537375235e0124eeb5ce7de5d3818c39113a3,2,8,1,7,0,0,0,1,2,0,1,2,0.99107606,164,27,14,18,17,1,973,925,48,6,5,1,1,100,NoArch
b1dd03663c549c191d2aa61b80f0af5e5978d542,23,195,135,60,0,0,0,1,4,0,1,4,2.87838294,2165,28,13,196,193,3,9142,8877,265,116,115,1,0,99.01026393,NoArch
a179dc4d2e98b819e992d36ae6bf2b6563d705af,4,50,6,44,0,0,0,1,5,0,1,1,1.987442359,589,29,14,83,77,6,2582,2337,245,52,49,3,0,100,NoArch
79eb25360468283e525e6730a6f52b31008dd29f,0,0,0,0,0,0,0,0,0,0,0,0,0,0,30,15,0,0,0,0,0,0,0,0,0,0,100,NoArch
515bac41819e209190a53c8f6b1de1db25dee575,164,1304,4011,2707,0,6,6,4,68,144,4,73,5.497529278,45862,567,12,5248,5531,283,213873,224210,10337,1960,2038,78,0,99.55686854,NoArch
4a711cfb5c37680a6d606aec658fed1381b6180f,1,0,132,132,0,1,1,5,26,0,1,1,0,132,107,0,0,13,13,0,440,440,0,13,13,0,99.17417417,NoArch
11b9d84cf2b148c97420ca0ca899cb1cec2ed354,6,33,35,2,0,0,0,6,69,9,1,6,2.391480833,3049,108,1,193,193,0,15546,15594,48,72,72,0,1,100,NoArch
fedfd0cbb41f0e28cf59d10e4178bbd273be4ef8,2,5,0,5,0,0,0,1,2,0,1,1,0.970950594,159,31,16,9,9,0,1166,1126,40,6,6,0,0,100,NoArch
f13030431a0c1ab2a9ce434a932a96104108000e,11,314,320,6,3,3,6,2,41,24,1,7,3.193079834,1623,2,2,113,118,5,9165,9191,26,42,46,4,1,96.7922417,Arch
f443e7f5dc9263766ae2202334437e5ef82a7d4a,2,14,8,6,0,0,0,3,42,0,1,2,1,493,3,3,27,27,0,3149,3131,18,5,5,0,1,100,NoArch
70fa8025a59acb5fb90fb6c0195a8b94e11cf8a1,22,250,208,42,0,0,0,2,12,81,2,11,3.743189552,3717,568,13,426,423,3,22541,22232,309,149,147,2,0,99.94488334,NoArch
13c4f5083258b848dbd74ff38b44f8f67ccd24a1,0,0,0,0,0,0,0,0,0,0,0,0,0,0,34,6,0,0,0,0,0,0,0,0,0,1,100,NoArch
81f2e6b500fa68a3c944d19a7bdde025159f98e5,4,6,3,3,0,0,0,5,13,0,2,3,1.974937501,1288,32,17,217,217,0,6335,6331,4,51,51,0,0,100,NoArch
75613c4e6646dbaa810abd434b42b082a8306d90,1,0,1,1,0,0,0,5,14,0,1,1,0,1066,33,18,204,204,0,5020,5027,7,42,42,0,0,100,NoArch
721d1fe2b238870b85745ee5fbc0601f152f763b,1,7,0,7,0,0,0,1,3,3,1,1,0,65,34,19,8,8,0,363,363,0,4,4,0,0,100,NoArch
292bb9dcc3cc8d4a6b0f311c6d0afb7232d4b9c8,5,439,0,439,5,0,5,1,1,0,1,2,1.971096667,0,35,20,43,0,43,1934,0,1934,25,0,25,0,99.79820216,NoArch
adcc8ada4e2f4d028f53c3dc8210ecdede323a27,2,5,0,5,0,0,0,2,5,0,1,1,0.970950594,159,36,21,9,9,0,1149,1119,30,6,6,0,0,100,NoArch
4af55522253a9f5d0b25923b4f72ab3e13fbb88b,1,2,2,0,0,0,0,2,6,0,1,1,0,67,37,22,2,2,0,326,328,2,2,2,0,0,100,NoArch
4b66c38229fcb479a44bc67bd38d51f0dddef2ee,1,2,2,0,0,0,0,1,2,0,1,1,0,44,38,23,4,4,0,235,234,1,1,1,0,0,100,NoArch
2d40bd6ebeca444f414775e4456275ad5e11044e,1,0,2,2,0,0,0,1,2,0,1,1,0,139,39,24,15,15,0,782,812,30,5,5,0,0,100,NoArch
03424784c070b28b3e6ec3fcc1fab1163d1decf3,50,738,584,154,3,0,3,2,70,34,3,20,4.888589089,10103,109,2,949,929,20,61169,59861,1308,447,430,17,1,98.68468468,NoArch
3bc895ff8672f6f3d00f34a5a66385fad3f7d96a,2,12,3,9,0,0,0,1,3,0,1,2,0.836640742,181,40,25,20,19,1,1054,1017,37,7,6,1,0,100,NoArch
a351fdf2624f25acbdbde1c338551e5f74458e31,4,61,15,46,1,0,1,1,5,2,1,2,1.6100375,453,41,26,67,60,7,2116,1828,288,47,41,6,0,99.92907801,NoArch
115fec691bb1c36047ea24e79bce5befb449c78d,2,117,5,112,1,0,1,1,2,0,1,2,0.955931264,8,42,27,14,0,14,816,14,802,5,0,5,0,99.85848222,NoArch
4b25f31b1c616ca86438e0690c5f411c852f2156,13,556,177,379,3,2,5,1,7,0,1,5,2.977396136,1108,43,28,174,128,46,6333,4613,1720,102,82,20,0,99.66419229,NoArch
ae086da2e70abb2c89d17f9bd9f8d5343b9cbaaa,1,1,1,0,0,0,0,1,2,0,1,1,0,121,44,29,21,21,0,1019,1013,6,3,3,0,1,100,NoArch
ec393c0090f12d8ddc93b3934efe0a5dbd754281,1,6,2,4,0,0,0,1,4,0,1,1,0,194,45,30,25,23,2,771,751,20,17,17,0,0,100,NoArch
090e1886c7468c87796f92b4a6d021218e8dcd6d,1,1,1,0,0,0,0,1,5,0,1,1,0,198,46,31,25,25,0,771,771,0,17,17,0,1,100,NoArch
fed7d6133df15b27c2d210a784f4a0cbea7c9dda,40,636,426,210,3,0,3,3,54,26,3,8,4.21708207,5917,110,3,551,526,25,33115,32205,910,341,325,16,1,99.34721242,NoArch
c7435d3f96caaa1cdd857d608cbc44d50a44193b,1,82,0,82,1,0,1,1,1,0,1,1,0,0,47,32,7,0,7,312,0,312,6,0,6,0,99.80620155,NoArch
407cfd34e013919fc5bf975fd20c1b29f18b9416,2,70,53,17,0,0,0,1,3,2,1,1,0.695136099,240,48,33,22,22,0,846,783,63,15,16,1,0,100,NoArch
d3ace90fb457097c769ba996cb845395ff628d01,2,35,6,29,0,0,0,1,3,2,1,2,0.281193796,341,49,34,53,49,4,2048,1964,84,27,23,4,1,100,NoArch
489a1c27f13e384b973499498902605d60ee280a,1,1,1,0,0,0,0,1,6,1,1,1,0,198,50,35,25,25,0,771,771,0,17,17,0,0,100,NoArch
555cc737089c6d6be5d390a0928464d28bee4cef,25,571,418,153,2,1,3,3,55,0,3,9,3.709759087,4278,111,4,386,363,23,28125,25145,2980,242,222,20,1,99.32671864,NoArch
b9469ab3e6d65575357c68cddc4e0ca889b51ccf,6,70,77,7,0,0,0,6,34,0,2,5,2.169663474,1129,112,5,101,103,2,6220,6114,106,60,61,1,1,99.55516014,NoArch
e2fa1e0b2f8736072c879c6bde722125d759d91a,1,2,0,2,0,0,0,4,68,20,1,1,0,742,569,14,113,113,0,3279,3271,8,36,36,0,0,100,NoArch
f13833ee202321d2121f2f26cd27e7f3289046f1,1,12,8,4,0,0,0,4,11,29,1,1,0,43,35,6,3,2,1,153,119,34,1,1,0,1,100,NoArch
20fbf4d2216b0c0dc8abd4ae7df4e4cacb3e2c25,1,1,2,1,0,0,0,4,25,170,1,1,0,329,348,0,22,22,0,1656,1661,5,9,9,0,1,100,NoArch
34d576e43ada185f877e118663ca28cffb0991ba,0,0,0,0,0,0,0,0,0,0,0,0,0,0,51,33,0,0,0,0,0,0,0,0,0,1,100,NoArch
7aa6232663fa2ad6d4b2ec536bed27097b3e1c6b,5,1011,0,1011,5,0,5,1,3,105,2,2,2.122844809,0,52,33,110,0,110,5124,0,5124,49,0,49,1,99.64614296,NoArch
d84e4c0afad28a72a4d5505b8d3dc12e0454bab0,3,11,10,1,0,0,0,1,4,9,1,3,0.453716339,299,53,32,38,38,0,1836,1844,8,9,9,0,1,99.85925405,NoArch
52bbdd2d32ee2440f7884b95a10a85ee5c9172ac,1,9,9,0,0,0,0,4,15,35,1,1,0,172,349,1,13,13,0,943,942,1,11,11,0,1,100,NoArch
6fca24e9cfd2baef20e2c6fb3b15cc331e458056,7,56,36,20,0,0,0,5,15,30,2,5,1.887110631,1844,570,3,290,290,0,8353,8298,55,97,97,0,0,100,NoArch
c1a418840ba418ac6691d398ab7f3f65752f6f3f,47,458,417,41,0,0,0,3,71,137,4,37,4.431170661,10738,571,4,909,916,7,59678,59853,175,387,390,3,0,99.94722955,NoArch
5528154cb7636e474428d77639b8286ccf29ca33,1,17,10,7,0,0,0,2,4,0,1,1,0,77,54,26,7,5,2,323,243,80,6,4,2,1,100,NoArch
d457f73f1b2fd165c574213523b0e323ee54795a,2,75,19,56,1,0,1,1,5,0,1,2,0.973385435,84,55,27,8,7,1,626,323,303,7,6,1,1,99.84243697,NoArch
669b7ed603312b6bfafa3c7372f7c8c378f06f15,1,6,3,3,0,0,0,2,6,0,1,1,0,84,56,28,8,7,1,345,327,18,6,6,0,1,100,NoArch
c96fa1426e231d48b8e45cc84a862920f9173784,9,157,52,105,0,0,0,1,7,23,1,2,2.777429412,706,57,29,73,56,17,3062,2340,722,56,40,16,1,99.84268485,NoArch
7c6f529b41ad78f6a37107372a7331644cf2aedf,6,58,39,19,0,0,0,1,8,0,1,2,1.991754147,613,58,30,60,55,5,2539,2409,130,43,40,3,1,99.96490612,NoArch
f02c4bc7ed3b8dbff4864949b3370abf54f34428,8,64,54,10,0,0,0,2,9,0,1,1,2.556128554,748,59,31,72,75,3,2565,2652,87,53,56,3,1,99.96490612,NoArch
cce95dafcb40da1d0163a1ca1e01f8630cf3343d,2,5,5,0,0,0,0,2,6,18,1,2,0.721928095,162,60,32,8,8,0,863,856,7,8,8,0,1,100,NoArch
a8b77cbd6b9676ed3ec21957e4c901654e54bd02,1,5,3,2,0,0,0,2,10,0,1,1,0,92,61,33,10,10,0,357,348,9,7,7,0,1,100,NoArch
913d44d9a87032b24b33b29d443ff0d26ab4adf0,7,280,50,230,0,0,0,1,8,21,1,3,2.342464255,1282,62,30,214,157,57,5961,5138,823,151,94,57,1,100,NoArch
a704e1731bd11c63cc4de416073a97b54ccb9fa2,3,565,0,565,2,0,2,1,5,2,1,2,1.108742578,122,63,31,75,21,54,5372,1000,4372,37,3,34,1,99.04224389,NoArch
1bc1c14590ba8cac8eb7d2f92a46f5f400e04f73,2,126,26,100,1,0,1,1,2,387,1,2,0.963600478,72,64,24,21,10,11,792,260,532,13,8,5,1,99.94993324,NoArch
0bff67012bf4fcb83a5c47d1cc07a953d512a9f3,6,238,56,182,2,0,2,1,6,153,1,2,2.130385042,350,65,25,53,41,12,2622,1415,1207,30,28,2,1,99.91663888,NoArch
f747b5132626acbb320b5a384485693d522e3d2b,1,1,1,0,0,0,0,1,6,3,1,1,0,139,66,26,21,21,0,1000,1000,0,3,3,0,1,100,NoArch
22726e80d48f13e5f46ba3a0f9576e407bb7c466,40,300,308,8,0,0,0,1,8,198,3,10,4.714688936,9443,67,27,1103,1117,14,40258,40271,13,346,359,13,1,99.76670555,NoArch
018a14c838427581ad2126e601c470ead811b984,9,40,12,28,0,0,0,1,8,12,1,2,2.886733953,1324,68,28,152,148,4,5862,5792,70,50,46,4,1,99.86668889,NoArch
d32f30aa0ca389f31b48067381061636e27cb5ea,1,1,2,1,0,0,0,1,3,0,1,1,0,78,69,29,6,6,0,486,503,17,4,4,0,1,99.98333889,NoArch
1ead75a2ca54aae059619e9b0c033533fdda4ef2,1,1,2,1,0,0,0,1,4,0,1,1,0,99,70,30,13,13,0,667,684,17,7,7,0,1,99.85009993,NoArch
c0c8d9f64563d092506407f49addff96846a04cb,79,458,11658,11200,0,39,39,4,47,176,4,27,5.178576396,24447,572,3,1627,2821,1194,59912,100316,40404,526,939,413,0,94.08159974,Arch
ff79ff48c3a7228dc7ea89f917b2e9db87048728,222,2780,2245,535,2,0,2,5,57,298,4,68,6.823665687,28621,573,4,2273,2376,103,189448,188349,1099,1219,1237,18,0,91.55979203,Arch
ed18cb307e2df855efc1d6c5ffcb03251f94bfc9,2,11,2,9,0,0,0,4,19,0,1,2,0.391243564,659,36,1,53,53,0,3638,3613,25,19,19,0,0,100,NoArch
9b2c7aa28ed4e3afe1e8b74ce3f8266dc7927915,2,111,1,110,0,0,0,3,18,42,2,2,0.301378644,557,113,2,67,62,5,4252,3319,933,40,38,2,1,98.82011605,NoArch
f84ab255d5014c9f477c1197e5a9cb35d522c79f,1,12,1,11,0,0,0,2,2,4,1,1,0,127,574,5,21,20,1,472,410,62,17,17,0,0,100,NoArch
2b8d5e455e14cf7722846acbe89221a6cbdb166d,7,50,16,34,0,0,0,2,31,204,1,4,2.613104743,1354,575,6,146,144,2,5336,5310,26,73,71,2,0,100,NoArch
b840d2f12b7cc46c891ecbb85a7e9ca8b69f5774,1,12,1,11,0,0,0,2,6,3,1,1,0,92,71,20,15,13,2,785,639,146,8,7,1,1,100,NoArch
c62fe141e409d107a2d2b3cbed6840117763c780,5,24,19,5,0,0,0,2,12,0,1,2,1.673411449,1803,72,21,311,311,0,13990,13974,16,164,164,0,0,100,NoArch
235098da699bf57e013183f30447f9c0c89058e0,4,5,5,0,0,0,0,4,13,0,1,1,1.921928095,1735,73,22,305,305,0,13528,13518,10,160,160,0,0,100,NoArch
10afd75e2db4339c3185f09cabd19887fa91e4fc,1,8,14,6,0,0,0,2,49,67,1,1,0,885,576,7,96,96,0,4287,4301,14,41,41,0,0,100,NoArch
705828f78799f586d5539b87307d7dc4031ffef1,1,12,14,2,0,0,0,5,20,5,1,1,0,127,577,8,11,11,0,727,754,27,6,6,0,0,100,NoArch
75845af558f3ae0607336a17ff491265e0315aec,1,114,92,22,0,0,0,5,15,303,1,1,0,238,37,2,21,22,1,2048,2038,10,3,3,0,0,100,NoArch
7e75b29b73839c8164a4584918226c0855fa78a1,1,1,1,0,0,0,0,5,16,0,1,1,0,260,38,3,21,21,0,2048,2048,0,3,3,0,0,100,NoArch
170284d12c82dc305df9414d839d5d8434387021,0,0,0,0,0,0,0,0,0,0,0,0,0,0,52,0,0,0,0,0,0,0,0,0,0,1,100,NoArch
75a2a7068dcaeb14568d52f3554babb3b0289ebf,0,0,0,0,0,0,0,0,0,0,0,0,0,0,53,1,0,0,0,0,0,0,0,0,0,1,100,NoArch
8a99d7561228883cfddcda43428053cd78611b11,99,864,875,11,0,1,1,4,72,14,4,45,5.42077486,23535,578,8,2553,2554,1,120804,121517,713,974,973,1,0,99.30528753,NoArch
f1ca6dee7fd0ce189b250eaf01b475847c19ffda,0,0,0,0,0,0,0,0,0,0,0,0,0,0,54,2,0,0,0,0,0,0,0,0,0,0,100,NoArch
5352ea2dbe1b21da0873c4ccf34b92e1840dd4d7,4,264,11,253,2,0,2,2,43,18,1,2,1.839124443,1045,4,0,78,62,16,7827,6491,1336,33,27,6,1,99.92266048,NoArch
758dc915161008d81183cf7b42a0e50985f517ba,3,167,2,165,2,0,2,2,3,4,1,1,1.055743984,138,74,23,34,21,13,858,472,386,20,17,3,0,99.82622128,NoArch
d61aa504fbc7dafef58048b007d30cb081592b7d,1,2,2,0,0,0,0,2,9,23,1,1,0,286,75,24,37,37,0,1104,1104,0,22,22,0,1,100,NoArch
6c34155d2c5f2eb4188a772215bd8f080d75e870,1,196,0,196,1,0,1,1,1,0,1,1,0,0,76,25,21,0,21,575,0,575,13,0,13,1,99.96141975,NoArch
b60177d7e2ef6a15a23ab301d4c2ff6516baf963,1,33,6,27,0,0,0,2,7,18,1,1,0,106,77,26,14,12,2,483,441,42,9,7,2,1,100,NoArch
2ce6410a48f54137afe140cca6b5b4007593cc4f,2,4,1,3,0,0,0,2,10,14,1,1,0.970950594,414,78,27,38,38,0,3271,3207,64,12,12,0,0,100,NoArch
451dc8c2b9b5b348b32a64161ab111d6aa2909d2,1,4,1,3,0,0,0,2,8,3,1,1,0,232,79,28,45,45,0,1039,1027,12,32,32,0,0,100,NoArch
2c6fc0bbebb249dd1954b428b2c1a5238f57f050,1,4,2,2,0,0,0,2,9,0,1,1,0,235,80,29,46,45,1,1056,1039,17,32,32,0,0,100,NoArch
93ddcf8bc21ca37bc76b8bf5857a602b0bc9c0c0,1,15,4,11,0,0,0,2,5,23,1,1,0,334,81,30,50,49,1,1312,1284,28,41,41,0,0,100,NoArch
ee62ea239c82953f563b8163b0271d6ad0233278,2,21,32,11,0,0,0,3,10,1,2,2,0.313812964,652,82,31,102,103,1,3318,3382,64,42,43,1,0,100,NoArch
7be2356a7b44ff6a67ffa158525b41addd02a626,8,63,69,6,0,0,0,4,18,61,1,2,2.554759642,2409,83,32,413,415,2,12954,12987,33,185,188,3,1,100,NoArch
1d54c24c1a139e9a2fd4d206a136201a1e106865,1,0,2,2,0,0,0,2,7,16,1,1,0,63,84,33,4,4,0,247,256,9,1,1,0,0,100,NoArch
96b7f9b53dd85ff206c89011c917961b61964b77,1,4,2,2,0,0,0,2,8,0,1,1,0,61,85,34,4,4,0,232,247,15,1,1,0,0,100,NoArch
3686970f586cff8a52e9ab73650540b2ee57e80f,1,2,0,2,0,0,0,2,6,0,1,1,0,345,86,35,50,50,0,1312,1312,0,41,41,0,0,100,NoArch
5ce59923464550a51f4dd8f7cea50cfaba228844,34,356,849,493,0,1,1,4,44,54,4,18,3.576633579,12424,579,9,1618,1688,70,57392,59527,2135,501,514,13,0,99.7689197,NoArch
88848aef092c49122f58e1ae898cb21db61ed8a7,2,69,3,66,1,0,1,1,6,77,1,2,0.581321499,245,87,35,36,32,4,1460,998,462,13,11,2,0,99.88468191,NoArch
894b64695337ed467a5c7038f2b89f1e11b709f0,1,12,2,10,0,0,0,4,7,73,1,1,0,99,88,36,9,9,0,290,290,0,4,4,0,0,100,NoArch
a1dd99275fd93488e01439fa2a1c7d75d8d5b15d,2,18,1,17,0,0,0,4,18,57,1,1,0.485460761,499,350,0,55,54,1,2199,2043,156,24,23,1,0,100,NoArch
2ca68e8b9e154e03f6f081f1ef726760e3905b63,16,37,41,4,0,0,0,5,50,49,2,12,3.539788081,5031,114,1,531,531,0,29650,29727,77,203,203,0,0,98.5106383,NoArch
dd2619f81b656b741a13f3d627044d3a4356fb8d,2,95,48,47,0,0,0,3,20,18,2,2,0.462309904,551,115,2,42,39,3,4296,4087,209,21,20,1,1,100,NoArch
64301883acca71df44f307f5c281639839c62818,69,400,845,445,0,2,2,3,58,86,4,39,4.828413956,20943,580,8,2206,2262,56,94379,96554,2175,772,791,19,0,99.92202729,NoArch
6510938993147374125229bf833dc676a5aeae84,4,274,86,188,1,0,1,3,22,12,2,3,1.687846952,795,116,3,66,55,11,6768,5233,1535,36,32,4,1,97.45036979,Arch
1e923edde6f7bf16d5ab177377cbf38afccaebe8,5,120,7,113,1,0,1,2,11,27,1,3,1.515967871,729,89,25,114,101,13,3448,2839,609,71,63,8,0,99.88365329,NoArch
04a4b3d4236b3e083c5778f833a01fc3cc130803,1,75,35,40,0,0,0,1,2,0,1,1,0,86,90,26,15,8,7,651,478,173,8,4,4,0,99.40692558,NoArch
0ada0cb8bd89217d4c995b566627df47db8b1486,1,1,1,0,0,0,0,4,12,85,1,1,0,255,91,27,43,43,0,1087,1087,0,28,28,0,0,100,NoArch
e763bdfd3cb5077c9359536966b9b1925ae4772f,1,0,14,14,0,0,0,1,3,0,1,1,0,126,92,28,15,15,0,507,651,144,8,8,0,0,99.32988704,NoArch
af1c02cce14cad4ad8f390e1f21272be06af8cc7,1,17,4,13,0,0,0,1,4,1,1,1,0,112,93,29,17,15,2,614,507,107,8,8,0,0,100,NoArch
8f6bd9e072c960958f09200221888570c4ec7c2c,1,4,4,0,0,0,0,2,28,331,1,1,0,438,581,9,65,65,0,2300,2304,4,19,19,0,0,100,NoArch
878d80f99e8d9c2c43828a1fec476026a628e766,1,31,18,13,0,0,0,2,25,334,1,1,0,298,582,10,45,45,0,1874,1792,82,15,15,0,0,100,NoArch
6680267723a56fab773f61834ba99a84fb707d0e,1,2,1,1,0,0,0,2,12,334,1,1,0,67,583,10,5,5,0,335,319,16,4,4,0,0,100,NoArch
7865230994fb76084e7d5db80b840c5bd308f589,2,21,21,0,0,0,0,2,29,168,1,1,0.998363673,942,584,11,148,148,0,4883,4891,8,41,43,2,0,100,NoArch
fbf804bb0c294c9d06869a30c7baa1ebd5a77cad,16,345,87,258,3,0,3,2,12,26,1,2,3.431121261,1252,94,23,141,109,32,6091,4969,1122,99,79,20,0,99.45694337,NoArch
fa5ca4a8fca3e8aa83478763470a585b19bcf4fb,1,36,10,26,0,0,0,2,11,7,1,1,0,288,95,24,41,38,3,1180,1114,66,25,23,2,0,100,NoArch
0687a7a26061e0965882ca694dfec1ef583d225b,1,0,1,1,0,0,0,2,8,30,1,1,0,124,96,25,12,12,0,392,392,0,11,11,0,0,100,NoArch
ffc9d6a3fec99aedea4d710d23d56fdcaa59635f,1,3,10,7,0,0,0,2,7,20,1,1,0,249,97,26,31,32,1,1025,1038,13,10,11,1,0,100,NoArch
013d0eb78b795ced6f6b4efe63c36f5df5a35e2a,1,90,14,76,0,0,0,2,5,0,1,1,0,44,98,27,11,2,9,678,203,475,7,2,5,1,99.53506393,NoArch
8b9a6bf7d767b0933d6ebbde594f1f88b351e281,1,2,2,0,0,0,0,1,3,50,1,1,0,118,99,28,15,15,0,538,540,2,5,5,0,0,100,NoArch
a5994378c57bb9a6ecc7c67810ed898a94cd47dc,1,2,1,1,0,0,0,2,6,0,1,1,0,72,100,29,7,7,0,245,232,13,5,5,0,0,100,NoArch
b5d873b2fc1df325fefe8bd4651660d6ed322426,2,5,1,4,0,0,0,2,9,0,1,1,0.918295834,405,101,30,42,41,1,1399,1397,2,29,28,1,0,100,NoArch
8a51eb432fbf8f7080ceec249f54ebca39c33a2b,1,5,0,5,0,0,0,2,8,0,1,1,0,96,102,31,8,7,1,853,815,38,4,4,0,0,100,NoArch
7a57c515e4a42967d8cee6b72b82fad6ef5125d3,1,2,1,1,0,0,0,2,9,0,1,1,0,67,103,32,2,2,0,360,342,18,2,2,0,0,100,NoArch
7ab7df7b40bbe936c9d095f50320f73292dd09f7,1,3,3,0,0,0,0,2,4,42,1,1,0,193,104,33,15,15,0,1555,1544,11,9,9,0,0,100,NoArch
e81fe138735d132b61a647a693bf16eaa83deeb0,2,25,19,6,0,0,0,2,9,0,1,2,0.510787823,174,105,34,15,15,0,1071,1059,12,9,9,0,0,100,NoArch
d24b3031e677324494409f114ed662f292d04cb1,2,2,3,1,0,0,0,2,9,48,1,2,0.970950594,129,106,35,7,7,0,402,402,0,5,5,0,0,100,NoArch
66e63a120beeb61dea873e698a488ee44fb4a317,3,23,9,14,0,0,0,2,10,0,1,2,0.946686087,477,107,36,45,44,1,1766,1759,7,32,31,1,0,100,NoArch
2b9294068a004b97dccfeb41c16a4c76e09f6afd,1,37,1,36,0,0,0,2,9,107,1,1,0,243,585,10,52,39,13,1179,985,194,19,18,1,0,100,NoArch
bf7cb962c6aff6c6b1f8bc3190245949604ad519,3,45,14,31,0,0,0,3,11,130,2,2,0.959298443,865,108,34,106,103,3,4574,4412,162,39,38,1,1,100,NoArch
41acc3f8ba9fae40948dfb7687dad80bea36a607,1,14,0,14,0,0,0,1,5,11,1,1,0,125,109,35,17,17,0,614,614,0,8,8,0,1,100,NoArch
42b989b0104ff75d10a89ebe69bc8822778b611c,2,14,1,13,0,0,0,1,8,43,1,2,0.721928095,517,110,36,70,67,3,2014,1939,75,53,51,2,0,100,NoArch
20a43c49986dd721eb23d4fbc6efb633b50b8011,1,1,1,0,0,0,0,2,7,7,1,1,0,58,111,37,7,7,0,210,215,5,5,5,0,0,100,NoArch
68de812e21943b3a2cc34ce23e6cac65cb1c7605,1,1,1,0,0,0,0,2,10,6,1,1,0,278,112,38,28,28,0,885,881,4,20,20,0,0,100,NoArch
e236ae93e6c025ef3d8de7f0fb6668d7337efba4,2,30,1,29,0,0,0,7,25,38,1,2,0.345117315,142,117,3,17,17,0,867,867,0,7,7,0,0,100,NoArch
6ab620d9f672b43fcb08ab0a20447bcb495d2f52,1,1,1,0,0,0,0,1,6,2,1,1,0,184,113,39,20,20,0,713,710,3,12,12,0,0,100,NoArch
b553e02f3bcda293d761b1f76009bc48caa3a0f3,1,23,1,22,0,0,0,2,9,2,1,1,0,346,114,40,53,50,3,1419,1304,115,42,41,1,0,100,NoArch
a87bed8d606a707f401371558467bd54feaa0c26,2,18,4,14,0,0,0,2,12,8,1,1,0.845350937,614,115,41,104,101,3,2628,2552,76,77,75,2,0,100,NoArch
8b6f5d72d89ed19d94cb01da1a6161451780ca98,1,276,0,276,1,0,1,1,1,0,1,1,0,0,116,42,28,0,28,1915,0,1915,5,0,5,0,98.39799267,NoArch
23e751fc5d60385c85f1a7d410f493c43e8c9c6f,2,78,42,36,0,0,0,2,4,33,1,2,0.783776947,179,117,43,20,17,3,1159,836,323,5,6,1,0,99.8844376,NoArch
51e2486689dc8427ed8291a6faddd5a8c755a43e,1,18,0,18,0,0,0,1,2,3,1,1,0,276,118,44,28,28,0,1922,1915,7,5,5,0,0,100,NoArch
ef7b7682a4ae4465fc9472f0921dd96d715ee32d,1,5,0,5,0,0,0,2,11,3,1,1,0,368,119,45,54,53,1,1447,1419,28,43,42,1,0,100,NoArch
9cfe290fe0781002a8011111cd2b644f3e796c33,2,14,6,8,0,0,0,1,12,0,2,1,0.468995594,667,120,46,84,82,2,3396,3369,27,49,48,1,0,100,NoArch
9a5b4611d14559b1c8738cf65f5694dbebde594f,1,2,1,1,0,0,0,1,4,0,1,1,0,294,121,47,28,28,0,1925,1922,3,5,5,0,0,100,NoArch
24a75dbf158c935ba74245adb15add4caf6c923c,1,14,5,9,0,0,0,1,5,0,1,1,0,295,122,48,28,28,0,1924,1925,1,5,5,0,0,100,NoArch
3181b4bb3f2eab7e5bb3e5a7db2bfa61642f4d15,0,0,0,0,0,0,0,0,0,0,0,0,0,0,39,0,0,0,0,0,0,0,0,0,0,1,100,NoArch
8267c5b6f67a263028672e5a7ac2849b0479d9eb,3,83,34,49,0,0,0,2,18,32,1,2,1.23631484,592,118,4,75,68,7,4467,3927,540,28,25,3,0,100,NoArch
d4b792442e4be3da8acd009f90c55b761437906e,2,90,0,90,1,0,1,1,6,22,1,2,0.503258335,304,123,39,32,27,5,2457,1879,578,13,10,3,1,99.9614792,NoArch
86306e5d6cad056c6f64b29d16d5ba655bffb9a7,2,10,4,6,0,0,0,2,5,0,1,2,0.863120569,215,124,39,21,20,1,1189,1159,30,6,5,1,0,100,NoArch
6a4a189231a75ba32ad63cb67609a949f703934e,3,10,5,5,0,0,0,2,11,9,1,1,1.103307409,409,125,39,43,42,1,1368,1340,28,30,30,0,0,100,NoArch
e6b4e352c4d9ce41908a5c67d325fb430b2fd44e,10,355,161,194,2,0,2,2,13,14,2,4,2.693793957,1759,126,39,251,229,22,10902,10063,839,144,131,13,0,99.86535872,NoArch
b50007094b3b817e9a5119af83c93d73093321b1,2,46,2,44,0,0,0,2,6,0,1,2,0.968461009,598,127,40,57,54,3,4771,4495,276,36,34,2,0,100,NoArch
48840c1fe40e8f66ecc0b23a2ed51e4f162b1915,20,733,868,135,0,0,0,2,73,47,3,18,3.61042656,6503,119,5,449,456,7,41913,42426,513,189,193,4,1,99.78882703,NoArch
001b04d44c193533a24b868159bab20e3379692a,5,37,27,10,0,0,0,2,31,60,2,3,1.07121226,998,120,6,114,113,1,4601,4567,34,67,67,0,0,100,NoArch
5606a0d2b3bbf8996fa6e9e36aa1ab5f60199a77,1,0,3,3,0,0,0,2,12,0,1,1,0,133,121,7,19,20,1,876,892,16,5,5,0,0,100,NoArch
763db667457934e7b465ec661d0acb9a97133335,3,42,15,27,0,0,0,4,19,45,1,1,1.188157128,1239,128,41,185,183,2,5371,5271,100,78,76,2,0,100,NoArch
c93818ef801be7bc45e3ded82e13919cafa0643d,1,11,18,7,0,0,0,1,6,5,1,1,0,304,129,42,27,28,1,1851,1924,73,5,5,0,0,100,NoArch
3fc2024c83a1575a8c28b82d5ec918044b86f20a,1,2,5,3,0,0,0,2,26,23,1,1,0,311,586,6,44,45,1,1863,1874,11,15,15,0,0,100,NoArch
27d33a2f42fcb583e78699a1659644e83ca93188,12,2789,0,2789,12,0,12,1,1,0,2,2,3.260766286,0,30,0,312,0,312,14645,0,14645,87,0,87,1,98.63932898,NoArch
20276b4ade92758323e1b798bbf2bbd134c0ee2d,0,0,0,0,0,0,0,0,0,0,0,0,0,0,587,7,0,0,0,0,0,0,0,0,0,1,100,NoArch
61b5385aa74f5dc813129599bcf7e50f5a234169,1,3,0,3,0,0,0,4,6,36,1,1,0,76,588,8,4,4,0,405,392,13,4,4,0,1,100,NoArch
ad53dbea31ecfb9b0c3bb02b3e3470a4c5d5c586,1,5,1,4,0,0,0,4,18,342,1,1,0,107,589,9,11,10,1,533,511,22,5,5,0,0,100,NoArch
31d93a8ac65fb0878391d88aa2166762a28ebbf4,1,4,1,3,0,0,0,2,24,51,1,1,0,723,590,10,92,91,1,3821,3808,13,13,13,0,1,100,NoArch
1259c968fc6f0f222b5d385c44fd8104608b10d4,2,71,12,59,0,0,0,5,18,71,1,2,0.816017297,1141,591,11,119,109,10,7541,7156,385,66,64,2,1,100,NoArch
c8270dc4e72930ae4f1e993fbcfe44ddaf61e3b8,8,875,263,612,2,0,2,2,24,0,1,4,2.267849971,1377,122,8,172,125,47,14136,9667,4469,74,51,23,1,97.28232647,Arch
f900e2a6e1a5a60a76757c5a61a9024a6545bcd6,9,171,209,38,0,0,0,6,60,8,2,9,2.509018979,2651,123,9,163,160,3,14620,14656,36,68,67,1,1,100,NoArch
c4a0cb9426b7792d4365f0e419917cf85d6e5b63,7,141,194,53,0,0,0,2,50,7,3,6,1.92466236,2191,124,10,141,139,2,15188,15088,100,69,69,0,1,100,NoArch
69ad72b64c90836a20eb600fc8acf1a00743f427,1,19,17,2,0,0,0,6,45,64,1,1,0,381,125,11,43,43,0,2783,2761,22,10,10,0,0,100,NoArch
22d7d31c58adfc711986028ed0e03a07f740483f,10,321,72,249,2,0,2,1,25,83,1,7,2.47270442,1476,40,1,126,104,22,9476,8225,1251,38,27,11,1,99.30773034,NoArch
d53cf4a1ae2c94132ebb247a872e391d74389cf4,43,518,462,56,0,0,0,1,74,34,4,26,4.53270924,10364,592,12,1194,1192,2,50609,50499,110,429,427,2,0,100,NoArch
d41b3609f226d921a53b69ce834a5c0a8eb1409e,3,88,93,5,0,0,0,1,51,0,2,3,0.209156095,974,126,12,67,64,3,6914,6562,352,35,33,2,1,100,NoArch
07d3d5fe6f4c9b250c6c03a826b1cfe7d2b5f8ac,12,204,255,51,2,0,2,1,69,227,1,6,3.214767141,3057,593,13,403,420,17,14736,15056,320,142,146,4,0,99.86863711,NoArch
2ede1c0d067dca290150c3a9be28b62743dc9130,2,36,26,10,0,0,0,4,12,157,1,1,0.981152234,459,594,14,43,42,1,3499,3461,38,8,8,0,1,100,NoArch
b0695e95e7d66fd569d0cb80ec1ac9b80c20d21a,2,121,6,115,1,0,1,1,2,36,1,2,0.50062806,153,595,15,32,22,10,1400,714,686,19,12,7,0,99.93427539,NoArch
3f1450a35e058c5353004affd12f3ddd7e7327e8,46,223,215,8,0,1,1,5,47,92,5,34,4.958553254,7578,596,16,780,778,2,44714,44741,27,342,340,2,0,97.35309688,Arch
c69893b5c99758e176525dc03c9ea724a397173a,2,24,15,9,0,0,0,2,15,17,2,2,0.477071306,221,597,17,24,24,0,1581,1631,50,7,7,0,0,97.76556127,Arch
1619a3f3fb5692ac36805e18a617870989cf85ce,6,12,12,0,0,0,0,2,16,0,2,5,2.522055209,1481,598,18,199,199,0,12032,12031,1,98,98,0,0,97.76556127,Arch
f4597a2eb0eafe379f200ace797e92fc96c73786,1,1,1,0,0,0,0,2,17,0,1,1,0,108,599,19,20,20,0,676,676,0,5,5,0,0,100,NoArch
61ae2e77f725bbc71c2ed9899f8b91fd6f422242,30,221,180,41,0,0,0,5,61,49,4,19,4.139796404,6438,600,20,607,610,3,33746,33919,173,270,271,1,0,97.76556127,Arch
981b4431e6ad7f4194687ae8b758d2b1a164c101,1,1,1,0,0,0,0,6,24,196,1,1,0,74,127,11,6,6,0,348,348,0,3,3,0,1,100,NoArch
597db6a05e4e2464d26b19109d6a4ee43cc5c363,3,118,20,98,0,0,0,2,15,4,1,2,1.182823557,972,130,41,136,122,14,6311,5690,621,83,77,6,0,100,NoArch
f029d24a28c10915b49474e6b6d47809f446e5a4,1,29,14,15,0,0,0,2,9,2,1,1,0,309,131,42,29,28,1,2000,1872,128,5,6,1,0,100,NoArch
b801629db0fa2a64946917561844ba38137f04c6,2,1,4,3,0,0,0,2,12,17,1,2,0.970950594,525,132,43,56,56,0,2835,2837,2,34,34,0,0,100,NoArch
57f0c7d567fedc0828bb72cda774a1c8ace1e2a7,1,122,0,122,1,0,1,1,1,0,1,1,0,0,601,20,8,0,8,984,0,984,6,0,6,0,99.96686547,NoArch
1ce47b660e9d4605f36e8ac41681c0991a65d78f,4,165,43,122,0,0,0,2,22,8,1,3,1.782972548,982,128,11,82,71,11,8817,7897,920,46,41,5,1,100,NoArch
1bb9546ee479ee23138ccb29d5a452ade4199a07,2,141,86,55,0,0,0,2,23,3,1,2,0.727183044,664,129,12,66,69,3,4931,4957,26,25,26,1,1,100,NoArch
3c9538a43c1c02567f6018cf3bafbeadb49b7b65,16,691,222,469,4,0,4,2,75,12,2,10,2.856939335,3702,130,13,330,299,31,23181,21459,1722,127,104,23,1,97.69003932,Arch
d0dc3886420effe3c0913aa865cae4499bc15465,3,12,9,3,0,0,0,2,16,3,1,2,1.267770216,1100,133,40,126,124,2,6663,6674,11,86,86,0,0,100,NoArch
ebc739324e931b150a73dc53f60e43105378c2ed,1,11,32,21,0,0,0,1,2,0,1,1,0,113,131,14,10,10,0,302,284,18,7,7,0,1,100,NoArch
76059d43401ddeb8df1fb8e6e5677adcd3378b4f,2,3,3,0,0,0,0,1,3,0,1,2,1,208,132,15,19,19,0,955,912,43,13,13,0,1,100,NoArch
237bcbdcd40b27c1bae2d191d8b7c60bd20da72e,5,17,20,3,0,0,0,2,15,0,2,3,2.079427728,699,133,16,74,74,0,3148,3186,38,31,31,0,1,100,NoArch
28a69a00105a7f1001d4ff3f803eedbbcb8a6c2c,5,52,47,5,0,0,0,2,25,26,3,5,1.790748721,971,134,17,93,91,2,6490,6464,26,38,38,0,1,99.69165855,NoArch
58b5f28efe24232e833d116249bde23217f4f840,7,171,135,36,1,0,1,2,17,31,2,2,1.917425012,1814,134,40,236,239,3,8668,8753,85,161,162,1,0,99.37198068,NoArch
72583eb53f987abd605fce2de9d1cf8f1ac00cc7,9,21,8,13,0,0,0,1,48,5,2,7,2.701797374,1181,135,18,75,75,0,7082,7064,18,33,33,0,0,99.74457216,NoArch
48d069f4559da3870ee1e3b36df757b29b781885,27,2973,23,2950,24,0,24,1,18,4,1,7,4.518902502,828,136,19,264,90,174,19274,4203,15071,132,51,81,1,96.87086093,Arch
77c59bcdf244253cf376bac1ba7d430e46a75dd4,1,1,1,0,0,0,0,3,4,132,1,1,0,45,137,20,6,6,0,174,174,0,2,2,0,1,100,NoArch
cf76c3f875b935b68db345ccefc1636224487905,2,132,71,61,0,0,0,1,2,0,1,2,0.909865931,405,138,21,19,15,4,2667,2365,302,9,7,2,1,100,NoArch
71ecd11a54369ad8d98ec7a297899983b24ed7d8,1,1,2,1,0,0,0,1,3,0,1,1,0,228,139,22,13,13,0,1287,1293,6,6,6,0,1,100,NoArch
9608f224f5f86cf786584c9c9524b30adf14dc07,9,1121,0,1121,9,0,9,1,1,0,2,3,3.028187894,0,602,17,101,0,101,6415,0,6415,44,0,44,1,99.65729952,NoArch
049e7dc6cae23f7992aee48ec1f85d0cc133a20c,107,694,560,134,0,0,0,2,70,18,4,44,5.714024486,20041,603,18,1904,1904,0,102277,102449,172,943,938,5,0,98.34751309,NoArch
833c65998e3cf6ac33cc7068f3d689eb99e10566,2,96,63,33,0,0,0,2,5,78,1,2,0.936018616,838,41,2,112,107,5,4226,3988,238,43,42,1,1,100,NoArch
abb9151ccecf844fd9976158f68e2dfe89fe2f9d,1,7,2,5,0,0,0,5,13,147,1,1,0,144,42,3,14,14,0,688,674,14,5,5,0,1,100,NoArch
21d08d20a72f22cd2a26cd66fb983bfb9ea37d70,5,191,26,165,3,0,3,1,15,1,1,1,1.98378728,376,135,27,54,44,10,1924,1360,564,34,28,6,0,99.59087333,NoArch
4b8c8d4ae0b18e25683342d41a4950388c8bd091,10,173,31,142,0,0,0,5,27,61,2,7,2.98647348,3346,103,0,343,316,27,18092,17414,678,152,146,6,1,100,NoArch
52f677a87a11a5d84389ad34955082776b1dcf7d,1,34,28,6,0,0,0,5,25,58,1,1,0,140,604,18,19,19,0,969,871,98,3,3,0,1,100,NoArch
10d666390968cba134b31b78d6c3c99b0b6164cd,41,90,93,3,0,0,0,3,27,18,2,12,5.063304568,5553,104,1,422,422,0,30432,30669,237,161,161,0,1,96.84443042,Arch
69ba194af61508da5e286b5690d171e01ab1635e,128,815,1168,353,0,0,0,4,71,219,3,50,6.576096211,25105,605,19,2955,3229,274,114292,114261,31,1336,1336,0,1,100,NoArch
fff59db8997f9d0afe8216fe382c9c03fc3fb2e7,0,0,0,0,0,0,0,0,0,0,0,0,0,0,43,4,0,0,0,0,0,0,0,0,0,1,100,NoArch
6c9a0234c234250eab869c59e27bfdcf167723ea,0,0,0,0,0,0,0,0,0,0,0,0,0,0,44,5,0,0,0,0,0,0,0,0,0,1,100,NoArch
5a6f2711f2b1ca6be3726731cec10157357625a1,0,0,0,0,0,0,0,0,0,0,0,0,0,0,45,6,0,0,0,0,0,0,0,0,0,0,100,NoArch
bb6c61679795d2ebc5483e706a076f4f10583225,6,82,67,15,0,0,0,2,14,340,1,2,1.832562312,889,105,2,53,55,2,5594,5417,177,23,25,2,0,100,NoArch
5a7067b89828b28feeb5df964edca3d02746a15f,22,25,25,0,0,0,0,3,10,4,2,5,4.32385619,2415,106,3,218,218,0,11000,10950,50,133,133,0,1,98.79974732,NoArch
af0434f0518d9bbf53d0e22581d4591d05c9f590,1,6,6,0,0,0,0,3,8,3,1,1,0,291,107,4,26,26,0,1266,1254,12,11,11,0,1,100,NoArch
4c864912764782e54f33c0c511d4955c62e3453d,1,1,1,0,0,0,0,6,46,29,1,1,0,320,5,0,21,21,0,2089,2089,0,3,3,0,0,100,NoArch
d2c0b5ee8d401bdab705f859e07697c3e26e3901,1,1,1,0,0,0,0,6,21,84,1,1,0,69,140,22,8,8,0,392,392,0,2,2,0,1,100,NoArch
515a414a4ee0bc872621fd0af360d7669e6806a1,16,1509,0,1509,16,0,16,1,1,0,1,4,3.641301298,0,108,5,145,0,145,8089,0,8089,79,0,79,1,98.39475839,NoArch
1ab159a766ee7c0219c0bd9a5b3ee914c280fdff,1,6,9,3,0,0,0,3,6,709,1,1,0,78,606,19,4,3,1,347,343,4,2,2,0,0,100,NoArch
4a31f91b01b79b741611a300262e2eeb2fd12378,1,2,1,1,0,0,0,6,30,14,1,1,0,281,607,18,24,24,0,1772,1754,18,8,8,0,1,100,NoArch
f50b9a69bb2f072d0dced7c747cbf8f9a408f25c,7,104,102,2,0,0,0,6,76,40,1,6,2.02844176,2965,141,16,208,199,9,16313,16080,233,75,75,0,1,100,NoArch
9b6984319d93ecf5e0ea3f1b827055ad20005a8b,4,6,4,2,0,0,0,1,2,4,1,1,1.570950594,409,109,6,27,26,1,2442,2423,19,12,12,0,0,100,NoArch
595fd5ae02b98a6637f55f9b0850e995f3e34544,3,46,24,22,0,0,0,2,47,77,1,3,1.355700916,881,6,1,59,59,0,5219,5219,0,16,16,0,0,100,NoArch
f201912ac6e4f36fd6d286fc12e905f2cc4cc822,2,5,3,2,0,0,0,3,19,21,2,1,0.811278124,776,608,12,96,95,1,3877,3863,14,55,55,0,0,100,NoArch
e20c007f190de6acdae723b192290b60aeb10fb4,1,1,1,0,0,0,0,2,12,174,1,1,0,146,609,9,7,7,0,512,512,0,5,5,0,0,100,NoArch
903575e1bbd5f13d6674b872b96a3fe5dd28ba44,4,106,30,76,1,0,1,1,17,21,2,4,1.498695887,747,142,15,51,47,4,4749,4284,465,24,21,3,0,98.96721311,NoArch
48a678cc7ee0ce43532e916e51a4c30d121e2162,1,2,2,0,0,0,0,4,28,23,1,1,0,396,143,15,23,23,0,3269,3269,0,13,13,0,0,100,NoArch
16d172e920ea94ca73aa5aeaae47067cdec52be1,1,1,1,0,0,0,0,4,18,4,1,1,0,305,144,16,26,26,0,1620,1620,0,12,12,0,1,100,NoArch
d4997623f55762409880a2a94bfb211c998d64d0,0,0,0,0,0,0,0,0,0,0,0,0,0,0,46,5,0,0,0,0,0,0,0,0,0,0,100,NoArch
fa4822bf80aeb21a5a8099e9396d661e6d3d89f7,1,1,1,0,0,0,0,3,4,48,1,1,0,81,47,6,3,3,0,540,533,7,1,1,0,0,99.95253916,NoArch
de4e1df4da6345ae766c86da63871490cd113cfb,0,0,0,0,0,0,0,0,0,0,0,0,0,0,48,7,0,0,0,0,0,0,0,0,0,0,100,NoArch
319fd82531c3bc5b8b0751fdf83b8d1d68dc4114,4,92,20,72,0,0,0,3,12,35,2,1,1.197626955,939,136,1,102,93,9,6186,5840,346,45,40,5,0,100,NoArch
38c0cb46cc4f0cf551325fec5def4de1e187bd33,1,3,3,0,0,0,0,3,10,56,1,1,0,300,137,2,30,30,0,2237,2237,0,4,4,0,1,100,NoArch
8ce9787b69ef4cba6409502b71496acd4ee838d6,1,10,1,9,0,0,0,4,12,198,1,1,0,207,351,0,40,39,1,1131,1090,41,6,6,0,1,100,NoArch
94089d639ecd312a3bb340dc06e06cb46160c753,0,0,0,0,0,0,0,0,0,0,0,0,0,0,49,8,0,0,0,0,0,0,0,0,0,0,100,NoArch
4560cd81722872c9bbcafb63c56178954a9ce0b7,0,0,0,0,0,0,0,0,0,0,0,0,0,0,7,2,0,0,0,0,0,0,0,0,0,0,100,NoArch
be0683b90b3a316d7082261821dc4f8e5095e25e,0,0,0,0,0,0,0,0,0,0,0,0,0,0,8,3,0,0,0,0,0,0,0,0,0,0,100,NoArch
fbf5509aa30f7f569608aac8e5635bde8338b645,0,0,0,0,0,0,0,0,0,0,0,0,0,0,145,5,0,0,0,0,0,0,0,0,0,0,100,NoArch
d6cd587272e8870530cdc57f58ed7d0a7ba2b212,2,4,4,0,0,0,0,3,48,18,1,2,0.811278124,549,9,4,30,30,0,3339,3339,0,5,5,0,0,100,NoArch
efb835bd259eae59ce91307ff328f12b84dbac9e,1,2,2,0,0,0,0,6,26,117,1,1,0,131,146,6,15,14,1,839,824,15,3,3,0,0,100,NoArch
4bb80404696edb20723ab8b770a3b82a6ac66abc,1,2,1,1,0,0,0,5,42,60,1,1,0,355,147,7,49,49,0,2154,2153,1,18,18,0,0,100,NoArch
88193f062d488f8d9a2bf046961affc8cea0104b,1,2,1,1,0,0,0,2,2,367,1,1,0,29,148,8,1,1,0,66,66,0,1,1,0,0,100,NoArch
42f7417ab4bc5ec9914b044dae2c35cbc29f4330,1,7,6,1,0,0,0,4,20,69,1,1,0,691,138,2,150,149,1,4012,4027,15,62,61,1,1,100,NoArch
38a69607daa70d532dfa915c01f7d70fd84be00b,3,35,17,18,0,0,0,4,16,118,1,2,1.196731843,863,139,3,145,140,5,6680,6590,90,74,74,0,1,100,NoArch
9b7802a753deb776492d1370a821fc50829ae6f6,2,315,0,315,2,0,2,1,1,0,1,2,0.443320237,0,140,4,38,0,38,1315,0,1315,22,0,22,1,99.92097361,NoArch
d94fda18195a8f78202e473d5ac174fed1a73b46,0,0,0,0,0,0,0,0,0,0,0,0,0,0,20,0,0,0,0,0,0,0,0,0,0,0,100,NoArch
b0cb378466ddeb172eff9b44ad65badc122431bb,9,16,21,5,0,0,0,2,77,33,2,9,3.047989353,3315,149,9,227,227,0,18764,18708,56,85,85,0,0,100,NoArch
cab04b8bc6859662717cacdef5f48899788341f8,1,1,1,0,0,0,0,3,7,51,1,1,0,57,110,5,6,6,0,138,138,0,6,6,0,0,100,NoArch
59143ea6e416eb0555eed568571f0398967285dd,0,0,0,0,0,0,0,0,0,0,0,0,0,0,610,4,0,0,0,0,0,0,0,0,0,0,100,NoArch
0e3e6c509f2b1b7807d7918bb09bce886cfa1940,0,0,0,0,0,0,0,0,0,0,0,0,0,0,611,5,0,0,0,0,0,0,0,0,0,0,100,NoArch
60314413d24ab8e34130ae565dd2e17fc44f7f8a,0,0,0,0,0,0,0,0,0,0,0,0,0,0,612,6,0,0,0,0,0,0,0,0,0,0,100,NoArch
3afb3eda82eb08b6c1faae9c61076c260dd20838,0,0,0,0,0,0,0,0,0,0,0,0,0,0,613,7,0,0,0,0,0,0,0,0,0,0,100,NoArch
868e831312979b00db2ef70f4d2956ff1244c380,0,0,0,0,0,0,0,0,0,0,0,0,0,0,613,7,0,0,0,0,0,0,0,0,0,0,100,NoArch
4dee1c3c540f091905a62c6d25d7961fc7785e2e,0,0,0,0,0,0,0,0,0,0,0,0,0,0,55,0,0,0,0,0,0,0,0,0,0,0,100,NoArch
b5e646be274b11c4a8cd0f4092995907236fdded,0,0,0,0,0,0,0,0,0,0,0,0,0,0,50,4,0,0,0,0,0,0,0,0,0,0,100,NoArch
e1136b9f97ad5dabf3c0251a06487d0e84eebb74,0,0,0,0,0,0,0,0,0,0,0,0,0,0,56,1,0,0,0,0,0,0,0,0,0,1,100,NoArch
270ab0b0a7b3dfab91ea51e70324baffee98e7db,0,0,0,0,0,0,0,0,0,0,0,0,0,0,57,2,0,0,0,0,0,0,0,0,0,0,100,NoArch
e149a1afd6c74b265cb64c3558adeb501716f336,0,0,0,0,0,0,0,0,0,0,0,0,0,0,58,3,0,0,0,0,0,0,0,0,0,0,100,NoArch
b0949ba773cb9dbb754d247a0aac73cbd893ee5f,0,0,0,0,0,0,0,0,0,0,0,0,0,0,59,4,0,0,0,0,0,0,0,0,0,0,100,NoArch
89c5404ac5f1ab7a7aaea10c9701d1e829a6346a,0,0,0,0,0,0,0,0,0,0,0,0,0,0,59,4,0,0,0,0,0,0,0,0,0,0,100,NoArch
834433b4982990a8eea5dc16c87e9f4cb1df2953,0,0,0,0,0,0,0,0,0,0,0,0,0,0,60,5,0,0,0,0,0,0,0,0,0,0,100,NoArch
a9e5c04062e77579f3bba7fd902266bb3b34f00e,0,0,0,0,0,0,0,0,0,0,0,0,0,0,61,6,0,0,0,0,0,0,0,0,0,0,100,NoArch
fe5c88e8885d63f9cf5794a6c2ef279ac452b37d,0,0,0,0,0,0,0,0,0,0,0,0,0,0,62,7,0,0,0,0,0,0,0,0,0,0,100,NoArch
01b48600034873ccabcdfc7a9ccbc0ca9a10d100,0,0,0,0,0,0,0,0,0,0,0,0,0,0,63,8,0,0,0,0,0,0,0,0,0,0,100,NoArch
7c514c1147fe3f725b49c4ca0f6591dd1623245b,0,0,0,0,0,0,0,0,0,0,0,0,0,0,65,10,0,0,0,0,0,0,0,0,0,0,100,NoArch
24472b1ab9f2db976c153ef140757a57c14f1978,0,0,0,0,0,0,0,0,0,0,0,0,0,0,64,9,0,0,0,0,0,0,0,0,0,0,100,NoArch
a5c0e6ba0b76f475e6604f4114ef883dfbee879f,0,0,0,0,0,0,0,0,0,0,0,0,0,0,65,10,0,0,0,0,0,0,0,0,0,0,100,NoArch
47a4094224730dee474efb03a6f45c0c605b6fbe,0,0,0,0,0,0,0,0,0,0,0,0,0,0,66,11,0,0,0,0,0,0,0,0,0,0,100,NoArch
df53a47dda7543542384286f98b3fc36bea22ed9,0,0,0,0,0,0,0,0,0,0,0,0,0,0,51,5,0,0,0,0,0,0,0,0,0,0,100,NoArch
767b996c1e222e2c5790fe7a9ddc4bf30e86b75b,0,0,0,0,0,0,0,0,0,0,0,0,0,0,67,12,0,0,0,0,0,0,0,0,0,0,100,NoArch
9ba70fa29876a94d2fc55c746fcb7c7ba2f8154e,0,0,0,0,0,0,0,0,0,0,0,0,0,0,68,13,0,0,0,0,0,0,0,0,0,0,100,NoArch
581bc60406bf2e89b03eb5c925c3466b5ae8bd50,1142,165913,0,165913,1142,0,1142,1,1,0,1,243,9.622161264,0,66,11,16547,0,16547,807604,0,807604,7641,0,7641,0,63.85696041,Arch
410d9e199e224480e5fc46df16bf2aa3e807708e,1142,0,165913,165913,2,1140,1142,0,0,0,1,243,9.622161264,165913,69,14,0,16547,16547,0,807604,807604,0,7641,7641,0,63.85696041,Arch
6e53a4d652acc3e7ffc8a1978bac8090217af68d,0,0,0,0,0,0,0,0,0,0,0,0,0,0,70,15,0,0,0,0,0,0,0,0,0,0,100,NoArch
1626b4cbe0991c15147fd8796ac0b41111642ae1,0,0,0,0,0,0,0,0,0,0,0,0,0,0,71,16,0,0,0,0,0,0,0,0,0,1,100,NoArch
b4aa90e336466d3d48f2a36cd3d58d25a3f35e58,0,0,0,0,0,0,0,0,0,0,0,0,0,0,72,17,0,0,0,0,0,0,0,0,0,0,100,NoArch
ea1c577e65d7c9d5000aa3ec3d5a2f445f43e807,0,0,0,0,0,0,0,0,0,0,0,0,0,0,73,18,0,0,0,0,0,0,0,0,0,0,100,NoArch
03eb0c2a1b804363b1fa430b6dfd8336f66c602e,0,0,0,0,0,0,0,0,0,0,0,0,0,0,74,19,0,0,0,0,0,0,0,0,0,0,100,NoArch
e5f5a3bd82dcfccc0e0a8646392840db642ce65d,0,0,0,0,0,0,0,0,0,0,0,0,0,0,75,20,0,0,0,0,0,0,0,0,0,0,100,NoArch
f4f40ac9d6ab2c1f055cd7e44111297448a21ec7,0,0,0,0,0,0,0,0,0,0,0,0,0,0,76,21,0,0,0,0,0,0,0,0,0,0,100,NoArch
e66a7bd0ed9d7a6186f1ba7feca5de817d7a58b7,0,0,0,0,0,0,0,0,0,0,0,0,0,0,77,22,0,0,0,0,0,0,0,0,0,0,100,NoArch
58f38346052516cc11eae436ee027d4a09d6f8b4,0,0,0,0,0,0,0,0,0,0,0,0,0,0,78,23,0,0,0,0,0,0,0,0,0,0,100,NoArch
02bd351e922fe054c0b723c44fae8b0a9455135f,0,0,0,0,0,0,0,0,0,0,0,0,0,0,79,24,0,0,0,0,0,0,0,0,0,0,100,NoArch
ce337a9c20c48c52c1680a4d1074a943c57c2107,0,0,0,0,0,0,0,0,0,0,0,0,0,0,83,28,0,0,0,0,0,0,0,0,0,0,100,NoArch
b0949ba773cb9dbb754d247a0aac73cbd893ee5f,0,0,0,0,0,0,0,0,0,0,0,0,0,0,59,4,0,0,0,0,0,0,0,0,0,0,100,NoArch
7c514c1147fe3f725b49c4ca0f6591dd1623245b,0,0,0,0,0,0,0,0,0,0,0,0,0,0,65,10,0,0,0,0,0,0,0,0,0,0,100,NoArch
581bc60406bf2e89b03eb5c925c3466b5ae8bd50,1142,165913,0,165913,1142,0,1142,1,1,0,1,243,9.622161264,0,66,11,16547,0,16547,807604,0,807604,7641,0,7641,0,63.85696041,Arch
ce337a9c20c48c52c1680a4d1074a943c57c2107,1142,0,165913,165913,2,1140,1142,0,0,0,1,243,9.622161264,165913,83,28,0,16547,16547,0,807604,807604,0,7641,7641,0,63.85696041,Arch
8622138425f4ebb0a1c2a03a81b31e27faf7cc9a,0,0,0,0,0,0,0,0,0,0,0,0,0,0,80,25,0,0,0,0,0,0,0,0,0,0,100,NoArch
6073bb29dfca8d40bdd65cbb833ff8ff2795af82,1,19,32,13,0,0,0,2,23,83,1,1,0,237,614,4,28,30,2,1136,1150,14,18,21,3,0,100,NoArch
ad1416331ecd86960610cc6774caa5e1bcf109bb,3,75,31,44,0,0,0,1,7,576,1,2,1.538861509,221,615,5,23,19,4,1143,842,301,18,17,1,0,100,NoArch
6cc884c4c6fbf0921424d4f895556d5d8957a337,3,108,11,97,1,0,1,3,15,231,2,3,1.208596212,450,21,0,50,43,7,3225,2651,574,12,10,2,1,99.96842438,NoArch
bb54d455599d0ccd320673380e6186bed67e8f6a,4,309,16,293,2,0,2,1,2,46,2,2,1.0663627,130,141,0,54,14,40,2035,447,1588,26,10,16,1,98.89410695,NoArch
86b3d6161c14fb63724323a1ee6802308bc6751d,1,14,3,11,0,0,0,1,2,0,1,1,0,245,142,1,36,36,0,1492,1473,19,14,14,0,1,100,NoArch
697a8d7493be7f6f7d2dc670ce66a1a3db641900,5,101,2,99,1,0,1,2,3,18,1,2,1.388517398,257,143,2,26,21,5,1631,1039,592,18,14,4,1,99.94176736,NoArch
5ea5a26a5da1fcd4436ff2cfa4d634602114269e,1,1,1,0,0,0,0,1,1,0,1,1,0,256,144,3,36,36,0,1492,1492,0,14,14,0,1,99.94179278,NoArch
9e7dbb0a8a8127331f8c3342ad3be4b56ca0ba16,3,31,8,23,0,0,0,1,17,290,1,2,1.361250403,690,616,2,117,111,6,3155,3065,90,71,71,0,0,100,NoArch
c242e523dcb20dc9585580bfc5d8b459217160fd,0,0,0,0,0,0,0,0,0,0,0,0,0,0,81,21,0,0,0,0,0,0,0,0,0,1,100,NoArch
d77c389712f1ae0d4cc082faf55699d052e52d0a,0,0,0,0,0,0,0,0,0,0,0,0,0,0,617,3,0,0,0,0,0,0,0,0,0,0,100,NoArch
939ac30b4b482bb3ae24dcf73c730dd1f9021615,68,279,241,38,0,0,0,2,78,149,1,31,4.996806226,12649,618,4,1474,1470,4,64125,64032,93,623,622,1,0,100,NoArch
8974838b108b09e45ad9d738d54b6bc6f12e0346,6,454,10,444,2,0,2,2,51,201,1,2,1.41990079,1281,619,5,140,122,18,6929,5504,1425,71,59,12,0,99.53092935,NoArch
1f5c571a14f012acb0c2ba5d44f01f4b91b68ae4,1,15,12,3,0,0,0,4,72,132,1,1,0,716,620,4,108,107,1,3234,3186,48,35,35,0,0,100,NoArch
5d90b588af177e3b468ec6b8e84dca981773858d,1,63,0,63,1,0,1,1,1,0,1,1,0,0,621,5,6,0,6,214,0,214,3,0,3,0,99.88190139,NoArch
7cf21394342f2c491605204b2c23c4c8ec6ea4da,2,9,1,8,0,0,0,3,18,529,1,2,0.721928095,213,352,0,29,27,2,1121,1094,27,16,14,2,0,100,NoArch
a59f6f8c5144f9d94b183c16ecfb72ebbf9491d8,2,24,1,23,0,0,0,5,18,140,1,2,0.634309555,1293,353,1,58,57,1,6777,6628,149,31,30,1,0,100,NoArch
54085a14150ff205860af7400628981475a7e52d,1,3,0,3,0,0,0,3,8,836,1,1,0,58,354,2,6,6,0,180,180,0,4,4,0,0,100,NoArch
a2bb4115d2d234e90ec3be9192f8b57d5a580213,1,2,0,2,0,0,0,4,10,836,1,1,0,68,355,3,9,9,0,229,229,0,5,5,0,0,100,NoArch
15c61ee24bcd381f3d34650f61a95dbe59c1a417,1,2,0,2,0,0,0,3,9,807,1,1,0,47,356,4,0,0,0,70,70,0,0,0,0,0,100,NoArch
706ffc2e9b66b7856c37cd7cefefe90c22cdf56a,1,1,1,0,0,0,0,5,20,140,1,1,0,260,357,5,21,21,0,2042,2042,0,3,3,0,0,100,NoArch
ae8259169fc77e5a04c38935e2ae2a9561f77de4,1,1,1,0,0,0,0,2,10,124,1,1,0,354,10,0,29,29,0,1880,1880,0,11,11,0,1,100,NoArch
1c761e024dcf32ec25c6296b6c52f51d87773742,1,1,3,2,0,0,0,2,9,151,1,1,0,311,150,0,47,47,0,1413,1425,12,28,28,0,0,100,NoArch
58fd277b2a697fe09cc092c0f180576de15f0aa3,57,223,197,26,0,0,0,2,79,149,4,42,5.239614676,14481,622,2,1394,1392,2,88977,88984,7,616,614,2,0,100,NoArch
07d604f2c4fdcd67dd0463e5867d01abaf420090,2,26,22,4,0,0,0,2,19,87,1,2,0.842657877,1110,11,1,80,88,8,6622,6703,81,34,33,1,1,100,NoArch
58d9bf0fdb63bfc40f13a651814e46024544b502,1,54,0,54,1,0,1,1,1,0,1,1,0,0,12,2,1,0,1,439,0,439,1,0,1,1,99.86725664,NoArch
bade960ad6b0b51335cab2ffef9702ef9affe46b,2,207,0,207,2,0,2,1,1,0,1,2,0.781281209,0,623,3,25,0,25,807,0,807,22,0,22,0,90.99610642,Arch
5e4edb71a094cbf969f5629915c2ed3b8716b6ec,1,7,0,7,0,0,0,2,16,163,1,1,0,328,624,4,45,44,1,1504,1489,15,22,21,1,0,100,NoArch
e767bb623ab4c841918ce6590f09b534f3d1ba0b,1,1,1,0,0,0,0,3,12,553,1,1,0,46,13,3,1,1,0,32,32,0,1,1,0,1,100,NoArch
a12e609eb50890998d0ecc48e57916d7fdb92ed6,1,1,1,0,0,0,0,5,20,166,1,1,0,437,14,4,49,49,0,1794,1794,0,20,20,0,1,100,NoArch
e92c694e8d2cca1dcaaddb36f0200f27d21e28df,0,0,0,0,0,0,0,0,0,0,0,0,0,0,15,5,0,0,0,0,0,0,0,0,0,1,100,NoArch
9bd4f80752eeb7f4a5853499229b29a6fb24ee32,8,167,18,149,1,0,1,1,28,119,1,5,2.843847478,1263,625,5,159,143,16,7203,6532,671,101,94,7,0,99.31875224,NoArch
49aca6b9fe5c1c4ee8005cd8e1370b9d1817dec5,3,95,7,88,0,0,0,2,29,289,1,3,1.562564004,672,16,5,64,57,7,4502,4046,456,38,34,4,1,100,NoArch
cf12948b2c48dab276264c3a3667bc2088bfc677,4,17,2,15,0,0,0,1,12,343,1,4,1.739954647,552,626,4,115,113,2,2407,2338,69,40,38,2,0,97.94889623,Arch
c31a625a813efe311f4c345f364db91db365daae,2,25,4,21,0,0,0,1,10,244,1,2,0.735508582,296,145,0,34,32,2,1609,1446,163,13,12,1,1,100,NoArch
614fc76a6c650a617662f06450b52c2de30d35f0,1,24,4,20,0,0,0,3,3,587,1,1,0,213,31,0,21,19,2,1546,1364,182,9,9,0,1,100,NoArch
f77c2559b8fefc40c06a7090d20af00afd1e41a0,4,82,78,4,0,0,0,1,4,198,1,2,1.229477667,472,627,1,50,50,0,3030,2986,44,21,20,1,1,100,NoArch
bbb43bda144803b5c8a306324aaee7a1a27d7822,17,35,34,1,0,0,0,2,32,173,3,11,3.856581298,4429,628,1,603,603,0,23293,23335,42,240,240,0,0,95.22761889,Arch
d8a7b9163f7176aa7185319b6917eae1c87e8383,1,2,1,1,0,0,0,2,20,0,1,1,0,108,629,2,20,20,0,676,676,0,5,5,0,0,100,NoArch
04a0324f309e8a30aa1d0a1f11489d9a4c93cfb8,25,77,90,13,0,0,0,4,80,367,2,16,4.277475357,5106,630,3,430,429,1,28217,28281,64,194,193,1,0,100,NoArch
d7a490a9fd59b47679e6d3d0248f4e79d639e1ff,4,44,39,5,0,0,0,3,15,32,1,1,1.42517004,884,631,4,94,94,0,5109,5078,31,55,55,0,0,100,NoArch
02f8694d044b85938a56f48444743f367987ad37,26,874,255,619,1,0,1,5,20,260,3,6,4.175382446,3996,146,0,584,488,96,23073,18849,4224,334,284,50,1,99.96626181,NoArch
c1471da87a12878970eea447df9eb8bb32f2491a,1,3,2,1,0,0,0,5,14,152,1,1,0,214,151,0,39,40,1,1131,1131,0,6,6,0,0,100,NoArch
0ac86361e072ce60b5294f73f2825fca8b313752,8,120,48,72,2,0,2,1,31,137,1,3,2.747578165,781,17,0,85,84,1,4291,4070,221,43,40,3,1,99.17478132,NoArch
7892be34c11990b514b3e24237b04b5116efc2d3,11,919,260,659,9,1,10,1,18,83,2,4,3.309396917,334,18,1,82,35,47,5898,1765,4133,47,20,27,1,96.66112957,Arch
d29a980d71402b3e9b7e3f408cc19a59a6037689,1,66,58,8,0,0,0,4,4,55,1,1,0,233,152,1,22,21,1,1602,1546,56,10,9,1,0,100,NoArch
50a76b61a210c1b409d01c0b2b02a03856da940d,1,8,1,7,0,0,0,2,34,169,1,1,0,339,632,2,49,48,1,1699,1684,15,22,21,1,0,100,NoArch
85ec3a32bfd7b337c8cd45aecac7494c429c462f,119,444,10161,9717,0,37,37,4,25,339,4,36,5.353039043,32521,633,1,2652,3826,1174,108525,147998,39473,982,1362,380,1,91.5029548,Arch
5bde30b43928038e36386f77e39acb63b9005b2b,1,432,0,432,1,0,1,1,1,0,1,1,0,0,634,2,83,0,83,2609,0,2609,18,0,18,1,99.97001499,NoArch
5a5765179fb8e97990f6a5b04bc018b7a9cee389,3,60,31,29,0,0,0,7,61,170,1,2,1.340170503,819,635,3,89,89,0,5861,5658,203,25,25,0,1,97.0793374,Arch
0c4bba06474f7d7b4d5e93ced45ea665b296fa75,1,3,1,2,0,0,0,4,73,165,1,1,0,719,636,4,108,108,0,3236,3234,2,35,35,0,1,100,NoArch
1bed5fbdb46dc89a86e9b9d05dabde47517c3461,2,12,0,12,0,0,0,2,74,194,1,2,0.41381685,910,637,5,122,120,2,4423,4357,66,46,45,1,1,100,NoArch
c0f3d944047ad6c32a129b02a28822e34cc781a4,25,105,68,37,0,0,0,2,25,385,2,11,3.796750187,3176,638,6,301,292,9,19060,18971,89,103,94,9,1,99.95769882,NoArch
6bc7b7f3452fd717ced096e87e75fa7adaf16d36,1,21,12,9,0,0,0,2,9,145,1,1,0,890,19,2,51,51,0,5450,5341,109,28,28,0,0,100,NoArch
234b35200c18e8a143a8f4005fc3ccfe66a48e30,7,383,78,305,0,0,0,1,30,475,1,5,2.375924973,1530,639,7,175,146,29,9875,7987,1888,60,51,9,1,100,NoArch
237ace3aa6113adcfa4e8a8049157da4818611f4,3,24,58,34,0,1,1,4,22,471,2,1,1.183193825,547,640,8,105,105,0,2496,2562,66,56,56,0,1,99.92950797,NoArch
af8ebde30992f66d7978a8f5278f9e895d39451a,1,61,4,57,0,0,0,7,49,321,1,1,0,165,641,9,13,11,2,1157,923,234,6,5,1,1,99.98590755,NoArch
cfec62fa98be0545c3a01c8fd34b2744385e1786,1,3,3,0,0,0,0,3,13,15,1,1,0,300,642,10,30,30,0,2221,2221,0,4,4,0,1,100,NoArch
da457338777808ee9c5b09d893f6bc76c79b6906,1,1,3,2,0,0,0,2,7,315,1,1,0,292,643,11,34,34,0,1237,1263,26,24,24,0,1,100,NoArch
1eb917262f980798586c3cb9c54152dbb59485f9,1,1,3,2,0,0,0,2,8,0,1,1,0,290,147,0,34,34,0,1215,1237,22,24,24,0,1,100,NoArch
711ab6074b5e4ccf8092e9204abe640901ea0411,2,199,6,193,0,0,0,4,8,394,1,2,0.958385815,173,148,1,35,14,21,1936,640,1296,13,8,5,1,99.94365404,NoArch
ebaa95d2ab70eab6a9587afabe554e4fe7b84426,3,114,30,84,0,0,0,3,8,317,1,2,1.059047139,545,149,2,49,46,3,4040,3425,615,20,17,3,1,100,NoArch
5baba6ec444157370bc9c999d3b8f374d9d7aea1,1,3,3,0,0,0,0,3,6,0,1,1,0,161,150,3,6,6,0,1151,1151,0,4,4,0,1,100,NoArch
76da194b25659aab6bc5ac1ae0787376132c950e,1,18,22,4,0,0,0,3,19,316,1,1,0,177,644,12,29,29,0,1088,1059,29,15,15,0,1,100,NoArch
41b0a8bc33964f7a1e5e186fd125cc53f1de2b52,1,27,18,9,0,0,0,5,15,54,1,1,0,215,645,13,43,39,4,1170,1131,39,7,6,1,1,100,NoArch
347aaedee6f7ec1e7f7f115d08d060f1d436d1e1,1,1,1,0,0,0,0,2,3,161,1,1,0,81,153,1,6,6,0,480,480,0,3,3,0,1,100,NoArch
0d4cb371d24fe83f3d52f5ea60269938c4d0ab70,2,36,5,31,1,0,1,1,16,0,1,2,0.759275785,224,646,14,44,43,1,1216,1170,46,8,7,1,1,99.94368577,NoArch
b588af39baa033efac8eba809cc899d71b5a9280,5,143,69,74,0,0,0,2,20,277,2,3,1.597942921,713,647,15,81,74,7,3918,3097,821,34,31,3,1,100,NoArch
de48f9f96207215bf0f7962d04d2a88da2717a14,1,11,7,4,0,0,0,2,7,81,1,1,0,222,648,16,13,13,0,1310,1275,35,6,6,0,1,100,NoArch
f9406683539f5a3ecefa132ae7cb7c83e700d94f,2,17,18,1,0,0,0,5,15,97,2,2,0.775512658,391,649,16,67,66,1,1722,1623,99,56,56,0,1,100,NoArch
ca920b35069f7433cc67353415de2b3780da15d1,1,3,3,0,0,0,0,5,43,283,1,1,0,356,650,17,49,49,0,2154,2154,0,18,18,0,1,100,NoArch
e8b1acf8dc45ba764d6cd91c8b5e5d0a714faa1c,2,238,133,105,1,0,1,1,5,25,1,2,0.934428623,241,651,18,27,22,5,2106,1602,504,14,10,4,1,99.16573971,NoArch
a9234ce16d6ba605747fc641302ce68aba303495,1,27,14,13,0,0,0,5,17,11,1,1,0,223,652,19,43,43,0,1170,1168,2,7,7,0,1,100,NoArch
ba6e77f733659cec32d39c1f63cdeb69f3ee6ff6,0,0,0,0,0,0,0,0,0,0,0,0,0,0,52,0,0,0,0,0,0,0,0,0,0,1,100,NoArch
495f736df90968b6f03ae2b050cd05ea8602fd5f,2,44,9,35,1,0,1,1,10,113,2,2,0.803715924,199,151,4,24,25,1,1031,848,183,14,13,1,1,99.94508512,NoArch
d2915a0b38562de5b27f06e7a6ec5f6c35c9c06f,8,56,35,21,0,0,0,2,3,258,1,5,2.565571253,1687,653,16,100,99,1,8940,8810,130,32,31,1,1,100,NoArch
f3723040d134b5a8d2739f1d7c9ffb6245679e79,11,4,1538,1534,0,4,4,4,20,55,3,5,2.097279502,4086,152,5,360,555,195,14446,20970,6524,79,121,42,1,99.50193691,NoArch
d9ccec463c7f9ffc3c99f1e2e4eeaeee4bbb11bf,0,0,0,0,0,0,0,0,0,0,0,0,0,0,654,16,0,0,0,0,0,0,0,0,0,1,100,NoArch
ad8b61d809b5fd15dea9ef031d14ec8055ab9a03,18,161,86,75,0,0,0,5,44,236,3,12,3.743299975,4538,655,16,452,452,0,29444,29004,440,175,175,0,1,99.83261264,NoArch
b1d63885954bff8d804fce8ccdeef88b20a59ecd,2,24,7,17,0,0,0,2,24,34,1,1,0.938315352,684,656,17,46,44,2,3803,3735,68,17,17,0,0,100,NoArch
977cc3995690858f7714fb587947ce9231dca06b,2,13,11,2,0,0,0,3,10,19,1,1,0.994984828,470,20,0,43,43,0,2987,2929,58,16,16,0,0,100,NoArch
8bf7ac422adcbc74d6d8ebd87edc39caf4eac879,1,10,10,0,0,0,0,4,23,62,1,1,0,691,153,6,150,150,0,3997,4007,10,62,62,0,1,100,NoArch
0b78318b2fbc0a8c6503cb4bca6cda581c8876a9,0,0,0,0,0,0,0,0,0,0,0,0,0,0,21,1,0,0,0,0,0,0,0,0,0,1,100,NoArch
e04d6f329b74538370cf2656d532aee41fb9527c,2,24,19,5,0,0,0,5,21,66,1,2,0.271389588,1316,154,3,60,58,2,6837,6774,63,32,31,1,1,100,NoArch
84d667d8aec89664a2fe69532f30de3e0e44835a,1,4,4,0,0,0,0,5,22,0,1,1,0,929,155,4,60,60,0,6454,6454,0,32,32,0,0,100,NoArch
3a0509f60a1cf5fb6dbd35911e51d2dad6214b68,1,1,1,0,0,0,0,5,21,193,1,1,0,437,154,0,49,49,0,1794,1794,0,20,20,0,0,100,NoArch
75f8f0eb54fb2dcf3d6e2d3160b47a1089cdee80,1,7,0,7,0,0,0,6,23,252,1,1,0,69,358,0,8,8,0,392,392,0,2,2,0,0,100,NoArch
9703584d0d86d8576bb02738fa31736d8bf3d8a6,6,95,81,14,0,0,0,4,17,371,2,6,2.438335186,700,657,6,62,66,4,3664,3656,8,31,34,3,1,99.94421977,NoArch
672b6f9cf5e46175c78b277d8c07ac88de7308d8,1,4,4,0,0,0,0,3,14,370,1,1,0,376,22,0,34,35,1,1155,1176,21,22,22,0,1,100,NoArch
306b285816c6d200e29ddc94bd13ade411978249,1,2,10,8,0,0,0,3,15,0,1,1,0,376,23,1,34,34,0,1143,1155,12,22,22,0,1,100,NoArch
3c7136379aa22f900c7111175479be3c1d60b95b,4,293,0,293,4,0,4,1,1,0,1,2,1.96161236,0,658,5,29,0,29,1457,0,1457,16,0,16,1,99.65205289,NoArch
8efcdac10686a5776a920a9d3cc3e184f847f147,2,30,3,27,0,0,0,2,3,446,1,2,0.884963636,181,22,2,15,15,0,1445,1177,268,5,5,0,1,100,NoArch
a06f96c8a011bd2c9c0e572e3d965dc6f9325bd4,0,0,0,0,0,0,0,0,0,0,0,0,0,0,659,6,0,0,0,0,0,0,0,0,0,1,100,NoArch
3a1adb7b5b84f5ea4ce2aee7ca99e55b459266d0,26,252,203,49,0,0,0,5,62,234,4,23,3.652254124,7442,660,7,964,952,12,38674,38341,333,415,411,4,0,95.62596383,Arch
7d656ca9ad1f5fab7d66fac8b3b11776135704c2,2,0,0,0,2,0,2,2,5,532,1,1,0,0,23,2,0,0,0,0,0,0,0,0,0,0,99.94335882,NoArch
5a2a2562e8231d1c7e159023bb658d3f675612df,0,0,0,0,0,0,0,0,0,0,0,0,0,0,661,4,0,0,0,0,0,0,0,0,0,1,100,NoArch
37d9cca5df12c5d6104038179f20e6d34aa58a74,2,129,62,67,0,0,0,1,2,126,1,2,0.317809429,301,24,2,35,26,9,2391,2029,362,19,12,7,1,100,NoArch
75d18373ebd5ebf291ffcd58f2d51fc1ca2fe358,1,4,4,0,0,0,0,4,19,543,1,1,0,285,25,3,51,51,0,1297,1297,0,33,33,0,0,100,NoArch
0b04779565a30f0e1e6debb6c2ce846fb1df1447,1,8,8,0,0,0,0,3,21,28,1,1,0,172,662,5,25,29,4,1075,1081,6,15,15,0,1,100,NoArch
4ee6a1fbc4ffcf701582d75e5509f407ea371a8f,2,51,9,42,0,0,0,2,12,374,1,2,0.783776947,733,26,4,47,45,2,4792,4322,470,23,22,1,1,100,NoArch
c181b9f5f0d9b8933f1b3bce9efd9ecabaa6a362,4,7,5,2,0,0,0,1,7,238,2,4,1.918295834,414,27,4,50,50,0,1730,1720,10,34,34,0,1,100,NoArch
d2fe1ac3708c6aecf61858692f5b0f61789e3464,0,0,0,0,0,0,0,0,0,0,0,0,0,0,663,2,0,0,0,0,0,0,0,0,0,1,100,NoArch
d61a0ee216389fcac1d3e56f531aa4cc8f597c59,104,568,617,49,1,0,1,4,81,240,5,56,5.70036175,24382,664,3,2791,2778,13,128186,128216,30,1045,1036,9,0,99.9150262,NoArch
aadc0984ea019fcc79867386406d0c3bf1037ac7,2,14,57,43,0,0,0,2,4,432,1,1,0.838007851,291,665,4,16,19,3,746,891,145,7,8,1,1,100,NoArch
43c059c7dec4d67a7cebac94356d7ee068c9e00c,1,9,2,7,0,0,0,2,24,347,1,1,0,224,666,5,28,28,0,1180,1136,44,18,18,0,0,100,NoArch
530253de47fb45ec813f45109bb1036ff3f87cb7,1,44,0,44,1,0,1,5,5,1150,1,1,0,0,667,6,0,0,0,23,0,23,0,0,0,0,99.92924862,NoArch
14bfc076eaa8a8af2484c95b0c8945f836256587,0,0,0,0,0,0,0,0,0,0,0,0,0,0,0,0,0,0,0,0,0,0,0,0,0,0,100,NoArch
7a9e99ec4ac53d32d598b63412ee470fc8a03c2e,21,943,54,889,9,0,9,1,76,327,2,9,3.513346771,3177,668,5,508,410,98,19181,14758,4423,233,179,54,0,90.53091615,Arch
151de0d737501af5dcfee8a21bc7d18ff6edddc8,17,3594,0,3594,16,0,16,1,8,2,2,4,3.728809447,104,1,1,411,15,396,19336,325,19011,152,6,146,2,99.3423525,NoArch
13bd3085ad83d08efe45ab4cb20f296ee9f8c7a5,1,30,27,3,0,0,0,1,2,0,1,1,0,61,2,2,4,4,0,186,186,0,3,3,0,1,100,NoArch
75ea223e804ad6936976ef9ffd7947f45a690c75,4,123,58,65,0,0,0,1,35,657,1,3,0.67744751,391,669,4,46,39,7,2185,1947,238,14,12,2,1,100,NoArch
f696d3635f390a514bd708ffa762486850f55ed1,34,404,22,382,0,0,0,4,27,299,3,12,4.132794182,7998,670,5,1188,1188,0,35334,34500,834,577,577,0,1,100,NoArch
2f4ac68921f348abbebbb9e6434c9531972539a8,2,108,58,50,1,0,1,1,3,22,1,1,0.816017297,165,671,6,26,19,7,1323,939,384,11,8,3,1,99.9067686,NoArch
3bfdd3a08ea71973c5f475ceec147079b8430890,1,10,6,4,0,0,0,2,4,3,1,1,0,173,672,6,23,23,0,1221,1177,44,8,8,0,1,100,NoArch
07bfa59e5a3a359136e0c565564dfe769f3f84db,1,70,0,70,0,0,0,2,11,573,1,1,0,112,111,0,4,2,2,1504,870,634,4,2,2,1,100,NoArch
d25dd2069df700169753952a2dec44879a5178c2,13,509,108,401,5,0,5,1,2,12,1,2,3.251532048,704,673,4,127,69,58,5506,2901,2605,67,38,29,0,88.91797557,Arch
17988ce5e65cf9668c68e2704620c82d5bd84817,7,167,14,153,2,0,2,1,2,0,1,2,1.92843889,437,674,5,68,53,15,3080,2331,749,32,26,6,0,99.92847777,NoArch
f5bb6b7eadaf63e07a79e5c13a1cbbe59576538d,14,338,18,320,0,0,0,5,66,463,1,5,2.813669399,2706,675,6,309,275,34,16996,14610,2386,194,173,21,1,96.77338355,Arch
c4550a1812cbb5a8f6db8250c604635527bfd538,4,31,15,16,0,0,0,2,2,40,1,2,1.418892573,943,676,7,72,69,3,4886,4842,44,25,23,2,1,100,NoArch
9ceb0970e01ca74cd0ea2bf030d60291cd603d52,1,2,3,1,0,0,0,1,2,41,1,1,0,42,677,5,3,3,0,126,146,20,3,3,0,0,100,NoArch
a25bab20fbd704726013b64d93a965763ffb04ad,6,7,8,1,0,0,0,2,54,271,1,3,2.523231429,1633,678,6,131,131,0,6771,6785,14,73,73,0,0,100,NoArch
c4597cb82df23157764baed7f8944f713316e75f,3,172,3,169,2,0,2,1,8,169,1,2,1.181138723,95,679,7,24,13,11,1263,332,931,19,11,8,1,99.9204244,NoArch
baa399cd2361dd4c6b5ca5a0357f9b18376d35af,3,283,0,283,2,0,2,1,27,14,1,2,1.029430921,718,112,1,111,92,19,5539,3833,1706,16,13,3,1,99.85424672,NoArch
58fb7c5df98097318453db2cb7e7b413a4749719,1,3,7,4,0,0,0,3,3,5,1,1,0,173,28,0,9,9,0,971,1007,36,3,3,0,0,99.85467037,NoArch
6aa2bdbd288919f6ac2c97feae8a066b921c0150,6,126,34,92,1,0,1,1,49,401,1,4,2.134722119,1006,29,1,52,48,4,6080,5532,548,17,14,3,1,95.99303136,Arch
466f319cead11e9733dbfd0d25a343627e102aad,6,393,133,260,4,0,4,2,8,45,1,2,2.445036186,346,32,0,45,27,18,3578,2102,1476,28,14,14,1,92.29673929,Arch
af775ba7dd35ba27f836de39a2610c1c1e82afde,9,1415,0,1415,9,0,9,1,1,0,1,2,2.981217797,0,30,2,157,0,157,8571,0,8571,87,0,87,1,90.91334165,Arch
763433cd756da7fda62e1fe6ee60a52f2c8d5221,2,130,0,130,2,0,2,1,1,0,1,2,0.997266543,0,156,0,9,0,9,540,0,540,6,0,6,1,99.91839399,NoArch
bdacb9a41ec7c5acc53b606ff63d2e2bea47dc5a,1,16,0,16,0,0,0,2,2,6,1,1,0,82,359,0,8,8,0,598,598,0,6,6,0,0,100,NoArch
747dfa4eda826821c2df5c99cd1d587ccb4011b4,9,401,24,377,4,0,4,1,25,165,1,5,2.870049189,509,360,1,85,48,37,4264,2591,1673,36,17,19,1,99.83718658,NoArch
c36923f525ef9be0f6e11e71bc892c52734b7b99,4,741,0,741,4,0,4,1,1,0,1,2,1.831237721,0,361,2,60,0,60,4646,0,4646,22,0,22,1,99.83771503,NoArch
f29a874f803f76c090c55db9ef02a85113773964,8,17,278,261,0,3,3,1,31,429,1,4,2.505118558,1134,680,7,90,121,31,5001,5881,880,33,55,22,1,96.18837612,Arch
dec61dee27807815b9308b75213f067a53c81f32,0,0,0,0,0,0,0,0,0,0,0,0,0,0,3,0,0,0,0,0,0,0,0,0,0,1,100,NoArch
b0ac9f5178fe52ed4b7e82feb610ffcb1417da48,2,23,8,15,0,0,0,1,2,64,1,1,0.554778163,427,4,1,44,39,5,2318,2188,130,11,11,0,1,99.98467668,NoArch
39386b2bbfb0b6f0e0d360d262be714f86337009,12,25,587,562,0,1,1,2,26,365,1,8,2.656596115,1919,681,8,100,187,87,8195,11702,3507,25,54,29,1,99.86211123,NoArch
00e3d8f9f8141d438edc817b64c8bc4ee667245b,2,3,3,0,0,0,0,2,18,164,1,2,0.918295834,175,31,3,15,15,0,827,827,0,10,10,0,1,100,NoArch
a13b4b7fae76062d7db63aebbde750fce6daed70,182,3072,3334,262,14,3,17,4,82,244,3,94,6.734134078,34341,682,9,3060,3133,73,197574,201287,3713,1255,1242,13,1,96.04485528,Arch
a116dc7085f78ae025a7d13c0ff078a1c71f3f4e,3,149,1,148,2,0,2,1,2,261,1,3,1.066686925,55,683,10,15,3,12,946,262,684,12,3,9,1,99.91011236,NoArch
be09d7347223baab6bc217502661e4caa69de3a4,5,194,18,176,0,0,0,2,19,167,1,2,1.788551895,1007,684,11,114,100,14,6980,6047,933,70,60,10,1,97.89212647,Arch
2feae277d324ec985d93624a4f34f66813e53007,1,105,10,95,0,0,0,3,14,1,1,1,0,746,685,12,137,123,14,6600,5986,614,16,15,1,1,99.59592694,NoArch
62b237759d5f37a0b1400655248ff4c7428e3d3e,2,3,3,0,0,0,0,2,5,0,1,2,0.918295834,404,686,13,26,26,0,2247,2243,4,8,8,0,1,100,NoArch
b16c26072da5828e6b9a05a882da838463a8f2a6,48,263,248,15,0,0,0,2,40,140,4,28,4.836331225,8632,687,13,790,791,1,52976,52977,1,397,398,1,0,99.62601626,NoArch
d023fad1ab0f9443a4d67f8924a42907d1616940,4,196,116,80,1,0,1,3,20,300,1,2,1.619306511,327,688,14,32,26,6,1874,1469,405,18,15,3,1,99.90248659,NoArch
e23728debd770f4710d9455c5bb6117b3d864ff9,38,753,117,636,5,0,5,2,32,342,2,15,4.282965851,4458,32,4,532,479,53,26220,22426,3794,269,236,33,1,98.97122649,NoArch
2d2e58631ae92e4e989f3114c3e37a033c003983,4,2,281,279,0,3,3,4,26,278,2,1,1.183016375,477,689,12,11,28,17,1292,2083,791,3,11,8,1,99.88851728,NoArch
281156e2c3a5a768f5fe70db3dd1e6bcd9edf152,3,14,53,39,0,0,0,2,3,7,2,2,0.85721853,393,690,13,10,20,10,1517,1662,145,4,7,3,1,99.79256423,NoArch
3d4e6f287302a1d1e6371688829a2c007f971592,13,230,89,141,0,0,0,5,34,266,3,9,3.138458863,4664,49,0,644,617,27,24468,23476,992,185,174,11,1,96.87346538,Arch
4b30ce3d047911e9f6a9924a2ad6ea625f2c99b8,0,0,0,0,0,0,0,0,0,0,0,0,0,0,5,2,0,0,0,0,0,0,0,0,0,1,100,NoArch
0681eb11afbe12e512e0c475ef3e76018500c6a9,12,37,26,11,0,0,0,7,83,81,2,6,2.941854008,2230,691,12,151,150,1,11558,11536,22,56,56,0,1,100,NoArch
35032b8b4e08e8873ac02d96cb2a63f5b19daae3,57,458,1970,1512,1,8,9,2,68,224,4,24,4.837100238,15239,692,12,1657,1768,111,82034,93443,11409,926,1003,77,1,95.85222502,Arch
375e080d1f9b53631b55a40cdb88850d859677f9,1,2,0,2,0,0,0,3,18,16,1,1,0,314,24,0,32,31,1,1416,1410,6,20,19,1,0,100,NoArch
75d76fdf94a30adbf43c0ab97261891abe7e8db8,0,0,0,0,0,0,0,0,0,0,0,0,0,0,693,13,0,0,0,0,0,0,0,0,0,0,100,NoArch
05a29c3f08b8f938e98c00703588db145d09f6f4,0,0,0,0,0,0,0,0,0,0,0,0,0,0,362,3,0,0,0,0,0,0,0,0,0,1,100,NoArch
4641c87ebc5e8cd9d2764b6a17445d6ce7dc3997,9,39,134,95,0,0,0,4,23,6,2,8,2.85561083,1204,694,14,88,101,13,6998,7720,722,49,53,4,1,99.79848866,NoArch
208aa074f35c0c0143f9ad00b7f0056299b80eba,40,134,130,4,0,0,0,2,69,79,4,26,4.807278111,9078,695,15,912,919,7,47582,47865,283,483,485,2,0,99.86561398,NoArch
ad17b0d1f00bea5f1932ce3d8f2170120e29d4f2,9,209,220,11,2,0,2,2,55,142,1,5,2.400910687,1731,696,16,138,148,10,6923,7131,208,75,76,1,0,99.91603694,NoArch
c8e77d84ea952b1e0d17164e8aa0ddd5fbed039f,1,4,0,4,0,0,0,3,9,22,1,1,0,98,82,0,8,8,0,495,495,0,4,4,0,0,100,NoArch
abff05e2a13cb88d4d4628062d2bbf02df058b08,0,0,0,0,0,0,0,0,0,0,0,0,0,0,83,1,0,0,0,0,0,0,0,0,0,0,100,NoArch
c439f53c74d6c8589ced4c89c1a312bbf70d8d62,7,731,13,718,6,0,6,1,3,7,1,2,2.419020016,79,33,2,89,8,81,4142,399,3743,46,2,44,1,92.63157895,Arch
105be3e11b0bc426879dd3ea1f9bcb30adbfdd4f,0,0,0,0,0,0,0,0,0,0,0,0,0,0,84,2,0,0,0,0,0,0,0,0,0,1,100,NoArch
6063d3f5927847c6200793beb798a7d30df5b811,0,0,0,0,0,0,0,0,0,0,0,0,0,0,85,3,0,0,0,0,0,0,0,0,0,1,100,NoArch
554f434158d7adffdb8d41b88166a5d15ddee724,1,1,0,1,0,0,0,5,25,456,1,1,0,87,155,0,11,11,0,485,479,6,4,4,0,0,100,NoArch
328a543e60954f3e7c83a58af55d15d76804991d,4,26,2,24,0,0,0,6,58,158,1,2,1.574417427,1079,156,1,103,101,2,6413,6279,134,39,38,1,1,100,NoArch
80366ee59bc003a5cf18910340bd3d2a08d87de5,101,1107,2366,1259,4,14,18,1,48,190,4,49,6.010813251,16363,697,16,1750,1937,187,82518,86536,4018,744,882,138,1,90.86120996,Arch
9af07ed974ec639518d6980448ab892c6c120908,11,1030,636,394,0,0,0,7,54,318,2,6,2.746318315,2077,157,2,171,159,12,13740,12662,1078,88,82,6,1,100,NoArch
ce284d8f2cd8e9ad9901c8ee9f8e277e2dc17858,2,93,6,87,0,0,0,2,21,19,1,2,0.872475205,563,50,1,67,61,6,3777,3205,572,40,37,3,1,100,NoArch
fb7dd583e70de55c491b5582ea843faa0e89dfdb,10,16,433,417,0,4,4,2,17,529,1,4,2.60366704,1333,698,17,60,104,44,5791,7356,1565,28,56,28,1,99.80225989,NoArch
bd5d2f30a93f7accbf019c34e88ed47cfea0fa64,4,547,0,547,4,0,4,1,1,0,1,2,1.94458705,0,34,3,31,0,31,3590,0,3590,16,0,16,1,99.33399462,NoArch
f3a9cc138cf2e4e64436d24eda06d32d335aff85,51,352,319,33,1,0,1,5,49,199,5,36,5.082420236,10124,699,18,1122,1129,7,57393,57939,546,436,437,1,0,91.73010897,Arch
11afe576b256b9b44229348cddfadaddbb359f0f,4,66,19,47,0,0,0,3,21,113,1,1,1.647496671,379,700,19,42,37,5,2413,2164,249,23,20,3,1,99.92147008,NoArch
471cb81754b3f377abd077efd57f9ae9e1978f68,1,8,0,8,0,0,0,2,2,14,1,1,0,257,701,20,30,29,1,1764,1728,36,12,11,1,1,99.98431619,NoArch
f147e17328f402f6a6580878a3a772ed298f2dae,0,0,0,0,0,0,0,0,0,0,0,0,0,0,702,17,0,0,0,0,0,0,0,0,0,1,100,NoArch
82f941298bad7760b61485d029590efd6994b43d,3,37,50,13,0,0,0,4,23,332,1,2,1.18151931,297,703,16,17,19,2,1244,1280,36,10,12,2,0,100,NoArch
d8ac693133622ba28da15d54bf0d5400697242dc,3,26,14,12,0,0,0,2,22,20,1,2,1.141153528,946,704,17,95,95,0,5603,5469,134,57,57,0,1,100,NoArch
4e75f777e8ecebf0fc36cdebc5b62e1ca9d68413,5,8,8,0,0,0,0,4,26,473,1,2,2.155639062,780,705,18,78,78,0,3757,3779,22,43,43,0,1,100,NoArch
84f17ae48ddeaf6de637d839e4625aa32484fd00,6,387,6,381,4,0,4,1,22,24,1,2,2.38798882,189,35,2,50,14,36,2612,903,1709,29,11,18,1,99.85895628,NoArch
bd368539913733904e9ca74c19c726258f2c3bbe,1,125,121,4,0,0,0,7,55,20,1,1,0,454,706,17,26,28,2,2388,2649,261,12,12,0,0,100,NoArch
3218e951e55dea4d2cb984be697f39bb70e82a36,102,835,742,93,0,0,0,2,84,92,3,59,4.735099934,22923,707,18,2416,2413,3,128880,129086,206,862,857,5,0,99.93743157,NoArch
172bb3bd8c83c45ba50a255621ddade9c8e8d1af,24,578,147,431,5,0,5,3,51,233,3,7,3.474834769,2600,158,3,328,287,41,15362,13559,1803,197,178,19,1,91.24877089,Arch
8049eff6dd48dc2621219c51e1eef97dd62165c8,1,254,0,254,1,0,1,1,1,0,1,1,0,0,159,4,20,0,20,2077,0,2077,17,0,17,1,98.85892116,NoArch
ff31f377268456d212763b9c60d9205acd3ab1ba,1,1,1,0,0,0,0,3,14,24,1,1,0,313,708,17,28,28,0,1950,1946,4,11,11,0,1,100,NoArch
c03322867930e5a9a40f19035eaf4d3cd26dafe2,1,13,15,2,0,0,0,3,19,39,1,1,0,316,709,18,31,32,1,1401,1416,15,20,20,0,0,100,NoArch
6ad3e135004f695f0a795cadf09d39f4a1b74bbb,1,6,1,5,0,0,0,1,3,24,1,1,0,113,710,19,9,9,0,526,483,43,2,2,0,1,100,NoArch
a581a13a5f3dc5688e231392dad652af1bcd6376,1,23,1,22,0,0,0,1,4,1,1,1,0,118,711,20,12,9,3,643,526,117,3,2,1,1,100,NoArch
b479bd27035f0222df7176816afde0b14cfe4418,6,240,239,1,0,0,0,1,5,0,1,2,1.279893178,1341,6,0,109,99,10,7134,6127,1007,39,33,6,1,99.72269906,NoArch
3e276bb4a8855734fa440845e75c9376b7a5cdcb,1,1,3,2,0,0,0,2,6,0,1,1,0,125,7,1,13,13,0,525,529,4,5,5,0,1,100,NoArch
afc8abbd70f2a3c5df25ef06d4b7e52572eee280,1,2,1,1,0,0,0,2,8,23,1,1,0,281,712,18,38,38,0,1619,1609,10,16,16,0,1,100,NoArch
933e22a2afa9bfe6a38f1f33d6adb0cee6cc38aa,16,278,152,126,1,0,1,2,41,45,2,5,2.995558566,1887,160,5,226,210,16,8506,7836,670,154,146,8,1,94.78226756,Arch
a3b93795bb530d9be3f7b3c2dfac8e89a6a980e2,3,97,11,86,0,0,0,4,21,40,1,2,1.215690382,327,157,0,34,23,11,2125,1618,507,13,10,3,1,100,NoArch
0e23821df0e1b0e17d1ed7b196ed5185f6d2db33,1,53,10,43,0,0,0,2,7,7,1,1,0,123,8,2,16,13,3,619,525,94,6,5,1,1,100,NoArch
3ffddc56c4d954ae8c03fb41f8cf8290467266b0,2,68,0,68,2,0,2,1,1,0,1,2,0.923119984,0,158,1,8,0,8,418,0,418,4,0,4,1,99.92243051,NoArch
9c5a1f8e7a296438291a55ca58441045d1e75b0d,1,25,15,10,0,0,0,5,37,46,1,1,0,422,161,6,23,23,0,3286,3242,44,13,13,0,0,100,NoArch
a4fc290a53eb512487388ff87d52569aa8adacc7,1,6,1,5,0,0,0,6,50,29,1,1,0,302,159,2,43,42,1,1868,1851,17,18,18,0,1,100,NoArch
691bf8e65a6fe348019acc637a648b1976ceef99,1,0,9,9,0,0,0,6,38,0,1,1,0,432,160,3,23,23,0,3241,3286,45,13,13,0,1,100,NoArch
57472918a320e2c4b2c011a875ecc5ad8591a620,0,0,0,0,0,0,0,0,0,0,0,0,0,0,713,16,0,0,0,0,0,0,0,0,0,1,100,NoArch
15712a6eda44b04cb52e61ac04a779848f9485c1,11,92,44,48,0,0,0,4,22,0,3,6,2.928639807,1065,714,17,97,97,0,5328,5357,29,43,43,0,0,100,NoArch
642d48ff0be783668753fbc0e06a32a6f03aea09,1,2,2,0,0,0,0,2,9,154,1,1,0,83,715,18,9,9,0,387,387,0,9,9,0,0,100,NoArch
ece4db69918406abb86c65cd422d3f9edf71be24,16,19,1175,1156,0,8,8,3,71,60,3,5,3.465284957,3470,716,18,157,283,126,15610,21638,6028,82,183,101,1,93.45485862,Arch
8205dae408407f764e8f7bdfaa66feae7c94b32c,0,0,0,0,0,0,0,0,0,0,0,0,0,0,86,0,0,0,0,0,0,0,0,0,0,1,100,NoArch
0e3f35da37442d6dd451d355290aafb651805995,0,0,0,0,0,0,0,0,0,0,0,0,0,0,87,1,0,0,0,0,0,0,0,0,0,1,100,NoArch
fcd0f0ed5659e4946289e8f34f38f06d9333614c,0,0,0,0,0,0,0,0,0,0,0,0,0,0,88,2,0,0,0,0,0,0,0,0,0,0,100,NoArch
3cf3f3056efc271af60e83107212115eeae52f68,0,0,0,0,0,0,0,0,0,0,0,0,0,0,89,3,0,0,0,0,0,0,0,0,0,0,100,NoArch
f879fca57d41cb16830f8ad5a5202e38536238ad,0,0,0,0,0,0,0,0,0,0,0,0,0,0,90,4,0,0,0,0,0,0,0,0,0,0,100,NoArch
1d21076b4a67367f912de6762b4b4723b76cc4c4,0,0,0,0,0,0,0,0,0,0,0,0,0,0,91,5,0,0,0,0,0,0,0,0,0,1,100,NoArch
d78e18637e66d1e5d25a036653a2ecaa92363fb5,0,0,0,0,0,0,0,0,0,0,0,0,0,0,92,6,0,0,0,0,0,0,0,0,0,0,100,NoArch
dafeaaa6406c0f2b1ac6d5ca61ebc20ae114fcc1,0,0,0,0,0,0,0,0,0,0,0,0,0,0,93,7,0,0,0,0,0,0,0,0,0,0,100,NoArch
a6f66312ac183a70a84c8867dc6c967d215cdfaa,5,63,14,49,0,0,0,3,30,405,2,3,1.181886083,1357,51,0,256,249,7,7407,7138,269,105,102,3,1,100,NoArch
5d14fc9bbf18cf7ef645f4a397aef18410f02c70,2,6,7,1,0,0,0,4,25,36,1,2,0.961236605,606,52,1,54,56,2,3288,3302,14,29,29,0,0,100,NoArch
39fe22402990d06f23a39cec18e74887ea5eb262,209,1023,1065,42,16,2,18,3,85,208,5,90,6.810743894,44866,717,9,5263,5287,24,204270,206637,2367,1984,1995,11,0,99.40609952,NoArch
9ae4c2622ef2554bcce37353e48e511c16bf5df9,2,6,2,4,0,0,0,7,55,22,1,2,1,708,718,7,51,50,1,5074,5061,13,24,23,1,0,100,NoArch
8f2373a4af29e51bba97def52f29ba56fce3f06b,1,3,4,1,0,0,0,4,16,0,1,1,0,146,719,8,14,14,0,658,664,6,5,5,0,0,100,NoArch
8aecd6c6692856f92dc83119b2d2a0ebba36a0f6,0,0,0,0,0,0,0,0,0,0,0,0,0,0,720,7,0,0,0,0,0,0,0,0,0,1,100,NoArch
a4778a48c6f21ab6a65189c737530c5e41ec75c8,14,150,150,0,1,0,1,2,26,226,3,12,3.520850562,1603,363,0,136,138,2,9000,8961,39,40,42,2,1,99.87232684,NoArch
bb62dab20ac28605492d778e1642e6e4bc50f6ab,1,1,1,0,0,0,0,4,8,9,1,1,0,80,364,1,4,4,0,384,384,0,4,4,0,0,100,NoArch
522ee0b5dbf30156745e9d66abb70149c4ec4cfb,14,817,242,575,2,0,2,6,40,71,3,10,3.402732591,2458,53,2,303,200,103,18820,15058,3762,149,105,44,1,92.39609782,Arch
f3609730fc992b310afe36f0fd08e4183bd53188,8,389,97,292,1,0,1,4,37,231,2,3,1.971413112,1258,54,3,167,127,40,9674,7675,1999,63,49,14,2,93.40715941,Arch
4dd8881bff84519df3b90d8da3d4d53dea1f4b9b,6,308,111,197,0,0,0,2,13,58,2,3,2.487539831,971,162,0,102,82,20,7649,6260,1389,61,47,14,1,97.33740725,Arch
a6bdcbba056612ad4057e68c405527992e8a958b,10,166,169,3,0,0,0,2,38,4,2,5,3.155058897,2000,721,4,183,185,2,13064,13161,97,86,86,0,2,100,NoArch
ec7c14065938798598bbb514fc5228156d8ae533,0,0,0,0,0,0,0,0,0,0,0,0,0,0,722,5,0,0,0,0,0,0,0,0,0,1,100,NoArch
77fa3161a89df6a2bb8688b1c4a5f1b97a474adf,1,4,2,2,0,0,0,2,5,89,1,1,0,92,723,3,10,10,0,476,472,4,7,7,0,1,100,NoArch
b50c396cbafc60bdaf98de9d2f3d409d4e75d376,0,0,0,0,0,0,0,0,0,0,0,0,0,0,94,0,0,0,0,0,0,0,0,0,0,0,100,NoArch
804b46e093f9c0104a00f16f9a5305c8d7732125,0,0,0,0,0,0,0,0,0,0,0,0,0,0,724,4,0,0,0,0,0,0,0,0,0,0,100,NoArch
a14fd1c1e44f7e330809887a1e2f6e1b69f1137b,0,0,0,0,0,0,0,0,0,0,0,0,0,0,725,5,0,0,0,0,0,0,0,0,0,0,100,NoArch
1d455e15f79cbb1c958610f3a04fb436421ae9fc,0,0,0,0,0,0,0,0,0,0,0,0,0,0,726,6,0,0,0,0,0,0,0,0,0,0,100,NoArch
99b0f5429c482ba1af411d1a6c0e24567346143c,0,0,0,0,0,0,0,0,0,0,0,0,0,0,726,6,0,0,0,0,0,0,0,0,0,0,100,NoArch
4cb42512b71cc1d410c0b438d4b0ca80864daa5e,0,0,0,0,0,0,0,0,0,0,0,0,0,0,727,7,0,0,0,0,0,0,0,0,0,0,100,NoArch
7ecf707b3e27fd665d74419957dade54755b57b4,0,0,0,0,0,0,0,0,0,0,0,0,0,0,728,8,0,0,0,0,0,0,0,0,0,0,100,NoArch
cbb1ad8c8a205ee543c6874aeaf7773d33f41fd2,0,0,0,0,0,0,0,0,0,0,0,0,0,0,729,9,0,0,0,0,0,0,0,0,0,0,100,NoArch
1bbc6a96210a8edbcc396268cd5d924dffdcb109,0,0,0,0,0,0,0,0,0,0,0,0,0,0,730,10,0,0,0,0,0,0,0,0,0,0,100,NoArch
467bf1839b82b80d017e7a1cabd642a1c2b0b778,1221,169400,0,169400,1221,0,1221,1,1,0,1,262,9.750825165,0,727,7,16471,0,16471,838298,0,838298,7792,0,7792,0,63.35751295,Arch
1deba16f7d1309e0981b3400ad96f46d77e08dbe,1221,0,169400,169400,1,1220,1221,0,0,0,1,262,9.750825165,169400,731,11,0,16471,16471,0,838298,838298,0,7792,7792,0,63.35751295,Arch
737249b0db7fafd150ac56ddc2bc1b465b12abb7,0,0,0,0,0,0,0,0,0,0,0,0,0,0,365,0,0,0,0,0,0,0,0,0,0,1,100,NoArch
4510a3ce147f6947231ac19f384fe554a8a8f52b,0,0,0,0,0,0,0,0,0,0,0,0,0,0,366,1,0,0,0,0,0,0,0,0,0,0,100,NoArch
fa42f721cdc0b0a5115ab38256378729b5760317,0,0,0,0,0,0,0,0,0,0,0,0,0,0,367,2,0,0,0,0,0,0,0,0,0,0,100,NoArch
cef6f88628be1d93ac1cc307464d8329204710c9,0,0,0,0,0,0,0,0,0,0,0,0,0,0,368,3,0,0,0,0,0,0,0,0,0,0,100,NoArch
fb171d41f9e36856285a0e8bde7c683a2c899a4f,1,14,8,6,0,0,0,3,3,153,1,1,0,58,369,4,5,5,0,327,299,28,2,2,0,1,100,NoArch
fc0ecc2dfc137f0aa6c000064144ff98f447db25,0,0,0,0,0,0,0,0,0,0,0,0,0,0,53,0,0,0,0,0,0,0,0,0,0,1,100,NoArch
691ed8e5eda676ec39dcb3ba12a956f50245ba65,0,0,0,0,0,0,0,0,0,0,0,0,0,0,732,11,0,0,0,0,0,0,0,0,0,0,100,NoArch
b1f46d50240b2601e401939404bdbc7197572006,0,0,0,0,0,0,0,0,0,0,0,0,0,0,733,12,0,0,0,0,0,0,0,0,0,0,100,NoArch
8b18401cae445111de6af7c3cd50c19d3cf12e03,0,0,0,0,0,0,0,0,0,0,0,0,0,0,736,15,0,0,0,0,0,0,0,0,0,0,100,NoArch
175b269dc6bd5243f3d6529132fbcc24af584da0,0,0,0,0,0,0,0,0,0,0,0,0,0,0,734,13,0,0,0,0,0,0,0,0,0,0,100,NoArch
c02e98f2eeff25bce854133dbbe9de8579bbc634,5,5,5,0,0,0,0,2,15,104,1,1,2.321928095,549,163,0,39,39,0,3234,3230,4,20,20,0,0,100,NoArch
55439df8c2b595c9cbe3f452d330dcd77e982ea4,0,0,0,0,0,0,0,0,0,0,0,0,0,0,735,13,0,0,0,0,0,0,0,0,0,0,100,NoArch
a500c977d047d0955bf5dd830f558241c918e3c2,0,0,0,0,0,0,0,0,0,0,0,0,0,0,736,14,0,0,0,0,0,0,0,0,0,0,100,NoArch
93b66b11b89965957970fce64e2d6cb12dbbc966,0,0,0,0,0,0,0,0,0,0,0,0,0,0,737,15,0,0,0,0,0,0,0,0,0,0,100,NoArch
bebbd10e4276bd01256b75bbac262d5305264b2a,0,0,0,0,0,0,0,0,0,0,0,0,0,0,738,16,0,0,0,0,0,0,0,0,0,0,100,NoArch
1292145799e70890d4898353e4f5279d0484c5b7,0,0,0,0,0,0,0,0,0,0,0,0,0,0,739,17,0,0,0,0,0,0,0,0,0,0,100,NoArch
e597fcdb0465cb3f23ebc30266bc16993205c5d3,0,0,0,0,0,0,0,0,0,0,0,0,0,0,743,21,0,0,0,0,0,0,0,0,0,0,100,NoArch
467bf1839b82b80d017e7a1cabd642a1c2b0b778,1221,169400,0,169400,1221,0,1221,1,1,0,1,262,9.750825165,0,727,7,16471,0,16471,838298,0,838298,7792,0,7792,0,63.35751295,Arch
8b18401cae445111de6af7c3cd50c19d3cf12e03,1222,14,169408,169394,1,1220,1221,3,3,0,2,263,9.751422829,169458,736,15,5,16476,16471,327,838597,838270,2,7794,7792,0,63.35751295,Arch
e597fcdb0465cb3f23ebc30266bc16993205c5d3,5,5,5,0,0,0,0,2,15,104,1,1,2.321928095,549,743,21,39,39,0,3234,3230,4,20,20,0,0,100,NoArch
5d64fbce6cd194a90e26ca35f90f61c88e75135b,0,0,0,0,0,0,0,0,0,0,0,0,0,0,740,18,0,0,0,0,0,0,0,0,0,0,100,NoArch
ac28cf4841459c785e4beee061cc350ce97c9838,2,3,2,1,0,0,0,3,16,175,2,1,0.970950594,472,741,9,88,86,2,2026,2011,15,62,62,0,1,100,NoArch
a26d3b136f0c8b24904f062bfbc1d2b14448eac1,5,14,14,0,0,0,0,2,35,325,2,5,2.182005815,1055,742,10,129,130,1,5556,5550,6,63,63,0,1,100,NoArch
e37620bc847b7942384016749d43077c6a250caa,0,0,0,0,0,0,0,0,0,0,0,0,0,0,743,11,0,0,0,0,0,0,0,0,0,0,100,NoArch
96d93d4325208fa4fe253d294e52e983dd798beb,4,11,9,2,0,0,0,2,26,99,1,3,1.638758681,1067,744,12,86,86,0,5240,5212,28,39,39,0,1,100,NoArch
efa6a1770ec807050c269c580bb08a6a7a5b481d,0,0,0,0,0,0,0,0,0,0,0,0,0,0,745,13,0,0,0,0,0,0,0,0,0,0,100,NoArch
740db0320ad8fc1af0f3a79953aa74f175bd6fd7,0,0,0,0,0,0,0,0,0,0,0,0,0,0,746,14,0,0,0,0,0,0,0,0,0,0,100,NoArch
96024a77ce7b2d271e4c84e185912189ec53bd4e,42,528,253,275,5,0,5,1,80,217,1,20,4.485334106,6657,36,0,731,720,11,34707,33438,1269,332,306,26,1,99.69640017,NoArch
fad58fee36a45d473c6f919c9476f9f17e9c471c,2,161,87,74,0,0,0,5,25,135,1,1,0.037878947,318,747,15,35,24,11,2540,2148,392,19,7,12,1,100,NoArch
6d38de26f5ac36fb07c2c3640d722f03620e23c5,1,0,214,214,0,1,1,3,13,878,1,1,0,214,748,16,0,11,11,0,1472,1472,0,4,4,0,98.27271451,NoArch
0793ce4513a5f3f8b64da9d4d3ed6355edec46d5,1,55,62,7,0,0,0,2,5,92,1,1,0,392,749,17,43,43,0,1133,1139,6,21,21,0,1,100,NoArch
304d6b3456cb983c441624f430186f47e1da5062,0,0,0,0,0,0,0,0,0,0,0,0,0,0,750,18,0,0,0,0,0,0,0,0,0,0,100,NoArch
50fd693770212294b1c14eb9ec10324c7d99a303,84,1,2,1,0,0,0,1,1,0,1,31,0,13684,751,19,1175,1175,0,77302,77323,21,530,530,0,1,89.50908831,Arch
466f8fe8672a32afd5174d29fef56e3c66f22dc1,1,6,0,6,0,0,0,4,17,7,1,1,0,188,752,20,36,35,1,1019,1003,16,12,11,1,1,100,NoArch
e2620d31bab2ef08518d0fa0963de6ee87f6506e,1,852,0,852,1,0,1,1,1,0,1,1,0,0,753,21,105,0,105,4104,0,4104,37,0,37,1,99.96994289,NoArch
c3fe242df3a9bd14a12014671cac30aad7c39dfe,6,30,1,29,0,0,0,1,24,838,1,3,2.554824039,759,754,22,110,103,7,3362,3230,132,78,72,6,1,100,NoArch
5c9f8fb6e5c8330540c0c424d7fe122daa608c79,1,0,3,3,0,0,0,2,6,193,1,1,0,280,755,23,14,15,1,1461,1467,6,5,6,1,1,100,NoArch
d608a88d95b4a7bfd5f32a24f0c0a5d5cf6f25cf,111,1125,816,309,0,0,0,2,86,106,3,71,6.029471596,25843,37,1,2380,2382,2,152770,151112,1658,919,919,0,1,99.13923286,NoArch
e7b1934536bb9dc014a744406a7122e088f2a435,2,21,4,17,0,0,0,3,24,6,1,1,0.989587521,326,756,24,44,42,2,1976,1887,89,11,11,0,1,100,NoArch
f5e773225fffa34ee6f1040c283fd81ef54b557e,5,26,20,6,0,0,0,1,3,0,1,1,2.085346679,463,757,25,33,33,0,2480,2461,19,21,21,0,1,100,NoArch
623be86e5837ae0f5f9f84d9409eda4550c2308d,2,218,0,218,2,0,2,1,1,0,1,2,0.940840309,0,758,26,19,0,19,1212,0,1212,10,0,10,1,99.92416199,NoArch
4ef41c7748e23e3dfc3c90d52092b92dcb088653,10,22,18,4,0,0,0,2,31,161,3,9,2.945461844,2240,759,27,180,180,0,14515,14474,41,63,63,0,0,97.74382408,Arch
96117d39eed51f10ee1300917f80abc32908d373,53,167,181,14,0,0,0,2,58,81,4,39,4.712629709,11208,760,28,1054,1060,6,61529,61835,306,515,519,4,0,99.85127096,NoArch
4f85c156b15fa44ed1e7d3b62e0b5e0ac25058a2,1,1,1,0,0,0,0,2,6,764,1,1,0,161,761,29,27,27,0,664,667,3,9,9,0,0,100,NoArch
9d93d27e94fe0a4753a35d27c9acd1429c1f45f8,1,2,0,2,0,0,0,1,2,1,1,1,0,852,762,30,105,105,0,4135,4104,31,37,37,0,1,100,NoArch
d3ccbe045f29d260ad27bf364047b59b939b1805,8,48,40,8,0,0,0,1,32,44,3,8,2.412432816,1275,763,31,111,109,2,7501,7405,96,38,37,1,1,100,NoArch
1f672cb7befb8f6bf553fde8c87c7e6238c2ddd7,4,403,131,272,3,0,3,1,9,39,1,2,1.812713693,277,764,32,39,17,22,3469,2272,1197,26,9,17,1,99.83759643,NoArch
b4c54009ee19014149b18941b4341297ccdab562,3,461,0,461,2,0,2,4,13,33,2,3,0.638433671,841,765,33,134,83,51,4714,2424,2290,94,68,26,1,99.9324233,NoArch
0de31cb5d92f79abdf1f82b4b0a0847b5f8e757f,14,1368,906,462,3,0,3,2,62,132,3,8,3.325221691,2993,164,1,230,220,10,20369,19444,925,126,120,6,1,96.40328519,Arch
e4e7947ccb3b5260732ce044b7d0334b7547bef3,0,0,0,0,0,0,0,0,0,0,0,0,0,0,766,34,0,0,0,0,0,0,0,0,0,0,100,NoArch
793a170399de40ec7da6bffa15e8aeb9368fbead,1,5,2,3,0,0,0,7,63,3,1,1,0,570,767,35,36,36,0,2788,2793,5,12,12,0,1,100,NoArch
4ac06616432df2d08ba924d278c6c739dc3437c2,1,41,58,17,0,0,0,2,3,3,1,1,0,246,768,36,30,36,6,1922,1810,112,6,10,4,0,100,NoArch
194986dc255b7486444a15867be9c736945b0dd8,1,0,80,80,0,1,1,2,5,825,1,1,0,80,769,37,0,10,10,0,367,367,0,7,7,0,99.97022923,NoArch
055f4abec06d90e7fcc1c707768480a6902db877,19,20,20,0,0,0,0,1,18,331,3,14,4.221928095,3949,770,38,237,237,0,25040,25078,38,124,124,0,0,100,NoArch
3f3cc8a2fff90017c16a26209556238b73cfeb0b,18,119,230,111,0,0,0,5,50,389,3,10,3.804076392,3071,771,39,219,236,17,18249,18408,159,156,147,9,0,100,NoArch
5681bb0f11e29897635456c43603605169010ecf,0,0,0,0,0,0,0,0,0,0,0,0,0,0,772,40,0,0,0,0,0,0,0,0,0,1,100,NoArch
6634dc9a3f6e9962457d4aa7843689d7ab218bc7,2,25,25,0,0,0,0,3,10,6,1,1,0.634309555,315,773,38,27,27,0,2078,2078,0,9,9,0,1,100,NoArch
74f849b10c4d76281f31741a9cef48ceddcde123,268,914,1047,133,2,1,3,3,87,178,4,116,7.60311858,54341,38,2,5374,5388,14,304913,306603,1690,2196,2199,3,1,98.92601432,NoArch
346c98c319c0fd978f8a0959d85452848e0e0bda,22,46,27,19,1,0,1,2,23,0,3,17,2.490045792,3522,39,3,333,330,3,18566,18649,83,139,138,1,1,99.68652038,NoArch
fd730ff6025009ed25a50dc74f7bae2283ce5fd0,0,0,0,0,0,0,0,0,0,0,0,0,0,0,40,4,0,0,0,0,0,0,0,0,0,1,100,NoArch
38616e010567870d39b9fd5ef7211ef348fdb29b,5,20,10,10,0,0,0,2,20,17,2,5,2.027877968,739,41,5,61,61,0,3965,3870,95,28,28,0,0,100,NoArch
d497b6871e219622bff3a6d5b503b6d203e1861d,1,4,1,3,0,0,0,3,15,10,1,1,0,361,42,6,25,25,0,2469,2459,10,16,16,0,0,100,NoArch
95743219fd99d1bed8241b9206293af6fa8fe7b2,1,2,1,1,0,0,0,6,23,14,1,1,0,180,774,28,11,11,0,992,981,11,2,2,0,0,100,NoArch
507af7a6975bb795b7e3d60f67a7e75e4e247352,4,498,146,352,2,0,2,1,2,18,1,1,1.849827426,430,775,28,32,15,17,2378,1374,1004,23,10,13,1,99.89569364,NoArch
70fb5a121258d375005b5c3c3d96786c363f708a,2,8,6,2,0,0,0,2,31,652,1,1,0.591672779,193,776,6,5,6,1,652,648,4,3,3,0,0,100,NoArch
b51662be15e5fbce55e4c323c54fc064c0a65a50,0,0,0,0,0,0,0,0,0,0,0,0,0,0,777,7,0,0,0,0,0,0,0,0,0,1,100,NoArch
a8df4a23aa6eaefea26d72a822b4710da991ea94,19,1534,11,1523,17,0,17,1,17,43,1,8,3.826249889,211,43,5,178,29,149,9611,1131,8480,119,13,106,1,99.45306726,NoArch
a8fb97ebd61ff4a67fa32e063e0779bdc2d46396,11,26,360,334,0,4,4,2,53,182,1,5,3.051353086,2268,44,6,101,127,26,11073,12415,1342,45,63,18,1,94.23171734,Arch
fe9baebb217b04ca5764d5dc0eb927240c25f8e8,4,0,0,0,4,0,4,2,10,0,1,1,0,0,45,7,0,0,0,0,0,0,0,0,0,1,99.85041137,NoArch
b79bc621ce888770c67e6e1facb8880976e2c5ec,1,0,1,1,0,0,0,1,2,0,1,1,0,124,46,8,8,8,0,752,763,11,5,5,0,0,100,NoArch
b4f8b6b0a85ce825ba29a83539dbfc1f5b761d43,3,231,0,231,3,0,3,1,1,0,1,3,1.462639734,0,47,9,9,0,9,1388,0,1388,6,0,6,1,99.79439252,NoArch
f9af45c30cbdac92f95e62b06d53334beef1b4e2,16,57,62,5,0,0,0,4,21,600,3,7,2.983798265,1962,778,4,136,137,1,10269,10334,65,63,63,0,1,100,NoArch
ce3ca5ec278fc55b79491e3e3805957707e16b5d,6,135,119,16,0,0,0,3,21,66,1,2,1.177435342,930,779,5,68,59,9,6318,6099,219,23,23,0,1,100,NoArch
a2c5df682f143a82fb726c1a556cfca35f0b1b47,4,351,2,349,2,0,2,1,2,2,1,2,1.160597612,173,48,10,43,13,30,3352,1140,2212,27,9,18,1,99.68465962,NoArch
9101588c917614dc5ff9c589a7bb935042236d0b,11,30,22,8,0,0,0,2,26,150,1,6,3.144480768,1471,780,6,120,120,0,7927,7778,149,71,71,0,1,90.40776001,Arch
d4d72203893ecada27dce2594b290f00462ca3cf,2,6,42,36,0,1,1,1,2,6,1,2,0.811278124,143,49,11,5,7,2,540,667,127,4,5,1,0,99.82431483,NoArch
cb143232cecdeb309609edca7d073da8855bf0c2,4,120,33,87,2,0,2,1,2,32,1,1,1.85960203,170,781,7,18,10,8,585,371,214,18,10,8,1,99.84118581,NoArch
b185cd5b34e9bddf5f7deac7c6af2032a1b37eb4,2,28,10,18,0,0,0,1,6,151,1,2,0.981940787,237,782,8,29,28,1,1265,1153,112,24,23,1,1,100,NoArch
3d44c1ee288700b0a5ffd8aaf2f734cf4315de99,49,206,436,230,0,1,1,1,30,129,4,33,4.254135222,6926,783,9,648,671,23,32150,32921,771,305,311,6,0,99.55830389,NoArch
a8689591e32c8c27d74f3b0caad34e42eea1af70,3,37,43,6,0,0,0,5,28,130,2,2,1.550999017,1288,784,10,213,211,2,7563,7504,59,92,91,1,1,100,NoArch
d0dbdfb7bb33326e6157cc69c0292a40dee1d10a,6,476,18,458,4,0,4,1,7,16,1,1,2.129714435,883,785,11,134,109,25,6709,3861,2848,39,30,9,1,94.82791405,Arch
5626e10584e3c29614aea84985f2d07daf9ce899,1,27,10,17,0,0,0,3,37,50,1,1,0,346,786,12,54,49,5,1749,1704,45,22,22,0,0,100,NoArch
c3dfffa3f5b9d7cc060289aeaf4e980d5e1d6e42,0,0,0,0,0,0,0,0,0,0,0,0,0,0,787,13,0,0,0,0,0,0,0,0,0,1,100,NoArch
e4cf2c733d38e11277c933701e7cb496e419cb14,1,5,0,5,0,0,0,2,8,547,1,1,0,71,788,12,7,6,1,276,263,13,6,5,1,0,100,NoArch
e3fb0c4f3162fda964b6ad8658fb09702bc279d2,28,1055,819,236,13,6,19,1,18,155,1,6,4.325903724,1406,50,3,136,136,0,9061,7800,1261,87,74,13,1,98.95384615,NoArch
a5ec598b63138a5243e4a5895b53614d12de3400,1,0,0,0,0,0,0,1,1,0,1,1,0,231,51,4,25,25,0,1208,1208,0,14,14,0,0,99.91820041,NoArch
91ff58708329ef6112e218458a7a36746fa91cdf,1,1,1,0,0,0,0,6,54,43,1,1,0,302,52,5,20,20,0,1853,1853,0,3,3,0,1,100,NoArch
e43db6158f5cb97b2c67081144cece74153ab79f,6,43,51,8,0,0,0,1,28,25,1,3,2.375677881,1184,53,6,110,109,1,5940,6012,72,57,56,1,0,100,NoArch
e4dfc93f53c1fa923803e0dac96274f0351bcd6d,14,80,68,12,0,1,1,5,29,191,2,7,3.380264019,4279,789,11,683,675,8,27565,27411,154,294,288,6,0,99.8566455,NoArch
82fb4016fa0c002a8753dc6f72b010da7122939d,6,17,16,1,0,0,0,3,24,66,2,5,2.484872048,1143,790,12,110,110,0,5733,5722,11,47,47,0,0,100,NoArch
b04eb0ed363ea438b498325bf0799f3fcc21dcd7,3,12,12,0,0,0,0,1,34,54,2,3,1.384431504,650,791,13,45,45,0,3541,3541,0,19,19,0,0,100,NoArch
b722041e31c83db3935256bec94ed4c8120e7f1a,18,1179,0,1179,18,0,18,1,1,0,1,2,4.022130603,0,792,14,57,0,57,5068,0,5068,45,0,45,1,97.84812746,Arch
183fa8faea7b4011ab93025a2696aa1a380f1bf5,1,2,2,0,0,0,0,1,2,97,1,1,0,215,793,14,25,25,0,1149,1149,0,9,9,0,1,100,NoArch
a515335bbe063f612c9c09b1e0360cc5848ad396,10,1187,74,1113,4,0,4,4,16,77,2,3,2.614575422,1346,794,14,250,126,124,13444,7071,6373,117,62,55,1,92.42097701,Arch
23722bcc7103b2253c1216aed934fa78271d3c64,14,44,40,4,0,0,0,2,24,31,3,9,3.371184769,2442,795,14,214,214,0,14978,14932,46,82,82,0,1,100,NoArch
69e3a649a0580f0c02536fdb9a6a79a82821475f,7,618,2,616,5,0,5,6,32,42,2,7,2.087703267,838,54,4,208,165,43,8540,4550,3990,87,59,28,1,92.69521411,Arch
856f9dfc4804fde5aaccd125e82cd3bb596a3380,2,0,310,310,0,2,2,2,8,546,1,2,0.448204261,310,796,8,0,33,33,0,1097,1097,0,19,19,1,99.91604869,NoArch
ccafd1a85c81a7fda05582f7149fda5d67c653ba,1,1,1,0,0,0,0,2,3,120,1,1,0,201,797,8,22,22,0,1477,1472,5,3,3,0,1,100,NoArch
7c72dc4fe3d80a30d6daa9dc8b20973a176580b4,5,62,37,25,0,0,0,3,88,262,2,3,1.195863804,1172,370,0,128,126,2,6250,6018,232,49,49,0,1,100,NoArch
f580dbfeaab498faad78ac0314089d511caf9b28,1,97,0,97,1,0,1,1,1,0,1,1,0,0,371,1,17,0,17,505,0,505,8,0,8,1,98.88532813,NoArch
63ccd5ab86f1b53b0ac780c678c7567a1471d95e,1,35,27,8,0,0,0,3,3,123,1,1,0,139,372,2,18,16,2,1186,1071,115,3,3,0,0,100,NoArch
d10f7096b9decc15cad55f4d7fd46b4feb7bb88c,0,0,0,0,0,0,0,0,0,0,0,0,0,0,373,3,0,0,0,0,0,0,0,0,0,1,100,NoArch
136942055bacc2a3d1db40f8654ec96391937080,2,26,5,21,0,0,0,4,10,66,2,2,0.770629069,486,374,4,78,75,3,2717,2500,217,55,54,1,0,100,NoArch
efa490c12b86034a26c9534dd6c9459550da2e5e,3,388,0,388,3,0,3,1,1,0,1,2,1.578216141,0,375,5,35,0,35,2741,0,2741,9,0,9,1,99.71002486,NoArch
e55ec3c0157b794e9d9058b974db50b19c8843e0,5,328,89,239,2,0,2,1,2,0,1,2,2.230903686,388,376,6,52,35,17,4248,2741,1507,15,9,6,1,98.9701897,NoArch
d54c89bbfba59792741d052b7ea94cd2e93ae1d8,4,55,36,19,0,0,0,4,83,243,2,4,1.333860854,1187,798,9,155,148,7,5880,5750,130,56,53,3,0,100,NoArch
68f00b01edd76acb20a8bb0fbb1e43070c1bfab4,11,112,79,33,0,0,0,2,84,233,3,7,3.224976122,4327,799,10,571,559,12,19927,19741,186,269,259,10,1,100,NoArch
b59e46855e589f31a5a6e831a90beeed34e03c89,25,181,242,61,0,0,0,3,44,36,3,14,3.44093857,3442,800,11,343,349,6,18832,19395,563,158,158,0,1,93.23092945,Arch
42fab8a4b13e8bbc3c675741d846eebd44900149,1,7,4,3,0,0,0,4,22,305,1,1,0,284,801,6,47,47,0,1262,1264,2,29,29,0,0,100,NoArch
032d3ac2a35c77b5eb29e76a3cbbde6d85cc1707,7,328,199,129,0,0,0,2,64,127,2,3,2.206170872,1570,165,0,146,140,6,9079,8231,848,57,55,2,1,100,NoArch
7da117daf6873ce275cf9b6bba58e45ecc33733b,1,12,3,9,0,0,0,2,3,147,1,1,0,83,802,6,3,3,0,491,512,21,2,2,0,1,100,NoArch
3e720bc9cbafc163018f92695c374ca004cc13f7,0,0,0,0,0,0,0,0,0,0,0,0,0,0,803,7,0,0,0,0,0,0,0,0,0,1,100,NoArch
ce3ac7947f5425437f449ee57205c124391cbded,1,458,0,458,1,0,1,1,1,0,1,1,0,0,804,8,55,0,55,2887,0,2887,29,0,29,1,99.97464503,NoArch
3894b57af0239b00c82284d9d268acefa81c0461,2,1,5,4,0,0,0,2,6,227,1,2,0.650022422,361,805,9,30,30,0,2376,2382,6,6,6,0,1,100,NoArch
62fdbb9e6323c4688fdbcc240a26beaa7c7d9736,0,0,0,0,0,0,0,0,0,0,0,0,0,0,806,10,0,0,0,0,0,0,0,0,0,0,100,NoArch
a36831c085d42aedc28553106fa52082fe0adf32,0,0,0,0,0,0,0,0,0,0,0,0,0,0,807,11,0,0,0,0,0,0,0,0,0,1,100,NoArch
7cd73f5662f19c4b2f007d6c6ebe51d51d97158b,0,0,0,0,0,0,0,0,0,0,0,0,0,0,808,7,0,0,0,0,0,0,0,0,0,1,100,NoArch
ac6bab2209fd5cd203a29dd8be19c1097305e841,1,12,3,9,0,0,0,1,3,86,1,1,0,209,809,7,20,20,0,1327,1260,67,6,6,0,0,100,NoArch
bbe149d4a79b85222f4a88cabb487dd99e0affb2,0,0,0,0,0,0,0,0,0,0,0,0,0,0,377,0,0,0,0,0,0,0,0,0,0,1,100,NoArch
3088f5893b228dbbcccf0a8bfad7f2d06c6153c6,1,3,0,3,0,0,0,2,10,210,1,1,0,125,810,2,11,12,1,761,796,35,6,7,1,0,100,NoArch
df391cadef65a655268873822bb32fdb8be93951,1,5,0,5,0,0,0,1,2,65,1,1,0,458,811,3,55,55,0,2919,2887,32,29,29,0,0,100,NoArch
e10506d9cba0e4676a901836f0931ee0c7846c8e,1,4,6,2,0,0,0,2,5,359,1,1,0,188,812,4,16,16,0,893,886,7,6,6,0,1,100,NoArch
ec1110272a81664a92cdd3d7916551a2565e3b43,1,3,0,3,0,0,0,3,5,100,1,1,0,324,813,5,45,45,0,2005,1999,6,18,18,0,1,100,NoArch
5f76b2ae7567970adac579e34168cb18561aa847,0,0,0,0,0,0,0,0,0,0,0,0,0,0,814,5,0,0,0,0,0,0,0,0,0,1,100,NoArch
48612cb8a4081a4c70e78fb84a255a59041f021e,2,18,2,16,0,0,0,3,6,95,1,2,1,362,815,6,44,42,2,2881,2835,46,6,6,0,1,100,NoArch
cc8070905f4a9556fdd54cb7e9cf9ecc2c898d95,1,13,4,9,0,0,0,2,3,966,1,1,0,57,816,6,5,3,2,231,195,36,2,2,0,1,100,NoArch
3a16b20f8ea42778d4203e789329c178f51432a6,5,17,13,4,0,0,0,1,6,313,2,4,1.238826429,720,161,0,73,73,0,2874,2838,36,46,46,0,1,99.89873418,NoArch
318a0e8861b658726e4a4dba114a84e7a26a41c6,1,52,42,10,0,0,0,4,11,434,1,1,0,154,55,0,14,10,4,1079,962,117,9,7,2,1,100,NoArch
c864d1f3ddce6ed42bc0b6871398462b77e9d58b,0,0,0,0,0,0,0,0,0,0,0,0,0,0,378,0,0,0,0,0,0,0,0,0,0,1,100,NoArch
05abdd6a1e0bd90ed1c13d055ac228dfc8a59969,2,197,0,197,2,0,2,1,1,0,1,1,0.999089039,0,817,7,20,0,20,930,0,930,15,0,15,0,99.72141319,NoArch
0b12c1c7c783aa74c37cc568686d3a126a3fb479,0,0,0,0,0,0,0,0,0,0,0,0,0,0,818,8,0,0,0,0,0,0,0,0,0,0,100,NoArch
12659e1be565572466d20780a0f91c6b791cc7ea,2,47,4,43,0,0,0,1,4,206,1,1,0.999722648,166,819,3,16,14,2,1095,871,224,6,4,2,0,99.8733536,NoArch
b7b518c5a85841b8019de3cd0b99804abfd6508b,2,10,0,10,0,0,0,4,30,440,1,1,0.721928095,1128,162,1,149,148,1,4439,4410,29,61,60,1,1,100,NoArch
21779d890a7c11002493849f62760e73287b5c9e,6,863,0,863,6,0,6,1,1,0,1,2,2.416751086,0,163,2,91,0,91,3245,0,3245,71,0,71,1,99.78548896,NoArch
1593176db998dc5c62017c61c4d5c8f86de24cd3,1,2,2,0,0,0,0,5,21,175,1,1,0,654,164,3,109,109,0,5304,5302,2,58,58,0,1,100,NoArch
9bdd41d9bdc60ad1f6d48671b1a341c33f02b8a7,1,1,1,0,0,0,0,3,8,1018,1,1,0,289,165,4,31,31,0,2412,2412,0,14,14,0,1,100,NoArch
5212d25bd0b371bd2fab261d8bcf722b3eb0b50e,2,28,15,13,0,0,0,3,8,535,1,1,0.952265625,881,166,5,154,154,0,5139,5139,0,16,16,0,1,100,NoArch
528ffcd080419a6fd5edcaa49490bb5c2260a1aa,50,193,304,111,0,0,0,4,33,332,4,23,4.838155552,12984,167,6,1625,1650,25,70078,70506,428,800,812,12,1,99.89939638,NoArch
15a7014e889513e9c4e6470a227b97dfc90559d5,4,40,39,1,0,0,0,1,32,88,2,2,1.546694865,1412,168,7,225,228,3,6585,6657,72,113,116,3,1,100,NoArch
95f836bfb22663dee1ee109512fb202b7932ecbd,33,592,542,50,1,0,1,4,33,190,2,14,3.461316379,7951,169,8,1151,1145,6,43542,44125,583,564,559,5,2,99.97485542,NoArch
b35c86bf5ee4b773e7cfb5a57de449fa4a828660,1,4,0,4,0,0,0,3,6,1,1,1,0,33,170,9,4,3,1,119,110,9,2,1,1,1,100,NoArch
33414e645ee7135176fd2dd66af19b90f0df8716,5,108,26,82,1,0,1,1,7,108,1,3,1.582980423,1027,171,10,166,152,14,6511,5802,709,72,70,2,1,99.96231156,NoArch
ffc7fabb57ecb08220e53ceaafc6ac8b4d665860,22,2523,576,1947,9,0,9,1,16,79,1,4,3.826415663,3445,9,0,547,384,163,26265,18250,8015,214,139,75,1,97.39422431,Arch
80cfd1c4a99eaa250d52655daed9dd856f139e1e,2,28,1,27,0,0,0,4,55,246,1,2,0.79732651,373,379,0,32,29,3,2372,2202,170,9,8,1,1,99.98556165,NoArch
020e3bede9efc69833fb01402bc97870420bf85a,1,1,1,0,0,0,0,3,4,197,1,1,0,297,380,1,29,29,0,1864,1860,4,11,11,0,0,100,NoArch
845cbcdd860ee1aa8817259b9b6a5415a5196275,64,1798,2679,881,18,28,46,6,56,258,3,23,5.329888098,6950,56,0,557,615,58,35840,38302,2462,261,300,39,1,96.27238039,Arch
4e64e04a1c742f9499710e5877218b79cb5194ba,7,10,10,0,0,0,0,1,2,0,1,1,2.721928095,265,57,1,20,20,0,833,833,0,18,18,0,1,100,NoArch
b70621d756f234598f69deb9bef1c029ad770938,6,118,161,43,0,2,2,2,57,98,1,4,2.040437309,1227,58,2,82,79,3,7516,7540,24,30,30,0,1,99.92535085,NoArch
3a38fb9d8c58bb5be7e2a9899788085812441b8e,1,6,1,5,0,0,0,4,25,292,1,1,0,206,381,2,32,30,2,1205,1180,25,7,7,0,1,100,NoArch
798b6a5cc23fa33ac166b8993361e674b3620124,0,0,0,0,0,0,0,0,0,0,0,0,0,0,382,3,0,0,0,0,0,0,0,0,0,1,100,NoArch
89720ce9c41fa68367826b482832cec7570579bc,1,7,5,2,0,0,0,2,5,171,1,1,0,859,820,1,108,106,2,4175,4148,27,38,38,0,1,100,NoArch
7fa228fcaa75178c75c819436abd6e4c1dd55a1a,1,0,3,3,0,0,0,2,7,149,1,1,0,273,821,2,24,25,1,2011,2017,6,2,3,1,1,100,NoArch
b58213b267ed7efaf9c148df68cf953d423a973a,0,0,0,0,0,0,0,0,0,0,0,0,0,0,822,3,0,0,0,0,0,0,0,0,0,1,100,NoArch
250edf36cd6bc9c3cb3e6332b42ae451a9251f48,0,0,0,0,0,0,0,0,0,0,0,0,0,0,823,4,0,0,0,0,0,0,0,0,0,0,100,NoArch
c3496d1b4a5a3012d546e73079a07a137788a5c6,34,1264,776,488,8,7,15,1,30,85,1,12,4.094214691,3138,59,3,336,305,31,19122,18262,860,225,196,29,1,89.12589499,Arch
adab9e7a3f8267410330c1e9f43d6606fdcb8c07,3,46,2,44,1,0,1,2,8,244,1,2,0.74299334,396,824,5,22,20,2,1957,1818,139,8,7,1,1,99.97022037,NoArch
4a8d35ee89f9ead3854fd2c79af7b299b57cf2d4,1,2,3,1,0,0,0,2,6,214,1,1,0,70,825,6,5,5,0,386,367,19,2,2,0,1,100,NoArch
434b9936259ff00ac6772cbd0970e7dd1e24e24f,1,2,1,1,0,0,0,2,5,237,1,1,0,73,826,7,6,6,0,365,363,2,4,4,0,1,100,NoArch
e498621f5a46872ffd60bf757b96a616e73ffffc,0,0,0,0,0,0,0,0,0,0,0,0,0,0,827,8,0,0,0,0,0,0,0,0,0,1,100,NoArch
5a76e5354e70ee63b7b3b92862155ced2ae7030c,1,11,8,3,0,0,0,5,34,42,1,1,0,719,828,8,150,149,1,3788,3766,22,61,61,0,0,100,NoArch
149941141dcc05cd92c154139ad04c2d4529bc2a,111,536,346,190,0,0,0,2,58,194,4,61,5.936307559,24638,829,9,2742,2734,8,127343,127589,246,1242,1238,4,0,95.00765697,Arch
0d4e2bc1901f7ee67254dc562695ff8a6e2e3b87,0,0,0,0,0,0,0,0,0,0,0,0,0,0,830,10,0,0,0,0,0,0,0,0,0,1,100,NoArch
7773abc1f63d878327ffcfb306081eb051e1f647,0,0,0,0,0,0,0,0,0,0,0,0,0,0,831,11,0,0,0,0,0,0,0,0,0,1,100,NoArch
307a198b9cf7262d06fda40045980a7155a69ca7,2,5,3,2,0,0,0,1,2,314,1,1,0.811278124,701,832,12,46,46,0,3823,3803,20,17,17,0,0,100,NoArch
6d94195a79b36e1ec0968a28a93c6c0e3462f13f,1,2,1,1,0,0,0,6,59,8,1,1,0,279,833,13,18,18,0,1725,1718,7,3,3,0,0,100,NoArch
1dd5ff1cc735f41369df6208dd55fe38670f4b1f,1,2,0,2,0,0,0,2,6,220,1,1,0,231,60,4,30,30,0,1931,1922,9,6,6,0,0,100,NoArch
765834c377d7283cc4243dc91d682dc2aab98040,6,18,1,17,0,0,0,2,6,435,1,1,2.31345975,598,834,14,35,35,0,3053,2954,99,22,22,0,1,100,NoArch
7be37c082b016c9477955e14462ac4c335f50d2b,2,7,2,5,0,0,0,4,10,16,1,2,0.764204507,858,10,0,63,62,1,3224,3208,16,25,24,1,1,100,NoArch
a8be9be983ec747145ca34aa094dd4594c8ab6b7,2,7,8,1,0,0,0,4,7,11,1,2,0.996791632,500,11,1,37,37,0,2374,2372,2,19,19,0,1,100,NoArch
db304a20982e8665a365226b7e007867444cab6d,0,0,0,0,0,0,0,0,0,0,0,0,0,0,835,15,0,0,0,0,0,0,0,0,0,1,100,NoArch
b8a553b5a1e7e58dc27a47d4860b7f8106a566d7,1,1,1,0,0,0,0,3,10,24,1,1,0,470,12,2,33,33,0,2270,2270,0,12,12,0,0,100,NoArch
c06c89ae80b6279ffe78156ddc650e329bcb6441,1,3,1,2,0,0,0,4,25,78,1,1,0,295,61,2,27,26,1,1669,1661,8,17,17,0,1,100,NoArch
f4009bfed0f76c9674bccfa06bdff8cd65a41c36,0,0,0,0,0,0,0,0,0,0,0,0,0,0,836,12,0,0,0,0,0,0,0,0,0,1,100,NoArch
bd654ca4fa9311d3a4b9db83642cbb11318c7c1e,8,208,129,79,0,0,0,3,60,343,2,4,1.652676734,1861,166,0,127,119,8,11204,10468,736,72,69,3,1,94.57981881,Arch
7c0da9029832e3e1f2e5313cdd7e42cbff541e04,5,53,216,163,0,1,1,2,7,138,1,2,1.954965711,596,837,9,29,42,13,2261,3255,994,18,27,9,1,99.87618016,NoArch
4cad7a0d9da8f4626a15f895db1e2e27ef68e2dd,9,21,17,4,0,0,0,2,4,50,1,2,3.109549067,720,62,2,65,64,1,4085,4062,23,38,39,1,0,100,NoArch
ff23ffd05bc364ca91e84a9390a53673775c8299,1,25,5,20,0,0,0,8,42,334,1,1,0,497,838,8,56,53,3,3520,3419,101,16,15,1,1,100,NoArch
b0ccf74e0596e678c5d13cb065b3169d206edb36,10,122,22,100,1,0,1,3,89,312,3,9,2.410109021,3604,839,7,238,234,4,21563,20762,801,97,94,3,1,99.96904983,NoArch
971a56d1d6ea40cbc1505594baeb0685c63cb659,21,34,30,4,0,0,0,2,26,448,3,15,4.246268266,3973,840,7,442,442,0,20665,20705,40,155,155,0,0,100,NoArch
790e703706c7f0e9776bf40c76b1810fd565d669,5,36,131,95,0,0,0,4,35,76,1,1,2.201397732,1859,841,8,326,350,24,8270,8878,608,161,167,6,1,100,NoArch
437d9189078a12efee99d52e51b5018e1786c7ca,6,342,25,317,1,0,1,1,9,746,1,3,1.913692364,425,842,9,53,27,26,4443,2057,2386,43,20,23,1,100,NoArch
94f64e6128ae3ba6bf3a76987b43e48e738141f7,5,305,4,301,2,0,2,3,24,196,1,4,2.012748075,398,843,9,88,53,35,4437,2205,2232,43,30,13,1,99.76830399,NoArch
aa4cabef42a30a3e8965e7519dde93fc977256a6,0,0,0,0,0,0,0,0,0,0,0,0,0,0,172,0,0,0,0,0,0,0,0,0,0,1,100,NoArch
e3f0b7ddf09cdd53d5dc4fdc5785cf852dc52cb5,0,0,0,0,0,0,0,0,0,0,0,0,0,0,173,1,0,0,0,0,0,0,0,0,0,0,100,NoArch
f76674786c4b7a31bfa5e8743a15056220c919c5,0,0,0,0,0,0,0,0,0,0,0,0,0,0,174,2,0,0,0,0,0,0,0,0,0,1,100,NoArch
07513b859baff21f3ff5a4ad309e4bdaa8fe25c8,0,0,0,0,0,0,0,0,0,0,0,0,0,0,383,0,0,0,0,0,0,0,0,0,0,0,100,NoArch
7809d0489a2b342f718ef62317f04ae03c1e8399,0,0,0,0,0,0,0,0,0,0,0,0,0,0,384,1,0,0,0,0,0,0,0,0,0,0,100,NoArch
ea9726767b108495f49448bdd6be05297f10fce5,0,0,0,0,0,0,0,0,0,0,0,0,0,0,385,2,0,0,0,0,0,0,0,0,0,0,100,NoArch
29a7f38810270fa45a17bdf2418c896c1594d43c,45,2685,966,1719,24,1,25,1,31,57,3,21,4.301135855,3937,386,3,552,485,67,30808,24051,6757,227,203,24,1,93.29430548,Arch
819cc97c0b37cb4855a6f40b9a9fedbe8b4375b4,4,18,13,5,0,0,0,3,20,933,2,3,1.593613552,579,25,0,32,31,1,3021,2985,36,14,14,0,0,99.45595555,NoArch
8ca83b1fd2fb101f21e5af7d471ba334420e84cd,1,22,16,6,0,0,0,3,16,479,1,1,0,212,26,1,24,23,1,1120,1100,20,8,8,0,1,100,NoArch
8193b05cccacabbcbd2a90fa5730ac7086261a2e,1,1,1,0,0,0,0,1,2,6,1,1,0,130,387,4,15,15,0,952,952,0,3,3,0,1,100,NoArch
5c5a93d7795a802f6baf7ac2793a6734ed79e640,1,1,1,0,0,0,0,6,23,9,1,1,0,234,388,5,42,42,0,1176,1174,2,7,7,0,0,100,NoArch
c70f4c1990c94bc42c4630f4bcb91dec68912d2c,0,0,0,0,0,0,0,0,0,0,0,0,0,0,389,6,0,0,0,0,0,0,0,0,0,1,100,NoArch
ac83cf3753a1948364de2d1639aa8aeb2c5c76dc,27,52,2221,2169,0,13,13,3,22,727,2,7,4.120994075,4441,27,2,165,335,170,10810,21012,10202,90,166,76,1,94.69960278,Arch
3b9f63579a691838d8e8eec7af33f6f255f4dbdf,5,37,11,26,0,0,0,1,6,20,2,3,2.071577939,703,390,7,60,59,1,4741,4487,254,14,14,0,1,100,NoArch
5e191d93a23eb403d7bdee731d51be352957a6d9,1,8,1,7,0,0,0,3,7,23,1,1,0,262,844,3,36,35,1,1508,1439,69,17,17,0,1,100,NoArch
4194a28a7fd44438f0277c55deff67509bb9fcc4,131,743,590,153,0,1,1,2,90,196,4,75,6.106886538,27095,845,3,2988,2972,16,137002,137074,72,1314,1288,26,0,96.76299144,Arch
763c94cac94ada5120cee0cd76fae21ebbff0a14,20,83,134,51,0,0,0,2,60,293,3,14,3.621282836,4730,846,4,373,374,1,31306,32225,919,118,118,0,1,99.24225029,NoArch
f56404ad6131bd06e10b57064a1795bedce39ee0,1,1,1,0,0,0,0,6,61,6,1,1,0,280,847,3,18,18,0,1727,1725,2,3,3,0,1,100,NoArch
189ac5985d1e01e6c24fdab1bd4dd607003ccbd1,1,4,1,3,0,0,0,6,62,1,1,1,0,280,848,4,19,18,1,1744,1727,17,3,3,0,0,100,NoArch
8b71fc0e7b98e5f885ef1d9b7b403b3caa586210,2,2,2,0,0,0,0,3,18,225,1,1,1,275,167,0,27,27,0,1706,1704,2,12,12,0,1,100,NoArch
4199e60a704c5f3b615ca3e04a02ae57f9242384,0,0,0,0,0,0,0,0,0,0,0,0,0,0,168,1,0,0,0,0,0,0,0,0,0,0,100,NoArch
45a3cc11f74c55367151878f702cda504d9794e1,1,9,4,5,0,0,0,2,5,601,1,1,0,75,169,2,10,9,1,369,320,49,7,7,0,1,100,NoArch
08734219ddb27516e4cefcf79f213d66e86dd046,2,10,9,1,0,0,0,3,8,489,1,2,0.949452015,395,170,3,39,39,0,2812,2812,0,30,30,0,1,100,NoArch
31f5a5f46c56ff29796302014b71ae2f11c4ad71,0,0,0,0,0,0,0,0,0,0,0,0,0,0,849,5,0,0,0,0,0,0,0,0,0,1,100,NoArch
f5ac4584c8600b8c02bf6d632ea9471436137816,0,0,0,0,0,0,0,0,0,0,0,0,0,0,850,6,0,0,0,0,0,0,0,0,0,1,100,NoArch
4bfa8ebab936c8f524394bda3fcb738a7a1f5858,1,1,1,0,0,0,0,4,34,544,1,1,0,171,171,4,27,27,0,675,668,7,24,24,0,0,100,NoArch
dbf9bd37c7917dbfe4c594d6ea46179386d13141,4,27,18,9,0,0,0,2,12,637,1,4,1.429228244,471,851,7,40,40,0,2862,2859,3,34,34,0,1,100,NoArch
93c7800834e57506bcfb5372a50764ff846cbb1c,1,55,48,7,0,0,0,5,35,110,1,1,0,722,852,8,150,150,0,3780,3788,8,61,61,0,1,100,NoArch
e107bfa88bca9b7a39e440b59382ab0396b4f368,24,164,196,32,0,1,1,4,19,532,2,11,3.960129046,4471,28,1,439,440,1,21998,21808,190,171,174,3,1,99.95387986,NoArch
760aec883d24d08f633ba4d2c5525372290c6fc6,1,8,1,7,0,0,0,2,4,278,1,1,0,92,853,9,4,3,1,523,491,32,2,2,0,1,100,NoArch
083eb988e4bd6426e6aedc5b60d11a199300c715,11,25,41,16,0,0,0,4,18,3,2,5,2.720322838,2356,29,2,224,226,2,11190,11288,98,88,89,1,1,100,NoArch
5fc5b6505fe3b8aab755eb8225f73ba6a73b45ef,9,1436,0,1436,9,0,9,1,1,0,2,4,2.556817754,0,55,0,120,0,120,7633,0,7633,62,0,62,1,99.75848189,NoArch
5a5c3247ea619f3b83204ff3120f2532b1023e29,0,0,0,0,0,0,0,0,0,0,0,0,0,0,391,1,0,0,0,0,0,0,0,0,0,1,100,NoArch
ac89aa3c0417e92e0e970141fee14e3d2113ee18,2,42,2,40,0,0,0,2,6,810,1,2,0.773226674,193,392,1,17,14,3,1040,728,312,11,10,1,1,100,NoArch
202d376d2845c7bc05f78f5f4683b2123b9545d8,0,0,0,0,0,0,0,0,0,0,0,0,0,0,393,2,0,0,0,0,0,0,0,0,0,1,100,NoArch
95736dde4a5285f53dcfdae41dbcb9e00996d417,3,256,93,163,2,0,2,5,27,31,1,1,1.559220542,347,394,3,45,34,11,3180,2196,984,12,6,6,1,96.48046092,Arch
f533aefdc3562f578f16a6dd27bbe6a08a77d130,2,21,10,11,0,0,0,1,2,0,1,1,0.637387499,248,395,4,25,25,0,1664,1706,42,8,8,0,1,96.72811623,Arch
6c86257f784d8e142039d5d8ff3da260c739b662,4,34,3,31,0,0,0,5,28,261,2,2,1.564990805,571,396,5,52,47,5,3178,2964,214,26,23,3,1,96.75054972,Arch
fb65e8a329848d63886074e541395093a7a39eec,2,4,4,0,0,0,0,8,28,104,1,1,1,131,397,6,11,11,0,559,559,0,6,6,0,0,100,NoArch
230b8c5bc9afa9055db49b09692ac8dd076ea37f,0,0,0,0,0,0,0,0,0,0,0,0,0,0,398,7,0,0,0,0,0,0,0,0,0,1,100,NoArch
6fc9667f092addd03c9e5a98b5eabb6561e1c395,2,17,1,16,0,0,0,1,4,252,1,2,0.503258335,427,854,5,30,29,1,2409,2273,136,12,11,1,1,100,NoArch
215570df00da2a682f2109d85c5eab12b78b485e,1,2,1,1,0,0,0,2,9,433,1,1,0,178,63,0,23,23,0,1220,1215,5,8,8,0,1,100,NoArch
b2866979dfb1d9fc7bcf72905ccb29d5011612eb,1,9,8,1,0,0,0,2,6,596,1,1,0,116,399,8,11,11,0,702,702,0,2,2,0,0,100,NoArch
52ce4129a013933836b4bc6ba1bde282810f1959,64,230,230,0,0,0,0,1,1,0,2,17,5.66239905,8773,400,9,845,845,0,40471,40029,442,399,399,0,1,93.17496229,Arch
eecf9dbb97e691fada0c9f81f4a99e1949fce0cc,1,2,3,1,0,0,0,2,7,0,1,1,0,117,401,10,11,11,0,694,702,8,2,2,0,0,100,NoArch
dff4ef1a7c9420a664c441f49aa39652213a213c,1,1,0,1,0,0,0,2,8,0,1,1,0,116,402,11,11,11,0,694,694,0,2,2,0,0,100,NoArch
3a50c882374e89a285707600d1f9a17dfec5b327,3,109,1,108,1,0,1,1,9,119,2,3,1.073525684,287,403,12,43,33,10,2505,1975,530,21,17,4,0,99.94240295,NoArch
de69de1d385b4c64d1d710c869f79315944e45f5,2,21,7,14,0,0,0,4,15,80,1,1,0.940285959,429,404,13,39,37,2,2714,2601,113,24,23,1,1,100,NoArch
12379ec7bfc25014ce2bb46888e9617899e67cc5,3,3,6,3,0,0,0,3,10,541,1,3,1.435520504,438,405,14,32,32,0,2828,2867,39,21,21,0,0,100,NoArch
b2e119a79c3a8ce26de523982e9a0b168fc88bc7,1,32,0,32,1,0,1,1,1,0,1,1,0,0,406,15,4,0,4,332,0,332,1,0,1,1,99.95394888,NoArch
7ad6f1375acf47e7fdbcd812802081c11bb2645f,1,2,1,1,0,0,0,4,16,0,1,1,0,337,407,16,31,31,0,2200,2191,9,20,20,0,0,100,NoArch
e0ec7c1be9cf1141123b00841c9502e85f5ae426,167,8582,640,7942,61,0,61,2,91,137,4,86,6.201221739,21225,855,6,2740,2003,737,153904,119693,34211,1135,750,385,0,94.25974647,Arch
90d175e5a930b0081332ea1d2f079815fe846112,1,48,49,1,0,0,0,4,11,0,1,1,0,205,408,17,21,21,0,1140,1129,11,11,11,0,1,100,NoArch
bee7405746e85665cabb64201d6bb3547f633189,2,43,3,40,0,0,0,3,9,27,1,2,0.495969072,509,409,18,54,53,1,3515,3042,473,25,25,0,1,99.92534528,NoArch
d491f69bc2a6e2d0d369d84c03b46338fe886b42,61,0,8080,8080,0,61,61,3,23,0,1,17,5.601415886,8080,410,19,0,801,801,0,35540,35540,0,385,385,1,96.7468528,Arch
3988abddbc7abbf4c36b759cd88240fc8f553d2b,5,10,13,3,0,0,0,7,57,29,1,5,2.261996198,863,411,20,45,45,0,4646,4694,48,23,23,0,0,100,NoArch
807ad49c4b3fa4a4f558283cd4fa2d7d3cd9117d,1,15,16,1,0,0,0,2,5,3,1,1,0,152,412,21,19,19,0,842,842,0,6,6,0,1,100,NoArch
e410e34ddc9066e0a1b22f199c54b662fe9494e9,1,13,13,0,0,0,0,3,3,146,1,1,0,106,413,22,5,5,0,798,798,0,2,2,0,0,100,NoArch
509b443752e5099b7080abca9344f4ca98df55f4,1,64,62,2,0,0,0,6,63,49,1,1,0,283,414,23,19,19,0,1744,1744,0,3,3,0,0,100,NoArch
1b0d9ee637273bdd884c544b3694e4a6a073b7dc,1,10,18,8,0,0,0,6,16,437,1,1,0,76,415,24,1,2,1,343,409,66,1,2,1,0,100,NoArch
3ba87c8695c8c8b00a7ebc5fdb916e62c541ad7c,1,23,20,3,0,0,0,3,4,58,1,1,0,136,416,25,8,8,0,1060,1060,0,3,3,0,0,100,NoArch
b4e428cfe2f47566ffffd62824dfbdfdd4e0918e,1,8,7,1,0,0,0,3,22,190,1,1,0,322,417,26,40,40,0,1253,1253,0,27,27,0,0,100,NoArch
81d64c0977a896c40e582d80724501bfd9c694dc,23,600,1462,862,5,7,12,3,33,122,3,9,4.024071215,3041,64,1,219,329,110,12402,17579,5177,93,158,65,1,99.26671638,NoArch
ca18680aa892900773be3440a58f2cd63aaf7b44,6,594,79,515,1,0,1,1,26,180,2,5,1.583635651,901,856,4,177,110,67,8870,5946,2924,71,39,32,1,99.93815708,NoArch
8ad8d96cb41120e5278ade09437d91f5120291e0,1,4,3,1,0,0,0,3,22,638,1,1,0,553,418,27,76,76,0,2481,2481,0,56,56,0,0,100,NoArch
8bee08594605e6ddb4bb8d3a658463f534533950,0,0,0,0,0,0,0,0,0,0,0,0,0,0,419,28,0,0,0,0,0,0,0,0,0,1,100,NoArch
f23eb85caa05801f978f54799abfffc0047a385a,1,149,0,149,1,0,1,1,1,0,1,1,0,0,857,5,21,0,21,859,0,859,8,0,8,1,99.95055013,NoArch
fd0d1951e1b6737f249b27070966c917ca4309c5,2,0,231,231,0,2,2,2,13,330,1,2,0.863120569,231,858,6,0,37,37,0,1118,1118,0,7,7,0,97.95503468,Arch
faa82ce3719898058da06a1d7b0948bf326968eb,11,630,91,539,6,0,6,1,34,21,1,3,3.107256033,1316,420,29,163,131,32,9577,6911,2666,65,48,17,1,98.77628212,NoArch
4688b73ba9d99e0dc77367a62f5d7e4b36c8cc72,1,104,146,42,0,0,0,4,14,61,1,1,0,214,421,30,14,14,0,1084,1642,558,4,3,1,0,100,NoArch
070cf44cb72d3034e4098db6fd8a22d17de28260,0,0,0,0,0,0,0,0,0,0,0,0,0,0,422,31,0,0,0,0,0,0,0,0,0,0,100,NoArch
f1a7de436bb6098e8c51991f00f84802b17b6527,1,11,8,3,0,0,0,5,14,156,1,1,0,151,423,32,10,10,0,992,992,0,8,8,0,0,100,NoArch
2e4d30660950bea4610036917d108079c0bcb887,16,740,9,731,13,0,13,1,35,7,2,5,3.690875607,941,424,33,142,81,61,7404,4069,3335,79,50,29,1,99.6693686,NoArch
baa3a8c60a51a8d41ab20ebf04f3cc86636a0be7,5,182,156,26,0,0,0,1,6,278,1,2,1.031571822,736,859,6,58,57,1,4637,4275,362,22,21,1,1,100,NoArch
2736bc5c58f71c2fa863ff64bf61b3960c122b86,10,78,56,22,0,0,0,3,92,15,3,8,3.231604206,3762,860,6,333,322,11,20896,20786,110,118,118,0,0,100,NoArch
1dc03a53897010623429fd5b63b4af8f7368db22,1,1,1,0,0,0,0,7,68,1,1,1,0,521,861,7,37,37,0,2920,2920,0,13,13,0,0,100,NoArch
3631151aa02e5df237b4f20be673d6fc5d299cef,6,342,76,266,1,0,1,1,11,79,2,5,1.82920249,830,65,2,94,72,22,7242,5381,1861,50,36,14,1,98.87744593,NoArch
d317c1cbd78b0d0b06464010f52a057f29eff554,4,156,5,151,1,0,1,1,11,6,3,3,0.552212625,554,66,3,52,41,11,4647,3656,991,25,24,1,1,99.93010484,NoArch
cdafd91b26b2049b69717085074dc4ee6fb61a30,1,6,6,0,0,0,0,5,15,212,1,1,0,166,425,33,13,13,0,1145,1133,12,7,7,0,0,100,NoArch
467fe17a305c5347fdd9c5c0ac7823043a9ac3d9,0,0,0,0,0,0,0,0,0,0,0,0,0,0,426,34,0,0,0,0,0,0,0,0,0,0,100,NoArch
8771d8921483ba202cd44f58b33f770f489c0f1c,1,4,4,0,0,0,0,2,3,82,1,1,0,101,427,35,8,8,0,451,446,5,5,5,0,0,100,NoArch
efb7b638eb4329ba86a8bdfb6a1b73b5d1ebeb14,2,161,1,160,1,0,1,1,26,231,1,2,0.095970403,212,428,36,63,42,21,2469,1304,1165,12,5,7,1,99.98003594,NoArch
8a2c0f3e24424e533b253b7110615c2ce75b043e,5,464,124,340,4,0,4,5,30,5,1,1,2.185647041,266,429,37,37,20,17,3487,1516,1971,11,4,7,1,95.25024969,Arch
4b2c5d37e9c6fb4636d3c931da168b6e143c88d8,3,16,3,13,0,0,0,1,27,627,1,2,0.953013885,431,862,8,65,63,2,2812,2770,42,20,20,0,2,100,NoArch
9f6eb59b2669888d4dd65b6d512701add7ebb9b5,1,19,21,2,0,0,0,2,2,0,1,1,0,160,863,9,21,21,0,1079,1165,86,7,7,0,0,100,NoArch
c8143391050e7137a405691c59e3848e3086ff3b,1,41,0,41,1,0,1,1,1,0,1,1,0,0,430,38,3,0,3,337,0,337,1,0,1,1,99.97503121,NoArch
d2dd88487f4bcc1972f25d71e74afd4940b7398b,2,23,9,14,0,0,0,4,18,368,1,1,0.997180399,702,431,39,64,62,2,4380,4311,69,24,24,0,0,100,NoArch
1ead5ae9809a2048c27a6af02dd59e12fce03f87,3,22,6,16,0,0,0,4,19,254,1,1,1.185616163,682,432,40,62,60,2,4320,4249,71,24,24,0,0,100,NoArch
128e3bed08b5b34d82f1154d101863fc57d30e04,1,2,3,1,0,0,0,1,2,2,1,1,0,147,433,41,8,8,0,1001,1009,8,4,4,0,0,100,NoArch
08e65f66279f03caaa46f789f20d17d1db36c78f,35,480,2691,2211,1,20,21,2,64,125,1,17,4.735988655,4750,67,4,206,421,215,15104,27293,12189,105,256,151,1,89.47685813,Arch
5ee07e316a372e81bae135153c1157c2ef276562,3,92,4,88,1,0,1,2,17,0,1,2,0.621944646,547,68,5,80,79,1,3150,2634,516,49,48,1,1,99.96190476,NoArch
aad970c9d687fe802709380583b76cf9bf1d19d9,2,0,185,185,0,2,2,1,2,180,1,1,0.967700682,185,69,6,0,24,24,0,661,661,0,20,20,1,99.92378049,NoArch
d8629d6c29daf985e5b0c4c8aa179355a90be9b2,1,2,1,1,0,0,0,2,4,0,1,1,0,197,70,7,13,13,0,1384,1380,4,8,8,0,1,100,NoArch
2f7f0dc0cfd8c31e4cfa54f397866b66c6dc2d21,3,22,4,18,0,0,0,3,22,309,1,2,1.300194643,674,864,10,59,54,5,4308,4187,121,27,26,1,1,100,NoArch
bea695ddeee7f54b7128bc916442385bb02f0a5e,2,44,6,38,0,0,0,2,32,659,1,1,0.981453895,1111,865,11,168,158,10,6295,5972,323,53,51,2,1,100,NoArch
330250d36b0308c6b49975cf0f9065466e07aef9,2,2,2,0,0,0,0,3,39,366,1,1,1,679,866,11,99,99,0,3212,3216,4,46,46,0,0,100,NoArch
2bccb1d2f845cb2ef385acebfde0773a21bdc925,0,0,0,0,0,0,0,0,0,0,0,0,0,0,56,0,0,0,0,0,0,0,0,0,0,1,100,NoArch
eecce949023711e3ed55833ca84e1a0d3887f301,0,0,0,0,0,0,0,0,0,0,0,0,0,0,33,0,0,0,0,0,0,0,0,0,0,1,100,NoArch
d98241a04d24dd46eb549a493f835abe6c68a4e9,0,0,0,0,0,0,0,0,0,0,0,0,0,0,434,9,0,0,0,0,0,0,0,0,0,1,100,NoArch
4fbab15638e53ce494796260f6c291bb2926ad19,7,215,89,126,3,0,3,2,31,172,2,3,2.611377047,517,867,5,57,52,5,3431,3048,383,29,25,4,1,94.26343154,Arch
05cf6342b2699ecba05a44abfc5e47e680a425fe,4,55,6,49,1,0,1,2,5,58,2,2,1.451789465,506,435,10,55,50,5,3420,3103,317,14,12,2,1,99.92062232,NoArch
1eb8e4f612e251b02c6921d59f6e23a7a5ab5189,1,18,1,17,0,0,0,3,7,293,1,1,0,223,436,11,29,25,4,1818,1672,146,3,3,0,0,100,NoArch
6b4c192d420cb9bb8596eeefcb2c280d3eed0b15,0,0,0,0,0,0,0,0,0,0,0,0,0,0,868,6,0,0,0,0,0,0,0,0,0,1,100,NoArch
846ef86fa1e40ccdec01445c5c29703107d564d3,1,25,25,0,0,0,0,3,32,10,1,1,0,269,869,7,35,35,0,1613,1613,0,13,13,0,1,100,NoArch
5389d76eed9ce58aefd9b08e0827ce48ca6fea39,4,22,9,13,0,0,0,2,5,92,2,2,1.676465973,362,437,10,41,39,2,1956,1833,123,14,14,0,1,99.98413202,NoArch
d04071c12abc80df189041eb168ac007f8cd7f99,1,1,1,0,0,0,0,3,10,73,1,1,0,307,438,4,37,37,0,1945,1945,0,17,17,0,0,100,NoArch
69febd5a32829837e8267ad3d804154f8f3d03b7,0,0,0,0,0,0,0,0,0,0,0,0,0,0,439,5,0,0,0,0,0,0,0,0,0,0,100,NoArch
a2346aebab853c08f6076e6cac573a3499d48b27,1,3,3,0,0,0,0,1,2,46,1,1,0,149,440,6,12,12,0,1031,1031,0,3,3,0,0,100,NoArch
2c1c3ad1057f9e36227549064fa555a37d307a7a,1,1,1,0,0,0,0,2,4,47,1,1,0,101,441,7,8,8,0,451,451,0,5,5,0,0,100,NoArch
4bb34a8b88cf399b58b0ff279613b7c1473c8fbd,0,0,0,0,0,0,0,0,0,0,0,0,0,0,442,8,0,0,0,0,0,0,0,0,0,0,100,NoArch
e75074d1349574cc6c19579aadf826d831866995,2,4,4,0,0,0,0,6,31,76,1,1,1,330,870,6,25,25,0,2101,2101,0,6,6,0,1,100,NoArch
220e11992cc33c088c360be948c0ee5aa365e4f3,1,2,2,0,0,0,0,4,20,71,1,1,0,290,871,7,28,28,0,2117,2117,0,4,4,0,1,100,NoArch
1c9c61798fc66195dbd015df2244f90c92a1094a,1,7,1,6,0,0,0,8,44,76,1,1,0,515,872,8,56,56,0,3535,3516,19,16,16,0,1,100,NoArch
4c2d7deb2fe77db40b5f01ac3de09bf1283ac77c,1,2,2,0,0,0,0,7,32,512,1,1,0,121,873,8,10,10,0,725,721,4,2,2,0,1,100,NoArch
38b644235d854331d59f27d3461ead8c72334508,1,104,105,1,0,0,0,3,6,157,1,1,0,155,443,9,24,19,5,1082,1214,132,4,3,1,0,100,NoArch
2ead329cb23df8561510b4e3ca191cc77a6605cf,1,115,31,84,0,0,0,3,14,677,1,1,0,167,874,8,42,19,23,1498,969,529,5,5,0,1,100,NoArch
408e57bb224d5fbf276eba7ca5056e681623d219,1,10,8,2,0,0,0,3,7,1,1,1,0,154,444,10,25,24,1,1090,1082,8,4,4,0,0,100,NoArch
c9d49ee0b1b63f4503cbb3457a6c96c67e3df799,6,4,9,5,0,0,0,2,11,1,1,1,2.469670487,764,445,11,75,75,0,3989,4070,81,34,34,0,0,99.74611235,NoArch
c1d2cd13539c1e4c58cb013da6c63ed362720386,15,170,37,133,1,0,1,2,33,1151,1,4,2.921523866,1552,875,8,192,176,16,7045,6531,514,102,87,15,1,99.82542454,NoArch
3292d07fa38bd482a27eb757f3cfad5fd4e2ba1d,3,4,4,0,0,0,0,5,17,706,1,2,1.5,185,446,12,8,8,0,951,951,0,3,3,0,1,100,NoArch
cf4cfaa245fecd522d678e207f1861ae99774f80,0,0,0,0,0,0,0,0,0,0,0,0,0,0,447,13,0,0,0,0,0,0,0,0,0,1,100,NoArch
7bfa45c6e870935af96622d96d622be242bb4c96,3,14,7,7,0,0,0,1,21,362,2,3,1.339664264,900,876,9,117,114,3,5010,4951,59,60,60,0,1,100,NoArch
131eb4a1f8d2865e62c97779ac59dedc365d2988,24,3069,71,2998,16,0,16,5,45,97,3,11,3.753977703,2128,57,0,699,335,364,31785,12137,19648,284,139,145,1,93.61934691,Arch
e5ad03222a60e7fc11f43fc04d600b26b6cc5678,2,5,2,3,0,0,0,1,2,0,1,1,0.863120569,619,58,1,94,94,0,4006,3990,16,41,41,0,0,100,NoArch
07f8c0afbcdda2839164919857406066e2cdfe12,1,2,1,1,0,0,0,2,2,3,1,1,0,512,71,0,60,60,0,4039,4018,21,22,22,0,1,99.9399904,NoArch
4fbfbc694a956c6e4923af27fbd42eb26467bb9f,110,824,696,128,0,1,1,2,86,80,4,61,5.929497767,18445,877,10,1811,1789,22,105191,106758,1567,749,717,32,1,93.86116601,Arch
2e2ef2cadb6d5c047e3f45356d689e8977a99dcc,3,33,1,32,0,0,0,1,18,525,1,3,0.745217654,246,878,11,28,24,4,1389,1130,259,18,16,2,1,100,NoArch
ce91968a54263986f45f74dac55f8987ec6941ed,1,2,1,1,0,0,0,2,5,0,1,1,0,33,879,12,3,4,1,91,99,8,2,2,0,1,100,NoArch
2b5dabe1817fff5db738dce15446d2693d1084b7,0,0,0,0,0,0,0,0,0,0,0,0,0,0,448,13,0,0,0,0,0,0,0,0,0,1,100,NoArch
d8e91f904e3306651743e1ad2a2c48e4f3745248,17,1086,83,1003,8,0,8,5,18,161,2,8,3.562910835,2218,449,14,232,149,83,15298,9699,5599,114,72,42,1,97.36490102,Arch
f81face912ea2d911cba2514b13e9ae022dc5458,4,23,225,202,0,3,3,1,25,454,2,2,1.73229508,433,880,12,14,34,20,1347,2288,941,2,17,15,0,99.84463277,NoArch
4be0a0821ae7e3a4b61ce42d5c31ddc5395392de,2,71,35,36,0,0,0,2,7,325,1,2,0.185803079,154,881,13,12,6,6,1125,827,298,5,4,1,1,99.91519435,NoArch
c586b3e013fa57feebea59b6e1cf4aab615b9b04,1,46,11,35,0,0,0,2,8,0,1,1,0,119,882,14,14,11,3,700,643,57,5,4,1,2,100,NoArch
9d448811aa05a14758390f1c4f19f67b4f267559,16,1117,16,1101,10,0,10,3,68,68,2,9,3.222953261,2934,172,0,267,186,81,26419,21348,5071,142,91,51,1,99.6056338,NoArch
bcde5878421f8721402c1f435658af737f5b4eda,0,0,0,0,0,0,0,0,0,0,0,0,0,0,450,13,0,0,0,0,0,0,0,0,0,1,100,NoArch
8150e795c22e43ab7cbb5f265684bcaccc4f2cb6,1,13,4,9,0,0,0,3,12,5,1,1,0,306,451,14,32,31,1,2352,2259,93,2,2,0,1,100,NoArch
96ea50161aa164271e335061f7730844865b8c62,1,10,7,3,0,0,0,1,2,5,1,1,0,147,452,15,15,15,0,951,934,17,7,7,0,1,100,NoArch
05f9475a731cbbd00ef871263436410e7998b1de,2,3,3,0,0,0,0,1,10,403,1,2,0.918295834,185,883,14,16,16,0,981,983,2,14,14,0,1,100,NoArch
f22d03cb408c1cc05304f9c1633620f0dff49b67,0,0,0,0,0,0,0,0,0,0,0,0,0,0,173,1,0,0,0,0,0,0,0,0,0,1,100,NoArch
e9cc3238826c6c248b6ba69eceba6807ac9defeb,42,1216,443,773,3,0,3,3,9,66,2,14,4.058888671,6631,30,0,772,684,88,36120,31232,4888,312,302,10,1,99.49267193,NoArch
d6aba1afc80cbeb3c6945c69b6e5ee13d4699496,37,477,477,0,0,0,0,3,4,18,2,10,4.192507241,6413,31,1,689,689,0,30547,30607,60,295,295,0,0,100,NoArch
3a14a77f222e7a276d3719eb9af005926bd61e39,2,87,12,75,0,0,0,1,2,43,1,2,0.999926399,254,72,1,13,8,5,2025,1497,528,7,5,2,1,99.90097609,NoArch
319649691808de0aab899cf11820691f3944abc6,1,2,4,2,0,0,0,1,1,0,1,1,0,251,453,8,20,20,0,1252,1276,24,15,15,0,0,99.94342291,NoArch
5a2250c6e82880eb68b6f0a3953403c476486dfe,20,828,444,384,1,1,2,2,11,186,1,3,3.082661336,4648,13,0,499,466,33,25422,23675,1747,191,181,10,1,99.55915813,NoArch
7942746edc830e88cd4ee8f55ea1a2b54d0169ea,3,31,3,28,0,0,0,2,38,747,1,2,1.436990524,407,884,9,48,45,3,1977,1882,95,14,13,1,1,100,NoArch
5214b1d7a44e3f82d7011fadbfc748520c8c07de,7,185,58,127,0,0,0,3,12,62,1,3,1.900183262,2363,14,1,183,167,16,11005,10427,578,65,63,2,1,100,NoArch
ebeade909b952e203f30416486ee45b7848d1741,7,58,185,127,0,0,0,3,13,0,1,3,1.900183262,2490,15,2,167,183,16,10427,11005,578,63,65,2,1,100,NoArch
8bac9143bda95a13b992e074a090df24be91019f,9,442,128,314,0,0,0,3,14,39,1,3,2.712666254,2926,16,3,237,208,29,14337,13219,1118,84,78,6,1,100,NoArch
c590f1b006f6c186ea1e98e9aaea27df66f83f98,2,26,9,17,0,0,0,2,20,474,1,2,0.315997133,329,174,1,37,34,3,1498,1362,136,19,17,2,1,100,NoArch
4432e3194bc54dcbfe8fd7267c01bddd26762e3a,1,4,6,2,0,0,0,2,9,0,1,1,0,79,175,2,10,10,0,387,390,3,8,8,0,1,100,NoArch
faf0b6e325b52e0f25f7e8b657981441ac6f8608,2,350,0,350,2,0,2,1,1,0,1,2,0.969254718,0,175,0,42,0,42,2569,0,2569,16,0,16,1,98.53923205,NoArch
86352e3decdf7b1caffdbb03e11cbb3c640db8fe,1,17,0,17,0,0,0,2,4,1426,1,1,0,170,176,1,11,10,1,1725,1523,202,8,7,1,1,99.98645354,NoArch
c898d272120b6d63a8b81175fad2f1e72a711310,6,554,0,554,4,0,4,1,2,0,2,4,2.15137162,350,177,2,78,42,36,5506,2569,2937,37,16,21,1,99.82422931,NoArch
f5cce9b0b12dbfaae57dd753e8ffe2729d300dc4,3,36,26,10,0,0,0,1,2,0,2,2,1.077256715,313,178,3,21,18,3,1947,1836,111,15,15,0,1,99.97300945,NoArch
11763fb82ee9f90de3a8114333a9ecf405add48b,2,25,11,14,0,0,0,1,3,0,2,2,0.852405179,435,179,4,53,52,1,2508,2453,55,18,17,1,1,100,NoArch
60fae60a240bfc3880717f96ee884cdccaa1c5d4,1,35,15,20,0,0,0,2,10,0,1,1,0,77,176,3,12,10,2,412,387,25,9,8,1,1,100,NoArch
7ad345d3331db7a38ef100d2512f3145232ceedd,2,86,48,38,0,0,0,3,5,92,2,2,0.4094994,283,32,2,18,13,5,2235,2008,227,5,5,0,1,100,NoArch
6290deb496f0974fc9a776463b810a3bb5fd947a,1,78,0,78,1,0,1,1,1,0,1,1,0,0,33,3,5,0,5,353,0,353,1,0,1,1,96.41729581,Arch
4eac2cb442d62f12e532621cbcd666a0237635f4,1,2,2,0,0,0,0,2,8,152,1,1,0,278,885,1,14,14,0,1477,1477,0,5,5,0,1,100,NoArch
dc637e81642ddf1171bfaa171c15c28bc0594565,13,372,118,254,2,0,2,3,36,264,2,5,2.836500843,1752,177,3,202,180,22,10349,9093,1256,131,118,13,2,98.18548387,NoArch
8642b98ebd1de6e1b2286ef80d44adf959b34140,3,514,0,514,3,0,3,1,1,0,1,2,1.5251133,0,34,2,46,0,46,3444,0,3444,18,0,18,1,99.88121752,NoArch
564c3e13a9eaf84fc76335b4a415937a747c974f,60,518,646,128,1,1,2,2,57,93,3,36,5.254651289,11961,886,1,1137,1143,6,65777,66282,505,469,470,1,0,99.47800149,NoArch
15925a5bb0bed57dde21c071997d79c411068162,8,9,52,43,0,0,0,2,19,200,3,8,2.540454453,2707,887,2,321,321,0,12948,12948,0,128,128,0,1,100,NoArch
eae542027e78732bff9a553e238683dcca08f94c,1,8,19,11,0,0,0,2,3,70,1,1,0,51,888,3,2,3,1,122,179,57,1,3,2,1,100,NoArch
78545ff1d97693d51a718eb2992c104b025ab79c,6,109,26,83,0,0,0,4,23,324,3,4,1.77393064,1064,178,4,96,91,5,6634,6130,504,58,54,4,1,100,NoArch
71bf817489d4f23b85d1d2ee048093e8353a3f12,3,166,50,116,2,0,2,1,39,15,1,2,1.574700051,266,889,4,35,33,2,1912,1531,381,7,5,2,1,99.91007194,NoArch
1540cecb889e1204a7fef826e92e30f60486af5c,1,8,21,13,0,0,0,2,4,5,1,1,0,187,890,5,9,11,2,1014,1091,77,4,5,1,0,100,NoArch
8bc64151162118158ebc4b362be7d0f9709a065c,1,37,0,37,1,0,1,1,1,0,1,1,0,0,180,5,3,0,3,124,0,124,3,0,3,1,99.97005091,NoArch
e6a308bebe5ee5b4c45fed6c08cc7aa83bce85f6,6,657,143,514,1,0,1,1,37,82,3,4,1.866722143,1628,454,0,234,180,54,10306,8275,2031,100,76,24,1,99.97006884,NoArch
822a5e17c3c1e07c711821b3c19c7641b19c55a5,7,36,73,37,0,0,0,2,13,4,3,5,2.175406008,1899,891,6,188,186,2,9298,9557,259,80,78,2,0,100,NoArch
69f324d9ed6a70e4eb7f6190b2e1751ce9dfca10,7,145,22,123,0,0,0,2,38,156,3,5,2.542134141,1724,455,1,213,201,12,9338,8648,690,127,119,8,1,100,NoArch
b7b432c7f958b3feed1fd181f9bda08aa6c1865d,7,217,28,189,0,0,0,2,13,329,2,3,1.800020542,826,456,2,114,84,30,5489,4216,1273,49,41,8,1,100,NoArch
051cbcf86e5dd61a198803256781c058120938d0,30,140,123,17,0,0,0,2,39,129,4,25,4.383670847,6585,892,6,776,774,2,36848,36893,45,341,339,2,0,99.86530979,NoArch
bc9aa53c3fa0409c98801bbc2a58af6d48dd4c94,1,6,0,6,0,0,0,3,4,213,1,1,0,126,457,3,7,6,1,827,768,59,3,3,0,1,100,NoArch
f57e759a33a9edbcb7bfb4424a04f4889250706f,1,378,0,378,1,0,1,1,1,0,1,1,0,0,458,4,42,0,42,2085,0,2085,16,0,16,1,99.97006884,NoArch
33592c1a38c48efd2b9cbb042a31f94236e0b89b,26,2983,399,2584,11,2,13,3,23,382,1,4,4.149191358,2214,113,0,513,240,273,29769,13151,16618,148,81,67,4,90.58473736,Arch
3be3d239e82b2f977778f3d7163c642980e34474,2,110,67,43,0,0,0,2,6,38,1,2,0.968245218,389,181,0,30,27,3,2534,2150,384,14,10,4,1,100,NoArch
5995c32d6ea481dd5dbf494c8f92af8463386816,0,0,0,0,0,0,0,0,0,0,0,0,0,0,893,0,0,0,0,0,0,0,0,0,0,0,100,NoArch
f9a9f39b05ba380e56901b78234a801b86c6e719,1,2,1,1,0,0,0,3,5,286,1,1,0,99,459,0,4,4,0,542,523,19,2,2,0,1,100,NoArch
356bfd15aeee5e14010f0af8436f261e12f1f907,2,52,9,43,0,0,0,4,14,94,1,2,0.349184374,488,460,1,48,45,3,3616,3287,329,10,9,1,1,100,NoArch
1ce7d01775bd547c570fafa808111e4456a185f2,0,0,0,0,0,0,0,0,0,0,0,0,0,0,461,2,0,0,0,0,0,0,0,0,0,0,100,NoArch
3d22cb24b2822b6740b555455625431340663bed,0,0,0,0,0,0,0,0,0,0,0,0,0,0,0,0,0,0,0,0,0,0,0,0,0,0,100,NoArch
1de25ed59593d34b6f5968951e2f624cbe4edfb2,0,0,0,0,0,0,0,0,0,0,0,0,0,0,1,1,0,0,0,0,0,0,0,0,0,0,100,NoArch
d29dd6cd3a32ddbb22d2fabaec3b42078b217c51,0,0,0,0,0,0,0,0,0,0,0,0,0,0,1,1,0,0,0,0,0,0,0,0,0,0,100,NoArch
d5af57b38606e96772bcd0344d489b37c8419077,0,0,0,0,0,0,0,0,0,0,0,0,0,0,2,2,0,0,0,0,0,0,0,0,0,0,100,NoArch
deb1c161ccec42d78f692932e5bef19331695954,0,0,0,0,0,0,0,0,0,0,0,0,0,0,3,3,0,0,0,0,0,0,0,0,0,0,100,NoArch
17a286d0403eed3e8c3c8cb2aaa815d0bce0bbe9,0,0,0,0,0,0,0,0,0,0,0,0,0,0,5,5,0,0,0,0,0,0,0,0,0,0,100,NoArch
17a286d0403eed3e8c3c8cb2aaa815d0bce0bbe9,0,0,0,0,0,0,0,0,0,0,0,0,0,0,5,5,0,0,0,0,0,0,0,0,0,0,100,NoArch
63e58164dac143488300b9ce9bf3038a27a81623,0,0,0,0,0,0,0,0,0,0,0,0,0,0,4,4,0,0,0,0,0,0,0,0,0,0,100,NoArch
118c25493d2073057b0617a9efb8aa42d52da97d,2,41,51,10,0,0,0,2,20,908,1,1,0.996929708,617,894,1,104,108,4,2606,2662,56,64,64,0,1,100,NoArch
d2b08cdb1d6864bf5bb5228b6fd0a592d9dc19f2,0,0,0,0,0,0,0,0,0,0,0,0,0,0,895,2,0,0,0,0,0,0,0,0,0,1,100,NoArch
e881d555d40fbbe03ab25051c283715fce537fb5,0,0,0,0,0,0,0,0,0,0,0,0,0,0,896,3,0,0,0,0,0,0,0,0,0,1,100,NoArch
b5c65a5441eed37d532bdcd007957ed7c2e80db0,1,17,5,12,0,0,0,2,10,122,1,1,0,864,897,4,109,108,1,4211,4178,33,39,38,1,1,100,NoArch
da7c5b68f0777b70ed305df3f8adb0ad107dfe76,2,2,2,0,0,0,0,2,21,0,1,1,1,607,898,5,104,104,0,2606,2606,0,64,64,0,1,100,NoArch
1de8cec0ace0a8026f8c7b4e9fd8961d7496b2ca,44,86,88,2,0,0,0,4,93,266,1,22,5.092436333,11581,899,6,881,881,0,64681,64247,434,388,388,0,1,100,NoArch
3f2d65a4708c3d457cbdd9c4974afb90c2f2abbf,1,25,21,4,0,0,0,1,2,745,1,1,0,155,900,7,15,14,1,738,728,10,3,3,0,1,100,NoArch
7c2b66444177812e26572e6d66a70e29a2855fa9,46,264,86,178,0,0,0,2,66,348,3,34,5.311692165,8318,901,8,575,502,73,48189,47153,1036,244,244,0,1,100,NoArch
c94a7d005e938476736f96e652be2b536fa61e5f,1,4,1,3,0,0,0,2,4,348,1,1,0,117,902,9,11,10,1,826,812,14,3,3,0,1,100,NoArch
22dc9fe1e12db6e672e00fc885fae24309938423,1,114,115,1,0,0,0,1,3,198,1,1,0,422,903,10,49,48,1,2374,2171,203,26,26,0,1,100,NoArch
522dfbb7699cecc24babcad3394935cfb21f3a15,1,1,1,0,0,0,0,6,33,5,1,1,0,317,904,11,28,28,0,1626,1637,11,12,12,0,1,100,NoArch
2343aee681db7e70e5b7568dc809eaf39e820889,1,3,0,3,0,0,0,2,5,351,1,1,0,267,905,12,35,34,1,1087,1070,17,24,24,0,1,100,NoArch
b9a9f9415a02bd2bb2aa5ca6aa1d4aead4290f89,2,2,2,0,0,0,0,2,2,76,1,1,1,401,179,0,43,43,0,3113,3113,0,6,6,0,0,100,NoArch
2153bb95b1dcd1ada274c99bdf1a5a049f7aa3f8,5,253,253,0,1,0,1,3,10,84,1,2,1.833344237,654,180,1,60,52,8,4464,4102,362,34,31,3,1,95.64761405,Arch
529b114bde729951ffe22bd3845dbe19dfdd45df,5,101,81,20,0,0,0,3,11,0,1,2,1.921226295,654,181,2,60,60,0,4464,4464,0,34,34,0,0,100,NoArch
a28cf1dc0d4191ccd4b4798a2cdb27348a3d96dd,7,161,4,157,1,0,1,1,12,506,1,1,2.382494496,509,182,3,49,34,15,2754,2102,652,32,17,15,1,96.86956522,Arch
1ac30a4af120f511c04461f5fbef6984d4cfa806,35,599,627,28,0,0,0,3,94,265,3,13,3.410574359,8740,183,4,778,777,1,50635,50718,83,382,380,2,1,98.70153291,NoArch
f4fbdbbc5040f0f5802a093fa7662b2e9bd95c16,7,38,38,0,0,0,0,7,33,431,1,1,2.133135218,679,184,5,66,66,0,3414,3414,0,23,23,0,1,98.31692032,NoArch
6db7f6287a5720ea3dca07c1c89da4568bb4e84e,30,596,465,131,0,0,0,3,67,77,2,23,3.576315643,6353,462,0,547,514,33,38434,38125,309,221,215,6,1,99.91012044,NoArch
03a94924b8c788f1b3e97114fa4d5b1167157bae,15,69,62,7,0,0,0,4,58,129,3,13,3.206709581,3278,463,1,349,350,1,18373,18355,18,132,133,1,1,100,NoArch
6a3f566d3d7661d6a78e92996d0d58f45d12eda6,7,632,12,620,4,0,4,1,27,200,1,5,2.099254562,545,185,6,92,36,56,5353,2098,3255,63,31,32,1,99.87434931,NoArch
8843678330bf7f80c8ef11344fdeb2b25d37a71c,0,0,0,0,0,0,0,0,0,0,0,0,0,0,464,2,0,0,0,0,0,0,0,0,0,0,100,NoArch
dd2b1986a41c8d4423bba93064c47739be1f96b5,3,662,1,661,2,0,2,1,15,215,1,2,1.06378399,289,906,12,128,57,71,4169,1282,2887,56,20,36,1,99.91044241,NoArch
175701cb6261ef2f5eab9878d92ba10baec32496,20,1600,1009,591,3,2,5,2,28,132,1,4,3.750535719,4674,17,0,413,387,26,25740,23591,2149,162,150,12,1,91.04764961,Arch
76e80dceb487cc9105b3e993bc9fadd65701fbb8,16,469,203,266,2,0,2,3,33,23,2,5,3.44786579,2143,186,7,222,202,20,13182,12027,1155,130,112,18,1,98.88292471,NoArch
457db943e6833e90db1d800fc7ed51f59d479e58,6,266,263,3,0,0,0,1,15,4,1,3,1.437809901,1108,187,8,105,104,1,5860,5744,116,62,61,1,1,100,NoArch
8d102ea2cea0e43c91e867362ec842fbc286fb26,41,87,56,31,0,0,0,3,70,105,3,16,5.113807131,7475,188,8,721,721,0,46232,45749,483,341,341,0,0,97.7539487,Arch
8953d93be40143d0ff51481231ce087564086eff,16,18,18,0,0,0,0,1,95,200,1,6,3.947702779,4397,189,9,365,365,0,21841,21805,36,151,151,0,0,99.76831741,NoArch
98f66f4f1c2e2b994613177fe05fa130a09423aa,2,138,64,74,0,0,0,2,5,2,1,2,0.858401835,459,0,0,52,46,6,2803,2563,240,30,27,3,2,100,NoArch
1371326369e3ca9b019251a19a1e91a97dcb5411,4,125,47,78,0,0,0,2,6,13,1,2,1.630913371,670,1,1,68,61,7,3989,3493,496,38,34,4,2,100,NoArch
1627c7d181b83855271d88fcff520f02e5ebf7e2,1,15,2,13,0,0,0,4,26,63,1,1,0,348,0,0,29,26,3,2354,2265,89,11,11,0,1,100,NoArch
61bfaaa9a96f3f4512d0bce375b1219b6b3de91e,15,0,112,112,0,0,0,4,27,116,1,2,2.939624942,2502,1,1,221,242,21,15421,16184,763,67,70,3,0,100,NoArch
eeaf4a83a056a5dd5fddf5d3ca0745e2be1155ba,1,1,1,0,0,0,0,2,22,70,1,1,0,306,907,1,52,52,0,1303,1303,0,32,32,0,0,100,NoArch
63f3118f8aa2e21bb030d209e706f03046ed9a1e,6,21,33,12,0,0,0,2,28,232,1,3,2.128025351,1939,2,2,232,231,1,10938,11080,142,79,79,0,0,90.97288676,Arch
cff65e7cb900ddb5bdf6a88b304020f086da7ee8,12,85,124,39,0,0,0,2,33,61,1,4,2.461008222,3401,3,3,412,411,1,19843,20102,259,114,110,4,0,100,NoArch
a93745846d1fb5b41af5f1e33810cefb9f0806f7,4,17,297,280,0,1,1,9,66,32,1,2,1.89562783,1481,2,2,86,118,32,7055,9027,1972,43,53,10,1,99.94661922,NoArch
d364748c74d1dda33c413cc7f3f3f86943d77696,1,3,3,0,0,0,0,9,67,0,1,1,0,364,3,3,22,22,0,1903,1903,0,10,10,0,1,100,NoArch
3eba6f26486dcb9e2ec03702b60a38de399e738f,18,287,242,45,1,0,1,2,23,50,2,6,3.879242604,2330,190,2,199,197,2,13110,12956,154,128,129,1,1,93.95235186,Arch
f99a18f07f743bdde96cc08140715b6bc3312abf,13,123,41,82,0,0,0,4,71,94,3,11,2.40144614,4283,4,4,284,280,4,28732,28102,630,162,160,2,1,100,NoArch
90987ff6c7efd130938266d8beb8fed7c61cdc6b,13,334,350,16,0,3,3,6,72,362,2,9,3.203516625,3600,4,4,303,283,20,24823,24001,822,133,135,2,1,99.50810955,NoArch
26a6b243d0eb79680521536746687801efdc6628,1,3,1,2,0,0,0,5,21,2,1,1,0,393,5,5,29,29,0,2837,2820,17,18,18,0,0,100,NoArch
ba81a9322c8006217df919e89e212e7723cbb9a2,16,175,549,374,0,2,2,4,96,39,2,10,3.298051688,5396,5,3,360,408,48,32176,34130,1954,175,190,15,2,92.82201045,Arch
dfbcfb18efe7f9371bb754dfcc12917f191e88b7,2,14,10,4,0,0,0,6,74,6,2,2,0.738284866,996,6,4,82,82,0,7893,7849,44,24,24,0,2,100,NoArch
2cfaf19221b07b57b0b42d9e843a2e464c0ead21,9,53,30,23,0,0,0,4,97,16,3,8,1.598973941,2955,7,5,186,185,1,20555,20476,79,86,86,0,1,100,NoArch
73ff886ec2fdb7598d69a930f1308ed5321e6ce5,1,3,3,0,0,0,0,2,7,4,1,1,0,156,8,6,16,16,0,955,953,2,7,7,0,0,100,NoArch
68826d977fb5bd94cd93382019c149030e696360,1,8,6,2,0,0,0,6,14,11,1,1,0,434,9,7,22,22,0,3231,3209,22,12,12,0,0,100,NoArch
51f58b8b5a066d0afabc850c19fae21b9f24ca95,35,333,217,116,0,0,0,6,98,191,2,15,4.672363924,9010,10,6,752,750,2,56753,55646,1107,269,269,0,0,99.20883165,NoArch
bf2df6e86e2ed7efdd631adc8d347ff409a411a4,1,46,77,31,0,0,0,2,9,23,1,1,0,325,11,3,27,27,0,1687,1687,0,14,14,0,0,100,NoArch
fd355fe7b249b552160eba3ce72aee3a09ee08e8,6,30,293,263,0,1,1,4,73,39,2,5,1.905885337,2502,12,4,144,171,27,14572,16402,1830,68,74,6,1,96.63624978,Arch
1b7d47acd8392ca5ac632a8ff6d331ac27301160,14,68,1839,1771,0,7,7,10,99,139,1,4,3.357130473,3165,13,5,89,288,199,7327,18597,11270,31,92,61,2,96.42021946,Arch
d6b1b5f518b55c045258e36bfbeeaeaf079eb456,1,1,1,0,0,0,0,3,7,365,1,1,0,124,908,0,12,12,0,789,781,8,2,2,0,1,100,NoArch
eccd384b0ed93fe51ba4d52b70f6a701c4bad50a,1,3,2,1,0,0,0,3,15,206,1,1,0,331,909,1,30,30,0,2362,2344,18,2,2,0,1,100,NoArch
4df72fbac47d88ce3d66bf9a67f7e88276500a1a,3,74,51,23,0,0,0,2,29,1017,1,1,1.552061072,1688,910,2,369,364,5,7724,7551,173,158,153,5,0,100,NoArch
9ebd317942cdfd90395785a3cad7b2f571f9bf63,2,20,11,9,0,0,0,11,100,28,1,2,0.907165768,636,14,3,34,31,3,2585,2582,3,12,12,0,1,100,NoArch
3f1b344c77fec2124ca7eb32748f4da7fa32f9ff,0,0,0,0,0,0,0,0,0,0,0,0,0,0,191,0,0,0,0,0,0,0,0,0,0,0,100,NoArch
6b390e785eacbd91dd53ca71a10fafd410c93e93,1,10,13,3,0,0,0,1,3,122,1,1,0,225,192,1,17,17,0,1182,1182,0,4,4,0,0,100,NoArch
9d08db8b658fef04eadf3eae6669d9b45269640b,1,3,1,2,0,0,0,3,7,216,1,1,0,427,911,0,44,44,0,3215,3200,15,18,18,0,1,100,NoArch
e1b128959e1109a067399cc5670d75393f858ecc,1,395,0,395,1,0,1,1,1,0,1,1,0,0,73,0,56,0,56,2760,0,2760,24,0,24,1,99.83246463,NoArch
21cdb526fae3897af5fb74f5d1af2b2af5ca3be2,1,9,0,9,0,0,0,1,3,929,1,1,0,113,912,1,12,11,1,475,444,31,12,11,1,1,100,NoArch
137423f4e5f0d822cd44615125a87f836429923c,0,0,0,0,0,0,0,0,0,0,0,0,0,0,6,0,0,0,0,0,0,0,0,0,0,1,100,NoArch
9c7a9e7488555d27bd7f6a0bebb4021671b1842f,5,1010,1025,15,2,1,3,1,24,303,1,5,1.327049769,1326,182,0,163,194,31,9241,8736,505,28,29,1,1,99.88849656,NoArch
2fd2aed8702c9bd4490978f9c0eee2f27ba66958,2,18,3,15,0,0,0,1,2,6,1,2,0.702466551,1000,183,1,132,131,1,7763,7437,326,16,15,1,1,100,NoArch
f514c8294e6a61d8b1a345738d3870919f888e78,1,34,30,4,0,0,0,1,3,1,1,1,0,893,184,2,127,126,1,6749,6745,4,12,12,0,1,100,NoArch
298eef9ddff628a9ce6b4d2c77644f7166cec9cd,1,11,0,11,0,0,0,3,8,35,1,1,0,429,74,1,45,44,1,3289,3215,74,18,18,0,1,100,NoArch
3bf7a1c54816fb5c055d897389ba0c37a66404ed,3,68,2,66,0,0,0,1,42,328,1,3,1.51248501,1194,75,2,127,124,3,7638,7252,386,59,57,2,1,100,NoArch
f60ceca58810052e30842d25305941c1bb9c9dc1,2,0,4,4,0,0,0,3,43,0,1,2,1,1057,76,3,123,123,0,5977,6017,40,55,55,0,1,100,NoArch
590ffede5cf8cac72c6c278b09a270bf99c13c25,29,409,1728,1319,0,5,5,3,101,210,3,13,3.798735041,6592,193,0,389,516,127,33292,39503,6211,212,292,80,1,99.5557201,NoArch
4aa9091ce6f5e06b4a9c21af682ab82579d203b2,1,2,2,0,0,0,0,6,68,261,1,1,0,295,913,1,24,24,0,1773,1775,2,3,3,0,1,100,NoArch
d994ab807a6a08965be959d17b9ae3157fb75971,7,0,915,915,0,5,5,2,7,385,1,4,2.684239758,913,77,4,0,39,39,0,5565,5565,0,23,23,1,99.51994092,NoArch
b06077a7217548e3c3a7c5748dc03bf9e52015b6,59,0,6466,6466,0,56,56,5,37,989,2,7,5.675601574,6463,78,5,0,462,462,0,34895,34895,0,164,164,1,88.91529452,Arch
9bbc7a0c10f43a77e0b7459f1c15c4ce7addc184,5,10,6,4,0,0,0,2,3,410,1,2,2.186278124,412,79,6,23,23,0,2349,2285,64,16,16,0,1,100,NoArch
0a80b544349320c89b495fc2f78588297359d929,65,13,6886,6873,0,64,64,3,32,1155,2,12,5.776020074,7033,80,6,20,564,544,727,32569,31842,10,298,288,1,97.61059089,Arch
26cee84a0b90ce98b7b9a540018c3ba017289595,0,0,0,0,0,0,0,0,0,0,0,0,0,0,81,7,0,0,0,0,0,0,0,0,0,1,100,NoArch
5257bc9d294a28c83e6b50e70d1ef2026976e43f,4,39,33,6,0,0,0,5,32,360,1,2,1.986053575,567,114,0,48,48,0,3385,3349,36,15,15,0,1,99.93351064,NoArch
9a15cb8d2e13b44f88b45428c37bbd6bb14eabcc,7,1111,0,1111,7,0,7,1,1,0,1,2,2.688638903,0,115,1,96,0,96,6297,0,6297,27,0,27,1,99.63533897,NoArch
39b8c2d006a2df6c1e919d883a4d220148908cec,3,4,6,2,0,0,0,1,2,0,1,1,1.485475297,385,116,2,29,29,0,2337,2357,20,9,9,0,1,89.89735278,Arch
8dd6dba6dfac61d8e74859827cdfd564bdb0b27a,0,0,0,0,0,0,0,0,0,0,0,0,0,0,117,3,0,0,0,0,0,0,0,0,0,1,100,NoArch
1526c5b9e465aaae38b90eae7e208cf41e5bd2b4,8,329,139,190,2,0,2,1,7,509,2,4,2.431585179,496,118,4,35,26,9,3829,2864,965,19,16,3,1,99.88146977,NoArch
e64dd36ec79d1c22a6161078f5363cfb5f89ff91,87,420,420,0,0,0,0,3,77,489,4,54,5.297558365,20913,7,1,2459,2459,0,111115,111115,0,906,906,0,1,100,NoArch
44459bda14b550d8929728294bc9af412aa41852,42,573,577,4,0,0,0,5,69,196,4,33,2.811790724,12159,8,2,1395,1395,0,60166,60226,60,405,405,0,1,100,NoArch
d8d721acc0b4616b688bbe56b5fe5ae96dda407d,17,242,364,122,0,2,2,1,13,371,2,5,3.195827579,1351,119,5,85,87,2,6963,7382,419,55,55,0,1,99.84208448,NoArch
0d7555556bcc4a9a5aef16340e09df54bd1e8658,1,2,2,0,0,0,0,2,9,463,1,1,0,89,914,1,15,15,0,391,391,0,9,9,0,1,100,NoArch
35fa73f05fa65905e4b9e26f8fdbea51d2e945f4,50,6908,6682,226,19,19,38,3,26,1571,1,13,4.581455926,12384,185,3,1522,1387,135,47657,39501,8156,538,560,22,1,89.44642279,Arch
8fa659d3db512a0f0db1af065d9445f093c8ec85,0,0,0,0,0,0,0,0,0,0,0,0,0,0,186,4,0,0,0,0,0,0,0,0,0,1,100,NoArch
d63c631e347e63afc8a19c88f912e0b094b3b7af,2,15,3,12,0,0,0,1,10,671,1,2,0.964078765,138,915,2,17,16,1,831,692,139,11,10,1,0,100,NoArch
ff886ecec5048a030708c5b3a99b2a4401e8b8d2,1,1,1,0,0,0,0,3,23,41,1,1,0,127,194,1,12,12,0,886,886,0,6,6,0,0,100,NoArch
3f09bcd423a4216f6a7e6ee8ff478028864530d6,1,15,33,18,0,0,0,3,8,41,1,1,0,320,195,2,36,43,7,2195,2272,77,12,13,1,0,100,NoArch
bd7f364c9ad10bdec910aff5c8bb7865e45c3676,1,18,0,18,0,0,0,6,46,49,1,1,0,604,465,0,79,77,2,2721,2663,58,38,37,1,1,100,NoArch
50b4637a387f54729144bb38699df672aa76e8f1,1,117,175,58,0,0,0,4,10,68,1,1,0,448,196,2,21,18,3,3622,3384,238,17,16,1,1,100,NoArch
73c5336bc755373b6edc51d41abd2b6453b3da11,1,96,159,63,0,0,0,4,11,68,1,1,0,432,197,3,22,21,1,3289,3267,22,18,17,1,1,100,NoArch
2e681c461c685c23e13ad7ada0eba5a9136c29a2,3,32,18,14,0,0,0,7,78,51,1,2,0.987785743,461,198,4,28,28,0,1961,1959,2,10,10,0,0,100,NoArch
e69bcbd022f59e1ec0fb6cec5fea0a742c761cf3,3,81,114,33,0,0,0,4,12,70,1,3,1.2293036,1008,199,5,59,62,3,8261,8532,271,42,43,1,1,100,NoArch
03fca8714727e38b8efa2ea8e5320c170e11bfcf,1,1,1,0,0,0,0,8,57,190,1,1,0,237,466,1,10,10,0,1316,1319,3,6,6,0,1,100,NoArch
a344c6be5962fae2f762b6a487065fbd06673e25,9,9,9,0,0,0,0,3,9,54,1,3,3.086048612,838,120,0,74,74,0,5288,5262,26,34,34,0,1,100,NoArch
bb10835b8e092fbf709ccd8c55edbd078cbd5491,11,41,1504,1463,0,10,10,6,49,767,1,3,2.927347156,1615,82,0,19,162,143,896,9139,8243,8,70,62,1,99.69713656,NoArch
cd02e8bd4ed8d7425eedfe37f42fa23a605f6dbd,1,11,0,11,0,0,0,7,26,641,1,1,0,234,121,1,47,42,5,1259,1173,86,8,7,1,1,100,NoArch
1bdf3ab8af012cb3248384073f99c1dc69f7e97f,5,8,9,1,0,0,0,2,8,369,1,2,2.027489311,275,122,2,26,26,0,1013,1027,14,22,22,0,1,100,NoArch
9a0617dd700bc428746d9ac447f6dacfea0074dd,0,0,0,0,0,0,0,0,0,0,0,0,0,0,123,3,0,0,0,0,0,0,0,0,0,1,100,NoArch
2ab5e922cf165b77a8304d9c86feb16a32baa9ac,1,3,3,0,0,0,0,3,8,0,1,1,0,162,124,4,15,15,0,1196,1203,7,4,4,0,1,100,NoArch
d94eb39fa85641da388646a5d9e8d340910f7b8d,10,76,53,23,0,0,0,3,14,20,1,4,3.040050296,926,125,5,74,75,1,5358,5360,2,48,46,2,1,99.9585349,NoArch
cfd85f859c73b3c7899a9337bd4aeab5e1281eb7,1,1,1,0,0,0,0,6,16,237,1,1,0,193,83,1,5,5,0,1111,1111,0,3,3,0,1,100,NoArch
69ea83dade036e74d5d0c40e3f060ba3ac4ad9bd,0,0,0,0,0,0,0,0,0,0,0,0,0,0,126,6,0,0,0,0,0,0,0,0,0,1,100,NoArch
b758f8d8f3c9d7db89add438eff1a5f599cf826d,0,0,0,0,0,0,0,0,0,0,0,0,0,0,127,7,0,0,0,0,0,0,0,0,0,1,100,NoArch
79b654d49d19ef3463152864e0485b9f500e8ed4,0,0,0,0,0,0,0,0,0,0,0,0,0,0,84,2,0,0,0,0,0,0,0,0,0,1,100,NoArch
3beecc0e8e48909ab17f70022adf7ee878bbe696,4,13,13,0,0,0,0,2,5,565,3,3,1.290120853,440,128,8,38,38,0,3070,3067,3,14,14,0,1,100,NoArch
f4d9a5b22e7fac290b74717a1f78c908f211d0c4,1,1,2,1,0,0,0,3,9,4,1,1,0,44,129,9,3,3,0,153,153,0,3,3,0,1,100,NoArch
5b94d3fbb16d73a0e88dfd7ab04b79ff33bbba24,1,32,12,20,0,0,0,2,16,327,1,1,0,293,916,0,62,58,4,1377,1291,86,22,21,1,0,100,NoArch
36e198142d8e876b622f0563c8176066185b8ecf,6,0,686,686,0,4,4,4,20,1700,1,1,2.319927608,684,917,1,0,84,84,0,3417,3417,0,61,61,0,99.77827051,NoArch
6d0a451f7068cfacd9384d6e50908b4c01dad7e3,0,0,0,0,0,0,0,0,0,0,0,0,0,0,130,10,0,0,0,0,0,0,0,0,0,0,100,NoArch
7c8c27eeb83e065740a49b4551c01d7100b90344,0,0,0,0,0,0,0,0,0,0,0,0,0,0,131,11,0,0,0,0,0,0,0,0,0,0,100,NoArch
d521b72eec4964d547922e357ad77f2b4fc1f06e,2,27,12,15,0,0,0,1,8,1134,1,2,0.779349837,387,200,4,44,40,4,3272,3130,142,27,25,2,1,100,NoArch
d0b12880eb7e7dc965e5cb174f8311a2de4a54f1,0,0,0,0,0,0,0,0,0,0,0,0,0,0,15,0,0,0,0,0,0,0,0,0,0,0,100,NoArch
f467a7b4e23c950e1f60a10eb122bce170c44aec,1,10,0,10,0,0,0,4,9,0,1,1,0,108,201,5,17,13,4,485,455,30,6,6,0,1,100,NoArch
eec57e4ff74eff067b2ac4093a93c008b5287af9,0,0,0,0,0,0,0,0,0,0,0,0,0,0,132,12,0,0,0,0,0,0,0,0,0,0,100,NoArch
9e154d923ee0f8801edac9e8a9df6f6f824958a0,0,0,0,0,0,0,0,0,0,0,0,0,0,0,133,13,0,0,0,0,0,0,0,0,0,0,100,NoArch
86b1196bb540df26fcb03ae5c03904779924face,2,154,141,13,0,0,0,5,10,40,2,2,0.058592302,340,134,14,26,26,0,2254,2495,241,8,7,1,0,100,NoArch
ee910dfbfbeee2bcff9afd83f0bdcf4c9356e08b,0,0,0,0,0,0,0,0,0,0,0,0,0,0,16,1,0,0,0,0,0,0,0,0,0,0,100,NoArch
1f59d8ea289ffb8290e39f5b3fe2fec42e0a2591,0,0,0,0,0,0,0,0,0,0,0,0,0,0,135,15,0,0,0,0,0,0,0,0,0,0,100,NoArch
caacd5c28d435d5ed45617ad3fc18623d3e2a318,0,0,0,0,0,0,0,0,0,0,0,0,0,0,17,2,0,0,0,0,0,0,0,0,0,0,100,NoArch
abb4fe4c8c949fc310f086f4397fe0645d67ba29,0,0,0,0,0,0,0,0,0,0,0,0,0,0,18,3,0,0,0,0,0,0,0,0,0,0,100,NoArch
cdfa6c68800df2b8ec1e1a177b8c8978ef2a7e18,0,0,0,0,0,0,0,0,0,0,0,0,0,0,19,4,0,0,0,0,0,0,0,0,0,0,100,NoArch
159174ebfbeede79b9bcef3e1c3ade5aac24d6c1,0,0,0,0,0,0,0,0,0,0,0,0,0,0,19,4,0,0,0,0,0,0,0,0,0,0,100,NoArch
a320da91873e98640378fd0afbf811d820526087,0,0,0,0,0,0,0,0,0,0,0,0,0,0,20,5,0,0,0,0,0,0,0,0,0,0,100,NoArch
f692f7d69577ce6bb2e7e045c0ce9c3d72c76dd8,0,0,0,0,0,0,0,0,0,0,0,0,0,0,21,6,0,0,0,0,0,0,0,0,0,0,100,NoArch
9c452eebb98ae7c99582f55746692c1123c8d936,0,0,0,0,0,0,0,0,0,0,0,0,0,0,23,8,0,0,0,0,0,0,0,0,0,0,100,NoArch
256c7a70a19243c6304c972a8a0c81463d798a56,0,0,0,0,0,0,0,0,0,0,0,0,0,0,22,7,0,0,0,0,0,0,0,0,0,0,100,NoArch
cb7e6cd5b4581c26a93edaa71fba54b35f11e79d,0,0,0,0,0,0,0,0,0,0,0,0,0,0,23,8,0,0,0,0,0,0,0,0,0,0,100,NoArch
b8c11c6c9ce4777ace544427ef9685ce9c56864d,0,0,0,0,0,0,0,0,0,0,0,0,0,0,24,9,0,0,0,0,0,0,0,0,0,0,100,NoArch
8b15e117d943a46aaac14fe7a4c6746cfbd8e52b,0,0,0,0,0,0,0,0,0,0,0,0,0,0,27,12,0,0,0,0,0,0,0,0,0,0,100,NoArch
0596971048899c0243370e20104d12d24675a39f,0,0,0,0,0,0,0,0,0,0,0,0,0,0,25,10,0,0,0,0,0,0,0,0,0,0,100,NoArch
9d083f17b6a4fa099dac6783c5de500539ccaa85,1,16,18,2,0,0,0,3,5,234,1,1,0,105,202,6,11,10,1,622,614,8,2,2,0,1,100,NoArch
44bf39a9f02ac39589f4cdf542117336da43b03d,1,8,7,1,0,0,0,3,6,0,1,1,0,103,203,7,11,11,0,622,622,0,2,2,0,1,100,NoArch
214b3292a9975c7a1bf635e99e84c00290c47c47,1,2,2,0,0,0,0,3,7,0,1,1,0,104,204,8,11,11,0,622,622,0,2,2,0,1,100,NoArch
90cd33ae5be980c60ffd7b37b108c238f4397e98,3,19,17,2,0,0,0,8,102,116,1,1,0.803071727,462,205,9,33,33,0,2396,2354,42,10,10,0,0,100,NoArch
87eed5bd06efdac96fa99883d37985e2dae1779f,1,2,2,0,0,0,0,7,33,0,1,1,0,74,206,10,6,6,0,360,360,0,2,2,0,0,100,NoArch
a4740550cbfe6d1ceac08c011f095ade423800fc,0,0,0,0,0,0,0,0,0,0,0,0,0,0,136,16,0,0,0,0,0,0,0,0,0,0,100,NoArch
e5cbfb226d808dc51ebe419524c494171c42e34a,0,0,0,0,0,0,0,0,0,0,0,0,0,0,54,0,0,0,0,0,0,0,0,0,0,0,100,NoArch
a99ce3c8370e029bd5df4b6d2a7bbe9e2f01a607,8,151,233,82,0,0,0,3,79,288,3,7,1.947841839,1341,207,11,65,71,6,6766,6915,149,31,33,2,1,99.98610725,NoArch
25c5e7aae291e5463178ec5a6d76e29a8859bc39,0,0,0,0,0,0,0,0,0,0,0,0,0,0,26,11,0,0,0,0,0,0,0,0,0,0,100,NoArch
1ac5f1af46bfd48b29d97f3663d0328f6d890b5d,0,0,0,0,0,0,0,0,0,0,0,0,0,0,27,12,0,0,0,0,0,0,0,0,0,0,100,NoArch
cce962d5668dc5be8c3d3fc4efd0d3f13a234fc4,0,0,0,0,0,0,0,0,0,0,0,0,0,0,31,16,0,0,0,0,0,0,0,0,0,0,100,NoArch
4c112817b845cdae6a1967a0680d5f7aa4c3b75e,0,0,0,0,0,0,0,0,0,0,0,0,0,0,28,13,0,0,0,0,0,0,0,0,0,0,100,NoArch
010f8ebf35a322604d6497e175a1fe20924a991d,0,0,0,0,0,0,0,0,0,0,0,0,0,0,29,14,0,0,0,0,0,0,0,0,0,0,100,NoArch
9be3b158c5341d4cca33ada6ce1155e7ca5b25f3,0,0,0,0,0,0,0,0,0,0,0,0,0,0,30,15,0,0,0,0,0,0,0,0,0,0,100,NoArch
9d847e0357a2138687808ee257e53455ae4786c3,0,0,0,0,0,0,0,0,0,0,0,0,0,0,35,20,0,0,0,0,0,0,0,0,0,0,100,NoArch
9c452eebb98ae7c99582f55746692c1123c8d936,0,0,0,0,0,0,0,0,0,0,0,0,0,0,23,8,0,0,0,0,0,0,0,0,0,0,100,NoArch
8b15e117d943a46aaac14fe7a4c6746cfbd8e52b,0,0,0,0,0,0,0,0,0,0,0,0,0,0,27,12,0,0,0,0,0,0,0,0,0,0,100,NoArch
cce962d5668dc5be8c3d3fc4efd0d3f13a234fc4,12,191,272,81,0,0,0,3,102,218,3,9,2.508617916,1906,31,16,109,114,5,9784,9883,99,43,45,2,0,99.98610725,NoArch
9d847e0357a2138687808ee257e53455ae4786c3,0,0,0,0,0,0,0,0,0,0,0,0,0,0,35,20,0,0,0,0,0,0,0,0,0,0,100,NoArch
c4bd519bb4daacd73d6a856ed8588d98a39363e3,0,0,0,0,0,0,0,0,0,0,0,0,0,0,31,16,0,0,0,0,0,0,0,0,0,0,100,NoArch
229aeff334882293c915b27e40a4864878a644b9,214,1905,2078,173,0,0,0,2,103,270,4,96,6.377428888,50873,918,0,5580,5606,26,283257,284315,1058,2136,2142,6,0,99.86103391,NoArch
0f5531490c8c05de53788acf1a527d461b0484f7,1,16,6,10,0,0,0,2,4,5,1,1,0,133,85,0,18,15,3,843,771,72,8,8,0,1,100,NoArch
c6df97ba6352e56bb1d5a431c1eafb64366ed634,2,4,19,15,0,0,0,6,16,4,2,2,0.426228657,347,919,1,46,46,0,1922,2017,95,7,7,0,1,100,NoArch
b285e2d2b39b64b7f5e4c43a919ffad398af0b29,2,56,1,55,1,0,1,1,7,2,1,2,0.297472249,418,86,1,54,51,3,1401,1177,224,30,27,3,1,99.91663193,NoArch
1608f61a2092a021a28b37b1d06fbaedf8049a5a,9,413,47,366,2,0,2,3,5,323,2,8,2.118922689,1640,920,2,251,206,45,10845,7997,2848,86,75,11,1,99.93059411,NoArch
2cd3ea39e3dc70f1ffcffae92cb0901894bed63b,1,1,1,0,0,0,0,6,48,5,1,1,0,620,921,3,80,79,1,2723,2719,4,38,38,0,1,100,NoArch
c9a79471aa9b1c9ff8ce5f8695357e6dab91cd5b,3,40,18,22,0,0,0,1,6,812,1,2,0.886934313,460,922,4,24,21,3,2698,2499,199,8,8,0,1,100,NoArch
35e02588b398447ac1b70077ce529c55e53a2108,1,3,1,2,0,0,0,3,5,22,1,1,0,142,87,2,12,12,0,762,746,16,6,6,0,0,100,NoArch
7d90a581ef2c1a6059ff06403c98069211b89cee,2,6,5,1,0,0,0,2,12,28,1,1,0.994030211,645,88,3,74,74,0,4618,4583,35,34,34,0,1,100,NoArch
a793d3a64edc544ffe5edcf3f7c164814c4f9a22,1,1,1,0,0,0,0,2,5,788,1,1,0,790,923,5,78,78,0,3898,3898,0,38,38,0,1,100,NoArch
09ab62452c81d0423e957bc9e8ac9acb10651ac7,1,1,1,0,0,0,0,4,34,425,1,1,0,151,924,6,5,5,0,477,477,0,2,2,0,1,100,NoArch
0a0551eb06149e2919707237f678e4e9953c836e,0,0,0,0,0,0,0,0,0,0,0,0,0,0,925,2,0,0,0,0,0,0,0,0,0,1,100,NoArch
c395a3b7e68748f88068e8c86ed81d71f77a650a,4,26,17,9,0,0,0,6,71,423,2,3,0.972197183,2101,89,2,253,253,0,12302,12247,55,84,84,0,1,100,NoArch
49a8268ded2d0b9da8866b7aa3676d7acbeae061,0,0,0,0,0,0,0,0,0,0,0,0,0,0,926,3,0,0,0,0,0,0,0,0,0,1,100,NoArch
f543a10d285c7cf97b5d845a938ec24e6feae88b,2,61,0,61,0,0,0,1,19,534,1,2,0.995148096,130,927,4,18,11,7,1420,881,539,8,5,3,0,99.95838535,NoArch
1029bc039fa6b13e000efe9dbdff7800e04be2fc,2,14,5,9,0,0,0,6,26,567,1,2,0.998000884,769,187,0,136,135,1,5874,5817,57,71,70,1,1,100,NoArch
c4b3169a8de7716d9a2d48ddd0902eee3248dd2d,1,1,1,0,0,0,0,1,2,456,1,1,0,344,928,3,53,53,0,1407,1407,0,18,18,0,0,100,NoArch
39a3539b81ad86b488f408eb5441e3328981a07f,1,2,2,0,0,0,0,6,17,110,1,1,0,264,59,0,42,42,0,1586,1586,0,3,3,0,0,100,NoArch
22b0c3d3ca7fb07f5abf34aab6ad3449d5b69c7b,5,385,285,100,1,0,1,4,14,237,1,4,1.71467881,1260,208,0,109,100,9,10025,9184,841,56,51,5,1,99.94452919,NoArch
4300ff31500eab95d54fc6fff2eb5441b4585825,1,25,7,18,0,0,0,4,7,150,1,1,0,511,60,1,50,47,3,3622,3486,136,18,18,0,1,99.68051118,NoArch
c831d30bee3604202f24bf7ba8ec31925a740304,3,0,159,159,0,1,1,8,59,428,1,2,1.031878781,721,209,1,62,80,18,2794,3572,778,38,52,14,0,99.94432846,NoArch
74f9303eeaaf278c507bbabc306c6341af5fc03a,2,155,16,139,0,0,0,2,8,160,1,2,0.98909344,366,90,0,53,35,18,3451,2368,1083,25,19,6,1,100,NoArch
62eeeae391554793dac788c062588deb89ba7ed4,5,14,2,12,0,0,0,1,36,1495,1,3,2.052421284,668,91,1,67,66,1,3373,3282,91,41,40,1,1,99.94431296,NoArch
ba4bd06db2d753d75b00613ade842f5c90f543e1,1,0,41,41,0,1,1,1,2,30,1,1,0,41,210,2,0,2,2,0,310,310,0,2,2,1,99.94429745,NoArch
e73d67ff0b96170fb61a66779a34142f6463d199,1,1,1,0,0,0,0,2,4,1490,1,1,0,104,92,2,17,16,1,506,498,8,10,10,0,0,100,NoArch
b293384f8641db47ce9103f492f5115fe15867f4,1,11,2,9,0,0,0,2,9,48,1,1,0,300,93,1,40,39,1,1857,1801,56,19,18,1,0,100,NoArch
0e291d4e8ad48763447c2cf3826b331392864a41,1,24,0,24,0,0,0,2,5,10,1,1,0,104,94,2,23,17,6,612,506,106,14,10,4,0,100,NoArch
7dc7e095943c1e916da88b3f5d58e8b99d3d187a,3,10,1,9,0,0,0,3,7,804,1,1,1.309296668,462,188,0,61,57,4,2120,2034,86,33,33,0,1,100,NoArch
0fe5282a038e5e5c960912fb32569cd77c77bd75,1,24,1,23,0,0,0,2,6,214,1,1,0,314,189,1,12,11,1,2169,1989,180,7,6,1,1,100,NoArch
a07bfc3abfca6b81b4de537d921828e8728a3a77,26,2560,0,2560,26,0,26,1,1,0,1,4,4.426953384,0,190,2,286,0,286,12408,0,12408,168,0,168,1,99.08890116,NoArch
0b8db82fb99bdd664a1aabed17dc338e8bc3ebc6,4,151,152,1,0,0,0,1,18,84,2,2,1.714141687,255,191,3,14,14,0,1379,1379,0,8,8,0,1,100,NoArch
3d4e6e2e0e2e2a1f8f73f7d83305ce738c5fb477,4,143,28,115,1,0,1,1,3,0,1,2,1.406384598,375,192,4,56,52,4,2678,1500,1178,54,51,3,1,99.9726477,NoArch
0e847ae12d1bc62c9f8bdd16aa3a7ba942c622ac,1,184,184,0,0,0,0,1,3,0,1,1,0,286,193,5,50,50,0,1003,1003,0,49,49,0,1,100,NoArch
aebdfaf6f87a8b89449ba0eb5020a60ee92ab22a,6,250,45,205,2,0,2,1,38,211,1,2,2.05718853,1254,194,6,239,223,16,7920,6502,1418,114,108,6,1,99.89072531,NoArch
be028c7a1ba0e9af8c4a761ad9d89075efbad814,1,38,0,38,0,0,0,1,4,0,1,1,0,39,195,7,4,2,2,660,183,477,4,2,2,1,99.97269997,NoArch
ba3d406896bcb927bf9c5e05b4563d90444833c8,0,0,0,0,0,0,0,0,0,0,0,0,0,0,196,8,0,0,0,0,0,0,0,0,0,1,100,NoArch
5fc1b502dfd649c4c4112252309ef68f453c397a,1,484,0,484,1,0,1,1,1,0,1,1,0,0,197,9,42,0,42,1692,0,1692,27,0,27,1,99.94542229,NoArch
500d981c93dddbb5b9e28cdce02e47c120372273,1,1,1,0,0,0,0,1,2,8,1,1,0,101,198,10,9,9,0,617,619,2,3,3,0,1,100,NoArch
fab8d87d14361db02e37ea756e9b1640b2f74ba0,1,8,1,7,0,0,0,5,87,861,1,1,0,728,929,0,111,111,0,3319,3282,37,36,36,0,1,100,NoArch
e9787eff04cfcfd6192b2412b7053efdc7f120bd,1,3,1,2,0,0,0,3,41,278,1,1,0,237,930,1,26,25,1,1338,1328,10,5,5,0,0,100,NoArch
478cad97b77c6bee4c9a53685a8d7a41b5d99f3c,5,200,34,166,0,0,0,3,20,366,1,1,1.62898398,1714,18,0,140,123,17,8427,7706,721,50,44,6,1,100,NoArch
2424717bdb4309d9d6f84c264feecee09b8c52ef,3,13,10,3,0,0,0,9,61,416,1,2,1.264672679,672,211,0,58,57,1,4299,4292,7,20,18,2,1,100,NoArch
a8f16b8bf83b1bb049f5bd7a83c2d4e0c8b04925,1,199,0,199,1,0,1,1,1,0,1,1,0,0,95,0,28,0,28,1283,0,1283,10,0,10,1,99.93184297,NoArch
a89b08167ae581eb2907f19224ab265856cef8e9,2,176,179,3,1,1,2,1,10,500,1,1,0.999948485,179,96,1,23,46,23,1239,2440,1201,8,16,8,1,99.93192648,NoArch
7a01e245feaa8eb1f9cf6f2d7897b7153f829a1d,1,506,0,506,1,0,1,1,1,0,1,1,0,0,931,1,58,0,58,3008,0,3008,28,0,28,1,99.97280392,NoArch
8b6a26a153cd87720b6f323da1317ea6177a998f,38,230,207,23,0,0,0,2,72,119,3,16,4.65121511,7557,932,1,754,754,0,38870,38892,22,300,300,0,0,99.56604285,NoArch
0bce4cd90a7b8fca3da894e4abff30edd78b1804,1,1,1,0,0,0,0,9,81,329,1,1,0,326,32,0,15,15,0,1252,1252,0,6,6,0,1,100,NoArch
0ab9b15356197e7387714484da9c1cd39a555c84,1,4,7,3,0,0,0,3,11,329,1,1,0,142,33,1,15,15,0,887,889,2,7,7,0,1,100,NoArch
1e3f7aedc67c6c7c7e55afc282447387c7952f91,17,826,614,212,0,1,1,2,62,597,2,3,2.598484274,4396,199,0,621,587,34,27090,25863,1227,319,307,12,1,99.95938262,NoArch
f181ccef73aa77493f846fc27ca34bb58590ddcf,3,4,4,0,0,0,0,3,8,1283,1,3,1.5,1423,200,1,150,150,0,7240,7248,8,66,66,0,1,100,NoArch
1b50c196538a1cc9223f67ac4e41927790b98638,2,63,7,56,0,0,0,2,28,0,1,2,0.881290899,947,201,2,161,149,12,7214,6795,419,82,80,2,1,100,NoArch
f8125269795412cdc1b8602adfb24ea2754a368c,4,4,4,0,0,0,0,4,9,220,1,2,2,2121,202,3,262,262,0,7567,7563,4,88,88,0,1,100,NoArch
308d034c4fb0ca62239c1dd63335ebc981f8e981,4,16,32,16,0,0,0,4,10,110,1,2,2,2354,203,4,289,289,0,8542,8574,32,102,102,0,1,100,NoArch
c4714d8fe38a5d44d8cdd2385942bdb773e83754,1,21,19,2,0,0,0,4,17,41,1,1,0,180,19,1,19,14,5,1126,1071,55,2,2,0,1,100,NoArch
ca9b6d0c814bffc8551debcf2317a60c0ab58df3,8,209,1,208,2,0,2,1,8,949,1,5,2.650625179,2304,204,5,220,193,27,10055,8783,1272,109,93,16,1,99.87823028,NoArch
03e68753602be563af8d19c9e62659ecc9cca67f,4,36,16,20,0,0,0,3,22,93,1,2,1.655067348,1727,20,1,143,139,4,7507,7434,73,50,50,0,1,100,NoArch
b20785fc9d11868bc1c9551ce1db71ef795f9b8e,2,149,1,148,1,0,1,1,34,734,1,2,0.102158036,479,933,2,84,76,8,3642,2479,1163,28,23,5,1,99.94598974,NoArch
5a76df996586396ac28c54474668b207c9274900,1,7,1,6,0,0,0,1,4,1033,1,1,0,211,934,3,25,24,1,1157,1132,25,9,9,0,1,100,NoArch
570202f378e10e4027758e816b82f1e24b64b78e,1,3,1,2,0,0,0,2,5,1113,1,1,0,58,935,0,6,6,0,221,212,9,5,5,0,0,100,NoArch
48daaac77adfa6fc2e3eb4d6ddc0f757e28b6b14,1,1,1,0,0,0,0,3,42,105,1,1,0,239,936,1,25,26,1,1332,1338,6,5,5,0,0,100,NoArch
d688be00c27311031db14a7644a248f9e4cb1881,1,1,2,1,0,0,0,2,3,71,1,1,0,484,937,2,42,42,0,1686,1695,9,27,27,0,0,100,NoArch
9e1ffa407672020df5485c1373a7adcc2d03c1d1,1,224,0,224,1,0,1,1,1,0,1,1,0,0,97,0,25,0,25,1310,0,1310,11,0,11,1,99.89184805,NoArch
d51e8b7358ae605e0770f6cf8ba8323503964585,1,186,0,186,1,0,1,1,1,0,1,1,0,0,98,1,25,0,25,1193,0,1193,6,0,6,1,99.93230436,NoArch
6413ec447742fbb8a86030a7ce9cccdcc9e32ef2,1,1,0,1,0,0,0,6,19,402,1,1,0,310,34,0,39,39,0,1953,1946,7,17,17,0,1,100,NoArch
c98080785a6ffd1b60a3b86862be86b61c9b8dee,1,1,0,1,0,0,0,5,88,167,1,1,0,735,938,0,111,111,0,3336,3319,17,36,36,0,0,100,NoArch
e7011776a60d81073f21306158f3e9ed8cfc1582,1,80,9,71,0,0,0,2,10,1588,1,1,0,151,205,0,14,6,8,1994,1479,515,5,4,1,1,100,NoArch
acda70bccad1a506f13053e216a22c9ecfc5997c,4,58,52,6,0,0,0,2,6,104,1,2,0.750671704,1089,206,1,165,165,0,7460,7421,39,109,109,0,1,100,NoArch
df130cb98c8d8f4accddbcd793a11677b6e2aa36,1,75,46,29,0,0,0,1,2,216,1,1,0,89,207,2,11,10,1,387,368,19,8,8,0,0,100,NoArch
a2375a39c11c09fcd10bbdfee7d5cffda64e2baa,2,19,3,16,0,0,0,5,14,1007,1,2,0.902393283,404,208,3,42,42,0,2364,2102,262,18,18,0,0,100,NoArch
0600c3786af720f261f51f916ae6624dd2193c7b,1,93,0,93,0,0,0,2,17,444,1,1,0,569,939,1,137,119,18,2978,2640,338,65,50,15,1,100,NoArch
5c13640d05309e1a4b7fb99142546cd9bb89ee4e,3,60,31,29,1,0,1,2,7,72,1,2,1.342789207,191,940,2,24,24,0,1213,1154,59,18,18,0,1,99.94588745,NoArch
6529d6340eae2123297d0857d9fbb81f3e8c8176,3,75,57,18,0,0,0,2,31,302,1,1,1.509530689,1798,941,3,403,384,19,8211,8007,204,174,173,1,0,100,NoArch
606139dff68790be49816f8857fb22f5edb17020,0,0,0,0,0,0,0,0,0,0,0,0,0,0,467,0,0,0,0,0,0,0,0,0,0,1,100,NoArch
4884cc4f94b93fb461e2416a89c2cf5207d9213e,2,38,34,4,0,0,0,2,10,1634,1,2,0.997772472,176,942,3,24,23,1,635,591,44,10,10,0,0,100,NoArch
04c337423690a1ba25f9eb1f602dd4caeb472aaf,4,76,37,39,0,0,0,1,11,853,1,4,0.991414536,312,943,4,46,35,11,1592,1399,193,23,18,5,0,99.94589477,NoArch
0c1cb71aa95e4ec789159bf80174fe5ee00c2fb9,2,12,14,2,0,0,0,2,43,350,1,1,0.961236605,329,944,2,45,40,5,1762,1730,32,14,14,0,0,100,NoArch
f96f852a9c77b72c2a521fa89801b202df41624a,12,12,0,12,0,0,0,3,38,1478,1,4,3.584962501,2303,99,0,304,304,0,12275,12251,24,90,90,0,1,100,NoArch
e527616c988f96e3cf60fac7c1229769a8f12935,1,60,19,41,0,0,0,2,11,89,1,1,0,222,209,0,15,14,1,2139,1994,145,5,5,0,1,100,NoArch
dde8b34fdbfb0634a51824ed45ae419eff313212,1,1,1,0,0,0,0,2,12,0,1,1,0,263,210,1,15,15,0,2141,2139,2,5,5,0,1,100,NoArch
127d4503c4408f44695ca0e67302e7f67ecdd417,8,108,126,18,0,0,0,2,12,616,2,7,2.679503926,636,945,0,67,70,3,2769,2919,150,32,32,0,0,100,NoArch
2deba3678e74cf3a59dcc670e9116e50795d590e,27,231,416,185,0,2,2,5,21,1040,4,19,3.412197195,3765,946,1,347,363,16,21080,21714,634,151,158,7,0,99.91877623,NoArch
7dac77913f714143ea76e1c130a2af55ac2374c1,0,0,0,0,0,0,0,0,0,0,0,0,0,0,211,0,0,0,0,0,0,0,0,0,0,1,100,NoArch
63546f99df425b9601511925e785fec619bce110,4,5,13,8,0,0,0,2,10,1433,1,4,1.925126559,550,212,1,88,89,1,2134,2174,40,58,59,1,1,100,NoArch
ac0abc69d9bcbab4e7e3c2b8afddfeb2fbb2fbe6,2,23,1,22,0,0,0,3,5,798,1,2,0.41381685,658,213,2,63,62,1,2683,2459,224,25,24,1,1,100,NoArch
441c8b32dddb80bbdb7844016c9bfda2eabe577d,1,1,14,13,0,0,0,3,6,2,1,1,0,575,214,3,56,58,2,1910,1979,69,22,22,0,1,100,NoArch
69653557a82d62ce18ac2b2f3292ee422ed939f8,1,7,0,7,0,0,0,4,6,633,1,1,0,151,100,0,13,12,1,966,924,42,6,6,0,1,100,NoArch
034f21a11b57b65945d017d1c6d74c3589a1f469,1,4,6,2,0,0,0,4,10,683,1,1,0,80,101,1,10,10,0,300,307,7,8,8,0,1,100,NoArch
b90e8466bc9a4042a648f7f73173e58e012ee8d5,1,1,1,0,0,0,0,6,18,635,1,1,0,192,102,2,5,5,0,1107,1107,0,3,3,0,1,100,NoArch
2b8b2a7d5b9cc726e436e28ad6ff8a5555a36a50,1,1,0,1,0,0,0,4,12,635,1,1,0,183,103,3,10,10,0,1135,1122,13,3,3,0,1,100,NoArch
44f8d0adc2c4b3d7b4b5ce6b2eefedada51e6b9a,3,49,7,42,0,0,0,2,73,507,1,3,1.367535462,1437,104,4,92,89,3,9184,8674,510,37,36,1,1,100,NoArch
f4d8201a5f6090d5cb76bd3fddc1ee4f325a911c,1,5,1,4,0,0,0,4,30,647,1,1,0,361,947,0,51,50,1,1761,1732,29,30,30,0,1,100,NoArch
c81abd5dd6d7efe5970e7cf19edc55e3286eac67,0,0,0,0,0,0,0,0,0,0,0,0,0,0,948,1,0,0,0,0,0,0,0,0,0,0,100,NoArch
8396a27bb2881b59c4aa9bb49427f0e7c27ae095,53,159,191,32,0,0,0,3,104,753,4,41,4.996501548,15915,949,2,1701,1705,4,96560,97085,525,606,606,0,0,99.97290707,NoArch
6a4942cd0fb2dfce2766ce070341242ea8cb9086,36,596,402,194,2,2,4,3,49,1027,3,22,4.516583276,6029,468,0,527,521,6,35830,34586,1244,228,227,1,1,99.59178119,NoArch
f862e2b821ffc202008cb5359350194368d5ac35,2,15,1,14,0,0,0,2,9,583,1,2,1,284,61,0,35,35,0,1924,1792,132,17,17,0,1,100,NoArch
0c99a40783c5f7e66f5759fd1d04be245c4783f2,1,0,2,2,0,0,0,4,17,14,1,1,0,108,62,1,6,6,0,680,698,18,4,4,0,0,100,NoArch
fc6c6f3777bb05cd5e2bbebf2565bcaadcd2bd74,12,26,39,13,0,0,0,3,50,0,2,10,2.78738847,2408,469,1,209,209,0,13343,13541,198,76,76,0,1,99.94532531,NoArch
ace4c35cbe87ed4e485e68173dc97b9a50700a69,4,574,154,420,2,0,2,2,8,675,1,2,1.965836194,417,215,0,71,36,35,5777,2681,3096,30,14,16,1,99.94537012,NoArch
86d269b3104c940ed8ff0d065332e0af347ac523,4,102,38,64,1,0,1,2,9,0,1,2,1.569658147,650,216,1,62,60,2,4275,4050,225,23,22,1,1,99.93180578,NoArch
0afb32c6d15435f37711655b3099569ee4673774,1,1,1,0,0,0,0,2,8,2,1,1,0,278,217,2,18,18,0,2614,2614,0,11,11,0,1,100,NoArch
e200147652165bb457f4b14de4ce96e96f98866d,7,77,23,54,0,0,0,5,23,1631,1,6,2.145365351,954,105,0,104,99,5,5456,5305,151,50,48,2,1,100,NoArch
87a2503b48a4638a82f9b7473e9165600d04cfdc,1,1,1,0,0,0,0,3,6,0,1,1,0,178,106,1,13,13,0,1102,1106,4,5,5,0,1,100,NoArch
c3154b86dce55f8ca318c35f97751d3aeee415aa,5,101,25,76,1,0,1,3,16,0,1,3,1.522148201,663,107,2,58,50,8,4012,3715,297,32,26,6,1,99.94549666,NoArch
49bf055acf29dcc1aa69bd37e97b5dfe3015e7ba,1,0,2,2,0,0,0,3,8,0,1,1,0,191,108,3,13,13,0,1149,1181,32,5,5,0,1,100,NoArch
8a8e10dec709e9869ab8fe411c7fc07c7a7b265c,5,179,55,124,2,0,2,1,19,381,1,3,1.969251515,362,109,4,46,34,12,2373,1819,554,27,19,8,1,99.86385296,NoArch
1d3131815cb929a7f1e580bce825c29a6848b41c,1,26,33,7,0,0,0,4,20,640,1,1,0,360,110,5,54,54,0,1698,1737,39,34,34,0,1,100,NoArch
9dba3cc0501f096ef2e569829d9f18e275334907,3,114,49,65,0,0,0,3,5,1530,1,2,1.349094431,410,111,6,32,25,7,3325,2897,428,13,11,2,1,100,NoArch
bfd82145bfc1d94b7dfabae2bc04737929c41747,2,38,10,28,1,0,1,1,7,282,1,2,0.776555785,198,112,7,22,23,1,756,697,59,14,13,1,1,99.97278912,NoArch
a1e5c7bfc0e48f289e7de4f062a901d625f3e00c,2,19,3,16,0,0,0,6,31,659,1,1,0.994030211,532,113,8,66,64,2,2956,2900,56,38,37,1,1,100,NoArch
1250c232a8ae93c76b28b0fa8b5267362e692d1b,1,1,0,1,0,0,0,3,5,792,1,1,0,235,114,9,18,18,0,1129,1120,9,9,9,0,1,100,NoArch
dbaadb1c8c720a41296fb8a3e215c38aa53ed5ca,0,0,0,0,0,0,0,0,0,0,0,0,0,0,115,10,0,0,0,0,0,0,0,0,0,1,100,NoArch
750a1a0243456b25f259dd55cd71c4a827875ab4,1,6,3,3,0,0,0,3,3,1671,1,1,0,86,116,11,8,7,1,418,406,12,2,2,0,1,100,NoArch
6a8de49a78333bbafddc9877685065d911604942,1,1,1,0,0,0,0,3,10,1539,1,1,0,132,117,12,7,7,0,756,754,2,4,4,0,1,100,NoArch
f2eccdccf8066a8d140949afbaf7162e898140a3,1,2,5,3,0,0,0,2,3,131,1,1,0,181,950,0,24,24,0,1161,1180,19,6,6,0,1,100,NoArch
e7a90d186e1940ce817413eff04a6946db0238d1,1,6,1,5,0,0,0,3,20,2082,1,1,0,329,118,13,60,58,2,1607,1574,33,39,38,1,1,100,NoArch
7b10d65ade075c00a5930437542aa87692c42c15,5,108,4,104,1,0,1,3,8,456,1,2,1.776312527,808,119,14,82,73,9,4911,4289,622,43,40,3,1,99.85046221,NoArch
25b51464a991fa26f566e9c4d79be8a332a81181,2,186,131,55,0,0,0,4,19,735,2,2,0.097689506,277,5,0,12,11,1,1804,1649,155,6,6,0,0,100,NoArch
f2dc2fd6602fcec6d812aeec0eb36f4b2c3a6ff6,1,2,13,11,0,0,0,7,20,0,1,1,0,245,6,1,6,6,0,1241,1241,0,3,3,0,0,100,NoArch
733f4b64b700e80d2f5649306b1daf5ab13d6351,1,38,10,28,0,0,0,7,21,0,1,1,0,234,7,2,8,6,2,1471,1241,230,4,3,1,0,100,NoArch
8511167483774c09fd6620b749991b5493b2213d,1,16,9,7,0,0,0,8,36,826,1,1,0,126,120,15,10,10,0,781,768,13,2,2,0,1,100,NoArch
418f643b2ace74ce0cadc0e5e2d7808cd65674e3,2,138,66,72,0,0,0,4,11,871,1,2,0.282217634,262,121,16,23,23,0,853,854,1,15,15,0,1,100,NoArch
a3baa242603d82f1cc34aec3d08562f76b9ecb03,1,1,1,0,0,0,0,5,20,1115,1,1,0,204,122,17,16,16,0,1301,1299,2,4,4,0,1,100,NoArch
95cf05f1aacee2195e802b515deb2af0a6b8606f,1,17,9,8,0,0,0,7,22,2,1,1,0,262,8,3,8,8,0,1515,1471,44,4,4,0,0,100,NoArch
7071580d31460d854b5f1d7148c37c0c8c42c3f7,1,4,2,2,0,0,0,6,20,393,1,1,0,311,123,18,39,39,0,1957,1953,4,17,17,0,1,100,NoArch
553252f9dd3b744006a1fe755f9ab1785ab47e62,1,5,5,0,0,0,0,4,9,475,1,1,0,527,124,19,50,50,0,3608,3600,8,18,18,0,1,100,NoArch
dce96b20c9b2f5341f37d36cf22130fb8cd2d995,1,0,5,5,0,0,0,5,10,120,1,1,0,244,125,20,33,34,1,1599,1639,40,15,16,1,0,100,NoArch
10c535c16ea567a2105a6cbcbeb2af3321028417,48,561,175,386,2,0,2,2,21,370,4,36,3.528855485,9702,951,1,935,947,12,53905,55424,1519,357,363,6,0,99.91852254,NoArch
d5b6b74306fac6cbcab2498e0e14b3c53b4f7a23,2,164,80,84,1,0,1,1,5,398,1,2,0.939788396,179,952,2,27,16,11,1738,967,771,7,6,1,1,99.95929444,NoArch
21a9c51552b0f7ef94882effa90b072de3ff6a54,1,27,14,13,0,0,0,5,21,1,1,1,0,204,126,21,16,16,0,1364,1301,63,4,4,0,1,100,NoArch
e5cc83df010f7857b3b18284ab5fa963eb3e78c5,4,85,26,59,0,0,0,2,28,935,1,2,1.921826195,677,127,22,119,109,10,3806,3460,346,60,57,3,0,99.90530303,NoArch
c5edfe9ac7f34203ed2f26ab266e5331bc3efa8e,2,5,6,1,0,0,0,3,4,475,1,2,0.945660305,376,128,23,39,39,0,2642,2644,2,13,13,0,1,100,NoArch
63c81f15995fa6dfcd1c11cdd97c9b0d791ee13a,13,458,106,352,6,0,6,2,51,82,2,4,3.20277779,1725,129,24,185,162,23,11545,10018,1527,90,76,14,1,99.66393332,NoArch
1e898e791b0df150485a715542793623e01e860d,8,536,11,525,6,0,6,1,41,19,2,4,2.458472746,275,130,23,60,20,40,3769,1531,2238,32,9,23,1,99.45369753,NoArch
f9baeba30c31ad6f9d2f9b7172589d7c45998c25,2,11,8,3,0,0,0,1,42,0,2,2,0.74248757,290,131,24,17,17,0,1718,1722,4,6,6,0,0,92.78618371,Arch
50349a6053bdc71cae1ab6ccab3ec281b22456dc,1,2,1,1,0,0,0,1,3,0,1,1,0,63,132,25,3,3,0,335,320,15,1,1,0,0,94.17650919,Arch
70eecdb341e017a308813712471539f831144d6a,1,1,1,0,0,0,0,5,43,0,1,1,0,230,133,26,14,14,0,1398,1398,0,5,5,0,0,100,NoArch
10740e3b38433f9e0be0f3edba605cbfd50f8972,2,163,99,64,1,0,1,3,6,12,1,1,0.994907878,193,95,0,19,17,2,1082,841,241,5,3,2,1,99.89478431,NoArch
df39ce464b8383c05f70d46e11e6adfb2adc1ded,7,150,246,96,1,2,3,1,19,12,1,1,2.31485852,720,134,25,42,50,8,3481,4014,533,18,22,4,1,99.65408332,NoArch
5d667589f9f7d775448389c69bf6c6776ef54269,28,44,243,199,0,1,1,2,30,871,2,9,3.548303091,3062,135,26,277,302,25,16223,16825,602,144,166,22,0,99.65324891,NoArch
210b26585d87b7096286b162b733b18f18d9c785,88,236,236,0,2,0,2,6,105,913,4,54,6.005258699,20630,136,26,2217,2229,12,121319,121256,63,809,816,7,0,99.93957704,NoArch
402e296c5efe03d91a8ca8e962705bc79b2b6f23,74,6,101,95,0,0,0,6,106,0,4,49,5.849877356,17042,218,0,1776,1776,0,102549,103259,710,615,615,0,1,99.90906335,NoArch
4841efbcd36c2d7bd160fe673824578f3adc5a23,137,678,642,36,0,0,0,7,107,1147,2,60,5.179445583,21767,137,27,2246,2239,7,106976,106719,257,1079,1074,5,0,100,NoArch
d95bddae46e6b9210a4c4b89d71202e7881a08db,18,240,343,103,3,2,5,2,44,337,1,10,3.676505318,2808,138,27,238,244,6,16246,17008,762,114,120,6,1,99.28375495,NoArch
3c22856e8f2163301aa0ea870622c142427b4b40,59,241,181,60,0,0,0,5,22,1076,2,28,5.102530449,10313,139,25,1122,1121,1,59980,59968,12,431,430,1,0,99.98471883,NoArch
de76182341022df3819c1cf29ca0593ecbf34917,22,24,421,397,0,6,6,4,75,918,3,13,3.023515215,4252,140,25,254,302,48,23317,24630,1313,135,166,31,0,98.78487849,NoArch
67e09b3ee3ada13ae709c18d010f56bfa4555d74,2,16,0,16,0,0,0,5,33,834,2,2,0.954434003,495,219,1,49,49,0,2661,2636,25,23,23,0,1,100,NoArch
1036a80ac81a092574a84b129e936dea37af5907,2,2,2,0,0,0,0,5,34,0,2,2,1,511,220,2,49,49,0,2661,2661,0,23,23,0,1,100,NoArch
6d16230d5548b1acd9762dee1f76b98f2727e2a2,158,1305,1305,0,2,0,2,3,108,491,4,75,5.751680737,39036,141,19,4437,4434,3,199449,199398,51,1812,1809,3,1,99.94103774,NoArch
d1ba46ece920edad9fd87f6306436c3e949c577a,0,0,0,0,0,0,0,0,0,0,0,0,0,0,142,15,0,0,0,0,0,0,0,0,0,1,100,NoArch
5f8070b989f5f6f87fc41053ad91d640dbe8712f,1,1,1,0,0,0,0,5,10,17,1,1,0,166,221,3,24,24,0,974,979,5,7,7,0,1,100,NoArch
e8b1f807ac6ac4dafb3b307769f6af4067f535c0,1,2,1,1,0,0,0,5,10,892,1,1,0,118,222,4,17,17,0,485,485,0,6,6,0,0,100,NoArch
2359f98e7af58e46f2b1b4a87bd5a690ce859fc8,0,0,0,0,0,0,0,0,0,0,0,0,0,0,143,13,0,0,0,0,0,0,0,0,0,1,100,NoArch
bdb1c48561578dc496d05c263b28b68d0c97e2d2,47,643,659,16,3,1,4,5,36,407,4,30,2.942800274,13720,144,14,1747,1747,0,71472,71297,175,581,578,3,1,99.82298274,NoArch
4d1f06290348faa37ce17d2739b94e47923375d0,1,1,1,0,0,0,0,2,35,1451,1,1,0,400,953,0,58,58,0,2272,2274,2,15,15,0,1,100,NoArch
17270d846a337f4b8e5cfa2b19175aa8f07c58c7,4,14,11,3,0,0,0,4,10,28,1,3,1.384381458,1964,63,0,223,222,1,9058,9056,2,89,89,0,1,100,NoArch
46ed1c07f3606df8e3d47ca3531c07b03911659d,2,4,65,61,0,0,0,1,6,282,1,2,0.955758991,242,954,1,17,27,10,841,1175,334,11,15,4,0,100,NoArch
67a531e942f10611477f9ffd4424f957d41cbb7c,32,34,33,1,0,0,0,7,36,706,3,21,4.961611579,8442,0,0,951,951,0,47443,47443,0,302,302,0,0,100,NoArch
c79dde5a9b847c58b888d0745fd4fa86af781f90,1,6,17,11,0,0,0,3,5,46,1,1,0,72,145,4,6,6,0,207,256,49,5,5,0,1,100,NoArch
8ba23091ee0eafe5f303058621cb7b86758b1629,1,38,0,38,1,0,1,1,1,0,1,1,0,0,146,5,2,0,2,113,0,113,2,0,2,1,99.91151748,NoArch
2eaae3646498b74c37ce53604b6129f1697092f3,0,0,0,0,0,0,0,0,0,0,0,0,0,0,147,6,0,0,0,0,0,0,0,0,0,1,100,NoArch
c36dc719028351db110d0acaf1fe65b846c5c258,11,20,20,0,0,0,0,4,19,122,3,10,3.141446071,1769,1,1,133,133,0,10643,10643,0,65,65,0,0,100,NoArch
be945338d4cb09ecd3e165f6b322cf132fc027c0,20,680,269,411,0,0,0,3,42,446,2,7,3.416762918,7490,137,0,1109,1036,73,42723,40649,2074,571,532,39,1,99.98525943,NoArch
be8e8a05152595c3b31e81cb2b3fcf54d951f4d3,3,3,3,0,0,0,0,3,14,0,1,1,1.584962501,200,138,1,13,13,0,1282,1282,0,13,13,0,1,100,NoArch
abd58a8fcd8edf1a6925229864efe0e13cd0bbfb,0,0,0,0,0,0,0,0,0,0,0,0,0,0,139,2,0,0,0,0,0,0,0,0,0,0,100,NoArch
812d0ba2ae098ad86fa66c92f30eb264be78debb,11,1167,650,517,9,0,9,5,10,268,2,2,2.708019221,962,140,3,138,156,18,11288,7010,4278,66,29,37,1,99.63332356,NoArch
0a0fddf469f3f58f74c12dc2fe47ba8d8141c161,14,184,99,85,0,0,0,5,43,415,2,5,2.833142746,4945,141,4,747,737,10,20460,20261,199,420,407,13,1,100,NoArch
3cadef96006421dc7f169bf10de2d0ed4b78bebc,4,58,21,37,0,0,0,1,13,328,2,3,1.790800538,554,142,5,41,39,2,4216,3950,266,20,18,2,0,100,NoArch
1519d015d3b1cb112788e94e7de5ac2466229026,1,24,1,23,0,0,0,5,11,5,1,1,0,462,143,6,59,55,4,3691,3486,205,16,15,1,0,100,NoArch
a95412337722e1cfecf23f8fa29ead6438f55daa,1,3,0,3,0,0,0,5,12,0,1,1,0,485,144,7,60,59,1,3703,3691,12,16,16,0,0,100,NoArch
fc209b78248d6ee12189763df5e8a22118f06e3b,1,4,1,3,0,0,0,6,44,23,1,1,0,911,64,0,190,190,0,4679,4653,26,53,53,0,1,100,NoArch
c9684aae817642fba89483a1d96893e21710011d,1,16,14,2,0,0,0,5,13,27,1,1,0,488,145,5,61,60,1,3704,3703,1,16,16,0,0,100,NoArch
87faa135f14d66f052ed89a5e987d0ccb54c2a1a,1,20,14,6,0,0,0,5,14,0,1,1,0,490,146,6,64,61,3,3728,3704,24,16,16,0,0,100,NoArch
802464db19ab8ea041ba35f26335ba376d61c51d,2,46,10,36,0,0,0,3,4,371,1,2,0.999079718,433,0,0,62,56,6,3028,2828,200,23,21,2,1,100,NoArch
e5ee197bb70a5d0458f45dc93a1f4c8366690109,3,8,5,3,0,0,0,3,11,1321,1,3,1.460484681,472,1,1,51,51,0,3696,3661,35,28,28,0,1,100,NoArch
c233f90323d2aa6413035c694154c67faf4848c2,1,10,7,3,0,0,0,3,3,3538,1,1,0,33,2,2,3,3,0,64,67,3,3,3,0,2,99.92701795,NoArch
f95d551355130df5fd3d147caa6f978ca98c1de4,14,1130,49,1081,1,0,1,1,30,1700,2,8,1.540647638,1912,3,3,227,168,59,7706,5220,2486,166,132,34,1,99.9416314,NoArch
a23d87a0b20b54ffb3a1a64f92e4296c13c45453,2,115,15,100,0,0,0,3,8,1481,1,2,0.817317416,269,4,4,60,42,18,2150,1483,667,26,22,4,1,100,NoArch
a8d3dbd11adf6bb1255cc8c949ef004a78bddee2,28,2454,613,1841,6,0,6,7,45,559,2,4,3.531967282,7397,5,5,1271,1024,247,45683,35253,10430,716,563,153,1,95.99228143,Arch
8649ac2655c4b6dbd0a6065e3a42cea6d6e741b5,10,1467,0,1467,9,0,9,4,5,10,2,3,3.017907142,65,6,6,173,9,164,8278,227,8051,69,7,62,1,99.66857487,NoArch
7b7cfef8a9288fb901505fff1b8f9c7e6374d869,0,0,0,0,0,0,0,0,0,0,0,0,0,0,148,0,0,0,0,0,0,0,0,0,0,0,100,NoArch
97f6db225444438e51cbd132b572168ecd8a01e8,6,164,27,137,0,0,0,4,23,126,1,2,1.759767014,800,149,1,68,54,14,5979,5071,908,35,29,6,1,99.98498047,NoArch
2d3fed22c5b5aa7200b74b581c8e574dab8afc7b,0,0,0,0,0,0,0,0,0,0,0,0,0,0,150,2,0,0,0,0,0,0,0,0,0,1,100,NoArch
fd242548372aba9051f7676ac56b8c8e5e0317ec,6,1516,0,1516,6,0,6,1,1,0,1,3,2.400368488,0,7,7,130,0,130,7268,0,7268,40,0,40,1,99.71518513,NoArch
d54c59b406def0d478e2c005e49fcfaa803f6b2d,10,92,5,87,0,0,0,6,13,1168,1,3,2.637270476,913,2,0,101,101,0,4308,4308,0,62,62,0,0,100,NoArch
672364de57c8ba570fd6944e1ee29d319339f792,0,0,0,0,0,0,0,0,0,0,0,0,0,0,3,1,0,0,0,0,0,0,0,0,0,0,100,NoArch
69ce85fa6e2f6e1ba3a430057c6f790db60b596e,0,0,0,0,0,0,0,0,0,0,0,0,0,0,4,2,0,0,0,0,0,0,0,0,0,0,100,NoArch
b7ebff7fd747e8986dc41839a1b194c742eb1c78,0,0,0,0,0,0,0,0,0,0,0,0,0,0,5,3,0,0,0,0,0,0,0,0,0,0,100,NoArch
1d6dc496f13d049caf6b2b5fab50cc9a3561bffd,7,1166,0,1166,7,0,7,1,1,0,1,2,2.350392715,0,8,8,81,0,81,6550,0,6550,41,0,41,1,99.65722802,NoArch
ec9035c60d8133286de3a7a123d299e25d2a1991,8,533,0,533,3,0,3,1,2,10,1,5,1.799152543,919,9,7,140,75,65,9941,7086,2855,62,32,30,2,99.91100564,NoArch
4edc814197dcae1c4c085b326aba5c4ba5c73600,2,33,3,30,0,0,0,1,3,18,1,2,0.918295834,523,10,7,73,66,7,3515,3345,170,20,19,1,1,100,NoArch
5b29d0367ff99d215d30a45355f9257df36f24d8,1,0,3,3,0,0,0,1,3,0,1,1,0,164,11,7,14,14,0,1374,1410,36,7,7,0,1,100,NoArch
a400cb8acb5ad65c28ac646a1b1208451e0b0c50,2,14,0,14,0,0,0,4,15,1880,1,2,0.371232327,215,6,4,38,37,1,1192,1108,84,15,14,1,1,99.98518079,NoArch
cb80ec66ec9e2b4acbc94182a3c64c9c429ae043,1,0,3,3,0,0,0,1,3,9,1,1,0,164,12,5,12,12,0,1173,1216,43,4,4,0,1,100,NoArch
9899396f574ec686b4cd12e9d786ef98a7414775,1,24,41,17,0,0,0,1,3,11,1,1,0,327,13,6,50,52,2,1682,1727,45,10,11,1,1,100,NoArch
bc5ca9400f45de703aa82ff051c238f75fdcc3a2,1,8,4,4,0,0,0,1,2,33,1,1,0,355,14,7,23,22,1,975,958,17,11,11,0,1,100,NoArch
bad258a7ad3d5240538e2dc6566a35f62fe04f40,1,0,3,3,0,0,0,3,7,153,1,1,0,505,955,0,57,58,1,2960,2987,27,28,28,0,0,100,NoArch
dc62944247cc3dbc212aad50fd9d7243ce3fd446,84,308,556,248,0,0,0,3,46,601,4,48,5.75961551,20292,65,0,2328,2333,5,108932,110951,2019,1115,1114,1,1,100,NoArch
a6f16219a25291db451a3ff20d0a604089c5991b,1,17,10,7,0,0,0,5,19,678,1,1,0,194,7,4,21,21,0,1192,1162,30,2,2,0,1,100,NoArch
754fd18bd52d198518ce0ac3882581427593ece1,0,0,0,0,0,0,0,0,0,0,0,0,0,0,8,3,0,0,0,0,0,0,0,0,0,1,100,NoArch
cfc31552094358301ab5d31d932620d599d29723,3,27,1,26,0,0,0,3,25,178,1,2,1.151565379,556,9,3,78,76,2,3672,3452,220,20,19,1,1,100,NoArch
b04eba0733e756fb367109613e61cd18a3a62d81,6,50,21,29,0,0,0,4,28,363,1,4,2.211447357,1596,10,4,243,241,2,10322,10117,205,124,123,1,1,99.98518079,NoArch
096d686486fb30a2dbce9c4e33ecc9875a2c0fa8,1,0,2,2,0,0,0,4,8,0,1,1,0,34,11,5,3,3,0,110,117,7,1,1,0,1,100,NoArch
aeb8c72aec0ad5be73d94eb21ad4b90517e7b00b,1,14,0,14,0,0,0,3,5,1,1,1,0,73,12,6,3,2,1,590,466,124,3,2,1,1,100,NoArch
8c539d2b051ce7f9ac6a9b13256708935b6ad44a,2,11,7,4,0,0,0,3,16,3,1,2,0.918295834,331,13,7,37,37,0,2213,2215,2,18,18,0,1,100,NoArch
d40bf86a1084c778b6125db83f125cfd596036ab,1,3,3,0,0,0,0,4,25,23,1,1,0,372,151,0,28,28,0,2428,2420,8,13,13,0,0,100,NoArch
dca3aab6fc8bb26513e226eb77600322d5b0e9e8,1,8,9,1,0,0,0,5,25,1038,1,1,0,107,147,0,8,8,0,697,692,5,5,5,0,1,100,NoArch
67d149037c651cbe2a341e2548bde70fb5fdb4dc,2,29,14,15,0,0,0,6,14,112,1,1,0.782444129,791,14,8,132,129,3,5040,4944,96,55,55,0,1,100,NoArch
ed9e993d7eb23de48c2d7133d760b1fb085d5f08,1,2,0,2,0,0,0,3,9,1827,1,1,0,64,148,1,6,6,0,237,221,16,6,6,0,1,100,NoArch
740a9c958330d665987808a6f04813c217322c55,3,119,13,106,0,0,0,4,31,179,1,2,1.273550527,459,149,2,78,62,16,3821,2992,829,34,30,4,1,100,NoArch
f5b2ef2651945b120c301bbcaea773f75ef3c3fe,2,339,0,339,1,0,1,1,11,85,1,2,0.052174468,565,150,3,117,71,46,4123,2020,2103,32,24,8,1,99.92589299,NoArch
dda8a7814ef8ccbaf5056e76663d81dc946cd48f,3,7,3,4,0,0,0,4,19,1268,1,2,1.370950594,330,470,0,16,16,0,2023,1966,57,8,8,0,1,100,NoArch
4ce12cc008e64d4c301123c13c8ce1fe007497a0,10,68,30,38,0,0,0,2,109,537,1,9,2.814549337,3123,34,0,265,260,5,15952,15784,168,128,125,3,1,100,NoArch
e3ec9d80c23269e3160494575dfa283459da5e02,39,180,148,32,0,0,0,4,79,811,3,26,4.892158067,9574,35,1,710,707,3,62406,62105,301,341,339,2,1,100,NoArch
ab0c8f3dac1e88724fe5bb01a4141b9db98f8168,0,0,0,0,0,0,0,0,0,0,0,0,0,0,36,2,0,0,0,0,0,0,0,0,0,1,100,NoArch
da4f5c94abdc1adc6a95a38ca645a07832888a22,0,0,0,0,0,0,0,0,0,0,0,0,0,0,152,1,0,0,0,0,0,0,0,0,0,1,100,NoArch
0c43ada4a6d5690538a326148ff643647ddde44d,0,0,0,0,0,0,0,0,0,0,0,0,0,0,151,4,0,0,0,0,0,0,0,0,0,1,100,NoArch
092f374530822d6cbd2d4bcea5d5902b8a673f1a,1,9,11,2,0,0,0,9,26,13,1,1,0,265,152,5,42,42,0,1565,1581,16,3,3,0,1,100,NoArch
d1e5295b786f159731c348671d63520ffaf7167c,3,26,16,10,0,0,0,4,22,147,1,2,1.409975019,595,153,6,52,48,4,3880,3783,97,9,9,0,1,100,NoArch
6657591cb459b058643f2d31c7ee96df1d01fc95,0,0,0,0,0,0,0,0,0,0,0,0,0,0,471,1,0,0,0,0,0,0,0,0,0,1,100,NoArch
8dc2719a33efaa35492e3147b987583e7ffa5a3f,0,0,0,0,0,0,0,0,0,0,0,0,0,0,472,2,0,0,0,0,0,0,0,0,0,1,100,NoArch
f2ad4e16e7778d6652d3383d402e7819d7629dd6,0,0,0,0,0,0,0,0,0,0,0,0,0,0,473,3,0,0,0,0,0,0,0,0,0,1,100,NoArch
454557b65eaf7deca7bf5e35a644ce57f2a44ab3,1,4,3,1,0,0,0,5,12,2,1,1,0,96,474,4,14,14,0,391,389,2,7,7,0,0,100,NoArch
a3306645e446d00237e41d722e0ee74f89dcec84,3,54,5,49,0,0,0,1,3,52,1,2,1.231263763,830,15,3,52,50,2,5000,4754,246,22,21,1,1,100,NoArch
ee8e393ee7a4f245861b1648966ca05adef5096f,2,53,7,46,1,0,1,2,14,2610,1,2,0.85995305,266,153,2,35,34,1,1252,1094,158,25,24,1,1,99.94073196,NoArch
f09ea540f2e8fc0d87d110018194745c030fb482,1,1,2,1,0,0,0,1,2,70,1,1,0,283,16,4,35,35,0,1473,1485,12,10,10,0,1,100,NoArch
6d87badaaf89bdf2e76ea87aed0b1c549576ace8,2,10,1,9,0,0,0,3,25,927,1,2,0.684038436,329,154,7,53,52,1,1784,1720,64,24,23,1,1,99.9555753,NoArch
77cbd83e5504480667a57d06354421e2ed29cd65,2,5,5,0,0,0,0,5,16,332,1,2,0.721928095,417,956,1,42,42,0,2320,2326,6,18,18,0,1,100,NoArch
89a2ba02042fa9aa4eced6801bbd566a25e3c392,4,117,96,21,0,0,0,7,18,114,1,2,1.497411509,554,15,8,52,44,8,3913,3533,380,27,23,4,1,100,NoArch
26e532fd792ed08203c94ef02c480708a9e92d33,2,82,62,20,0,0,0,3,26,2,1,2,0.870864469,338,155,8,59,53,6,1947,1784,163,25,24,1,1,100,NoArch
fa5336eba62537b237df358338bc723c1398a7ea,1,2,5,3,0,0,0,3,9,0,1,1,0,126,156,9,12,12,0,650,681,31,8,8,0,1,100,NoArch
9ced02fb64732b1b664c01bacdd54fc28760d631,0,0,0,0,0,0,0,0,0,0,0,0,0,0,16,9,0,0,0,0,0,0,0,0,0,1,100,NoArch
4ca6b866a4b2cdacec85be5f1828594a1ef76754,97,266,257,9,0,0,0,2,110,407,4,59,6.024502753,25678,957,2,2769,2765,4,153016,153189,173,1135,1132,3,0,100,NoArch
2282122dcd1e27747f44da7ba08e5c63a6627b0c,2,138,95,43,0,0,0,5,7,197,1,2,0.962347605,382,475,5,43,39,4,2886,2664,222,15,13,2,1,100,NoArch
5c200426dd8f29d0b073caea4b85b1f49223117f,0,0,0,0,0,0,0,0,0,0,0,0,0,0,958,3,0,0,0,0,0,0,0,0,0,1,100,NoArch
10093c97f3dc09660f839da83aabfc97e20fef93,0,0,0,0,0,0,0,0,0,0,0,0,0,0,157,10,0,0,0,0,0,0,0,0,0,1,100,NoArch
554bcb9a2d7dfe1bc7c4ef2e2e9a562437c62082,18,2050,0,2050,18,0,18,1,1,0,1,2,3.876381346,0,476,6,200,0,200,11446,0,11446,120,0,120,1,99.36736796,NoArch
cbab3380c963f42f261ee63d10d1659344f19e3b,0,0,0,0,0,0,0,0,0,0,0,0,0,0,17,10,0,0,0,0,0,0,0,0,0,1,100,NoArch
42b4d33be64a2d00d2a1665697d6d2d0efee19fe,16,380,356,24,0,0,0,1,2,0,1,2,3.656514102,1929,477,7,200,187,13,11232,10846,386,113,109,4,1,99.95614035,NoArch
6e333b9dab6f2be809a73b31f492cf8bb3269b99,1,42,0,42,1,0,1,1,1,0,1,1,0,0,478,8,6,0,6,217,0,217,2,0,2,1,99.89769073,NoArch
e48eb4cb394c8dfe5ed395dd77d769792c1eaa43,11,20,20,0,0,0,0,4,22,135,3,10,3.141446071,1763,479,9,132,132,0,10606,10606,0,65,65,0,1,100,NoArch
b5c8c04927b8b59e64e065ff5e1422d27c2d8f71,4,151,0,151,4,0,4,1,1,0,1,1,1.977067143,0,480,10,13,0,13,722,0,722,13,0,13,1,99.78105386,NoArch
4a6453cdefac463d15c02371b0042c0b3be7e556,11,77,44,33,0,0,0,2,28,648,2,10,2.465542213,1983,481,11,195,187,8,10556,10421,135,85,85,0,1,100,NoArch
54a66572dfce70f67851b672da0662d7b1916442,21,202,31,171,0,0,0,2,12,96,1,3,4.00315553,1840,18,11,168,168,0,11088,11272,184,108,108,0,1,99.92713495,NoArch
72c68828a0018a736caa596dd7fa1f92e19d7335,1,15,12,3,0,0,0,5,14,219,1,1,0,252,482,12,23,22,1,1784,1759,25,9,9,0,2,100,NoArch
e66f94b8ea6e4a3feac3aa0d92a50b593d17c647,2,17,2,15,0,0,0,2,4,0,1,2,0.831474388,252,483,13,15,14,1,1578,1420,158,13,13,0,1,100,NoArch
bbd2b7ea35a36804a2f813cebfdd66061adaabcc,10,320,69,251,0,0,0,3,47,192,1,6,2.63463867,1830,154,3,177,163,14,12689,10938,1751,77,70,7,1,99.86888112,NoArch
dd56a290f592281f80f0146139a2c954b98aa352,3,183,4,179,1,0,1,1,19,76,1,3,0.902463468,683,155,4,58,49,9,6457,5347,1110,37,32,5,1,99.97086247,NoArch
01b6488536a3102b20e5e4d109afff3d02c77684,1,7,4,3,0,0,0,9,63,226,1,1,0,185,484,14,10,10,0,1097,1076,21,5,5,0,1,100,NoArch
81419837bb4a88540e126f20009419c644236f09,0,0,0,0,0,0,0,0,0,0,0,0,0,0,19,12,0,0,0,0,0,0,0,0,0,1,100,NoArch
e6370c079379b5640dadb7e8f3a62068bfeac432,1,3,3,0,0,0,0,5,9,0,1,1,0,361,20,13,34,34,0,2604,2598,6,16,16,0,1,100,NoArch
6b7f601ad34d484b7c63a7711d7964c0beaf132c,7,206,173,33,0,0,0,5,8,838,1,4,1.989594031,1537,156,5,176,171,5,8465,8092,373,72,72,0,1,99.62154294,NoArch
d0bed6dbb08a76ff018e0b248e2be60bccf2431c,4,240,161,79,2,0,2,1,8,480,1,2,1.749499457,572,157,6,41,28,13,4600,3932,668,20,13,7,1,99.91277802,NoArch
06ce99241a610b15a556104e8f5ccf75ffd6cfb0,0,0,0,0,0,0,0,0,0,0,0,0,0,0,485,15,0,0,0,0,0,0,0,0,0,1,100,NoArch
bbf536942a6044048b6f909dfe346268f5370df9,9,367,269,98,0,0,0,4,24,532,1,4,2.414614675,1473,486,16,123,111,12,8686,7854,832,35,32,3,1,96.01139601,Arch
8bd9487ae9ed9e8e136e95d1ac7fb839895242d6,0,0,0,0,0,0,0,0,0,0,0,0,0,0,487,17,0,0,0,0,0,0,0,0,0,0,100,NoArch
31cb292293bd539e29458896e78bad5d72b2b895,123,240,208,32,0,0,0,4,89,506,3,79,6.613503289,25228,488,18,2349,2340,9,143733,143247,486,950,950,0,1,99.94910294,NoArch
035cd73153fa6ca2c5e521a7c16193986ba1639f,2,62,1,61,0,0,0,4,59,0,1,2,0.817507288,1015,489,19,110,103,7,5126,4660,466,52,46,6,1,100,NoArch
87d4b2e03012ca44f5c0f6629b0546785d9058ee,93,360,364,4,0,0,0,5,81,12,3,61,6.052300696,17910,17,2,1455,1455,0,107209,107244,35,594,594,0,1,99.91088479,NoArch
7678af4d27230234c07767c40fb9ff2bf3e8e203,5,87,206,119,0,1,1,7,20,56,1,2,1.829632567,653,158,7,50,58,8,3760,4280,520,21,29,8,1,99.9617737,NoArch
f58960dca071c6c0d4ab46e3bb19b428ce8f0734,2,9,4,5,0,0,0,4,18,0,1,2,0.619382195,563,490,20,41,40,1,3246,3203,43,10,10,0,1,100,NoArch
25d59aa146c7edc802832cbcd5ef076ba4d92bd2,8,36,14,22,0,0,0,2,34,8,2,8,2.575616305,2012,491,21,187,183,4,11423,11135,288,64,64,0,1,100,NoArch
6d9179e1497f89a3fb1703c31918f9cdf46b60a2,19,84,146,62,0,0,0,3,35,59,3,16,3.576478532,5004,159,8,439,461,22,26601,27325,724,170,169,1,1,99.98724815,NoArch
17f63629727bc2b67fb6d0ac1b0df0f15eb6c257,127,127,0,127,0,0,0,5,81,993,1,30,6.988684687,17771,160,9,1633,1633,0,99147,98893,254,647,647,0,1,100,NoArch
b5d68c5a09af34dc79f54f81a32a36302885f127,3,323,0,323,3,0,3,1,1,0,1,2,1.574755245,0,21,13,28,0,28,1688,0,1688,9,0,9,1,98.67958813,NoArch
3aa430961e0bd0cd3de24c7f600eb210749ab11e,0,0,0,0,0,0,0,0,0,0,0,0,0,0,22,14,0,0,0,0,0,0,0,0,0,1,100,NoArch
4da4468986b9dd2b4837ac1fa6796681a4c37392,1,3,3,0,0,0,0,5,8,1,1,1,0,142,23,15,13,13,0,676,682,6,8,8,0,1,100,NoArch
1c16298cd7c72738519f8e5018ba16210a0f2f5b,1,1,0,1,0,0,0,4,10,235,1,1,0,550,66,0,64,64,0,3726,3719,7,17,17,0,1,100,NoArch
fab9d376a2b17d4487a75250bdf1c96908cfadf6,3,456,0,456,3,0,3,1,1,0,1,1,1.352478686,0,18,3,39,0,39,3193,0,3193,12,0,12,1,99.42837544,NoArch
58cc1ae19757e09389196dff605359be72f797fe,114,515,496,19,0,0,0,3,111,163,4,60,5.943516619,29826,161,10,3160,3174,14,152689,152612,77,1390,1393,3,1,100,NoArch
8b194c80a6645b9dc7f0851fb33e224b553a6a37,23,31,31,0,0,0,0,5,35,0,3,14,4.349199939,7299,162,11,865,865,0,33960,33960,0,407,407,0,1,100,NoArch
bf555a67db57bd27e28728cef1eeb078d592d03f,4,16,4,12,0,0,0,3,5,0,1,3,1.021928095,463,24,11,40,40,0,2456,2484,28,27,27,0,1,100,NoArch
2c2b52d9173be7b1b3284554a590fa04fa6a3d14,1,2,1,1,0,0,0,2,4,16,1,1,0,85,25,12,6,6,0,567,560,7,3,3,0,1,100,NoArch
33af892642740f01291ea88ed30bebe2626270d6,1,1,3,2,0,0,0,6,36,0,1,1,0,371,158,11,61,62,1,1434,1454,20,44,44,0,1,100,NoArch
727ddf6a52b5341d79f364ef6a4fed9772b67fbf,2,2,0,2,0,0,0,3,9,1269,1,2,1,308,163,12,27,27,0,1524,1520,4,13,13,0,1,100,NoArch
11321f7cccac0e32c90d0fecb132351aca69a1bc,6,6,0,6,0,0,0,3,21,2382,1,2,2.584962501,447,164,13,31,31,0,1636,1624,12,20,20,0,1,100,NoArch
4cd0064939fb84bf343e3cff9401f37d8870df9f,2,64,1,63,0,0,0,3,15,1342,1,2,0.198234964,434,26,12,31,30,1,3281,2849,432,19,18,1,1,99.94320763,NoArch
8460c0cbcf029beaa64f082e73d2a45f0b05f342,1,22,10,12,0,0,0,3,16,1,1,1,0,325,27,13,16,16,0,2617,2556,61,6,6,0,1,100,NoArch
6b6b8a0211bb1cf6ba201e05e687ac8c1f97666f,7,92,49,43,0,0,0,3,6,16,1,3,2.656533935,1505,19,3,122,111,11,6922,6735,187,48,46,2,1,99.93179493,NoArch
eb78d61e6f74fd1ae3102729667d605ee2b63ee9,1,6,6,0,0,0,0,2,3,11,1,1,0,456,20,4,41,41,0,1961,1952,9,9,9,0,1,100,NoArch
7f431a0494c6ab1c7f3ded7f45f3b3890c38ef28,2,10,6,4,0,0,0,2,5,0,1,1,1,153,21,4,13,12,1,990,969,21,7,6,1,0,100,NoArch
16e1e41ef34631e96d911b4a2081da6525204e5a,1,17,0,17,0,0,0,3,5,0,1,1,0,58,28,13,7,7,0,411,411,0,3,3,0,1,100,NoArch
4aed7cce0f7ff2c34348ac8d101e706838199598,5,88,103,15,0,0,0,5,61,112,1,3,0.739462369,1530,165,11,173,175,2,8318,8491,173,70,72,2,1,100,NoArch
9152a13729be2c43f6d275c5cc7f2c845777e14b,15,98,58,40,0,0,0,6,75,1092,1,3,3.320747706,1528,166,12,151,151,0,7972,7762,210,52,50,2,1,100,NoArch
157bca3ba477b0f1480958b11f9d8950e7c841aa,1,78,17,61,0,0,0,3,3,15,1,1,0,65,159,4,12,6,6,1005,448,557,4,3,1,0,100,NoArch
335a993715963616980d746f9d80d28f0c22fabe,46,98,91,7,0,0,0,5,79,116,1,27,4.949375565,10615,959,0,1042,1042,0,55183,55229,46,409,409,0,0,100,NoArch
d711ac12007394a990e0dbc7c5cb8426a20eacdd,11,1169,219,950,4,0,4,5,63,39,2,4,3.07153925,1568,29,8,245,150,95,14097,7655,6442,105,76,29,1,99.89792446,NoArch
f656195b54f0ebddbd4c1aa65c8db22ce30a0f49,1,0,1,1,0,0,0,2,5,33,1,1,0,86,30,6,6,6,0,560,567,7,3,3,0,1,100,NoArch
22533ae66540ba3d86167b20f859095fd640f995,8,70,67,3,0,0,0,5,64,5,2,4,2.372132768,2311,31,7,247,247,0,12847,12838,9,101,101,0,1,99.87552337,NoArch
53fe357aba3194ae1cf3a28e056e948a629d640f,2,2,2,0,0,0,0,8,21,0,1,1,1,532,32,8,46,46,0,3412,3422,10,14,14,0,1,100,NoArch
d49d4c8a2d8f19c84f5f7b5543d2aa427390f0c6,3,2,7,5,0,0,0,3,5,33,1,1,0.986426729,420,33,9,51,52,1,2182,2187,5,22,22,0,1,100,NoArch
7ee9154fa43f2550ce64bb81f3e2bcbaec04feda,1,1,1,0,0,0,0,4,12,24,1,1,0,536,167,6,63,63,0,3575,3575,0,16,16,0,1,100,NoArch
13aa5273ea661af61f19096067ec1fefa97a790e,0,0,0,0,0,0,0,0,0,0,0,0,0,0,34,10,0,0,0,0,0,0,0,0,0,1,100,NoArch
3ea5a17fb5218699ae361c52a67318480d1d12be,4,16,18,2,0,0,0,2,5,44,1,2,1.943854923,238,35,11,15,15,0,937,948,11,13,13,0,1,100,NoArch
c533e9376d40736c1cd95f4ed58b4c28ed3da697,0,0,0,0,0,0,0,0,0,0,0,0,0,0,36,12,0,0,0,0,0,0,0,0,0,1,100,NoArch
656537eb4a62a5d4afe0f35597883105aa05b490,0,0,0,0,0,0,0,0,0,0,0,0,0,0,0,0,0,0,0,0,0,0,0,0,0,0,100,NoArch
b44256efca249c6b3b7b16dc3106db1c82e068a1,1,1,1,0,0,0,0,5,12,256,1,1,0,270,1,1,50,50,0,1249,1249,0,33,33,0,0,100,NoArch
74078b68af6456a19db6ae8f7c49f52adffeae2d,6,206,211,5,0,0,0,5,22,4,1,2,1.582779476,1401,37,13,102,103,1,9485,9169,316,33,33,0,1,99.95479715,NoArch
efe408bafef6edd3076d35ea85117a032d136879,1,28,28,0,0,0,0,7,28,6,1,1,0,398,38,14,48,51,3,2063,2062,1,20,20,0,1,100,NoArch
b35e54fb71bfcbd5563d06eea5145fab5ec9ad1d,4,422,156,266,2,0,2,1,39,30,1,4,1.963280049,580,160,1,59,35,24,5174,3104,2070,20,15,5,1,95.59899117,Arch
99a5ce8c56a168084a5f4f0ae26ae1032bcefa79,3,3,9,6,0,0,0,2,27,0,1,3,1.040852083,507,39,13,28,28,0,3287,3344,57,9,9,0,1,100,NoArch
cb9a9eab9ff7dacd3efc7df149f2d1db6ba6dbeb,2,21,28,7,0,0,0,10,40,0,1,2,0.803090976,463,40,14,40,42,2,2565,2584,19,13,13,0,1,100,NoArch
9d7d6151ccc387fde6bbe092d2cedffafcc7c77e,0,0,0,0,0,0,0,0,0,0,0,0,0,0,41,15,0,0,0,0,0,0,0,0,0,1,100,NoArch
eae8c6c84b8a6481d1c16feb9c6627ef6dc03ee0,0,0,0,0,0,0,0,0,0,0,0,0,0,0,42,16,0,0,0,0,0,0,0,0,0,1,100,NoArch
4a8ffdc594c84eefcdd03d087403f231e37fffea,0,0,0,0,0,0,0,0,0,0,0,0,0,0,2,2,0,0,0,0,0,0,0,0,0,0,100,NoArch
3173c6a2ffd19df9a732a0dbb976293fe25ed457,0,0,0,0,0,0,0,0,0,0,0,0,0,0,3,3,0,0,0,0,0,0,0,0,0,0,100,NoArch
2880d6a27b31dd52f175222a8da02395f4e00552,0,0,0,0,0,0,0,0,0,0,0,0,0,0,4,4,0,0,0,0,0,0,0,0,0,0,100,NoArch
5febdc5554ad0479ae8a9125b887fe192452116e,0,0,0,0,0,0,0,0,0,0,0,0,0,0,5,5,0,0,0,0,0,0,0,0,0,0,100,NoArch
371bef607ac191a6f90ef366a42d912325f7f0f5,0,0,0,0,0,0,0,0,0,0,0,0,0,0,6,6,0,0,0,0,0,0,0,0,0,0,100,NoArch
f9c7de41950c5ed764831207acf96be2ecc3f8c1,0,0,0,0,0,0,0,0,0,0,0,0,0,0,7,7,0,0,0,0,0,0,0,0,0,0,100,NoArch
2f9697f89c61f77e8474f647812f11aed46c46dc,0,0,0,0,0,0,0,0,0,0,0,0,0,0,8,8,0,0,0,0,0,0,0,0,0,0,100,NoArch
a362bb5876ede0c14352297cee46dd763b3dc555,0,0,0,0,0,0,0,0,0,0,0,0,0,0,9,9,0,0,0,0,0,0,0,0,0,0,100,NoArch
54025dfac4d3edfc28dc63b9d58bcb1924edb817,0,0,0,0,0,0,0,0,0,0,0,0,0,0,10,10,0,0,0,0,0,0,0,0,0,0,100,NoArch
47576b7da37c68bd32e9e9144ee5b6220da20570,0,0,0,0,0,0,0,0,0,0,0,0,0,0,11,11,0,0,0,0,0,0,0,0,0,0,100,NoArch
cd13dfd89072713c491edd0b61e9461f04396f32,0,0,0,0,0,0,0,0,0,0,0,0,0,0,12,12,0,0,0,0,0,0,0,0,0,0,100,NoArch
f7feb2328f49af2f136d3af6c969fc5fc8d916d4,0,0,0,0,0,0,0,0,0,0,0,0,0,0,13,13,0,0,0,0,0,0,0,0,0,0,100,NoArch
ff32b1adca4dcf123924c1b538ee83cda21f8fdd,0,0,0,0,0,0,0,0,0,0,0,0,0,0,14,14,0,0,0,0,0,0,0,0,0,0,100,NoArch
4e71b72cc609ee245a8da19d85e68810221b4c55,0,0,0,0,0,0,0,0,0,0,0,0,0,0,15,15,0,0,0,0,0,0,0,0,0,0,100,NoArch
bf1e899d328df636b8bd3ef5f726ff955b2626a6,0,0,0,0,0,0,0,0,0,0,0,0,0,0,16,16,0,0,0,0,0,0,0,0,0,0,100,NoArch
8e68ee590688fef4ac214906f191ded0ff827f57,0,0,0,0,0,0,0,0,0,0,0,0,0,0,17,17,0,0,0,0,0,0,0,0,0,0,100,NoArch
60a602d00536dbd3c828261c8f21d24e9eda0689,0,0,0,0,0,0,0,0,0,0,0,0,0,0,18,18,0,0,0,0,0,0,0,0,0,0,100,NoArch
0c9478ece1a4161c8c0ef0a75ad42cec5c560e2c,1,0,2,2,0,0,0,3,8,37,1,1,0,89,43,14,9,9,0,329,329,0,8,8,0,1,100,NoArch
097ec69706778c041aa3d9d949b7cf003b2bebf6,0,0,0,0,0,0,0,0,0,0,0,0,0,0,19,19,0,0,0,0,0,0,0,0,0,0,100,NoArch
81f7dfa09091102911e1707082a30b9962a60034,2,692,0,692,2,0,2,1,1,0,1,2,0.999783071,0,168,1,67,0,67,4279,0,4279,28,0,28,1,99.928714,NoArch
27a4d3f97549e222b07edcd9f2e5bac099bebbbe,0,0,0,0,0,0,0,0,0,0,0,0,0,0,492,0,0,0,0,0,0,0,0,0,0,0,100,NoArch
86573002086f6f0381c4aa927efac76608cd7f0a,0,0,0,0,0,0,0,0,0,0,0,0,0,0,493,1,0,0,0,0,0,0,0,0,0,0,100,NoArch
060e6cf4091a4bcc7e9d30d12211d74eb02d45b6,0,0,0,0,0,0,0,0,0,0,0,0,0,0,493,1,0,0,0,0,0,0,0,0,0,0,100,NoArch
eb465f42c91eaedb50030ae19c24315c621b8833,0,0,0,0,0,0,0,0,0,0,0,0,0,0,20,20,0,0,0,0,0,0,0,0,0,1,100,NoArch
7619995a0ab5a5faf95c7c61dd66bb3180721c37,0,0,0,0,0,0,0,0,0,0,0,0,0,0,21,21,0,0,0,0,0,0,0,0,0,1,100,NoArch
f43adfea425fe2a34f4c845df6fe7dbea5f68261,11,163,54,109,2,0,2,1,24,120,2,4,2.572350403,3129,21,0,357,347,10,15628,15026,602,153,145,8,1,98.57806946,NoArch
bc8eafdd518b121fc79377b67537f7b0b08d38c7,6,86,175,89,0,1,1,6,31,257,2,5,1.313829684,2256,22,1,240,246,6,11836,12157,321,62,65,3,1,97.56559031,Arch
5b56a529b9ed4e17b68283aeb1f139fa5869a4a6,0,0,0,0,0,0,0,0,0,0,0,0,0,0,22,0,0,0,0,0,0,0,0,0,0,1,100,NoArch
9676d7a5a55b1efc6ad64ce6e93c94e2e3cc38de,0,0,0,0,0,0,0,0,0,0,0,0,0,0,23,1,0,0,0,0,0,0,0,0,0,1,100,NoArch
00d3d83ced62377a356a478bfe115c6430f4b2b3,1,1,0,1,0,0,0,7,31,102,1,1,0,245,960,0,47,47,0,1263,1261,2,8,8,0,1,100,NoArch
9e9ffd32f64e02ddb1a114e7df21108fba2f873e,0,0,0,0,0,0,0,0,0,0,0,0,0,0,44,0,0,0,0,0,0,0,0,0,0,1,100,NoArch
824b430f40bfb770c0782471f7c1cc86322808e7,0,0,0,0,0,0,0,0,0,0,0,0,0,0,45,1,0,0,0,0,0,0,0,0,0,1,100,NoArch
e21ebcb20115462c7d8d6b513769f11b22f631b6,0,0,0,0,0,0,0,0,0,0,0,0,0,0,46,2,0,0,0,0,0,0,0,0,0,1,100,NoArch
771b3138b033eb28315c9a9d7f94fe6f124e856f,0,0,0,0,0,0,0,0,0,0,0,0,0,0,24,2,0,0,0,0,0,0,0,0,0,1,100,NoArch
dc88c8d37bd735280f01b7ec24934f3c7f8cc67d,0,0,0,0,0,0,0,0,0,0,0,0,0,0,25,3,0,0,0,0,0,0,0,0,0,1,100,NoArch
9dbb1a04e29b222f4dd9bbad8ab21a42e36e7e75,0,0,0,0,0,0,0,0,0,0,0,0,0,0,26,4,0,0,0,0,0,0,0,0,0,1,100,NoArch
c3e0b8c5bee2314e3c4799f7fac411f6f38a3f70,1,32,11,21,0,0,0,6,16,373,1,1,0,372,47,3,42,39,3,1575,1551,24,19,17,2,1,100,NoArch
125d2e386b7fc07e1b34c3d79670767f6c129fb1,2,120,36,84,1,0,1,1,8,605,1,1,0.866725613,182,48,4,25,19,6,1640,1161,479,14,12,2,1,99.9757517,NoArch
1e8951f6a806b4d2fb1b317b84db9be95d3050f6,3,59,59,0,0,0,0,5,71,98,1,3,1.162234474,968,169,0,73,72,1,6728,6755,27,43,41,2,1,100,NoArch
b60c9090cf6823b04b8608b4b21b003e3d5367d6,219,189,23968,23779,1,173,174,3,82,225,4,67,7.113177352,32624,170,1,669,2873,2204,51968,184467,132499,328,1218,890,1,86.2266038,Arch
7d4faa844189899eaccf69aa58c86dcf437e1a56,0,0,0,0,0,0,0,0,0,0,0,0,0,0,171,2,0,0,0,0,0,0,0,0,0,1,100,NoArch
7820b672466e2c6ba55b8c8d6c12ebe0eafb287f,0,0,0,0,0,0,0,0,0,0,0,0,0,0,49,5,0,0,0,0,0,0,0,0,0,1,100,NoArch
e90d90134e9b2d32ab61a6ab31a05f84d0b816d7,10,170,91,79,0,0,0,3,76,422,1,7,2.540499212,2184,172,3,183,177,6,15258,14480,778,75,73,2,1,94.95679497,Arch
ed2321df8ada6e1c1d219186da99301073846810,1,38,0,38,1,0,1,1,1,0,1,1,0,0,173,4,1,0,1,146,0,146,1,0,1,1,96.24810893,Arch
0116ebdc0d12b4ff941dc13568e99503f1878b35,0,0,0,0,0,0,0,0,0,0,0,0,0,0,174,5,0,0,0,0,0,0,0,0,0,1,100,NoArch
cd829a2c43a6866179abe58ce12a4133b932c65c,3,111,1,110,2,0,2,1,5,684,1,2,1.546179692,142,23,2,24,16,8,996,367,629,18,14,4,1,99.91989747,NoArch
f494f8f34cf589fe6dff8d48f5a5886452297727,2,28,3,25,0,0,0,5,18,1634,1,1,0.938315352,328,24,3,73,67,6,1875,1743,132,29,27,2,1,100,NoArch
8269b08176ec734c875141656b05a7b99c88c465,1,1,1,0,0,0,0,3,3,145,1,1,0,132,961,1,11,11,0,989,989,0,5,5,0,0,100,NoArch
3241531314b2e388f84ccce2f1b3c6b0311a2323,0,0,0,0,0,0,0,0,0,0,0,0,0,0,50,6,0,0,0,0,0,0,0,0,0,1,100,NoArch
0833411f3286b20ce1d6c936d16ab43cfa711aee,8,72,36,36,0,0,0,4,49,356,1,2,2.790881807,2417,51,7,416,413,3,13270,13162,108,231,226,5,1,100,NoArch
faefa0c2a634afbe59e65a3e3e504efa6a9b02d1,0,0,0,0,0,0,0,0,0,0,0,0,0,0,52,8,0,0,0,0,0,0,0,0,0,1,100,NoArch
a1e815eced1a1455c3462dd9ae860570d0262c68,0,0,0,0,0,0,0,0,0,0,0,0,0,0,962,2,0,0,0,0,0,0,0,0,0,0,100,NoArch
b717cfc0d9720607517e0380eb6cb8e8ee13bde4,9,398,280,118,1,1,2,5,26,113,1,2,2.089513858,2209,25,4,147,138,9,10625,9774,851,66,62,4,1,99.88780253,NoArch
841b783a043a5b122d5eb72d9b8c3195e6331001,1,2,2,0,0,0,0,5,19,43,1,1,0,562,27,0,56,56,0,4123,4111,12,22,22,0,1,100,NoArch
b89d1c35301bd6032a388b429c7e699d615dd6ac,1,1,1,0,0,0,0,3,9,1862,1,1,0,109,28,1,13,13,0,273,273,0,9,9,0,0,100,NoArch
e70534f7a4ec2b54ec768ac7ab901471c449283f,1,17,0,17,0,0,0,4,6,189,1,1,0,288,29,2,38,38,0,1486,1486,0,12,12,0,1,100,NoArch
f868a68b7eb416a6eab16c1bc5111a9304abda78,1,3,1,2,0,0,0,2,5,212,1,1,0,36,175,0,1,1,0,137,136,1,1,1,0,1,100,NoArch
5741b1e318b22e438ca1eeb91925bc4baee70b64,0,0,0,0,0,0,0,0,0,0,0,0,0,0,30,3,0,0,0,0,0,0,0,0,0,0,100,NoArch
fcc3260b5a1e83ef05302f2eb6b7d4fd40fad1ef,1,20,2,18,0,0,0,9,23,186,1,1,0,331,31,2,36,34,2,2419,2282,137,8,8,0,1,100,NoArch
31f58654d63d42bbda1d7e912b6f95efb6120627,1,64,40,24,0,0,0,9,24,2,1,1,0,349,32,3,39,36,3,2586,2419,167,12,8,4,1,100,NoArch
09127f56c636ee637eb1f07d0eba3440b6712f10,1,1,1,0,0,0,0,9,25,4,1,1,0,373,33,4,39,39,0,2587,2586,1,12,12,0,1,100,NoArch
6cd9cc6a8d1e532428172d8c54f492780cbf5b7a,0,0,0,0,0,0,0,0,0,0,0,0,0,0,34,5,0,0,0,0,0,0,0,0,0,0,100,NoArch
c8f9f08756d150c5a46f445a17304919b9e41f95,0,0,0,0,0,0,0,0,0,0,0,0,0,0,35,6,0,0,0,0,0,0,0,0,0,0,100,NoArch
c029e29adc9db2f7a2471358b2b5a061093cfb02,0,0,0,0,0,0,0,0,0,0,0,0,0,0,36,7,0,0,0,0,0,0,0,0,0,0,100,NoArch
ff27b1223d4d5453fd2906adcf72b9a747680e10,1,2,2,0,0,0,0,9,19,245,1,1,0,148,37,8,21,21,0,721,721,0,11,11,0,0,100,NoArch
b381afd170e9cc4163736bfa71ddae77701a0816,17,29,45,16,0,1,1,6,12,521,1,8,3.341002448,2333,38,9,135,135,0,14074,14087,13,88,88,0,0,99.80744544,NoArch
3828ebf93ec969d4a7f819383025bfb91ad9a741,1,3,3,0,0,0,0,4,27,121,1,1,0,343,39,9,46,46,0,1627,1627,0,10,10,0,0,100,NoArch
de46e0eae6d0ea4a38224707e901ecd295446493,1,1,1,0,0,0,0,4,28,0,1,1,0,343,40,10,46,46,0,1627,1627,0,10,10,0,0,100,NoArch
6b4f770852690e1d34fe43e0db37628137d6c82d,1,1,1,0,0,0,0,3,10,74,1,1,0,109,41,11,13,13,0,273,273,0,9,9,0,0,100,NoArch
ae0d0d872fed2966ef12a5cf71ac9f5960f5828c,0,0,0,0,0,0,0,0,0,0,0,0,0,0,42,10,0,0,0,0,0,0,0,0,0,0,100,NoArch
2a2bf0b031c4469027045b22ec4f31aa3de55a4b,1,3,3,0,0,0,0,3,11,551,1,1,0,180,43,10,19,19,0,672,672,0,6,6,0,0,100,NoArch
2d5c5a18b7dd46479303dbacc73f6352f595f0b1,1,1,1,0,0,0,0,4,11,518,1,1,0,105,44,6,0,0,0,101,101,0,0,0,0,0,100,NoArch
34795fc34ca1a67262c0c8a8e76002b370c74ef1,1,1,1,0,0,0,0,2,2,1871,1,1,0,62,45,7,0,0,0,139,139,0,0,0,0,0,100,NoArch
c91c0a525b17efd583e2db9587ed1636f4a8d6b8,1,1,1,0,0,0,0,5,12,288,1,1,0,172,46,8,11,11,0,1098,1098,0,5,5,0,0,100,NoArch
411a86eb6e47ca9ac5c33af87d59e2380475a4db,1,1,1,0,0,0,0,3,18,2367,1,1,0,199,47,9,0,0,0,235,235,0,0,0,0,0,100,NoArch
131c84c923edbb949e2066761c88e8ea79763e99,19,43,44,1,0,0,0,2,90,1807,2,10,4.004497331,4982,48,10,741,741,0,19543,19543,0,315,315,0,1,100,NoArch
ca3300f23f47bc44b20a0ae55815ad003756463e,1,1,1,0,0,0,0,4,6,519,1,1,0,352,49,10,54,54,0,1457,1457,0,18,18,0,0,100,NoArch
82bbf156a58baa2b45a3f76ff6c886ee3fdf395b,1,13,6,7,0,0,0,1,3,538,1,1,0,55,176,0,4,5,1,271,200,71,1,1,0,1,100,NoArch
bf1d130e3e221512b764f7a321ba608dd7efbcb2,1,2,3,1,0,0,0,4,8,149,1,1,0,153,177,1,15,15,0,992,998,6,7,7,0,1,100,NoArch
00566b139ec2bf0355864b333a8331b6fac1add9,0,0,0,0,0,0,0,0,0,0,0,0,0,0,50,11,0,0,0,0,0,0,0,0,0,1,100,NoArch
9abf7557ca81150d98dec2ac44543ef39af4f31c,4,45,5,40,0,0,0,4,6,308,1,2,1.760964047,699,51,12,58,53,5,5326,5126,200,23,20,3,1,100,NoArch
b3d25547b6232ece8e77ee034b1248aaff52f108,1,3,0,3,0,0,0,3,5,313,1,1,0,226,52,13,21,21,0,1827,1810,17,9,9,0,1,100,NoArch
ce272b232d75d13b3812ad1f06a65b8ff8156cc7,1,0,4,4,0,0,0,4,5,292,1,1,0,208,53,14,11,11,0,1410,1430,20,8,8,0,0,100,NoArch
3231e8b074c810b013e301d3c060ed03e86706ce,1,1,1,0,0,0,0,8,26,297,1,1,0,413,54,15,0,0,0,404,404,0,0,0,0,0,100,NoArch
d45c030478b733f37f32c6cc770ddfe4ce8b1c2b,1,1,1,0,0,0,0,4,5,532,1,1,0,212,55,16,14,14,0,631,631,0,6,6,0,0,100,NoArch
7923646ecb3359aa81d905ac2ad98ecf6f71a605,0,0,0,0,0,0,0,0,0,0,0,0,0,0,963,0,0,0,0,0,0,0,0,0,0,1,100,NoArch
1cdd0956f8e82c9ffea5058b3b017bfe3fde55cc,32,504,8,496,2,0,2,2,13,445,4,15,4.901616728,5210,964,1,670,670,0,35770,35770,0,259,259,0,1,98.46837188,NoArch
f7d1c10588df3e31be6b88f18752b443d5102261,2,2,2,0,0,0,0,2,5,0,1,2,1,233,965,2,25,25,0,1467,1467,0,8,8,0,1,98.52873563,NoArch
13a20a5a3ab25cbdcd7129866f612136fc7f73a0,1,1,1,0,0,0,0,7,17,173,1,1,0,393,56,14,42,42,0,1575,1575,0,19,19,0,0,100,NoArch
4fc5ff5924ecf1ec07c9727b0b1825185ad0e19e,1,4,4,0,0,0,0,7,18,0,1,1,0,393,57,15,42,42,0,1575,1575,0,19,19,0,0,100,NoArch
a5bc1b248b3bceee85278bb06348a165a2f300b8,1,1,1,0,0,0,0,4,6,1378,1,1,0,76,58,16,8,8,0,238,238,0,5,5,0,0,100,NoArch
b2d204fcac71a6e76cfb249b27c25f0f5d961451,1,1,1,0,0,0,0,4,5,2288,1,1,0,279,59,17,29,29,0,921,921,0,20,20,0,0,100,NoArch
2f22cc7a8e4a80b37fedb4b7b7f39b561da90845,1,1,1,0,0,0,0,4,6,0,1,1,0,279,60,18,29,29,0,921,921,0,20,20,0,0,100,NoArch
f7ddce5bedabc1a5dd548f47a64306e5b9fd63b6,1,1,1,0,0,0,0,4,7,0,1,1,0,279,61,19,29,29,0,921,921,0,20,20,0,0,100,NoArch
cbae1e8b5de643277439ebe67a6d15288514057e,0,0,0,0,0,0,0,0,0,0,0,0,0,0,62,20,0,0,0,0,0,0,0,0,0,1,100,NoArch
5592426ee15d7b81dcc3d8213704be47fe113227,2,35,3,32,0,0,0,3,4,326,1,1,0.998000884,140,966,3,13,9,4,970,786,184,8,6,2,1,100,NoArch
a2afabff4602fc08d0b67876e0daacab36d156da,0,0,0,0,0,0,0,0,0,0,0,0,0,0,63,20,0,0,0,0,0,0,0,0,0,1,100,NoArch
5a5acf0697de2bf4d44e3f28e8cba69210855a67,1,16,1,15,0,0,0,2,9,3982,1,1,0,78,967,4,16,13,3,384,311,73,10,8,2,0,100,NoArch
e0a4f02fe67abe9d836984366433f58b48d3e5ae,1,1,1,0,0,0,0,5,10,1803,1,1,0,240,64,8,5,5,0,1492,1492,0,3,3,0,0,100,NoArch
9d58fc8500a3a48a806ae2ebdb41d9d64dc22572,1,0,1,1,0,0,0,2,2,178,1,1,0,297,65,9,15,15,0,1723,1734,11,5,5,0,0,100,NoArch
e8f1e701d25144d81cd0195a9f5fbc9458dd6f9a,0,0,0,0,0,0,0,0,0,0,0,0,0,0,66,10,0,0,0,0,0,0,0,0,0,1,100,NoArch
3032e7b893d56adc630134652c2377ab65920ee0,6,439,14,425,4,0,4,1,41,617,1,3,2.235169219,2440,26,0,291,257,34,9507,7898,1609,167,143,24,1,99.8716303,NoArch
7f7ff5e8ba17c6c8d625c33b8f05e606fc9f71e3,1,8,8,0,0,0,0,11,26,211,1,1,0,375,67,5,13,13,0,1408,1408,0,6,6,0,0,100,NoArch
1a38c2339ab6749dfcc6810d94e1793beb82f6ef,0,0,0,0,0,0,0,0,0,0,0,0,0,0,68,0,0,0,0,0,0,0,0,0,0,0,100,NoArch
921e2015ef96bc9655c9d821e051d6c0d2e99045,41,81,72,9,0,0,0,3,27,442,3,22,5.173557696,7418,69,1,470,470,0,46206,46194,12,248,248,0,1,99.88774856,NoArch
e56c7ff17a2385076e8a05f36d9a63adf4f078ec,3,208,1,207,1,0,1,11,28,152,1,2,0.766772905,694,70,2,67,52,15,4490,3376,1114,30,23,7,1,99.95193848,NoArch
5c9a671d5f511bc01eae6f950023583f3be90182,1,4,4,0,0,0,0,2,2,0,1,1,0,177,53,0,12,12,0,917,925,8,5,5,0,0,100,NoArch
abbf629a5d31dc5151bb3c394284f4773c816560,2,8,9,1,0,0,0,11,29,0,1,2,0.787126586,724,54,1,55,55,0,3551,3565,14,25,25,0,0,100,NoArch
e8cd2306709625bd0f2ed3e4e768f510a4343b96,3,11,3,8,0,0,0,6,22,18,2,2,1.287054028,945,71,3,43,43,0,6575,6510,65,22,22,0,1,100,NoArch
072f1ae98e47b54aa751499832f60961ebe9677a,1,2,1,1,0,0,0,7,77,301,1,1,0,317,178,0,24,24,0,1940,1932,8,3,3,0,1,100,NoArch
9e6098a25b1968d239502651d634f92836eed1bb,1,7,1,6,0,0,0,7,78,2,1,1,0,318,179,1,25,24,1,1977,1940,37,3,3,0,1,100,NoArch
02ecad17bac6be42eb946fcc029d10dda283b57c,0,0,0,0,0,0,0,0,0,0,0,0,0,0,27,0,0,0,0,0,0,0,0,0,0,1,100,NoArch
91095865ff06c3b77efcb3d9514df10f70f95912,2,31,3,28,0,0,0,3,3,2530,1,2,0.787126586,201,55,2,17,16,1,1176,996,180,13,12,1,1,100,NoArch
3cc95f4fc8e167417e12def3948b13bd7e1f57f6,8,81,27,54,0,0,0,4,8,245,1,2,2.494846291,944,56,3,74,71,3,6090,5626,464,50,48,2,1,99.96801024,NoArch
f739dca9e8d666e52d7388ad53dae1293d934ae5,1,40,0,40,1,0,1,1,1,0,1,1,0,0,57,4,3,0,3,97,0,97,2,0,2,1,99.90418397,NoArch
770b5af25e1fbeaf5b273f1c74433dacddd0104a,1,12,4,8,0,0,0,11,30,40,1,1,0,394,58,5,14,14,0,1614,1558,56,7,7,0,1,100,NoArch
e1bb0027ba261e3822d379914ab3ab4bcf7b8aeb,2,68,1,67,0,0,0,12,82,504,1,2,0.189278431,679,59,6,88,82,6,4727,4140,587,42,40,2,1,100,NoArch
0c1b4a1e07fa6be269615c08a3813af04a71d46e,1,14,4,10,0,0,0,3,7,446,1,1,0,99,60,5,7,6,1,636,580,56,4,4,0,0,100,NoArch
40907b1f5cbf02a6eb64cce11e1fcaa27f6c4f18,1,26,12,14,0,0,0,4,7,447,1,1,0,75,61,6,8,7,1,507,413,94,3,3,0,1,100,NoArch
17ab609eac44fd5f539f10604c664a2cbfee98fe,0,0,0,0,0,0,0,0,0,0,0,0,0,0,62,7,0,0,0,0,0,0,0,0,0,1,100,NoArch
f75ea67e61cfbd25c2bf1dc094ae6c739831bb43,1,2,3,1,0,0,0,5,32,341,1,1,0,424,180,2,32,32,0,2889,2904,15,16,16,0,1,100,NoArch
f1c99aa6a03880f80f483d24ac46a0d097a130b5,1,1,1,0,0,0,0,4,6,75,1,1,0,85,63,8,5,5,0,435,437,2,4,4,0,1,100,NoArch
209714387177f289273d64d48ed6141b9d5aa1e2,1,1,3,2,0,0,0,4,7,15,1,1,0,111,64,9,10,10,0,771,774,3,6,6,0,1,100,NoArch
682feb495ad2a18716afc11eff5d9138984e5b8d,1,1,1,0,0,0,0,3,5,1395,1,1,0,52,65,10,3,3,0,226,225,1,3,3,0,1,100,NoArch
2e7c3198e4d9e5e3fce876da83c3ef0d2ce6423a,1,1,1,0,0,0,0,2,2,2893,1,1,0,47,66,11,3,3,0,182,181,1,2,2,0,1,100,NoArch
d72ba280d8ed202f60872e3b2cc9d167c7b6699d,0,0,0,0,0,0,0,0,0,0,0,0,0,0,67,12,0,0,0,0,0,0,0,0,0,1,100,NoArch
cd167f96b31eec1c4e7affc0f188d06c753cd39c,36,125,134,9,0,0,0,4,49,791,4,23,3.786478201,8469,68,13,1013,1015,2,43095,42997,98,392,392,0,1,100,NoArch
018ec691f0f734aca79ba7353d6e8a2b731054e3,4,1525,0,1525,4,0,4,1,1,0,1,2,1.939240033,0,69,14,226,0,226,9310,0,9310,78,0,78,1,99.71351265,NoArch
b96e7ba8fab03745257d5feb6ab97247d6abcee8,1,2,1,1,0,0,0,4,9,22,1,1,0,174,70,15,7,7,0,1168,1164,4,7,7,0,1,100,NoArch
cf8fec97f253a2e60db4d853231311320f612422,1,4,2,2,0,0,0,4,10,0,1,1,0,175,71,16,7,7,0,1182,1168,14,7,7,0,1,100,NoArch
b4e41ba3e745dabf6024a4a6f3f44c22a01cf1b7,4,214,133,81,0,0,0,1,2,0,1,2,1.916430577,1525,72,17,247,226,21,10275,9310,965,83,78,5,1,99.87289482,NoArch
ba4e9d9c999177f6a5fa85cc6461a982a34059a7,0,0,0,0,0,0,0,0,0,0,0,0,0,0,28,1,0,0,0,0,0,0,0,0,0,1,100,NoArch
9c167fc0c2face25e6e8b90f0c065f9bf681b21f,0,0,0,0,0,0,0,0,0,0,0,0,0,0,72,0,0,0,0,0,0,0,0,0,0,1,100,NoArch
8e0495d48a7ba1eec21fa4e0d0afc2efa3ef8073,0,0,0,0,0,0,0,0,0,0,0,0,0,0,73,1,0,0,0,0,0,0,0,0,0,1,100,NoArch
beb2ff38a86224f7855f526dbbdaee3727db779e,0,0,0,0,0,0,0,0,0,0,0,0,0,0,73,18,0,0,0,0,0,0,0,0,0,1,100,NoArch
fbf614367dafbe3229054d81b2c3817c50e94519,0,0,0,0,0,0,0,0,0,0,0,0,0,0,74,19,0,0,0,0,0,0,0,0,0,1,100,NoArch
211edf2178cd44d027ab1ec9def58d0895725c88,4,60,34,26,0,0,0,6,31,350,1,3,1.513765038,783,75,20,41,41,0,3860,3761,99,20,20,0,1,100,NoArch
6d8fbe246b46a1a935767bb4d2c8be7e27ec15a3,2,42,2,40,1,0,1,1,22,238,1,2,0.439496987,84,76,21,8,7,1,522,357,165,6,5,1,1,99.35773924,NoArch
f2eb7e1b759bada8130cfc00b1d72d8f3b83febb,3,83,52,31,0,0,0,3,9,616,1,2,1.083510103,470,77,21,63,59,4,2394,2178,216,34,31,3,1,100,NoArch
7016ff63856c8deffcf11b8f932b845e04160147,2,2,2,0,0,0,0,3,9,0,1,2,1,345,78,22,42,42,0,1483,1482,1,28,28,0,1,100,NoArch
84326249883a55eb502c114a3149c52cf4297425,0,0,0,0,0,0,0,0,0,0,0,0,0,0,79,23,0,0,0,0,0,0,0,0,0,1,100,NoArch
25efc4357261656d5edcbe0e2ae3852d5ebe6100,2,18,2,16,0,0,0,3,6,215,1,2,0.934068055,521,74,2,56,54,2,3101,3000,101,25,24,1,1,100,NoArch
62766057cc02d6550f854f13d77dc0a6629a7ac7,1,3,1,2,0,0,0,4,7,0,1,1,0,242,80,23,23,23,0,1915,1905,10,10,10,0,1,100,NoArch
09b4ef12001f21f55089baf36a8a4281641cdd27,1,26,19,7,0,0,0,5,5,524,1,1,0,231,81,21,15,14,1,1371,1349,22,2,2,0,1,100,NoArch
37201275a452d3f906eac6e10e5e6cd740b5ec0a,0,0,0,0,0,0,0,0,0,0,0,0,0,0,82,22,0,0,0,0,0,0,0,0,0,1,100,NoArch
c88c240fc6bb33a8206ede54d4bb81c25e67066c,30,113,66,47,0,0,0,4,35,619,4,22,4.420721138,5738,83,23,570,566,4,32660,32387,273,290,290,0,1,99.78947368,NoArch
343bd9b3a4935cad9c178b34639f1060938ef33a,0,0,0,0,0,0,0,0,0,0,0,0,0,0,84,24,0,0,0,0,0,0,0,0,0,1,100,NoArch
fcaf1f5e6998ca1363a30582926488ef736148e3,0,0,0,0,0,0,0,0,0,0,0,0,0,0,85,25,0,0,0,0,0,0,0,0,0,1,100,NoArch
802233b7a22a09a81a1bc9e6f1d68d7c5814da46,1,11,0,11,0,0,0,6,14,0,1,1,0,98,86,26,14,14,0,512,393,119,7,7,0,1,100,NoArch
1e1175531c9c27f5f60e9e3ae06db387dfa79c3c,1,0,1,1,0,0,0,9,19,3,1,1,0,282,0,0,26,26,0,1586,1586,0,14,14,0,0,100,NoArch
69178eb38fbb9cad0e32ff2cf36304f183dfb62c,1,0,1,1,0,0,0,10,17,108,1,1,0,249,87,24,27,27,0,1561,1572,11,16,16,0,0,100,NoArch
fa2e343dd464293d7ff74d33f2997a079111c95a,0,0,0,0,0,0,0,0,0,0,0,0,0,0,75,3,0,0,0,0,0,0,0,0,0,0,100,NoArch
edd0725252f00c7ed89c8718967a9edc20916d55,0,0,0,0,0,0,0,0,0,0,0,0,0,0,76,4,0,0,0,0,0,0,0,0,0,0,100,NoArch
7a5ffcb875367369a4270e3ed638daed60fc0b4d,0,0,0,0,0,0,0,0,0,0,0,0,0,0,77,5,0,0,0,0,0,0,0,0,0,0,100,NoArch
44200432b98a9e889858c818ffa4e8beaeb2c52a,1,2,0,2,0,0,0,10,28,531,1,1,0,263,88,25,42,42,0,1581,1565,16,3,3,0,1,100,NoArch
9ecac13b6221f4cce0326aee2dcff1b90e5896e8,0,0,0,0,0,0,0,0,0,0,0,0,0,0,89,26,0,0,0,0,0,0,0,0,0,1,100,NoArch
d0976522fc36999bbd1df82bdcbbb2c174539c09,0,0,0,0,0,0,0,0,0,0,0,0,0,0,90,27,0,0,0,0,0,0,0,0,0,1,100,NoArch
59dbea77e73ca8ea49d7ed346c1e6b7e06f89930,0,0,0,0,0,0,0,0,0,0,0,0,0,0,91,28,0,0,0,0,0,0,0,0,0,0,100,NoArch
58546105b5680bae0993fd9167fb97b1b65e2ae0,0,0,0,0,0,0,0,0,0,0,0,0,0,0,92,29,0,0,0,0,0,0,0,0,0,1,100,NoArch
a851ddc46955ae1fb35c621edbaed4daae7bdbd8,2,28,14,14,0,0,0,3,6,460,1,2,0.993447238,166,93,30,16,15,1,551,334,217,12,12,0,1,100,NoArch
3186b37fb0e8a711bf07029db45fe9fc940f0079,3,60,116,56,0,0,0,3,10,1680,2,3,1.485749237,562,94,31,49,65,16,2856,3097,241,21,20,1,1,99.91918539,NoArch
82534918c3cdebf610c8c49c4c4ad3112703eb64,10,82,90,8,0,0,0,7,83,482,2,5,2.788220734,2243,95,22,225,226,1,14254,14185,69,84,84,0,1,99.93540052,NoArch
c20d04cde96a1c09fa9819c870d22acb8918d906,1,9,5,4,0,0,0,9,20,17,1,1,0,281,96,23,26,26,0,1631,1586,45,14,14,0,1,100,NoArch
95c68de3eb275c9333bd067b1ed1cf00e7fcb40a,2,66,1,65,0,0,0,4,18,430,1,2,0.527642326,342,97,24,43,37,6,2690,2232,458,20,18,2,1,100,NoArch
055fbeda80e0f9227aa67d5c3ef87785a1cf1a88,0,0,0,0,0,0,0,0,0,0,0,0,0,0,98,25,0,0,0,0,0,0,0,0,0,0,100,NoArch
24c4921f1a3c305656229bea2ee8f21521f2a9b8,1,17,19,2,0,0,0,4,5,31,1,1,0,283,99,18,22,26,4,1857,1878,21,5,5,0,1,99.98386576,NoArch
06205a6cd43d9d2fac4b59184e03d52725fde536,1,2,1,1,0,0,0,4,7,67,1,1,0,494,100,19,24,24,0,2096,2075,21,8,8,0,1,100,NoArch
44cc7b3e9102a05aa5c963a8d0a2aba241553b6d,2,38,17,21,0,0,0,4,12,317,1,2,0.945660305,484,101,18,68,67,1,2466,2233,233,30,29,1,1,100,NoArch
59cd40a4b32eec1d5eb4539781b4e59e6486787c,0,0,0,0,0,0,0,0,0,0,0,0,0,0,102,19,0,0,0,0,0,0,0,0,0,1,100,NoArch
304fb0f05af390ae3e34778f42aeedf84de270f8,3,89,41,48,0,0,0,5,10,310,1,2,1.167465733,541,103,17,62,50,12,3818,3602,216,19,18,1,1,100,NoArch
05e5398c029ef8a470ba1b3fe53e3e74fe636f26,0,0,0,0,0,0,0,0,0,0,0,0,0,0,104,18,0,0,0,0,0,0,0,0,0,1,100,NoArch
c371b4e399d3ca1ceaf76b4200a6db5657ad7513,1,10,19,9,0,0,0,6,15,48,1,1,0,208,105,17,12,15,3,1197,1191,6,6,6,0,0,100,NoArch
80e4928bc2a2ff168ad9cd2bab60c8896b6dd38d,0,0,0,0,0,0,0,0,0,0,0,0,0,0,106,15,0,0,0,0,0,0,0,0,0,1,100,NoArch
2e5449f24d06c2e9f1006ae82c86b883d4cdf7ef,29,70,49,21,0,0,0,7,33,211,3,13,4.415526642,4229,1,0,351,348,3,23408,23335,73,192,189,3,1,100,NoArch
d520c597df9caf412ee59cff8d44a1dbd255038c,0,0,0,0,0,0,0,0,0,0,0,0,0,0,107,16,0,0,0,0,0,0,0,0,0,1,100,NoArch
6413575104c174922ccbaa4a63f3e815c8bb90f5,5,1411,0,1411,5,0,5,1,1,0,1,2,1.828263308,0,108,13,145,0,145,6984,0,6984,56,0,56,1,99.80676329,NoArch
e62e64a1032b74e18e4dd4c1f9ee54826ca8e5ca,0,0,0,0,0,0,0,0,0,0,0,0,0,0,109,14,0,0,0,0,0,0,0,0,0,1,100,NoArch
c87196e4e24a758d652b5ba36e26701c35726654,5,148,40,108,1,0,1,7,29,320,2,3,2.252800635,1036,110,15,109,91,18,6620,6054,566,43,42,1,1,99.85542169,NoArch
2e5e8a573b2074526104847b26707d131f6c35ba,1,2,2,0,0,0,0,1,2,4,1,1,0,88,111,16,7,7,0,217,217,0,6,6,0,0,100,NoArch
2b054b6bfd4c9d6a53d0a4a3d0a5b72c455d4d56,1,3,2,1,0,0,0,1,2,5,1,1,0,345,112,17,40,40,0,2639,2628,11,6,6,0,0,100,NoArch
16e952d6cbaecda90cd16de87cb51da384a6ca22,1,12,14,2,0,0,0,3,6,86,1,1,0,73,113,18,6,6,0,289,290,1,2,2,0,0,100,NoArch
6a8cfcde4d862689b0b2db3a48328de4884f2776,3,12,11,1,0,0,0,4,8,233,1,1,0.840491401,686,114,15,43,42,1,3031,3059,28,15,15,0,1,100,NoArch
ede812b2b7c6519cd2a4eebfca0538a65b7d7a8d,2,5,3,2,0,0,0,5,14,709,1,2,1,346,115,10,25,25,0,2335,2342,7,7,7,0,1,100,NoArch
d15537b19c6b6d221c20567dcaefddeb39eed7f5,2,78,6,72,0,0,0,4,12,1317,1,2,0.67694187,955,223,0,168,160,8,7217,6599,618,27,24,3,1,100,NoArch
f6c9f3d475b23da31c6af20b597dc6b313dfecc4,0,0,0,0,0,0,0,0,0,0,0,0,0,0,116,8,0,0,0,0,0,0,0,0,0,1,100,NoArch
0b0f254897e5e98fdb683083d6bc52b847f80178,0,0,0,0,0,0,0,0,0,0,0,0,0,0,117,2,0,0,0,0,0,0,0,0,0,0,100,NoArch
b0dc01b24aae9e583dd873541ab9f3eafe0b7d9a,1,1,1,0,0,0,0,4,9,50,1,1,0,493,118,3,24,24,0,2092,2086,6,8,8,0,1,100,NoArch
7bb6320b1fbd446ec416afed1f322f4ab04dcc5a,0,0,0,0,0,0,0,0,0,0,0,0,0,0,119,4,0,0,0,0,0,0,0,0,0,0,100,NoArch
1c06e9db4fb2623af8953fe14ddf2a8002e4c015,1,33,55,22,0,0,0,8,13,96,1,1,0,182,120,5,18,21,3,854,1009,155,10,9,1,1,100,NoArch
dcc8b38f31b3ee59b7da55b82a5c63038e43edad,0,0,0,0,0,0,0,0,0,0,0,0,0,0,121,6,0,0,0,0,0,0,0,0,0,0,100,NoArch
d32fa5f95e4e351b36423b77bb32367a546ad0ca,0,0,0,0,0,0,0,0,0,0,0,0,0,0,122,7,0,0,0,0,0,0,0,0,0,0,100,NoArch
75fa7993dbb34c6dcdb67822ec45396d7492c2d3,0,0,0,0,0,0,0,0,0,0,0,0,0,0,123,8,0,0,0,0,0,0,0,0,0,0,100,NoArch
8fd8964def87d065b2e648a26f996247e5f5db1f,0,0,0,0,0,0,0,0,0,0,0,0,0,0,123,8,0,0,0,0,0,0,0,0,0,0,100,NoArch
dfa1ded57519a1f790f268e6b5c7a4e157a5f4b6,0,0,0,0,0,0,0,0,0,0,0,0,0,0,124,8,0,0,0,0,0,0,0,0,0,0,100,NoArch
0fbb722b80251907a7842ee84e7e2e368dbeb4eb,1,1,1,0,0,0,0,3,9,2511,1,1,0,61,125,9,6,6,0,241,241,0,5,5,0,1,100,NoArch
26a338e3f01717afaa11a6fd2aaf764bb21bd2c9,1,0,1,1,0,0,0,10,38,659,1,1,0,299,126,10,23,23,0,1536,1538,2,14,14,0,0,100,NoArch
4aaf42a07dfe1990420ab6f28b18b5476421a443,1,1,0,1,0,0,0,10,39,0,1,1,0,298,127,11,23,23,0,1538,1536,2,14,14,0,0,100,NoArch
82d51ea3287b5a34931bbfe36f4c39b95a00d858,0,0,0,0,0,0,0,0,0,0,0,0,0,0,128,12,0,0,0,0,0,0,0,0,0,0,100,NoArch
b49a45a152050f92c140bea73b47043ff545cff3,0,0,0,0,0,0,0,0,0,0,0,0,0,0,129,13,0,0,0,0,0,0,0,0,0,0,100,NoArch
377131e745ef87fbf1c18f269e13301f48471d23,0,0,0,0,0,0,0,0,0,0,0,0,0,0,130,14,0,0,0,0,0,0,0,0,0,0,100,NoArch
e9fbbc0459389f1ccccb304043ec85acef6e70e7,0,0,0,0,0,0,0,0,0,0,0,0,0,0,131,15,0,0,0,0,0,0,0,0,0,0,100,NoArch
1fbd7b7bd7c509073e0ea4af63a997694e742d55,1,2,2,0,0,0,0,6,26,651,1,1,0,369,132,16,32,32,0,2442,2442,0,2,2,0,0,100,NoArch
f88d7dc297f7b72127105605cf46ecc6334620e5,3,1,4,3,0,0,0,6,41,422,1,1,1.370950594,870,181,0,95,95,0,4838,4852,14,38,38,0,1,100,NoArch
89c7f4c4a29a153945d68ad085896a627328ce37,0,0,0,0,0,0,0,0,0,0,0,0,0,0,133,16,0,0,0,0,0,0,0,0,0,0,100,NoArch
770bcbadeaab566bf0c831a84d96491fc0e08139,0,0,0,0,0,0,0,0,0,0,0,0,0,0,134,17,0,0,0,0,0,0,0,0,0,0,100,NoArch
b32bcc998c4b4c7a0a75b1cb7cdbc8031b21d73b,0,0,0,0,0,0,0,0,0,0,0,0,0,0,136,19,0,0,0,0,0,0,0,0,0,0,100,NoArch
31354daeb589b4af9e6a0b5795a500c2d012ae3d,0,0,0,0,0,0,0,0,0,0,0,0,0,0,135,18,0,0,0,0,0,0,0,0,0,0,100,NoArch
dbe5d501b911f66770791e96640c0578226f956b,0,0,0,0,0,0,0,0,0,0,0,0,0,0,136,19,0,0,0,0,0,0,0,0,0,0,100,NoArch
750043ebe07efce9ae9a5d159655ab3e3089c9a2,0,0,0,0,0,0,0,0,0,0,0,0,0,0,137,20,0,0,0,0,0,0,0,0,0,0,100,NoArch
02faa512a7a7b9b04ab8dcc70d2e9770894b2d46,1,2,2,0,0,0,0,9,65,619,1,1,0,658,138,21,87,87,0,2897,2897,0,43,43,0,0,100,NoArch
23adfe36515e771433712d23eb900681c421e63c,0,0,0,0,0,0,0,0,0,0,0,0,0,0,139,22,0,0,0,0,0,0,0,0,0,0,100,NoArch
05b35b3f75e357094ccec7f7ef36a19ad29bbf33,0,0,0,0,0,0,0,0,0,0,0,0,0,0,142,25,0,0,0,0,0,0,0,0,0,0,100,NoArch
4eb085d55237404ae61a17a8712e6b64de239a41,0,0,0,0,0,0,0,0,0,0,0,0,0,0,140,23,0,0,0,0,0,0,0,0,0,0,100,NoArch
a096f35cae260d68f63ced51634c920ca4cbfc92,0,0,0,0,0,0,0,0,0,0,0,0,0,0,141,23,0,0,0,0,0,0,0,0,0,0,100,NoArch
5a41f8fb35fdec453f5874a143f854101bc9785e,0,0,0,0,0,0,0,0,0,0,0,0,0,0,182,1,0,0,0,0,0,0,0,0,0,1,100,NoArch
4f368b8efd9e040a3b982321fe2eb207b49b48b1,0,0,0,0,0,0,0,0,0,0,0,0,0,0,183,2,0,0,0,0,0,0,0,0,0,1,100,NoArch
67f146c86e4961a693becc49f270b1850d90ab19,2,62,13,49,0,0,0,4,91,628,1,2,0.984426898,926,184,3,127,123,4,4691,4486,205,49,47,2,1,100,NoArch
78996cb6b215662402dcdaa29fc1454ce84c52f6,0,0,0,0,0,0,0,0,0,0,0,0,0,0,142,24,0,0,0,0,0,0,0,0,0,1,100,NoArch
700224140ffb5cda4517f2d32261612b3d29bace,51,7496,0,7496,51,0,51,5,40,510,2,9,5.231161303,0,143,25,782,0,782,42965,0,42965,254,0,254,1,96.23141469,Arch
7b9c6c5cab87bc86267e398b067a9c9e506833b6,0,0,0,0,0,0,0,0,0,0,0,0,0,0,144,26,0,0,0,0,0,0,0,0,0,1,100,NoArch
81838f2d8f77cee2e6869aa8372f51401d8759a4,0,0,0,0,0,0,0,0,0,0,0,0,0,0,145,27,0,0,0,0,0,0,0,0,0,0,100,NoArch
52432040ec77bb22374268f9b3e33f72cf360121,0,0,0,0,0,0,0,0,0,0,0,0,0,0,149,31,0,0,0,0,0,0,0,0,0,0,100,NoArch
a46d104d37a1b8125fc35b80d2890e4b8c646f10,0,0,0,0,0,0,0,0,0,0,0,0,0,0,146,28,0,0,0,0,0,0,0,0,0,0,100,NoArch
2396246c13ac844d6a9b7d9d02c7fcd779d11804,1,6,28,22,0,0,0,4,11,65,1,1,0,358,224,0,35,39,4,2843,2996,153,16,17,1,1,100,NoArch
bef1e8e81b69c968afaebd747efe07a956e2211d,2,23,2,21,0,0,0,2,10,826,1,2,0.634309555,261,225,1,30,27,3,987,873,114,19,18,1,1,100,NoArch
b29f6631d993c0f5fd8f067bc85c34f3a8d7740d,0,0,0,0,0,0,0,0,0,0,0,0,0,0,147,23,0,0,0,0,0,0,0,0,0,0,100,NoArch
18b2c440c8a7e4c389f6d548f696e81cedf21056,0,0,0,0,0,0,0,0,0,0,0,0,0,0,148,24,0,0,0,0,0,0,0,0,0,1,100,NoArch
e93f05d642aa759cbc0a69c9e275d39167e34f8f,3,53,17,36,0,0,0,10,21,144,1,2,1.440174665,676,149,25,76,68,8,4538,4146,392,37,37,0,1,100,NoArch
6b1be46477855d652fef9a18b7eec86e50b9cf6f,1,1,10,9,0,0,0,5,12,6,1,1,0,336,150,26,35,35,0,2757,2843,86,16,16,0,1,100,NoArch
3b4f783171afb64be082f442171ee48ef60cf180,0,0,0,0,0,0,0,0,0,0,0,0,0,0,78,0,0,0,0,0,0,0,0,0,0,0,100,NoArch
632a45d5ad962bb03ef2e571d5f91cd191b5fc73,0,0,0,0,0,0,0,0,0,0,0,0,0,0,79,1,0,0,0,0,0,0,0,0,0,0,100,NoArch
d1c79edf5596437dd5980fffee26c0da5f1da432,0,0,0,0,0,0,0,0,0,0,0,0,0,0,80,2,0,0,0,0,0,0,0,0,0,1,100,NoArch
29c3f055950ed8fc038c9cbf8cee67a07f6dc2ef,0,0,0,0,0,0,0,0,0,0,0,0,0,0,81,3,0,0,0,0,0,0,0,0,0,1,100,NoArch
08da3686124f67a529bfc8b00a829b7dc72a9a4e,2,4,0,4,0,0,0,7,22,2,1,1,1,457,151,27,47,47,0,2862,2862,0,21,21,0,1,100,NoArch
0080be59ee880a3007a612f43fe6fdca86556aa6,0,0,0,0,0,0,0,0,0,0,0,0,0,0,152,28,0,0,0,0,0,0,0,0,0,1,100,NoArch
ab6216f1e57a95454e39233f406ffbd7c7fe7cfb,3,12,11,1,0,0,0,10,23,4,1,2,1.450908284,716,153,29,76,76,0,4617,4538,79,37,37,0,1,100,NoArch
4d4efb0cb3ce1ba12009179b38a848460cb076a8,2,16,4,12,0,0,0,7,24,0,1,1,1,462,154,30,47,47,0,3003,2923,80,21,21,0,1,100,NoArch
84059288d0fc2b645c449e04fb030872137091eb,12,72,94,22,0,0,0,6,112,501,3,10,2.376377383,2971,155,31,165,165,0,18647,18734,87,84,84,0,1,100,NoArch
a2339d02b15c2e56b74ededc143e74f2606b880d,1,2,2,0,0,0,0,1,2,196,1,1,0,483,156,32,65,65,0,3690,3690,0,17,17,0,1,100,NoArch
8552cff1d923d91c479bf0ce40fdc96543655529,1,17,8,9,0,0,0,4,5,124,1,1,0,345,157,33,53,53,0,1535,1446,89,30,30,0,1,100,NoArch
9a7458f2bb5b882d239c5751b6c4945dafc7e2fa,0,0,0,0,0,0,0,0,0,0,0,0,0,0,158,34,0,0,0,0,0,0,0,0,0,1,100,NoArch
fab3d2f6ae5aa92cdbefcf3ba5e110e7a71fd991,1,0,14,14,0,0,0,5,7,279,1,1,0,194,159,35,16,16,0,1164,1164,0,3,3,0,1,100,NoArch
d74edf431d3a5678d51d4fd89b415c67ea9a76d6,1,1,1,0,0,0,0,5,28,174,1,1,0,586,160,36,77,77,0,2599,2599,0,57,57,0,0,100,NoArch
fdded755a7ba0ccd467aa52e9c4e0d524ded5219,0,0,0,0,0,0,0,0,0,0,0,0,0,0,161,37,0,0,0,0,0,0,0,0,0,0,100,NoArch
a41d378df344330192c88ea9d63e248bd8182f5c,0,0,0,0,0,0,0,0,0,0,0,0,0,0,166,41,0,0,0,0,0,0,0,0,0,0,100,NoArch
b32bcc998c4b4c7a0a75b1cb7cdbc8031b21d73b,5,4,7,3,0,0,0,6,41,885,1,3,2.118078209,1300,136,19,133,133,0,7521,7535,14,45,45,0,0,100,NoArch
05b35b3f75e357094ccec7f7ef36a19ad29bbf33,1,2,2,0,0,0,0,9,65,619,1,1,0,658,142,25,87,87,0,2897,2897,0,43,43,0,0,100,NoArch
52432040ec77bb22374268f9b3e33f72cf360121,53,7558,13,7545,51,0,51,5,91,533,2,11,5.269263013,926,149,31,909,123,786,47656,4486,43170,303,47,256,0,96.23141469,Arch
a41d378df344330192c88ea9d63e248bd8182f5c,22,190,174,16,0,0,0,1,112,375,4,18,3.656500476,5874,166,41,517,510,7,36076,35648,428,263,263,0,0,100,NoArch
28de0d8e7e31c3f5c38dc8bfe4e0df71ce2437b8,0,0,0,0,0,0,0,0,0,0,0,0,0,0,162,38,0,0,0,0,0,0,0,0,0,0,100,NoArch
6130da0bbdb7e382615c499dc8e1b1c68f9812d1,0,0,0,0,0,0,0,0,0,0,0,0,0,0,2,0,0,0,0,0,0,0,0,0,0,0,100,NoArch
256fe2714e949798a1aeae1329de0b6d5fc7c8ff,0,0,0,0,0,0,0,0,0,0,0,0,0,0,163,22,0,0,0,0,0,0,0,0,0,0,100,NoArch
29ff0a8b71de50e333b5bc9701c67baaa684e7a5,1,1,1,0,0,0,0,4,8,1436,1,1,0,516,3,1,36,36,0,1844,1841,3,19,19,0,0,100,NoArch
a0ce86226101a06dacb82d08bc2156736862c6c2,0,0,0,0,0,0,0,0,0,0,0,0,0,0,164,23,0,0,0,0,0,0,0,0,0,0,100,NoArch
3e9cd90fa55c6300d60b36d1d02bc9f632625412,2,42,4,38,0,0,0,5,17,774,1,2,0.615253891,218,185,0,42,38,4,1357,1155,202,16,14,2,1,100,NoArch
678525a86e75741ee6426efdd8b163b6004efee7,1,7,1,6,0,0,0,4,6,744,1,1,0,238,165,2,37,37,0,1054,1054,0,14,14,0,1,100,NoArch
4e1b7a6ebf54a444e01ffa613fe44a1f11f06e31,2,24,8,16,0,0,0,5,7,1322,1,1,0.997180399,308,166,3,28,26,2,1614,1499,115,11,11,0,1,100,NoArch
f322cbc13a5f2914d8429850673612cddc23b08a,1,2,3,1,0,0,0,4,6,1156,1,1,0,161,167,4,10,10,0,818,823,5,6,6,0,1,100,NoArch
5e25fddbaedf0a9ca2daa54021570b03d1a74251,0,0,0,0,0,0,0,0,0,0,0,0,0,0,168,3,0,0,0,0,0,0,0,0,0,1,100,NoArch
adbf34c1c54625e9bea9e8d6b5f6d9e21298847e,0,0,0,0,0,0,0,0,0,0,0,0,0,0,169,4,0,0,0,0,0,0,0,0,0,1,100,NoArch
d257e955295583f5de4775159f9c3488ceb9248d,0,0,0,0,0,0,0,0,0,0,0,0,0,0,0,0,0,0,0,0,0,0,0,0,0,1,100,NoArch
8128b9bae0814e7d82c42b25f76154036efbe383,0,0,0,0,0,0,0,0,0,0,0,0,0,0,1,1,0,0,0,0,0,0,0,0,0,0,100,NoArch
d4e58278d0f406049d156c730cda6683c3529f93,4,237,235,2,0,1,1,5,11,1326,2,4,0.663373952,645,968,0,50,43,7,3924,3914,10,17,18,1,1,99.70006817,NoArch
dde5e3f7cf414b0d6eb88f5f3e337d1bcc55b4ae,0,0,0,0,0,0,0,0,0,0,0,0,0,0,170,4,0,0,0,0,0,0,0,0,0,1,100,NoArch
f6fd0ce109f425fd56237b92a21dec09cd0388f0,3,54,21,33,0,0,0,4,12,726,2,3,0.576315347,504,186,0,61,60,1,3168,2963,205,29,29,0,1,100,NoArch
7dbe24a0d35518d330173c82bb437bfbd011fcc4,0,0,0,0,0,0,0,0,0,0,0,0,0,0,4,0,0,0,0,0,0,0,0,0,0,0,100,NoArch
7120506af5e5eb97235b69a42795c9309e6c0404,3,4,3,1,0,0,0,1,30,36,1,2,1.448815636,501,5,1,28,28,0,3294,3275,19,9,9,0,0,99.89059081,NoArch
cb901b410349875178345e378e51c6749c245ca1,2,0,56,56,0,2,2,5,6,1038,1,2,0.99631652,56,6,2,0,2,2,0,62,62,0,2,2,0,99.94526546,NoArch
0dc7b5cdebe24b9dd309d0c08a2049245d30d0a3,4,41,51,10,0,0,0,10,36,1559,1,1,1.206041569,432,7,3,41,41,0,1558,1559,1,21,21,0,0,97.37685806,Arch
ee41571393261942e86191b4f0200680def23885,1,1,1,0,0,0,0,5,8,808,1,1,0,219,8,4,18,18,0,1114,1114,0,5,5,0,0,100,NoArch
235b6cad6eff26bc6251a76f17308961c3997096,1,2,1,1,0,0,0,3,25,1707,1,1,0,183,187,1,15,15,0,849,831,18,11,11,0,1,99.96887644,NoArch
13b793cccf3662c7f5289bc383dccbede0e12aed,1,1,1,0,0,0,0,5,9,313,1,1,0,227,29,0,34,34,0,1367,1365,2,11,11,0,1,100,NoArch
dce39e6255de28e7c5b9ab534635ec50c80c26da,0,0,0,0,0,0,0,0,0,0,0,0,0,0,188,2,0,0,0,0,0,0,0,0,0,1,100,NoArch
38bcfb522c7b6a33f55d9d7472b5610754714f53,0,0,0,0,0,0,0,0,0,0,0,0,0,0,171,1,0,0,0,0,0,0,0,0,0,0,100,NoArch
31fed42cb8afee148da17eeeb0a2e858ac9af142,0,0,0,0,0,0,0,0,0,0,0,0,0,0,172,2,0,0,0,0,0,0,0,0,0,1,100,NoArch
62b94a582e9c2c52b6ba512304dd36df9897da6a,3,82,9,73,0,0,0,2,10,986,2,3,1.12900232,386,189,3,60,48,12,2784,2212,572,31,26,5,1,99.95336546,NoArch
2ace5ccff9ee43ab8c23665cf7d713afc3ab9331,1,18,6,12,0,0,0,5,8,328,1,1,0,241,190,4,35,32,3,1186,1092,94,7,6,1,1,100,NoArch
2a6b55e1cde25285623af1dd925b3d0b669585aa,0,0,0,0,0,0,0,0,0,0,0,0,0,0,191,5,0,0,0,0,0,0,0,0,0,1,100,NoArch
dc3638afacc5b7c9e0f4e3aec775daa064a71a88,0,0,0,0,0,0,0,0,0,0,0,0,0,0,192,6,0,0,0,0,0,0,0,0,0,1,100,NoArch
4e532ba536e0af2c5edd3fbe2584c52545afcf96,0,0,0,0,0,0,0,0,0,0,0,0,0,0,9,5,0,0,0,0,0,0,0,0,0,0,100,NoArch
f95fda217838bae7d40eb7be62cb20b35db64a0d,6,50,1677,1627,0,4,4,1,11,293,1,2,2.162434849,1829,173,2,19,270,251,814,11253,10439,14,99,85,1,99.70423412,NoArch
744d7e373498b5dc83655304c5e0bfe66b8c6585,0,0,0,0,0,0,0,0,0,0,0,0,0,0,0,0,0,0,0,0,0,0,0,0,0,0,100,NoArch
f53cfe112513cd4ff37d2d5dbefa6c95973bafde,0,0,0,0,0,0,0,0,0,0,0,0,0,0,30,1,0,0,0,0,0,0,0,0,0,1,100,NoArch
f85becc6809858818e074b881f49c5f7f91ac62e,0,0,0,0,0,0,0,0,0,0,0,0,0,0,193,6,0,0,0,0,0,0,0,0,0,1,100,NoArch
d3db3eea1e667b144eaf40e8d506ce088a306534,0,0,0,0,0,0,0,0,0,0,0,0,0,0,31,2,0,0,0,0,0,0,0,0,0,1,100,NoArch
52d824f3ea1f1de9e371b3d7db89ae1c7f688ae2,1,4,3,1,0,0,0,4,6,843,1,1,0,239,174,3,24,24,0,1329,1317,12,19,19,0,1,100,NoArch
048b6899f4cbe1226981fd030cf6890510754406,0,0,0,0,0,0,0,0,0,0,0,0,0,0,32,3,0,0,0,0,0,0,0,0,0,1,100,NoArch
f4a9c597f3e254a4a19e663ef2ee47a78a3048bd,0,0,0,0,0,0,0,0,0,0,0,0,0,0,33,4,0,0,0,0,0,0,0,0,0,1,100,NoArch
82ceb2ab34bb3a88bbd92b01892019700cf67b80,1,1,1,0,0,0,0,10,41,190,1,1,0,298,175,4,23,23,0,1536,1536,0,14,14,0,0,100,NoArch
f689fadc747825d0ffa6d77350cd31e4fe74dd53,2,3,3,0,0,0,0,5,7,1304,1,1,0.918295834,184,1,1,12,12,0,842,830,12,4,4,0,1,100,NoArch
abea22627dc67d6dedd513c9000b64e5728aca5e,0,0,0,0,0,0,0,0,0,0,0,0,0,0,176,5,0,0,0,0,0,0,0,0,0,1,100,NoArch
2b4fa028bb8621e04b84f411e14b2345877ca73b,0,0,0,0,0,0,0,0,0,0,0,0,0,0,177,6,0,0,0,0,0,0,0,0,0,1,100,NoArch
101a9a60f200aef4401fc748adbfef3af8bdd080,0,0,0,0,0,0,0,0,0,0,0,0,0,0,34,4,0,0,0,0,0,0,0,0,0,1,100,NoArch
d0261e801739c6bb767176a4d643ab065e4d9996,0,0,0,0,0,0,0,0,0,0,0,0,0,0,35,5,0,0,0,0,0,0,0,0,0,1,100,NoArch
2b8bfc2453b9b061d23b710241b041c4571c182c,0,0,0,0,0,0,0,0,0,0,0,0,0,0,36,6,0,0,0,0,0,0,0,0,0,1,100,NoArch
2ab6e297ef4f7a4d2d480152424d2670d10395d0,0,0,0,0,0,0,0,0,0,0,0,0,0,0,37,7,0,0,0,0,0,0,0,0,0,0,100,NoArch
ebffa7a88cf46103a144baefdd7027b31f4df432,0,0,0,0,0,0,0,0,0,0,0,0,0,0,178,5,0,0,0,0,0,0,0,0,0,1,100,NoArch
e58f704e276f6dd736a16a2db74a8fe6a80db1c4,1,1,1,0,0,0,0,7,16,870,1,1,0,88,179,6,6,6,0,573,567,6,3,3,0,1,100,NoArch
ebec1e32185bdcc10f48972f791487fe376d4c7b,1,3,1,2,0,0,0,11,31,63,1,1,0,278,2,2,12,12,0,1877,1855,22,4,4,0,1,100,NoArch
056dc18c4dfc6e52026dc88a09a6aeb451f003d0,0,0,0,0,0,0,0,0,0,0,0,0,0,0,226,0,0,0,0,0,0,0,0,0,0,1,100,NoArch
d8ceebe302ccaafa877d092e5d125e4bdb59b966,1,1,1,0,0,0,0,8,32,734,1,1,0,215,227,1,26,26,0,1123,1123,0,9,9,0,1,100,NoArch
5b3171d81667a2ef9431c05e1e4ef56982490bd4,0,0,0,0,0,0,0,0,0,0,0,0,0,0,3,3,0,0,0,0,0,0,0,0,0,1,100,NoArch
2e2114f312fbf4d3856c0c4fcdec3ca81de72f07,0,0,0,0,0,0,0,0,0,0,0,0,0,0,194,1,0,0,0,0,0,0,0,0,0,1,100,NoArch
4080fe4ce74a7adef18330d4dc49667e5219c2b8,0,0,0,0,0,0,0,0,0,0,0,0,0,0,195,1,0,0,0,0,0,0,0,0,0,1,100,NoArch
c1086aa319a1b0fdbe8412cf88c8d67c55cee492,1,0,6,6,0,0,0,4,6,889,1,1,0,188,196,2,13,14,1,905,911,6,7,8,1,1,100,NoArch
76d3f74d071a1a3e6b7228edf9b76bf8e448b0cf,5,364,44,320,2,0,2,1,79,438,1,2,1.641346353,671,197,3,116,66,50,5143,3847,1296,32,12,20,1,99.92210625,NoArch
5477173c071f3e70493cf36bd85de741998eb17b,1,8,162,154,0,0,0,13,35,214,1,1,0,401,4,2,14,14,0,1608,1608,0,7,7,0,0,100,NoArch
0fe6a49d76c237bd831a27f8526c62cf1c7f5cc8,6,222,103,119,0,0,0,5,38,908,2,2,1.770967989,1198,198,4,205,188,17,6483,5584,899,117,113,4,1,99.93772381,NoArch
d51639d615a0a19575f45188642c6b7a946bb44d,0,0,0,0,0,0,0,0,0,0,0,0,0,0,5,1,0,0,0,0,0,0,0,0,0,1,100,NoArch
4538d8f33f01ad7a4541cf2b8bc265049363c644,0,0,0,0,0,0,0,0,0,0,0,0,0,0,6,2,0,0,0,0,0,0,0,0,0,1,100,NoArch
ff3b13e5a7d19678260220e18da291a5bd6c311c,0,0,0,0,0,0,0,0,0,0,0,0,0,0,199,5,0,0,0,0,0,0,0,0,0,1,100,NoArch
e431289d450baba0f73811335959834b11362a72,0,0,0,0,0,0,0,0,0,0,0,0,0,0,7,3,0,0,0,0,0,0,0,0,0,1,100,NoArch
deafc5cc6db3a6c10d21d13a2fa99b6db4e11b83,0,0,0,0,0,0,0,0,0,0,0,0,0,0,180,0,0,0,0,0,0,0,0,0,0,1,100,NoArch
678957e64fb937be688c471622877103edb8592a,1,37,32,5,0,0,0,6,13,316,1,1,0,164,181,1,16,15,1,1229,1205,24,5,4,1,1,100,NoArch
fa2972607a4ba589a4db42cfafd5293b350f671a,9,45,33,12,0,0,0,5,19,1243,1,3,2.847699038,878,182,2,78,74,4,5101,4843,258,48,47,1,1,100,NoArch
28a9e82edfe31cce0300f8ff7be4dd96262ef0a9,1,4,4,0,0,0,0,8,16,0,1,1,0,163,183,3,21,21,0,1286,1286,0,7,7,0,1,100,NoArch
0be8a407b1ada018e2f35e93dc7561f1683fe6e2,0,0,0,0,0,0,0,0,0,0,0,0,0,0,200,5,0,0,0,0,0,0,0,0,0,1,100,NoArch
94b08db7c444d5a00929e8a52e4359cc029bf237,4,16,26,10,0,0,0,5,20,0,1,2,1.801463832,439,201,6,32,32,0,2332,2332,0,22,22,0,1,100,NoArch
28fe00310d0f74a8e5c2350dc7c17bdbcb388fa1,1,2,1,1,0,0,0,5,17,0,1,1,0,182,184,4,11,11,0,1164,1164,0,3,3,0,1,100,NoArch
6ed413c9b194a02ccce770922c99a1e9edd41a30,0,0,0,0,0,0,0,0,0,0,0,0,0,0,202,7,0,0,0,0,0,0,0,0,0,1,100,NoArch
0c7c65e673848f856aefb22336af8605120c5ae7,5,112,14,98,0,0,0,9,113,443,1,4,1.855098427,1209,203,8,81,71,10,6127,5474,653,45,41,4,1,100,NoArch
d6a08331597861de59819b0f5b10e68c6dd57113,9,9,5,4,0,0,0,5,80,960,2,4,2.69951385,1675,204,9,122,122,0,9503,9485,18,65,65,0,1,100,NoArch
497ac820ac0652031ae62b1ddef3e85f30972072,1,1,0,1,0,0,0,9,48,1168,1,1,0,124,205,10,7,7,0,637,635,2,4,4,0,1,100,NoArch
37f28bd6472cd1700ffc16015096a53749e0a09b,2,80,0,80,1,0,1,1,1,0,1,2,0,149,206,11,14,11,3,1571,989,582,7,5,2,1,99.89103362,NoArch
7afd9f4cf51c6ebde450d57ad756d7fd7e13b326,5,179,297,118,0,0,0,7,34,869,1,3,1.870259839,1283,207,12,119,122,3,7088,7569,481,73,77,4,1,97.41070036,Arch
9f036af1028a8456ef50102222765efabad69f01,5,33,65,32,0,0,0,6,29,682,2,4,1.222255235,1289,208,13,144,143,1,7170,7254,84,44,44,0,1,99.92181392,NoArch
657803cdb7e8361bf02208ee435d8fbf900b2903,1,7,7,0,0,0,0,5,18,2838,1,1,0,198,185,5,24,24,0,522,521,1,10,10,0,1,100,NoArch
fb6408bd207a2a3053aadf1a189dff2310204b27,1,7,7,0,0,0,0,5,19,0,1,1,0,198,186,6,24,24,0,521,522,1,10,10,0,1,100,NoArch
69eb75e334907b230edf6d2c7ef12b79c5216de2,1,5,5,0,0,0,0,3,3,3970,1,1,0,51,187,7,5,5,0,124,107,17,5,5,0,1,100,NoArch
1a9d87432110ab40723e3e21691a2f8d66a776bf,1,5,5,0,0,0,0,3,4,0,1,1,0,51,188,8,5,5,0,107,124,17,5,5,0,1,100,NoArch
1a42d852daa75cf9b6a78013544647be2ec2a8e3,800,0,0,0,0,0,0,1,1,0,1,164,0,109070,10,0,10605,10605,0,548472,548472,0,5115,5115,0,1,48.49509094,Arch
a64100d443edabe608668d4cac9f9fa0221d03af,3,224,0,224,3,0,3,1,1,0,1,1,1.574773933,0,11,1,34,0,34,1223,0,1223,6,0,6,1,99.90062935,NoArch
f789bd0de54514e614334b7766f07d4ab5d21129,2,34,32,2,0,0,0,2,2,0,1,1,0.32984607,153,209,11,28,28,0,858,858,0,5,5,0,1,100,NoArch
5f070b4312060a04e857386fbaea9a189a5a3727,1,6,4,2,0,0,0,2,2,0,1,1,0,311,210,12,40,40,0,1871,1861,10,19,19,0,1,100,NoArch
9a46c29d010c36c090a14aca84d488079eb19247,0,0,0,0,0,0,0,0,0,0,0,0,0,0,211,13,0,0,0,0,0,0,0,0,0,1,100,NoArch
b0036a958479599ed15b9f29752d47c33e31b613,0,0,0,0,0,0,0,0,0,0,0,0,0,0,212,14,0,0,0,0,0,0,0,0,0,1,100,NoArch
9a5bab5ef9328ec5e527f8dcfe08439d11971058,14,173,206,33,0,2,2,2,2,0,1,5,3.33040107,1280,213,15,106,102,4,7441,7528,87,58,59,1,1,94.32589719,Arch
bae0d6e11bc4ac19beebba85b1670dcb4be3e3df,0,0,0,0,0,0,0,0,0,0,0,0,0,0,38,0,0,0,0,0,0,0,0,0,0,1,100,NoArch
6731710c30ae09092b058935b416d42b9ce77b11,0,0,0,0,0,0,0,0,0,0,0,0,0,0,214,16,0,0,0,0,0,0,0,0,0,1,100,NoArch
b962375718a597b3177217c74f2305f480f3230c,0,0,0,0,0,0,0,0,0,0,0,0,0,0,8,3,0,0,0,0,0,0,0,0,0,1,100,NoArch
92fbb7149134b685891965fb5cc5982505d1457e,1,0,3,3,0,0,0,2,2,604,1,1,0,172,215,16,10,10,0,576,576,0,9,9,0,1,100,NoArch
19383c24e23ba6a0721e832702255f99610e4ae9,0,0,0,0,0,0,0,0,0,0,0,0,0,0,189,9,0,0,0,0,0,0,0,0,0,1,100,NoArch
c383f0b6308d5d11e297eb64be1eb0fc875bea23,1,6,0,6,0,0,0,2,2,23,1,1,0,171,190,10,14,14,0,1158,1158,0,7,7,0,1,100,NoArch
3a284f5eb89cf09b61b73cf6ff2711741bbacc7a,6,32,14,18,0,0,0,2,34,702,4,5,2.018870212,1235,216,16,85,81,4,8080,7926,154,28,28,0,1,100,NoArch
1fb3f6aeed780f0362d63bed0b52a44efcb320bb,9,88,30,58,1,0,1,1,11,467,1,3,2.688755829,938,12,2,67,65,2,5737,5488,249,49,48,1,1,99.90522824,NoArch
1570b44019662548936df3d3ac282d6753046f55,0,0,0,0,0,0,0,0,0,0,0,0,0,0,217,17,0,0,0,0,0,0,0,0,0,1,100,NoArch
1132b48a540150a251d0d18471c010813e929cb4,0,0,0,0,0,0,0,0,0,0,0,0,0,0,218,18,0,0,0,0,0,0,0,0,0,1,100,NoArch
25c9cee1ac3f2d4c3d2c839ddad2caf386b07770,0,0,0,0,0,0,0,0,0,0,0,0,0,0,219,17,0,0,0,0,0,0,0,0,0,1,100,NoArch
a47466fbc31df0335b37de2f4d190ea1c9b22fa9,0,0,0,0,0,0,0,0,0,0,0,0,0,0,220,18,0,0,0,0,0,0,0,0,0,1,100,NoArch
524fc62e706bc71230860ff52688b2a15f01949b,46,0,7121,7121,0,46,46,2,2,0,1,8,5.08550644,7121,221,19,0,755,755,0,40858,40858,0,245,245,1,94.34087883,Arch
c43287f816aeea6d3aef21046d420a7c0c37e57b,0,0,0,0,0,0,0,0,0,0,0,0,0,0,39,1,0,0,0,0,0,0,0,0,0,1,100,NoArch
d141c8e887904122a2b3cb4bf94851e7401d807d,27,276,67,209,0,0,0,2,15,203,2,7,4.307979695,3421,222,8,324,299,25,20368,19035,1333,211,193,18,1,100,NoArch
58e6581424438243c5bf670b26d505a9d8175f98,0,0,0,0,0,0,0,0,0,0,0,0,0,0,223,9,0,0,0,0,0,0,0,0,0,1,100,NoArch
575f8c2bd491122e777523bde284eeb6def74796,0,0,0,0,0,0,0,0,0,0,0,0,0,0,224,10,0,0,0,0,0,0,0,0,0,1,100,NoArch
29e3f2820746f53ceaab2c173c6e48434d59d2c6,0,0,0,0,0,0,0,0,0,0,0,0,0,0,40,1,0,0,0,0,0,0,0,0,0,1,100,NoArch
464e8de1f0854e0d84e2b3a4a1320be128f720c9,0,0,0,0,0,0,0,0,0,0,0,0,0,0,225,3,0,0,0,0,0,0,0,0,0,1,100,NoArch
d3c09ba44bdaba2fe63a3bf8badd2ea4b9f567b8,2,31,27,4,0,0,0,5,6,1129,1,2,0.992266639,344,226,4,30,31,1,1951,1926,25,8,8,0,1,100,NoArch
4f668dba945e2d61d62d37276a1d4a03f3b14276,3,70,20,50,1,0,1,1,2,58,1,2,1.456564762,126,227,5,16,14,2,753,570,183,12,10,2,1,99.77212971,NoArch
5b0b559cb9985a10f3a206f4dc557d817bd0d085,6,87,30,57,1,0,1,1,2,70,1,5,2.352694817,1453,228,6,124,118,6,7884,7596,288,42,39,3,1,95.80088046,Arch
c1adfe003ce0f50ecf5b429fcbc38277e3b426a1,9,1803,195,1608,5,0,5,1,2,36,1,2,2.336660761,1261,229,7,160,125,35,12152,6511,5641,61,48,13,1,99.81970169,NoArch
6634aaaf2222de25f855a70963c03f39410ba90a,0,0,0,0,0,0,0,0,0,0,0,0,0,0,82,0,0,0,0,0,0,0,0,0,0,0,100,NoArch
bf40156eacda79253142c96ebb856cb68f0d3ca0,0,0,0,0,0,0,0,0,0,0,0,0,0,0,83,1,0,0,0,0,0,0,0,0,0,0,100,NoArch
6bda4d73ff5d2b3b4ad4288fb22cde44a2898fe3,0,0,0,0,0,0,0,0,0,0,0,0,0,0,41,0,0,0,0,0,0,0,0,0,0,0,100,NoArch
360613f1d6c6b4694d2ac5a229950010ff4eab04,0,0,0,0,0,0,0,0,0,0,0,0,0,0,0,0,0,0,0,0,0,0,0,0,0,0,100,NoArch
d850a091d3240f7863c92380fc01624c27f783c4,0,0,0,0,0,0,0,0,0,0,0,0,0,0,2,0,0,0,0,0,0,0,0,0,0,0,100,NoArch
299fe6cc217f3d62057a55140a44ada0ce6ea145,3,155,33,122,0,0,0,2,2,102,1,2,1.259960357,564,0,0,98,78,20,4630,3785,845,43,34,9,1,100,NoArch
84a4bce9e4a4964d396a4ada3da35df4d842a9fe,2,94,8,86,1,0,1,1,2,52,1,2,0.752212173,224,1,1,28,24,4,1802,1177,625,11,9,2,1,99.7869551,NoArch
b59276e9271d4b865331cd192d7a19871847fbb8,0,0,0,0,0,0,0,0,0,0,0,0,0,0,2,2,0,0,0,0,0,0,0,0,0,1,100,NoArch
aa0f0f461f6b9ca0186a7e054ec61eee76f396f7,0,0,0,0,0,0,0,0,0,0,0,0,0,0,3,3,0,0,0,0,0,0,0,0,0,1,100,NoArch
cb6abe1f9b54e35be1b3189422b91d395f732031,0,0,0,0,0,0,0,0,0,0,0,0,0,0,4,4,0,0,0,0,0,0,0,0,0,1,100,NoArch
e8d2617d36d54371701707531756135147aed1b7,0,0,0,0,0,0,0,0,0,0,0,0,0,0,5,5,0,0,0,0,0,0,0,0,0,1,100,NoArch
0be2ea46aa3a700e9e863d0c5f75f256ff56641b,1,11,2,9,0,0,0,3,3,8,1,1,0,435,0,0,87,85,2,2766,2722,44,33,33,0,1,100,NoArch
5a1c2ccba645ee38bbc3a7c251a470a42194f41e,0,0,0,0,0,0,0,0,0,0,0,0,0,0,1,1,0,0,0,0,0,0,0,0,0,1,100,NoArch
8714a0f722663ea5cb16c14c5b8a01e57574cd93,0,0,0,0,0,0,0,0,0,0,0,0,0,0,42,1,0,0,0,0,0,0,0,0,0,1,100,NoArch
7423629056bf709be07d0c7bb7d42e0e250f3ad9,0,0,0,0,0,0,0,0,0,0,0,0,0,0,43,2,0,0,0,0,0,0,0,0,0,1,100,NoArch
d5c94bdde1ca02bf84fe6a2c5fb28bce5c07309e,0,0,0,0,0,0,0,0,0,0,0,0,0,0,44,3,0,0,0,0,0,0,0,0,0,0,100,NoArch
e0751eaaca4bb06adcf80108d85ad0dc6cc67074,6,146,63,83,0,0,0,2,36,191,2,4,2.120249972,1221,1,1,124,115,9,7728,7389,339,74,71,3,1,100,NoArch
9d6be1cd3b0a1f6a846e985ece0365b0ba218cdf,0,0,0,0,0,0,0,0,0,0,0,0,0,0,2,2,0,0,0,0,0,0,0,0,0,0,100,NoArch
1d1134ee941c6a06804fdb5fef536e3ed95ed36e,0,0,0,0,0,0,0,0,0,0,0,0,0,0,3,3,0,0,0,0,0,0,0,0,0,1,100,NoArch
88bddb08ab014df9d1d14b75fc96f6a8380b4545,6,33,122,89,0,0,0,2,37,61,2,3,1.994529249,1445,4,4,120,128,8,8790,9402,612,77,84,7,0,95.04106128,Arch
127bd01344532f2f666335b80450279bb96c45eb,0,0,0,0,0,0,0,0,0,0,0,0,0,0,5,5,0,0,0,0,0,0,0,0,0,0,100,NoArch
656878ea69adf7663015156b55ad5c9ea3ec7e4f,0,0,0,0,0,0,0,0,0,0,0,0,0,0,45,4,0,0,0,0,0,0,0,0,0,1,100,NoArch
26d3db6ba1f12870af996ef9eaea17dfc4a8b8fb,0,0,0,0,0,0,0,0,0,0,0,0,0,0,46,5,0,0,0,0,0,0,0,0,0,1,100,NoArch
9cf90546dfa8bf11c99089a12d70b0272e7da211,0,0,0,0,0,0,0,0,0,0,0,0,0,0,47,6,0,0,0,0,0,0,0,0,0,1,100,NoArch
dd78ed9479559cd222f24fa0be57655cf2e3075b,2,244,5,239,0,0,0,2,6,932,1,2,0.663823245,217,228,0,53,24,29,2055,968,1087,36,18,18,1,100,NoArch
0f4f5dec7f3a7de7161d1fabf3e02418099f4446,1,43,0,43,0,0,0,5,19,932,1,1,0,180,229,1,47,38,9,1323,964,359,16,15,1,1,100,NoArch
5083f58359dd103ac6d8e72a50c53bb20a5df14e,1,127,0,127,0,0,0,3,6,3028,1,1,0,34,230,2,29,3,26,1231,110,1121,4,1,3,1,99.84804741,NoArch
63b765abb305cca6d726f54549a92018754a6348,1,21,14,7,0,0,0,5,20,0,1,1,0,223,231,3,48,47,1,1365,1323,42,16,16,0,1,100,NoArch
cc9a70ebbdaceb8d5c2fcecd1a8cd9bee67e323e,0,0,0,0,0,0,0,0,0,0,0,0,0,0,0,0,0,0,0,0,0,0,0,0,0,0,100,NoArch
99fd9ba4f9673b2b2d30c2b403aaa294503cc2a2,2,7,6,1,0,0,0,2,6,465,2,2,0.619382195,390,232,4,30,30,0,1583,1577,6,17,17,0,1,100,NoArch
a12135b94002367046ef6edc977527d586026689,0,0,0,0,0,0,0,0,0,0,0,0,0,0,1,1,0,0,0,0,0,0,0,0,0,0,100,NoArch
0844e69d6cbdc7bbfd54ba01dc9c829764eaeb6d,12,127,48,79,0,0,0,2,21,417,3,11,2.200233424,5007,233,5,676,642,34,23429,22747,682,295,294,1,1,96.89765149,Arch
8bcaa77340ac377a20237af4efbe891dc5a4790d,4,37,34,3,0,0,0,6,11,1496,2,4,0.551804755,1323,234,6,140,140,0,5205,5200,5,69,69,0,1,100,NoArch
fcb436d2a7ed399dd8006b3254e655634000f4a1,1,2,2,0,0,0,0,4,12,0,1,1,0,171,235,7,21,21,0,1041,1041,0,8,8,0,1,100,NoArch
d319b325066620a82d079379564188912e8b0b92,0,0,0,0,0,0,0,0,0,0,0,0,0,0,2,2,0,0,0,0,0,0,0,0,0,0,100,NoArch
11046fb5273b559298111b201470d80cd6af43d9,0,0,0,0,0,0,0,0,0,0,0,0,0,0,48,6,0,0,0,0,0,0,0,0,0,0,100,NoArch
907781bb856b47cb7b180484c6d4b9f55a6df038,2,25,0,25,0,0,0,1,2,736,1,2,0.904381458,187,49,5,21,18,3,1047,858,189,16,13,3,1,99.95839689,NoArch
8c529ccff23d419c4cb5191b0435de40d6a9831c,0,0,0,0,0,0,0,0,0,0,0,0,0,0,50,6,0,0,0,0,0,0,0,0,0,1,100,NoArch
b044a07797a8fef23d10f10126615c9b7db659bb,0,0,0,0,0,0,0,0,0,0,0,0,0,0,51,6,0,0,0,0,0,0,0,0,0,1,100,NoArch
fd7a0bf969e19f069dc97c7d908f9c120c58acdd,0,0,0,0,0,0,0,0,0,0,0,0,0,0,3,3,0,0,0,0,0,0,0,0,0,0,100,NoArch
a8e09cd3aa1c9d6fdda2eaf84f86a06a33963658,2,58,21,37,0,0,0,2,3,86,1,1,0.973835482,432,6,0,89,85,4,2673,2395,278,33,28,5,1,100,NoArch
b77caec6f1c2b9bb48a619a7680c5a5e351579f8,0,0,0,0,0,0,0,0,0,0,0,0,0,0,4,4,0,0,0,0,0,0,0,0,0,0,100,NoArch
c1ca30872c622e513e49fc1bb111bc4b8a527d3b,1,12,1,11,0,0,0,2,2,3077,1,1,0,147,5,5,12,11,1,581,539,42,8,7,1,1,100,NoArch
c20eee89c6cc669494cf7edbb80255a83e194a15,1,13,2,11,0,0,0,8,20,749,1,1,0,1687,6,6,101,99,2,3988,3949,39,79,78,1,1,100,NoArch
6fbf3663b55def1f75fa3bed4690bf9562146921,1,4,5,1,0,0,0,3,8,17,1,1,0,181,236,8,30,30,0,1441,1458,17,5,5,0,1,100,NoArch
45d88031c8e782a624eaf6cefea9700600805647,5,78,5,73,0,0,0,8,39,733,1,2,2.187471366,2313,7,1,285,272,13,12107,11711,396,185,178,7,1,100,NoArch
3dd18344a47fb86b5127bcf3e051a2eb4e7ca996,0,0,0,0,0,0,0,0,0,0,0,0,0,0,52,4,0,0,0,0,0,0,0,0,0,1,100,NoArch
37b85253981770b455bd9936cef23de460662483,0,0,0,0,0,0,0,0,0,0,0,0,0,0,0,0,0,0,0,0,0,0,0,0,0,1,100,NoArch
2b65475c3ab682ebd47cffdc6b502698799cd2c8,0,0,0,0,0,0,0,0,0,0,0,0,0,0,7,0,0,0,0,0,0,0,0,0,0,3,100,NoArch
638ac8c7f783d30f5a52c62ca50c28cabde454f8,0,0,0,0,0,0,0,0,0,0,0,0,0,0,8,1,0,0,0,0,0,0,0,0,0,0,100,NoArch
32badb1d360ddf514e6b253f2dea9ae7e5df078a,0,0,0,0,0,0,0,0,0,0,0,0,0,0,8,1,0,0,0,0,0,0,0,0,0,3,100,NoArch
8b2bec7f5e3a0d3500e38bbecbc3db6d08e7435c,0,0,0,0,0,0,0,0,0,0,0,0,0,0,10,3,0,0,0,0,0,0,0,0,0,0,100,NoArch
24cb5576f720737b73906ebb15be486d540ac629,0,0,0,0,0,0,0,0,0,0,0,0,0,0,11,4,0,0,0,0,0,0,0,0,0,1,100,NoArch
9bfb767323833586873272af4db446f68f357f1f,0,0,0,0,0,0,0,0,0,0,0,0,0,0,12,5,0,0,0,0,0,0,0,0,0,2,100,NoArch
63cebf76e9c7746a1851841e37f5873704e086e8,0,0,0,0,0,0,0,0,0,0,0,0,0,0,53,0,0,0,0,0,0,0,0,0,0,1,100,NoArch
e4ba7887fc6dbf17c3d73f8d4aa1045eeb48d53e,0,0,0,0,0,0,0,0,0,0,0,0,0,0,54,1,0,0,0,0,0,0,0,0,0,1,100,NoArch
25a6fc0967357e6ba4aafcaf11bf3f7faec752fd,0,0,0,0,0,0,0,0,0,0,0,0,0,0,55,2,0,0,0,0,0,0,0,0,0,1,100,NoArch
272b1615311c551def0a686a75cc64591b01007e,0,0,0,0,0,0,0,0,0,0,0,0,0,0,56,3,0,0,0,0,0,0,0,0,0,0,100,NoArch
dec441fb895c96d1e756619d15d75bba00b10fa3,0,0,0,0,0,0,0,0,0,0,0,0,0,0,57,2,0,0,0,0,0,0,0,0,0,1,100,NoArch
c9d978a460203736732af546f8b88120795c5d33,1,62,1,61,0,0,0,5,11,536,1,1,0,224,58,3,31,26,5,993,780,213,17,17,0,1,100,NoArch
ccaec1b267d768e890695dd36c49a34d621e1e73,2,66,12,54,0,0,0,2,3,246,1,2,0.73206669,305,0,0,30,25,5,2087,1728,359,11,9,2,0,98.91555813,NoArch
377dcace16fe4fd77baaab91ad575e9da5c49ac0,2,12,66,54,0,0,0,1,2,43,1,2,0.73206669,359,59,4,25,30,5,1728,2087,359,9,11,2,1,98.91555813,NoArch
2715ed201b7e6d583ee40e6d262a29a400fd16fb,0,0,0,0,0,0,0,0,0,0,0,0,0,0,60,4,0,0,0,0,0,0,0,0,0,0,100,NoArch
846307d5b03ef7df6d3c890f2a291b4c11581e80,0,0,0,0,0,0,0,0,0,0,0,0,0,0,61,5,0,0,0,0,0,0,0,0,0,1,100,NoArch
e7f247d8ee25cf59ca0d58dc426edfee62e3613f,0,0,0,0,0,0,0,0,0,0,0,0,0,0,62,5,0,0,0,0,0,0,0,0,0,0,100,NoArch
56a2305ed14a3f4706b10c394a27d3429c2103b4,0,0,0,0,0,0,0,0,0,0,0,0,0,0,63,6,0,0,0,0,0,0,0,0,0,0,100,NoArch
66f164057e322d2e63ea02c35c9e30c3969e80b1,0,0,0,0,0,0,0,0,0,0,0,0,0,0,64,7,0,0,0,0,0,0,0,0,0,0,100,NoArch
e5bc885fdb4492a6d54232cea6c7e8e0abd4080d,0,0,0,0,0,0,0,0,0,0,0,0,0,0,65,6,0,0,0,0,0,0,0,0,0,0,100,NoArch
7a50a291b4598e9809f9acf609b92175ce7f953b,0,0,0,0,0,0,0,0,0,0,0,0,0,0,66,7,0,0,0,0,0,0,0,0,0,1,100,NoArch
00c0149b95d3621ed5991578ac534ba5fdf5ac02,0,0,0,0,0,0,0,0,0,0,0,0,0,0,67,8,0,0,0,0,0,0,0,0,0,0,100,NoArch
a80974037853c5227f9e5ef1c384a1fca134746e,0,0,0,0,0,0,0,0,0,0,0,0,0,0,13,0,0,0,0,0,0,0,0,0,0,3,100,NoArch
ee6359f621b508ab7f21df0316941e68c75eb3e5,0,0,0,0,0,0,0,0,0,0,0,0,0,0,68,9,0,0,0,0,0,0,0,0,0,2,100,NoArch
b447f3fd07eafa36440dc4347e8514a15501e3c2,0,0,0,0,0,0,0,0,0,0,0,0,0,0,14,1,0,0,0,0,0,0,0,0,0,0,100,NoArch
a70f48537524bdaa92178bf539bf84aad501c80d,0,0,0,0,0,0,0,0,0,0,0,0,0,0,15,2,0,0,0,0,0,0,0,0,0,0,100,NoArch
a6c8346ddb82390e2f5b5bd8c5968c436264e8a6,0,0,0,0,0,0,0,0,0,0,0,0,0,0,69,4,0,0,0,0,0,0,0,0,0,0,100,NoArch
4bac5c295b3b820a6e7f25e4dcf5a843b7d1983e,0,0,0,0,0,0,0,0,0,0,0,0,0,0,70,5,0,0,0,0,0,0,0,0,0,0,100,NoArch
25c9ed0ebeb34a3ef43a48fa47ea0340a049aac0,0,0,0,0,0,0,0,0,0,0,0,0,0,0,71,6,0,0,0,0,0,0,0,0,0,1,100,NoArch
8d6ac39fc08d11d84a0c37bf81d8af5d6d7fe234,0,0,0,0,0,0,0,0,0,0,0,0,0,0,72,7,0,0,0,0,0,0,0,0,0,0,100,NoArch
445c1e3f743e687e874353b054c98253475d3413,0,0,0,0,0,0,0,0,0,0,0,0,0,0,73,8,0,0,0,0,0,0,0,0,0,0,100,NoArch
c6ee8cbcdb6ae205624b908bc16ae462515c98e6,0,0,0,0,0,0,0,0,0,0,0,0,0,0,74,9,0,0,0,0,0,0,0,0,0,0,100,NoArch
85a098a364d467616394cd76d186d44f5f49a227,0,0,0,0,0,0,0,0,0,0,0,0,0,0,75,10,0,0,0,0,0,0,0,0,0,0,100,NoArch
656225c67fb5cc5d232ac77a4201ecd2f1136805,0,0,0,0,0,0,0,0,0,0,0,0,0,0,76,8,0,0,0,0,0,0,0,0,0,0,100,NoArch
336f0e7dba88253838397dc2c579d5a6a472870f,0,0,0,0,0,0,0,0,0,0,0,0,0,0,77,8,0,0,0,0,0,0,0,0,0,0,100,NoArch
74c10743dfaa3d00b7cea1b89a0432173187866c,0,0,0,0,0,0,0,0,0,0,0,0,0,0,78,9,0,0,0,0,0,0,0,0,0,0,100,NoArch
f870a630291bd9d623b32c21f087ba19e69eb1fc,20,1902,0,1902,20,0,20,1,1,0,1,3,4.081148906,0,0,0,192,0,192,9556,0,9556,49,0,49,1,99.40714187,NoArch
c96498680df551f2cbd2a4735d9408044a0c7bc3,13,29,44,15,0,0,0,1,2,0,1,2,2.664733923,1375,1,1,144,144,0,7262,7387,125,31,31,0,1,99.8903659,NoArch
91f15ecfe5d26de36d8e9bcd6cf109b307882a32,8,115,55,60,0,0,0,2,5,585,3,8,2.283076611,1211,0,0,122,116,6,7775,7400,375,48,48,0,1,100,NoArch
149c98592fe447c98dfb5afc67b5809725cc3056,0,0,0,0,0,0,0,0,0,0,0,0,0,0,16,0,0,0,0,0,0,0,0,0,0,3,100,NoArch
03a5bb61ed56daccd207d7a255956e21612cf995,12,16,16,0,0,0,0,1,3,0,1,1,3.27439747,886,2,2,75,75,0,4329,4329,0,16,16,0,1,100,NoArch
6dd0c92ddb9dad2627e9ca5e28118865d6fba159,2,58,11,47,0,0,0,6,7,306,1,2,0.918295834,348,3,3,39,30,9,2172,1951,221,9,8,1,1,100,NoArch
d9e26c64d620d723c94386e1a5ef9e70588c31a3,0,0,0,0,0,0,0,0,0,0,0,0,0,0,1,1,0,0,0,0,0,0,0,0,0,1,100,NoArch
e24c4afb699c2930d372c701fe2de874a2a2f6c0,0,0,0,0,0,0,0,0,0,0,0,0,0,0,17,1,0,0,0,0,0,0,0,0,0,2,100,NoArch
2d1b0bf632724ceb091035582274201269cfe3e3,20,607,306,301,0,0,0,1,4,20,1,3,3.878488962,1887,4,4,192,192,0,9465,9431,34,49,49,0,1,100,NoArch
034afd61126660b6f44b232fdf3e1dd9d1a79708,0,0,0,0,0,0,0,0,0,0,0,0,0,0,5,0,0,0,0,0,0,0,0,0,0,1,100,NoArch
3c88f50432dc8dd70ab7eb03e1bbf419f3f7ab81,0,0,0,0,0,0,0,0,0,0,0,0,0,0,79,0,0,0,0,0,0,0,0,0,0,1,100,NoArch
c34e8a84c39b7bd2175cdbcb8583d487548a34b4,0,0,0,0,0,0,0,0,0,0,0,0,0,0,6,1,0,0,0,0,0,0,0,0,0,1,100,NoArch
61c9e1a92975de5891f082068fb708dc30cfafa1,0,0,0,0,0,0,0,0,0,0,0,0,0,0,7,2,0,0,0,0,0,0,0,0,0,1,100,NoArch
4e6577d140c203eae0b634764971bf2444438f41,0,0,0,0,0,0,0,0,0,0,0,0,0,0,8,3,0,0,0,0,0,0,0,0,0,1,100,NoArch
666d314fb8d9f466a5496a143d73d55036aea619,0,0,0,0,0,0,0,0,0,0,0,0,0,0,18,0,0,0,0,0,0,0,0,0,0,0,100,NoArch
6651a328679742ce6c14ce8a4e6ab0bc0a05f7e9,0,0,0,0,0,0,0,0,0,0,0,0,0,0,19,1,0,0,0,0,0,0,0,0,0,0,100,NoArch
c1a10d9b5a62036cbfc93a775a3817f69a85bf6e,0,0,0,0,0,0,0,0,0,0,0,0,0,0,20,1,0,0,0,0,0,0,0,0,0,0,100,NoArch
f1095d8c30d33e0e86e691f797d13c6f7bc11c4c,0,0,0,0,0,0,0,0,0,0,0,0,0,0,0,0,0,0,0,0,0,0,0,0,0,1,100,NoArch
379863d8f9dff8c0a42c341c68044c9c52b597e0,1,2,2,0,0,0,0,3,4,1544,1,1,0,122,2,0,6,6,0,633,628,5,4,4,0,1,100,NoArch
6530e8144f9638932092d65bbdc72faf0fc840cd,1,1,1,0,0,0,0,3,5,28,1,1,0,122,3,1,6,6,0,628,633,5,4,4,0,1,100,NoArch
ae1808be0e76c15544e75ec54aae3fc720f65364,0,0,0,0,0,0,0,0,0,0,0,0,0,0,21,0,0,0,0,0,0,0,0,0,0,0,100,NoArch
310534319ae8df4cd95c3ff044afb6afdaee2605,2,3,4,1,0,0,0,3,4,472,2,2,0.863120569,528,9,0,49,49,0,2710,2710,0,18,18,0,1,100,NoArch
0f037cb03e77c09627c36962600e4fb00c4013c8,0,0,0,0,0,0,0,0,0,0,0,0,0,0,10,1,0,0,0,0,0,0,0,0,0,1,100,NoArch
d0f64205a116853aa471dd1361a635167da15fcc,0,0,0,0,0,0,0,0,0,0,0,0,0,0,22,0,0,0,0,0,0,0,0,0,0,0,100,NoArch
c3936fd3820fe4fb6cdd1cba7944f016dc0d5e13,1,4,5,1,0,0,0,1,5,39,1,1,0,408,11,2,42,43,1,1754,1769,15,12,12,0,0,100,NoArch
1ca1ef32483f35014cdd96596c454cafe83c34f3,0,0,0,0,0,0,0,0,0,0,0,0,0,0,12,0,0,0,0,0,0,0,0,0,0,0,100,NoArch
e005b28b263ce5eeab6f105ead660a3fe89cb756,0,0,0,0,0,0,0,0,0,0,0,0,0,0,23,0,0,0,0,0,0,0,0,0,0,0,100,NoArch
0c672bbcd95b8f757d7faccc09d980c62576f41c,0,0,0,0,0,0,0,0,0,0,0,0,0,0,80,0,0,0,0,0,0,0,0,0,0,0,100,NoArch
901ef03b4c7f7da96452fbd08018b32ef2341fe0,0,0,0,0,0,0,0,0,0,0,0,0,0,0,81,1,0,0,0,0,0,0,0,0,0,0,100,NoArch
463989272b4219716ca692cb4f9b757076d5c690,0,0,0,0,0,0,0,0,0,0,0,0,0,0,24,1,0,0,0,0,0,0,0,0,0,0,100,NoArch
fde08a9a57af94511fddc501dcff09fbd7825d48,0,0,0,0,0,0,0,0,0,0,0,0,0,0,82,2,0,0,0,0,0,0,0,0,0,0,100,NoArch
43bea68f363143d87f567eedff147460db5bd146,0,0,0,0,0,0,0,0,0,0,0,0,0,0,25,1,0,0,0,0,0,0,0,0,0,0,100,NoArch
15ee1951d1ba8d8ee7d24e2510af187fd984c8cf,0,0,0,0,0,0,0,0,0,0,0,0,0,0,26,2,0,0,0,0,0,0,0,0,0,0,100,NoArch
b0ee8e2657a900315140d21205416338cc955864,0,0,0,0,0,0,0,0,0,0,0,0,0,0,27,3,0,0,0,0,0,0,0,0,0,0,100,NoArch
d5ea1f1be4d8ee6e3ceb7863322921c331a6c0a2,0,0,0,0,0,0,0,0,0,0,0,0,0,0,13,0,0,0,0,0,0,0,0,0,0,0,100,NoArch
9b169e7e710f1a4883a15b652ad8ece86a88960f,0,0,0,0,0,0,0,0,0,0,0,0,0,0,14,1,0,0,0,0,0,0,0,0,0,0,100,NoArch
ec8a5a006385c0ecf25f1d982ace83bb3c41e052,1,1,1,0,0,0,0,2,2,1018,1,1,0,493,4,0,24,24,0,2099,2092,7,8,8,0,1,100,NoArch
87c15bea46081baab98db9a0dbd480c5dac5ceb4,131,322,431,109,0,0,0,3,30,1123,3,65,6.319077755,29138,5,1,3193,3219,26,152024,152860,836,1246,1246,0,1,100,NoArch
7476e35535b062e5ce883dfb1125001c2cf58a16,0,0,0,0,0,0,0,0,0,0,0,0,0,0,6,2,0,0,0,0,0,0,0,0,0,1,100,NoArch
4d3a3863552e23c4aaafd82545222b0e6a3cd1fd,0,0,0,0,0,0,0,0,0,0,0,0,0,0,7,3,0,0,0,0,0,0,0,0,0,1,100,NoArch
47790146ab93f742eb987f751e40645dfd530b37,0,0,0,0,0,0,0,0,0,0,0,0,0,0,0,0,0,0,0,0,0,0,0,0,0,1,100,NoArch
c7241d5875a933a0b58cab0ceecb8962625040b7,2,15,27,12,0,0,0,2,17,1205,2,2,0.998363673,536,1,1,28,28,0,3731,3814,83,12,12,0,1,100,NoArch
b58df10f4c822ae989bb436734880940e9063fde,0,0,0,0,0,0,0,0,0,0,0,0,0,0,2,2,0,0,0,0,0,0,0,0,0,1,100,NoArch
9f4abbd96bc03ec5b76ed6a67a661904051cea50,0,0,0,0,0,0,0,0,0,0,0,0,0,0,3,3,0,0,0,0,0,0,0,0,0,1,100,NoArch
f5f54a1560c708913c30d460bec361eb71ab0bd7,15,22,23,1,0,0,0,2,6,576,1,2,3.797082818,1602,4,4,138,138,0,6993,7004,11,37,37,0,1,100,NoArch
eeca175c3a838a8aaa821cbbcd8d0376bd17939d,1,27,19,8,0,0,0,4,5,906,1,1,0,180,8,4,15,13,2,994,932,62,5,5,0,0,100,NoArch
4de8c58624556983a6745a8841c50fb2a380e0b5,1,0,1,1,0,0,0,4,6,0,1,1,0,188,9,5,15,15,0,994,994,0,5,5,0,0,100,NoArch
af0db6ed86dc50ac428d3b60b828f585aed7ca9c,0,0,0,0,0,0,0,0,0,0,0,0,0,0,6,0,0,0,0,0,0,0,0,0,0,0,100,NoArch
cc361cb7b6588601b63ce23b5e6a984d997e8453,0,0,0,0,0,0,0,0,0,0,0,0,0,0,10,6,0,0,0,0,0,0,0,0,0,0,100,NoArch
6cf991c60ac73dbd32b26d8ea0b773ac07d16193,0,0,0,0,0,0,0,0,0,0,0,0,0,0,5,5,0,0,0,0,0,0,0,0,0,1,100,NoArch
205896fde04baa774f77703c5867f09b20895e6b,0,0,0,0,0,0,0,0,0,0,0,0,0,0,6,6,0,0,0,0,0,0,0,0,0,1,100,NoArch
089275713f5f49499d939569fd9929f2f50ce1f3,0,0,0,0,0,0,0,0,0,0,0,0,0,0,7,7,0,0,0,0,0,0,0,0,0,1,100,NoArch
e5dca85992d32133c54f2f9dca668abce2eb923f,0,0,0,0,0,0,0,0,0,0,0,0,0,0,15,0,0,0,0,0,0,0,0,0,0,0,100,NoArch
4b1c133325da0119e693b69811a54a16cd77aa55,3,49,98,49,0,0,0,2,29,1320,2,2,1.258776696,751,11,7,47,49,2,4467,4867,400,26,26,0,1,99.93147869,NoArch
1f17d23f6095e67a2f8d188f4817e286cf916e98,2,66,12,54,0,0,0,2,5,153,1,2,0.73206669,305,7,1,30,25,5,2086,1727,359,11,9,2,0,98.92887746,NoArch
91c1626df337900051ead7019f70bd15fe93f6a7,0,0,0,0,0,0,0,0,0,0,0,0,0,0,8,2,0,0,0,0,0,0,0,0,0,0,100,NoArch
d5d8de1857d60b7b53b9baf0af6e7aea26bbde19,0,0,0,0,0,0,0,0,0,0,0,0,0,0,16,1,0,0,0,0,0,0,0,0,0,1,100,NoArch
edec611f07d4e7a352a3332af271207652caab02,0,0,0,0,0,0,0,0,0,0,0,0,0,0,17,2,0,0,0,0,0,0,0,0,0,1,100,NoArch
5624a96c6da94ad1c95077dbbdab71409d85770c,2,5,11,6,0,0,0,2,3,526,1,2,1,331,12,8,19,19,0,1721,1759,38,7,7,0,1,100,NoArch
57429b176a94514acce5f6985a1299fccb8d115f,1,1,1,0,0,0,0,2,2,1036,1,1,0,67,13,9,3,3,0,180,180,0,3,3,0,1,100,NoArch
c0f44b79ff735d8e9e95af46bbd6afcdb97cfe65,3,12,6,6,0,0,0,2,2,339,1,3,1.392147224,392,9,3,22,22,0,1939,1901,38,10,10,0,1,100,NoArch
312c714329135573bf83db00db58d8c8b84133e1,3,6,12,6,0,0,0,2,3,695,1,3,1.392147224,398,10,4,22,22,0,1901,1939,38,10,10,0,1,100,NoArch
0853c069f87e7e93a74edd79487c51b945187c73,0,0,0,0,0,0,0,0,0,0,0,0,0,0,11,5,0,0,0,0,0,0,0,0,0,1,100,NoArch
b988c493b562ceeaa5f82027f108c67d06c1fc19,771,62,62,0,0,0,0,1,31,0,4,162,2.982677092,106733,28,0,10283,10231,52,531081,527837,3244,5023,5000,23,1,51.90327613,Arch
34800682e119975183b3f24c20366acf692d128d,0,0,0,0,0,0,0,0,0,0,0,0,0,0,29,1,0,0,0,0,0,0,0,0,0,1,100,NoArch
3eb9fdf923e60c9df4a87b7f691d9a468692beb8,0,0,0,0,0,0,0,0,0,0,0,0,0,0,18,3,0,0,0,0,0,0,0,0,0,0,100,NoArch
441460e77cd38acc684cb2351dad5f0e6156c1f0,0,0,0,0,0,0,0,0,0,0,0,0,0,0,19,4,0,0,0,0,0,0,0,0,0,1,100,NoArch
adb0955f549dfa8f427ddb8273dd2f9d1f23a6c2,0,0,0,0,0,0,0,0,0,0,0,0,0,0,8,8,0,0,0,0,0,0,0,0,0,1,100,NoArch
6604f1d9f636bf331ac70077be557e75d3b035d9,0,0,0,0,0,0,0,0,0,0,0,0,0,0,9,9,0,0,0,0,0,0,0,0,0,1,100,NoArch
a4f24dda8f30745e1989da7f0e1cb6baaf82cc80,2,3,3,0,0,0,0,2,16,0,2,2,0.918295834,913,10,10,128,128,0,4366,4362,4,46,46,0,1,100,NoArch
5e07c8646f46ce55400094c3ab817a87fbf3d5b5,0,0,0,0,0,0,0,0,0,0,0,0,0,0,11,11,0,0,0,0,0,0,0,0,0,1,100,NoArch
260753fdb9cc2b17a3e4dbf373e79c3de4887654,0,0,0,0,0,0,0,0,0,0,0,0,0,0,20,5,0,0,0,0,0,0,0,0,0,0,100,NoArch
5197ac9e8393763dd4ed58f5f1e9f167e75d3078,2,37,2,35,0,0,0,2,7,326,1,1,0.291818257,661,21,6,82,76,6,3472,3201,271,18,16,2,2,100,NoArch
16aeaba993556767c95a4cd59540f1d3b6992772,4,4,0,4,0,0,0,2,33,504,2,2,2,951,22,7,93,93,0,4887,4879,8,49,49,0,1,100,NoArch
3aefb18d73e2df241f38a06d69b001f1669c1d8e,0,0,0,0,0,0,0,0,0,0,0,0,0,0,12,6,0,0,0,0,0,0,0,0,0,1,100,NoArch
6874995394596eb192c37a066dd750d87e602c0a,0,0,0,0,0,0,0,0,0,0,0,0,0,0,13,7,0,0,0,0,0,0,0,0,0,0,100,NoArch
896a6ed07b3be65c8a59bfa7a2dff11bbdd2f909,0,0,0,0,0,0,0,0,0,0,0,0,0,0,23,8,0,0,0,0,0,0,0,0,0,0,100,NoArch
2b5584bbcfa95094421b637786e1885a716f07f6,0,0,0,0,0,0,0,0,0,0,0,0,0,0,24,9,0,0,0,0,0,0,0,0,0,0,100,NoArch
736721e0eb655c0af8c836475a6f7cc9c36a80fe,0,0,0,0,0,0,0,0,0,0,0,0,0,0,25,10,0,0,0,0,0,0,0,0,0,0,100,NoArch
d1583664215742083099465c51e877fcb8369e46,0,0,0,0,0,0,0,0,0,0,0,0,0,0,14,10,0,0,0,0,0,0,0,0,0,0,100,NoArch
1748916497e805f7fce21b9aee70e31760b50a27,0,0,0,0,0,0,0,0,0,0,0,0,0,0,15,11,0,0,0,0,0,0,0,0,0,1,100,NoArch
94f5464b3f42be3164061030d352ffcfc78be711,1,1,2,1,0,0,0,4,10,1149,1,1,0,94,16,12,9,9,0,223,231,8,9,9,0,1,100,NoArch
2ff34a0ed3a1d35d5fdeef6cdc1f576931104b8a,1,1,1,0,0,0,0,2,2,7,1,1,0,97,17,13,9,9,0,445,451,6,4,4,0,1,100,NoArch
d19ee0d47a2ba44a7ff0f60998e0e0c42c4224a6,0,0,0,0,0,0,0,0,0,0,0,0,0,0,18,14,0,0,0,0,0,0,0,0,0,1,100,NoArch
eb77ce6e6dd546d9389fd105e47c4883bd943879,0,0,0,0,0,0,0,0,0,0,0,0,0,0,19,15,0,0,0,0,0,0,0,0,0,1,100,NoArch
1bcda32146713144eac4889c3065c448417c36f6,0,0,0,0,0,0,0,0,0,0,0,0,0,0,26,11,0,0,0,0,0,0,0,0,0,1,100,NoArch
88520fb1b54953967f4d7e299cfd772f4357c768,2,9,18,9,0,0,0,2,2,8,1,2,0.605186577,321,27,12,15,17,2,2006,2110,104,7,7,0,1,100,NoArch
4ef9d31ff253aeed9795379d440f8f1439651acc,38,357,456,99,0,0,0,2,35,1329,3,18,4.738277655,6729,20,16,660,661,1,37850,38471,621,231,231,0,1,100,NoArch
3a476e44f73f02ec986bee373c7632c109f2bc69,0,0,0,0,0,0,0,0,0,0,0,0,0,0,21,17,0,0,0,0,0,0,0,0,0,0,100,NoArch
d8e0568e7ff45e5fcbccf4a5aaa2df6059c4aade,1,47,47,0,0,0,0,2,2,11,1,1,0,211,22,18,12,12,0,1156,1083,73,6,6,0,1,100,NoArch
cd366d17e1d9b4c001b0ffa08864e1ad5d21034d,2,32,16,16,0,0,0,2,2,10,1,2,0.69621226,310,23,19,29,28,1,1955,1795,160,12,11,1,1,100,NoArch
9b6b2361ec0a4eacfb3700d123e02ccb6291f796,2,16,14,2,0,0,0,2,3,0,1,2,0.468995594,326,24,20,29,29,0,1983,1955,28,12,12,0,1,100,NoArch
1be5a00c809fe0c7d26fcad24536428b5f0b564e,0,0,0,0,0,0,0,0,0,0,0,0,0,0,28,13,0,0,0,0,0,0,0,0,0,1,100,NoArch
355418e32e737fe66b18e81759461cceaff5392c,0,0,0,0,0,0,0,0,0,0,0,0,0,0,25,21,0,0,0,0,0,0,0,0,0,0,100,NoArch
53e5adac2f24da4ff9f3276c73e89c2b14e03916,7,23,6,17,0,0,0,2,6,346,2,2,2.685783807,1762,29,14,143,143,0,8122,8108,14,64,64,0,1,100,NoArch
85f9ece660407fe68ad61560ebd723a57ec761e6,172,1055,1487,432,0,0,0,2,38,579,3,75,6.828759562,38310,26,22,4219,4222,3,207095,209038,1943,1717,1717,0,1,100,NoArch
8a1978a753192a82f602f3d791ed9946cc7bcf08,1,1,1,0,0,0,0,4,11,5,1,1,0,93,27,23,9,9,0,223,223,0,9,9,0,1,100,NoArch
30fe6cc83f83578c922d8c01742ae7a6939280e8,0,0,0,0,0,0,0,0,0,0,0,0,0,0,30,15,0,0,0,0,0,0,0,0,0,1,100,NoArch
ebb39fe4ae917188b7a1ac235fd8d04e30c92cba,0,0,0,0,0,0,0,0,0,0,0,0,0,0,31,16,0,0,0,0,0,0,0,0,0,1,100,NoArch
97a920f72c6655a615522272b752e6d0cbc1d429,0,0,0,0,0,0,0,0,0,0,0,0,0,0,30,2,0,0,0,0,0,0,0,0,0,0,100,NoArch
d67a1d034fca4b70299c4bbc1ed77e38c7d00841,0,0,0,0,0,0,0,0,0,0,0,0,0,0,32,17,0,0,0,0,0,0,0,0,0,0,100,NoArch
4cff54295d9e494eaff46a190b73bcb8d491f7e5,25,102,483,381,0,1,1,2,16,97,3,11,2.614192164,3717,28,24,316,370,54,16364,18101,1737,151,182,31,1,99.93452284,NoArch
44a9849c075f42f5d1029d604a64a72b7415a0b4,0,0,0,0,0,0,0,0,0,0,0,0,0,0,31,3,0,0,0,0,0,0,0,0,0,0,100,NoArch
c70d708f2c11ff9fd5974d0c124a9f56790df428,0,0,0,0,0,0,0,0,0,0,0,0,0,0,14,8,0,0,0,0,0,0,0,0,0,0,100,NoArch
db624ef35c8174e9bd5a9f63f9e2957e8bd594b8,25,482,101,381,1,0,1,3,17,0,3,11,2.605033292,3336,15,9,370,316,54,18101,16364,1737,182,151,31,1,99.93452284,NoArch
a551b15e2b88b32e12860f8c01e59a8999700d14,0,0,0,0,0,0,0,0,0,0,0,0,0,0,15,9,0,0,0,0,0,0,0,0,0,1,100,NoArch
92bdcf8e0f74cf8e4da858156602e658bfbe0c70,0,0,0,0,0,0,0,0,0,0,0,0,0,0,17,11,0,0,0,0,0,0,0,0,0,0,100,NoArch
670a7d219e4eab8c7735083d52cefa13e81197fb,21,63,446,383,0,1,1,3,18,92,3,13,2.02586362,3497,29,25,327,381,54,18955,20631,1676,128,159,31,1,99.93452284,NoArch
f63ee5fdde0f35ecd5a851c9122f5195befc9348,0,0,0,0,0,0,0,0,0,0,0,0,0,0,18,12,0,0,0,0,0,0,0,0,0,0,100,NoArch
33263f68c8157a63734f445669f34c326edec2d3,0,0,0,0,0,0,0,0,0,0,0,0,0,0,30,26,0,0,0,0,0,0,0,0,0,0,100,NoArch
2b6c17fa0b067299eccc1365512465edcbf5f155,0,0,0,0,0,0,0,0,0,0,0,0,0,0,31,27,0,0,0,0,0,0,0,0,0,0,100,NoArch
c203c97b498a0add45ed0f213e76dddb20e33652,0,0,0,0,0,0,0,0,0,0,0,0,0,0,32,28,0,0,0,0,0,0,0,0,0,0,100,NoArch
f66ce94a9f809f910eae65347a7d25f6e6fd4241,0,0,0,0,0,0,0,0,0,0,0,0,0,0,32,4,0,0,0,0,0,0,0,0,0,0,100,NoArch
5e41bc096444fb4d04a88e47200e4d50c406621d,0,0,0,0,0,0,0,0,0,0,0,0,0,0,33,29,0,0,0,0,0,0,0,0,0,0,100,NoArch
27ff9df077fd498edcb5e92946be0d5041f755dd,0,0,0,0,0,0,0,0,0,0,0,0,0,0,19,13,0,0,0,0,0,0,0,0,0,0,100,NoArch
daad3a4ce618cbd05be468c4ce6e451618f3a028,0,0,0,0,0,0,0,0,0,0,0,0,0,0,20,14,0,0,0,0,0,0,0,0,0,1,100,NoArch
37b82124faf98dda5ef9f350f64477570a3bc804,0,0,0,0,0,0,0,0,0,0,0,0,0,0,21,15,0,0,0,0,0,0,0,0,0,0,100,NoArch
be5a05d126e5bf275c4bd1766962493f1c8ac342,1,10,0,10,0,0,0,6,19,6,1,1,0,173,34,27,37,35,2,991,911,80,15,14,1,1,100,NoArch
628b1302f273accf53b2d91e6f7ac90e20c4102f,0,0,0,0,0,0,0,0,0,0,0,0,0,0,35,27,0,0,0,0,0,0,0,0,0,1,100,NoArch
c58d65d78ff349968fe9b8d8e758659fcfc001c5,0,0,0,0,0,0,0,0,0,0,0,0,0,0,33,18,0,0,0,0,0,0,0,0,0,0,100,NoArch
77ed7bb54982d2a81e085c0689a95d4902b03960,0,0,0,0,0,0,0,0,0,0,0,0,0,0,34,19,0,0,0,0,0,0,0,0,0,0,100,NoArch
b5c63caf99934b1a602e64e0906a2c97b033b025,0,0,0,0,0,0,0,0,0,0,0,0,0,0,22,16,0,0,0,0,0,0,0,0,0,0,100,NoArch
864ba1aea23ece6491acff38adab0cd1b0d29354,21,446,63,383,1,0,1,3,19,0,3,13,2.02586362,3114,23,17,381,327,54,20631,18955,1676,159,128,31,1,99.93452284,NoArch
4325123cc97770e242e10061478834bf5474ccf8,0,0,0,0,0,0,0,0,0,0,0,0,0,0,35,20,0,0,0,0,0,0,0,0,0,0,100,NoArch
3ecf5f825ca0255cdedaf085326c602e3b404b5e,0,0,0,0,0,0,0,0,0,0,0,0,0,0,36,21,0,0,0,0,0,0,0,0,0,0,100,NoArch
c7867d52248ffe0fc4aac073dbb03dbc214d0fae,0,0,0,0,0,0,0,0,0,0,0,0,0,0,36,28,0,0,0,0,0,0,0,0,0,0,100,NoArch
f7921f4fb50030f2a84913b080e335a2d7eb30a5,0,0,0,0,0,0,0,0,0,0,0,0,0,0,33,5,0,0,0,0,0,0,0,0,0,0,100,NoArch
ac021efa45e4706ceb309f6cb578c1d6910daea2,0,0,0,0,0,0,0,0,0,0,0,0,0,0,12,7,0,0,0,0,0,0,0,0,0,1,100,NoArch
cb9be1dae4352c2cfacf9b4732e8065c062a9230,0,0,0,0,0,0,0,0,0,0,0,0,0,0,37,29,0,0,0,0,0,0,0,0,0,0,100,NoArch
f208b8a4a899fbf5ca8646cddf8960f8d5ee3c88,0,0,0,0,0,0,0,0,0,0,0,0,0,0,38,30,0,0,0,0,0,0,0,0,0,0,100,NoArch
94cb88cad4ef7f0d06895ed8e85db3fcaf1c8656,0,0,0,0,0,0,0,0,0,0,0,0,0,0,39,31,0,0,0,0,0,0,0,0,0,0,100,NoArch
50357a4f48a8307bd1b84858dda5765f70940b94,0,0,0,0,0,0,0,0,0,0,0,0,0,0,37,22,0,0,0,0,0,0,0,0,0,0,100,NoArch
8f46ac3e7d664219e8a3cf1e7a2cbf833aec7f47,0,0,0,0,0,0,0,0,0,0,0,0,0,0,40,32,0,0,0,0,0,0,0,0,0,0,100,NoArch
b7dc3a53af3250123f8ef82e3f259657991dfaa9,0,0,0,0,0,0,0,0,0,0,0,0,0,0,38,23,0,0,0,0,0,0,0,0,0,0,100,NoArch
fa758ce77db00b3518a680516fe07afb58a3979e,0,0,0,0,0,0,0,0,0,0,0,0,0,0,41,33,0,0,0,0,0,0,0,0,0,0,100,NoArch
dc6bf103f583bf8ab78f73aa5b6183042aa73022,0,0,0,0,0,0,0,0,0,0,0,0,0,0,42,34,0,0,0,0,0,0,0,0,0,0,100,NoArch
05fea2a13d0291917ed9605d563c899bc2ce04a9,0,0,0,0,0,0,0,0,0,0,0,0,0,0,43,35,0,0,0,0,0,0,0,0,0,0,100,NoArch
5fdd30c3cd448fe23affcf0466d5761f146573e0,0,0,0,0,0,0,0,0,0,0,0,0,0,0,44,36,0,0,0,0,0,0,0,0,0,0,100,NoArch
fb9a7c3d0ed9b4c348d2945766e8546f560eacdd,0,0,0,0,0,0,0,0,0,0,0,0,0,0,13,8,0,0,0,0,0,0,0,0,0,0,100,NoArch
fb30375e40062ff9b85357857d0e09dc38da25fc,0,0,0,0,0,0,0,0,0,0,0,0,0,0,14,9,0,0,0,0,0,0,0,0,0,0,100,NoArch
8439846c99c2c81dde6a03eb40105ea908555943,0,0,0,0,0,0,0,0,0,0,0,0,0,0,39,24,0,0,0,0,0,0,0,0,0,0,100,NoArch
832b08c40752b58a98e1a89891a1e0ff54094910,0,0,0,0,0,0,0,0,0,0,0,0,0,0,45,37,0,0,0,0,0,0,0,0,0,0,100,NoArch
724b9070cbde160d237f58a5a178125f00dcfc84,0,0,0,0,0,0,0,0,0,0,0,0,0,0,0,0,0,0,0,0,0,0,0,0,0,0,100,NoArch
54ef150e8f31ce2292ea02902674d86c9c35ffd7,0,0,0,0,0,0,0,0,0,0,0,0,0,0,1,1,0,0,0,0,0,0,0,0,0,0,100,NoArch
98be68ac7fde5d22b502a8cab98069e13f363abb,0,0,0,0,0,0,0,0,0,0,0,0,0,0,0,0,0,0,0,0,0,0,0,0,0,1,100,NoArch
eae79da4c2642a195a63462f8781e56600c1295e,0,0,0,0,0,0,0,0,0,0,0,0,0,0,18,0,0,0,0,0,0,0,0,0,0,1,100,NoArch
4d059f85f7341130193a74d18a951fe3110f884b,0,0,0,0,0,0,0,0,0,0,0,0,0,0,19,1,0,0,0,0,0,0,0,0,0,1,100,NoArch
db5a1d5ce5a6e4a3999cf2b943e29e9b64bbed5d,0,0,0,0,0,0,0,0,0,0,0,0,0,0,52,0,0,0,0,0,0,0,0,0,0,0,100,NoArch
f2f8cba4279b86b3a902fcac27e6f5db1d1e49ba,0,0,0,0,0,0,0,0,0,0,0,0,0,0,114,13,0,0,0,0,0,0,0,0,0,0,100,NoArch
a5c7cec9fbe24112c71cef5bc428b342a4a78ac3,0,0,0,0,0,0,0,0,0,0,0,0,0,0,115,14,0,0,0,0,0,0,0,0,0,1,100,NoArch
e16bcc3d152eb6cf9f512f75bbf5e009b00fe992,0,0,0,0,0,0,0,0,0,0,0,0,0,0,116,15,0,0,0,0,0,0,0,0,0,1,100,NoArch
c397ef7f7b104a56980d928466022ad2b59ac297,0,0,0,0,0,0,0,0,0,0,0,0,0,0,115,14,0,0,0,0,0,0,0,0,0,0,100,NoArch
2a8139dcfb3ad523aeaced225c162ceabde7dcff,0,0,0,0,0,0,0,0,0,0,0,0,0,0,118,17,0,0,0,0,0,0,0,0,0,0,100,NoArch
08e02602e947ff945b9bd73ab5f0b45863df3e53,0,0,0,0,0,0,0,0,0,0,0,0,0,0,20,2,0,0,0,0,0,0,0,0,0,1,100,NoArch
a60c79e7a2f32aa3e3c78d184e4219360f24869e,0,0,0,0,0,0,0,0,0,0,0,0,0,0,20,2,0,0,0,0,0,0,0,0,0,0,100,NoArch
bcdad32ac3d250d7c42195d9bfa5e48fcbd4fe1f,0,0,0,0,0,0,0,0,0,0,0,0,0,0,21,3,0,0,0,0,0,0,0,0,0,0,100,NoArch
4c05501b6c10074149b93500beae9fa5f0d421ca,0,0,0,0,0,0,0,0,0,0,0,0,0,0,22,4,0,0,0,0,0,0,0,0,0,0,100,NoArch
64108c94d9918f031bb17b78403db3866eaf5dc6,0,0,0,0,0,0,0,0,0,0,0,0,0,0,23,5,0,0,0,0,0,0,0,0,0,0,100,NoArch
8f879548a3e310b960b6b555bd8def40cf60130f,0,0,0,0,0,0,0,0,0,0,0,0,0,0,22,4,0,0,0,0,0,0,0,0,0,0,100,NoArch
660036ebba42b739162ec4456ca4da4cea64af2a,0,0,0,0,0,0,0,0,0,0,0,0,0,0,24,6,0,0,0,0,0,0,0,0,0,0,100,NoArch
cd830b69bbc31addbf2375d92fcd70ce09c6543e,0,0,0,0,0,0,0,0,0,0,0,0,0,0,25,7,0,0,0,0,0,0,0,0,0,0,100,NoArch
0b2d3a15f0adfd5b847dce8e6e33c82797a1f906,0,0,0,0,0,0,0,0,0,0,0,0,0,0,26,8,0,0,0,0,0,0,0,0,0,0,100,NoArch
a98bd9db539416484c89cf49d7433179d5bc9a43,0,0,0,0,0,0,0,0,0,0,0,0,0,0,27,9,0,0,0,0,0,0,0,0,0,0,100,NoArch
c89e3126c4d85fcdfcdee657b87fd48b6671ba38,0,0,0,0,0,0,0,0,0,0,0,0,0,0,28,10,0,0,0,0,0,0,0,0,0,0,100,NoArch
3958af3df16fd7d8546a8d7eaba2e3c692644f70,0,0,0,0,0,0,0,0,0,0,0,0,0,0,30,12,0,0,0,0,0,0,0,0,0,0,100,NoArch
00ef278cd05d11120faf6305b773564b9b0ef671,0,0,0,0,0,0,0,0,0,0,0,0,0,0,23,5,0,0,0,0,0,0,0,0,0,0,100,NoArch
7fcf655aa45d49a549a537f4449d2431883ce5b6,0,0,0,0,0,0,0,0,0,0,0,0,0,0,0,0,0,0,0,0,0,0,0,0,0,0,100,NoArch
506212ba1b991b8681b35b73abe89537643158c4,0,0,0,0,0,0,0,0,0,0,0,0,0,0,1,1,0,0,0,0,0,0,0,0,0,0,100,NoArch
e2549b78cd17ecdaeaec5ca67bad2474a7cb2d60,0,0,0,0,0,0,0,0,0,0,0,0,0,0,2,2,0,0,0,0,0,0,0,0,0,0,100,NoArch
ae8e3bbe62acb5473ea59e78e15982ad465b9334,0,0,0,0,0,0,0,0,0,0,0,0,0,0,21,3,0,0,0,0,0,0,0,0,0,1,100,NoArch
a04a32fd12430d3460690ef057e98ecf628bc198,0,0,0,0,0,0,0,0,0,0,0,0,0,0,32,14,0,0,0,0,0,0,0,0,0,0,100,NoArch
ac56b5512356ed4a2c590808ee0f68bb512afa10,0,0,0,0,0,0,0,0,0,0,0,0,0,0,33,15,0,0,0,0,0,0,0,0,0,0,100,NoArch
0e718ec99681319487c2b7eade17bb58beb1ff3d,0,0,0,0,0,0,0,0,0,0,0,0,0,0,34,16,0,0,0,0,0,0,0,0,0,0,100,NoArch
3a724debcff6c26765a77300d79b28b32b7e3398,0,0,0,0,0,0,0,0,0,0,0,0,0,0,3,3,0,0,0,0,0,0,0,0,0,0,100,NoArch
9c0314528b4fec247ec92654bfcc1471a880e578,0,0,0,0,0,0,0,0,0,0,0,0,0,0,4,4,0,0,0,0,0,0,0,0,0,0,100,NoArch
c81fc8b72b2fa36469b839423fddab13feba869d,0,0,0,0,0,0,0,0,0,0,0,0,0,0,5,5,0,0,0,0,0,0,0,0,0,0,100,NoArch
9759e024ee93bbcbef142ab15b92e71207096798,0,0,0,0,0,0,0,0,0,0,0,0,0,0,6,6,0,0,0,0,0,0,0,0,0,0,100,NoArch
2346425bdb4c11133bda8759f106c7637007d702,0,0,0,0,0,0,0,0,0,0,0,0,0,0,7,7,0,0,0,0,0,0,0,0,0,0,100,NoArch
747d94b1da72c7e3b909087b8f04e03d760df346,0,0,0,0,0,0,0,0,0,0,0,0,0,0,8,8,0,0,0,0,0,0,0,0,0,0,100,NoArch
b582dc5291512ace348540491db8671d7d41c0a2,0,0,0,0,0,0,0,0,0,0,0,0,0,0,35,17,0,0,0,0,0,0,0,0,0,0,100,NoArch
516e3fb9ab340a2e641770e32d6511c8c7b365b6,0,0,0,0,0,0,0,0,0,0,0,0,0,0,36,18,0,0,0,0,0,0,0,0,0,0,100,NoArch
c8bdf2efc66d9dbba07d0c50d8369fb721581149,0,0,0,0,0,0,0,0,0,0,0,0,0,0,37,19,0,0,0,0,0,0,0,0,0,0,100,NoArch
0b38f5167297b3654f1f5fa5e79ce6e8d086ae53,0,0,0,0,0,0,0,0,0,0,0,0,0,0,38,20,0,0,0,0,0,0,0,0,0,0,100,NoArch
6f135ee6deeb8f70f33bde17c2353dd2db9dedb1,0,0,0,0,0,0,0,0,0,0,0,0,0,0,39,21,0,0,0,0,0,0,0,0,0,0,100,NoArch
bd360a2b34432f01cfa53bb7854c5f49854b73ca,0,0,0,0,0,0,0,0,0,0,0,0,0,0,40,22,0,0,0,0,0,0,0,0,0,0,100,NoArch
38cc9e2706e07612cac9b400aac19001253e2fee,0,0,0,0,0,0,0,0,0,0,0,0,0,0,22,4,0,0,0,0,0,0,0,0,0,1,100,NoArch
a84294211d9f426e7bc8709f6f876ce23b21ba6d,0,0,0,0,0,0,0,0,0,0,0,0,0,0,41,23,0,0,0,0,0,0,0,0,0,0,100,NoArch
6e5359d59ac02f9df18176ce465de6afe7b2078f,0,0,0,0,0,0,0,0,0,0,0,0,0,0,42,24,0,0,0,0,0,0,0,0,0,0,100,NoArch
fc433408f4f2c9b6065598fa27fe7f9e1a3533a0,0,0,0,0,0,0,0,0,0,0,0,0,0,0,43,25,0,0,0,0,0,0,0,0,0,0,100,NoArch
c4feca039d93cfa10c074d732511ec3dfa86b69e,0,0,0,0,0,0,0,0,0,0,0,0,0,0,44,26,0,0,0,0,0,0,0,0,0,0,100,NoArch
3c53a6dcfb0cc8e25d7da4b62e8ed056a7629b98,0,0,0,0,0,0,0,0,0,0,0,0,0,0,45,27,0,0,0,0,0,0,0,0,0,0,100,NoArch
f463a5c4cc832932663afe5331cc5ad379abc599,0,0,0,0,0,0,0,0,0,0,0,0,0,0,46,28,0,0,0,0,0,0,0,0,0,0,100,NoArch
9c69c28af0494875d7e9417b82a11b79a063c146,0,0,0,0,0,0,0,0,0,0,0,0,0,0,48,30,0,0,0,0,0,0,0,0,0,0,100,NoArch
a8a719efaedd453059241b15fbbd99a9e9ceb4c8,0,0,0,0,0,0,0,0,0,0,0,0,0,0,119,6,0,0,0,0,0,0,0,0,0,0,100,NoArch
a2b60567ac55f38f942f9fabd3981c1f8b784723,0,0,0,0,0,0,0,0,0,0,0,0,0,0,120,7,0,0,0,0,0,0,0,0,0,0,100,NoArch
f71020f41107fd4ac621c9814313e5e2cd0b014b,0,0,0,0,0,0,0,0,0,0,0,0,0,0,51,28,0,0,0,0,0,0,0,0,0,1,100,NoArch
d5072a082bf702d5a6f275dd058f7fefa5cb2a5d,0,0,0,0,0,0,0,0,0,0,0,0,0,0,52,29,0,0,0,0,0,0,0,0,0,1,100,NoArch
be2ad1c75b756ca7a797596ab70356308360a509,0,0,0,0,0,0,0,0,0,0,0,0,0,0,53,30,0,0,0,0,0,0,0,0,0,0,100,NoArch
b45178e2832cc30bace75ec29be8dfaa943444c2,0,0,0,0,0,0,0,0,0,0,0,0,0,0,54,31,0,0,0,0,0,0,0,0,0,0,100,NoArch
534c2f8d9a5788db0d671d9623109791dcd579c8,0,0,0,0,0,0,0,0,0,0,0,0,0,0,55,18,0,0,0,0,0,0,0,0,0,0,100,NoArch
7c0babd79bf352c98d46a4d7dab38d11ef9b6669,0,0,0,0,0,0,0,0,0,0,0,0,0,0,56,19,0,0,0,0,0,0,0,0,0,0,100,NoArch
cf5a33d565f6602f6624bc4d34c62c048379140f,0,0,0,0,0,0,0,0,0,0,0,0,0,0,2,0,0,0,0,0,0,0,0,0,0,1,100,NoArch
2f2ca3c987745c51fcaa10d056dbd9d6503a9fd6,0,0,0,0,0,0,0,0,0,0,0,0,0,0,57,6,0,0,0,0,0,0,0,0,0,0,100,NoArch
9b4eabb9cfc27eb4f8d062b33114e32a590dc791,0,0,0,0,0,0,0,0,0,0,0,0,0,0,58,7,0,0,0,0,0,0,0,0,0,0,100,NoArch
c29496cb11372baddbb76acdee51530347525645,0,0,0,0,0,0,0,0,0,0,0,0,0,0,59,8,0,0,0,0,0,0,0,0,0,1,100,NoArch
31833fa6827729155934be77bdde7c546ebd47f3,0,0,0,0,0,0,0,0,0,0,0,0,0,0,0,0,0,0,0,0,0,0,0,0,0,0,100,NoArch
e74c478d223c9f2ec90478dd2236c1b886bc5050,0,0,0,0,0,0,0,0,0,0,0,0,0,0,0,0,0,0,0,0,0,0,0,0,0,1,100,NoArch
c17bee3c2705495b638d81ae2ad374bf7494c3f3,0,0,0,0,0,0,0,0,0,0,0,0,0,0,60,0,0,0,0,0,0,0,0,0,0,1,100,NoArch
48d6ca51738f9560aced6e15e1201025243a0d90,0,0,0,0,0,0,0,0,0,0,0,0,0,0,1,0,0,0,0,0,0,0,0,0,0,1,100,NoArch
a799ead59aa77cab0596f72bbe40872b59367e35,0,0,0,0,0,0,0,0,0,0,0,0,0,0,0,0,0,0,0,0,0,0,0,0,0,1,100,NoArch
36c15d8a633f6836b35578e9915c96f4ca71ac55,0,0,0,0,0,0,0,0,0,0,0,0,0,0,145,0,0,0,0,0,0,0,0,0,0,1,100,NoArch
fed8c472084b976965b59cdc3129d20e7fde7735,0,0,0,0,0,0,0,0,0,0,0,0,0,0,61,1,0,0,0,0,0,0,0,0,0,0,100,NoArch
5a3b4f509cfca5ab7ce5fe85a4fd006e89e460c8,0,0,0,0,0,0,0,0,0,0,0,0,0,0,0,0,0,0,0,0,0,0,0,0,0,0,100,NoArch
b41e140cc01a58a233eb91e632ed5e1780607406,0,0,0,0,0,0,0,0,0,0,0,0,0,0,62,2,0,0,0,0,0,0,0,0,0,1,100,NoArch
182ef0229842054ba1bbad4352791d493546ade1,0,0,0,0,0,0,0,0,0,0,0,0,0,0,63,3,0,0,0,0,0,0,0,0,0,0,100,NoArch
2be27b3784412beb907374026cd5e5c787a55eec,0,0,0,0,0,0,0,0,0,0,0,0,0,0,121,0,0,0,0,0,0,0,0,0,0,0,100,NoArch
6081793d063381c3e6c7ef121ee66660ec789ce6,0,0,0,0,0,0,0,0,0,0,0,0,0,0,64,4,0,0,0,0,0,0,0,0,0,0,100,NoArch
3f8d181ca519982c95e7d2f83f8d0701748406f2,0,0,0,0,0,0,0,0,0,0,0,0,0,0,65,5,0,0,0,0,0,0,0,0,0,0,100,NoArch
d3fb367b31cfe7932e2c1c5607838158b8df0e73,0,0,0,0,0,0,0,0,0,0,0,0,0,0,66,6,0,0,0,0,0,0,0,0,0,0,100,NoArch
f04fa9afe83ce9e147909c9956b62f05f6257aba,0,0,0,0,0,0,0,0,0,0,0,0,0,0,67,7,0,0,0,0,0,0,0,0,0,0,100,NoArch
d264c1b6a3dd5451ff002f86bd241098a4b6f5f6,0,0,0,0,0,0,0,0,0,0,0,0,0,0,68,8,0,0,0,0,0,0,0,0,0,0,100,NoArch
c806504cd9b85705659a27c12116b9ef04a22dad,0,0,0,0,0,0,0,0,0,0,0,0,0,0,69,9,0,0,0,0,0,0,0,0,0,0,100,NoArch
ef5820f22f6a3e7acfdcde278bc28e8c8f0c41d1,0,0,0,0,0,0,0,0,0,0,0,0,0,0,70,10,0,0,0,0,0,0,0,0,0,0,100,NoArch
74766e309cb371059ce73fe2f7a585d6757662a4,0,0,0,0,0,0,0,0,0,0,0,0,0,0,64,3,0,0,0,0,0,0,0,0,0,1,100,NoArch
d043db4035f641b92be392bdb09320e896a93c0a,0,0,0,0,0,0,0,0,0,0,0,0,0,0,0,0,0,0,0,0,0,0,0,0,0,0,100,NoArch
9595d30ad1db5d77920d887c8676082c1375bce5,0,0,0,0,0,0,0,0,0,0,0,0,0,0,1,1,0,0,0,0,0,0,0,0,0,0,100,NoArch
8c14b309cb4319cb304b68328bc646a3ec48f55d,0,0,0,0,0,0,0,0,0,0,0,0,0,0,65,1,0,0,0,0,0,0,0,0,0,1,100,NoArch
47a9362255fed1e1f8a21c1bf93549b308987d52,0,0,0,0,0,0,0,0,0,0,0,0,0,0,73,2,0,0,0,0,0,0,0,0,0,0,100,NoArch
4149843c13c8eb5c54deaad3fd77a22968c5f966,0,0,0,0,0,0,0,0,0,0,0,0,0,0,74,3,0,0,0,0,0,0,0,0,0,0,100,NoArch
e3530b24132b39ee7ada7d5ec9a9edf388984fb1,0,0,0,0,0,0,0,0,0,0,0,0,0,0,75,4,0,0,0,0,0,0,0,0,0,0,100,NoArch
72dfcee8c15594c7d3cc9daee13de0752451a48b,0,0,0,0,0,0,0,0,0,0,0,0,0,0,76,4,0,0,0,0,0,0,0,0,0,0,100,NoArch
9a4f9d36298259274dac94665eda7ce9e482cdbd,8,0,0,0,0,0,0,1,1,0,2,4,0,758,77,5,8,4,4,2678,1339,1339,8,4,4,0,99.61464355,NoArch
b3c6708bab882e2637a854b1a00ec21dbe268b2d,0,0,0,0,0,0,0,0,0,0,0,0,0,0,78,6,0,0,0,0,0,0,0,0,0,0,100,NoArch
9f83099af8c9e788da00cdb422f9e97ac8492961,0,0,0,0,0,0,0,0,0,0,0,0,0,0,79,7,0,0,0,0,0,0,0,0,0,0,100,NoArch
89484d8791bbeba6ccd42271de67d76541529100,0,0,0,0,0,0,0,0,0,0,0,0,0,0,80,8,0,0,0,0,0,0,0,0,0,0,100,NoArch
ecf642f7de1fd56435282e7db6734e6abe359d7b,0,0,0,0,0,0,0,0,0,0,0,0,0,0,81,9,0,0,0,0,0,0,0,0,0,0,100,NoArch
e2dde2272fe5956faaf1da2b34bc9119d7f33a5d,0,0,0,0,0,0,0,0,0,0,0,0,0,0,82,10,0,0,0,0,0,0,0,0,0,0,100,NoArch
50f605a0d5c484a5b0d4028fb09d15aba57a290a,0,0,0,0,0,0,0,0,0,0,0,0,0,0,83,11,0,0,0,0,0,0,0,0,0,0,100,NoArch
0f82e09527150753901ea0deeb2fcec8d45de781,0,0,0,0,0,0,0,0,0,0,0,0,0,0,84,12,0,0,0,0,0,0,0,0,0,0,100,NoArch
2670242f0d065bf2deb521f337d7a2d8b705b0b2,0,0,0,0,0,0,0,0,0,0,0,0,0,0,85,13,0,0,0,0,0,0,0,0,0,0,100,NoArch
cbdec6e059a07f2f33a3e67a5f3ce1febf963651,0,0,0,0,0,0,0,0,0,0,0,0,0,0,86,14,0,0,0,0,0,0,0,0,0,0,100,NoArch
aedb0243715058c5e32a7026b7350e221b3fc788,0,0,0,0,0,0,0,0,0,0,0,0,0,0,0,0,0,0,0,0,0,0,0,0,0,0,100,NoArch
d108041d92faa0327339e478305222022b858329,0,0,0,0,0,0,0,0,0,0,0,0,0,0,1,1,0,0,0,0,0,0,0,0,0,0,100,NoArch
e56378cf7191fefa56eab6c17266a956d01f709e,8,0,379,379,0,4,4,1,1,0,2,4,1.993830231,758,146,0,4,8,4,1339,2678,1339,4,8,4,0,99.61464355,NoArch
b99e71c32c9fece5acf4485e7f3073d50240336a,0,0,0,0,0,0,0,0,0,0,0,0,0,0,0,0,0,0,0,0,0,0,0,0,0,1,100,NoArch
be254cdf3d7d24826e52a0f3db66902e485fad43,0,0,0,0,0,0,0,0,0,0,0,0,0,0,1,1,0,0,0,0,0,0,0,0,0,0,100,NoArch
fe4cb1a0919eebd8262ad8f0ff142a53de9eba42,0,0,0,0,0,0,0,0,0,0,0,0,0,0,147,0,0,0,0,0,0,0,0,0,0,1,100,NoArch
d9b32f308804859b382e855d5a323a62ba7153e1,0,0,0,0,0,0,0,0,0,0,0,0,0,0,2,0,0,0,0,0,0,0,0,0,0,1,100,NoArch
800a9ed6d7e015aa82b9eb7624bb441b71a8f397,1,53,0,53,0,0,0,6,23,2639,1,1,0,236,44,0,58,49,9,1743,1394,349,18,17,1,1,100,NoArch
6188fa578acdfb275119a4f85ba128fc0506b4f8,0,0,0,0,0,0,0,0,0,0,0,0,0,0,0,0,0,0,0,0,0,0,0,0,0,1,100,NoArch
a128b768e62a229be845855ecee235240efec8f7,0,0,0,0,0,0,0,0,0,0,0,0,0,0,3,1,0,0,0,0,0,0,0,0,0,0,100,NoArch
1d198100aa02005e8e5e0319ca2a08113bf58468,0,0,0,0,0,0,0,0,0,0,0,0,0,0,4,2,0,0,0,0,0,0,0,0,0,0,100,NoArch
defbbd20f78c7b9e0bcc3a81d3d79d76be32cf23,0,0,0,0,0,0,0,0,0,0,0,0,0,0,5,3,0,0,0,0,0,0,0,0,0,0,100,NoArch
5f3133c337ca89893b0accb2e7edae9a4e756166,0,0,0,0,0,0,0,0,0,0,0,0,0,0,6,4,0,0,0,0,0,0,0,0,0,1,100,NoArch
54f01bce24a946b2f93f6606f6c970e62c3c57ee,0,0,0,0,0,0,0,0,0,0,0,0,0,0,7,5,0,0,0,0,0,0,0,0,0,0,100,NoArch
b213213a302caa91fc4b5a64247a4a1862244b38,0,0,0,0,0,0,0,0,0,0,0,0,0,0,8,6,0,0,0,0,0,0,0,0,0,0,100,NoArch
e591012439c04e98d669ef9732fde865a9ef76fa,0,0,0,0,0,0,0,0,0,0,0,0,0,0,9,7,0,0,0,0,0,0,0,0,0,0,100,NoArch
fe77fc19fc0c4d0c05c55a30a473acc71e30f1de,0,0,0,0,0,0,0,0,0,0,0,0,0,0,10,8,0,0,0,0,0,0,0,0,0,0,100,NoArch
d5014fc543343b08a0c876c2b76d09f86092e86c,0,0,0,0,0,0,0,0,0,0,0,0,0,0,11,9,0,0,0,0,0,0,0,0,0,0,100,NoArch
bb33d9a5a09a8b77c0853c41cd85228cecc40675,0,0,0,0,0,0,0,0,0,0,0,0,0,0,12,10,0,0,0,0,0,0,0,0,0,0,100,NoArch
2872a3082549731314e4426774978da86698aa3a,0,0,0,0,0,0,0,0,0,0,0,0,0,0,13,11,0,0,0,0,0,0,0,0,0,0,100,NoArch
f0a246a341cdf66e1ff727a469ed268c00b7ebfe,0,0,0,0,0,0,0,0,0,0,0,0,0,0,14,12,0,0,0,0,0,0,0,0,0,0,100,NoArch
2613883f2f6af05e69cdcc5945a456480747566e,0,0,0,0,0,0,0,0,0,0,0,0,0,0,15,13,0,0,0,0,0,0,0,0,0,0,100,NoArch
c80e00f894779b9c937eea280b3b7c39d07ed610,0,0,0,0,0,0,0,0,0,0,0,0,0,0,16,14,0,0,0,0,0,0,0,0,0,0,100,NoArch
52154565410a7ebb9f9cdfe13ad9f039c1f8abb7,0,0,0,0,0,0,0,0,0,0,0,0,0,0,17,15,0,0,0,0,0,0,0,0,0,0,100,NoArch
2483037dc65fd69a508759f241e62709ea780af3,0,0,0,0,0,0,0,0,0,0,0,0,0,0,18,16,0,0,0,0,0,0,0,0,0,0,100,NoArch
697eae12c513f15e97a18b8a4e143fdc53064b7f,0,0,0,0,0,0,0,0,0,0,0,0,0,0,19,17,0,0,0,0,0,0,0,0,0,0,100,NoArch
1e6584d78e8dc83c04fd1c29a8b01d7e63b6005d,0,0,0,0,0,0,0,0,0,0,0,0,0,0,20,18,0,0,0,0,0,0,0,0,0,0,100,NoArch
9fe4aadc731ffecf3996992b51b8044c880b0e94,0,0,0,0,0,0,0,0,0,0,0,0,0,0,21,19,0,0,0,0,0,0,0,0,0,0,100,NoArch
8a7bd9156880f3f12509c64cda62ac389cbb4f7d,0,0,0,0,0,0,0,0,0,0,0,0,0,0,22,20,0,0,0,0,0,0,0,0,0,0,100,NoArch
4f2108c576daaa3198671568eaa619266e787b1a,0,0,0,0,0,0,0,0,0,0,0,0,0,0,23,21,0,0,0,0,0,0,0,0,0,0,100,NoArch
ec5eb314fa4c9c30282c78ee1d1e033148674015,0,0,0,0,0,0,0,0,0,0,0,0,0,0,0,0,0,0,0,0,0,0,0,0,0,0,100,NoArch
9beddd3108ae453091a21a881c6693016f5f2012,0,0,0,0,0,0,0,0,0,0,0,0,0,0,24,21,0,0,0,0,0,0,0,0,0,1,100,NoArch
03918713563bf6aac55299d7239c4e042795faf0,0,0,0,0,0,0,0,0,0,0,0,0,0,0,25,22,0,0,0,0,0,0,0,0,0,1,100,NoArch
fc36bef157dc47d9572c4cfd460067e1916910a0,0,0,0,0,0,0,0,0,0,0,0,0,0,0,26,23,0,0,0,0,0,0,0,0,0,1,100,NoArch
5a07b51b4f85ea54ee234bd8e2bc320f49f8968c,0,0,0,0,0,0,0,0,0,0,0,0,0,0,27,24,0,0,0,0,0,0,0,0,0,0,100,NoArch
9a2055e7b7bd1788b0b7523367772650ffdb6b53,0,0,0,0,0,0,0,0,0,0,0,0,0,0,122,0,0,0,0,0,0,0,0,0,0,0,100,NoArch
ca8b4935c4014397ee4ffc7cd7964dce0979cdf6,0,0,0,0,0,0,0,0,0,0,0,0,0,0,24,21,0,0,0,0,0,0,0,0,0,0,100,NoArch
df08a37c4112cbe1161f5c20f985e9c1c9abff42,8,0,0,0,0,0,0,1,1,0,2,4,0,758,122,0,8,4,4,2678,1339,1339,8,4,4,0,99.61464355,NoArch
2f55adeffebef2fdd1295deb1c44489d33b0b495,8,0,379,379,0,4,4,3,3,424,2,4,1.993830231,758,123,1,4,8,4,1339,2678,1339,4,8,4,0,99.61464355,NoArch
b887ab3653590c854f2b118162114f1133b9534d,0,0,0,0,0,0,0,0,0,0,0,0,0,0,125,2,0,0,0,0,0,0,0,0,0,0,100,NoArch
1c528a194ebad97f24934685e7bfd9872ebe3019,0,0,0,0,0,0,0,0,0,0,0,0,0,0,29,0,0,0,0,0,0,0,0,0,0,0,100,NoArch
6141be782e271748c9839de1e2b837eabb25033c,0,0,0,0,0,0,0,0,0,0,0,0,0,0,30,1,0,0,0,0,0,0,0,0,0,0,100,NoArch
b9895898d799ae913ad2b37e10b4ae75467b5e37,0,0,0,0,0,0,0,0,0,0,0,0,0,0,31,2,0,0,0,0,0,0,0,0,0,0,100,NoArch
4c1d12e39801ca7e2fa1170190d77e150ff11d66,0,0,0,0,0,0,0,0,0,0,0,0,0,0,32,3,0,0,0,0,0,0,0,0,0,0,100,NoArch
d53d444374c874a89abd87042a4bdd6a57915258,0,0,0,0,0,0,0,0,0,0,0,0,0,0,33,4,0,0,0,0,0,0,0,0,0,0,100,NoArch
36da4cf3d4982e246191a3ec7eac2495a25f8a86,0,0,0,0,0,0,0,0,0,0,0,0,0,0,34,5,0,0,0,0,0,0,0,0,0,0,100,NoArch
5c51c60180b05f5ea70ef7b86daf62c7e250ef08,0,0,0,0,0,0,0,0,0,0,0,0,0,0,35,6,0,0,0,0,0,0,0,0,0,0,100,NoArch
71ce4bf599f7abe8508724d124fa4554153055c6,0,0,0,0,0,0,0,0,0,0,0,0,0,0,36,7,0,0,0,0,0,0,0,0,0,0,100,NoArch
84f389140c3781ace210ad9fc977f0d464666644,0,0,0,0,0,0,0,0,0,0,0,0,0,0,37,8,0,0,0,0,0,0,0,0,0,0,100,NoArch
7dff35bc3c61c3e0b95e8e59406742be15203a69,0,0,0,0,0,0,0,0,0,0,0,0,0,0,38,9,0,0,0,0,0,0,0,0,0,0,100,NoArch
33d1a6e699c688191fe079bfa427f89dbbe532e4,198,37106,0,37106,176,0,176,1,10,127,3,28,6.699384917,2404,39,0,4036,213,3823,162664,10477,152187,1862,56,1806,0,87.48508353,Arch
5eda9e1fdd390a94fe7740ff196b5de155d9e3d6,774,2559,0,2559,25,0,25,1,1,0,2,162,4.331233877,100347,40,1,9892,9613,279,510866,499990,10876,4939,4781,158,0,55.35413153,Arch
65c8aae283540df0a9ba68bbacb15e09d757a526,0,0,0,0,0,0,0,0,0,0,0,0,0,0,41,2,0,0,0,0,0,0,0,0,0,0,100,NoArch
4f18f402a289de7fb41f067c411bd059d3b0138d,0,0,0,0,0,0,0,0,0,0,0,0,0,0,42,3,0,0,0,0,0,0,0,0,0,0,100,NoArch
020a187523266dad14da2dc36ca87d7cc186de82,3,456,0,456,3,0,3,1,1,0,1,1,1.491713086,0,43,4,22,0,22,3353,0,3353,15,0,15,1,99.82993197,NoArch
3ee84f9c1dec2c559050e371362aeaf8f02ebbba,0,0,0,0,0,0,0,0,0,0,0,0,0,0,44,5,0,0,0,0,0,0,0,0,0,1,100,NoArch
5ca36a458dbafee65244514fc0b46f4672ddfc49,0,0,0,0,0,0,0,0,0,0,0,0,0,0,45,6,0,0,0,0,0,0,0,0,0,0,100,NoArch
a39ccda97cb02b2c9445ad2dd68e203d511f32bc,0,0,0,0,0,0,0,0,0,0,0,0,0,0,46,7,0,0,0,0,0,0,0,0,0,0,100,NoArch
505f08553970471edfeb251f2f54396e4793704e,0,0,0,0,0,0,0,0,0,0,0,0,0,0,47,8,0,0,0,0,0,0,0,0,0,0,100,NoArch
2d53a5c6b08c1fb16bef048443f718c1bad39c10,0,0,0,0,0,0,0,0,0,0,0,0,0,0,48,9,0,0,0,0,0,0,0,0,0,1,100,NoArch
ed37c220cbd86b11dde67e6290151ac13f227772,0,0,0,0,0,0,0,0,0,0,0,0,0,0,49,10,0,0,0,0,0,0,0,0,0,0,100,NoArch
c23a9f696f33994b8f733aa09ce4540f9e0bc4a4,0,0,0,0,0,0,0,0,0,0,0,0,0,0,50,11,0,0,0,0,0,0,0,0,0,0,100,NoArch
7b9eea4673e8325f49d184ed5275afacfd851026,0,0,0,0,0,0,0,0,0,0,0,0,0,0,51,12,0,0,0,0,0,0,0,0,0,1,100,NoArch
9f9b518b79f6950879f8141500ebc12149caa442,0,0,0,0,0,0,0,0,0,0,0,0,0,0,52,13,0,0,0,0,0,0,0,0,0,1,100,NoArch
5aacd5bede9fbf78fc1347cc85a42a498408b1ce,0,0,0,0,0,0,0,0,0,0,0,0,0,0,53,14,0,0,0,0,0,0,0,0,0,0,100,NoArch
03432eaa383ad10a95b1c7d3d1db590ffa0678b7,0,0,0,0,0,0,0,0,0,0,0,0,0,0,54,15,0,0,0,0,0,0,0,0,0,0,100,NoArch
6867631269e1de85b3965473219c01b3d9f1aee9,0,0,0,0,0,0,0,0,0,0,0,0,0,0,55,16,0,0,0,0,0,0,0,0,0,0,100,NoArch
f7719650ddccb313c68483eb7dd1cd855b425014,0,0,0,0,0,0,0,0,0,0,0,0,0,0,56,17,0,0,0,0,0,0,0,0,0,1,100,NoArch
f8e728ab7724d02a800b31fa4007fb9725c417d1,0,0,0,0,0,0,0,0,0,0,0,0,0,0,57,18,0,0,0,0,0,0,0,0,0,0,100,NoArch
01aec6b39e8a5cc72675be5b2641ddca4f38adab,0,0,0,0,0,0,0,0,0,0,0,0,0,0,58,19,0,0,0,0,0,0,0,0,0,0,100,NoArch
8d407a161f15f194a4af2452a3cbe12947971f67,0,0,0,0,0,0,0,0,0,0,0,0,0,0,59,20,0,0,0,0,0,0,0,0,0,1,100,NoArch
9e2f710041445b63b87a3ae021354721e55d91ff,0,0,0,0,0,0,0,0,0,0,0,0,0,0,60,21,0,0,0,0,0,0,0,0,0,0,100,NoArch
d076ab6bee986a26b336459c449afe2af0547dae,0,0,0,0,0,0,0,0,0,0,0,0,0,0,61,22,0,0,0,0,0,0,0,0,0,0,100,NoArch
5acdd99d30eb79b6d7996e82099a2ecd7e50fa34,0,0,0,0,0,0,0,0,0,0,0,0,0,0,62,23,0,0,0,0,0,0,0,0,0,1,100,NoArch
98d345cbca531ab8906a447b3c949d9871462cf1,0,0,0,0,0,0,0,0,0,0,0,0,0,0,63,24,0,0,0,0,0,0,0,0,0,1,100,NoArch
c317393277c56ed789246b17fabbcea18679ba9a,0,0,0,0,0,0,0,0,0,0,0,0,0,0,64,25,0,0,0,0,0,0,0,0,0,1,100,NoArch
ff658853dc7d6a588b60957119c4183a8e00bd9b,0,0,0,0,0,0,0,0,0,0,0,0,0,0,65,26,0,0,0,0,0,0,0,0,0,0,100,NoArch
0fca1c0f6f2e9f45905171ac80550e33e72c477e,0,0,0,0,0,0,0,0,0,0,0,0,0,0,66,27,0,0,0,0,0,0,0,0,0,0,100,NoArch
abcc6456756b45f2ed14ff6c8ffecf893d679cc7,1,2,0,2,0,0,0,1,2,53,1,1,0,652,67,23,78,78,0,2463,2454,9,31,31,0,1,100,NoArch
edb29e5f2e7b4acf288cf106b7a58d0b3b80c965,975,0,40123,40123,0,204,204,1,9,63,7,189,6.920010064,142874,39,0,9826,13950,4124,510467,676892,166425,4837,6816,1979,0,44.0397351,Arch
6990bd5adca7a83308301cec0fa5fb27849d47dc,0,0,0,0,0,0,0,0,0,0,0,0,0,0,40,1,0,0,0,0,0,0,0,0,0,0,100,NoArch
209d09e12c33b04cc0dd35c267e5be2017ace755,0,0,0,0,0,0,0,0,0,0,0,0,0,0,41,2,0,0,0,0,0,0,0,0,0,0,100,NoArch
d4def830db4570ca06b65e67decaa7dcfa64f7b8,0,0,0,0,0,0,0,0,0,0,0,0,0,0,42,3,0,0,0,0,0,0,0,0,0,0,100,NoArch
574ccc990673afdd34cb47f2b50f4379c5823212,0,0,0,0,0,0,0,0,0,0,0,0,0,0,43,4,0,0,0,0,0,0,0,0,0,0,100,NoArch
eff8b1fd6a5c871331345d40bc1c9061b7ea2a40,975,39934,0,39934,203,0,203,1,10,24,4,191,6.909365118,102940,68,4,13950,9826,4124,676892,510467,166425,6816,4837,1979,2,44.0397351,Arch
aa57e2f171ee8836f2645c1cdd087faf2ee1f934,0,0,0,0,0,0,0,0,0,0,0,0,0,0,69,2,0,0,0,0,0,0,0,0,0,2,100,NoArch
5a1d85f59f3503102298b410a0b81c2acb458a76,975,0,40123,40123,0,204,204,1,9,63,7,189,6.920010064,142874,45,0,9826,13950,4124,510467,676892,166425,4837,6816,1979,0,44.0397351,Arch
0a51eb0f5bf3e70575b8b5527de23d05650d8bdd,0,0,0,0,0,0,0,0,0,0,0,0,0,0,46,1,0,0,0,0,0,0,0,0,0,0,100,NoArch
eec16428d2d9ce1158867b8ebf6f68e194058ec0,0,0,0,0,0,0,0,0,0,0,0,0,0,0,47,2,0,0,0,0,0,0,0,0,0,0,100,NoArch
a6db60ddd0a02d1f16bd4b95ac1d243a4d3c7102,0,0,0,0,0,0,0,0,0,0,0,0,0,0,48,3,0,0,0,0,0,0,0,0,0,0,100,NoArch
62297da7ea5dc72e73e6d2c749ac73664c283c15,0,0,0,0,0,0,0,0,0,0,0,0,0,0,49,4,0,0,0,0,0,0,0,0,0,0,100,NoArch
02f75f997bbc01083a345287072e821bfe4f1558,1062,39934,0,39934,203,0,203,1,10,22,4,214,6.909365118,112888,70,3,14846,10722,4124,731347,564922,166425,7237,5258,1979,1,38.87399464,Arch
0908c521a5c35a2cd107404334db7a89accbb523,0,0,0,0,0,0,0,0,0,0,0,0,0,0,71,4,0,0,0,0,0,0,0,0,0,1,100,NoArch
e0573de33887e9d0909f1a5c34313680916b5aee,383,0,50142,50142,0,236,236,4,51,3007,3,84,7.199103194,72446,72,5,2035,7709,5674,121514,367794,246280,932,3499,2567,2,76.10429448,Arch
410ed16af1fc587999868dd4990cebfa7d14633e,857,0,0,0,0,0,0,1,1,0,1,183,0,112475,73,6,10784,10784,0,563982,563982,0,5356,5356,0,0,46.14745932,Arch
49ad8cb457079301a87b02e71ba1273c62585bed,176,7182,28402,21220,12,112,124,1,11,0,2,29,6.492137057,36406,74,7,1483,3560,2077,94359,140827,46468,731,1690,959,1,83.71246588,Arch
7b0b27b903c415e13ad7de7ea379553cddcafa79,1242,29565,259,29306,117,1,118,1,64,313,9,253,6.261247392,155549,0,0,18431,14840,3591,932716,808740,123976,8757,7225,1532,0,24.45504087,Arch
545648f6a8f69139757f0328e924c6b16a839441,1266,276,8,268,2,0,2,1,12,0,4,275,1.342269636,187150,75,0,18704,18431,273,943413,932716,10697,8910,8757,153,0,27.37608004,Arch
0bf221ee9f24adfc9054db059be2899ffdbadc0f,0,0,0,0,0,0,0,0,0,0,0,0,0,0,76,1,0,0,0,0,0,0,0,0,0,0,100,NoArch
a29bbd794849e8ad7c179135f199135978c6ad97,0,0,0,0,0,0,0,0,0,0,0,0,0,0,77,0,0,0,0,0,0,0,0,0,0,0,100,NoArch
025efffcf1c733bb8fcc83266dcfe56bbfbe961f,0,0,0,0,0,0,0,0,0,0,0,0,0,0,126,0,0,0,0,0,0,0,0,0,0,0,100,NoArch
758cfada62556d679c445416dff9d9fb2a3c4e59,0,0,0,0,0,0,0,0,0,0,0,0,0,0,127,1,0,0,0,0,0,0,0,0,0,0,100,NoArch
70f8c9024fedf94ce6902e94dfaad7990f1b2542,0,0,0,0,0,0,0,0,0,0,0,0,0,0,128,2,0,0,0,0,0,0,0,0,0,0,100,NoArch
b4ddcd082589b3a452b5ffc5824e2befd01b4994,0,0,0,0,0,0,0,0,0,0,0,0,0,0,129,3,0,0,0,0,0,0,0,0,0,0,100,NoArch
a615067cab51de15d1f8d09a666527792081ad07,0,0,0,0,0,0,0,0,0,0,0,0,0,0,2,0,0,0,0,0,0,0,0,0,0,0,100,NoArch
264974ddad5f97e6a6f9348982505d6ae5f064c8,0,0,0,0,0,0,0,0,0,0,0,0,0,0,3,1,0,0,0,0,0,0,0,0,0,0,100,NoArch
5122dbe38fee2ee6e3ac617c8b447f38fcfca9a0,0,0,0,0,0,0,0,0,0,0,0,0,0,0,4,2,0,0,0,0,0,0,0,0,0,0,100,NoArch
6c1f8a11b4ba45cbd6f3074925e7a4f0d7e07ceb,0,0,0,0,0,0,0,0,0,0,0,0,0,0,5,3,0,0,0,0,0,0,0,0,0,0,100,NoArch
aa26f695a6ef1923b710ddf8b7c48aafef618796,0,0,0,0,0,0,0,0,0,0,0,0,0,0,6,4,0,0,0,0,0,0,0,0,0,0,100,NoArch
af6066f4b0fd2e932dd2352ac58da880a053e4d3,0,0,0,0,0,0,0,0,0,0,0,0,0,0,7,5,0,0,0,0,0,0,0,0,0,0,100,NoArch
d5f84c94fbf6a63971b55e0051fcf81d1be3f120,0,0,0,0,0,0,0,0,0,0,0,0,0,0,130,4,0,0,0,0,0,0,0,0,0,0,100,NoArch
1e265c982937ee227921335bc6342cafb7dcd512,0,0,0,0,0,0,0,0,0,0,0,0,0,0,131,5,0,0,0,0,0,0,0,0,0,0,100,NoArch
70120d398df0f1f8f1e88972efe37f2cb938c394,0,0,0,0,0,0,0,0,0,0,0,0,0,0,132,6,0,0,0,0,0,0,0,0,0,0,100,NoArch
5aed83e35b54bba7cfd012e72b907f82eacbbbaf,0,0,0,0,0,0,0,0,0,0,0,0,0,0,133,7,0,0,0,0,0,0,0,0,0,0,100,NoArch
fdea0d79a8e8c2e96e5a3ceb2011093827961476,0,0,0,0,0,0,0,0,0,0,0,0,0,0,134,8,0,0,0,0,0,0,0,0,0,0,100,NoArch
f537d80609736e0a5f88ec514d289173b29ae8b5,0,0,0,0,0,0,0,0,0,0,0,0,0,0,135,9,0,0,0,0,0,0,0,0,0,0,100,NoArch
bb3cb83ca4419d830b69be923d1327d78d17b4e0,0,0,0,0,0,0,0,0,0,0,0,0,0,0,136,10,0,0,0,0,0,0,0,0,0,0,100,NoArch
981147db7ede56d94f38c99a429320cf76ca5bdd,0,0,0,0,0,0,0,0,0,0,0,0,0,0,137,11,0,0,0,0,0,0,0,0,0,0,100,NoArch
5d8b94ecbe0e0be50bcf8e8aa1746c447bb3b497,0,0,0,0,0,0,0,0,0,0,0,0,0,0,138,12,0,0,0,0,0,0,0,0,0,0,100,NoArch
e72eb918b75716e4aa5cdfaba594699943a8aaa4,0,0,0,0,0,0,0,0,0,0,0,0,0,0,139,13,0,0,0,0,0,0,0,0,0,0,100,NoArch
0064cde029f1681dd4d81a7ff893a54f24e381d1,0,0,0,0,0,0,0,0,0,0,0,0,0,0,140,14,0,0,0,0,0,0,0,0,0,0,100,NoArch
878310443e47816d7e75d3ea424d00480186a584,0,0,0,0,0,0,0,0,0,0,0,0,0,0,141,15,0,0,0,0,0,0,0,0,0,0,100,NoArch
d885cf02b51507e6fb98045bb63ec81d67814b22,0,0,0,0,0,0,0,0,0,0,0,0,0,0,142,16,0,0,0,0,0,0,0,0,0,0,100,NoArch
3543c9dd49931dfc8fbb7347148d765729e418aa,0,0,0,0,0,0,0,0,0,0,0,0,0,0,143,17,0,0,0,0,0,0,0,0,0,0,100,NoArch
be1ec41ae35d2f08b0af5221398755091f34751a,0,0,0,0,0,0,0,0,0,0,0,0,0,0,144,18,0,0,0,0,0,0,0,0,0,0,100,NoArch
02cde581157ab3a21dbc17f1533d362aa2b88db5,0,0,0,0,0,0,0,0,0,0,0,0,0,0,145,19,0,0,0,0,0,0,0,0,0,0,100,NoArch
33ee492fd61ed983d07beae0ba17c275e9940b3f,0,0,0,0,0,0,0,0,0,0,0,0,0,0,146,20,0,0,0,0,0,0,0,0,0,0,100,NoArch
2878b98765a7fcc10d7f2c05bcf10eb9bb6b026f,0,0,0,0,0,0,0,0,0,0,0,0,0,0,147,21,0,0,0,0,0,0,0,0,0,0,100,NoArch
3d8aa9f084066c12114527e7620586ad21d8945b,0,0,0,0,0,0,0,0,0,0,0,0,0,0,148,22,0,0,0,0,0,0,0,0,0,0,100,NoArch
3d54d12b150ffca7e2d5fa50781d4f27140b953d,0,0,0,0,0,0,0,0,0,0,0,0,0,0,83,0,0,0,0,0,0,0,0,0,0,0,100,NoArch
58b6cd361c9aa954876f7f1b96180cc63aa27eeb,0,0,0,0,0,0,0,0,0,0,0,0,0,0,84,1,0,0,0,0,0,0,0,0,0,0,100,NoArch
eb90d8805ac6a4526b857a8a2a58113b42d3ef53,0,0,0,0,0,0,0,0,0,0,0,0,0,0,10,8,0,0,0,0,0,0,0,0,0,0,100,NoArch
42bb10c89777daf5e1e8ae443da50c5a54fde98b,0,0,0,0,0,0,0,0,0,0,0,0,0,0,149,23,0,0,0,0,0,0,0,0,0,0,100,NoArch
b7a99b44553faa9147b4813342bb78ba1c5e11d3,0,0,0,0,0,0,0,0,0,0,0,0,0,0,150,24,0,0,0,0,0,0,0,0,0,0,100,NoArch
357f674d8db2c8d9fd2824726ded4784206dd3b0,0,0,0,0,0,0,0,0,0,0,0,0,0,0,85,0,0,0,0,0,0,0,0,0,0,0,100,NoArch
0e97d216288cb529948d3a95b54985a8993d8530,0,0,0,0,0,0,0,0,0,0,0,0,0,0,86,1,0,0,0,0,0,0,0,0,0,0,100,NoArch
fdbed4e45b0a97cae5fc5899e1b628ff48202e2f,0,0,0,0,0,0,0,0,0,0,0,0,0,0,87,2,0,0,0,0,0,0,0,0,0,0,100,NoArch
51e59419ef6db8d4d3a8685375d9ce49bc140ef4,0,0,0,0,0,0,0,0,0,0,0,0,0,0,88,3,0,0,0,0,0,0,0,0,0,0,100,NoArch
f7fe2c250f1e06c165692734e034a7c048cbb774,0,0,0,0,0,0,0,0,0,0,0,0,0,0,89,4,0,0,0,0,0,0,0,0,0,0,100,NoArch
0db4ff4542a1147edc0c9926b5cb38ee3b717d1f,0,0,0,0,0,0,0,0,0,0,0,0,0,0,151,0,0,0,0,0,0,0,0,0,0,0,100,NoArch
fae32653c70a2ef311f97aabe71be8349324c792,0,0,0,0,0,0,0,0,0,0,0,0,0,0,152,1,0,0,0,0,0,0,0,0,0,0,100,NoArch
c51f2d8258ec0537c12e915b7220e8c49c67669f,0,0,0,0,0,0,0,0,0,0,0,0,0,0,153,2,0,0,0,0,0,0,0,0,0,0,100,NoArch
0542e4034f55b113e40ffc3c80d4c05ab6622077,0,0,0,0,0,0,0,0,0,0,0,0,0,0,154,3,0,0,0,0,0,0,0,0,0,0,100,NoArch
7ccda509fc328f394a744315738e0d0cac4681eb,0,0,0,0,0,0,0,0,0,0,0,0,0,0,155,4,0,0,0,0,0,0,0,0,0,0,100,NoArch
c6afcf033c340493143031b91dc706ac2e7ea122,0,0,0,0,0,0,0,0,0,0,0,0,0,0,156,5,0,0,0,0,0,0,0,0,0,0,100,NoArch
bfa829c146aeef367ac8d45124561307d73a9069,0,0,0,0,0,0,0,0,0,0,0,0,0,0,157,6,0,0,0,0,0,0,0,0,0,0,100,NoArch
