CommitID,NMF,TotalAddLines,TotalDeleteLines,LC,FileAdd,FileDelete,NAD,NDVE,NUC,AGE,NMS,NMD,Entropy ,MLMF,EXP,REXP,CommitComplexity,LastCommitComplexity,CFC,CommitTokenCount,LastCommitTokenCount,NCC,CommitMethodNum,LastCommitMethodNum,NFC,NIR,a2a,Tag
d3b347338a8fdbf9d039eeb75ae83ae11795ddc3,0,0,0,0,0,0,0,0,0,0,0,0,0.0,0,0,0,0,0,0,0,0,0,0,0,0,0,100.0,NoArch
89b4de72bd65b4271b68b0a427ef31134b2e0916,0,0,0,0,0,0,0,0,0,0,0,0,0.0,0,50,50,0,0,0,0,0,0,0,0,0,0,100.0,NoArch
2caed6218a5ec0a0b7fce2975743331e5ec76c89,1,52,31,21,0,0,0,12,29,14,1,1,0.0,354,12,1,58,55,3,1759,1677,82,15,14,1,1,100.0,NoArch
df3fdc9d5ca51822756923e2106249047b3c04a8,24,3000,0,3000,24,0,24,1,1,0,1,3,4.070045411,0,0,0,299,0,299,11931,0,11931,176,0,176,0,99.07730162,NoArch
8431717af65b233ac71efb38af42024e183e5cf6,0,0,0,0,0,0,0,0,0,0,0,0,0.0,0,46,6,0,0,0,0,0,0,0,0,0,1,100.0,NoArch
26b35a8ca99af3bbaaa68f40608ea7142d78d2ec,3,105,11,94,0,0,0,14,115,1006,1,3,0.517247337,1479,0,0,210,196,14,6909,6418,491,78,76,2,1,100.0,NoArch
ede86ab4b6711b2f2971220f05c60bcf2f59655e,1,0,0,0,0,0,0,1,1,0,1,1,0.0,131,372,5,11,11,0,606,606,0,2,2,0,1,99.92562291,NoArch
eaf528f2cefcebaaf01c3bf2acbecaef661ce33d,0,0,0,0,0,0,0,0,0,0,0,0,0.0,0,1264,21,0,0,0,0,0,0,0,0,0,0,100.0,NoArch
103a67cbaf85cdb125c8671eec8f10917eaad573,2,40,0,40,0,0,0,1,5,125,1,1,0.848548178,268,973,5,21,18,3,1296,1060,236,11,9,2,1,99.55399809,NoArch
7dcb4c7cdf872e8c4e073a02782925b62828f47a,0,0,0,0,0,0,0,0,0,0,0,0,0.0,0,1020,6,0,0,0,0,0,0,0,0,0,0,100.0,NoArch
0b1c63e328b6ed9a6c8417efdaf3a38129dd2644,1,1,1,0,0,0,0,6,16,0,1,1,0.0,130,118,118,15,15,0,733,733,0,8,8,0,0,100.0,NoArch
c1ee1955703363cd783039d6b603345ed27a88af,0,0,0,0,0,0,0,0,0,0,0,0,0.0,0,78,0,0,0,0,0,0,0,0,0,0,1,100.0,NoArch
580d9beda4d003da9723a228356e8945b5f6c416,0,0,0,0,0,0,0,0,0,0,0,0,0.0,0,2626,14,0,0,0,0,0,0,0,0,0,0,100.0,NoArch
94af1d99f8917e760f3e5fd08b378468d5060116,1,11,4,7,0,0,0,1,2,0,1,1,0.0,64,381,5,7,5,2,241,214,27,2,2,0,1,100.0,NoArch
51c0399030dcb0b88080a7f9e50c3d09c6913dda,1,29,2,27,0,0,0,16,28,533,1,1,0.0,795,11,0,140,136,4,2735,2625,110,46,45,1,1,100.0,NoArch
bdec668de9c600165bb69c95b6ea0625d9f74fb0,56,4764,155,4609,39,0,39,1,129,521,3,19,5.419511425,7936,90,21,1234,867,367,51161,36547,14614,596,353,243,1,98.20859873,NoArch
9e678193cf3210729f2e70ccc844ebdc1cea2eb2,2,5,2,3,0,0,0,8,115,21,2,2,0.985228136,2108,1224,23,293,293,0,7998,7988,10,128,128,0,2,100.0,NoArch
280b8d3ec5b63e758ac653cfa1db34c2d2f8d326,0,0,0,0,0,0,0,0,0,0,0,0,0.0,0,133,5,0,0,0,0,0,0,0,0,0,0,100.0,NoArch
a3787b73072db673feeb6a5fe034009685c509e6,0,0,0,0,0,0,0,0,0,0,0,0,0.0,0,1,1,0,0,0,0,0,0,0,0,0,0,100.0,NoArch
6ca2a980b8e23a78e47a19bbfdbe03b909bc962d,0,0,0,0,0,0,0,0,0,0,0,0,0.0,0,95,1,0,0,0,0,0,0,0,0,0,1,100.0,NoArch
ceb08cfa77cb552b8315b8ee60846d0584db9488,8,40,17,23,0,0,0,3,150,2983,4,5,2.923551524,3262,114,0,476,470,6,11462,11360,102,234,234,0,0,100.0,NoArch
38317c822ad2bc368bab2ba1e0a4b61fd08bc9b0,0,0,0,0,0,0,0,0,0,0,0,0,0.0,0,111,111,0,0,0,0,0,0,0,0,0,0,100.0,NoArch
effd92055cb4bd17d4cd5a44366b6996ae7d5907,2,1,2,1,0,0,0,2,59,24,1,1,0.918295834,919,1094,30,106,106,0,4550,4570,20,19,19,0,0,100.0,NoArch
1f9e91da55a4d6a0314eda7dd5ae4500999adb3d,1,15,0,15,0,0,0,1,5,25,1,1,0.0,220,1076,35,24,23,1,1113,1035,78,4,4,0,1,100.0,NoArch
90d5ab7642a5143b64725c128dba868371c3c93d,0,0,0,0,0,0,0,0,0,0,0,0,0.0,0,0,0,0,0,0,0,0,0,0,0,0,0,100.0,NoArch
c3cf29438e3d65d6ee5c5726f8611af99d9a649a,11,575,215,360,2,0,2,14,210,61,2,6,2.830131268,5347,15,0,580,544,36,24157,22728,1429,272,248,24,1,99.86659043,NoArch
e210666f94403ae3782e76c2dbe02c0b9e0b8d84,0,0,0,0,0,0,0,0,0,0,0,0,0.0,0,1,1,0,0,0,0,0,0,0,0,0,0,100.0,NoArch
40f1082cfaf14bd9f0276f21b9211c1ff8f7cc92,0,0,0,0,0,0,0,0,0,0,0,0,0.0,0,72,1,0,0,0,0,0,0,0,0,0,1,100.0,NoArch
d7ae6ad6c13ff75aae686a460bb0d4c6481399ea,2,0,2,2,0,0,0,1,65,7,2,2,1.0,1250,1161,13,154,154,0,6065,6091,26,42,42,0,0,100.0,NoArch
803c2155548f7d985e2f7afeb36f29761b5b1b49,0,0,0,0,0,0,0,0,0,0,0,0,0.0,0,12,1,0,0,0,0,0,0,0,0,0,0,100.0,NoArch
aec341a7a9e292a4fc537e1042da8b9ce867580c,3,179,15,164,2,0,2,1,7,137,1,3,1.471864606,199,24,0,33,20,13,1633,1024,609,11,6,5,1,99.91783073,NoArch
fe331b8d7fa66189f833315f1f861f328ad0e9f9,0,0,0,0,0,0,0,0,0,0,0,0,0.0,0,99,99,0,0,0,0,0,0,0,0,0,0,100.0,NoArch
1f8e0732b888f2a0c939b7d010a7d7b9c16c78f5,0,0,0,0,0,0,0,0,0,0,0,0,0.0,0,0,0,0,0,0,0,0,0,0,0,0,0,100.0,NoArch
c29777386b8d23bbfc16789bd02273eacf4f9bf6,1,42,26,16,0,0,0,15,65,0,1,1,0.0,912,1,1,93,90,3,4659,4581,78,22,18,4,1,100.0,NoArch
b9e6795b6ce7f15e26bd436543886d97dbda732f,1,10,0,10,0,0,0,4,12,0,1,1,0.0,110,0,0,11,9,2,533,455,78,2,2,0,0,100.0,NoArch
0c157e1393390a085b5c4c1f28d686e5348b0802,0,0,0,0,0,0,0,0,0,0,0,0,0.0,0,2619,7,0,0,0,0,0,0,0,0,0,0,100.0,NoArch
720e46d91dce7268e91c32f0af37c37dac919d85,1,1,0,1,0,0,0,39,199,5,1,1,0.0,1745,73,0,221,220,1,8205,8186,19,38,38,0,1,100.0,NoArch
f98e632108f2b9496e306dc4630fa24ca5ca45b9,3,9,1,8,0,0,0,5,196,778,1,2,1.521928095,2016,7,1,234,232,2,10329,10227,102,46,46,0,1,100.0,NoArch
bf59026554f954296bbedaa21359afc0a9c3e4b2,0,0,0,0,0,0,0,0,0,0,0,0,0.0,0,369,2,0,0,0,0,0,0,0,0,0,1,100.0,NoArch
05d9ee3cfbbb94b6aed5e1aae2d31365182bbcd9,0,0,0,0,0,0,0,0,0,0,0,0,0.0,0,1189,11,0,0,0,0,0,0,0,0,0,1,100.0,NoArch
2a5fde5cac7d8168cdc3a2351f9a6e04a909e5c6,0,0,0,0,0,0,0,0,0,0,0,0,0.0,0,75,2,0,0,0,0,0,0,0,0,0,0,100.0,NoArch
14449e426aee2763d6435b63ef632b7c0b9ed767,0,0,0,0,0,0,0,0,0,0,0,0,0.0,0,39,5,0,0,0,0,0,0,0,0,0,1,100.0,NoArch
0fe726fe63d754cf60eceac6812079ba71b70f54,0,0,0,0,0,0,0,0,0,0,0,0,0.0,0,94,94,0,0,0,0,0,0,0,0,0,0,100.0,NoArch
040d3434335f72f1bb77ca86af9d3f4ac837901a,0,0,0,0,0,0,0,0,0,0,0,0,0.0,0,4,0,0,0,0,0,0,0,0,0,0,0,100.0,NoArch
706826e18e03d3182644a2fbb6fd72f386540ea8,0,0,0,0,0,0,0,0,0,0,0,0,0.0,0,59,1,0,0,0,0,0,0,0,0,0,0,100.0,NoArch
42ed0ede91184284b5cecdbff2eace3a29ce04b3,1,20,0,20,0,0,0,2,12,0,1,1,0.0,784,924,31,115,113,2,3781,3651,130,12,11,1,1,100.0,NoArch
f793d862e3158f8dde98f00905f907b6bd5e0aaf,14,0,1845,1845,0,14,14,6,24,760,2,3,3.649271579,1845,376,0,0,142,142,0,7774,7774,0,88,88,0,99.39140358,NoArch
5e42c7c631376923df7186ce37c6911eb9755c56,0,0,0,0,0,0,0,0,0,0,0,0,0.0,0,9,9,0,0,0,0,0,0,0,0,0,0,100.0,NoArch
d3b347338a8fdbf9d039eeb75ae83ae11795ddc3,0,0,0,0,0,0,0,0,0,0,0,0,0.0,0,0,0,0,0,0,0,0,0,0,0,0,0,100.0,NoArch
65ec04c2363b16d08b760fe7e494b56b347bffee,1,37,1,36,0,0,0,1,2,455,1,1,0.0,59,93,24,11,4,7,258,110,148,6,4,2,1,100.0,NoArch
40302afc0ce12137cbe912ec52cc759e1d4aba85,0,0,0,0,0,0,0,0,0,0,0,0,0.0,0,22,22,0,0,0,0,0,0,0,0,0,0,100.0,NoArch
958380685d360d793cc95c5087bad93be1623a8e,1,5,31,26,0,0,0,9,25,0,1,1,0.0,204,69,6,15,19,4,897,1071,174,4,4,0,1,100.0,NoArch
cbbb9cf7e390b3215fd424706d06a13b9a7e8bbd,0,0,0,0,0,0,0,0,0,0,0,0,0.0,0,106,0,0,0,0,0,0,0,0,0,0,1,100.0,NoArch
d6d69f8239a1fea67c862228e380c8f9ce88cc54,1,1,1,0,0,0,0,2,8,0,1,1,0.0,110,56,56,9,9,0,455,455,0,2,2,0,0,100.0,NoArch
42c99b45e45224810ee2f914b238123cbf599a96,0,0,0,0,0,0,0,0,0,0,0,0,0.0,0,0,0,0,0,0,0,0,0,0,0,0,1,100.0,NoArch
9623c91327367e1313fd1aba273b9834d06acce1,0,0,0,0,0,0,0,0,0,0,0,0,0.0,0,56,11,0,0,0,0,0,0,0,0,0,0,100.0,NoArch
0080e845884922814d26914d0ae9f59b084bee35,20,30,30,0,0,0,0,12,365,1490,4,15,4.106890596,7691,7,7,973,973,0,31359,31459,100,479,479,0,1,100.0,NoArch
7d7a43135cbc76064a8830f0e2204b41b782231b,0,0,0,0,0,0,0,0,0,0,0,0,0.0,0,156,0,0,0,0,0,0,0,0,0,0,1,100.0,NoArch
3b1181b87e501bbf9b46a61a94dc7a54af790ede,1,1,4,3,0,0,0,3,24,0,1,1,0.0,765,1120,7,96,96,0,3360,3382,22,19,19,0,0,99.94189425,NoArch
f2d48a06ad0655acbf8ab6c596219fbf94ebcf2f,2,19,0,19,0,0,0,1,31,6,1,2,0.998000884,1077,942,33,132,128,4,5447,5337,110,55,54,1,1,100.0,NoArch
a3a5411b0fcd1170a51b4d374fab6015ff8a9f0a,0,0,0,0,0,0,0,0,0,0,0,0,0.0,0,77,77,0,0,0,0,0,0,0,0,0,0,100.0,NoArch
117cfde44e34a45f2b38929aa164e61650681aeb,11,104,67,37,0,0,0,26,201,119,3,5,3.010274081,6385,5,1,716,709,7,27650,27438,212,275,273,2,1,99.96119519,NoArch
3dc17a6a837baf238568d93ca28e870e70bf3d8e,0,0,0,0,0,0,0,0,0,0,0,0,0.0,0,58,13,0,0,0,0,0,0,0,0,0,0,100.0,NoArch
781551133f90c1c3d457a993ccb1992c962a84ae,0,0,0,0,0,0,0,0,0,0,0,0,0.0,0,2637,25,0,0,0,0,0,0,0,0,0,0,100.0,NoArch
5a0e6915073e052072f7de57a59878c3600a17f8,2,103,3,100,0,0,0,2,73,630,1,2,0.77170947,767,1164,15,94,85,9,3803,3351,452,28,23,5,1,100.0,NoArch
da8d45d550c3562082a35bab3245e596f01f7693,1,7,0,7,0,0,0,4,78,26,1,1,0.0,523,1212,32,46,45,1,2805,2765,40,14,14,0,1,100.0,NoArch
40302afc0ce12137cbe912ec52cc759e1d4aba85,0,0,0,0,0,0,0,0,0,0,0,0,0.0,0,22,22,0,0,0,0,0,0,0,0,0,0,100.0,NoArch
c180c2137c187c721ff05c484bedc6dcd1eaf97f,1,10,0,10,0,0,0,12,368,32,1,1,0.0,2034,1038,14,232,231,1,8559,8512,47,58,57,1,0,100.0,NoArch
7bb1083d0fd30819f41fc519719245939df84316,1,1,1,0,0,0,0,4,16,0,1,1,0.0,117,97,97,11,11,0,549,549,0,2,2,0,0,100.0,NoArch
a3706dc37822016f5ffcc6cfcbd7c73e32e8307d,0,0,0,0,0,0,0,0,0,0,0,0,0.0,0,5,5,0,0,0,0,0,0,0,0,0,0,100.0,NoArch
6f3130aa4c7df6245d2f20cb4ef7692a19d05f10,6,553,0,553,6,0,6,1,1,0,1,1,2.392997424,0,962,11,61,0,61,1831,0,1831,19,0,19,0,99.57028852,NoArch
5c5983476a0431a6bdbbdc30ae1ed9f7697633eb,0,0,0,0,0,0,0,0,0,0,0,0,0.0,0,105,5,0,0,0,0,0,0,0,0,0,0,100.0,NoArch
8edac61ae51029ce73f5f4cabd2b5652556d5090,0,0,0,0,0,0,0,0,0,0,0,0,0.0,0,0,0,0,0,0,0,0,0,0,0,0,1,100.0,NoArch
ed6d2b40e9c477269b25eaa852e11282357e6c12,0,0,0,0,0,0,0,0,0,0,0,0,0.0,0,48,48,0,0,0,0,0,0,0,0,0,0,100.0,NoArch
466ac17cca80d9af23957eba7c3777f2dad7e85c,0,0,0,0,0,0,0,0,0,0,0,0,0.0,0,128,1,0,0,0,0,0,0,0,0,0,0,100.0,NoArch
fc1962e659b4fed675f0d729ece866514fedb896,1,24,3,21,0,0,0,12,19,91,1,1,0.0,351,27,1,28,27,1,2141,2116,25,4,4,0,1,100.0,NoArch
7a5ccb383bc2f76d246670467f563d9d98acf060,1,21,1,20,0,0,0,2,7,435,1,1,0.0,96,941,32,9,7,2,558,459,99,3,2,1,1,99.9381953,NoArch
a3f88234d429acd60d563e9f4d593870b1754225,1,2,0,2,0,0,0,39,206,8,1,1,0.0,1486,153,8,230,230,0,8296,8296,0,39,39,0,0,100.0,NoArch
ab39d82dd13203eb48dfc01328aac73b59991be6,0,0,0,0,0,0,0,0,0,0,0,0,0.0,0,1176,14,0,0,0,0,0,0,0,0,0,0,100.0,NoArch
45076f33a0f38e34c72f2493ae5be484f56466f1,0,0,0,0,0,0,0,0,0,0,0,0,0.0,0,74,1,0,0,0,0,0,0,0,0,0,0,100.0,NoArch
b607a31165684192cb4bc0a29b28c219c73d8c2e,0,0,0,0,0,0,0,0,0,0,0,0,0.0,0,2,2,0,0,0,0,0,0,0,0,0,0,100.0,NoArch
0f4b974af63878cdbda084bd004eefa12d60ed68,0,0,0,0,0,0,0,0,0,0,0,0,0.0,0,92,92,0,0,0,0,0,0,0,0,0,0,100.0,NoArch
4f8adb9599ca61c8720272e78b00153450a0ea96,0,0,0,0,0,0,0,0,0,0,0,0,0.0,0,4,4,0,0,0,0,0,0,0,0,0,0,100.0,NoArch
3492f3ae997ef949d926201fc864c4a207fc7659,0,0,0,0,0,0,0,0,0,0,0,0,0.0,0,142,0,0,0,0,0,0,0,0,0,0,1,100.0,NoArch
a96fd11b1fb9724d563cfde60288d17ddd22bf7e,0,0,0,0,0,0,0,0,0,0,0,0,0.0,0,322,0,0,0,0,0,0,0,0,0,0,1,100.0,NoArch
bf4af4c32697700a352c2b0ba5b0576863f30cec,1,2,2,0,0,0,0,2,4,1294,1,1,0.0,67,1146,1,3,3,0,248,236,12,3,3,0,0,100.0,NoArch
d011e4d6cbec9ed19207e9dab4e5bea0d83ee962,0,0,0,0,0,0,0,0,0,0,0,0,0.0,0,95,95,0,0,0,0,0,0,0,0,0,0,100.0,NoArch
3e917677e484067b853eaa4a6de44ebcf5a988de,2,42,1,41,0,0,0,15,213,59,1,2,0.693127415,2254,15,3,253,250,3,11395,11239,156,72,70,2,1,100.0,NoArch
a25a535e281e47a197e2019aa65199c956c6b184,0,0,0,0,0,0,0,0,0,0,0,0,0.0,0,4,4,0,0,0,0,0,0,0,0,0,0,100.0,NoArch
03b48aeca888bc5549cfc0ac906066163dc5c0d2,1,1,1,0,0,0,0,1,4,0,1,1,0.0,110,10,10,9,9,0,455,455,0,2,2,0,0,100.0,NoArch
f179e38933fc591cd00e25136fccaee55c75c4c7,1,7,3,4,0,0,0,3,13,0,1,1,0.0,484,1168,18,61,59,2,2240,2227,13,16,16,0,0,100.0,NoArch
759db789e10623626ebb00690c24e8935698f5d4,2,27,15,12,0,0,0,8,107,46,1,1,0.791858353,2440,1251,25,385,386,1,9455,9321,134,206,207,1,1,99.85247111,NoArch
cd4c904218737a2fa61f2cb2b91ecba3c4ffbd09,5,29,14,15,1,0,1,3,10,0,1,2,1.990690697,478,0,0,65,62,3,2615,2567,48,26,24,2,0,99.85786802,NoArch
2e51e10b6dda2219fdb5501defc0c4513f575248,0,0,0,0,0,0,0,0,0,0,0,0,0.0,0,354,11,0,0,0,0,0,0,0,0,0,0,100.0,NoArch
f957961cb8e3ab58dfa563e1d8d200c5151cdada,2,11,8,3,0,0,0,6,95,77,2,2,0.485460761,2720,951,25,418,418,0,11098,11062,36,186,186,0,1,100.0,NoArch
2ffb15c84aa1152f6c6982c165f7a10c93d978de,0,0,0,0,0,0,0,0,0,0,0,0,0.0,0,0,0,0,0,0,0,0,0,0,0,0,0,100.0,NoArch
b877445cb987921d684d130ba16a35cd20807ea8,16,180,188,8,0,0,0,13,81,1678,2,9,3.891276621,5227,54,0,340,345,5,27170,27194,24,288,293,5,1,99.59318094,NoArch
241aa78725cb2811945e7b0b521a2aed612a6236,0,0,0,0,0,0,0,0,0,0,0,0,0.0,0,7,7,0,0,0,0,0,0,0,0,0,0,100.0,NoArch
18e3d3ea0df08f2b43e4902879da4422f960c7c5,1,1,1,0,0,0,0,1,2,0,1,1,0.0,18,1,1,3,3,0,78,73,5,2,2,0,0,100.0,NoArch
2628d713a97a8b5f761733c1b079ca51c9c5b179,1,56,58,2,0,0,0,10,62,504,1,1,0.0,1894,94,0,153,153,0,12070,12090,20,135,135,0,1,100.0,NoArch
067d997415e9f2a66d0472dd2bd61a4c4f8cc76f,1,1,1,0,0,0,0,6,16,0,1,1,0.0,130,118,118,15,15,0,733,733,0,8,8,0,0,100.0,NoArch
958418a2d185034d5d4ae842d331dcb0a76be359,0,0,0,0,0,0,0,0,0,0,0,0,0.0,0,39,39,0,0,0,0,0,0,0,0,0,0,100.0,NoArch
295c205a65b20a9ce53e73ce58f1dd1744b8b542,2,50,5,45,0,0,0,2,147,3522,1,2,0.988283611,2023,20,1,319,317,2,7751,7476,275,179,178,1,1,99.97956682,NoArch
1fcc45afe3c00fcf6ec7101ebbca7d9868001557,0,0,0,0,0,0,0,0,0,0,0,0,0.0,0,122,122,0,0,0,0,0,0,0,0,0,0,100.0,NoArch
1859142a151549c980caf6f93088f808c52fdeba,1,4,1,3,0,0,0,3,5,0,1,1,0.0,119,1,1,15,15,0,679,663,16,8,8,0,0,100.0,NoArch
c10f412029b287b206a46b13d73e0af56838100a,0,0,0,0,0,0,0,0,0,0,0,0,0.0,0,921,42,0,0,0,0,0,0,0,0,0,0,100.0,NoArch
3ea2993c0b5e93904c06e06ee63d93e74885f1bd,0,0,0,0,0,0,0,0,0,0,0,0,0.0,0,60,60,0,0,0,0,0,0,0,0,0,0,100.0,NoArch
2a5fde5cac7d8168cdc3a2351f9a6e04a909e5c6,0,0,0,0,0,0,0,0,0,0,0,0,0.0,0,75,2,0,0,0,0,0,0,0,0,0,0,100.0,NoArch
872f9416d601a8bd918f35315fa56084a29731dc,10,16,16,0,0,0,0,7,14,1417,5,6,3.25,1666,41,7,183,183,0,7590,7606,16,62,62,0,0,100.0,NoArch
083423fd50bd5aecc5e1ecf4350a99f30d9acfb3,0,0,0,0,0,0,0,0,0,0,0,0,0.0,0,5,0,0,0,0,0,0,0,0,0,0,1,100.0,NoArch
c18b8872de1d1da37ec33186c92091d60edc34e1,2,4,12,8,0,0,0,4,363,211,2,2,1.0,2655,1006,23,301,302,1,9467,9477,10,111,112,1,1,100.0,NoArch
6fba7aa3c4d31d088df3ef682f7307b7c9a2f17c,1,3,3,0,0,0,0,8,14,0,1,1,0.0,192,0,0,21,21,0,817,817,0,10,10,0,0,100.0,NoArch
951b5ee95f40147abbc2bb9d928e408b85d5aef3,0,0,0,0,0,0,0,0,0,0,0,0,0.0,0,164,2,0,0,0,0,0,0,0,0,0,0,100.0,NoArch
9b58d2bad23a66be161c4664ef21ce219c2c8584,0,0,0,0,0,0,0,0,0,0,0,0,0.0,0,36,6,0,0,0,0,0,0,0,0,0,0,100.0,NoArch
52c12dab44d69e0479d4f23736dfdf91733654e5,0,0,0,0,0,0,0,0,0,0,0,0,0.0,0,145,14,0,0,0,0,0,0,0,0,0,1,100.0,NoArch
fe9a21ca8162df9b6ac51b7842d1ec6bf9141fff,2,47,11,36,0,0,0,2,18,393,1,2,0.929363626,362,1019,5,43,38,5,1477,1294,183,27,26,1,1,100.0,NoArch
530cb535c3c07a089f59ed970763dd4d3d19de4b,0,0,0,0,0,0,0,0,0,0,0,0,0.0,0,76,0,0,0,0,0,0,0,0,0,0,1,100.0,NoArch
57b006fe345e4e592042927df45d3ac0539e35b7,0,0,0,0,0,0,0,0,0,0,0,0,0.0,0,360,17,0,0,0,0,0,0,0,0,0,1,100.0,NoArch
5d7c76403d12c7006a44564de2ca9913b4c338a8,1,22,0,22,0,0,0,3,77,67,1,1,0.0,604,1261,24,67,64,3,3034,2878,156,21,21,0,0,100.0,NoArch
98b6027a2d2f1866e4f5720daf562f544d8cc02b,0,0,0,0,0,0,0,0,0,0,0,0,0.0,0,2636,24,0,0,0,0,0,0,0,0,0,0,100.0,NoArch
d5a5bc553a131f1ecca5503dde359dedcec4c506,0,0,0,0,0,0,0,0,0,0,0,0,0.0,0,0,0,0,0,0,0,0,0,0,0,0,1,100.0,NoArch
a96fd11b1fb9724d563cfde60288d17ddd22bf7e,0,0,0,0,0,0,0,0,0,0,0,0,0.0,0,322,0,0,0,0,0,0,0,0,0,0,1,100.0,NoArch
8456294977b40660ce37db853de344f0d26ee46d,3,109,63,46,1,0,1,1,200,1612,1,2,1.451274162,1885,15,0,237,236,1,9100,9029,71,46,44,2,1,99.90608124,NoArch
02bc2a69fc8d1a14ff35645d9478b686a07cf29f,0,0,0,0,0,0,0,0,0,0,0,0,0.0,0,74,1,0,0,0,0,0,0,0,0,0,0,100.0,NoArch
79100c6b35d29f0b74951b7f7486f259d90f8e97,0,0,0,0,0,0,0,0,0,0,0,0,0.0,0,157,1,0,0,0,0,0,0,0,0,0,0,100.0,NoArch
de9d99659b0badbe3eb71c5fa73ab7f2edffad29,0,0,0,0,0,0,0,0,0,0,0,0,0.0,0,41,41,0,0,0,0,0,0,0,0,0,0,100.0,NoArch
e96c8dab7eda4abc29f9cf9a0843e90afca1e6ab,1,6,6,0,0,0,0,3,6,119,1,1,0.0,239,1172,10,25,25,0,1001,1001,0,11,11,0,1,100.0,NoArch
9020e459a19b9ba7fbb3704c14aa38d6438de954,1,14,1,13,0,0,0,2,52,13,1,1,0.0,787,1057,21,89,86,3,4003,3944,59,18,18,0,1,100.0,NoArch
251ba225c67c9fbf80d4c5e09deba7f2105f9015,5,13,61,48,0,0,0,3,23,4,4,5,2.035504841,2035,54,0,239,245,6,8986,9346,360,108,110,2,1,100.0,NoArch
14ff5dd0dad46169ae2439253ab00e01bca8584c,0,0,0,0,0,0,0,0,0,0,0,0,0.0,0,79,2,0,0,0,0,0,0,0,0,0,1,100.0,NoArch
8af0a674db7cf1199d62e1cba60e29f84a144129,0,0,0,0,0,0,0,0,0,0,0,0,0.0,0,109,2,0,0,0,0,0,0,0,0,0,0,100.0,NoArch
6ebdbb1de579168bd5876383b446702c59164655,0,0,0,0,0,0,0,0,0,0,0,0,0.0,0,19,19,0,0,0,0,0,0,0,0,0,0,100.0,NoArch
117cfde44e34a45f2b38929aa164e61650681aeb,11,104,67,37,0,0,0,26,201,119,3,5,3.010274081,6385,5,1,716,709,7,27650,27438,212,275,273,2,1,99.96119519,NoArch
7aef3915515828aaec834ee5120049cdc305a53b,2,45,3,42,0,0,0,2,2,530,1,2,0.988699408,104,1,1,12,9,3,480,243,237,8,6,2,1,100.0,NoArch
5a6b42d721e1595a8877a576dc2360b5968d39af,0,0,0,0,0,0,0,0,0,0,0,0,0.0,0,70,3,0,0,0,0,0,0,0,0,0,0,100.0,NoArch
25f27fc501e7730619f7c36246d44d15f4ec93f2,0,0,0,0,0,0,0,0,0,0,0,0,0.0,0,8,8,0,0,0,0,0,0,0,0,0,0,100.0,NoArch
067171d28acc7399f421c668254148394d7f78f7,0,0,0,0,0,0,0,0,0,0,0,0,0.0,0,3,0,0,0,0,0,0,0,0,0,0,1,100.0,NoArch
76427d2320b5758f1a97fe81c61cdc6c5fff95b9,8,224,76,148,1,0,1,1,2,7,1,3,2.75075479,1114,92,23,138,124,14,4192,3669,523,78,69,9,1,99.76649154,NoArch
acd61cc708f202c3e674304ef84034517c0b7723,0,0,0,0,0,0,0,0,0,0,0,0,0.0,0,339,2,0,0,0,0,0,0,0,0,0,0,100.0,NoArch
3212efee784f0b9edf1c855d9eb73b45871aca7d,1,10,3,7,0,0,0,13,80,4,1,1,0.0,795,0,0,106,105,1,3948,3928,20,21,21,0,1,100.0,NoArch
a945ca4ed314714fdc2be4616bcf34eaf6d3c1f5,1,7,4,3,0,0,0,9,17,2,1,1,0.0,151,91,22,12,11,1,509,498,11,6,6,0,1,100.0,NoArch
4c21e11b011999d8455d4406a07bcc2e6eaa73ae,3,3,3,0,0,0,0,7,42,2089,2,3,1.584962501,1642,9,9,244,247,3,6634,6654,20,42,42,0,1,100.0,NoArch
d4f84764094cad78ff9ba0e1f9fd00b2880e75fc,0,0,0,0,0,0,0,0,0,0,0,0,0.0,0,117,117,0,0,0,0,0,0,0,0,0,0,100.0,NoArch
b4476a300f2d95407d12da41a1ab17f4ed19db52,0,0,0,0,0,0,0,0,0,0,0,0,0.0,0,129,1,0,0,0,0,0,0,0,0,0,0,100.0,NoArch
0399af0824651fd550d654035826cd2cde7284b4,1,1,1,0,0,0,0,4,19,0,1,1,0.0,117,112,112,11,11,0,549,549,0,2,2,0,0,100.0,NoArch
9166805a068ff176c237e9f340234f5132d6b4dd,1,1,1,0,0,0,0,16,30,519,1,1,0.0,830,13,0,142,142,0,2752,2752,0,46,46,0,1,100.0,NoArch
f820b41aed604da0405dca2337044f60540d0b49,5,60,197,137,0,0,0,3,4,415,1,2,1.887079825,654,9,1,35,51,16,2200,2930,730,25,33,8,1,99.90448902,NoArch
3bc2cf6a7a9d151fb10a3197ae4412e2ca11437c,23,127,459,332,0,4,4,3,4,1256,3,5,3.710883928,2922,30,0,207,225,18,9870,10999,1129,128,140,12,1,99.77241693,NoArch
fa2febb6f3730516414da24c3ebe9c60cae7ee21,1,19,0,19,0,0,0,10,16,41,1,1,0.0,313,8,0,23,22,1,1896,1756,140,3,2,1,1,100.0,NoArch
57acdd41b46dbf7ed4a762643d5705c0acc8af2d,1,9,2,7,0,0,0,13,32,46,1,1,0.0,337,52,11,47,46,1,1935,1889,46,11,11,0,3,100.0,NoArch
c4df060c2604fda20a9f4fccc0fbc71e4e7a38e7,2,42,41,1,0,0,0,15,69,100,1,1,0.654664053,2327,355,12,163,163,0,13924,13924,0,151,151,0,0,100.0,NoArch
d7d94af16931766bd779e52db5c9de6320c57241,1,30,0,30,0,0,0,1,9,416,1,1,0.0,298,1033,9,41,39,2,924,784,140,30,28,2,0,100.0,NoArch
002f67743708ed02121d3325d3cd874a4a7175ab,1,0,1,1,0,0,0,6,12,0,1,1,0.0,127,3,3,15,15,0,701,701,0,8,8,0,0,100.0,NoArch
8d221f97fc72fbd9099e082600590fdf6b85143c,0,0,0,0,0,0,0,0,0,0,0,0,0.0,0,52,2,0,0,0,0,0,0,0,0,0,0,100.0,NoArch
87d3ffae46af3947b264be70eb3b2bd66601a14f,0,0,0,0,0,0,0,0,0,0,0,0,0.0,0,1250,24,0,0,0,0,0,0,0,0,0,1,100.0,NoArch
067d997415e9f2a66d0472dd2bd61a4c4f8cc76f,1,1,1,0,0,0,0,6,16,0,1,1,0.0,130,118,118,15,15,0,733,733,0,8,8,0,0,100.0,NoArch
33ded77c02caa06afea62b6f46abf42897c842c1,0,0,0,0,0,0,0,0,0,0,0,0,0.0,0,13,13,0,0,0,0,0,0,0,0,0,0,100.0,NoArch
98db3ffd8796cbda8141e3e36926adcbb852a2e2,2,16,2,14,0,0,0,6,15,0,1,1,0.964078765,315,89,89,49,47,2,1883,1787,96,16,16,0,0,100.0,NoArch
dfd067b3ed6e170a784fc0e91f063a34f69f279a,5,26,1,25,0,0,0,3,72,337,3,3,2.204118413,1499,1040,13,176,173,3,6188,6156,32,85,82,3,0,100.0,NoArch
2c8f927ae78eb266d7bc4b13f27e70b7d6fa04eb,0,0,0,0,0,0,0,0,0,0,0,0,0.0,0,77,6,0,0,0,0,0,0,0,0,0,0,100.0,NoArch
c79682bca9ec00c82cf23c480862a4047f1deeee,1,3,3,0,0,0,0,6,9,6,1,1,0.0,170,106,6,20,20,0,627,627,0,10,10,0,1,100.0,NoArch
a5acd3ec6095ea2ff50191576c33685c1d038c1f,1,31,10,21,0,0,0,5,5,130,1,1,0.0,157,2,2,11,9,2,985,841,144,6,5,1,1,100.0,NoArch
25796220adb2ca53f591a28c7adb282554e5b168,0,0,0,0,0,0,0,0,0,0,0,0,0.0,0,367,0,0,0,0,0,0,0,0,0,0,0,100.0,NoArch
8431717af65b233ac71efb38af42024e183e5cf6,0,0,0,0,0,0,0,0,0,0,0,0,0.0,0,46,6,0,0,0,0,0,0,0,0,0,1,100.0,NoArch
388e659a17d23cba75afd93336181f768248efa3,0,0,0,0,0,0,0,0,0,0,0,0,0.0,0,1254,27,0,0,0,0,0,0,0,0,0,0,100.0,NoArch
73b8f102f6064edfa83ea98ea643d372c150c13e,0,0,0,0,0,0,0,0,0,0,0,0,0.0,0,1244,25,0,0,0,0,0,0,0,0,0,1,100.0,NoArch
b1564e34aa4ce5ae9ed412cc8e36858acff1855a,0,0,0,0,0,0,0,0,0,0,0,0,0.0,0,0,0,0,0,0,0,0,0,0,0,0,0,100.0,NoArch
f0fcef7e670ad64e55f37edcb723311ef49d323b,2,4,4,0,0,0,0,1,2,130,1,2,0.811278124,671,51,2,85,85,0,2720,2720,0,34,34,0,1,100.0,NoArch
0bbebeae7056349b23ef04d58632d7d69cd10068,0,0,0,0,0,0,0,0,0,0,0,0,0.0,0,1035,11,0,0,0,0,0,0,0,0,0,0,100.0,NoArch
e1f58d5f3dfd45ff407d3dc9ebaeeafb4bf2b6e5,1,14,0,14,0,0,0,2,24,120,1,1,0.0,722,982,10,68,66,2,3651,3585,66,13,13,0,1,100.0,NoArch
4cb8909336a5d7eb17e4e444bc9deeffa80426ba,5,316,0,316,5,0,5,1,1,0,2,2,2.313574153,0,5,2,10,0,10,831,0,831,10,0,10,0,99.46860854,NoArch
01ae5291a8fe1fc05e1a079a6e3b7790d2d45297,2,34,12,22,0,0,0,1,2,42,1,1,0.932111568,683,1217,29,97,94,3,3700,3542,158,31,29,2,1,100.0,NoArch
8b952b8d591512909a095bc0971ac87ea40e67c6,0,0,0,0,0,0,0,0,0,0,0,0,0.0,0,65,65,0,0,0,0,0,0,0,0,0,0,100.0,NoArch
79660d03ac5cad9808ef0446330f6fd466630fe1,0,0,0,0,0,0,0,0,0,0,0,0,0.0,0,37,37,0,0,0,0,0,0,0,0,0,0,100.0,NoArch
5db4951ffb0216cc82d09b3b8dff2f4721ee40a2,1,1,19,18,0,0,0,8,21,0,1,1,0.0,123,1,1,8,10,2,424,494,70,5,5,0,0,100.0,NoArch
6cf17fd8fa0dba2bc59ee2d1fe59071c9c99b6f9,0,0,0,0,0,0,0,0,0,0,0,0,0.0,0,68,5,0,0,0,0,0,0,0,0,0,1,100.0,NoArch
2049ab9e804bf07bafb13bb29962fbaf2b2840dc,0,0,0,0,0,0,0,0,0,0,0,0,0.0,0,925,32,0,0,0,0,0,0,0,0,0,1,100.0,NoArch
a31d5b0323c7d7f6111062d6e56144a85c9798e0,0,0,0,0,0,0,0,0,0,0,0,0,0.0,0,1,1,0,0,0,0,0,0,0,0,0,0,100.0,NoArch
ffc8cc20ca3bf0d43495881b90871b656d189df9,2,21,6,15,0,0,0,6,11,0,1,1,0.503258335,291,1,1,40,40,0,1671,1564,107,18,18,0,0,100.0,NoArch
26f1e817449a97af5cea35183494df45c05a03fd,0,0,0,0,0,0,0,0,0,0,0,0,0.0,0,103,2,0,0,0,0,0,0,0,0,0,0,100.0,NoArch
d1935f2d2660967a6afc210f7838b359b8cc4fb6,0,0,0,0,0,0,0,0,0,0,0,0,0.0,0,128,128,0,0,0,0,0,0,0,0,0,0,100.0,NoArch
bca95f0f6295afd3ba0f48e6cfa67e8104547b9d,1,11,0,11,0,0,0,2,7,62,1,1,0.0,245,1153,7,22,21,1,1149,1055,94,11,11,0,1,99.70991561,NoArch
a54c02e3f35365467ed28122621ebaecb271a58f,1,2,2,0,0,0,0,3,11,59,1,1,0.0,300,1262,25,38,38,0,1498,1498,0,10,10,0,1,100.0,NoArch
fbcb4e967c8a0705a93d8bfa25b0e29888ec6737,0,0,0,0,0,0,0,0,0,0,0,0,0.0,0,1,1,0,0,0,0,0,0,0,0,0,0,100.0,NoArch
9213ff2ea07ec7c97822151b84e9a308ed6289fd,1,3,2,1,0,0,0,4,15,0,1,1,0.0,116,90,90,11,11,0,549,533,16,2,2,0,0,100.0,NoArch
2d36e2a42090ac47bf0bdf9f83c5c14cdae47904,0,0,0,0,0,0,0,0,0,0,0,0,0.0,0,2632,20,0,0,0,0,0,0,0,0,0,0,100.0,NoArch
a25a535e281e47a197e2019aa65199c956c6b184,0,0,0,0,0,0,0,0,0,0,0,0,0.0,0,4,4,0,0,0,0,0,0,0,0,0,0,100.0,NoArch
631f1c76116d11ce2c6c46a801ef1fed08211908,1,0,7,7,0,0,0,1,2,0,1,1,0.0,97,44,1,2,2,0,529,529,0,2,2,0,1,100.0,NoArch
c1deb6233acbe18ba4a0bb38d4c9f439cef62936,0,0,0,0,0,0,0,0,0,0,0,0,0.0,0,131,3,0,0,0,0,0,0,0,0,0,0,100.0,NoArch
1df9413fd426cdae775568f9f4b54658fd1d17b4,1,82,11,71,0,0,0,2,7,210,1,1,0.0,246,1009,19,46,31,15,1489,1101,388,7,5,2,1,100.0,NoArch
40f1082cfaf14bd9f0276f21b9211c1ff8f7cc92,0,0,0,0,0,0,0,0,0,0,0,0,0.0,0,72,1,0,0,0,0,0,0,0,0,0,1,100.0,NoArch
95ee8908370744153531aa2e80a9bce93dc5d9bc,5,61,13,48,0,0,0,3,24,0,4,5,2.035504841,1987,1,1,245,239,6,9346,8986,360,110,108,2,1,100.0,NoArch
d204f02f62d5699786b17189b9bc5827c2bd4b0f,0,0,0,0,0,0,0,0,0,0,0,0,0.0,0,92,0,0,0,0,0,0,0,0,0,0,1,100.0,NoArch
b1482a3cb420c12544cc9a574da63c9ef9b78b82,2,30,12,18,0,0,0,1,33,0,1,2,0.829607103,1124,950,28,141,139,2,5686,5606,80,58,56,2,0,100.0,NoArch
2ffb15c84aa1152f6c6982c165f7a10c93d978de,0,0,0,0,0,0,0,0,0,0,0,0,0.0,0,0,0,0,0,0,0,0,0,0,0,0,0,100.0,NoArch
79e6e17f7f39aaa8acf279a35b3539f78acaa34d,1,1,1,0,0,0,0,2,4,0,1,1,0.0,119,2625,13,15,15,0,663,663,0,8,8,0,0,100.0,NoArch
712199a004663ef15d6cffb19fa2e87dbe2a02fa,0,0,0,0,0,0,0,0,0,0,0,0,0.0,0,61,0,0,0,0,0,0,0,0,0,0,0,100.0,NoArch
b8f066e77c8e3816b85457e75bf3cdbe3bda1d27,0,0,0,0,0,0,0,0,0,0,0,0,0.0,0,86,13,0,0,0,0,0,0,0,0,0,1,100.0,NoArch
b05b99a663c44c445469589e8b62967ee74daf0c,0,0,0,0,0,0,0,0,0,0,0,0,0.0,0,43,43,0,0,0,0,0,0,0,0,0,0,100.0,NoArch
d14aa05699c6c5672ff28347a6a289d7ca357702,1,38,0,38,1,0,1,1,1,0,1,1,0.0,0,2,2,4,0,4,269,0,269,2,0,2,0,99.95936611,NoArch
38d44c6e57540463414a6cc423e5aa3099b5cc30,0,0,0,0,0,0,0,0,0,0,0,0,0.0,0,59,0,0,0,0,0,0,0,0,0,0,0,100.0,NoArch
3b1181b87e501bbf9b46a61a94dc7a54af790ede,1,1,4,3,0,0,0,3,24,0,1,1,0.0,765,1120,7,96,96,0,3360,3382,22,19,19,0,0,99.94189425,NoArch
b77616c591cbbbf1f9719269810d6bb20569aa2b,1,1,1,0,0,0,0,4,9,0,1,1,0.0,129,2,2,16,16,0,708,708,0,8,8,0,0,100.0,NoArch
1a920c765e9b6d18c4ce5c52f77e4a37dffc649e,0,0,0,0,0,0,0,0,0,0,0,0,0.0,0,0,0,0,0,0,0,0,0,0,0,0,0,100.0,NoArch
ac931c7c67a6a7fc4edc1972b3a854c96c7b127b,0,0,0,0,0,0,0,0,0,0,0,0,0.0,0,0,0,0,0,0,0,0,0,0,0,0,0,100.0,NoArch
d14aa05699c6c5672ff28347a6a289d7ca357702,1,38,0,38,1,0,1,1,1,0,1,1,0.0,0,2,2,4,0,4,269,0,269,2,0,2,0,99.95936611,NoArch
9a162b5be13bc287a3d90a6e89a7599d87871a8d,0,0,0,0,0,0,0,0,0,0,0,0,0.0,0,51,51,0,0,0,0,0,0,0,0,0,0,100.0,NoArch
7c7cf365f22b9172fc843b32e76e28379e0a7fbe,0,0,0,0,0,0,0,0,0,0,0,0,0.0,0,1,1,0,0,0,0,0,0,0,0,0,0,100.0,NoArch
65a22d7f66caa681b49e57e731114fd19c5a93fd,0,0,0,0,0,0,0,0,0,0,0,0,0.0,0,1162,14,0,0,0,0,0,0,0,0,0,0,100.0,NoArch
4ff27db4f9111fbd4268d66b8f18dd44b61df0ee,1,3,3,0,0,0,0,10,21,0,1,1,0.0,360,14,1,26,26,0,2214,2214,0,14,14,0,1,100.0,NoArch
9be3468e2646949dd0b73d63cc4b1b73bd8300fb,8,81,4,77,0,0,0,2,361,114,1,6,1.156722722,3851,958,14,410,391,19,16627,16096,531,144,138,6,1,99.84467226,NoArch
3b21386c3f1ab85060f6c950fb2fb17123df8647,2,75,5,70,0,0,0,11,20,40,2,2,0.999549111,1094,340,3,189,171,18,5046,4780,266,54,50,4,1,100.0,NoArch
a748596cd8e3d60bbba8b9a9ea775ad05a1b5ff0,0,0,0,0,0,0,0,0,0,0,0,0,0.0,0,23,0,0,0,0,0,0,0,0,0,0,1,100.0,NoArch
5cf6d6b53dffe56cd21a0d1df6cfa2c11a69ce8d,0,0,0,0,0,0,0,0,0,0,0,0,0.0,0,36,2,0,0,0,0,0,0,0,0,0,1,100.0,NoArch
15745d0a63e84f987ea9c892a139564c5c557439,0,0,0,0,0,0,0,0,0,0,0,0,0.0,0,39,39,0,0,0,0,0,0,0,0,0,0,100.0,NoArch
ed4f6d1094d309d3325ca08aa2c499691933c16a,3,235,5,230,1,0,1,2,48,18,1,2,0.583206835,1476,959,8,220,190,30,8113,7495,618,69,40,29,1,99.93800372,NoArch
feac8c655c59cc5631ed726027f7d0a053c78aaa,0,0,0,0,0,0,0,0,0,0,0,0,0.0,0,1,1,0,0,0,0,0,0,0,0,0,0,100.0,NoArch
5528ca760ce2cef035c44c60b24e64421ecb9fe3,0,0,0,0,0,0,0,0,0,0,0,0,0.0,0,83,83,0,0,0,0,0,0,0,0,0,0,100.0,NoArch
89b4de72bd65b4271b68b0a427ef31134b2e0916,0,0,0,0,0,0,0,0,0,0,0,0,0.0,0,50,50,0,0,0,0,0,0,0,0,0,0,100.0,NoArch
9d137583dd35358ea473a30536a0eab4686150ca,1,13,1,12,0,0,0,3,8,187,1,1,0.0,112,969,4,11,7,4,569,491,78,2,2,0,1,100.0,NoArch
7dcb4c7cdf872e8c4e073a02782925b62828f47a,0,0,0,0,0,0,0,0,0,0,0,0,0.0,0,1020,6,0,0,0,0,0,0,0,0,0,0,100.0,NoArch
99953a44f164e5d23053ec97fee1c9b7a31d93cc,0,0,0,0,0,0,0,0,0,0,0,0,0.0,0,84,11,0,0,0,0,0,0,0,0,0,1,100.0,NoArch
5cdb8332f99a36e5a1da202da43e3c7dfbb49322,1,16,11,5,0,0,0,26,114,130,1,1,0.0,1514,61,1,204,202,2,7549,7532,17,47,47,0,1,100.0,NoArch
c3d69ec5b58bae85a33e6ea509945c04357bd346,0,0,0,0,0,0,0,0,0,0,0,0,0.0,0,2,2,0,0,0,0,0,0,0,0,0,0,100.0,NoArch
2297cc500772b20b7748376dc5e9bf8568d83288,0,0,0,0,0,0,0,0,0,0,0,0,0.0,0,62,62,0,0,0,0,0,0,0,0,0,0,100.0,NoArch
f8c8aa5fa120464fc4d4c146baaeea2151a402e4,0,0,0,0,0,0,0,0,0,0,0,0,0.0,0,24,1,0,0,0,0,0,0,0,0,0,0,100.0,NoArch
0c20759680cd42f10ad9e96b79025cd7ec615475,3,12,2,10,0,0,0,2,44,21,2,3,1.378783493,2214,1086,38,200,198,2,13377,13323,54,142,142,0,1,100.0,NoArch
9decf532e79d7d22082ca8f9e2d6989ff83ae421,0,0,0,0,0,0,0,0,0,0,0,0,0.0,0,351,8,0,0,0,0,0,0,0,0,0,1,100.0,NoArch
3a465e14779483c1c4f0be552298f5d2b232a29b,0,0,0,0,0,0,0,0,0,0,0,0,0.0,0,1,1,0,0,0,0,0,0,0,0,0,1,100.0,NoArch
f1aa5485a471badc7776ccef729a6a96d64cf302,1,1,2,1,0,0,0,7,15,566,1,1,0.0,39,66,2,0,0,0,95,108,13,0,0,0,0,100.0,NoArch
e7654f610a2a1d8400b215ba3f2f9eaa1fbd6fd5,0,0,0,0,0,0,0,0,0,0,0,0,0.0,0,85,12,0,0,0,0,0,0,0,0,0,1,100.0,NoArch
d3a389b57d0c41f1dfc38a84fb43d4b208e00bc2,0,0,0,0,0,0,0,0,0,0,0,0,0.0,0,23,23,0,0,0,0,0,0,0,0,0,0,100.0,NoArch
557c8f95c6a0d4cd42781db034959b8192e399f6,0,0,0,0,0,0,0,0,0,0,0,0,0.0,0,20,20,0,0,0,0,0,0,0,0,0,0,100.0,NoArch
8b03e3220090144aac8941ca1a8e8b3f181f4d0a,0,0,0,0,0,0,0,0,0,0,0,0,0.0,0,49,0,0,0,0,0,0,0,0,0,0,1,100.0,NoArch
9483d5ca433149a64f9d197d86d8cc6b841edff1,0,0,0,0,0,0,0,0,0,0,0,0,0.0,0,0,0,0,0,0,0,0,0,0,0,0,0,100.0,NoArch
1c12bf655d17151ae5562662bb7cd0f004341fcb,1,1,1,0,0,0,0,2,2,10765,1,1,0.0,42,40,6,2,2,0,59,57,2,2,2,0,1,100.0,NoArch
fa8c70ad8269797edd9f8f7419a7162463d06131,0,0,0,0,0,0,0,0,0,0,0,0,0.0,0,84,84,0,0,0,0,0,0,0,0,0,0,100.0,NoArch
1abc9c1e9ae3a59162f8c0d60a5bbafc712232bb,1,47,6,41,0,0,0,4,80,4,1,1,0.0,542,1216,32,54,48,6,3120,2885,235,15,14,1,1,100.0,NoArch
0c78c31304c52416ac4829fbf7f7e1166757dfda,0,0,0,0,0,0,0,0,0,0,0,0,0.0,0,1025,8,0,0,0,0,0,0,0,0,0,0,100.0,NoArch
16dd31aba109f5b02269df1ecdebe30f83172f12,0,0,0,0,0,0,0,0,0,0,0,0,0.0,0,1,0,0,0,0,0,0,0,0,0,0,1,100.0,NoArch
5c9512fd8c59a8611381529ce1c32e07cb91f16c,1,5,2,3,0,0,0,6,10,841,1,1,0.0,59,0,0,2,2,0,301,280,21,2,2,0,1,100.0,NoArch
ef8c95eb397651e10f677763dfcd9c8cea7c27b0,1,1,1,0,0,0,0,8,17,58,1,1,0.0,618,79,0,34,34,0,3529,3529,0,29,29,0,1,100.0,NoArch
750cb6cb15c8f8d272ae3dc071f9f5377c441baf,0,0,0,0,0,0,0,0,0,0,0,0,0.0,0,147,15,0,0,0,0,0,0,0,0,0,1,100.0,NoArch
8eda091d4e2231eee3c33b4e9d417d62971d0762,10,216,216,0,0,0,0,2,17,4079,4,8,2.222001695,1246,104,4,60,60,0,4940,4940,0,51,51,0,0,100.0,NoArch
a3bcfe7d116922ce5f627acbe049a20c66747510,1,1,1,0,0,0,0,2,42,11,1,1,0.0,735,1077,35,109,109,0,3861,3861,0,25,25,0,1,100.0,NoArch
06842d6b961a81e79a3f0cd86a0507e9afa2766f,1,5,16,11,0,0,0,3,3,3088,1,1,0.0,313,87,14,8,11,3,2324,2385,61,8,8,0,1,100.0,NoArch
05b748ff6aa15aa63a9c9d5f9f5679f47bf9e83d,3,9,6,3,0,0,0,4,4,7289,1,2,1.338268928,231,116,4,22,22,0,971,930,41,10,10,0,1,100.0,NoArch
c18b8872de1d1da37ec33186c92091d60edc34e1,2,4,12,8,0,0,0,4,363,211,2,2,1.0,2655,1006,23,301,302,1,9467,9477,10,111,112,1,1,100.0,NoArch
a123fce49521cf988d99a3450a9f0c549e0077f3,1,18,13,5,0,0,0,1,6,669,1,1,0.0,112,1069,31,11,11,0,439,445,6,5,4,1,0,100.0,NoArch
1b157097df47256ce60973a5cbd14283dd805605,1,1,1,0,0,0,0,6,100,12,1,1,0.0,2115,1060,24,344,343,1,8287,8283,4,173,173,0,0,100.0,NoArch
95022ebf3615e3f2bb9727912a834ff305ce6301,0,0,0,0,0,0,0,0,0,0,0,0,0.0,0,1074,34,0,0,0,0,0,0,0,0,0,1,100.0,NoArch
f87fea9589ad78bd856817da3c843bce3d030329,0,0,0,0,0,0,0,0,0,0,0,0,0.0,0,1249,24,0,0,0,0,0,0,0,0,0,1,100.0,NoArch
6c37a89744149e68f198429fb7eac70fe1707360,144,7242,3137,4105,37,4,41,1,290,281,5,35,6.244934608,27003,1187,9,3257,2861,396,131149,111421,19728,1491,1313,178,1,92.07556428,Arch
0ce5541bb5c92b87e2425efceee1aad53f415128,17,224,242,18,0,0,0,3,379,131,2,6,3.065379102,3890,1226,23,376,369,7,18194,18213,19,150,153,3,1,97.97833935,Arch
3f677ab042097232b88adb166dc3df13f2a49e55,1,0,32,32,0,0,0,2,16,224,1,1,0.0,155,931,30,8,13,5,572,720,148,6,11,5,0,95.50775071,Arch
2ae3616c3f346a85111f790cdec235f78b92edab,1,0,32,32,0,0,0,1,2,56,1,1,0.0,155,932,31,8,13,5,572,720,148,6,11,5,0,95.40703199,Arch
bd1f3b58e5de42ab2cd1122793b805c2551777a7,3,84,40,44,0,0,0,6,369,33,1,3,1.568127033,4414,1047,16,620,614,6,18022,17879,143,244,242,2,1,95.25820071,Arch
83237e46af5654c51c5c9005b054c1ffa01e327d,81,7614,2203,5411,60,0,60,7,371,83,3,12,5.230153931,8587,6,0,1390,945,445,57453,36036,21417,667,358,309,1,89.3666473,Arch
91e83d242486046a7612fee6d08be568768deaa2,14,286,289,3,3,2,5,1,373,98,1,6,3.192023026,2214,1088,37,200,201,1,9234,9358,124,54,71,17,0,94.48275862,Arch
2339e167506a3e0cdc33513f2905343564f16976,10,183,139,44,1,0,1,1,374,20,1,5,2.447585059,1618,15,9,135,134,1,8174,8086,88,58,57,1,0,93.0277244,Arch
1248bd1c1fb89d4a486d7ade29a80a5cb1845d78,9,297,175,122,1,0,1,1,376,26,1,4,1.755961089,2338,19,8,238,234,4,11080,10641,439,66,62,4,1,93.56823266,Arch
9be1144e4ef4dd01b4a7c7c164e2810ee903dd75,2,13,25,12,0,0,0,2,14,2862,1,2,0.0,396,1137,10,49,53,4,1881,1987,106,26,28,2,1,95.0764526,Arch
d3965e9cbf8e1f818a74a704e8c8616a4cc32a74,2,186,144,42,1,0,1,1,5,14,1,2,0.990413773,271,1147,2,33,33,0,1147,998,149,29,29,0,1,92.90082425,Arch
c6aab7be9f97879d00f7f4c36452c5d3bebaa020,28,152,104,48,1,0,1,1,40,35,2,8,1.22693272,2852,1151,5,203,202,1,8685,8580,105,84,83,1,0,94.53634085,Arch
6c37a89744149e68f198429fb7eac70fe1707360,144,7242,3137,4105,37,4,41,1,290,281,5,35,6.244934608,27005,1187,9,3257,2861,396,131149,111421,19728,1491,1313,178,1,92.07556428,Arch
0ce5541bb5c92b87e2425efceee1aad53f415128,17,224,242,18,0,0,0,3,379,131,2,6,3.065379102,3894,1226,23,376,369,7,18194,18213,19,150,153,3,1,97.97833935,Arch
2339e167506a3e0cdc33513f2905343564f16976,10,183,139,44,1,0,1,1,374,20,1,5,2.447585059,1616,15,9,135,134,1,8174,8086,88,58,57,1,0,93.0277244,Arch
d2510749d8c6677e8aa5db84f15a6e0075bab840,12,507,62,445,6,1,7,1,195,667,4,6,3.106155365,2630,0,0,337,308,29,14307,12948,1359,96,73,23,1,95.00520291,Arch
b962ff361aee64a291db588e9f88d86c5f9dee0c,19,145,58,87,0,0,0,12,22,4477,3,14,4.026299342,3510,11,0,275,270,5,17748,17424,324,184,176,8,1,97.37737738,Arch
f6c07d9358252bb4e9b0ad13c2729c6a42d0a4e8,2,369,60,309,1,0,1,1,9,32,1,2,0.908688278,486,2,0,84,69,15,4124,2339,1785,25,11,14,2,94.31578947,Arch
e183080273a5de9cead0c0622bb5dce7ab9308d0,133,1018,4350,3332,2,24,26,0,383,1170,9,61,6.029763052,35328,0,0,3439,3654,215,146233,159735,13502,1395,1551,156,1,94.08099688,Arch
0f519b4af49a5c4484b193cb445dfd63e470ebdc,19,145,58,87,0,0,0,12,22,4719,3,14,4.026299342,3510,11,0,275,270,5,17748,17424,324,184,176,8,1,97.37737738,Arch
4bdbc9bd80887af2fd02bacddd54dc48dcc44718,2,369,60,309,1,0,1,1,9,0,1,2,0.908688278,486,2,0,84,69,15,4124,2339,1785,25,11,14,2,94.31578947,Arch
a5b292ddf8042b75d5707024dbe69c53bb2bfd5b,10,738,164,574,6,0,6,3,33,481,1,5,2.776688524,1218,9,0,141,109,32,8727,6310,2417,70,54,16,1,94.04024768,Arch
bb916d0784c7631866167928e4d0615df3317567,214,3561,2512,1049,6,0,6,3,82,2954,16,66,6.524148887,30675,7,0,1651,1709,58,152501,144966,7535,1451,1466,15,1,97.08542714,Arch
e2891667dda38857ce0b269c0fb097408cca2eea,566,7558,18554,10996,35,88,123,0,383,1680,16,186,7.921283019,101596,73,0,9067,9718,651,386466,432936,46470,4208,4708,500,0,88.72336023,Arch
d87a1f5325488f51077619e0410b5d3d16f63f61,566,18560,7564,10996,88,35,123,3,385,2647,16,186,7.921169016,90600,118,1,9718,9070,648,432889,386550,46339,4708,4209,499,1,88.72336023,Arch
09f77da9b0c39848fe763bdd4a392151eec0d8c3,566,7558,18554,10996,35,88,123,0,383,1680,16,186,7.921283019,101596,75,2,9067,9718,651,386466,432936,46470,4208,4708,500,1,88.72336023,Arch
612dfddd26fbb4a403b027b9c246f8f11ccea7d9,566,18560,7564,10996,88,35,123,3,385,2647,16,186,7.921169016,90600,338,2,9718,9070,648,432889,386550,46339,4708,4209,499,1,88.72336023,Arch
e5f6634e17362387282b3867c9b23d4b54fea871,566,7565,18631,11066,35,88,123,0,383,1680,16,186,7.924875403,101666,323,1,9067,9736,669,386466,433208,46742,4208,4712,504,0,88.72336023,Arch
1e198050975b80f48c835ef51045c5bd9f835217,566,18575,7604,10971,88,35,123,3,385,2642,16,186,7.917735134,90679,119,2,9736,9088,648,433083,386822,46261,4712,4213,499,1,88.72336023,Arch
6aa1f4acf5d6323e9aa08b763cb9933dc96749b9,566,7600,18571,10971,35,88,123,0,383,1689,16,186,7.917709114,101650,56,0,9085,9736,651,386738,433130,46392,4212,4712,500,0,88.72336023,Arch
a02834611bad3442ad073b10f1dee2322916f1f3,566,18583,7599,10984,88,35,123,3,385,2642,16,186,7.91754,90679,15,1,9738,9088,650,433140,386822,46318,4712,4213,499,1,88.72336023,Arch
a46906806a31edb462b935e380a657b6efde6231,568,7617,18961,11344,35,90,125,0,383,1685,16,186,7.920919445,102023,327,5,9085,9774,689,386738,434601,47863,4212,4736,524,0,88.59032658,Arch
1ab29f548535cb512d0e4726308b32fe4284e6ba,568,18965,7621,11344,90,35,125,3,385,2624,16,186,7.920950799,90704,343,6,9776,9090,686,434694,386947,47747,4738,4215,523,1,88.59032658,Arch
05c21c65bdfed0f71a2f2ada8b84da59348c4c5d,568,7633,18973,11340,35,90,125,0,383,1693,16,186,7.918921472,102044,58,2,9087,9773,686,386863,434750,47887,4214,4738,524,0,88.59032658,Arch
7c742c298b60f60b1f8b92e43e4952ee128a4cd0,568,19006,7643,11363,90,35,125,3,385,2624,16,186,7.916498933,90704,17,2,9777,9090,687,434850,386947,47903,4740,4215,525,1,88.59032658,Arch
22954a04ffb631fefbf0e75cd056840d1248954a,30,0,0,0,0,0,0,1,1,0,1,7,0.0,3610,347,4,295,295,0,10952,10952,0,200,200,0,1,97.69304099,Arch
e25cf17d3be614b52eff677ff075bbb620f07160,36,147,88,59,0,0,0,1,19,46,3,8,4.499448791,4467,349,6,353,353,0,14237,14101,136,235,235,0,1,97.71428571,Arch
fbec4e7b3dbd68905d29b61e7c72019850b92da3,571,7688,19282,11594,35,92,127,0,383,1693,16,183,7.929728983,102379,76,0,9095,9792,697,387103,436102,48999,4218,4748,530,1,88.55246786,Arch
fc806a25eb2aa22d15c5fd1b7a31f52c7202112e,573,19295,7779,11516,92,36,128,5,385,2622,16,183,7.935918713,91010,121,0,9795,9103,692,436949,388450,48499,4751,4224,527,1,88.45829823,Arch
cfe05372b76217f0439e153e5b29053620e591a0,576,7818,19635,11817,36,94,130,0,383,1654,16,185,7.951618181,103022,329,0,9117,9839,722,389076,439154,50078,4226,4771,545,1,88.31196132,Arch
a20230829c1624cfea89caef87d7b213f51971d6,576,19719,7845,11874,94,36,130,5,385,2605,16,185,7.956045534,91205,16,0,9843,9120,723,439531,389160,50371,4774,4227,547,1,88.31196132,Arch
d6c9614fa922027be8453c507c948f3727a91327,576,7837,19711,11874,36,94,130,0,383,1654,16,185,7.956574552,103079,330,1,9117,9843,726,389076,439563,50487,4226,4774,548,1,88.31196132,Arch
12f3e7e878e3a22a696f7ba9b5c615d520807afb,574,19324,7855,11469,92,36,128,5,385,2602,15,184,7.955218974,91205,112,0,9807,9120,687,438053,389160,48893,4749,4227,522,0,88.45100105,Arch
66a43813770cd7dee9eb1ed0372e3f784ba0c541,574,7882,19312,11430,36,92,128,0,383,1712,15,184,7.95697215,102680,19,0,9119,9807,688,389351,438167,48816,4227,4749,522,1,88.42504744,Arch
cbaf7f7b48c35867142e83f3573e51724ebe6ae5,570,19229,7844,11385,92,36,128,5,385,2581,15,183,7.948880786,90761,123,1,9758,9082,676,436216,387792,48424,4721,4203,518,0,88.42504744,Arch
5a8997312680a4b9c69a129801524691bc546c08,570,7866,19218,11352,36,92,128,0,383,1762,15,183,7.948810366,102146,8,0,9084,9758,674,387921,436247,48326,4203,4721,518,2,88.42504744,Arch
b551be7445d37e4ba99bf4b976f7c61d6ac52ed8,567,19110,7823,11287,92,36,128,5,385,2582,15,183,7.939783945,90215,124,1,9664,9000,664,433521,385706,47815,4703,4189,514,0,88.42504744,Arch
8b693cc992ff4a5947babecd222fbebf7516e677,567,7813,19098,11285,36,92,128,0,383,1783,15,183,7.939930451,101502,82,5,8997,9664,667,385622,433552,47930,4188,4703,515,0,88.42504744,Arch
78fc3734f9325be818b1bf4aa9fc7d8f715a851a,567,19106,7821,11285,92,36,128,5,385,2582,15,183,7.939933793,90217,125,2,9664,9000,664,433521,385706,47815,4703,4189,514,0,88.42504744,Arch
7358b084b120e28f42b5ae37b1c298ba123e2a5e,567,7811,19096,11285,36,92,128,0,383,1783,15,183,7.940275111,101502,83,6,8997,9664,667,385622,433552,47930,4188,4703,515,0,88.42504744,Arch
367093390e1b1bd00b7bbfb009883fb4e0ec330f,567,19106,7821,11285,92,36,128,5,385,2582,15,183,7.939933793,90217,126,3,9664,9000,664,433521,385706,47815,4703,4189,514,0,88.42504744,Arch
7b355f72235c0bd26b872601b38a493ed1cc518b,567,7811,19096,11285,36,92,128,0,383,1783,15,183,7.940275111,101502,84,7,9003,9670,667,385671,433601,47930,4188,4703,515,1,88.42504744,Arch
1fc605dd69f99e91e0685a4f4ba279d2fd2eed21,568,19121,7822,11299,92,36,128,5,385,2582,15,183,7.940463286,90413,129,6,9697,9030,667,434565,386680,47885,4711,4196,515,1,88.42504744,Arch
7a8acdd8e66de81b4f7f918905976191837bf147,567,7811,19096,11285,36,92,128,0,383,1783,15,183,7.940275111,101509,85,8,9004,9671,667,385702,433632,47930,4188,4703,515,1,88.42504744,Arch
a7010c55e17c586f4c1c790db197b982ef279020,567,19106,7821,11285,92,36,128,5,385,2582,15,183,7.939933793,90224,130,7,9671,9007,664,433601,385786,47815,4703,4189,514,1,88.42504744,Arch
0635e92665cbd247a4144c328321b0e9f058398e,567,7811,19096,11285,36,92,128,0,383,1783,15,183,7.940275111,101509,331,0,9004,9671,667,385702,433632,47930,4188,4703,515,1,88.42504744,Arch
e29a6610865f674f6d9b856c03d156074d0d2df8,556,19058,7808,11250,92,36,128,5,385,2587,15,181,7.926351263,88841,0,0,9527,8863,664,427558,379982,47576,4626,4112,514,1,88.42504744,Arch
176b272f30c4fbd62013b4702ab28518c21628ac,556,7797,19046,11249,36,92,128,0,383,1817,15,181,7.926251093,100091,0,0,8860,9527,667,379898,427589,47691,4111,4626,515,1,88.42504744,Arch
e8b9cada65dbb527a0b19119745581c6b61a22f8,556,19056,7807,11249,92,36,128,5,385,2587,15,181,7.925916847,88842,131,1,9527,8863,664,427558,379982,47576,4626,4112,514,0,88.42504744,Arch
268f9565746175f5900670e372092e0c071d85bd,556,7797,19046,11249,36,92,128,0,383,1817,15,181,7.926251093,100091,88,2,8860,9527,667,379898,427589,47691,4111,4626,515,0,88.42504744,Arch
94df4a819a773833294874c02a7f01165f8a8ccc,556,19056,7807,11249,92,36,128,5,385,2589,15,181,7.925916847,88842,133,2,9527,8863,664,427558,379982,47576,4626,4112,514,0,88.42504744,Arch
25df095829bff8a1744db7dbf1ddd14aa1f8d43f,556,7797,19046,11249,36,92,128,0,383,1817,15,181,7.926251093,100091,89,3,8860,9527,667,379898,427589,47691,4111,4626,515,1,88.42504744,Arch
2321e03a9415c8edd59f67e22174bf60ec457e66,556,19056,7807,11249,92,36,128,5,385,2589,15,181,7.925916847,88842,364,1,9527,8863,664,427558,379982,47576,4626,4112,514,1,88.42504744,Arch
c395ca976dc9eaed65dcdc0037508d1edbfb57f3,556,7797,19046,11249,36,92,128,0,383,1817,15,181,7.926251093,100091,332,1,8860,9527,667,379898,427589,47691,4111,4626,515,1,88.42504744,Arch
f582ce88fc5f6db10f631959bab5acfbe1f58bb5,556,19090,7813,11277,92,36,128,5,385,2588,15,181,7.924633487,88842,116,0,9533,8863,670,427728,379982,47746,4628,4112,516,1,88.42504744,Arch
b74199ed446c83282ad806afaf962a7f74eac0ea,556,7821,18953,11132,36,91,127,0,383,1814,15,181,7.921142825,100134,8,0,8873,9533,660,380419,427873,47454,4120,4628,508,1,89.37288772,Arch
f7a775b79a195b5649c8c0309b673a4d5bdcf1c1,556,18963,7831,11132,91,36,127,5,385,2588,15,181,7.92082538,89002,139,8,9533,8876,657,427805,380503,47302,4628,4121,507,1,89.37288772,Arch
22a8cfa05976b23284388675dcabd7e5e8037fb0,556,7821,18953,11132,36,91,127,0,383,1814,15,181,7.921142825,100134,90,4,8873,9533,660,380419,427873,47454,4120,4628,508,1,89.37288772,Arch
a2ab329edc51c1f59493babc4f0f3d4b246a0c36,556,18963,7831,11132,91,36,127,5,385,2588,15,181,7.92082538,89002,140,9,9533,8876,657,427805,380503,47302,4628,4121,507,0,89.37288772,Arch
f32eb09892686cba083f9f175b3c8eac0ac42ae7,556,7821,18953,11132,36,91,127,0,383,1814,15,181,7.921142825,100134,91,5,8873,9533,660,380419,427873,47454,4120,4628,508,1,89.37288772,Arch
021e53f62718aed169ea7927242d8790d91f94d4,556,18963,7831,11132,91,36,127,5,385,2588,15,181,7.92082538,89002,142,11,9533,8876,657,427805,380503,47302,4628,4121,507,1,89.37288772,Arch
51f6d8b8525d8bf218f70100ec99a7ae97097923,556,7821,18953,11132,36,91,127,0,383,1814,15,181,7.921142825,100134,92,6,8873,9533,660,380419,427873,47454,4120,4628,508,1,89.37288772,Arch
6c67c9d0a6b7a717a2e5718a770638b9fcc0fbe3,556,18963,7831,11132,91,36,127,5,385,2588,15,181,7.92082538,89002,143,12,9533,8876,657,427805,380503,47302,4628,4121,507,1,89.37288772,Arch
7ecdb3c970d71de3e48fe4de691388868ac03630,556,7821,18953,11132,36,91,127,0,383,1814,15,181,7.921142825,100134,93,5,8873,9533,660,380419,427873,47454,4120,4628,508,1,89.37288772,Arch
ef62d7a4bd57cdd315dfa187780790e3449321aa,556,18963,7831,11132,91,36,127,5,385,2588,15,181,7.92082538,89002,19,0,9533,8876,657,427805,380503,47302,4628,4121,507,0,89.37288772,Arch
ea98e05a04480131370aa0c110b8c54cf726c06f,558,7836,18986,11150,36,91,127,0,383,1825,15,182,7.922315775,100405,94,4,8898,9560,662,381356,428856,47500,4130,4638,508,0,89.37288772,Arch
0137f35c1bbc3a3dadd07af105df66bd1293d5e5,558,18996,7846,11150,91,36,127,5,385,2586,15,182,7.921999949,89255,150,3,9560,8901,659,428825,381440,47385,4638,4131,507,0,89.37288772,Arch
4dc115967a9ac1522fe01d33de1a3279d52a559a,558,7836,18986,11150,36,91,127,0,383,1825,15,182,7.922315775,100405,97,3,8898,9560,662,381356,428856,47500,4130,4638,508,0,89.37288772,Arch
f594c0b9166c4c54ffb148a76bd0dbc1af425529,558,19021,7845,11176,91,36,127,5,385,2586,15,182,7.921360421,89255,8,0,9563,8901,662,428994,381440,47554,4639,4131,508,1,89.37288772,Arch
547dfddb2ef02f44d9f2d0730348eaedfcd2e126,558,7835,19011,11176,36,91,127,0,383,1825,15,182,7.921674527,100431,98,0,8898,9563,665,381356,429025,47669,4130,4639,509,0,89.37288772,Arch
76d7f58a61eb6aea8d2e8b78551e5d500cc74f6e,558,19038,7848,11190,91,36,127,5,385,2587,15,182,7.922391967,89255,9,0,9564,8901,663,429090,381440,47650,4640,4131,509,1,89.37288772,Arch
c76c9d9116b4626c20abe26c025623797249f997,558,7838,19028,11190,36,91,127,0,383,1825,15,182,7.92270611,100445,3,0,8898,9564,666,381356,429121,47765,4130,4640,510,1,89.37288772,Arch
aa30d9690b7eed1674bdf9d3eb5f858dc4da1630,558,19038,7848,11190,91,36,127,5,385,2587,15,182,7.922391967,89255,153,0,9564,8901,663,429090,381440,47650,4640,4131,509,1,89.37288772,Arch
383cabf9e4992eeff36c9b5731d95bafa72398d3,558,7809,19032,11223,36,91,127,0,383,1825,15,182,7.923468664,100445,99,0,8893,9564,671,381143,429121,47978,4129,4640,511,1,89.37288772,Arch
406c525ec45da466387dbf19f7fd8ed1d9885e66,558,19042,7819,11223,91,36,127,5,385,2587,15,182,7.923152762,89222,4,1,9564,8896,668,429090,381227,47863,4640,4130,510,1,89.37288772,Arch
e08834b79e9387811ece442f6e7b445b19110fcf,558,7809,19032,11223,36,91,127,0,383,1825,15,182,7.923468664,100445,4,1,8893,9564,671,381143,429121,47978,4129,4640,511,1,89.37288772,Arch
a6e462b53a4b6c87ef43f6cfe7fbde0b0939e3d6,558,19097,7836,11261,91,36,127,5,385,2585,15,182,7.925362605,89222,1,0,9567,8896,671,429426,381227,48199,4642,4130,512,1,89.37288772,Arch
4e5b3d55545e5f03f05ac7b0cd1b56689df36201,558,7826,19043,11217,36,91,127,0,383,1829,15,182,7.924487026,100483,1,0,8896,9567,671,381493,429457,47964,4131,4642,511,1,89.37288772,Arch
6b6589bf1ca4d322716992ea4b279d0f5cbc21c0,558,19053,7836,11217,91,36,127,5,385,2585,15,182,7.924171813,89266,154,1,9567,8899,668,429426,381577,47849,4642,4132,510,1,89.37288772,Arch
1ea42b0371f1bc99a4e0629c3734ad4ccfc0dcbd,558,7826,19043,11217,36,91,127,0,383,1829,15,182,7.924487026,100483,100,1,8896,9567,671,381493,429457,47964,4131,4642,511,1,89.37288772,Arch
23ffe3349f92cd5bb9a8ba0111a7ab9761b2e72c,558,19053,7836,11217,91,36,127,5,385,2581,15,182,7.924171813,89347,18,0,9581,8913,668,429868,382019,47849,4647,4137,510,1,89.37288772,Arch
93f9e85955abb40bb090bad689f15fa9969ef9ba,558,7826,19043,11217,36,91,127,0,383,1835,15,182,7.924487026,100564,3,0,8910,9581,671,381935,429899,47964,4136,4647,511,1,89.37288772,Arch
8c297e93a3d4d4e41130b87fa24271194eabdded,558,19055,7838,11217,91,36,127,5,385,2581,15,182,7.924500133,89347,155,2,9581,8913,668,429868,382023,47845,4647,4137,510,1,89.37288772,Arch
ab54d17dc2ec355c1e002e8751739edd9a96fcc3,558,7828,19045,11217,36,91,127,0,383,1832,15,182,7.924815383,100566,0,0,8909,9580,671,381955,429915,47960,4136,4647,511,1,89.37288772,Arch
f50de4ce9edf333e844ddd3af92e34f3eac90606,558,19055,7838,11217,91,36,127,5,385,2581,15,182,7.924500133,89349,156,3,9580,8912,668,429884,382039,47845,4647,4137,510,1,89.37288772,Arch
8882a9c599013182e42f0c7c321396c23b84dbe0,558,7827,19044,11217,36,91,127,0,383,1832,15,182,7.924655692,100566,0,0,8909,9580,671,381955,429918,47963,4136,4647,511,1,89.37288772,Arch
9735fffd983d052b99feff2663d38359774df5e3,558,19054,7837,11217,91,36,127,5,385,2582,15,182,7.924340457,89349,0,0,9580,8912,668,429887,382039,47848,4647,4137,510,0,89.37288772,Arch
0a6bbb8301717d386e6588a7ea32e3e2451c7060,584,7868,20755,12887,36,114,150,0,383,1741,15,185,8.055949608,102633,10,1,8951,9674,723,383379,436033,52654,4168,4731,563,1,88.62030495,Arch
25cf1576cc9d5a94bc293fa3e79bfbd4091d5e33,584,20770,7895,12875,114,36,150,5,385,2461,15,185,8.057028641,89746,99,0,9672,8954,718,435944,383463,52481,4730,4169,561,1,88.62030495,Arch
35e5a4d71db9f3bf6490998b51ec50827caa6141,71,1133,782,351,0,0,0,2,386,1164,5,39,5.081809132,19739,22,3,2088,2047,41,93650,91041,2609,646,620,26,1,95.88809613,Arch
d75bea415457b2eba7815bb9c3e9cd4e14b47fce,1,0,9,9,0,0,0,16,98,4,1,1,0.0,484,15,10,68,69,1,1747,1789,42,7,8,1,1,96.63523757,Arch
e50d65d228fb2bda72a8b79470918b9f9649f39c,14,2,23,21,0,0,0,3,79,565,5,12,3.70346519,2460,0,0,124,124,0,12079,12322,243,97,97,0,1,97.15675271,Arch
fb5f3f5b0f36d3232b0193c1d9b33fd0b36b9601,622,9172,22691,13519,38,121,159,0,383,1785,15,190,8.178005146,108849,0,0,9666,10433,767,403960,460369,56409,4475,5072,597,1,87.68472906,Arch
ffc2b99e3eebdeba77fa0fc8ec97a469ae75d148,628,22740,9213,13527,121,38,159,5,386,2101,16,189,8.177478514,95753,1,1,10438,9685,753,460590,405021,55569,5073,4488,585,1,86.50127691,Arch
5c36bf5ef78a162cefea47ccdaf0d28e01c1426c,642,9197,22824,13627,38,121,159,0,383,1782,16,192,8.197880168,111279,106,0,9841,10606,765,409886,466327,56441,4538,5136,598,3,86.50127691,Arch
a5f1bca9efdb19b6a04db9e31101c55d40a34559,642,22857,9219,13638,121,38,159,5,386,2137,17,191,8.194236733,97652,375,8,10600,9849,751,465817,410259,55558,5130,4544,586,0,86.50127691,Arch
19c3b917b3604f93fef0583a08e70f8695d3a359,642,9197,22835,13638,38,121,159,0,383,1782,16,192,8.197864954,111290,107,0,9841,10606,765,409886,466327,56441,4538,5136,598,1,86.50127691,Arch
f43f9f8a3bcd5167e75b38c930df1d9ac9bbfa08,642,22858,9220,13638,121,38,159,5,386,2137,17,191,8.194309082,97652,2,0,10600,9849,751,465812,410259,55553,5130,4544,586,1,86.50127691,Arch
ed3279809cad6c77cd8e5c217230c612d1222d9a,642,9198,22836,13638,38,121,159,0,383,1782,16,192,8.197937052,111290,110,3,9841,10606,765,409886,466322,56436,4538,5136,598,0,86.50127691,Arch
9dbd8e73662c6a69a18ae14089cac77c31213460,642,22858,9220,13638,121,38,159,5,386,2137,17,191,8.194309082,97652,161,1,10600,9849,751,465812,410259,55553,5130,4544,586,0,86.50127691,Arch
f568170e361ee2f448227ec4c2bce5a2ab2aa99d,642,9198,22836,13638,38,121,159,0,383,1782,16,192,8.197937052,111290,111,4,9841,10606,765,409886,466322,56436,4538,5136,598,0,86.50127691,Arch
98a6c4f14c85f584e37773b86b448d36c30e0d93,642,22858,9220,13638,121,38,159,5,386,2137,17,191,8.194309082,97652,0,0,10600,9849,751,465812,410259,55553,5130,4544,586,1,86.50127691,Arch
5bc395fd08719f221e10998db13475110d510651,631,9214,21535,12321,38,110,148,0,383,1807,16,191,8.134811837,109973,11,0,9841,10560,719,409886,462816,52930,4538,5050,512,0,86.90695108,Arch
3a06530dbce82e2054afa3cc4c81631910474bd0,631,21557,9236,12321,110,38,148,5,386,2183,17,190,8.131067356,97652,25,1,10554,9849,705,462301,410259,52042,5044,4544,500,0,86.90695108,Arch
10a72f30f7bdd19e803820a215383b975a5283ce,631,9318,21535,12217,38,110,148,0,383,1810,16,191,8.134955438,109973,13,0,9852,10560,708,410407,462811,52404,4542,5050,508,1,86.90695108,Arch
33aedfc28bfa38b10cb57302b404d8597d3971db,631,21568,9255,12313,110,38,148,5,386,2183,17,190,8.131671386,97756,26,0,10563,9860,703,462772,410780,51992,5048,4548,500,1,86.90695108,Arch
6ae4f7e2c54113192fdd4b7efe8404088f21539f,631,9233,21546,12313,38,110,148,0,383,1810,16,191,8.13541107,110069,31,0,9852,10569,717,410407,463282,52875,4542,5054,512,0,86.90695108,Arch
e6287b4701f102d2069f0316ce67dcb7e225e075,631,21568,9255,12313,110,38,148,5,386,2183,17,190,8.131671386,97756,162,0,10563,9860,703,462772,410780,51992,5048,4548,500,0,86.90695108,Arch
8348d2bd0a22bf50bbbe7401ec4e848ff0f32da3,617,9233,19701,10468,38,96,134,0,383,1867,14,188,8.073387451,108224,112,0,9852,10427,575,410407,455508,45101,4542,4966,424,0,87.42138365,Arch
0a8bd727ac6d184512ce513737bb56bb840d10de,617,19723,9255,10468,96,38,134,1,386,2243,15,187,8.069368529,97756,165,3,10421,9860,561,454998,410780,44218,4960,4548,412,1,87.42138365,Arch
100b17e1d7163cd263b7ee6e372ab76b3f87dd08,617,9233,19701,10468,38,96,134,0,383,1867,14,188,8.073387451,108224,113,1,9852,10427,575,410407,455508,45101,4542,4966,424,1,87.42138365,Arch
d8445a54bb4a7f7b223afe5bd8ee06bd31e50cf4,617,19723,9255,10468,96,38,134,1,386,2243,15,187,8.069368529,97756,166,4,10421,9860,561,454998,410780,44218,4960,4548,412,0,87.42138365,Arch
e09baa8ac4fcef82baacba4a66386f7479c753d9,618,9233,19735,10502,38,96,134,0,383,1865,14,188,8.07702967,108372,114,2,9870,10455,585,410750,456034,45284,4551,4978,427,0,87.42138365,Arch
706d9319f14b507f3c3deeba4eeda1a51a531c9b,618,19729,9264,10465,96,38,134,1,386,2244,15,187,8.071131284,97815,168,6,10425,9864,561,455209,411032,44177,4964,4552,412,1,87.42138365,Arch
0f3c39b8ed1a875ec58ebe91b2b18ca8b64b2fd3,617,9221,19393,10172,38,94,132,0,383,1881,14,188,8.066341114,108227,0,0,9877,10427,550,411875,455553,43678,4558,4966,408,1,85.19299726,Arch
b4773576a8b75631cc639509d415e64ecaf3a4ef,617,19417,9246,10171,94,38,132,1,386,2235,15,187,8.061580285,98055,27,0,10420,9884,536,455030,412231,42799,4960,4564,396,1,85.21171266,Arch
b4518b5fe416a552a59e5201b4569a9bc0af3153,620,9384,19348,9964,39,96,135,0,383,1898,14,189,8.072958598,108162,16,1,9882,10426,544,412360,454872,42512,4564,4968,404,1,85.05770816,Arch
7a772fecc02082834ddbe5423376b88d09e38814,620,19373,9410,9963,96,39,135,1,386,2193,15,188,8.068269577,98198,170,5,10418,9892,526,454306,412900,41406,4960,4572,388,1,85.05770816,Arch
84cbe1ab2e22a12c2c108d1a0e5233f875475fff,620,9384,19348,9964,39,96,135,0,383,1903,14,189,8.072958598,108161,118,5,9882,10426,544,412353,454865,42512,4564,4968,404,1,85.05770816,Arch
18725ec1e05e01b06557830ae10e83bdb933ab1a,620,19374,9410,9964,96,39,135,1,386,2193,15,188,8.068175289,98197,2,0,10419,9892,527,454318,412893,41425,4960,4572,388,1,85.05770816,Arch
99de6b49ee066c102737e4cb99af4be3edb257df,620,9384,19348,9964,39,96,135,0,383,1911,14,189,8.072958598,108161,2,0,9883,10427,544,412365,454877,42512,4564,4968,404,1,85.05770816,Arch
c0a49c7396a09c3f71a8a45313047f8eb0a75663,620,19373,9409,9964,96,39,135,1,386,2193,15,188,8.068169274,98197,171,3,10419,9893,526,454318,412905,41413,4960,4572,388,1,85.05770816,Arch
72c483b52702687f5a4160e1fd317b01c03988d3,620,9384,19348,9964,39,96,135,0,383,1911,14,189,8.072958598,108161,119,2,9883,10427,544,412365,454877,42512,4564,4968,404,1,85.05770816,Arch
ab4fec0a334698ff5f1ca5957c000a44cc6efd88,620,19396,9412,9984,96,39,135,1,386,2193,15,188,8.068751823,98197,3,1,10420,9893,527,454469,412905,41564,4960,4572,388,1,85.05770816,Arch
67ff80544866aa9256624d34a6e4178c3b913996,620,9406,19362,9956,39,96,135,0,383,1908,14,189,8.073638539,108181,3,1,9887,10428,541,412523,455028,42505,4565,4968,403,1,85.05770816,Arch
9d4b2b23f03f6b8fa7b78c9d7c60d03aedf52bad,620,19387,9431,9956,96,39,135,1,386,2193,15,188,8.06885715,98225,29,2,10420,9897,523,454469,413063,41406,4960,4573,387,1,85.05770816,Arch
27755123e30d46a73ede29cef5b4c340fcdc3fab,620,9406,19361,9955,39,96,135,0,383,1906,14,189,8.073530949,108181,333,0,9887,10428,541,412523,455028,42505,4565,4968,403,1,85.05770816,Arch
dbfe8097d229083919c53fd29b0fe4b7b92cb8e0,620,19361,9434,9927,95,39,134,1,386,2185,15,188,8.070248397,98282,30,2,10422,9899,523,454662,413290,41372,4962,4575,387,1,85.14097551,Arch
83257bfde0dd5b4d391063412494957c1b7e15e8,621,9451,19357,9906,39,95,134,0,383,1905,14,189,8.078755041,108357,18,1,9927,10458,531,413477,455747,42270,4580,4982,402,1,85.12039514,Arch
6b607109d3ce045106924139e96705fe7c42172e,620,19364,9433,9931,95,39,134,1,386,2185,15,188,8.070249469,98296,31,2,10429,9906,523,454845,413444,41401,4962,4575,387,1,85.13131313,Arch
d79485ff23c9017d47424ff24da1d6dd3c414a60,620,9548,19340,9792,39,95,134,0,383,1911,14,189,8.065533429,108227,19,2,9910,10437,527,413266,455404,42138,4574,4970,396,1,85.13131313,Arch
1d473233f21b63f351ded6904f4f9f98db3faaf1,620,19365,9433,9932,95,39,134,1,386,2186,15,188,8.070201435,98435,32,2,10443,9920,523,455221,413806,41415,4969,4582,387,1,85.13131313,Arch
0a118d6e244e17cf27654ce6e17b1d3140c0967e,620,9408,19340,9932,39,95,134,0,383,1911,14,189,8.074990232,108367,334,0,9910,10451,541,413266,455780,42514,4574,4977,403,1,85.13131313,Arch
6ca13af230e9a7c6dcb0bf629d9a2676d8f833ed,620,19365,9433,9932,95,39,134,1,386,2186,15,188,8.070201435,98435,389,0,10443,9920,523,455221,413806,41415,4969,4582,387,1,85.13131313,Arch
6f141968464b4ad24e5d90f1389065141cda5e3b,620,9418,19354,9936,39,95,134,0,383,1917,14,189,8.07364961,108398,0,0,9915,10456,541,413427,455962,42535,4576,4979,403,1,85.13131313,Arch
cc51006f2973356a1046ae0757325d5e9be75327,622,19452,9506,9946,96,39,135,1,386,2184,15,188,8.078587374,99180,18,0,10517,10003,514,456850,415303,41547,5029,4642,387,2,85.05955986,Arch
2bb1228de60e805b2f864254a0b1efef7e2d7dde,625,9529,19615,10086,39,98,137,0,383,1910,14,189,8.096271628,109310,1,1,9992,10535,543,414820,458000,43180,4636,5048,412,1,85.58093347,Arch
2798ee91968b31aa444cfd7ded14ada0a9f043f4,625,19640,9554,10086,98,39,137,1,386,2151,15,188,8.091553281,99245,2,2,10529,10004,525,457585,415504,42081,5041,4645,396,1,85.58093347,Arch
395411fe3184b9692ed16bafa578b40cc0051784,625,9570,19673,10103,39,98,137,0,383,1902,14,189,8.09262868,109343,32,0,9992,10535,543,414977,458222,43245,4637,5050,413,1,85.58093347,Arch
e327be3d85918a23a5ba48d752143a6dbf8b83f7,625,19693,9582,10111,98,39,137,1,386,2153,15,188,8.091597816,99240,3,2,10527,10002,525,457693,415517,42176,5042,4645,397,1,85.58093347,Arch
d29af9018b5c80177102aaab96bd37ed5fedf26c,625,9570,19673,10103,39,98,137,0,383,1907,14,189,8.09262868,109351,3,3,9992,10535,543,415007,458252,43245,4637,5050,413,1,85.58093347,Arch
1e33a572643628e7742eda2d469e4bd04b880523,626,19698,9596,10102,98,39,137,1,386,2150,16,189,8.09409127,99538,0,0,10543,10018,525,459645,417490,42155,5057,4660,397,1,85.59237944,Arch
f0caf9c9b31e31abb91ca986fe8168867cd0ded2,626,9591,19694,10103,39,98,137,0,383,1895,15,190,8.096207391,109627,120,0,10006,10549,543,416916,460194,43278,4651,5064,413,1,85.55842095,Arch
09e51544df6bc3a3f69afb2379eabe30db2c6034,626,19701,9599,10102,98,39,137,1,386,2151,16,189,8.094027627,99524,20,0,10541,10016,525,459628,417456,42172,5056,4659,397,0,85.55842095,Arch
572d5260b9040bd063b3dc84ce51684b8379df10,626,9591,19693,10102,39,98,137,0,383,1895,15,190,8.096219381,109626,121,1,10006,10549,543,416916,460187,43271,4651,5064,413,1,85.55842095,Arch
48be53abbc7b44b045fe5039e6a5200a93f21b60,626,19701,9599,10102,98,39,137,1,386,2151,16,189,8.094027627,99524,173,1,10541,10016,525,459628,417456,42172,5056,4659,397,1,85.55842095,Arch
cfeea9dac4c5a14c846382aa7a47a7d4e5f110f5,626,9588,19693,10105,39,98,137,0,383,1894,15,190,8.096253181,109626,122,2,10006,10549,543,416895,460187,43292,4651,5064,413,0,85.55842095,Arch
e1d359aa6d7d2b1e95daa431c6259f25a4687bea,626,19701,9596,10105,98,39,137,1,386,2151,16,189,8.094061104,99521,174,2,10541,10016,525,459628,417435,42193,5056,4659,397,1,85.55842095,Arch
78ca83e2a4271421aa3fc4f8153f8f061b09d52f,626,9642,19711,10069,39,98,137,0,383,1894,15,190,8.102381648,109590,125,5,10006,10538,532,416895,460059,43164,4651,5064,413,0,85.55842095,Arch
1954d51ff2841045b4af8a515ad0719805269d8d,9,178,45,133,3,0,3,5,63,2770,1,6,2.920210813,1955,20,0,189,187,2,9475,9246,229,50,50,0,1,93.62200117,Arch
8e5676c84a782d51c4156be059b6ce9a3dc3e1e1,626,19716,9549,10167,98,38,136,1,386,2129,16,189,8.094491846,99476,390,0,10530,10011,519,459620,417072,42548,5055,4656,399,1,86.35035242,Arch
14ca7234380f81e54a5643082816048f3b6b67cf,626,9561,19715,10154,38,98,136,0,383,1929,15,190,8.096892164,109650,21,1,10002,10538,536,416662,460253,43591,4649,5063,414,1,86.37845256,Arch
97c1e4b4aa73f5851801fdf5e17f013dd46a6b3e,626,19720,9576,10144,98,38,136,1,386,2123,16,189,8.094500885,99496,34,1,10529,10012,517,459647,417202,42445,5054,4657,397,1,86.37845256,Arch
5220420212cd576725c19be09f8b351a9625d11a,626,9568,19712,10144,38,98,136,0,383,1929,15,190,8.096699665,109640,131,11,10002,10537,535,416662,460206,43544,4649,5062,413,0,86.37845256,Arch
31193cbf0c93205a63c8c7b372b09200f60e69f4,626,19724,9588,10136,98,38,136,1,386,2123,16,189,8.094726741,99507,35,2,10529,10013,516,459674,417259,42415,5054,4657,397,1,86.37845256,Arch
88d29675ae2a0998d5be134c7941e8fd6aa706bd,626,9580,19716,10136,38,98,136,0,383,1929,15,190,8.096924013,109643,335,0,10003,10537,534,416719,460233,43514,4649,5062,413,1,86.37845256,Arch
e85ff889b333b82da20b988fbb42bdbfdb814545,626,19724,9588,10136,98,38,136,1,386,2123,16,189,8.094726741,99507,391,0,10529,10013,516,459674,417259,42415,5054,4657,397,1,86.37845256,Arch
f7b073f3eb88e4e82d5ec10a91d2bf6b442c03c6,626,9580,19716,10136,38,98,136,0,383,1937,15,190,8.096924013,109639,0,0,10003,10537,534,416705,460219,43514,4649,5062,413,1,86.37845256,Arch
896c707d324330d7d4ad92674187923945efcda9,628,19823,9729,10094,98,38,136,1,386,2127,16,190,8.103270019,99830,104,0,10539,10048,491,460551,418170,42381,5073,4674,399,1,86.37845256,Arch
c604db3c3a103e2212f4628d8e2a997017fe579e,626,9566,19665,10099,38,98,136,0,383,1948,15,190,8.094426441,109605,78,0,9990,10521,531,416868,460180,43312,4652,5062,410,1,86.37845256,Arch
d14bb3b8d34723cadd139bc4e5c3e3efdfbf68b8,626,19673,9574,10099,98,38,136,1,386,2117,16,189,8.092223899,99506,19,0,10513,10000,513,459621,417408,42213,5054,4660,394,1,86.37845256,Arch
263cf9542b4f137c59ab19fb4fae9f0d61ce2afa,627,9702,19668,9966,39,98,137,0,383,1923,15,190,8.100030391,109605,6,1,10002,10521,519,417394,460180,42786,4660,5062,402,2,86.43457383,Arch
bdb35f2deb01148eb56edc49f1c21ee0ffd6d694,626,19685,9581,10104,98,38,136,1,386,2119,16,189,8.092660317,99533,20,1,10515,10002,513,459859,417623,42236,5056,4662,394,2,86.46887326,Arch
08dff22a41e79c0da5fdda3f61699c788001b608,626,9574,19678,10104,38,98,136,0,383,1930,15,190,8.09483969,109637,7,2,9992,10523,531,417083,460418,43335,4654,5064,410,1,86.46887326,Arch
c99028b9fb67158edc9f202ff8a178c9465430ba,627,19801,9584,10217,98,38,136,1,386,2124,16,189,8.097906847,99630,2,0,10541,10013,528,460751,417930,42821,5064,4667,397,1,86.46887326,Arch
ff0300b7cfdb983fd4c54c60d956cbee79412849,626,9574,19678,10104,38,98,136,0,383,1925,15,190,8.09483969,109637,1,0,9992,10523,531,417085,460420,43335,4654,5064,410,1,86.46887326,Arch
be2b7f890d98af20eb0753650b6605a68a97ac05,626,19686,9583,10103,98,38,136,1,386,2119,16,189,8.092628264,99569,21,2,10518,10005,513,460032,417801,42231,5056,4662,394,1,86.46887326,Arch
3c6009cbf48f78bc8f657c1eb18fa8f522a994a5,626,9583,19684,10101,38,98,136,0,383,1925,15,190,8.094829435,109672,336,0,9995,10526,531,417274,460591,43317,4654,5064,410,1,86.46887326,Arch
643d1e782800e52bc2b8a85aa949e1c62b8f980a,626,19686,9583,10103,98,38,136,1,386,2119,16,189,8.092628264,99571,392,0,10518,10005,513,460045,417814,42231,5056,4662,394,1,86.46887326,Arch
85caf98029e43066579fc671f3138ea17e473224,626,9575,19678,10103,38,98,136,0,383,1925,15,190,8.094828776,109675,9,4,9995,10526,531,417274,460604,43330,4654,5064,410,1,86.46887326,Arch
3fef9c685d194a9aab2875e6c0ddfb850931b62d,626,19686,9583,10103,98,38,136,1,386,2119,16,189,8.092628264,99572,23,2,10518,10005,513,460045,417814,42231,5056,4662,394,1,86.46887326,Arch
4c9dc5abb20a5af134f507bcce05929dd3fca2a8,622,9570,19139,9569,38,93,131,0,383,1976,15,189,8.067564548,109224,11,3,9995,10482,487,417498,458902,41404,4654,5039,385,1,86.73172402,Arch
bdfd8de968d237f1a52008da1551aed43aa61a4b,622,19147,9578,9569,93,38,131,1,386,2139,16,188,8.065322467,99655,24,3,10474,10005,469,458333,418038,40295,5031,4662,369,0,86.73172402,Arch
28c763c72cf94ad13e235f985244764f7fd0c988,623,9578,19149,9571,38,93,131,0,383,1975,15,189,8.069707594,109362,1,0,10008,10495,487,418028,459435,41407,4658,5043,385,1,86.75440096,Arch
702f52d0ea7c5e90b495bc05f079ca3e952766a8,623,19189,9596,9593,93,38,131,1,386,2130,16,188,8.069965923,99791,3,1,10489,10018,471,458931,418568,40363,5036,4666,370,1,86.75440096,Arch
dd0ddef8f6d4c998472dff91d2a2153959a6049f,623,9575,19146,9571,38,93,131,0,383,1975,15,189,8.069018385,109384,2,1,10010,10497,487,418093,459500,41407,4659,5044,385,1,86.75440096,Arch
ca9aa8f4f3d4b440fb86536c0acfb858dcc2fdba,623,19154,9583,9571,93,38,131,1,386,2130,16,188,8.066776767,99813,25,3,10489,10020,469,458931,418633,40298,5036,4667,369,1,86.75440096,Arch
7b86ce8534010301f806faa631f02c18a5036030,623,9575,19146,9571,38,93,131,0,383,1975,15,189,8.069018385,109384,12,3,10010,10497,487,418093,459500,41407,4659,5044,385,1,86.75440096,Arch
93196d4bb72d3bf434256111f294d5bd1dd09d11,624,19149,9715,9434,93,39,132,1,386,2129,16,188,8.07065301,99899,5,0,10487,10028,459,458505,418920,39585,5035,4671,364,1,86.71567789,Arch
74eba2968b020d8da2360a45c3406a5132eb6aee,626,9717,19140,9423,39,93,132,0,383,1964,15,189,8.074762265,109513,3,2,10032,10507,475,418946,459613,40667,4670,5050,380,1,86.73382278,Arch
1c22f94522ec6686ded044a4e0ca0b3cb9d76e62,625,19148,9650,9498,93,39,132,1,386,2125,16,187,8.067595526,99947,36,0,10501,10036,465,458697,418984,39713,5038,4672,366,1,86.7381682,Arch
4de39476ff690774ece57637e91653d2ef234fd3,625,9642,19140,9498,39,93,132,0,383,1951,15,188,8.069831147,109445,14,0,10026,10509,483,418444,459266,40822,4664,5046,382,1,86.7381682,Arch
a83ed86c4850c3fc09e5623eb00869ab3e39c959,625,19148,9650,9498,93,39,132,1,386,2125,16,187,8.067595526,99947,26,0,10501,10036,465,458697,418984,39713,5038,4672,366,1,86.7381682,Arch
70e9381a7482d2d378e8bcccc8b40d5f966bbf62,625,9642,19140,9498,39,93,132,0,383,1951,15,188,8.069831147,109466,15,1,10027,10510,483,418469,459291,40822,4664,5046,382,1,86.7381682,Arch
3ad4fe5a1a3fe803e1372d9093a8ea27e95fc34c,625,19148,9650,9498,93,39,132,1,386,2125,16,187,8.067595526,99968,105,0,10502,10037,465,458722,419009,39713,5038,4672,366,1,86.7381682,Arch
5002a0b0b8b15334ebcb90b81ad2c2b6a75c1c74,625,9642,19140,9498,39,93,132,0,383,1951,15,188,8.069831147,109466,80,0,10027,10510,483,418469,459291,40822,4664,5046,382,1,86.7381682,Arch
6767f2500f1d005924ccff27f04350c253858a84,626,19150,9652,9498,93,39,132,1,386,2122,16,188,8.068455033,100041,38,0,10505,10040,465,458952,419231,39721,5040,4674,366,1,86.760707,Arch
0b0a96782e0298dfb1c7eeaebccf6ed917aaeaac,626,9667,19156,9489,39,93,132,0,383,1930,15,189,8.070419412,109539,25,1,10031,10513,482,418747,459521,40774,4667,5048,381,1,86.760707,Arch
2a276d0dcf5108a896eb44f2940baf98af2edbac,626,19155,9710,9445,93,39,132,1,386,2122,16,188,8.067705403,100103,39,1,10506,10051,455,459008,419559,39449,5041,4678,363,1,86.760707,Arch
8a928e59acc187c7d9f9f9d1e5b4a1c99c006926,626,9643,19141,9498,39,93,132,0,383,1930,15,189,8.070688756,109601,132,0,10041,10524,483,419019,459849,40830,4670,5052,382,1,86.760707,Arch
3d451672030376f3d956b2462abc1c1de881afa8,626,19149,9651,9498,93,39,132,1,386,2122,16,188,8.068452869,100103,178,0,10516,10051,465,459280,419559,39721,5044,4678,366,1,86.760707,Arch
d0c387b7bd7026a0354068da52fe0fa24ac1e1db,626,9643,19141,9498,39,93,132,0,383,1930,15,189,8.070688756,109601,133,1,10041,10524,483,419019,459849,40830,4670,5052,382,1,86.760707,Arch
7bd5fb38b34c2be4db7a31cbda16169cf0890ad1,626,19149,9651,9498,93,39,132,1,386,2122,16,188,8.068452869,100103,394,0,10516,10051,465,459280,419559,39721,5044,4678,366,0,86.760707,Arch
ac9132e4f4ada93369cc5188e836d54c885d4c99,626,9643,19141,9498,39,93,132,0,383,1930,15,189,8.070688756,109601,337,0,10041,10524,483,419019,459849,40830,4670,5052,382,0,86.760707,Arch
47fb9e8122b236f20c29b2ecf95a1b0e332fa3fb,626,19149,9651,9498,93,39,132,1,386,2122,16,188,8.068452869,100103,28,0,10516,10051,465,459280,419559,39721,5044,4678,366,1,86.760707,Arch
ca479180c535caa23b2b11631c924d1e98101d84,626,9643,19141,9498,39,93,132,0,383,1930,15,189,8.070688756,109601,16,0,10041,10524,483,419019,459849,40830,4670,5052,382,1,86.760707,Arch
54f9d91ebb05ff8a051272c4e91dca4ee4984d80,626,19236,9651,9585,93,39,132,1,386,2119,16,188,8.072470855,100103,5,0,10524,10051,473,459809,419559,40250,5047,4678,369,1,86.760707,Arch
0504c361b4c96a12969ba1dabd9971c194160aec,626,9654,19144,9490,39,93,132,0,383,1919,15,189,8.072147452,109688,4,0,10050,10532,482,419623,460378,40755,4673,5055,382,1,86.760707,Arch
df38f1c079923492f3517b81e5a72d6f35701dc9,626,19152,9662,9490,93,39,132,1,386,2119,16,188,8.069912231,100198,179,1,10524,10060,464,459809,420163,39646,5047,4681,366,0,86.760707,Arch
bb6bbf882d8f6c25967ec8d4fc239c9efd80cb17,626,9654,19144,9490,39,93,132,0,383,1919,15,189,8.072147452,109688,134,2,10050,10532,482,419623,460378,40755,4673,5055,382,0,86.760707,Arch
415eaf31de407efcbf61166afd8cf4e86cdafe11,628,19212,9685,9527,93,39,132,1,386,2131,16,188,8.077344072,100366,41,0,10540,10072,468,460465,420610,39855,5056,4689,367,1,86.760707,Arch
115febf29b9520eed6e94a65212e00e88806a860,626,9657,19147,9490,39,93,132,0,383,1924,15,189,8.072761018,109725,27,0,10054,10536,482,419832,460585,40753,4673,5055,382,1,86.760707,Arch
4e88d62ab23a2cef8b1ec8af479353bc4d86fe25,625,19169,9595,9574,93,38,131,1,386,2115,16,188,8.06653932,100217,395,0,10531,10059,472,460589,420577,40012,5049,4682,367,1,86.96089948,Arch
9b876fa90b1f3683617102d1843e3efb89654cb8,625,9587,19161,9574,38,93,131,0,383,1948,15,189,8.068777946,109791,136,1,10049,10539,490,420037,461158,41121,4674,5057,383,1,86.96089948,Arch
90c084dcf495e73c679395bc4b050500cbccf8cf,625,19264,9595,9669,93,38,131,1,386,2116,16,188,8.062895218,100217,42,1,10543,10059,484,460863,420577,40286,5054,4682,372,1,86.96089948,Arch
f164ab5f89c85657f6f5d8a6c05978e60c87dcc5,625,9604,19363,9759,38,93,131,0,383,1949,15,189,8.062060251,109975,137,0,10049,10558,509,420035,462131,42096,4674,5062,388,1,86.96089948,Arch
8ff8ebcaeadab54190581a6e4cdadbd80f872d9f,625,19401,9642,9759,93,38,131,1,386,2116,16,188,8.053999174,100216,0,0,10550,10059,491,461562,420575,40987,5054,4682,372,1,86.96089948,Arch
eaac5f345828d4b7b846dcc6da21a5f77822bfaa,625,9604,19363,9759,38,93,131,0,383,1949,15,189,8.062060251,109975,0,0,10049,10558,509,420035,462131,42096,4674,5062,388,1,86.96089948,Arch
5ce5591ae341188230d6ecca76c90bd0a786fcb2,657,19481,9722,9759,93,38,131,1,386,2320,17,193,8.079110253,104213,0,0,10861,10370,491,471874,430887,40987,5291,4919,372,0,86.96089948,Arch
e1e4f5bda02535f718785189082f4197037774f3,657,9711,19410,9699,38,93,131,0,383,1953,16,194,8.087350393,113972,0,0,10368,10869,501,430718,472443,41725,4913,5299,386,1,86.96089948,Arch
8125b3131f2e0f88837040b0baf4e0aaa8210679,659,19449,9750,9699,93,38,131,1,386,2290,17,193,8.08894494,104602,1,1,10891,10403,488,472917,432012,40905,5321,4946,375,0,86.96089948,Arch
95bdbf6821d16c2b4f1df6f820600e0d4b1b9166,659,9768,19454,9686,38,93,131,0,383,1971,16,194,8.091930111,114301,339,0,10399,10893,494,431800,473034,41234,4943,5323,380,1,86.96089948,Arch
35b93b0a589752cc88105623a2ddf9e52b56c1ce,659,19449,9750,9699,93,38,131,1,386,2290,17,193,8.08894494,104615,396,0,10892,10404,488,472956,432051,40905,5321,4946,375,1,86.96089948,Arch
029587fb0b8bf9e0e4edfbf198fa2a746ba5c827,659,9742,19441,9699,38,93,131,0,383,1971,16,194,8.091150606,114314,138,1,10399,10894,495,431800,473073,41273,4943,5323,380,0,86.96089948,Arch
2d9918a2d109ad21751ccee86209d0a487f12e2a,659,19449,9750,9699,93,38,131,1,386,2290,17,193,8.08894494,104615,183,1,10892,10404,488,472956,432051,40905,5321,4946,375,0,86.96089948,Arch
0f8f22e404c65594d0af5f5151d551dd7f64afc5,3,1,265,264,0,2,2,3,30,2714,1,1,1.131574242,590,184,2,29,75,46,1770,2642,872,8,31,23,1,96.96008017,Arch
73360100ca145d345afdeab6df60797a8b1a957e,660,10006,19441,9435,40,93,133,0,383,1973,16,194,8.099979398,114159,139,2,10418,10867,449,432146,472547,40401,4951,5308,357,1,87.43882545,Arch
a53a1aa232bc383baf055d884a7c66319d10d404,662,19817,10066,9751,95,40,135,1,386,2290,17,193,8.102948206,104724,6,0,10883,10423,460,474139,432397,41742,5322,4954,368,1,87.36756316,Arch
29c53d67483445094270740477fa8909b6fd9f85,662,10041,19792,9751,40,95,135,0,383,1965,16,194,8.107564401,114475,0,0,10418,10885,467,432146,474256,42110,4951,5324,373,1,87.36756316,Arch
b762fa9d5c44734b5e20eb83071e7c31821a5fad,8,192,125,67,1,0,1,1,116,1603,1,4,1.932237949,1123,28,0,99,102,3,4586,4115,471,74,70,4,2,97.55579171,Arch
e02e0c84ce2582ac363d40e115fceea4146e999c,662,19820,10056,9764,95,40,135,1,386,2278,17,193,8.102953046,104651,43,0,10865,10404,461,474029,432320,41709,5315,4946,369,2,87.41484403,Arch
20f539a3fd1db4850ee0dd63626641021bf10917,662,10031,19788,9757,40,95,135,0,383,1963,16,194,8.107254272,114408,140,0,10399,10867,468,432069,474146,42077,4943,5317,374,1,87.41484403,Arch
750e1e3e71194644acda437cefbd73c8bd408f5d,662,19813,10056,9757,95,40,135,1,386,2278,17,193,8.1026353,104651,6,0,10865,10404,461,474029,432320,41709,5315,4946,369,1,87.41484403,Arch
9fe564cdc736bde1f799774913c84a020fef81f7,662,10050,19790,9740,40,95,135,0,383,1958,16,194,8.107650107,114408,0,0,10403,10867,464,432146,474146,42000,4944,5317,373,1,87.41484403,Arch
ce4579108d653be2ab7eab43be7d5951151dae5b,662,19813,10057,9756,95,40,135,1,386,2279,17,193,8.102664391,104668,0,0,10869,10408,461,474106,432397,41709,5316,4947,369,1,87.41484403,Arch
55a2182a6b14c595d7223b6486a2d9f033818619,662,10032,19788,9756,40,95,135,0,383,1958,16,194,8.107280028,114424,6,0,10403,10871,468,432146,474223,42077,4944,5318,374,1,87.41484403,Arch
e410a6ce1dea787258e5675e71a672144e3f0419,662,19837,10073,9764,95,40,135,1,386,2278,17,193,8.103277031,104668,1,1,10869,10408,461,474133,432397,41736,5316,4947,369,1,87.64873471,Arch
d1bc037cc0bf5d5b4c8b3d2cf5ed4dcfd860b1ae,662,10031,19788,9757,40,95,135,0,383,1958,16,194,8.107254272,114432,1,1,10403,10871,468,432173,474250,42077,4944,5318,374,1,88.79852693,Arch
5502c0c8dba03c7241bd9dd1bb5ba023ab6f2670,662,19813,10056,9757,95,40,135,1,386,2278,17,193,8.1026353,104675,63,0,10869,10408,461,474133,432424,41709,5316,4947,369,1,88.79852693,Arch
2f7dfcfe82c07829cf92e1ab0622b1d81f9e4738,662,10031,19788,9757,40,95,135,0,383,1958,16,194,8.107254272,114432,34,0,10403,10871,468,432173,474250,42077,4944,5318,374,1,88.79852693,Arch
47e2d689d687358a85c2cdecc176cac36093817e,662,19817,10060,9757,95,40,135,1,386,2278,17,193,8.102695602,104675,7,0,10869,10408,461,474133,432424,41709,5316,4947,369,1,88.79852693,Arch
7e0e9f9fbece8f416807c14fc6b582e501f3a414,5,68,11,57,0,0,0,8,21,681,1,4,1.970002386,667,22,1,46,41,5,3664,3353,311,33,31,2,1,95.99758345,Arch
a4ed7bb6ba66ec4d6a471dc1b024c7469e17574d,662,10028,19842,9814,40,95,135,0,383,1967,16,194,8.109647575,114489,7,0,10403,10876,473,432173,474561,42388,4944,5320,376,1,87.48827025,Arch
2a9f39336cec1d8e52d30cc48503d51ed8672536,904,46545,19983,26562,299,61,360,1,386,1882,20,217,8.565506803,108478,45,0,12050,10843,1207,533891,451154,82737,6428,5155,1273,1,82.55902513,Arch
a7a5b8169ba76a8169898735c91856b3722af639,904,19991,46553,26562,64,299,363,0,383,1499,20,217,8.566334787,135043,29,0,10728,12159,1431,444068,541211,97143,5080,6502,1422,0,82.55902513,Arch
bff84bd634fd4cafe87f31ea155744095f6ecd1a,907,46723,20012,26711,300,64,364,1,386,1865,20,217,8.569640224,108605,47,2,12076,10855,1221,535349,451492,83857,6438,5162,1276,0,82.40839288,Arch
5136a5ea81f3db5ef38b75eb1b987b60fdf5f336,905,20025,46761,26736,64,299,363,0,383,1502,20,218,8.570930723,135294,17,0,10740,12194,1454,444348,542153,97805,5087,6521,1434,0,82.2733634,Arch
3f90e7028e0338c110aea267b44362653d55273a,900,46723,19985,26738,299,64,363,1,386,1798,20,218,8.566676505,108171,50,5,12075,10845,1230,534052,450798,83254,6439,5154,1285,0,82.2733634,Arch
75e19406952a4e1a58b382ec5c68dd16c101670b,900,19993,46732,26739,64,299,363,0,383,1492,20,218,8.567496929,134917,0,0,10733,12187,1454,443755,541488,97733,5080,6514,1434,1,82.2733634,Arch
c3361ab62296f35c5e8149a0633d450747a697c9,900,46739,19985,26754,299,64,363,1,386,1799,20,218,8.566701187,108178,51,6,12078,10848,1230,534097,450841,83256,6440,5155,1285,0,82.2733634,Arch
0f4387543debd77ab649f97014b72feb4046b3c6,902,20038,46965,26927,64,300,364,0,383,1495,20,218,8.571736748,135177,141,0,10741,12199,1458,443981,542583,98602,5082,6521,1439,1,82.23500155,Arch
36a4e9ff644850a96cfd173cda95819a8836e833,16,790,40,750,8,0,8,2,71,83,1,2,3.387830663,1550,57,0,225,154,71,11418,8028,3390,71,40,31,1,94.67600701,Arch
