CommitID,NMF,TotalAddLines,TotalDeleteLines,LC,FileAdd,FileDelete,NAD,NDVE,NUC,AGE,NMS,NMD,Entropy ,MLMF,EXP,REXP,CommitComplexity,LastCommitComplexity,CFC,CommitTokenCount,LastCommitTokenCount,NCC,CommitMethodNum,LastCommitMethodNum,NMC,NIR,a2a,Tag
fa23b096ac4a0577578da1da7aa82f33e617c0f8,1,41,2,39,0,0,0,3,25,26,1,1,0.0,717,404,23,68,64,4,5133,4865,268,21,20,1,1,99.970726,NoArch
41173aa0a0cc60924902ce9e78a452e2069a2a31,16,220,135,85,0,0,0,2,210,129,2,8,3.01416838,18638,356,0,1722,1704,18,118242,117765,477,711,697,14,1,100.0,NoArch
cf073633e89076e005ef80d996d000390820cd8c,2,71,13,58,0,0,0,4,136,8,1,2,0.99631652,6405,201,8,654,650,4,39605,39248,357,219,218,1,1,100.0,NoArch
66ca9655a4412e1c1db1d37e882a407706dbe3ad,1,23,2,21,0,0,0,2,5,2,1,1,0.0,968,72,2,92,89,3,5157,5101,56,29,29,0,1,100.0,NoArch
e3b5cd54d8cdd6f141c312328be25e1edc2a3e57,1,17,0,17,0,0,0,3,3,588,1,1,0.0,202,65,0,18,16,2,994,952,42,8,7,1,1,100.0,NoArch
ae84f1d239dfb76ac91d1f97688ef205ac1fcf0b,0,0,0,0,0,0,0,0,0,0,0,0,0.0,0,174,8,0,0,0,0,0,0,0,0,0,1,100.0,NoArch
200b42b7da3cffdeb0ef2d426981a8a34e0b1007,2,38,4,34,0,0,0,4,53,88,1,2,0.985228136,2061,415,6,204,200,4,13495,13301,194,61,60,1,1,100.0,NoArch
f8f5411ea0c17496090b65562f3b4b2da48cd059,1,4,0,4,0,0,0,6,92,0,1,1,0.0,1963,209,13,298,298,0,10913,10887,26,108,108,0,1,100.0,NoArch
b9d5c2056c1026903a30c35a67e5b16aa1b5bb2b,0,0,0,0,0,0,0,0,0,0,0,0,0.0,0,43,1,0,0,0,0,0,0,0,0,0,1,100.0,NoArch
34159fed90ab519a024d177b9fcd144cb4954437,1,10,3,7,0,0,0,3,6,3,1,1,0.0,240,195,17,7,7,0,2169,2118,51,7,7,0,1,100.0,NoArch
da3fecd53df56b96e29c8608068bf46a1995d611,23,521,201,320,0,0,0,2,32,98,2,13,2.951460533,12369,25,10,1316,1265,51,66763,65383,1380,491,477,14,1,100.0,NoArch
aed87d2dbf1ce99a53eb2e919934dff9b8517e01,1,1,14,13,0,0,0,3,12,81,1,1,0.0,350,263,5,48,49,1,1945,2039,94,20,20,0,1,100.0,NoArch
56365c80ef928f61204e21d1ae2bd52d301b985e,1,1,0,1,0,0,0,3,17,482,1,1,0.0,221,424,2,3,3,0,410,408,2,3,3,0,1,100.0,NoArch
c4dbeeab3fc20ccd75367013f2bbffc2fec7f3a3,0,0,0,0,0,0,0,0,0,0,0,0,0.0,0,489,3,0,0,0,0,0,0,0,0,0,1,100.0,NoArch
dbf36fb777054fdbff290356ec5488694d77d774,2,123,4,119,0,0,0,4,186,252,1,2,0.116849761,5081,341,1,620,618,2,30080,29452,628,169,167,2,1,100.0,NoArch
fac3222c768fbdfc8c1bbe55f94bc106900e6ae4,1,0,1,1,0,0,0,5,20,81,1,1,0.0,344,78,12,50,50,0,1951,1955,4,14,14,0,1,100.0,NoArch
dfe38490fd24485ddb1ba88df929682d63d555c9,19,176,41,135,2,1,3,1,84,29,4,10,2.813374481,7912,22,4,601,588,13,46916,46335,581,336,331,5,1,99.65986395,NoArch
2467d60896e5c99536fe4e64b58c6f57dc1587ec,3,26,168,142,0,0,0,3,9,6,1,2,0.255176221,1422,74,10,204,223,19,7379,8201,822,47,52,5,1,100.0,NoArch
c570a0e12921fff5787877ceb5612b08115d77a4,3,13,2,11,0,0,0,3,10,0,2,3,1.399581231,1949,314,15,140,140,0,15911,15792,119,48,48,0,1,100.0,NoArch
2118e96446bd3ca8858c831a5cf7ebc07d683007,5,70,23,47,0,0,0,3,82,151,1,4,1.535347461,4498,178,4,666,658,8,22412,22154,258,260,256,4,1,100.0,NoArch
a9048bb52c8efc194fca62f8764d97b6d3143147,2,33,2,31,0,0,0,4,91,28,1,2,0.898058793,1794,82,15,153,147,6,6267,6096,171,28,28,0,1,100.0,NoArch
9220170dd87e26542bcfe3bbdc29871625535e1f,2,47,5,42,0,0,0,4,61,60,1,2,0.456683632,2202,347,6,237,231,6,11832,11563,269,110,108,2,1,100.0,NoArch
952980a1a2c7ee83d85de336d7d64d5f7114f864,3,23,7,16,0,0,0,1,66,0,1,1,1.399581231,987,446,18,127,125,2,5202,5153,49,56,54,2,1,100.0,NoArch
396b9927959ff812f3926c0a9d2b430f070bb09e,1,1,1,0,0,0,0,4,19,3,1,1,0.0,446,271,17,89,89,0,2458,2463,5,20,20,0,1,100.0,NoArch
d1ea44d0b4f53f729fc7842b5325d0f941b6dd1c,1,5,1,4,0,0,0,5,55,3,1,1,0.0,884,338,8,111,109,2,5140,5120,20,21,21,0,1,100.0,NoArch
601fa0156a038d433c9ae03e87e463d5715c6fa4,0,0,0,0,0,0,0,0,0,0,0,0,0.0,0,489,61,0,0,0,0,0,0,0,0,0,1,100.0,NoArch
7a61e5b85f44b2e33b87a184c7d0d00e800edf00,23,165,103,62,0,0,0,3,74,0,6,19,4.032390354,11322,319,18,877,871,6,72108,71518,590,464,463,1,1,100.0,NoArch
6e1379664fd5815288c079dba703954ded9f5632,14,71,23,48,0,0,0,2,68,47,5,10,3.312049148,5971,325,19,428,426,2,35090,34749,341,255,253,2,1,100.0,NoArch
e8dc9f72f9d720e5bdf7bb3005d904451a02ce2b,0,0,0,0,0,0,0,0,0,0,0,0,0.0,0,217,9,0,0,0,0,0,0,0,0,0,1,100.0,NoArch
49fe873e932265159fcf2e43814a6d6be81b5d4d,0,0,0,0,0,0,0,0,0,0,0,0,0.0,0,233,4,0,0,0,0,0,0,0,0,0,1,100.0,NoArch
db732b2fb708fe82cec25fbc31d2b73020ae58d1,4,317,23,294,1,0,1,3,13,8,1,3,1.190648075,1477,17,3,185,159,26,9500,8100,1400,80,73,7,1,99.79645246,NoArch
a5c32093106437e1a98e9d735ef95f835c52bd9f,5,341,2,339,1,0,1,1,7,467,1,3,0.885400619,781,210,4,181,145,36,6429,3777,2652,57,43,14,1,99.94714588,NoArch
8ed79eaaf92401e270f2cefba7e933916883bab9,1,2,2,0,0,0,0,2,5,129,1,1,0.0,92,276,9,8,8,0,276,276,0,8,8,0,1,100.0,NoArch
bd0e6bd2cdf9b49630375006c14e3f5fc5d25cb6,12,221,222,1,0,0,0,2,22,247,5,7,3.083412917,2660,203,8,278,278,0,14024,14143,119,111,113,2,1,100.0,NoArch
12ef073c205ce7b09827a7ecbeea457d589c1c5f,0,0,0,0,0,0,0,0,0,0,0,0,0.0,0,23,8,0,0,0,0,0,0,0,0,0,1,100.0,NoArch
c241f40944e9bafd4c3682b001502b5ea7a5e6e8,1,2,2,0,0,0,0,5,39,89,1,1,0.0,832,474,1,98,98,0,3590,3590,0,33,33,0,1,100.0,NoArch
9086d455955b711717a79d59e21119271e491a23,1,11,51,40,0,0,0,1,19,0,1,1,0.0,517,484,56,64,71,7,2596,2748,152,30,34,4,1,100.0,NoArch
08aa7ac5a19300538b1e9a15fe8f338e4f1cf302,1,1,36,35,0,0,0,3,45,18,1,1,0.0,1116,291,12,106,110,4,5520,5631,111,48,50,2,1,100.0,NoArch
a03e1c951782372857a2431c41bef570b3ac8e10,2,24,12,12,0,0,0,4,79,2,1,1,0.309543429,1947,430,4,155,151,4,7214,7106,108,31,30,1,2,100.0,NoArch
1854cbf916d85890c0d222381a6cb76684fba689,0,0,0,0,0,0,0,0,0,0,0,0,0.0,0,495,6,0,0,0,0,0,0,0,0,0,2,100.0,NoArch
dfe38490fd24485ddb1ba88df929682d63d555c9,19,176,41,135,2,1,3,1,84,29,4,10,2.813374481,7912,22,4,601,588,13,46916,46335,581,336,331,5,1,99.65986395,NoArch
cb427d9c300b3d2b4decdc37cf405264baf3761f,2,55,0,55,0,0,0,3,7,363,1,2,0.13110653,397,16,0,26,24,2,2606,2360,246,14,12,2,1,100.0,NoArch
eadbfec4456b5edc318a5c94f90a2a78e172ebf4,4,32,22,10,0,0,0,2,5,0,1,1,1.837797162,1716,363,4,243,243,0,8845,8740,105,153,153,0,1,100.0,NoArch
a82da8ad4f7ff7a3379c800865f72936f6b3847b,1,22,15,7,0,0,0,3,14,182,1,1,0.0,481,56,6,75,74,1,2548,2513,35,12,12,0,1,100.0,NoArch
ca4ec1896be2121d1694481b18b9c7fedef31eb6,1,25,1,24,0,0,0,1,3,86,1,1,0.0,386,262,4,57,54,3,1734,1539,195,23,23,0,1,100.0,NoArch
f0c8845cb687d6b0af22b5800ca1e8947a34fac9,7,187,36,151,1,0,1,9,114,63,1,3,1.847518043,3474,447,19,437,423,14,19531,18842,689,170,157,13,1,99.93181043,NoArch
4d381d778f82d8d17ea9f718bbac3938ce4cc40d,15,207,49,158,0,0,0,5,92,354,3,12,3.228171379,9510,359,0,800,781,19,63566,62400,1166,402,392,10,1,100.0,NoArch
e51bcbc3049247f598991533c38e181a7e2d84a4,2,14,14,0,0,0,0,4,85,0,1,2,0.591672779,2739,485,57,214,213,1,19944,19960,16,54,54,0,1,100.0,NoArch
cd474e0e36eaa17befab7aa0fcdfa0813d9e6b49,2,2,6,4,0,0,0,5,36,16,1,1,1.0,936,0,0,107,108,1,5243,5256,13,28,29,1,1,100.0,NoArch
199ab0198d86344560675d2f46970de0f4053123,0,0,0,0,0,0,0,0,0,0,0,0,0.0,0,372,0,0,0,0,0,0,0,0,0,0,1,100.0,NoArch
30c5b4705d2a220d862cfdd60683e4ab1a5a6acc,0,0,0,0,0,0,0,0,0,0,0,0,0.0,0,218,7,0,0,0,0,0,0,0,0,0,1,100.0,NoArch
21d208f17305e6eaff14fa3856d5b925f3975669,1,2,2,0,0,0,0,5,37,107,1,1,0.0,831,440,1,98,98,0,3591,3591,0,33,33,0,1,100.0,NoArch
18290c8489df01f814087673ecdc6b140fbffc44,2,127,12,115,0,0,0,3,52,22,1,2,0.942444059,3011,166,12,337,324,13,18649,17885,764,94,92,2,1,100.0,NoArch
4d381d778f82d8d17ea9f718bbac3938ce4cc40d,15,207,49,158,0,0,0,5,92,354,3,12,3.228171379,9510,359,0,800,781,19,63566,62400,1166,402,392,10,1,100.0,NoArch
f5c1f47dfec8d4e432c6970fd3267dd13ade8b03,8,144,1,143,0,0,0,7,115,46,1,3,2.295495702,6033,448,20,641,631,10,31174,30632,542,271,261,10,1,100.0,NoArch
d26b8b2f2ffe99baa87ae49146989a959e7791f7,0,0,0,0,0,0,0,0,0,0,0,0,0.0,0,69,0,0,0,0,0,0,0,0,0,0,1,100.0,NoArch
19fb440041cf6debe7f7a1e1d1f9f0f914a5671a,3,613,11,602,1,0,1,1,39,4,1,3,0.605317911,1738,127,2,216,210,6,12935,10438,2497,104,100,4,1,99.91325092,NoArch
93313451294366a7b1d9b98188be943b3fa5d1c5,3,56,9,47,0,0,0,1,6,110,2,3,1.062850199,759,407,19,116,113,3,4954,4651,303,37,33,4,1,100.0,NoArch
9dabf94767480750f31d8f3e24d17a89bc036331,19,1362,272,1090,6,0,6,5,18,28,2,11,3.39643842,6807,111,3,768,685,83,41444,36705,4739,272,232,40,1,99.61984794,NoArch
efe49b8f646fd4b39afcf35f4d34b33d8df84cfb,0,0,0,0,0,0,0,0,0,0,0,0,0.0,0,310,16,0,0,0,0,0,0,0,0,0,1,100.0,NoArch
128668765290d14c80865018f23a21aed9f02eb9,23,210,530,320,0,0,0,2,31,76,2,13,2.908517674,12689,467,15,1265,1316,51,65383,66763,1380,477,491,14,1,100.0,NoArch
6b061cac8978703620245e7f5fd93f5b81740435,1,1,1,0,0,0,0,2,2,39,1,1,0.0,169,4,0,22,22,0,907,907,0,6,6,0,1,100.0,NoArch
935896d862c58f1ecc0a818199e60d1c30975637,0,0,0,0,0,0,0,0,0,0,0,0,0.0,0,1,1,0,0,0,0,0,0,0,0,0,0,100.0,NoArch
4b5b20e23638965495f186fb6fc28f5d82346b80,2,190,66,124,0,0,0,2,60,90,1,2,0.942163169,2211,295,4,217,212,5,12937,11938,999,90,86,4,1,100.0,NoArch
f673a1c99636b3dd4e2d3881338fb38c7dcb8fa3,0,0,0,0,0,0,0,0,0,0,0,0,0.0,0,283,28,0,0,0,0,0,0,0,0,0,0,100.0,NoArch
73ce1d0e3dec284f15d3a61c4569813cf5ded3cd,3,120,46,74,0,0,0,3,13,107,1,2,1.134918602,1766,129,4,204,199,5,10598,9775,823,56,54,2,1,100.0,NoArch
ff469b491dec5a1011e79d8d4f5104ee0e9044f5,0,0,0,0,0,0,0,0,0,0,0,0,0.0,0,410,14,0,0,0,0,0,0,0,0,0,1,100.0,NoArch
d1d94c2f4b64f817e6fa2f9b79972db035992d35,2,4,4,0,0,0,0,4,8,5,1,2,1.0,728,4,4,62,62,0,4935,4935,0,30,30,0,1,100.0,NoArch
16a0f57952d554e95ae1346ac3f360998ac7faac,9,176,74,102,0,0,0,1,71,194,3,7,2.314369773,4753,285,10,381,376,5,27920,26915,1005,220,217,3,1,99.909991,NoArch
ef77ff06afb1e8b1feb480129caaa4b0af311163,2,52,15,37,0,0,0,3,7,232,2,2,0.193642805,379,376,2,32,30,2,2470,2268,202,22,20,2,1,100.0,NoArch
cd068538d7ecc2cf18c606dfcf0bcbebcf2dbe11,0,0,0,0,0,0,0,0,0,0,0,0,0.0,0,1,0,0,0,0,0,0,0,0,0,0,1,100.0,NoArch
ab3c4c3468d665c9a1144452dab0ba5e580667a1,1,3,2,1,0,0,0,1,14,107,1,1,0.0,724,191,3,33,33,0,4253,4273,20,24,24,0,1,100.0,NoArch
bc62d81a78213175464658f58658f89105a027ad,3,146,17,129,0,0,0,3,66,27,1,3,1.420517194,2103,354,12,147,140,7,10253,9652,601,39,36,3,1,100.0,NoArch
ec6bbbf958878d9dfa7e2a32f467e1e6de8c1a9b,0,0,0,0,0,0,0,0,0,0,0,0,0.0,0,28,12,0,0,0,0,0,0,0,0,0,1,100.0,NoArch
65f476ce083ed042532f10b0c38a3074f3be370a,2,95,35,60,0,0,0,4,41,346,1,2,0.975272831,3884,330,0,432,430,2,24335,23702,633,109,109,0,1,100.0,NoArch
7d69a6ea976804b5b4e476483be02a74ee16dd94,0,0,0,0,0,0,0,0,0,0,0,0,0.0,0,42,7,0,0,0,0,0,0,0,0,0,1,100.0,NoArch
a68917741446bd6fe56b57d0860b71fdc110eb8f,3,9,9,0,0,0,0,1,18,0,2,2,1.224394445,927,483,55,114,114,0,4424,4424,0,69,69,0,1,100.0,NoArch
3dfd555190bcfc276b43964aa4cc09a13092ed86,1,1,1,0,0,0,0,1,3,10,1,1,0.0,358,411,12,48,48,0,1897,1897,0,19,19,0,1,100.0,NoArch
4cae42df9e0a6586ea245d6abe3aac61118b9f1d,3,13,16,3,0,0,0,2,14,0,2,2,1.383912263,618,312,17,95,97,2,2885,2891,6,30,30,0,1,100.0,NoArch
dac59a2aa71aab5daaa6fabdda9d8f48539e1bda,1,3,2,1,0,0,0,1,2,0,1,1,0.0,238,112,4,23,23,0,934,950,16,11,11,0,1,100.0,NoArch
1bef46e76e43291a52b4b4a39cd6f4d371f1bc23,1,1,1,0,0,0,0,2,2,20,1,1,0.0,364,268,17,31,30,1,2067,2058,9,14,14,0,1,100.0,NoArch
c04c7b5e5a08c90e5c128885cbd685d0d14e6ae8,1,15,2,13,0,0,0,5,15,159,1,1,0.0,1115,41,6,124,121,3,5702,5636,66,38,37,1,1,100.0,NoArch
dadd4e048c7aa630ead907783af2d9fdb74db786,1,21,10,11,0,0,0,4,24,0,1,1,0.0,425,241,12,42,39,3,1224,1171,53,36,35,1,1,100.0,NoArch
f31aba7bca4ff85dec69a4ac949c37e24f7eed1e,1,6,2,4,0,0,0,3,7,107,1,1,0.0,407,199,20,41,41,0,2809,2777,32,13,13,0,1,100.0,NoArch
a9f107c4c5b1b1029793c66bd2ef222c52cef976,0,0,0,0,0,0,0,0,0,0,0,0,0.0,0,438,8,0,0,0,0,0,0,0,0,0,1,100.0,NoArch
7a92c581f21d82f1bcb4cb5d7697b1db8fea0ea8,0,0,0,0,0,0,0,0,0,0,0,0,0.0,0,413,13,0,0,0,0,0,0,0,0,0,1,100.0,NoArch
e94f22723ada8e00edfd98606a5cac4a19446dee,6,10,10,0,0,0,0,2,13,65,3,5,2.521928095,1576,204,15,80,80,0,7094,7094,0,45,45,0,1,100.0,NoArch
672b26aff6b9ba092d6d853a8273d15f1782c574,1,4,0,4,0,0,0,5,115,0,1,1,0.0,3205,204,5,454,454,0,17749,17735,14,117,117,0,1,100.0,NoArch
9e9475752f17c0311de2f2bdc0c50d4a144d3a73,2,27,5,22,0,0,0,5,50,0,1,2,0.757878463,1790,464,36,58,58,0,14526,14311,215,44,44,0,1,100.0,NoArch
9220170dd87e26542bcfe3bbdc29871625535e1f,2,47,5,42,0,0,0,4,61,60,1,2,0.456683632,2202,347,6,237,231,6,11832,11563,269,110,108,2,1,100.0,NoArch
7aa927a72f8142a5d6e05531fd948dbff85493a9,7,125,17,108,0,0,0,3,40,30,2,5,2.207633873,4763,238,7,396,383,13,26872,26151,721,165,162,3,1,100.0,NoArch
52648442aea4a2d51044131a70b7e86b5fd805fb,1,62,62,0,0,0,0,4,5,135,1,1,0.0,2112,30,6,337,337,0,9929,9928,1,99,99,0,1,100.0,NoArch
beca145bbe61bc60a0e923072f95d8423f955ddc,2,50,24,26,0,0,0,4,137,0,1,2,0.877962001,6463,202,9,653,654,1,39735,39605,130,218,219,1,1,100.0,NoArch
4ec29425d63decfd8de4e1528f043271cf7cb3b2,7,361,51,310,0,0,0,2,173,188,3,6,1.920255671,12569,9,7,1257,1231,26,77338,75326,2012,457,447,10,1,99.81676592,NoArch
2b3c1449d793f5f0cdffff4b81a23e2ac2a282fa,1,1,1,0,0,0,0,1,1,0,1,1,0.0,58,210,7,4,4,0,222,222,0,2,2,0,1,99.90619137,NoArch
3a456bfddf02467b81b8e8321bd0b82bf9b20fec,1,1,1,0,0,0,0,3,44,3,1,1,0.0,606,228,13,2,2,0,1608,1608,0,2,2,0,1,100.0,NoArch
49fe873e932265159fcf2e43814a6d6be81b5d4d,0,0,0,0,0,0,0,0,0,0,0,0,0.0,0,233,4,0,0,0,0,0,0,0,0,0,1,100.0,NoArch
a6cd1820cbf0bd72d1cad8f386bda7a62593cbba,0,0,0,0,0,0,0,0,0,0,0,0,0.0,0,210,14,0,0,0,0,0,0,0,0,0,1,100.0,NoArch
5cc880c7bb0098055830c0473d261bef50f42cd6,6,79,5,74,0,0,0,3,107,77,2,2,1.630904634,5596,251,6,749,737,12,27423,27066,357,265,262,3,1,100.0,NoArch
70fda9507040de8da83935445c26111f1c1cd3da,24,210,531,321,0,0,0,2,37,57,2,14,2.919403683,13502,66,8,1361,1412,51,68863,70250,1387,509,523,14,1,100.0,NoArch
7b52eb8609858d2878a99229e0c2634c6ee77add,1,1,1,0,0,0,0,4,26,59,1,1,0.0,672,21,4,83,83,0,3053,3053,0,30,30,0,1,100.0,NoArch
dac59a2aa71aab5daaa6fabdda9d8f48539e1bda,1,3,2,1,0,0,0,1,2,0,1,1,0.0,238,112,4,23,23,0,934,950,16,11,11,0,1,100.0,NoArch
fbf1fcc2fcc439a640fc2c5ae9f37f807808a3e9,10,44,339,295,0,2,2,1,84,0,3,6,2.292323113,4073,482,54,436,470,34,21723,23119,1396,238,251,13,1,99.93091537,NoArch
1d2725b7982d9dec88580eeaf6c6ae38dbd44bd6,2,36,1,35,0,0,0,4,63,524,1,2,0.974024864,2250,338,0,240,237,3,12096,11912,184,111,110,1,1,100.0,NoArch
4e2aa2acca5972af07a671a43755c8fe599bb0fc,2,49,14,35,0,0,0,4,9,431,1,2,0.702466551,931,419,5,76,73,3,5226,5029,197,28,27,1,1,100.0,NoArch
7f3051b1f368cdee7568f8f12e8e2cd814e1ae17,6,59,53,6,0,0,0,2,13,39,2,5,2.231069096,1068,216,14,98,96,2,6529,6540,11,47,45,2,1,100.0,NoArch
4d5ea0e5151dca5dbf5d6aeb05efbe05bfc2208d,0,0,0,0,0,0,0,0,0,0,0,0,0.0,0,37,4,0,0,0,0,0,0,0,0,0,1,100.0,NoArch
66ee8e8f5098b2f304d8df23032dd6212eb6a1ab,1,2,2,0,0,0,0,4,52,878,1,1,0.0,390,16,0,38,38,0,1620,1610,10,16,16,0,1,100.0,NoArch
fe031a7a00055673d8b0aa109013e63c5d1386aa,0,0,0,0,0,0,0,0,0,0,0,0,0.0,0,232,25,0,0,0,0,0,0,0,0,0,0,100.0,NoArch
8d4b8e9a5b6cac168cd793b93e0940494c11ebc4,6,103,13,90,0,0,0,2,18,101,2,5,2.108206423,1361,211,12,120,108,12,7056,6395,661,54,53,1,1,99.97065728,NoArch
1421f59683b27b04f20e5060b79ef239a1078401,0,0,0,0,0,0,0,0,0,0,0,0,0.0,0,483,6,0,0,0,0,0,0,0,0,0,1,100.0,NoArch
9b1d507df7b2427c310908aff340818e3f684973,1,0,1,1,0,0,0,1,2,1,1,1,0.0,49,126,1,6,6,0,150,163,13,4,4,0,1,100.0,NoArch
a0c0ba19892285981b1842f99c4b4d2fa432cd39,0,0,0,0,0,0,0,0,0,0,0,0,0.0,0,440,12,0,0,0,0,0,0,0,0,0,2,100.0,NoArch
b4cd97295d432e682c66fa25ebe90df68d8e74a3,13,170,35,135,2,1,3,1,16,37,1,5,2.500190563,2625,283,7,292,279,13,14804,14223,581,148,143,5,1,99.72268441,NoArch
b14e639a650f6c57e8ad3bc99d6c9dee9626b0cf,0,0,0,0,0,0,0,0,0,0,0,0,0.0,0,44,9,0,0,0,0,0,0,0,0,0,1,100.0,NoArch
396b9927959ff812f3926c0a9d2b430f070bb09e,1,1,1,0,0,0,0,4,19,3,1,1,0.0,446,271,17,89,89,0,2458,2463,5,20,20,0,1,100.0,NoArch
65265de17b2356dfbe6bc3e1a54804cd9eb3850b,4,198,20,178,1,0,1,1,15,21,1,4,1.091956077,519,7,3,62,50,12,4284,3105,1179,31,22,9,1,98.48341232,NoArch
89d36629f5c5994da71106770b1fd1adfce7a71f,0,0,0,0,0,0,0,0,0,0,0,0,0.0,0,269,17,0,0,0,0,0,0,0,0,0,1,100.0,NoArch
55ae1e57cc4a3311791e4818782787a3b5d3fd18,1,17,3,14,0,0,0,4,17,114,1,1,0.0,178,292,7,12,10,2,1262,1198,64,10,10,0,1,100.0,NoArch
c0d59139c0c88a38e12d5b2240f2df7f5314baa4,6,158,30,128,2,0,2,2,39,33,1,3,2.045557515,2215,284,12,288,278,10,12448,11977,471,80,70,10,1,99.13393133,NoArch
c04283bf91fd96823eec37056d5c8b1a92728265,0,0,0,0,0,0,0,0,0,0,0,0,0.0,0,61,0,0,0,0,0,0,0,0,0,0,1,100.0,NoArch
bb51e4ed65f704f1a03b8420c163d2ee0dffdb81,1,86,75,11,0,0,0,9,156,3,1,1,0.0,2254,475,2,321,320,1,12824,12777,47,118,118,0,1,100.0,NoArch
dc2c8dca9effba8a1cf58760c08435f4f6f30535,2,65,2,63,0,0,0,3,82,163,1,2,0.111909909,1808,32,3,164,156,8,9426,8997,429,94,90,4,1,100.0,NoArch
98fd541b31dae3c5a3ec748c7d6ebe4329cd0769,6,507,13,494,3,0,3,3,56,20,1,2,1.6276397,2882,236,4,469,423,46,15897,13486,2411,205,173,32,1,99.72170686,NoArch
7731e0044532eaea9b2e4356ceeedf32017c763c,3,386,0,386,2,0,2,1,3,12,1,1,1.012653086,161,328,14,55,18,37,3110,905,2205,17,3,14,1,99.85494633,NoArch
7b45e9a142830e7dd8b0263d50dbaaef5fb0da76,27,904,358,546,8,0,8,3,216,218,5,11,4.137658927,20172,361,2,1789,1739,50,131124,129412,1712,779,740,39,1,99.18360257,NoArch
d77a2255a4ec86cf12bc28599b27d7fa33b7f19a,1,4,2,2,0,0,0,2,3,0,1,1,0.0,368,258,1,27,27,0,2206,2197,9,8,8,0,1,100.0,NoArch
5cba084eb7622bf81d9c7bdc3901df4f32d5ce63,0,0,0,0,0,0,0,0,0,0,0,0,0.0,0,41,3,0,0,0,0,0,0,0,0,0,1,100.0,NoArch
4d381d778f82d8d17ea9f718bbac3938ce4cc40d,15,207,49,158,0,0,0,5,92,354,3,12,3.228171379,9510,359,0,800,781,19,63566,62400,1166,402,392,10,1,100.0,NoArch
592884940cc4e86e32f7da3f157193c79676022a,5,30,26,4,0,0,0,3,108,18,2,5,2.040636798,3257,307,19,429,430,1,18614,18589,25,158,159,1,1,100.0,NoArch
2b1148c671860e6481d56af8880166703d1c4fff,4,264,72,192,0,0,0,3,56,295,2,1,0.645848692,1455,262,29,126,126,0,6405,6383,22,32,32,0,1,100.0,NoArch
72d1e4f98545269b8bff7ebecd5831c099b9da72,0,0,0,0,0,0,0,0,0,0,0,0,0.0,0,425,3,0,0,0,0,0,0,0,0,0,1,100.0,NoArch
f661803cccca222a1bdbba981749d9eb8c3d5a41,0,0,0,0,0,0,0,0,0,0,0,0,0.0,0,388,12,0,0,0,0,0,0,0,0,0,1,100.0,NoArch
588a14f04a7f39bffc178fe75cdf5e621c46a5b6,1,2,2,0,0,0,0,4,54,170,1,1,0.0,408,62,0,40,40,0,1677,1667,10,17,17,0,1,100.0,NoArch
14f8b36ac4f026c79e272cdf3c45b07d6af5e57b,0,0,0,0,0,0,0,0,0,0,0,0,0.0,0,8,1,0,0,0,0,0,0,0,0,0,1,100.0,NoArch
25960cc277e40ed0c926a3cb75122c6dac0181a0,1,6,1,5,0,0,0,2,5,9,1,1,0.0,174,295,16,23,23,0,1104,1081,23,6,6,0,1,100.0,NoArch
fa2b8c437e7cf1b8801b511828663093a3654a78,14,572,51,521,1,0,1,6,38,189,1,13,2.843602991,7885,125,0,750,687,63,50943,47684,3259,302,283,19,1,99.91313789,NoArch
493942d293eb5b4baa29b7dc2db9db2f6a96af2e,6,528,40,488,2,0,2,1,6,172,1,3,1.4580282,1297,5,0,248,202,46,9750,7674,2076,73,51,22,1,99.8738966,NoArch
c1c6d3eb61739e5d7d87cfda0fea999de174865d,0,0,0,0,0,0,0,0,0,0,0,0,0.0,0,67,2,0,0,0,0,0,0,0,0,0,1,100.0,NoArch
333edd0f05ce965f796bd4fbb53421090c51ac96,2,36,1,35,0,0,0,5,67,200,1,2,0.303374836,969,91,7,110,109,1,6422,6139,283,45,44,1,1,100.0,NoArch
e2c7f5de8d9decb0d81abdc716474d0928ffe80c,0,0,0,0,0,0,0,0,0,0,0,0,0.0,0,305,8,0,0,0,0,0,0,0,0,0,1,100.0,NoArch
971e0957a1302e20fe241b4aeac278dc87111257,1,4,1,3,0,0,0,6,48,0,1,1,0.0,979,459,31,123,122,1,5965,5957,8,38,38,0,1,100.0,NoArch
5c5b0da3954da630a0be480687e61c7f6331bdf2,1,9,27,18,0,0,0,1,12,9,1,1,0.0,742,162,19,33,33,0,4273,4435,162,24,24,0,1,100.0,NoArch
74ccd2df417045d5adcf0aae7eff31064560d35e,0,0,0,0,0,0,0,0,0,0,0,0,0.0,0,480,52,0,0,0,0,0,0,0,0,0,1,100.0,NoArch
b084c7f8d12ff38ff3d824734e009a1fc71ee20b,5,213,199,14,2,0,2,1,13,9,3,3,2.30655657,1013,186,8,76,86,10,7027,7042,15,26,35,9,1,98.18560381,NoArch
a9f107c4c5b1b1029793c66bd2ef222c52cef976,0,0,0,0,0,0,0,0,0,0,0,0,0.0,0,438,8,0,0,0,0,0,0,0,0,0,1,100.0,NoArch
0efaae854ed9743f3d07b7ce6fc85279eac14dd5,4,83,21,62,0,0,0,7,212,86,2,4,1.533304301,11409,122,3,995,987,8,71255,70830,425,375,371,4,1,100.0,NoArch
efa6afd0f3e8a5c2cde8f1c415f6b3f87c194c89,8,29,6,23,0,0,0,3,7,88,2,2,2.816298635,2350,35,3,181,181,0,11312,11342,30,116,116,0,1,100.0,NoArch
cc93065027dde291657771171f78dbeddf59e215,3,141,3,138,0,0,0,4,52,153,1,3,1.039932665,2492,30,1,233,212,21,17358,16521,837,76,72,4,1,100.0,NoArch
0bceb8e49e4896140b977f0ae5b99dc8a728308e,2,50,10,40,0,0,0,3,27,550,1,2,0.979868757,737,342,2,136,133,3,4856,4580,276,52,50,2,1,100.0,NoArch
5d95d998c38a965adaa0c7810ecb57520ef9f110,3,168,27,141,0,0,0,3,4,368,1,2,0.254138803,1156,436,7,199,180,19,7673,6850,823,49,44,5,1,100.0,NoArch
3eb60124b1269d0b32f783e07a2ed43e97b275e3,0,0,0,0,0,0,0,0,0,0,0,0,0.0,0,390,14,0,0,0,0,0,0,0,0,0,1,100.0,NoArch
5a8d8e49fb86478ba15f02674e2fae8de1eef761,3,15,2,13,0,0,0,5,123,106,1,2,1.159554752,4792,205,2,639,636,3,25470,25419,51,175,173,2,1,100.0,NoArch
57c0d2f36ea1eefafd6c2d649165a0532e28c3fc,0,0,0,0,0,0,0,0,0,0,0,0,0.0,0,490,4,0,0,0,0,0,0,0,0,0,1,100.0,NoArch
3a3185596327cbf493eb177f094153a98a8af790,3,15,2,13,0,0,0,5,123,27,1,2,1.159554752,4792,206,15,639,636,3,25470,25419,51,175,173,2,1,100.0,NoArch
45167a4cf67c5550f983172acb62c8e48ab1e090,2,65,2,63,0,0,0,2,76,337,1,2,0.111909909,1819,25,3,154,146,8,9310,8881,429,92,88,4,1,100.0,NoArch
6dabd8e992c1ace91b3612d39426f3fbd2d8fe2f,3,151,8,143,0,0,0,1,46,176,1,2,1.165902083,1455,452,24,212,188,24,9057,8340,717,74,66,8,1,100.0,NoArch
9355ceaa6cc45d42653c4d4bd38a868bc4c84d9c,0,0,0,0,0,0,0,0,0,0,0,0,0.0,0,8,1,0,0,0,0,0,0,0,0,0,1,100.0,NoArch
935b6888307419edfaa4ffa0cb77e888d581c7a6,4,111,7,104,0,0,0,1,10,136,1,4,1.875542648,1028,420,1,132,119,13,6637,6018,619,33,31,2,1,100.0,NoArch
4bedbc014dcb73ee8853bc0a78eb43b7804741d3,1,4,5,1,0,0,0,3,25,97,1,1,0.0,751,336,1,68,68,0,5042,5077,35,21,21,0,1,100.0,NoArch
fa23b096ac4a0577578da1da7aa82f33e617c0f8,1,41,2,39,0,0,0,3,25,26,1,1,0.0,717,404,23,68,64,4,5133,4865,268,21,20,1,1,99.970726,NoArch
1c9c7f6e4c41d77976726e9f84330008eb39c63d,2,18,9,9,0,0,0,3,14,266,2,2,0.691289869,886,60,0,119,115,4,5943,5876,67,31,31,0,1,100.0,NoArch
0af037d68cbd20af225b7940c1d0a394776b580f,1,2,3,1,0,0,0,3,39,65,1,1,0.0,564,224,4,59,59,0,3745,3754,9,8,8,0,1,100.0,NoArch
ca5d7d4b8e41ba318c90ea0232c32a797614d95d,2,108,19,89,0,0,0,5,124,148,1,2,0.369147641,3345,209,6,480,470,10,18826,18382,444,125,122,3,1,100.0,NoArch
714461f47e6408ec331acd0ddd640335e6a7a06c,2,207,38,169,0,0,0,2,37,92,1,2,0.993633397,1540,124,4,203,182,21,10216,9178,1038,99,88,11,1,100.0,NoArch
663ead2dc5f3778bbdeb0f479811e2d89f506afc,6,288,10,278,0,0,0,4,158,276,1,3,1.119942279,7425,102,0,960,935,25,45567,43700,1867,306,301,5,1,100.0,NoArch
028038dcfba6bf5242cc84ab8c69482853b3c4c9,17,455,178,277,0,0,0,1,218,154,3,8,3.174873021,15157,435,7,1603,1561,42,85636,83847,1789,628,615,13,1,100.0,NoArch
be0b47a0e58ccf166472e38bf15101434dd33b53,1,22,34,12,0,0,0,2,7,5,1,1,0.0,1122,218,15,121,123,2,5535,5577,42,37,37,0,1,100.0,NoArch
f673a1c99636b3dd4e2d3881338fb38c7dcb8fa3,0,0,0,0,0,0,0,0,0,0,0,0,0.0,0,283,28,0,0,0,0,0,0,0,0,0,0,100.0,NoArch
7a802b13d19c09ffe7bf0c331e0fac7234d0063b,3,95,5,90,0,0,0,2,12,0,1,3,1.310233267,1484,309,4,234,222,12,8778,8168,610,44,41,3,1,100.0,NoArch
495ec386f38c86fa073f86908740dcd384d74885,13,185,78,107,1,0,1,1,71,46,4,7,3.37394375,5036,460,32,505,476,29,29827,29152,675,238,237,1,1,99.83145121,NoArch
bd0e6bd2cdf9b49630375006c14e3f5fc5d25cb6,12,221,222,1,0,0,0,2,22,247,5,7,3.083412917,2660,203,8,278,278,0,14024,14143,119,111,113,2,1,100.0,NoArch
30c5b4705d2a220d862cfdd60683e4ab1a5a6acc,0,0,0,0,0,0,0,0,0,0,0,0,0.0,0,218,7,0,0,0,0,0,0,0,0,0,1,100.0,NoArch
20ef028f9769dc32b92bbc40e286c5fad58703b3,0,0,0,0,0,0,0,0,0,0,0,0,0.0,0,61,3,0,0,0,0,0,0,0,0,0,1,100.0,NoArch
d72cd949d52febc741f102d59413d6abe889df2b,3,27,168,141,0,0,0,3,5,6,1,2,0.254138803,1297,48,4,180,199,19,6850,7673,823,44,49,5,1,100.0,NoArch
6f0717e5e36f0d088d41256fe6a24af791692663,0,0,0,0,0,0,0,0,0,0,0,0,0.0,0,346,2,0,0,0,0,0,0,0,0,0,0,100.0,NoArch
3629dbe86583b3e2738652949b9050b83c42606e,6,0,0,0,0,0,0,1,17,207,1,3,0.0,2446,416,7,197,197,0,19151,19151,0,63,63,0,1,99.32787843,NoArch
4b5b20e23638965495f186fb6fc28f5d82346b80,2,190,66,124,0,0,0,2,60,90,1,2,0.942163169,2211,295,4,217,212,5,12937,11938,999,90,86,4,1,100.0,NoArch
7a61e5b85f44b2e33b87a184c7d0d00e800edf00,23,165,103,62,0,0,0,3,74,0,6,19,4.032390354,11322,319,18,877,871,6,72108,71518,590,464,463,1,1,100.0,NoArch
d26b8b2f2ffe99baa87ae49146989a959e7791f7,0,0,0,0,0,0,0,0,0,0,0,0,0.0,0,69,0,0,0,0,0,0,0,0,0,0,1,100.0,NoArch
ae267de541cc2014c770f34cf0e117c7e003b28c,4,286,4,282,0,0,0,1,24,98,2,3,0.917425727,1862,195,3,201,180,21,12860,11113,1747,83,75,8,1,100.0,NoArch
4995bccdb0b9b1bd491f21c34f3dbfca82710df9,0,0,0,0,0,0,0,0,0,0,0,0,0.0,0,5,2,0,0,0,0,0,0,0,0,0,1,100.0,NoArch
57827160a8772858f667aacba65c6589234c641b,8,317,30,287,1,0,1,1,6,294,1,4,1.625691013,2627,360,12,273,258,15,13569,11721,1848,113,103,10,1,98.87463426,NoArch
0efaae854ed9743f3d07b7ce6fc85279eac14dd5,4,83,21,62,0,0,0,7,212,86,2,4,1.533304301,11409,122,3,995,987,8,71255,70830,425,375,371,4,1,100.0,NoArch
73ce1d0e3dec284f15d3a61c4569813cf5ded3cd,3,120,46,74,0,0,0,3,13,107,1,2,1.134918602,1766,129,4,204,199,5,10598,9775,823,56,54,2,1,100.0,NoArch
51c8a8b7187af3791f6985d046b428fcb30666d6,7,135,21,114,0,0,0,3,58,45,2,4,2.334308151,3563,297,12,427,418,9,17629,17252,377,157,153,4,1,100.0,NoArch
e304e24f169f0db4a260924d354d019309e8ab5c,1,12,0,12,0,0,0,4,25,83,1,1,0.0,264,38,6,34,32,2,1715,1601,114,23,23,0,1,100.0,NoArch
fa5ae1ac2b8240e00abedf995b29c43c7af993fd,3,20,3,17,0,0,0,3,30,18,1,3,1.450908284,2024,117,6,206,203,3,11891,11793,98,75,74,1,1,100.0,NoArch
6c305bfa6b78140cfb8fb60f4b96f4a6c830c841,1,3,5,2,0,0,0,9,131,23,1,1,0.0,2036,38,2,297,297,0,11299,11296,3,104,104,0,1,100.0,NoArch
760cf0ca67513465536c42e6079a6b14f6f3e77f,0,0,0,0,0,0,0,0,0,0,0,0,0.0,0,274,18,0,0,0,0,0,0,0,0,0,1,100.0,NoArch
bfba46724d043dce22e0b313782b0c9e30bc2094,5,154,35,119,2,1,3,1,16,25,1,3,2.029150599,1007,10,2,147,134,13,6020,5559,461,70,65,5,1,99.71148298,NoArch
2422ca7584353f69bbc3ed2c1ce22374124d68e7,1,11,9,2,0,0,0,2,8,8,1,1,0.0,310,253,23,10,6,4,2726,2660,66,5,5,0,1,100.0,NoArch
89d36629f5c5994da71106770b1fd1adfce7a71f,0,0,0,0,0,0,0,0,0,0,0,0,0.0,0,269,17,0,0,0,0,0,0,0,0,0,1,100.0,NoArch
df87125e166675382e7da7a24c18730351c423a3,4,136,2,134,1,0,1,4,53,202,1,2,1.708505023,1148,427,0,114,105,9,7198,6459,739,51,49,2,1,99.94692144,NoArch
7f8fc7530b39106e238c67b7bd22d5ed5670d449,2,11,12,1,0,0,0,5,172,1,1,2,0.755375413,5652,8,6,677,678,1,34676,34690,14,191,191,0,1,100.0,NoArch
199ab0198d86344560675d2f46970de0f4053123,0,0,0,0,0,0,0,0,0,0,0,0,0.0,0,372,0,0,0,0,0,0,0,0,0,0,1,100.0,NoArch
9159e11700d3eff722fdda615565528182a619d2,2,145,20,125,0,0,0,4,27,71,1,2,0.945660305,1217,31,9,100,96,4,8631,7748,883,33,33,0,1,100.0,NoArch
7fe2dc59253f2f362db899c51f29a1a3f9568173,1,17,0,17,0,0,0,3,3,588,1,1,0.0,202,74,1,18,16,2,994,952,42,8,7,1,1,100.0,NoArch
e8610693f73454d0fc2deecb16f9026cc86cb43d,0,0,0,0,0,0,0,0,0,0,0,0,0.0,0,389,13,0,0,0,0,0,0,0,0,0,1,100.0,NoArch
84e1b8e847fc1ff9d2a897db2265319d94568214,0,0,0,0,0,0,0,0,0,0,0,0,0.0,0,398,17,0,0,0,0,0,0,0,0,0,1,100.0,NoArch
559099ea6144e933f7a386a356e351d680dd8408,1,1,69,68,0,0,0,1,5,0,1,1,0.0,242,417,8,12,16,4,1148,1587,439,4,6,2,1,100.0,NoArch
9361cc03035f838e90b46e886bbcb00f1bab85fd,0,0,0,0,0,0,0,0,0,0,0,0,0.0,0,41,6,0,0,0,0,0,0,0,0,0,1,100.0,NoArch
6ec3580ee62d92bf2d2f9d51c10fb13761317893,15,64,9,55,0,0,0,2,130,126,4,8,3.694168474,7325,190,6,927,927,0,38791,38470,321,329,329,0,1,100.0,NoArch
66b374e58258b3cddeaf1c73b5af695c23027b05,2,8,4,4,0,0,0,4,13,33,1,1,0.918295834,674,167,13,71,70,1,3441,3383,58,36,36,0,1,100.0,NoArch
cd068538d7ecc2cf18c606dfcf0bcbebcf2dbe11,0,0,0,0,0,0,0,0,0,0,0,0,0.0,0,1,0,0,0,0,0,0,0,0,0,0,1,100.0,NoArch
d489dcfc34454c4a487ce13a3c91140d712fdba1,18,67,50,17,0,0,0,2,153,31,7,11,4.00620641,17748,6,6,1909,1906,3,98672,98581,91,682,681,1,1,99.88314344,NoArch
6607e9448bae7dc24a777485dedb2e5cf787ee83,9,72,10,62,0,0,0,4,128,165,3,8,2.720190839,5091,330,2,547,542,5,35926,35506,420,201,197,4,1,100.0,NoArch
1333a83a5fd279daadcb49ee9b1a36d7961312a8,1,1,1,0,0,0,0,3,4,54,1,1,0.0,150,2,1,12,12,0,694,696,2,6,6,0,1,100.0,NoArch
d41819695864661af6be1f6bbd5d9723cc64d4f5,3,178,79,99,0,0,0,3,91,9,2,3,1.350983842,2721,208,12,369,352,17,16641,15967,674,136,127,9,1,100.0,NoArch
0ccc8e0c74773430282756a92d69bb8db27bdac0,0,0,0,0,0,0,0,0,0,0,0,0,0.0,0,226,6,0,0,0,0,0,0,0,0,0,1,100.0,NoArch
fba3a5121d00016fb055f96dbe8acc58d834e134,3,39,35,4,0,0,0,3,60,33,1,3,1.040996439,1977,334,6,136,136,0,8839,8760,79,34,33,1,1,100.0,NoArch
beca145bbe61bc60a0e923072f95d8423f955ddc,2,50,24,26,0,0,0,4,137,0,1,2,0.877962001,6463,202,9,653,654,1,39735,39605,130,218,219,1,1,100.0,NoArch
413c3cc7991e810d6b49539d71ecc930e838238e,8,203,61,142,1,0,1,3,118,50,3,4,2.017428851,11716,422,5,887,874,13,71395,70577,818,425,415,10,1,99.8914695,NoArch
44a6bb686b08326b45c232fb7466b43c574fe7c1,6,94,56,38,0,0,0,5,89,68,1,2,2.205069425,6325,87,4,470,476,6,38463,37993,470,270,268,2,1,100.0,NoArch
3f81c87152d4bca08605fc71d559931d025f7f3c,1,1,0,1,0,0,0,4,6,0,1,1,0.0,172,50,5,22,22,0,933,922,11,6,6,0,1,99.82028241,NoArch
7476fae834bafb7a36d17382a08a5385fee0e343,23,521,201,320,0,0,0,2,32,98,2,13,2.951460533,12369,413,7,1316,1265,51,66763,65383,1380,491,477,14,1,100.0,NoArch
c76ef84b825a38df01082df86dbe8642ecfd6269,2,108,19,89,0,0,0,5,124,36,1,2,0.369147641,3345,211,14,480,470,10,18826,18382,444,125,122,3,1,100.0,NoArch
8c6cab4a23109e60a1fa4cc0267bda959aee9396,3,63,36,27,0,0,0,2,7,48,1,2,0.485828213,2908,215,13,355,349,6,14851,14715,136,149,144,5,1,100.0,NoArch
18e9a5f22825f3e11a679ac03683f6de9179f9f0,4,74,32,42,0,0,0,2,56,44,1,3,1.244100756,2713,285,0,330,324,6,15253,15034,219,89,84,5,1,100.0,NoArch
163d8049d9b9107257b1aed707ffe195a41e6dbd,1,15,8,7,0,0,0,8,132,62,1,1,0.0,2077,51,0,302,302,0,11592,11571,21,106,106,0,1,100.0,NoArch
ae84f1d239dfb76ac91d1f97688ef205ac1fcf0b,0,0,0,0,0,0,0,0,0,0,0,0,0.0,0,174,8,0,0,0,0,0,0,0,0,0,1,100.0,NoArch
83e5307dbf5c7417e5b9f8da24c56c6b060ac48f,0,0,0,0,0,0,0,0,0,0,0,0,0.0,0,40,5,0,0,0,0,0,0,0,0,0,1,100.0,NoArch
de87def6b5f577b49c3fa2e1aaddeb29dece777c,5,204,112,92,0,0,0,3,23,238,2,4,2.096596244,1719,179,10,215,203,12,10670,10149,521,58,51,7,1,99.87604586,NoArch
cacae67a910a4957d982981e72a0d71a6f57dc56,1,4,4,0,0,0,0,7,69,234,1,1,0.0,1011,7,0,133,133,0,5939,5929,10,27,27,0,1,100.0,NoArch
6662605342e17335c31ad9177017d898e13f532d,1,4,0,4,0,0,0,6,92,0,1,1,0.0,1963,208,5,298,298,0,10913,10887,26,108,108,0,1,100.0,NoArch
317d45a5d410f2e6afedbe8563c258f4cc667d67,0,0,0,0,0,0,0,0,0,0,0,0,0.0,0,35,6,0,0,0,0,0,0,0,0,0,1,100.0,NoArch
0d87102e4bdb9f50425d295d396825a5fbd37dd0,14,986,396,590,5,0,5,4,160,78,1,4,2.235971827,5424,432,4,700,639,61,33508,30797,2711,320,285,35,1,99.75649351,NoArch
89d36629f5c5994da71106770b1fd1adfce7a71f,0,0,0,0,0,0,0,0,0,0,0,0,0.0,0,269,17,0,0,0,0,0,0,0,0,0,1,100.0,NoArch
87a99d022b20d4cc4243c67e89e3b2f508bf673a,1,2,2,0,0,0,0,2,2,167,1,1,0.0,234,47,2,32,32,0,1283,1281,2,11,11,0,1,100.0,NoArch
a3a9ceaad6d94200889f30a8d41cd1d42689797f,1,5,5,0,0,0,0,2,8,0,1,1,0.0,1110,219,16,121,121,0,5555,5535,20,37,37,0,1,100.0,NoArch
a5713a41fb9f5f7b885109f09ee7c03d1da03b66,2,232,1,231,1,0,1,1,4,4,1,2,0.0712504,112,194,19,24,7,17,1937,622,1315,19,2,17,2,90.53772405,Arch
5b464f27da273723e422607518c271cd3f040560,57,4236,663,3573,10,1,11,1,111,79,6,19,4.138160375,14443,177,9,2020,1508,512,89545,70046,19499,859,683,176,1,94.84995945,Arch
351a610589ef6f47bf00937c7f3289f4c4c1a204,29,467,254,213,0,0,0,1,29,162,3,18,3.949925777,11643,199,9,1206,1211,5,59043,58585,458,490,496,6,1,91.31956598,Arch
0df108154743ff689e3ba4ff2671e6c809eeb660,7,188,108,80,1,0,1,1,15,51,1,6,2.069991156,1524,200,10,160,157,3,8455,8073,382,67,64,3,1,95.61024277,Arch
693f2ca92777178a0cc6315d28c174da8115c125,25,12,47,35,0,0,0,2,112,297,7,18,3.950165197,10248,180,6,1240,1240,0,53259,53653,394,468,468,0,1,94.06282361,Arch
f58508a5692c817a11b7996ba563ba8a26b85560,20,1380,280,1100,4,0,4,1,113,24,2,9,3.733855214,9513,181,7,1382,1242,140,58228,52224,6004,497,423,74,1,96.05418139,Arch
6a2585764c64d0b70be34b59fab1c964a54588b4,10,531,58,473,3,0,3,1,114,112,1,6,2.629968939,5796,183,9,752,699,53,35238,32228,3010,241,213,28,1,88.87751621,Arch
98d5a31cb7f2963a7395c69f4942543dc050d82d,6,25,159,134,0,2,2,3,45,377,1,3,2.062680868,3115,206,7,240,248,8,16334,16720,386,143,149,6,1,90.08509064,Arch
4a60f05c105188aefb48f64c4ccf2efbc4b26da0,4,102,27,75,1,0,1,3,34,34,2,3,1.655116073,2127,208,9,219,210,9,11766,11378,388,69,67,2,1,94.1771376,Arch
9bca4c96b2e35c9a2dcb7dde927b22976f6b6c26,9,58,21,37,0,0,0,2,87,99,3,5,2.570313423,4153,193,15,503,500,3,21550,21359,191,184,183,1,1,94.28746929,Arch
34a557d1318aee9b23f5ac7ded9bccfd72508de1,25,534,114,420,2,0,2,1,120,50,7,19,3.515837239,15272,225,18,1844,1803,41,92460,89935,2525,595,583,12,1,93.58086847,Arch
792cda59370ff493b7672da4f5c80e1929eecd61,9,777,213,564,5,0,5,1,31,28,3,5,2.743452179,1419,226,19,93,55,38,8151,5271,2880,49,30,19,1,97.54001186,Arch
ed0bd643131934504dad60b326520c1d0f3d99c5,1,35,0,35,1,0,1,1,1,0,1,1,0.0,0,227,20,0,0,0,33,0,33,0,0,0,1,95.72885092,Arch
a062271bef2b592864f4467957241ad26cfcb8a6,10,326,73,253,0,0,0,1,121,59,4,7,2.495837957,7061,203,14,735,696,39,42790,41585,1205,288,270,18,1,97.27473607,Arch
5f58ecad2eea60e21ded81d586d60d7fe678588b,3,417,1,416,2,0,2,3,8,12,1,2,1.033595948,480,175,6,48,10,38,6837,4171,2666,14,3,11,1,95.05208333,Arch
1624e1f119f5d24c674c74fd82dc254c966a43d6,7,57,40,17,0,0,0,4,127,58,2,4,2.416315628,8553,177,8,893,891,2,45913,45913,0,353,349,4,1,97.92293799,Arch
6e07f0388b4a99a7d921ea697fb0c6cad2cea674,20,416,298,118,3,0,3,2,25,70,6,10,4.027637278,4813,180,10,433,425,8,25123,24897,226,190,189,1,1,95.70883662,Arch
0c324736bbcfa3d945cf9063426f0b04c50fcbf4,20,298,416,118,0,3,3,2,26,0,6,10,4.027637278,4931,181,11,425,433,8,24897,25123,226,189,190,1,1,95.70883662,Arch
7083f0119e48de342fad8ac1173ae18366ddd801,18,350,294,56,3,0,3,2,27,0,6,8,3.873905624,3735,182,12,348,348,0,20704,20721,17,176,176,0,1,95.70883662,Arch
d775daaee0743730df70b2a5e9bb6e30d03c4171,6,124,8,116,1,0,1,2,93,32,3,4,1.83828512,3484,217,9,449,438,11,20695,20061,634,159,155,4,1,97.53542822,Arch
617c8b8eab5193c3c26b77431153fc33d5099bf9,1,440,0,440,1,0,1,1,1,0,1,1,0.0,0,240,6,59,0,59,3013,0,3013,21,0,21,1,96.97717458,Arch
0a681b34e154bf622c68f753820153d7ee77f4c4,22,590,88,502,1,0,1,2,128,78,5,10,3.177706243,13779,184,10,1424,1376,48,80427,76906,3521,539,519,20,1,90.92572265,Arch
465dea1cca9b6030bd6cbe23826288ae21b38497,8,202,163,39,0,0,0,3,94,17,4,7,2.100320078,5217,185,11,647,640,7,28961,29143,182,241,238,3,1,88.43143927,Arch
e9b222e9b41ef13af962a80dc32d6512a75ad017,2,152,45,107,0,0,0,4,129,20,1,2,0.999981413,5866,189,5,612,600,12,36182,35064,1118,207,204,3,1,97.353914,Arch
26ad7037c3c01347be63ad33810faee0a3922a94,10,1763,8,1755,4,0,4,1,24,111,3,9,1.826709089,1034,246,8,212,48,164,14123,3198,10925,79,18,61,1,96.26911315,Arch
06ee16a33242099db958e6e9d8df6e322198049f,4,381,4,377,1,0,1,2,14,233,3,3,0.843859539,519,247,8,80,57,23,6141,3190,2951,22,13,9,1,97.03957619,Arch
bc65796146fca5d7d6eb49e85e20fda5bade0b57,43,2564,879,1685,8,1,9,2,131,126,5,15,4.398252203,13508,223,3,1846,1634,212,83517,72163,11354,765,714,51,1,94.16002058,Arch
b3a9ec0e7026ec3e5aea26a499dee5b7824c310e,2,49,12,37,0,0,0,1,25,146,2,2,0.560576943,636,227,6,83,79,4,3593,3395,198,22,19,3,1,94.63123644,Arch
acd0a46e36d01ec5d98b9ca263741c4238f0f9aa,15,1913,785,1128,6,1,7,2,74,218,4,9,2.597379992,2460,257,5,334,218,116,17820,12209,5611,149,81,68,1,91.35770235,Arch
8e351a4a37050eaa9c226528e97edec7a8a4337f,8,370,181,189,1,0,1,4,134,235,1,3,2.329082517,8479,198,6,947,923,24,50912,49575,1337,315,313,2,1,92.88256228,Arch
249f7482cdeff968b70db028eb18729d892ff2f5,5,204,46,158,1,0,1,4,135,34,2,4,1.487090211,6463,199,6,667,658,9,39954,39117,837,224,219,5,1,89.55067921,Arch
af9bd5bde1c36441c0fb1a12ae9b9aa33fb0213d,18,123,48,75,1,0,1,3,21,308,3,5,3.74754614,2319,200,7,304,296,8,12116,11574,542,167,163,4,1,96.04588723,Arch
d3fdd81bce50e9e4ac3b0b9f7e773d79eb9ac2a1,13,478,71,407,1,0,1,3,138,132,4,11,2.637555054,9305,259,2,919,883,36,59468,57067,2401,337,319,18,1,93.54454502,Arch
94499c9b8b494e83f6a6d6b8bf166192b58d547f,13,648,127,521,2,0,2,1,139,129,2,8,2.715867082,12944,230,2,1158,1139,19,81017,76972,4045,458,448,10,1,96.40685462,Arch
5bd8e4fd789efe0b3aea1ac2c8da9c00d6f63d23,19,1118,394,724,7,0,7,3,31,202,2,13,3.103275249,2633,264,6,263,215,48,18916,14446,4470,162,130,32,1,95.21503845,Arch
ee2f6aa6bbd40f6a72741fd047ba024f18f23ad5,252,5039,19156,14117,3,57,60,1,120,17,9,81,6.771308724,77432,235,0,6098,7485,1387,341095,428248,87153,2690,3270,580,0,86.77359979,Arch
f0e8a73f41a736c1bee50891e2c963c0f75ceeca,10,326,73,253,0,0,0,1,121,299,4,7,2.495837957,7061,203,0,735,696,39,42790,41585,1205,288,270,18,1,97.27473607,Arch
ba92893109644cb99a170e4b69b4b045168637eb,2,49,12,37,0,0,0,1,23,125,2,2,0.560576943,609,214,11,78,74,4,3482,3284,198,21,18,3,1,94.1662227,Arch
afe0c2dadef13e99446f5075d7105dce65359926,256,18314,5190,13124,54,3,57,2,141,82,9,85,6.732744309,66073,265,7,7698,6434,1264,434474,351787,82687,3355,2822,533,1,86.96035242,Arch
f531ed55065fd567585aad9789b4c91e8885fab6,256,5148,18412,13264,3,59,62,1,126,45,9,85,6.739609,79197,0,0,6434,7698,1264,351787,434474,82687,2822,3355,533,0,86.96035242,Arch
7295edd51658e10431ac3428855b0a79b0d5039c,256,18314,5190,13124,54,3,57,2,141,82,9,85,6.732744309,66073,0,0,7698,6434,1264,434474,351787,82687,3355,2822,533,0,86.96035242,Arch
03633b839e6af006b893dca05951b345065eff14,262,5356,18735,13379,3,59,62,1,126,45,9,86,6.779664199,81707,3,0,6699,7992,1293,365883,449128,83245,2934,3480,546,1,86.91561305,Arch
5ae6a40b694229574097f0bc75bca522a7bc00c2,263,18658,5419,13239,54,3,57,2,141,81,9,86,6.779039985,68536,237,6,7992,6699,1293,449260,366001,83259,3480,2934,546,1,86.91561305,Arch
6bb06d067e1342fe05acae108ded89c20cdf83de,34,1105,1095,10,1,2,3,3,41,51,6,12,3.507159375,11971,208,2,1143,1134,9,72830,73362,532,417,408,9,1,92.92324442,Arch
3535b142fd83745c9901d9f826d952b47eca26e2,28,4232,180,4052,18,0,18,1,26,39,4,9,4.435331618,2280,269,3,454,159,295,31581,12364,19217,305,76,229,1,94.25721219,Arch
7296793c87fc37f3fa3d588104abd8c3b0648bfd,12,73,275,202,0,0,0,1,42,11,3,3,3.225835688,4874,270,4,423,426,3,29774,31378,1604,130,131,1,1,90.91700522,Arch
e7e0b3fb6fbabbdb7fd06108359a00f50da5ebcf,16,849,344,505,2,1,3,3,143,189,5,10,2.756596731,8763,271,4,907,860,47,54730,52417,2313,350,320,30,1,90.35777721,Arch
97805278ed9b7e9f8a20521574b22515d1c553e7,37,365,944,579,0,0,0,3,44,58,5,17,4.223243002,12071,273,6,955,1009,54,64109,67330,3221,478,498,20,1,93.30669331,Arch
af46100b48c44c2bee0e580e072e53b15cb513f7,12,102,109,7,0,0,0,1,46,0,3,4,2.876927533,4302,275,8,398,400,2,26465,26508,43,167,167,0,1,90.41297935,Arch
333d64434c5523d8885245e66974bc151d6d9f6a,6,84,8,76,1,0,1,4,22,105,1,5,2.235170026,1022,4,2,62,57,5,6233,5937,296,34,31,3,1,90.90016367,Arch
36d08fe03b99ec154b9c91d158d7daecb84d1fa4,42,636,229,407,2,0,2,3,144,76,9,30,4.026047713,14576,239,0,1684,1665,19,91007,89028,1979,614,603,11,1,94.43501866,Arch
57b5875ab7122269f26b665e022be3df59142068,15,303,169,134,4,0,4,3,22,260,4,4,3.411632872,1695,279,10,162,163,1,7727,7593,134,84,85,1,1,86.52544866,Arch
47b52156cddd2ca9557dda6b673516a82df4facf,9,98,63,35,1,0,1,2,23,187,3,5,2.617945949,1961,222,11,207,207,0,10357,10048,309,89,89,0,1,93.70661731,Arch
da9bec23970b7bbf8060a97473f7b69c79b255db,6,10,99,89,0,0,0,3,6,12,1,1,2.550898533,348,282,12,21,31,10,637,836,199,18,28,10,1,88.44580777,Arch
2050f50e9e7d25c7b48ccc71fb507b4bf8bba23e,60,875,873,2,0,0,0,3,43,49,6,32,5.340985696,19565,224,11,1759,1759,0,103274,103072,202,798,798,0,1,94.99241275,Arch
74d04a48ac8572631b6b73fc27350526397c00e7,43,499,354,145,2,1,3,3,145,63,5,18,4.717521375,22065,225,11,2264,2256,8,134928,133874,1054,873,872,1,1,91.99888486,Arch
170af76fee3cefe524ae651c00389ade647dd698,18,62,135,73,0,2,2,2,41,165,6,12,3.64744478,4910,227,12,449,454,5,28183,28427,244,188,192,4,1,89.62318841,Arch
3e785f183ad5482d3bcf815a01966c2af146df99,8,179,29,150,2,0,2,3,18,50,3,6,2.144493477,2608,285,11,312,298,14,14269,13649,620,123,109,14,2,92.46107621,Arch
cb3338e86e88ae23bb6ec11945c3694d2277eff0,6,148,59,89,0,0,0,2,45,223,2,4,1.755982132,2551,286,12,228,215,13,12007,11555,452,59,57,2,1,91.82124789,Arch
bec90035b7597a48607299e7ae2cc881086f50e7,2,271,3,268,1,0,1,1,25,7,1,2,0.242961127,237,9,5,33,14,19,3454,1596,1858,16,7,9,1,96.21034078,Arch
e49ed3397cefe80700be58c3739d3d8d98d40c04,3,345,31,314,1,0,1,3,102,9,1,3,1.010525311,2263,288,11,337,304,33,14654,12789,1865,121,108,13,1,91.56424581,Arch
1d7ad6f73b4409c5f9f13978588768cf43cccafd,6,309,21,288,1,0,1,6,103,7,3,4,0.981872288,3450,289,12,538,500,38,19945,18215,1730,180,167,13,1,95.26594263,Arch
2213c109edce1380dfab9fe103d7441bb5e1e399,63,765,505,260,0,0,0,3,146,70,6,24,5.543061561,20018,290,11,1861,1834,27,118399,117197,1202,833,801,32,1,95.11981297,Arch
1c16b5bfc22cc5f09029c240fd2edd97954fa800,5,41,14,27,0,0,0,2,9,206,2,4,2.036999904,1428,247,7,196,195,1,7792,7583,209,62,62,0,1,90.8600701,Arch
62bbbdb78d6060688be33afe8dcec0a89eb0daa1,1,1,4,3,0,0,0,1,8,2,1,1,0.0,110,294,15,13,13,0,538,566,28,5,5,0,1,89.15629322,Arch
0306928f7ce6c51fb56a573a5403a7cb132571bd,2,83,3,80,1,0,1,1,12,52,1,2,0.271389588,131,297,18,20,12,8,1102,729,373,9,7,2,1,92.2459893,Arch
57d342cc32600956956f04fda3408f0a8e617a37,16,463,65,398,2,0,2,2,104,49,2,10,3.187859064,6490,300,21,748,703,45,37019,34783,2236,289,270,19,1,94.94759473,Arch
0df3d0f6f4f175dc013cc0286230eb5ddde98bed,9,21,18,3,0,0,0,3,105,16,5,4,2.953412455,6363,230,12,772,772,0,38134,38060,74,256,256,0,1,90.13465238,Arch
e92dc7fe4ed611ef88f77934940cd47a5da3ea11,30,146,132,14,2,0,2,3,31,177,6,15,4.009441038,4751,231,10,465,470,5,23605,23776,171,219,221,2,1,85.29216467,Arch
1831fda98497101566665d6157ceec02ff2166a4,32,811,388,423,2,0,2,2,46,4,6,11,3.933445678,12020,233,10,1166,1114,52,69798,68646,1152,564,536,28,1,85.18406759,Arch
78e1bc3a42091bdb31051093fa048b6dceb21b1c,6,97,72,25,0,1,1,2,13,244,4,4,2.055127364,939,234,10,79,76,3,5180,5171,9,35,32,3,1,93.72060858,Arch
b0c87d9b201d77f79cde6e6b37367deeb4c570f5,13,171,188,17,0,0,0,3,54,4,3,9,2.078427672,5880,303,20,589,595,6,35478,35936,458,217,217,0,1,93.47442681,Arch
ed32980f8352615aee9af8cbc8c865749fa37d4c,7,448,828,380,1,1,2,3,55,39,2,4,2.136319447,2410,235,6,177,212,35,13450,16019,2569,63,62,1,1,87.19062093,Arch
674158224b80f3eff1cbf0cb46304813a18634b6,9,108,413,305,0,1,1,1,106,68,3,7,2.785939221,4725,237,8,594,630,36,25411,26898,1487,210,224,14,1,79.93311037,Arch
80542718645d96cf23865428a166fe6aa3594a61,2,104,0,104,2,0,2,1,1,0,2,2,0.939115196,0,238,9,7,0,7,229,0,229,6,0,6,1,79.7993311,Arch
27e5b6c686870a72d30c1613376ea908761ea40f,139,824,799,25,1,1,2,3,147,21,7,54,6.41859076,41122,242,13,3857,3859,2,231085,231101,16,1742,1744,2,1,81.80322474,Arch
33982e1c54c5f087df0ad5e1bb458752769d5f8f,27,1333,1125,208,2,0,2,3,48,77,4,15,3.24513365,9107,306,18,878,875,3,53236,52843,393,369,356,13,1,93.35053024,Arch
6507bda6c86828cbefaaba364eeaa74e4ddae7b5,103,504,437,67,0,0,0,1,71,45,8,42,6.081212942,29508,244,14,2512,2501,11,170312,169344,968,1332,1326,6,1,96.39158035,Arch
309e9c06019355c668532d636b54c8f0b0c5128d,9,615,250,365,2,1,3,3,28,111,4,5,2.491597637,1167,245,15,134,122,12,8282,8327,45,52,48,4,1,90.90909091,Arch
eec14eb2b85a72021e8b06204f558b20b0251b2b,3,293,5,288,1,0,1,1,66,61,1,2,0.313975692,3071,252,7,316,304,12,16539,14482,2057,141,133,8,1,96.96874013,Arch
0d5fdf3dec8c22ba642eaa10b760fa8aced1c74e,54,452,503,51,1,0,1,2,109,10,8,36,3.691325948,21130,309,16,2167,2181,14,121417,121959,542,832,841,9,1,95.41446208,Arch
0557abf670e801958edb906b30046990ac27e20d,2,76,57,19,0,0,0,2,6,44,1,2,0.411645571,521,249,19,38,41,3,3443,3301,142,23,23,0,1,96.02984279,Arch
0361dd8f2abf25710743a163f30aa5252e6fbb75,26,189,188,1,0,0,0,2,112,67,6,16,3.921610498,11050,251,21,1110,1110,0,60643,60544,99,389,389,0,1,95.07565337,Arch
bf4f47dd00c9321f09c9bdfd66867f1255c76f72,10,17,24,7,0,0,0,3,16,26,3,5,3.110260163,2859,254,24,248,248,0,17353,17413,60,105,105,0,1,90.22066199,Arch
bd4a6049f19a146625eebd7d3c211b38d41eee74,43,280,28,252,7,0,7,4,33,86,4,26,4.885665766,5323,257,7,478,477,1,24742,23784,958,215,215,0,1,92.65996148,Arch
5d78968efad42710120b5f588160ff76588e3d6b,14,0,28,28,0,0,0,5,37,107,3,13,3.440759833,3119,259,9,340,340,0,16147,16410,263,137,137,0,1,97.0617431,Arch
4a41ccf06ffbcc8103b008f43c23442b5f4e988d,48,435,17,418,9,0,9,1,51,73,2,25,5.141220433,10624,260,10,1186,1186,0,53582,52672,910,562,562,0,1,92.18970737,Arch
41f5cd8a2cef0bd78f8208881459c0165f4cb56d,35,134,13,121,1,0,1,1,1,0,2,6,0.890032732,9073,257,27,876,858,18,52175,51560,615,330,327,3,1,90.33722438,Arch
469bf9052f7a51e67c82b4db300d71992d5fd874,53,477,366,111,5,0,5,3,40,0,6,28,5.290810374,12351,259,29,1027,1027,0,67330,67185,145,553,553,0,1,96.94708277,Arch
16fdf1bbbbdf7b315424fd9743d12962c7db375b,14,321,144,177,0,0,0,1,149,52,5,11,2.643250295,8783,261,31,1049,1032,17,50118,49402,716,292,275,17,1,93.53448276,Arch
c534a12c4344b47454d3137fa2010485cb517afd,19,918,431,487,3,1,4,3,25,56,2,9,3.527146736,5453,324,19,591,575,16,31439,28006,3433,222,213,9,1,89.19093851,Arch
d782e7ab6ebf6312a6b97408f940edf47476dab4,2,56,3,53,1,0,1,1,58,8,1,2,0.728656167,759,272,16,5,2,3,1688,1489,199,4,2,2,1,95.40329575,Arch
8e9ee5653781474a22d9e012c88be2b100c3bab7,5,7,115,108,0,1,1,4,4,626,1,1,1.112508674,1080,20,5,145,156,11,4285,4638,353,84,90,6,1,96.60825325,Arch
9085e7bb4d3d9a5c1a91aac48048da8127cee17a,16,991,31,960,8,0,8,3,157,26,3,8,3.393119948,10019,332,7,1090,1011,79,63494,58758,4736,407,366,41,1,88.7434555,Arch
176b12cde8421582e05afbf1cb5e1b46f3cf0d38,3,417,66,351,0,0,0,6,83,64,1,2,0.995823661,3895,21,3,218,203,15,27905,25830,2075,133,131,2,1,91.58529581,Arch
43e47bfac239dada7564b6f8e78462143be06ec7,3,684,5,679,1,0,1,1,12,49,2,3,0.463232217,1351,281,9,272,202,70,10983,7434,3549,62,29,33,1,88.61185984,Arch
fba3a5121d00016fb055f96dbe8acc58d834e134,22,46,860,814,1,3,4,0,83,17,5,13,1.820356736,10077,334,6,790,873,83,53709,57972,4263,360,398,38,1,88.2928475,Arch
2bdac27495f6899b766e537576e7edf6df53c7a3,27,1053,66,987,4,1,5,3,158,53,5,14,2.562507001,13882,282,10,1531,1434,97,85227,79884,5343,598,555,43,1,86.51718113,Arch
d6589d3accf01ce77adea74b8595f70431611563,5,20,193,173,0,1,1,3,159,0,2,4,2.030236406,4792,283,10,644,658,14,26115,27328,1213,195,200,5,1,89.16811092,Arch
f65e65aea8cbdb44dd65c6590fbe38dd84413a5a,9,2243,246,1997,3,0,3,1,160,23,1,2,2.272455899,10257,284,9,1273,1181,92,69007,56627,12380,453,378,75,1,89.97469956,Arch
80b5795b13b7483d876b741245708a56794cd771,3,66,417,351,0,0,0,6,85,0,1,2,0.995823661,4246,23,3,203,218,15,25830,27905,2075,131,133,2,1,89.26553672,Arch
fcc74261a0d76d00580f4d0dca042a1ed014ccec,3,417,66,351,0,0,0,6,86,0,1,2,0.995823661,3895,25,5,218,203,15,27905,25830,2075,133,131,2,1,89.26553672,Arch
fb05aace5062dc441da80f5ac8d4e322ab2a15ef,5,194,19,175,1,0,1,3,161,0,2,4,2.030236406,4639,286,11,660,644,16,27360,26132,1228,200,195,5,1,87.02377542,Arch
b4580a7b81ab1a5619987296641ebbf50fda4c55,17,1077,106,971,1,0,1,3,162,32,4,11,2.352053854,14648,336,6,1450,1384,66,94304,88288,6016,541,519,22,1,94.7862069,Arch
8d8972e33d199164191a4e671a90fd49171d9053,42,370,3458,3088,1,7,8,3,158,16,5,19,3.380466253,26892,335,5,2326,2522,196,136690,155565,18875,928,1049,121,1,87.28149488,Arch
e709d62aaf56115a771a361bc83d9d4bdd7bb924,42,3458,370,3088,7,1,8,3,162,51,5,19,3.380466253,23804,337,7,2522,2326,196,155492,136750,18742,1049,928,121,0,87.28149488,Arch
aa8d8053eaf9650b7ff60204020fa6466f857509,42,370,3458,3088,1,7,8,3,158,16,5,19,3.380466253,26892,336,6,2326,2522,196,136690,155565,18875,928,1049,121,1,87.28149488,Arch
b62298e1054c934e4ee8909b7ba3165ce344ea8b,42,3472,377,3095,7,1,8,3,162,51,5,19,3.406770028,24137,287,12,2550,2354,196,158788,139990,18798,1043,922,121,1,87.28149488,Arch
5e5683ab5e89f1fd88883ed40574c8fb04316dd1,8,574,8,566,4,0,4,1,119,23,2,4,2.017500121,4828,285,2,707,654,53,28847,25436,3411,250,215,35,1,96.21008654,Arch
7d1303fa606e700bd4d4b2a122a73a5badbbc889,1,201,76,125,0,0,0,2,2,83,1,1,0.0,247,290,15,19,23,4,2263,1253,1010,6,5,1,1,88.96969697,Arch
18e9a5f22825f3e11a679ac03683f6de9179f9f0,66,3376,4528,1152,12,11,23,3,158,5,5,26,4.756340489,32621,285,0,3245,3197,48,180312,190296,9984,1251,1268,17,1,83.98642394,Arch
dbe6a38a5646841fa60e103566d3a54cc8f3065e,74,4566,3390,1176,11,12,23,3,162,36,5,29,4.79684877,34868,339,8,3479,3526,47,212039,202141,9898,1396,1378,18,1,83.98642394,Arch
f83387931c191631772e95f0626888a918e2751f,66,3376,4528,1152,12,11,23,3,158,5,5,26,4.756340489,32621,337,6,3245,3197,48,180314,190298,9984,1251,1268,17,1,83.98642394,Arch
938097d85f6f943a399c16fa50f07a7e2b05bdb5,66,4535,3376,1159,11,12,23,3,162,39,5,26,4.759872709,31469,26,5,3198,3245,47,190273,180374,9899,1268,1251,17,1,83.98642394,Arch
59c0462aa851d30eae934075314a4ad18ae99a88,66,3376,4528,1152,12,11,23,3,158,6,5,26,4.756340489,32628,24,4,3246,3198,48,180362,190346,9984,1251,1268,17,1,83.98642394,Arch
3b34c4182839c63a0fa0dac66b22d8990acb04e0,66,4528,3376,1152,11,12,23,3,162,39,5,26,4.756340489,31476,27,6,3198,3246,48,190273,180422,9851,1268,1251,17,1,83.98642394,Arch
8bd2ca352664fab8d248593f60faa6c0ff223920,2,150,18,132,1,0,1,1,5,36,1,2,0.899393971,384,340,9,56,47,9,2731,1927,804,22,19,3,1,96.14450516,Arch
10b1f2058c5a8b53b3711f318da70ed23acc1937,66,3376,4528,1152,12,11,23,3,158,6,5,26,4.756340489,32628,338,7,3246,3198,48,180362,190346,9984,1251,1268,17,1,82.65492102,Arch
e328055e61a8dcaa1beed25e6da47f4a2279f3b6,73,4552,3388,1164,11,12,23,3,162,34,6,27,4.786869413,33400,28,7,3367,3413,46,202610,192668,9942,1333,1316,17,1,82.65492102,Arch
2d04d64aa770d7b1cc646bbe7a75c97dfe50afc3,66,3376,4528,1152,12,11,23,3,158,6,5,26,4.756340489,32628,26,5,3246,3198,48,180362,190346,9984,1251,1268,17,1,82.65492102,Arch
625450cf11454fa9697a902ba70367de00cdc170,75,4938,3412,1526,11,12,23,3,162,62,5,30,4.888795064,33944,13,1,3499,3494,5,203998,192252,11746,1378,1347,31,1,82.65492102,Arch
21ef8cd20e327927684e756b041a045df72d1c8f,75,3412,4938,1526,12,11,23,3,158,22,5,30,4.888795064,35515,27,6,3494,3499,5,192455,204334,11879,1347,1378,31,1,82.65492102,Arch
4cf6472e39018d8809a945f4ccb39155d8c03220,92,6265,3662,2603,15,12,27,3,163,46,6,38,5.142913282,37185,287,2,3998,3854,144,231029,213014,18015,1545,1467,78,1,84.61758808,Arch
7a381304a266c88ee84d936c1960c36a9015a174,75,3412,4938,1526,12,11,23,3,159,26,5,30,4.888795064,35536,286,1,3498,3503,5,192633,204516,11883,1350,1381,31,1,85.3051779,Arch
4ab67799f3b7115ebf6117993861dc0cd9634b24,76,4965,3439,1526,11,12,23,3,163,58,5,31,4.913412664,34254,288,3,3522,3517,5,205961,194211,11750,1396,1365,31,1,85.3051779,Arch
4e085fa32759445f428493c3df5b55ca235f9089,75,3412,4938,1526,12,11,23,3,159,26,5,30,4.888795064,35536,287,2,3498,3503,5,192633,204516,11883,1350,1381,31,1,85.3051779,Arch
c360b517394f858fa73d6737fd0dfbbeffe59c7f,76,4947,3414,1533,11,12,23,3,163,57,5,30,4.896850651,34511,30,9,3566,3558,8,207674,195875,11799,1401,1370,31,1,85.3051779,Arch
6a46e11c6a8057d5f713c7acacb63ffa299e38a5,75,3412,4938,1526,12,11,23,3,159,26,5,30,4.888795064,35536,28,7,3498,3503,5,192633,204516,11883,1350,1381,31,1,85.3051779,Arch
41fe736ddbbf367add778232799c5d7dfd37c5dc,77,4963,3422,1541,11,12,23,3,163,57,5,31,4.909531702,35337,289,4,3567,3562,5,214275,202338,11937,1422,1391,31,1,85.3051779,Arch
f67dcd794cf0e60277d3df14c7530cb647cadd69,75,3412,4938,1526,12,11,23,3,159,26,5,30,4.888795064,35536,288,3,3498,3503,5,192633,204516,11883,1350,1381,31,1,85.3051779,Arch
97528e9188a05b323699222e21ed7f22fd7ff8e3,81,5074,3509,1565,12,13,25,3,163,55,6,36,4.972332672,34913,290,5,3568,3566,2,210511,198929,11582,1412,1382,30,1,85.07376338,Arch
2b20bd7928f0f4a11291a48e6991f19a130d3b01,75,3412,4938,1526,12,11,23,3,159,27,5,30,4.888795064,35536,289,4,3498,3503,5,192631,204514,11883,1350,1381,31,1,85.3051779,Arch
09bd44e76c3e4fd10a474197b7db0f0e1c78541b,75,4954,3413,1541,11,12,23,3,163,57,5,30,4.894205168,34010,291,6,3503,3498,5,204588,192691,11897,1381,1350,31,1,85.3051779,Arch
375863f497219fb7e52c1afcf8225ad321ee6786,75,3413,4954,1541,12,11,23,3,159,27,5,30,4.894205168,35551,290,5,3498,3503,5,192631,204661,12030,1350,1381,31,1,85.3051779,Arch
4023898c109b8e50e71fa08eacdf294b66d162d1,81,5600,3535,2065,12,12,24,3,163,53,6,31,5.032861754,35546,293,8,3690,3651,39,216875,202340,14535,1452,1406,46,1,85.14021393,Arch
df9b37c1c8fc2fc1c9c2027620efa9caae2ba48a,81,3534,5599,2065,12,12,24,3,159,23,6,31,5.032654972,37641,29,8,3654,3693,39,202386,217054,14668,1406,1452,46,1,85.14021393,Arch
06fa79ae599187d7976ed5e9cccf9c66fc91eff7,92,5943,3686,2257,13,12,25,3,163,38,6,35,5.19616229,41247,294,9,4262,4210,52,254585,238389,16196,1668,1617,51,1,85.09101416,Arch
52648442aea4a2d51044131a70b7e86b5fd805fb,102,3773,6818,3045,12,15,27,3,159,23,6,40,5.359924236,47481,30,6,4480,4612,132,255226,275538,20312,1771,1868,97,1,84.99278499,Arch
fa2928f6a9fae32fb7edc5dad6374ca625c3b417,104,6823,3771,3052,15,12,27,3,164,35,6,41,5.3669128,45440,33,7,4738,4605,133,280317,260077,20240,1904,1807,97,1,84.99278499,Arch
ff359ff353cd95962d093113edd4a479796af59f,5,7,115,108,0,1,1,4,4,636,1,1,1.112508674,1080,20,4,145,156,11,4285,4638,353,84,90,6,1,96.60441426,Arch
88acd71c49d02eabd746ffc3a554e10ccd65fc02,16,991,31,960,8,0,8,3,157,26,3,8,3.393119948,10019,332,7,1090,1011,79,63494,58758,4736,407,366,41,1,88.73165618,Arch
10b1f2058c5a8b53b3711f318da70ed23acc1937,2,150,18,132,1,0,1,1,5,36,1,2,0.899393971,384,338,7,56,47,9,2731,1927,804,22,19,3,1,92.86816919,Arch
7a381304a266c88ee84d936c1960c36a9015a174,23,1327,250,1077,4,0,4,3,159,85,3,15,2.635993927,11571,286,1,1634,1495,139,73717,67452,6265,497,450,47,1,90.4398827,Arch
7511e45a68f96c208483155389722760861a6b8f,104,6823,3771,3052,15,12,27,3,164,35,6,41,5.3669128,45440,311,22,4738,4605,133,280317,260077,20240,1904,1807,97,0,84.99278499,Arch
7be5830a908602ff91a07d3020f2dddf7705d48f,52,141,151,10,0,0,0,2,44,37,3,19,5.030767066,13727,343,2,1302,1302,0,76845,76736,109,548,548,0,1,95.0255445,Arch
99f2b8ee94cd9ed551fa380ed0411b4cc69f6d77,2,144,0,144,0,0,0,3,21,90,2,2,0.249882293,652,348,7,70,58,12,4880,3911,969,27,19,8,1,97.12306873,Arch
fdebd19941c34f3d879a322e11cfe3642876b463,3,108,5,103,0,0,0,2,11,192,1,3,1.163177937,1381,308,3,222,206,16,8168,7646,522,41,34,7,1,90.33647376,Arch
e9208c0808c2a0649ce336d87534ad6f9cbab818,6,116,9,107,1,0,1,2,123,145,1,4,2.269487613,2901,304,13,417,407,10,16822,16346,476,160,153,7,1,91.06145251,Arch
b4674b485dd4e62c177d87581f302b243f24d797,9,1017,278,739,1,0,1,2,166,303,3,5,1.89627919,9791,5,5,942,880,62,63618,59048,4570,361,332,29,1,91.52907394,Arch
f801fa01d81ed0c0b7c1b39fbd551c5f86a8dda0,8,87,53,34,0,0,0,2,5,133,2,6,2.615845501,3952,44,5,462,457,5,20368,20150,218,144,142,2,1,97.71579707,Arch
cd0ed751ae502492733738f2d7d7d0ae8e4224e9,19,1003,227,776,2,0,2,2,174,58,5,11,3.391626316,16025,313,3,1301,1249,52,103745,99017,4728,529,502,27,2,83.96253193,Arch
880df51b016bf94927f8213078e48a6847efaa49,2,122,27,95,1,0,1,4,13,0,1,2,0.682712697,320,376,4,25,23,2,2919,2255,664,13,11,2,1,84.86080701,Arch
599bb0fe2ee6d80125c10eecc2554ddea8f869ef,10,605,52,553,2,0,2,2,179,153,3,8,2.75652342,12572,380,7,1074,1034,40,77154,73776,3378,371,355,16,1,87.40781207,Arch
c033965e7ae582c91884c86e0bc5edadb75c68ea,1,106,75,31,0,0,0,3,8,215,1,1,0.0,708,20,0,77,72,5,4190,4058,132,40,36,4,1,88.35827988,Arch
363249d6455d34605c361480685d41165b9118b1,6,111,242,131,0,1,1,2,183,274,2,5,2.267510508,10538,334,2,902,918,16,65179,65707,528,321,326,5,1,89.99748681,Arch
60438e312ca3bcb861e09074869493be82a75fca,3,312,10,302,2,0,2,1,37,172,1,2,1.380599139,546,27,1,83,64,19,4706,2750,1956,33,24,9,1,91.61694511,Arch
4facc6947b1fb887d365bc5b6bfb1e43a4484f66,2,164,11,153,1,0,1,1,32,267,1,2,0.721928095,469,28,2,60,45,15,2322,1349,973,42,39,3,1,89.76533786,Arch
d72aab4be532dbc1593b4a0cbe3fd8b32ebe90d1,2,197,3,194,1,0,1,1,38,65,1,2,0.40217919,560,32,1,73,66,7,4458,2822,1636,29,24,5,1,85.50488599,Arch
c033965e7ae582c91884c86e0bc5edadb75c68ea,192,1178,5976,4798,1,21,22,0,180,45,9,72,6.298343979,72601,20,0,5642,6064,422,400845,430131,29286,2646,2840,194,1,86.14638652,Arch
8e5d18e63e6c98aa4e89f568d159b3c1903b1dae,5,46,8,38,0,0,0,3,32,203,1,4,1.49805065,3063,325,0,199,197,2,18884,18494,390,141,140,1,1,90.88683864,Arch
5ac89e34edc6aa84726974365c16ac5a73df8670,2,45,2,43,0,0,0,3,13,417,1,2,0.658191266,250,329,4,22,20,2,2019,1625,394,16,15,1,1,94.23711161,Arch
9bf99b9a99b713afaccebb538e09ca3e6937fdac,11,151,499,348,0,0,0,3,24,242,2,3,2.985635857,3294,380,0,240,283,43,17314,19481,2167,101,121,20,1,94.93195683,Arch
d6126aacaff4361a1e2229222e0285b0f23b8e40,3,22,1,21,0,0,0,4,67,124,1,2,1.121177461,2565,33,4,232,227,5,15092,14885,207,102,101,1,1,91.10563766,Arch
7c1727a2b3c04b9c5bf0591e9afd9ac775026591,3,264,4,260,0,0,0,3,36,380,1,2,0.573207456,751,36,0,115,91,24,6388,4657,1731,63,44,19,1,91.82836841,Arch
97472e2a53526869a23e161585869cbc55e06f83,3,312,10,302,2,0,2,1,38,124,1,2,1.380599139,552,37,1,84,65,19,4754,2798,1956,33,24,9,1,90.01290323,Arch
904e2f94a2c8b81c3f6a7939d2aae2ded38f6665,2,164,11,153,1,0,1,1,33,177,1,2,0.721928095,469,38,2,60,45,15,2328,1355,973,42,39,3,1,93.79469435,Arch
da85ca8cffb01e147532cdb1bf2ec64c7e1a795e,2,197,3,194,1,0,1,1,39,65,1,2,0.40217919,566,43,1,74,67,7,4506,2870,1636,29,24,5,1,89.6611002,Arch
71fa843c0c70abd45c35d95b056c90f4ade258cf,7,343,4,339,4,0,4,1,8,233,1,3,2.590478552,627,382,0,62,48,14,5911,3868,2043,33,25,8,1,90.07423701,Arch
6e588d15184dc691df1c0227f40db91d9bc6d7d6,406,6252,22306,16054,8,42,50,1,188,60,10,122,6.999807245,136771,58,2,11832,13313,1481,680101,781574,101473,5115,5850,735,1,87.7605918,Arch
eaa2f2372e971308fc07a0e1b68fb8a468a8ade8,6,52,0,52,0,0,0,4,136,162,1,3,2.168558125,7496,51,1,722,717,5,46442,45976,466,287,285,2,1,97.51278475,Arch
72da6b8b4dbbcee53acce9019b16fec0e6aba1be,2,46,5,41,0,0,0,6,9,259,1,2,0.626751137,754,6,1,128,123,5,4887,4640,247,34,30,4,1,97.74647887,Arch
6a04fa48cb1113faf640115dcbba9b2270e756f3,26,712,256,456,0,0,0,2,32,107,2,15,3.550769291,13189,24,9,1353,1299,54,74270,71740,2530,514,498,16,2,94.89453972,Arch
55308630b6354ce070550d1ea4efbedbbae8e13a,19,245,21,224,2,0,2,1,42,84,2,11,2.978361705,6415,414,8,711,694,17,33740,32612,1128,283,274,9,1,88.71444824,Arch
a0a659a712bbe9e4362c668939c3893196996a0f,36,229,773,544,0,2,2,0,41,139,3,18,3.568769535,15449,468,16,1528,1596,68,77613,80121,2508,584,607,23,1,88.71444824,Arch
d5a0f39d98be9ae06be9008c1deee36827c204e6,37,765,221,544,2,0,2,1,42,100,4,19,3.619847025,15215,469,17,1614,1546,68,81542,79034,2508,615,592,23,1,88.71444824,Arch
4405dff238f46981987b57bb67cab32a01f3176f,37,230,774,544,0,2,2,0,41,141,4,19,3.582403064,15759,67,7,1546,1614,68,79034,81542,2508,592,615,23,1,88.71444824,Arch
70cd396d27188aa5e79280552199e7c81f7d2822,37,765,221,544,2,0,2,1,42,100,4,19,3.619847025,15215,26,10,1614,1546,68,81542,79034,2508,615,592,23,1,88.71444824,Arch
a142c335009350f9bdfae542b1fc360e65563d93,37,230,774,544,0,2,2,0,41,141,4,19,3.582403064,15759,26,10,1546,1614,68,79034,81542,2508,592,615,23,1,88.71444824,Arch
a382324c24a30ef7b632ca1f003a90873ac802e3,37,765,221,544,2,0,2,1,42,100,4,19,3.619847025,15215,27,11,1614,1546,68,81542,79034,2508,615,592,23,1,88.71444824,Arch
c152ed88e29bacc7542074706ba142e1c1821d99,37,230,774,544,0,2,2,0,41,141,4,19,3.582403064,15759,27,11,1546,1614,68,79034,81542,2508,592,615,23,1,88.71444824,Arch
05f77fe2b210341a16ead9fc51e53093c836d860,63,2748,417,2331,5,0,5,3,205,164,7,30,4.669126699,35186,355,5,3662,3411,251,212816,200697,12119,1509,1392,117,1,94.3324937,Arch
d6e7f93ec49f84082afc91afc7ae869be1489116,37,230,774,544,0,2,2,0,41,141,4,19,3.582403064,15759,355,5,1546,1614,68,79034,81542,2508,592,615,23,1,94.24688562,Arch
4a6808ce4c99458653bbe4328dfcad24649a48fb,40,1241,261,980,2,0,2,1,206,94,5,21,3.491373194,23921,68,6,2680,2579,101,137780,131107,6673,966,933,33,1,94.19471425,Arch
c69398509e25ebc8444b690e49022397bf9cb295,37,230,774,544,0,2,2,0,41,141,4,19,3.582403064,15759,68,6,1546,1614,68,79034,81542,2508,592,615,23,1,93.77664109,Arch
6e6ad706f5b6611058541c3bf072343bf002ced5,40,794,229,565,2,0,2,1,207,93,5,21,3.760530924,24357,69,7,2683,2612,71,137986,135272,2714,966,943,23,1,93.77664109,Arch
8cc874a3c1eeaceba0ac06c5fd69ee7b84c38b1d,37,230,774,544,0,2,2,0,41,141,4,19,3.582403064,15759,69,7,1546,1614,68,79034,81542,2508,592,615,23,1,93.77664109,Arch
ce69aa1e2ca3320d33c833a96a158f94bfd73f52,44,926,295,631,2,0,2,1,42,83,5,23,4.011656767,17419,415,6,1862,1785,77,94422,91400,3022,751,728,23,1,93.77664109,Arch
9968e569baa680b2ea1c53d0ea71f6378cc7da53,37,230,774,544,0,2,2,0,41,141,4,19,3.582403064,15759,412,3,1546,1614,68,79034,81542,2508,592,615,23,1,93.77664109,Arch
ed7f1abbce54093f56f33c35c8ac92d9e433760f,47,1090,378,712,3,0,3,1,208,91,6,24,4.219843073,33450,70,8,3156,3078,78,196520,193180,3340,1278,1247,31,1,91.32543103,Arch
d3d4b051d3c896b601a0c492cd6d5a9b27f04cff,37,230,774,544,0,2,2,0,41,141,4,19,3.582403064,15759,70,8,1546,1614,68,79034,81542,2508,592,615,23,1,93.21297989,Arch
e00b44a80d911601d8a6409a72f7b3eaa4dc844f,37,765,221,544,2,0,2,1,42,100,4,19,3.619847025,15215,71,9,1614,1546,68,81542,79034,2508,615,592,23,1,93.21297989,Arch
5c1b91064e71fc550b5eb77fe263bafbcb8e0ab3,37,230,774,544,0,2,2,0,41,141,4,19,3.582403064,15759,71,9,1546,1614,68,79034,81542,2508,592,615,23,1,93.21297989,Arch
f0b9d7ec7472d6c4b932c249f6106c5b6ca85b88,40,933,247,686,2,0,2,1,42,103,4,21,3.711420839,16495,470,15,1837,1750,87,89743,86413,3330,667,639,28,1,93.21297989,Arch
db9864c33d5f5a3ffb60b8d03089014235d3133c,37,230,774,544,0,2,2,0,41,141,4,19,3.582403064,15759,469,14,1546,1614,68,79034,81542,2508,592,615,23,1,93.21297989,Arch
d99f2b262989079d6f628f91560a8678a2313e73,37,765,221,544,2,0,2,1,42,100,4,19,3.619847025,15215,471,16,1614,1546,68,81542,79034,2508,615,592,23,1,93.21297989,Arch
5a0b0265da28b039d6dd3db47982aa12e7ee1389,37,230,774,544,0,2,2,0,41,141,4,19,3.582403064,15759,58,1,1546,1614,68,79034,81542,2508,592,615,23,1,93.21297989,Arch
faffae43c5533ce914b4a3d05cc12fb83dfc75fe,37,765,221,544,2,0,2,1,42,100,4,19,3.619847025,15215,472,14,1614,1546,68,81542,79034,2508,615,592,23,1,93.21297989,Arch
eec72121a434c7cbc8788ebcba0467316c40f58c,37,230,774,544,0,2,2,0,41,141,4,19,3.582403064,15759,471,13,1546,1614,68,79034,81542,2508,592,615,23,1,93.21297989,Arch
7d0ae69e2aff1e76faa5c89a3789e35ac254035c,39,769,600,169,2,1,3,4,42,101,5,20,3.514845898,15751,72,9,1633,1584,49,82439,82205,234,619,602,17,1,93.14128944,Arch
9a8cd4239762779dbb1f52cd3561a4aacf3e69c7,39,609,778,169,1,2,3,3,41,160,5,20,3.495201331,15920,413,3,1584,1633,49,82205,82439,234,602,619,17,1,92.72279445,Arch
2df32bffa07d88bf4a0b7f2dced2c17b678006ef,39,769,600,169,2,1,3,4,42,101,5,20,3.514845898,15751,73,9,1633,1584,49,82439,82205,234,619,602,17,1,92.72279445,Arch
3958733a1d549a22f0046dcc5b4f8774fd5fac9b,42,777,804,27,1,2,3,3,41,153,5,22,3.634719829,17200,72,8,1807,1837,30,90406,89818,588,654,666,12,1,92.72279445,Arch
1c4cc8a20c81259319c07d34fe496fd94e06dba8,39,769,600,169,2,1,3,4,42,101,5,20,3.514845898,15751,75,11,1633,1584,49,82439,82205,234,619,602,17,0,92.72279445,Arch
b4b4d21e28537ac652b553df473ebcbbfae0c8b7,39,609,778,169,1,2,3,3,41,160,5,20,3.495201331,15920,74,10,1584,1633,49,82205,82439,234,602,619,17,0,92.72279445,Arch
05cf9a528441b72b3265f80ae7f17daab2c5730f,39,769,600,169,2,1,3,4,42,101,5,20,3.514845898,15751,76,11,1633,1584,49,82439,82205,234,619,602,17,1,92.72279445,Arch
cc8c5bbf16c8a5ae835eac00060467cec790a331,39,609,778,169,1,2,3,3,41,160,5,20,3.495201331,15920,75,10,1584,1633,49,82205,82439,234,602,619,17,1,92.72279445,Arch
e5c36a91120d330223cb7af2996fcbd12b385540,39,769,600,169,2,1,3,4,42,101,5,20,3.514845898,15751,77,12,1633,1584,49,82439,82205,234,619,602,17,1,92.72279445,Arch
587a50230ac17045f4ec467c9b0c80d7235646f5,39,609,778,169,1,2,3,3,41,160,5,20,3.495201331,15920,76,11,1584,1633,49,82205,82439,234,602,619,17,1,92.72279445,Arch
282eb724009faffb3a4f7a71b7b464f777fe5c3b,39,769,600,169,2,1,3,4,42,101,5,20,3.514845898,15751,0,0,1633,1584,49,82439,82205,234,619,602,17,1,92.72279445,Arch
b6e382edb3b2d89effcbcb07d1e4a8ec67d45216,39,609,778,169,1,2,3,3,41,160,5,20,3.495201331,15920,77,11,1584,1633,49,82205,82439,234,602,619,17,1,92.72279445,Arch
d090fc9061c1b0e39d34e2683d59fb9bd3f8e6f8,39,769,600,169,2,1,3,4,42,101,5,20,3.514845898,15751,29,12,1633,1584,49,82439,82205,234,619,602,17,1,92.72279445,Arch
09c92662eb8821854c393436f7b41b3f53ddf3cc,39,609,778,169,1,2,3,3,41,160,5,20,3.495201331,15920,28,11,1584,1633,49,82205,82439,234,602,619,17,1,92.72279445,Arch
cea05e361b0c4150aadd91994ad69281d1e80695,39,769,600,169,2,1,3,4,42,101,5,20,3.514845898,15751,30,11,1633,1584,49,82439,82205,234,619,602,17,1,92.72279445,Arch
11aa17e01f7d72bdea26db2188f8b5cb0c3d84ae,17,3775,0,3775,17,0,17,1,1,0,1,5,3.606585109,0,108,2,420,0,420,19764,0,19764,234,0,234,1,96.24718539,Arch
70a465dfb73ca3ce97caf1c1427fe6324c1e073f,11,905,384,521,2,0,2,1,17,49,1,4,2.643199976,5475,417,4,645,609,36,33096,29869,3227,220,208,12,1,95.62611012,Arch
8710df0d1264a453218220ed48e5d2b5d2923da1,6,528,39,489,2,0,2,1,10,169,1,3,1.454684193,1441,34,5,278,232,46,10418,8343,2075,76,54,22,1,94.01247401,Arch
e10d80fe6008986900dadc51fc7823582d0dfb1a,13,1725,0,1725,12,0,12,1,3,80,2,3,3.42638237,30,128,3,165,0,165,8733,41,8692,76,0,76,1,91.7919351,Arch
4f66cb4baf926f9dcaf2ca4a47461f3ebf97679e,14,524,35,489,1,0,1,5,214,165,2,11,2.790805443,14663,101,0,1784,1734,50,92956,89865,3091,585,560,25,1,90.51923481,Arch
ecd90dc1f79a4b1614174b75030b85feb8842793,15,1194,101,1093,4,0,4,1,4,29,3,7,3.090368051,2743,137,9,448,320,128,22244,15441,6803,209,158,51,1,88.04958678,Arch
5f15a04769f54b60cf9a4368287091c431fc3267,3,64,17,47,0,0,0,4,42,233,1,3,0.701486195,1363,428,0,150,144,6,7640,7374,266,61,58,3,1,93.77725595,Arch
b1ae946c1bae76cb479362931a864f21e1fa73f6,4,69,4,65,0,0,0,2,159,67,3,3,1.526192819,4686,431,3,492,482,10,23268,22826,442,177,177,0,1,93.22421013,Arch
3dc26cf153afda9c8006e8bab42df16a9ce32ea8,26,3672,11,3661,19,0,19,1,97,13,4,12,3.795644314,3383,433,5,630,282,348,35289,14802,20487,269,95,174,1,97.12937475,Arch
737e24765d35ffedf830b5da9160a5a24f068602,28,546,80,466,3,0,3,1,97,145,3,12,3.950113637,11874,442,14,1152,1094,58,73889,70954,2935,462,449,13,1,89.96396396,Arch
3a143a67187b29f792c43b9acc40feec0dc16697,20,461,235,226,2,0,2,1,116,791,1,7,2.965378112,10289,465,37,1018,988,30,65531,64230,1301,462,442,20,1,86.58971668,Arch
eec648d3af68ef1b4967e5c7cfc464a476f308c6,42,836,370,466,8,1,9,1,167,0,4,11,4.381023513,14525,466,38,1601,1564,37,85246,83962,1284,718,681,37,1,90.04889272,Arch
cebbb0192602baca4da2352b82f18317595d9247,25,1020,766,254,5,3,8,1,168,16,4,6,4.0362751,12935,467,39,1435,1398,37,78502,78455,47,610,584,26,1,82.0,Arch
4a18c5d5baaaab4565da9d3c3085d98dfc91d07e,28,293,118,175,0,0,0,1,171,0,3,9,4.45772495,15313,470,42,1653,1633,20,93374,92145,1229,717,715,2,1,97.15673668,Arch
52f0e5d2a0ec36c781f4f0cca63d2150426add9d,10,505,82,423,0,0,0,9,172,121,2,5,2.782461262,7502,472,44,963,926,37,46557,43727,2830,381,367,14,1,95.15555556,Arch
24e17a4e5af7d81a08ca2019052896cf3b97f6a6,8,955,302,653,3,0,3,2,7,26,2,3,2.200335205,1642,365,1,302,218,84,12879,8660,4219,173,143,30,1,87.15808171,Arch
8b278ea84f4c64e7144c07fa79b38a6a719541d2,48,531,1331,800,0,2,2,1,223,9,3,14,3.827027022,43633,487,59,3583,3668,85,274567,279048,4481,1756,1784,28,2,95.38888889,Arch
