CommitID,NMF,TotalAddLines,TotalDeleteLines,LC,FileAdd,FileDelete,NAD,NDVE,NUC,AGE,NMS,NMD,Entropy ,MLMF,EXP,REXP,CommitComplexity,LastCommitComplexity,CFC,CommitTokenCount,LastCommitTokenCount,NCC,CommitMethodNum,LastCommitMethodNum,NMC,NIR,a2a
b9960d2817f9e6fa5cf28eb5dbaa949950c16818,0,0,0,0,0,0,0,0,0,0,0,0,0,0,173,7,0,0,0,0,0,0,0,0,0,1,100
ab206e509b3441b457b8796a694904478034f892,0,0,0,0,0,0,0,0,0,0,0,0,0,0,174,8,0,0,0,0,0,0,0,0,0,1,100
15b9cc79d9846c0376a36942ca075464282dd3f3,0,0,0,0,0,0,0,0,0,0,0,0,0,0,172,6,0,0,0,0,0,0,0,0,0,1,100
f41e3ee0282c25c81e4ec9246933cda4b6ed5702,0,0,0,0,0,0,0,0,0,0,0,0,0,0,173,7,0,0,0,0,0,0,0,0,0,1,100
b38c9313ec4bf1436d5aa749922b28e80b262894,1,2,0,2,0,0,0,3,29,14,1,1,0,1248,159,16,58,58,0,9681,9669,12,5,5,0,1,100
f38b330900a71f3aa643d4ff5e3975fc6c58bd37,13,50,27,23,0,0,0,2,57,51,4,9,3.464566063,4890,160,17,353,352,1,28573,28435,138,211,210,1,1,100
dcf2b076713c01e2f63004fbc9bf1b7a0403d5c9,2,12,11,1,0,0,0,2,6,16,1,2,0.426228657,685,161,18,45,45,0,4473,4473,0,31,31,0,1,100
5c5b0da3954da630a0be480687e61c7f6331bdf2,1,9,27,18,0,0,0,1,12,9,1,1,0,742,162,19,33,33,0,4273,4435,162,24,24,0,1,100
a5713a41fb9f5f7b885109f09ee7c03d1da03b66,2,232,1,231,1,0,1,1,4,4,1,2,0.0712504,112,194,19,24,7,17,1937,622,1315,19,2,17,2,90.53772405
4ae38e437f6312d7b8bc74280c82577f93ed46e6,17,65,73,8,0,0,0,1,56,26,5,12,3.49890893,7573,194,19,488,489,1,47012,47000,12,270,271,1,2,100
21106b443cfdf523f304535d186771280e9444fa,0,0,0,0,0,0,0,0,0,0,0,0,0,0,175,9,0,0,0,0,0,0,0,0,0,1,100
74078d3092292f7b27828491669850bfe68ce5f4,35,349,146,203,2,0,2,1,110,29,6,23,4.395121171,20927,197,16,1969,1953,16,120492,119167,1325,836,828,8,1,99.61582789
6d29107ceef4f7972a4f134caaf8e93307b99fc7,4,66,46,20,0,0,0,6,79,18,2,3,1.604628667,2712,198,17,362,357,5,15005,14839,166,125,123,2,1,99.69336911
ae84f1d239dfb76ac91d1f97688ef205ac1fcf0b,0,0,0,0,0,0,0,0,0,0,0,0,0,0,174,8,0,0,0,0,0,0,0,0,0,1,100
2ff672075a5ab2a364e9d3b3ffcf6fa8400a3ca9,14,80,9,71,0,0,0,2,80,30,3,5,3.646461093,7052,165,14,634,634,0,43275,42636,639,336,336,0,1,100
ee7f3850a7412600caadfa784411c0b1fcf92f82,1,6,0,6,0,0,0,1,2,957,1,1,0,329,175,9,43,42,1,1819,1787,32,24,24,0,1,100
664046686339934e96ec40de78481d841811ed72,0,0,0,0,0,0,0,0,0,0,0,0,0,0,176,9,0,0,0,0,0,0,0,0,0,1,100
18290c8489df01f814087673ecdc6b140fbffc44,2,127,12,115,0,0,0,3,52,22,1,2,0.942444059,3011,166,12,337,324,13,18649,17885,764,94,92,2,1,100
5b464f27da273723e422607518c271cd3f040560,57,4236,663,3573,10,1,11,1,111,79,6,19,4.138160375,14443,177,9,2020,1508,512,89545,70046,19499,859,683,176,1,94.84995945
66b374e58258b3cddeaf1c73b5af695c23027b05,2,8,4,4,0,0,0,4,13,33,1,1,0.918295834,674,167,13,71,70,1,3441,3383,58,36,36,0,1,100
36e74ea06ddb9831932281554fbdab8b290ced19,12,140,48,92,1,0,1,1,18,174,2,7,2.516281467,4022,168,14,442,434,8,20069,19600,469,186,184,2,1,99.82810486
351a610589ef6f47bf00937c7f3289f4c4c1a204,29,467,254,213,0,0,0,1,29,162,3,18,3.949925777,11643,199,9,1206,1211,5,59043,58585,458,490,496,6,1,91.31956598
0df108154743ff689e3ba4ff2671e6c809eeb660,7,188,108,80,1,0,1,1,15,51,1,6,2.069991156,1524,200,10,160,157,3,8455,8073,382,67,64,3,1,95.61024277
1b170a4ec0027cdb7dd5d5e28341187623df8658,4,54,31,23,0,0,0,1,16,110,1,3,1.755783861,1195,201,11,140,138,2,6440,6378,62,60,59,1,1,99.57757296
98b49f22790e5116e1fd48fa96b3b01c2359ffaf,4,107,72,35,0,0,0,3,15,17,2,2,1.208425057,1842,202,8,167,165,2,8505,8365,140,51,50,1,1,100
2118e96446bd3ca8858c831a5cf7ebc07d683007,5,70,23,47,0,0,0,3,82,151,1,4,1.535347461,4498,178,4,666,658,8,22412,22154,258,260,256,4,1,100
3d0edf44e001e74ad50301e700ecdc807af8221e,1,12,1,11,0,0,0,5,44,5,1,1,0,559,179,5,77,75,2,2698,2642,56,29,29,0,1,100
0d65fabbc84ed89bb1bfcccba0de2e31e813e92d,3,11,2,9,0,0,0,6,83,173,2,3,1.419556299,2197,203,7,281,281,0,10803,10723,80,111,111,0,1,100
693f2ca92777178a0cc6315d28c174da8115c125,25,12,47,35,0,0,0,2,112,297,7,18,3.950165197,10248,180,6,1240,1240,0,53259,53653,394,468,468,0,1,94.06282361
f58508a5692c817a11b7996ba563ba8a26b85560,20,1380,280,1100,4,0,4,1,113,24,2,9,3.733855214,9513,181,7,1382,1242,140,58228,52224,6004,497,423,74,1,96.05418139
537d3bca4cd72d50be07b6ccdac7312ab2a8daf7,2,3,4,1,0,0,0,3,7,106,1,1,0.863120569,156,182,8,17,17,0,622,645,23,9,9,0,1,100
6a2585764c64d0b70be34b59fab1c964a54588b4,10,531,58,473,3,0,3,1,114,112,1,6,2.629968939,5796,183,9,752,699,53,35238,32228,3010,241,213,28,1,88.87751621
0d495f167f9deb8949dec3fd629e50749e439e8c,1,0,52,52,0,0,0,1,3,0,1,1,0,204,184,10,15,21,6,892,1205,313,2,3,1,1,100
c75ce7066294384fd22a5d382f9301df3bf97053,2,8,8,0,0,0,0,1,2,0,1,2,1,328,185,11,31,31,0,2422,2414,8,13,13,0,1,100
672b26aff6b9ba092d6d853a8273d15f1782c574,1,4,0,4,0,0,0,5,115,0,1,1,0,3205,204,5,454,454,0,17749,17735,14,117,117,0,1,100
ed8c288a67143e426848f47831d045e94b402713,1,1,0,1,0,0,0,4,49,33,1,1,0,2404,205,6,114,114,0,15795,15782,13,80,80,0,1,100
98d5a31cb7f2963a7395c69f4942543dc050d82d,6,25,159,134,0,2,2,3,45,377,1,3,2.062680868,3115,206,7,240,248,8,16334,16720,386,143,149,6,1,90.08509064
ba89a0847974e7e0d95e460720871888ac226512,2,3,2,1,0,0,0,3,32,65,2,2,0.970950594,1248,186,10,147,147,0,7633,7633,0,46,46,0,1,100
ae6c9746ce9da1cf6ffcff4834af352c58fe83d8,2,17,5,12,0,0,0,3,17,18,2,2,0.976020648,891,207,8,67,67,0,3806,3770,36,28,28,0,1,100
4a60f05c105188aefb48f64c4ccf2efbc4b26da0,4,102,27,75,1,0,1,3,34,34,2,3,1.655116073,2127,208,9,219,210,9,11766,11378,388,69,67,2,1,94.1771376
3f3f94827486ceb87d9a76311911fe4ebc8cdc02,3,110,29,81,0,0,0,3,54,74,1,2,0.95520616,2530,209,10,377,363,14,11885,11493,392,176,162,14,1,100
c548c91576875030862aa909dea68cf8a40673a8,5,132,91,41,0,0,0,1,116,10,1,4,1.661047772,7267,187,10,1036,1027,9,39817,39591,226,305,304,1,1,100
8d87e0398bbe0b270822caf06b6d04f6b871e449,2,15,3,12,0,0,0,3,28,90,1,2,0.964078765,501,188,11,15,15,0,1620,1569,51,10,10,0,1,99.91194599
69b2b53a57c8366017a4a5df14bf83dd122c7dc9,1,8,3,5,0,0,0,3,35,87,1,1,0,542,189,12,57,53,4,3629,3577,52,7,7,0,1,100
44ea005b577c4c96593bf96b1eebe64242d7b416,1,32,0,32,0,0,0,3,29,1,1,1,0,397,210,11,2,2,0,1210,1156,54,2,2,0,2,100
8d4b8e9a5b6cac168cd793b93e0940494c11ebc4,6,103,13,90,0,0,0,2,18,101,2,5,2.108206423,1361,211,12,120,108,12,7056,6395,661,54,53,1,1,99.97065728
ece53e34a627a37765da9706e2022d47eb78972d,1,2,2,0,0,0,0,5,117,3,1,1,0,3217,190,13,459,457,2,17824,17812,12,117,117,0,1,100
5a24e979a8509da48b9e9dabc00e3e24944c6355,3,17,3,14,0,0,0,2,11,22,1,2,1.368995594,1794,212,13,213,211,2,8841,8789,52,60,59,1,1,100
90a056d64da6aaa5db4688448edc3975de3db0a8,2,18,9,9,0,0,0,3,25,66,1,2,0.503258335,1174,191,13,22,22,0,9656,9549,107,20,20,0,1,100
4669d71cf3728fa1bda0bc23a8068ee102ac8e87,1,3,0,3,0,0,0,3,9,39,1,1,0,917,213,14,83,83,0,4740,4722,18,28,28,0,1,100
2775c8ad0ad4f1a4cfe1935b3233aa4007e06224,1,3,3,0,0,0,0,3,15,66,1,1,0,690,192,14,90,90,0,4180,4180,0,29,29,0,1,100
9bca4c96b2e35c9a2dcb7dde927b22976f6b6c26,9,58,21,37,0,0,0,2,87,99,3,5,2.570313423,4153,193,15,503,500,3,21550,21359,191,184,183,1,1,94.28746929
3b2c4749a9f735f558144582c40c3bf49565f5dc,1,2,1,1,0,0,0,5,118,3,1,1,0,3217,194,16,459,459,0,17828,17824,4,117,117,0,1,100
34159fed90ab519a024d177b9fcd144cb4954437,1,10,3,7,0,0,0,3,6,3,1,1,0,240,195,17,7,7,0,2169,2118,51,7,7,0,1,100
674fd81a1a16d20b496b1bab42df6be3aa0ef9c2,10,83,13,70,0,0,0,1,70,74,4,6,2.567355944,4945,214,12,531,522,9,26237,25783,454,178,177,1,1,99.90331937
bd6fa6ee40ffe0989768808be7dcad15395149f0,1,2,1,1,0,0,0,1,5,9,1,1,0,376,196,18,59,58,1,2088,2084,4,9,9,0,1,100
8c6cab4a23109e60a1fa4cc0267bda959aee9396,3,63,36,27,0,0,0,2,7,48,1,2,0.485828213,2908,215,13,355,349,6,14851,14715,136,149,144,5,1,100
7f3051b1f368cdee7568f8f12e8e2cd814e1ae17,6,59,53,6,0,0,0,2,13,39,2,5,2.231069096,1068,216,14,98,96,2,6529,6540,11,47,45,2,1,100
8fab9244f6cd82bb3160c006f865c026b30dc56c,1,5,2,3,0,0,0,3,10,8,1,1,0,319,217,14,24,24,0,1589,1558,31,10,10,0,1,100
be0b47a0e58ccf166472e38bf15101434dd33b53,1,22,34,12,0,0,0,2,7,5,1,1,0,1122,218,15,121,123,2,5535,5577,42,37,37,0,1,100
a3a9ceaad6d94200889f30a8d41cd1d42689797f,1,5,5,0,0,0,0,2,8,0,1,1,0,1110,219,16,121,121,0,5555,5535,20,37,37,0,1,100
908512fc378d5dc6982ac2516822709f0cf06b0f,2,28,13,15,0,0,0,6,88,13,2,1,0.281193796,2208,197,18,272,271,1,10973,10865,108,105,104,1,1,100
0bf327c288274b0fde677bdfc373e6110f7b86e2,20,480,456,24,1,0,1,1,18,46,3,12,3.715335957,7275,220,17,767,775,8,38156,37706,450,294,302,8,1,99.71051785
762f322deef34e4b02d9df2a380784ceba359a13,6,104,10,94,0,0,0,2,15,3,2,5,1.913160662,1037,221,18,115,100,15,6935,6198,737,57,50,7,1,100
e22256ddf49154748ce84ad8d98bf8a365c68bc6,1,1,1,0,0,0,0,3,9,2,1,1,0,937,2,0,132,132,0,5306,5306,0,63,63,0,1,100
ba97f7f35af0ca94a966a30bb138d7f3ef9e2562,1,14,1,13,0,0,0,3,7,14,1,1,0,247,198,19,8,7,1,2262,2169,93,7,7,0,1,100
f31aba7bca4ff85dec69a4ac949c37e24f7eed1e,1,6,2,4,0,0,0,3,7,107,1,1,0,407,199,20,41,41,0,2809,2777,32,13,13,0,1,100
5a6f42a8118ef47475b4522ae984810616914461,8,241,63,178,0,0,0,3,119,38,2,6,2.513481676,8758,200,21,1246,1220,26,49115,48232,883,335,332,3,1,98.75328084
57b61c22f5f1056f7c37da468129f70c4f058cd9,1,3,6,3,0,0,0,1,4,0,1,1,0,894,201,21,127,127,0,4923,4937,14,20,20,0,1,100
cde19354d5a7ee73a2fff5312d5d5ecb995da428,2,2,24,22,0,0,0,2,12,10,1,2,0.619382195,1788,222,18,181,182,1,8671,8776,105,75,76,1,1,100
e32252cdcf6e52c1f361c780a7373168242e7c6c,3,164,0,164,1,0,1,3,35,17,2,3,1.07521967,1161,202,18,121,108,13,6562,5720,842,57,51,6,1,99.89939638
6416102f4ffbcde66e3bf4595d268d2539019c2e,6,27,0,27,0,0,0,3,36,41,2,3,2.185106836,2914,223,19,239,237,2,14269,14167,102,89,88,1,1,100
f34c7f320ae471b5a3957b85e58e3b38eab44717,4,105,68,37,0,0,0,2,19,114,1,2,1.181293407,707,224,17,61,57,4,3721,3604,117,31,27,4,1,100
34a557d1318aee9b23f5ac7ded9bccfd72508de1,25,534,114,420,2,0,2,1,120,50,7,19,3.515837239,15272,225,18,1844,1803,41,92460,89935,2525,595,583,12,1,93.58086847
792cda59370ff493b7672da4f5c80e1929eecd61,9,777,213,564,5,0,5,1,31,28,3,5,2.743452179,1419,226,19,93,55,38,8151,5271,2880,49,30,19,1,97.54001186
ed0bd643131934504dad60b326520c1d0f3d99c5,1,35,0,35,1,0,1,1,1,0,1,1,0,0,227,20,0,0,0,33,0,33,0,0,0,1,95.72885092
a03a33b200c6ac543059f89f8d1cccae9ff06d4c,1,70,13,57,0,0,0,3,7,3,1,1,0,678,228,21,58,53,5,4987,4623,364,19,16,3,1,100
3a305a9eed46b087d4cc3679783b7c49ec67d3c3,0,0,0,0,0,0,0,0,0,0,0,0,0,0,229,22,0,0,0,0,0,0,0,0,0,1,100
e144a129341840d0ec4f0bed1bd0cb920d41844d,1,18,0,18,0,0,0,1,2,3,1,1,0,29,230,23,0,0,0,70,70,0,0,0,0,1,100
d1f417afbab7c7b58833a588f8eff72f4bf8ce1e,0,0,0,0,0,0,0,0,0,0,0,0,0,0,231,24,0,0,0,0,0,0,0,0,0,0,100
fe031a7a00055673d8b0aa109013e63c5d1386aa,0,0,0,0,0,0,0,0,0,0,0,0,0,0,232,25,0,0,0,0,0,0,0,0,0,0,100
762c9cef8863eb48404ecf3ecc4ef08792bec525,0,0,0,0,0,0,0,0,0,0,0,0,0,0,233,23,0,0,0,0,0,0,0,0,0,0,100
145c730c8d1cea863185b2a3354b19f2ab21addd,0,0,0,0,0,0,0,0,0,0,0,0,0,0,234,24,0,0,0,0,0,0,0,0,0,0,100
762c9cef8863eb48404ecf3ecc4ef08792bec525,0,0,0,0,0,0,0,0,0,0,0,0,0,0,233,23,0,0,0,0,0,0,0,0,0,0,100
145c730c8d1cea863185b2a3354b19f2ab21addd,0,0,0,0,0,0,0,0,0,0,0,0,0,0,234,24,0,0,0,0,0,0,0,0,0,0,100
a062271bef2b592864f4467957241ad26cfcb8a6,10,326,73,253,0,0,0,1,121,59,4,7,2.495837957,7061,203,14,735,696,39,42790,41585,1205,288,270,18,1,97.27473607
e94f22723ada8e00edfd98606a5cac4a19446dee,6,10,10,0,0,0,0,2,13,65,3,5,2.521928095,1576,204,15,80,80,0,7094,7094,0,45,45,0,1,100
2e7086a004720624ba335a9b94b99629ec116456,2,9,11,2,0,0,0,4,72,16,2,2,0.721928095,1052,169,0,115,117,2,6137,6129,8,26,27,1,1,100
b2f85fe24968ca8ca5d73881ad812cb102908c8f,3,62,0,62,0,0,0,4,122,21,1,2,1.469064052,5937,205,16,710,702,8,34218,33852,366,205,203,2,1,100
e23c24bfed9caa3be4f048ab9f13c33d7da046b8,1,16,8,8,0,0,0,3,8,21,1,1,0,260,170,1,11,8,3,2216,2262,46,7,7,0,1,100
3a3185596327cbf493eb177f094153a98a8af790,3,15,2,13,0,0,0,5,123,27,1,2,1.159554752,4792,206,15,639,636,3,25470,25419,51,175,173,2,1,100
f40fb93f5ed75610ca6051c7c1001db5fd93537d,2,24,4,20,0,0,0,3,55,64,1,2,0.811278124,3139,171,2,340,339,1,18891,18744,147,95,95,0,1,100
9377f37499f025af37f9d2fad693146765d2d0b5,2,11,12,1,0,0,0,2,2,16,2,2,0.666578358,185,207,14,22,22,0,987,989,2,8,8,0,1,100
d41819695864661af6be1f6bbd5d9723cc64d4f5,3,178,79,99,0,0,0,3,91,9,2,3,1.350983842,2721,208,12,369,352,17,16641,15967,674,136,127,9,1,100
f8f5411ea0c17496090b65562f3b4b2da48cd059,1,4,0,4,0,0,0,6,92,0,1,1,0,1963,209,13,298,298,0,10913,10887,26,108,108,0,1,100
a6cd1820cbf0bd72d1cad8f386bda7a62593cbba,0,0,0,0,0,0,0,0,0,0,0,0,0,0,210,14,0,0,0,0,0,0,0,0,0,1,100
c76ef84b825a38df01082df86dbe8642ecfd6269,2,108,19,89,0,0,0,5,124,36,1,2,0.369147641,3345,211,14,480,470,10,18826,18382,444,125,122,3,1,100
d53947509326f2d0ec18a533b8444742cd14e105,2,71,14,57,0,0,0,4,125,4,1,2,0.970950594,5777,172,3,592,589,3,34833,34439,394,202,200,2,1,100
ce6441841bc686c17746c144595c1ef3c77b3d46,1,1,1,0,0,0,0,1,1,0,1,1,0,58,212,15,4,4,0,222,222,0,2,2,0,1,99.90619137
159e346ce8e8ec82ef386e792c20efc0e44bfc25,0,0,0,0,0,0,0,0,0,0,0,0,0,0,232,15,0,0,0,0,0,0,0,0,0,0,100
b555939a791da5daab8d9f4959b67f707ed1fab8,0,0,0,0,0,0,0,0,0,0,0,0,0,0,233,16,0,0,0,0,0,0,0,0,0,0,100
de4cbd6c6f98789c5831f9888dcd4901fc25399a,3,18,14,4,0,0,0,1,50,55,3,3,1.198192411,2598,173,4,203,203,0,12555,12555,0,78,78,0,1,100
e71a9ad281714deed573b14ae3d25ea75539a1c2,2,4,10,6,0,0,0,3,37,32,2,2,0.749595257,1837,213,14,170,170,0,9856,9921,65,59,59,0,1,100
1ee92e32c43ad4fd0f1a88a5e9622b838de4170a,2,9,6,3,0,0,0,3,14,44,1,1,0.918295834,1257,174,5,148,147,1,6391,6375,16,42,42,0,1,100
b8fef84177bd8b339e4d96f8ee2fd60a79830639,1,35,20,15,0,0,0,4,51,3,1,1,0,1462,214,14,170,168,2,7215,7104,111,52,52,0,1,100
ffe6455c26fdbef047726e69c072e25b167c10d5,1,7,2,5,0,0,0,5,126,15,1,1,0,3403,215,13,477,477,0,18885,18855,30,121,121,0,1,100
2e91bdeb00d91eb1d6ed4879ebb5f7fee6cf61b6,3,38,16,22,0,0,0,3,60,93,2,3,1.27202368,3207,216,14,230,228,2,17665,17581,84,128,126,2,1,100
5f58ecad2eea60e21ded81d586d60d7fe678588b,3,417,1,416,2,0,2,3,8,12,1,2,1.033595948,480,175,6,48,10,38,6837,4171,2666,14,3,11,1,95.05208333
0ecf1d13672aa4d58a106e1258c16f24a2b59af1,1,2,0,2,0,0,0,2,6,45,1,1,0,859,234,10,99,99,0,3973,3961,12,48,48,0,1,100
a786e41a3c0a164c649ef4922ebbc5a5f3d59201,7,41,24,17,0,0,0,1,16,141,2,4,2.48946387,2529,176,7,293,291,2,12944,12818,126,108,106,2,1,100
150ebd3c7934339f31a7b24012ece8e171e1f993,3,9,3,6,0,0,0,2,17,17,1,2,1.5,884,235,10,103,102,1,5033,5017,16,42,42,0,1,100
1624e1f119f5d24c674c74fd82dc254c966a43d6,7,57,40,17,0,0,0,4,127,58,2,4,2.416315628,8553,177,8,893,891,2,45913,45913,0,353,349,4,1,97.92293799
dbbb7a217be4a26e71b8e410aa66796c5c3096f1,5,37,30,7,0,0,0,3,62,70,1,4,2.275003058,4260,178,9,265,260,5,25163,25063,100,151,152,1,1,100
de87def6b5f577b49c3fa2e1aaddeb29dece777c,5,204,112,92,0,0,0,3,23,238,2,4,2.096596244,1719,179,10,215,203,12,10670,10149,521,58,51,7,1,99.87604586
98fd541b31dae3c5a3ec748c7d6ebe4329cd0769,6,507,13,494,3,0,3,3,56,20,1,2,1.6276397,2882,236,4,469,423,46,15897,13486,2411,205,173,32,1,99.72170686
6e07f0388b4a99a7d921ea697fb0c6cad2cea674,20,416,298,118,3,0,3,2,25,70,6,10,4.027637278,4813,180,10,433,425,8,25123,24897,226,190,189,1,1,95.70883662
0c324736bbcfa3d945cf9063426f0b04c50fcbf4,20,298,416,118,0,3,3,2,26,0,6,10,4.027637278,4931,181,11,425,433,8,24897,25123,226,189,190,1,1,95.70883662
7083f0119e48de342fad8ac1173ae18366ddd801,18,350,294,56,3,0,3,2,27,0,6,8,3.873905624,3735,182,12,348,348,0,20704,20721,17,176,176,0,1,95.70883662
36e940c6ff10f36df66072eb16393c9bbdd8e275,2,69,7,62,0,0,0,3,23,0,2,2,0.74248757,1078,183,13,85,77,8,4419,4176,243,14,13,1,2,100
6b1871970a4cd21ae5ad96f2e0c60d922066aa53,7,474,154,320,1,0,1,2,19,24,1,5,2.202454654,3168,237,5,408,350,58,17043,15679,1364,123,108,15,1,99.86898133
d775daaee0743730df70b2a5e9bb6e30d03c4171,6,124,8,116,1,0,1,2,93,32,3,4,1.83828512,3484,217,9,449,438,11,20695,20061,634,159,155,4,1,97.53542822
b069b98c52d7cbf054f8c8e82227b1b6a021a8a6,4,24,5,19,0,0,0,2,28,258,1,3,1.698570342,977,238,6,121,117,4,4937,4857,80,64,60,4,1,100
b506bb9149b3d1da74c14f825b99ab5dea7c7639,2,244,0,244,1,0,1,1,20,8,1,1,0.187771623,279,239,5,62,27,35,2316,1287,1029,31,12,19,1,100
617c8b8eab5193c3c26b77431153fc33d5099bf9,1,440,0,440,1,0,1,1,1,0,1,1,0,0,240,6,59,0,59,3013,0,3013,21,0,21,1,96.97717458
0a681b34e154bf622c68f753820153d7ee77f4c4,22,590,88,502,1,0,1,2,128,78,5,10,3.177706243,13779,184,10,1424,1376,48,80427,76906,3521,539,519,20,1,90.92572265
465dea1cca9b6030bd6cbe23826288ae21b38497,8,202,163,39,0,0,0,3,94,17,4,7,2.100320078,5217,185,11,647,640,7,28961,29143,182,241,238,3,1,88.43143927
b51af35e19efbb8425aecbfcb1665506d8427298,3,140,25,115,0,0,0,2,20,323,1,2,1.391488094,661,241,7,60,54,6,4245,2928,1317,24,23,1,1,99.82703949
2efe086d86209755f5a78472e39a5711fdbd7017,3,15,7,8,0,0,0,3,13,92,1,2,1.288649765,2359,3,0,259,256,3,11499,11430,69,100,99,1,1,100
b084c7f8d12ff38ff3d824734e009a1fc71ee20b,5,213,199,14,2,0,2,1,13,9,3,3,2.30655657,1013,186,8,76,86,10,7027,7042,15,26,35,9,1,98.18560381
083555aca45aae6cf1f113d08b3e9e3c3726117c,2,26,1,25,0,0,0,4,73,71,2,2,0.876716289,1134,242,6,73,72,1,5501,5406,95,9,9,0,1,100
ec115a3658e92d497769dd3158adf04598b8d03b,1,1,1,0,0,0,0,2,7,38,1,1,0,711,187,7,85,85,0,3756,3761,5,27,27,0,1,100
9fa541ba24235eec7dc7abc166bafd48ae0b39ed,7,110,52,58,0,0,0,3,37,328,1,1,2.7416818,2163,188,4,193,186,7,14692,14202,490,55,49,6,1,100
e9b222e9b41ef13af962a80dc32d6512a75ad017,2,152,45,107,0,0,0,4,129,20,1,2,0.999981413,5866,189,5,612,600,12,36182,35064,1118,207,204,3,1,97.353914
6ec3580ee62d92bf2d2f9d51c10fb13761317893,15,64,9,55,0,0,0,2,130,126,4,8,3.694168474,7325,190,6,927,927,0,38791,38470,321,329,329,0,1,100
a4344673a770e2c08d8f5b468a8d9dd46491c873,1,4,1,3,0,0,0,3,17,39,1,1,0,787,243,6,96,95,1,3727,3719,8,15,15,0,1,100
9f04ae4d7cb54e21fe43e1a11357eccdd1dad660,2,11,11,0,0,0,0,3,11,355,2,2,0.976020648,471,244,7,37,37,0,2955,2978,23,20,20,0,1,100
2275c4ee14c9830e868e6f6fa9773381a9a69760,7,255,0,255,1,0,1,2,26,108,1,7,1.544205003,4032,245,7,360,338,22,25186,23741,1445,176,158,18,1,98.31932773
26ad7037c3c01347be63ad33810faee0a3922a94,10,1763,8,1755,4,0,4,1,24,111,3,9,1.826709089,1034,246,8,212,48,164,14123,3198,10925,79,18,61,1,96.26911315
06ee16a33242099db958e6e9d8df6e322198049f,4,381,4,377,1,0,1,2,14,233,3,3,0.843859539,519,247,8,80,57,23,6141,3190,2951,22,13,9,1,97.03957619
d90dbd8dc4638784de702caa26bdd66a38005afb,1,11,12,1,0,0,0,3,18,8,1,1,0,790,248,9,97,96,1,3739,3727,12,15,15,0,1,100
cb9eb515bde88b1f145efc497fc264172d7e32da,4,58,8,50,0,0,0,2,96,45,4,4,1.427797194,2930,218,0,393,391,2,17570,17193,377,130,129,1,1,100
e2e1aa36d5d140afeec2cf81f1cc2bfabb6d9b18,0,0,0,0,0,0,0,0,0,0,0,0,0,0,219,1,0,0,0,0,0,0,0,0,0,1,100
ab3c4c3468d665c9a1144452dab0ba5e580667a1,1,3,2,1,0,0,0,1,14,107,1,1,0,724,191,3,33,33,0,4253,4273,20,24,24,0,1,100
c247a3bfcc242eae6609b384dc748458f11db5f8,7,535,531,4,1,0,1,2,19,70,1,3,2.138001618,2573,249,6,298,301,3,12744,12950,206,96,81,15,1,99.65537048
ca7c97dc1ee138e2a76f2a5e4bb5adf7306d5756,1,1,8,7,0,0,0,3,19,65,1,1,0,325,250,5,32,35,3,1684,1728,44,13,13,0,1,100
2c9ea237b8fe15e68ceae839212b4c809892e9f5,0,0,0,0,0,0,0,0,0,0,0,0,0,0,251,6,0,0,0,0,0,0,0,0,0,1,100
47b9d742fe00a4c1888f59cad26f72120fca92cd,1,2,1,1,0,0,0,3,12,43,1,1,0,398,220,2,28,28,0,2617,2606,11,18,18,0,1,100
1612e6d15abbf525881ed49515b96320f8ea877c,0,0,0,0,0,0,0,0,0,0,0,0,0,0,221,3,0,0,0,0,0,0,0,0,0,1,100
861d71103e92c49e3e059030dbb3396deabf2f60,1,1,0,1,0,0,0,3,13,260,1,1,0,642,192,1,126,126,0,4084,4073,11,43,43,0,1,100
031b2deb01ac7bb31d83f17672ba06131b0567d1,1,1,0,1,0,0,0,1,3,55,1,1,0,104,252,3,8,8,0,505,490,15,6,6,0,1,100
e5a825b683b8642bd8288717b385dfceecc15780,3,172,13,159,1,0,1,1,8,60,1,3,0.640638272,272,253,4,44,36,8,2521,1533,988,22,16,6,1,99.88515647
62bace35c2938eafd840547cebe2670c37787da1,8,239,95,144,1,0,1,1,20,24,2,4,2.485747108,2870,254,5,342,331,11,14788,13866,922,111,106,5,1,99.85665138
60905cd2599eb1c56e95b99d8723ef6b94cb4f93,4,612,3,609,2,0,2,1,15,26,1,1,1.096882139,469,255,6,83,36,47,7731,3286,4445,31,11,20,1,99.88551803
2e664e76cfe07bed6cc024ec474c6135f681919a,4,260,86,174,0,0,0,2,6,11,2,2,1.94083722,1231,256,7,113,87,26,10159,9150,1009,50,34,16,1,100
aa3b77209dce6d84fd34e2c7434fd92b4853da05,10,345,129,216,0,0,0,3,57,86,3,4,2.389636359,6761,193,2,673,635,38,43371,41445,1926,261,254,7,1,99.68643101
6e07fc7e7a4d8d4b8f9ddb7cf1e29ea3b47020be,1,4,1,3,0,0,0,2,2,3,1,1,0,141,222,2,8,8,0,689,655,34,5,5,0,1,100
bc65796146fca5d7d6eb49e85e20fda5bade0b57,43,2564,879,1685,8,1,9,2,131,126,5,15,4.398252203,13508,223,3,1846,1634,212,83517,72163,11354,765,714,51,1,94.16002058
763cb439b99faf7d7cd2bc2b27979824c502a238,2,12,12,0,0,0,0,4,23,108,1,1,0.918295834,910,194,3,129,129,0,4819,4819,0,49,49,0,1,100
0af037d68cbd20af225b7940c1d0a394776b580f,1,2,3,1,0,0,0,3,39,65,1,1,0,564,224,4,59,59,0,3745,3754,9,8,8,0,1,100
ec15f37353bf5fbe2323bd1abb23699d55f5bfc3,1,1,7,6,0,0,0,2,2,308,1,1,0,156,225,5,12,13,1,696,722,26,6,6,0,1,100
0ccc8e0c74773430282756a92d69bb8db27bdac0,0,0,0,0,0,0,0,0,0,0,0,0,0,0,226,6,0,0,0,0,0,0,0,0,0,1,100
ae267de541cc2014c770f34cf0e117c7e003b28c,4,286,4,282,0,0,0,1,24,98,2,3,0.917425727,1862,195,3,201,180,21,12860,11113,1747,83,75,8,1,100
b3a9ec0e7026ec3e5aea26a499dee5b7824c310e,2,49,12,37,0,0,0,1,25,146,2,2,0.560576943,636,227,6,83,79,4,3593,3395,198,22,19,3,1,94.63123644
80b91a4d8ccb211b50901cfc43dc3cfad991ec3f,3,151,46,105,1,0,1,1,132,35,1,3,1.391429962,5980,196,4,621,612,9,36904,36217,687,213,207,6,1,99.90396927
acd0a46e36d01ec5d98b9ca263741c4238f0f9aa,15,1913,785,1128,6,1,7,2,74,218,4,9,2.597379992,2460,257,5,334,218,116,17820,12209,5611,149,81,68,1,91.35770235
f96a53d2d423be1d0e55a0a422a55b7410f024c6,2,41,3,38,0,0,0,4,133,2,1,2,0.510787823,6039,197,5,618,616,2,37106,36732,374,209,208,1,1,100
8e351a4a37050eaa9c226528e97edec7a8a4337f,8,370,181,189,1,0,1,4,134,235,1,3,2.329082517,8479,198,6,947,923,24,50912,49575,1337,315,313,2,1,92.88256228
7fab1deae6174fdddc2cfda15c30c63c99ed93ee,22,105,15,90,0,0,0,3,14,24,1,2,3.304162526,3833,228,6,542,514,28,18062,17669,393,343,343,0,1,100
249f7482cdeff968b70db028eb18729d892ff2f5,5,204,46,158,1,0,1,4,135,34,2,4,1.487090211,6463,199,6,667,658,9,39954,39117,837,224,219,5,1,89.55067921
af9bd5bde1c36441c0fb1a12ae9b9aa33fb0213d,18,123,48,75,1,0,1,3,21,308,3,5,3.74754614,2319,200,7,304,296,8,12116,11574,542,167,163,4,1,96.04588723
cf073633e89076e005ef80d996d000390820cd8c,2,71,13,58,0,0,0,4,136,8,1,2,0.99631652,6405,201,8,654,650,4,39605,39248,357,219,218,1,1,100
beca145bbe61bc60a0e923072f95d8423f955ddc,2,50,24,26,0,0,0,4,137,0,1,2,0.877962001,6463,202,9,653,654,1,39735,39605,130,218,219,1,1,100
6b061cac8978703620245e7f5fd93f5b81740435,1,1,1,0,0,0,0,2,2,39,1,1,0,169,4,0,22,22,0,907,907,0,6,6,0,1,100
28c9f2a3029423bf3377fa12c2c628457c5aa42f,1,8,1,7,0,0,0,3,9,45,1,1,0,237,5,1,21,20,1,1323,1295,28,9,9,0,1,100
39e6b95a10085e21473a48bdcaf5c16aa3129e9b,0,0,0,0,0,0,0,0,0,0,0,0,0,0,0,0,0,0,0,0,0,0,0,0,0,0,100
e2bb2788f5a4170110ff2ef2b741490924621b40,1,20,12,8,0,0,0,2,2,387,1,1,0,164,1,1,17,16,1,956,866,90,6,6,0,1,100
fd9d0b84972f716d7fcf569448a45bbc7aaed610,1,1,2,1,0,0,0,3,6,288,1,1,0,141,229,5,16,16,0,490,495,5,9,9,0,1,100
75dea57f335b6966b60f7983f69a9d2026e0e3b3,1,6,4,2,0,0,0,2,2,35,1,1,0,366,6,2,27,27,0,2197,2191,6,8,8,0,1,100
d77a2255a4ec86cf12bc28599b27d7fa33b7f19a,1,4,2,2,0,0,0,2,3,0,1,1,0,368,258,1,27,27,0,2206,2197,9,8,8,0,1,100
d3fdd81bce50e9e4ac3b0b9f7e773d79eb9ac2a1,13,478,71,407,1,0,1,3,138,132,4,11,2.637555054,9305,259,2,919,883,36,59468,57067,2401,337,319,18,1,93.54454502
719db0fd0f2c76a0f2069d6b86ef4da2e29eca5f,0,0,0,0,0,0,0,0,0,0,0,0,0,0,260,3,0,0,0,0,0,0,0,0,0,1,100
bd0e6bd2cdf9b49630375006c14e3f5fc5d25cb6,12,221,222,1,0,0,0,2,22,247,5,7,3.083412917,2660,203,8,278,278,0,14024,14143,119,111,113,2,1,100
94499c9b8b494e83f6a6d6b8bf166192b58d547f,13,648,127,521,2,0,2,1,139,129,2,8,2.715867082,12944,230,2,1158,1139,19,81017,76972,4045,458,448,10,1,96.40685462
a6c7ee30a0b01c6aa81ab777ffdc9ef45c4f7a7a,3,241,65,176,1,0,1,1,37,64,1,3,1.129487254,1241,204,5,92,76,16,6943,5903,1040,21,15,6,1,99.90848078
8142f3c91c5ee8c22c461f4ba6fece35f04a550d,5,407,241,166,0,1,1,4,140,15,1,3,1.260080793,7227,205,6,744,733,11,45119,43764,1355,255,254,1,1,99.93898719
608ee831b4ed4471905eeef85da12c5ac4b25113,7,184,45,139,1,0,1,4,141,18,2,4,1.977652617,8852,261,3,878,872,6,54842,53920,922,313,310,3,1,99.63436929
ca4ec1896be2121d1694481b18b9c7fedef31eb6,1,25,1,24,0,0,0,1,3,86,1,1,0,386,262,4,57,54,3,1734,1539,195,23,23,0,1,100
aed87d2dbf1ce99a53eb2e919934dff9b8517e01,1,1,14,13,0,0,0,3,12,81,1,1,0,350,263,5,48,49,1,1945,2039,94,20,20,0,1,100
b25c8668d32fdc4839c5bae1358f4d8396160bd7,8,552,81,471,2,0,2,1,98,66,2,5,1.99208004,4699,231,2,622,589,33,26932,24810,2122,186,161,25,1,99.81779532
5bd8e4fd789efe0b3aea1ac2c8da9c00d6f63d23,19,1118,394,724,7,0,7,3,31,202,2,13,3.103275249,2633,264,6,263,215,48,18916,14446,4470,162,130,32,1,95.21503845
b63bf81eb332081f0d8d5689b98c5a7d1c25c02b,0,0,0,0,0,0,0,0,0,0,0,0,0,0,232,3,0,0,0,0,0,0,0,0,0,0,100
ee2f6aa6bbd40f6a72741fd047ba024f18f23ad5,252,5039,19156,14117,3,57,60,1,120,17,9,81,6.771308724,77432,235,0,6098,7485,1387,341095,428248,87153,2690,3270,580,0,86.77359979
f0e8a73f41a736c1bee50891e2c963c0f75ceeca,10,326,73,253,0,0,0,1,121,299,4,7,2.495837957,7061,203,0,735,696,39,42790,41585,1205,288,270,18,1,97.27473607
958f0a301055a7bab7f98b4d92ffa916ac8cf90f,2,9,11,2,0,0,0,4,72,256,2,2,0.721928095,1052,169,0,115,117,2,6137,6129,8,26,27,1,1,100
608c08af2412931041e09f85accb8bb4445f1039,3,62,0,62,0,0,0,4,122,181,1,2,1.469064052,5937,204,1,710,702,8,34218,33852,366,205,203,2,1,100
8974d523af653e56577b4bff8ddd8948fdd7df95,1,16,8,8,0,0,0,3,8,261,1,1,0,260,170,1,11,8,3,2216,2262,46,7,7,0,1,100
5a8d8e49fb86478ba15f02674e2fae8de1eef761,3,15,2,13,0,0,0,5,123,106,1,2,1.159554752,4792,205,2,639,636,3,25470,25419,51,175,173,2,1,100
c15d3ac4b9f0e6050326f810feee06c1c0ff67fd,2,11,12,1,0,0,0,2,2,250,2,2,0.666578358,185,206,3,22,22,0,987,989,2,8,8,0,1,100
b82d5f35d227468521337ad5e8ffd2783333f6d2,3,178,79,99,0,0,0,3,91,165,2,3,1.350983842,2721,207,4,369,352,17,16641,15967,674,136,127,9,1,100
6662605342e17335c31ad9177017d898e13f532d,1,4,0,4,0,0,0,6,92,0,1,1,0,1963,208,5,298,298,0,10913,10887,26,108,108,0,1,100
ca5d7d4b8e41ba318c90ea0232c32a797614d95d,2,108,19,89,0,0,0,5,124,148,1,2,0.369147641,3345,209,6,480,470,10,18826,18382,444,125,122,3,1,100
eb15f0ec0a97932b28b6b4e022b50bdfd2689799,2,71,14,57,0,0,0,4,125,0,1,2,0.970950594,5777,171,2,592,589,3,34833,34439,394,202,200,2,1,100
2b3c1449d793f5f0cdffff4b81a23e2ac2a282fa,1,1,1,0,0,0,0,1,1,0,1,1,0,58,210,7,4,4,0,222,222,0,2,2,0,1,99.90619137
469ffe639a3b95a8380a473f32817a95d568f2f5,2,9,6,3,0,0,0,3,14,262,1,1,0.918295834,1257,172,3,148,147,1,6391,6375,16,42,42,0,1,100
e868b19f1d172bbaa65e453cbf44ad1707e930d3,1,35,20,15,0,0,0,4,50,0,1,1,0,1462,211,8,170,168,2,7215,7104,111,52,52,0,1,100
279add42afcb94f65f0cc970320be46e475cd6e9,1,7,2,5,0,0,0,5,126,0,1,1,0,3403,212,9,477,477,0,18885,18855,30,121,121,0,1,100
7079ae9127e7840350503d0fde3b55d8a86b8011,3,38,16,22,0,0,0,3,60,235,2,3,1.27202368,3207,213,10,230,228,2,17665,17581,84,128,126,2,1,100
8a592a6e07985e8a77c45b3790487efb5d031bd0,1,2,0,2,0,0,0,2,6,255,1,1,0,859,236,1,99,99,0,3973,3961,12,48,48,0,1,100
7423ed27ede110caf818d006973708504d75da21,7,41,24,17,0,0,0,1,16,291,2,4,2.48946387,2529,173,4,293,291,2,12944,12818,126,108,106,2,1,100
a141218f03ca2e9d02fd668720816fb4124d3413,3,9,3,6,0,0,0,2,17,87,1,2,1.5,884,237,2,103,102,1,5033,5017,16,42,42,0,1,100
ad7f1cbed475fed96f5c639e9a90a8ac661a508b,4,57,8,49,0,0,0,1,93,196,4,4,1.440678731,2779,238,3,379,377,2,16399,16019,380,127,126,1,1,100
5aa8a1216f764992f4e96a6131eac5a8780675d5,1,1,0,1,0,0,0,3,13,368,1,1,0,642,174,5,126,126,0,4084,4073,11,43,43,0,1,100
250aee2043c8dfb10ff4d854643d63a8e0337cda,3,172,13,159,1,0,1,1,7,87,1,3,0.640638272,268,239,4,44,36,8,2465,1477,988,22,16,6,1,99.90625732
ba92893109644cb99a170e4b69b4b045168637eb,2,49,12,37,0,0,0,1,23,125,2,2,0.560576943,609,214,11,78,74,4,3482,3284,198,21,18,3,1,94.1662227
43480dac903515b8a28da31f1616c235f6158def,21,102,15,87,0,0,0,3,13,300,1,2,3.215899071,4179,240,5,528,501,27,21274,20896,378,331,331,0,1,100
afe0c2dadef13e99446f5075d7105dce65359926,256,18314,5190,13124,54,3,57,2,141,82,9,85,6.732744309,66073,265,7,7698,6434,1264,434474,351787,82687,3355,2822,533,1,86.96035242
49fe873e932265159fcf2e43814a6d6be81b5d4d,0,0,0,0,0,0,0,0,0,0,0,0,0,0,233,4,0,0,0,0,0,0,0,0,0,1,100
4d74c00e3f455227f243836937dedaca23570f97,0,0,0,0,0,0,0,0,0,0,0,0,0,0,234,4,0,0,0,0,0,0,0,0,0,1,100
4c09565c22e5310990b5dcb073ddf9ad4f3960ef,0,0,0,0,0,0,0,0,0,0,0,0,0,0,0,0,0,0,0,0,0,0,0,0,0,0,100
f531ed55065fd567585aad9789b4c91e8885fab6,256,5148,18412,13264,3,59,62,1,126,45,9,85,6.739609,79197,0,0,6434,7698,1264,351787,434474,82687,2822,3355,533,0,86.96035242
7295edd51658e10431ac3428855b0a79b0d5039c,256,18314,5190,13124,54,3,57,2,141,82,9,85,6.732744309,66073,0,0,7698,6434,1264,434474,351787,82687,3355,2822,533,0,86.96035242
2096836ce3eff9ba8bb3cff2f4aff2c27d9cf564,9,88,20,68,0,0,0,1,54,219,2,9,2.364648347,4435,235,5,429,420,9,28162,27508,654,185,179,6,1,99.91598992
9ddc6e045ef043b59ab0f668b630f82e744987f7,1,1,0,1,0,0,0,1,3,0,1,1,0,463,236,6,38,38,0,3612,3597,15,16,16,0,1,100
af538639c88ec7e5d7a19b73908ec64fcc88b95e,21,213,174,39,0,0,0,2,40,129,4,8,3.50941166,9253,206,2,870,850,20,56077,56241,164,307,301,6,1,100
4dfd8341d8642dea418195beb5d3778d3bcf35a9,10,149,135,14,1,1,2,3,50,98,1,2,2.558416615,6317,266,4,608,607,1,38191,38110,81,264,263,1,1,99.55144379
03633b839e6af006b893dca05951b345065eff14,262,5356,18735,13379,3,59,62,1,126,45,9,86,6.779664199,81707,3,0,6699,7992,1293,365883,449128,83245,2934,3480,546,1,86.91561305
79997ffd847121bda25aa74b867f951d782371f1,0,0,0,0,0,0,0,0,0,0,0,0,0,0,241,6,0,0,0,0,0,0,0,0,0,0,100
5ae6a40b694229574097f0bc75bca522a7bc00c2,263,18658,5419,13239,54,3,57,2,141,81,9,86,6.779039985,68536,237,6,7992,6699,1293,449260,366001,83259,3480,2934,546,1,86.91561305
df7ff3cb487fe835da17caa78024ea6f3aa76955,5,266,101,165,2,0,2,1,99,178,1,4,1.644111245,2291,207,1,340,330,10,14227,12905,1322,129,125,4,1,99.24242424
7aa927a72f8142a5d6e05531fd948dbff85493a9,7,125,17,108,0,0,0,3,40,30,2,5,2.207633873,4763,238,7,396,383,13,26872,26151,721,165,162,3,1,100
c2db6b83efc61ca846445c4f93d5f10926bb2083,1,2,2,0,0,0,0,4,13,16,1,1,0,595,1,1,72,72,0,2686,2679,7,22,22,0,1,100
6bb06d067e1342fe05acae108ded89c20cdf83de,34,1105,1095,10,1,2,3,3,41,51,6,12,3.507159375,11971,208,2,1143,1134,9,72830,73362,532,417,408,9,1,92.92324442
1aa98989b1a1a92df024241bac5163e2a1897780,1,4,16,12,0,0,0,5,142,72,1,1,0,3719,209,3,533,533,0,20606,20690,84,129,129,0,1,100
31f386bb6df7798da3e3bff3dd704e7879894d06,1,0,7,7,0,0,0,4,12,74,1,1,0,72,267,1,0,0,0,55,67,12,0,0,0,1,100
3b30bf19d8f11a4d5ad2170a9f53c108636cb20d,1,0,30,30,0,1,1,2,2,1334,1,1,0,30,268,2,0,0,0,0,33,33,0,0,0,1,99.94711793
a5c32093106437e1a98e9d735ef95f835c52bd9f,5,341,2,339,1,0,1,1,7,467,1,3,0.885400619,781,210,4,181,145,36,6429,3777,2652,57,43,14,1,99.94714588
3535b142fd83745c9901d9f826d952b47eca26e2,28,4232,180,4052,18,0,18,1,26,39,4,9,4.435331618,2280,269,3,454,159,295,31581,12364,19217,305,76,229,1,94.25721219
ca09b96263d2fba6684700ba22ef3f237cc1c235,2,25,21,4,0,0,0,3,14,51,1,2,0.965636133,1092,211,5,84,84,0,6998,6965,33,25,25,0,2,100
1333a83a5fd279daadcb49ee9b1a36d7961312a8,1,1,1,0,0,0,0,3,4,54,1,1,0,150,2,1,12,12,0,694,696,2,6,6,0,1,100
392727e1791078b82c6aa666a2206a279aa8813c,7,18,12,6,0,0,0,4,24,36,3,4,2.472905595,1440,212,6,166,166,0,6344,6332,12,80,80,0,1,100
cd474e0e36eaa17befab7aa0fcdfa0813d9e6b49,2,2,6,4,0,0,0,5,36,16,1,1,1,936,0,0,107,108,1,5243,5256,13,28,29,1,1,100
7296793c87fc37f3fa3d588104abd8c3b0648bfd,12,73,275,202,0,0,0,1,42,11,3,3,3.225835688,4874,270,4,423,426,3,29774,31378,1604,130,131,1,1,90.91700522
2e7641c69deb357926a3440c5d236ec65e0593be,10,271,68,203,1,0,1,3,64,164,1,7,2.351230311,7699,213,6,732,720,12,41936,40695,1241,355,346,9,1,99.75497703
e7e0b3fb6fbabbdb7fd06108359a00f50da5ebcf,16,849,344,505,2,1,3,3,143,189,5,10,2.756596731,8763,271,4,907,860,47,54730,52417,2313,350,320,30,1,90.35777721
2316c1dc951996765cbd887f6c3ab80a8e784fef,9,952,405,547,0,0,0,2,11,345,1,5,1.735010219,2661,3,2,381,319,62,16837,13637,3200,176,142,34,1,99.97832683
cfe9a42a9bd08b983d60d3823d9ed47c15ebdcf2,13,177,87,90,0,0,0,3,100,85,5,7,2.570571893,7990,214,6,979,979,0,48155,48155,0,310,310,0,1,100
650151acf1470f87eb3cc4f7d1cfd52621df1ed7,0,0,0,0,0,0,0,0,0,0,0,0,0,0,272,5,0,0,0,0,0,0,0,0,0,0,100
97805278ed9b7e9f8a20521574b22515d1c553e7,37,365,944,579,0,0,0,3,44,58,5,17,4.223243002,12071,273,6,955,1009,54,64109,67330,3221,478,498,20,1,93.30669331
ecf5abcb1044354e38ce62e66c8045eb37c50118,16,88,88,0,0,0,0,1,45,5,3,4,3.565865095,5306,274,7,483,483,0,33278,33278,0,190,190,0,1,98.11161218
af46100b48c44c2bee0e580e072e53b15cb513f7,12,102,109,7,0,0,0,1,46,0,3,4,2.876927533,4302,275,8,398,400,2,26465,26508,43,167,167,0,1,90.41297935
8ed79eaaf92401e270f2cefba7e933916883bab9,1,2,2,0,0,0,0,2,5,129,1,1,0,92,276,9,8,8,0,276,276,0,8,8,0,1,100
333d64434c5523d8885245e66974bc151d6d9f6a,6,84,8,76,1,0,1,4,22,105,1,5,2.235170026,1022,4,2,62,57,5,6233,5937,296,34,31,3,1,90.90016367
ddf049b377391745937047c007a77dad15eb8618,1,18,0,18,0,0,0,2,2,102,1,1,0,225,5,3,4,4,0,2119,2119,0,4,4,0,1,100
1f0dd5d1446ffff7c00c5fc5cf0ad1797fbddb92,2,123,0,123,2,0,2,1,1,0,1,2,0.850530668,0,277,10,8,0,8,390,0,390,4,0,4,1,99.83536385
55524f0ad6ef565046a848a04238952a55693fae,5,19,97,78,0,0,0,3,34,44,4,5,1.474021477,1926,215,7,166,168,2,11924,11935,11,62,62,0,1,100
171da568e9d46089e5722b43d94f115629dc90e6,4,63,13,50,1,0,1,1,4,38,3,4,1.336724099,904,278,11,93,90,3,6134,5938,196,41,39,2,1,99.83590417
36d08fe03b99ec154b9c91d158d7daecb84d1fa4,42,636,229,407,2,0,2,3,144,76,9,30,4.026047713,14576,239,0,1684,1665,19,91007,89028,1979,614,603,11,1,94.43501866
061dfe77f9f7c8402f0df7cdabcbe2cd858f4bdf,5,461,60,401,0,0,0,2,42,37,3,4,1.542593595,5246,216,8,456,411,45,35116,32436,2680,129,123,6,1,100
e8dc9f72f9d720e5bdf7bb3005d904451a02ce2b,0,0,0,0,0,0,0,0,0,0,0,0,0,0,217,9,0,0,0,0,0,0,0,0,0,1,100
2cbd8a235d45c94f46e09df5260fd00ca74da4ed,0,0,0,0,0,0,0,0,0,0,0,0,0,0,240,1,0,0,0,0,0,0,0,0,0,1,100
57b5875ab7122269f26b665e022be3df59142068,15,303,169,134,4,0,4,3,22,260,4,4,3.411632872,1695,279,10,162,163,1,7727,7593,134,84,85,1,1,86.52544866
835ac3ac37e7e4681667e06cc0692392e5d186a1,2,2,12,10,0,0,0,2,4,263,2,2,0.749595257,526,280,11,57,58,1,2370,2420,50,27,28,1,1,100
30c5b4705d2a220d862cfdd60683e4ab1a5a6acc,0,0,0,0,0,0,0,0,0,0,0,0,0,0,218,7,0,0,0,0,0,0,0,0,0,1,100
d319375149b74c35227080d29bc85ba9208e3863,0,0,0,0,0,0,0,0,0,0,0,0,0,0,219,8,0,0,0,0,0,0,0,0,0,1,100
f11cff6f0d17c2507b1b4c992c1cb61afc8f23b4,2,55,9,46,0,0,0,1,1,0,1,2,0.954434003,184,281,11,25,17,8,1267,904,363,10,6,4,1,99.79777553
a93fc4657fa1f84f1ff14dd2a55991211975fc06,0,0,0,0,0,0,0,0,0,0,0,0,0,0,220,9,0,0,0,0,0,0,0,0,0,1,100
6f0656f70555d1e72d16f27faea3824799d32d02,0,0,0,0,0,0,0,0,0,0,0,0,0,0,241,2,0,0,0,0,0,0,0,0,0,1,100
e9c6ff213f9c92b6ba0e270bacb61eb1c4a1c581,0,0,0,0,0,0,0,0,0,0,0,0,0,0,242,3,0,0,0,0,0,0,0,0,0,1,100
948e7a492043ac1cf210290b482ea59f8675ee1f,0,0,0,0,0,0,0,0,0,0,0,0,0,0,243,4,0,0,0,0,0,0,0,0,0,1,100
c3c3f784f83ab02725d7662e7d1edc20c2e46d7e,0,0,0,0,0,0,0,0,0,0,0,0,0,0,221,10,0,0,0,0,0,0,0,0,0,1,100
47b52156cddd2ca9557dda6b673516a82df4facf,9,98,63,35,1,0,1,2,23,187,3,5,2.617945949,1961,222,11,207,207,0,10357,10048,309,89,89,0,1,93.70661731
da9bec23970b7bbf8060a97473f7b69c79b255db,6,10,99,89,0,0,0,3,6,12,1,1,2.550898533,348,282,12,21,31,10,637,836,199,18,28,10,1,88.44580777
06bd3830295d8b6324989594ac0ae53a4599a4e9,3,36,34,2,0,0,0,3,28,62,1,2,1.293710073,1683,223,11,153,154,1,10193,10167,26,57,58,1,1,100
2050f50e9e7d25c7b48ccc71fb507b4bf8bba23e,60,875,873,2,0,0,0,3,43,49,6,32,5.340985696,19565,224,11,1759,1759,0,103274,103072,202,798,798,0,1,94.99241275
2e52635d9b42fc6fe9c64c6d4336d9180fedb05d,1,7,11,4,0,0,0,1,8,110,1,1,0,418,244,5,65,66,1,2274,2296,22,10,10,0,1,100
74d04a48ac8572631b6b73fc27350526397c00e7,43,499,354,145,2,1,3,3,145,63,5,18,4.717521375,22065,225,11,2264,2256,8,134928,133874,1054,873,872,1,1,91.99888486
842abc17e43c464b35576400230f96757ae503c7,16,66,65,1,0,0,0,2,44,0,5,8,3.342990295,6747,226,12,532,532,0,42521,42521,0,251,251,0,1,100
170af76fee3cefe524ae651c00389ade647dd698,18,62,135,73,0,2,2,2,41,165,6,12,3.64744478,4910,227,12,449,454,5,28183,28427,244,188,192,4,1,89.62318841
3a456bfddf02467b81b8e8321bd0b82bf9b20fec,1,1,1,0,0,0,0,3,44,3,1,1,0,606,228,13,2,2,0,1608,1608,0,2,2,0,1,100
692e2a0e7187009861dc23d263b5f5ed1f8b3896,1,0,149,149,0,1,1,2,2,911,1,1,0,149,283,11,0,15,15,0,625,625,0,10,10,1,99.90560101
c0d59139c0c88a38e12d5b2240f2df7f5314baa4,6,158,30,128,2,0,2,2,39,33,1,3,2.045557515,2215,284,12,288,278,10,12448,11977,471,80,70,10,1,99.13393133
ff7081e06db40bfb7e6dfc72a1c9ad6ca93be79f,20,938,10,928,2,0,2,3,13,26,1,7,2.854488827,5233,6,2,588,513,75,29832,24736,5096,369,319,50,1,99.39668175
3e785f183ad5482d3bcf815a01966c2af146df99,8,179,29,150,2,0,2,3,18,50,3,6,2.144493477,2608,285,11,312,298,14,14269,13649,620,123,109,14,2,92.46107621
cb3338e86e88ae23bb6ec11945c3694d2277eff0,6,148,59,89,0,0,0,2,45,223,2,4,1.755982132,2551,286,12,228,215,13,12007,11555,452,59,57,2,1,91.82124789
65265de17b2356dfbe6bc3e1a54804cd9eb3850b,4,198,20,178,1,0,1,1,15,21,1,4,1.091956077,519,7,3,62,50,12,4284,3105,1179,31,22,9,1,98.48341232
c259daedfde15ab7c38e3f647f76909ff4236015,1,4,0,4,0,0,0,4,11,2,1,1,0,726,0,0,85,85,0,3025,2979,46,27,27,0,1,100
141881ceeb1c0765f166b7691e473839e196288f,3,47,8,39,0,0,0,3,49,5,2,3,0.898656706,1455,287,11,151,150,1,8372,8061,311,42,41,1,1,100
cd0fc63e1319694e743c525c6f6091a9df5c18f6,2,3,0,3,0,0,0,1,1,0,1,2,0,123,8,4,8,8,0,405,390,15,4,4,0,1,99.74968711
bec90035b7597a48607299e7ae2cc881086f50e7,2,271,3,268,1,0,1,1,25,7,1,2,0.242961127,237,9,5,33,14,19,3454,1596,1858,16,7,9,1,96.21034078
2829173446165a3e6efc76a832166c5758e6838f,15,32,31,1,0,0,0,3,67,142,7,9,2.919728658,5177,229,14,275,277,2,30817,30789,28,173,175,2,1,99.66914806
e49ed3397cefe80700be58c3739d3d8d98d40c04,3,345,31,314,1,0,1,3,102,9,1,3,1.010525311,2263,288,11,337,304,33,14654,12789,1865,121,108,13,1,91.56424581
1d7ad6f73b4409c5f9f13978588768cf43cccafd,6,309,21,288,1,0,1,6,103,7,3,4,0.981872288,3450,289,12,538,500,38,19945,18215,1730,180,167,13,1,95.26594263
9fd3074f530aff9e1c1db5e7710c092e968fe937,1,2,1,1,0,0,0,1,2,1,1,1,0,263,10,4,17,17,0,1843,1832,11,9,9,0,1,100
9aa38b08a0880af08a122fbf17356522b8001b4c,1,1,1,0,0,0,0,1,6,186,1,1,0,107,245,5,14,14,0,381,381,0,13,13,0,1,100
770e3058ab797369f8ae3a9acbeaecd97b7cb30e,3,0,59,59,0,1,1,5,65,462,1,2,1.195889507,1712,246,6,132,134,2,7252,7436,184,80,82,2,1,99.94538504
2213c109edce1380dfab9fe103d7441bb5e1e399,63,765,505,260,0,0,0,3,146,70,6,24,5.543061561,20018,290,11,1861,1834,27,118399,117197,1202,833,801,32,1,95.11981297
08aa7ac5a19300538b1e9a15fe8f338e4f1cf302,1,1,36,35,0,0,0,3,45,18,1,1,0,1116,291,12,106,110,4,5520,5631,111,48,50,2,1,100
713145d8842a465410d441f08f81b66ada7e7988,0,0,0,0,0,0,0,0,0,0,0,0,0,0,292,13,0,0,0,0,0,0,0,0,0,1,100
1c16b5bfc22cc5f09029c240fd2edd97954fa800,5,41,14,27,0,0,0,2,9,206,2,4,2.036999904,1428,247,7,196,195,1,7792,7583,209,62,62,0,1,90.8600701
70db632f5dc26ec66b69b669337a33ea555a0559,22,196,106,90,0,0,0,3,31,163,7,12,3.673593612,6584,293,14,685,670,15,37622,37137,485,330,315,15,1,99.76415094
363dc07fc0c020a720d65ec03577d4d752d47cc6,1,18,20,2,0,0,0,5,10,6,1,1,0,826,11,5,108,108,0,3868,3832,36,40,40,0,1,100
af1884a1254bb3208daf09b184004b5007f43a72,4,187,19,168,0,0,0,3,50,64,3,3,0.994080904,1383,248,8,149,134,15,10509,9328,1181,38,35,3,1,100
62bbbdb78d6060688be33afe8dcec0a89eb0daa1,1,1,4,3,0,0,0,1,8,2,1,1,0,110,294,15,13,13,0,538,566,28,5,5,0,1,89.15629322
020872ae1840feac7040dcd95abee2802d40cacd,2,51,5,46,0,0,0,3,4,16,1,2,0.222284831,1048,249,9,110,106,4,5879,5587,292,56,54,2,1,100
25960cc277e40ed0c926a3cb75122c6dac0181a0,1,6,1,5,0,0,0,2,5,9,1,1,0,174,295,16,23,23,0,1104,1081,23,6,6,0,1,100
a9eb0d721dd6b611c330c11f65fd591a43e1c7ff,4,298,210,88,0,0,0,3,44,103,1,4,1.148547898,1463,296,17,162,149,13,8427,7920,507,62,54,8,1,99.53302201
0306928f7ce6c51fb56a573a5403a7cb132571bd,2,83,3,80,1,0,1,1,12,52,1,2,0.271389588,131,297,18,20,12,8,1102,729,373,9,7,2,1,92.2459893
c38d3127ac3c2335fa7961e7a2395e4c5aba72d8,2,10,11,1,0,0,0,4,27,4,1,1,0.998363673,434,298,19,30,30,0,2767,2767,0,16,16,0,1,100
d3191bd39d2a06166c43e2fd103e2add8e4dfa91,2,4,0,4,0,0,0,1,14,4,2,1,1,998,299,20,119,119,0,4666,4642,24,39,39,0,1,100
57d342cc32600956956f04fda3408f0a8e617a37,16,463,65,398,2,0,2,2,104,49,2,10,3.187859064,6490,300,21,748,703,45,37019,34783,2236,289,270,19,1,94.94759473
0df3d0f6f4f175dc013cc0286230eb5ddde98bed,9,21,18,3,0,0,0,3,105,16,5,4,2.953412455,6363,230,12,772,772,0,38134,38060,74,256,256,0,1,90.13465238
e92dc7fe4ed611ef88f77934940cd47a5da3ea11,30,146,132,14,2,0,2,3,31,177,6,15,4.009441038,4751,231,10,465,470,5,23605,23776,171,219,221,2,1,85.29216467
f5213ee4614f83562b9f24aed627736fb0b7fb77,1,2,0,2,0,0,0,3,4,33,1,1,0,144,250,6,8,8,0,702,693,9,5,5,0,2,100
5ae48c6ef568d0f56f3a6b6f785579f24ba1f557,6,35,32,3,0,0,0,2,32,10,2,4,2.328852857,1755,232,10,176,179,3,10503,10554,51,72,72,0,1,100
1831fda98497101566665d6157ceec02ff2166a4,32,811,388,423,2,0,2,2,46,4,6,11,3.933445678,12020,233,10,1166,1114,52,69798,68646,1152,564,536,28,1,85.18406759
675b237244f6bee827b8967541fda58ff1ff8c52,25,524,335,189,0,0,0,3,52,1,3,5,4.064932845,7370,301,18,662,646,16,41106,40426,680,371,364,7,1,99.03846154
45420856ee967dc777338020dcdfbbc6dd7b20b0,2,78,37,41,0,0,0,4,53,1,2,2,0.396021414,674,12,6,66,62,4,4469,4234,235,15,13,2,1,100
948565e99e309a1118d61d1c5c4883d4667e7760,0,0,0,0,0,0,0,0,0,0,0,0,0,0,7,0,0,0,0,0,0,0,0,0,0,1,100
78e1bc3a42091bdb31051093fa048b6dceb21b1c,6,97,72,25,0,1,1,2,13,244,4,4,2.055127364,939,234,10,79,76,3,5180,5171,9,35,32,3,1,93.72060858
548d813e5378a6a749827de04c0bbc9daaf21204,1,12,4,8,0,0,0,1,2,13,1,1,0,96,302,19,19,18,1,391,371,20,7,7,0,1,100
b0c87d9b201d77f79cde6e6b37367deeb4c570f5,13,171,188,17,0,0,0,3,54,4,3,9,2.078427672,5880,303,20,589,595,6,35478,35936,458,217,217,0,1,93.47442681
47ccad80927e370a993c77dfa82d57076d5f96c3,2,5,5,0,0,0,0,2,46,3,2,2,0.721928095,936,304,21,109,109,0,5870,5870,0,29,29,0,1,100
ed32980f8352615aee9af8cbc8c865749fa37d4c,7,448,828,380,1,1,2,3,55,39,2,4,2.136319447,2410,235,6,177,212,35,13450,16019,2569,63,62,1,1,87.19062093
5328978f40c679e92c6b424a8d09c6841acc1e12,1,527,0,527,1,0,1,1,1,0,1,1,0,0,236,7,54,0,54,3512,0,3512,8,0,8,1,99.35547843
674158224b80f3eff1cbf0cb46304813a18634b6,9,108,413,305,0,1,1,1,106,68,3,7,2.785939221,4725,237,8,594,630,36,25411,26898,1487,210,224,14,1,79.93311037
80542718645d96cf23865428a166fe6aa3594a61,2,104,0,104,2,0,2,1,1,0,2,2,0.939115196,0,238,9,7,0,7,229,0,229,6,0,6,1,79.7993311
a1dd8291289b029edd4cb451004148add703bce5,1,0,1,1,0,0,0,1,2,0,1,1,0,67,239,10,5,5,0,115,115,0,4,4,0,1,100
f184b1a0e183b70fb3de3282782ab9d5b8ca4c9a,17,116,95,21,0,0,0,3,47,8,2,5,3.486504135,6610,240,11,667,664,3,38834,39132,298,208,205,3,1,99.55730448
dadd4e048c7aa630ead907783af2d9fdb74db786,1,21,10,11,0,0,0,4,24,0,1,1,0,425,241,12,42,39,3,1224,1171,53,36,35,1,1,100
c171220b7ada97716eb6d778e9fb4630bb4deca0,5,24,11,13,0,0,0,1,16,28,2,2,1.948356877,1578,305,20,216,216,0,7583,7542,41,70,70,0,1,100
27e5b6c686870a72d30c1613376ea908761ea40f,139,824,799,25,1,1,2,3,147,21,7,54,6.41859076,41122,242,13,3857,3859,2,231085,231101,16,1742,1744,2,1,81.80322474
5a57868100feeb3779ae372fd656a6f3a9e897d4,1,59,50,9,0,0,0,4,7,8,1,1,0,186,243,14,14,12,2,986,930,56,10,7,3,1,100
dfb3f8d625fa17d6a0b97c3d9af15c381a042ecc,9,520,479,41,2,2,4,1,148,44,2,6,2.497475264,11296,13,6,996,1020,24,68067,68877,810,337,343,6,1,99.8019802
7536500fcf2a3b8f88254ecca39b5753ba5bf12b,0,0,0,0,0,0,0,0,0,0,0,0,0,0,0,0,0,0,0,0,0,0,0,0,0,0,100
935896d862c58f1ecc0a818199e60d1c30975637,0,0,0,0,0,0,0,0,0,0,0,0,0,0,1,1,0,0,0,0,0,0,0,0,0,0,100
33982e1c54c5f087df0ad5e1bb458752769d5f8f,27,1333,1125,208,2,0,2,3,48,77,4,15,3.24513365,9107,306,18,878,875,3,53236,52843,393,369,356,13,1,93.35053024
5cc880c7bb0098055830c0473d261bef50f42cd6,6,79,5,74,0,0,0,3,107,77,2,2,1.630904634,5596,251,6,749,737,12,27423,27066,357,265,262,3,1,100
592884940cc4e86e32f7da3f157193c79676022a,5,30,26,4,0,0,0,3,108,18,2,5,2.040636798,3257,307,19,429,430,1,18614,18589,25,158,159,1,1,100
6507bda6c86828cbefaaba364eeaa74e4ddae7b5,103,504,437,67,0,0,0,1,71,45,8,42,6.081212942,29508,244,14,2512,2501,11,170312,169344,968,1332,1326,6,1,96.39158035
309e9c06019355c668532d636b54c8f0b0c5128d,9,615,250,365,2,1,3,3,28,111,4,5,2.491597637,1167,245,15,134,122,12,8282,8327,45,52,48,4,1,90.90909091
f24962c6e94daf057a37399e1b551fa9d0b414be,1,2,1,1,0,0,0,2,7,159,1,1,0,89,308,20,10,10,0,516,512,4,2,2,0,1,100
eec14eb2b85a72021e8b06204f558b20b0251b2b,3,293,5,288,1,0,1,1,66,61,1,2,0.313975692,3071,252,7,316,304,12,16539,14482,2057,141,133,8,1,96.96874013
1e48706a7dbb3a48fa9721a0f965d80245827ce4,1,2,1,1,0,0,0,7,74,3,1,1,0,1853,253,8,243,243,0,9914,9912,2,71,71,0,1,100
215909e04415425688b9eb54d342d45ab6f5fa53,2,119,2,117,0,0,0,2,43,66,1,2,0.978161957,1102,246,16,139,123,16,7212,6463,749,30,27,3,1,100
0f2abb1ff7120af15ee422c057696d537ed89afb,1,13,2,11,0,0,0,3,28,2,1,1,0,455,247,17,52,50,2,2375,2348,27,23,22,1,1,100
0d5fdf3dec8c22ba642eaa10b760fa8aced1c74e,54,452,503,51,1,0,1,2,109,10,8,36,3.691325948,21130,309,16,2167,2181,14,121417,121959,542,832,841,9,1,95.41446208
e2692f7cacd56fd2e8d2734f79ecfbb447e2fc2c,1,2,1,1,0,0,0,2,5,0,1,1,0,291,248,18,24,24,0,1853,1844,9,10,10,0,1,100
efe49b8f646fd4b39afcf35f4d34b33d8df84cfb,0,0,0,0,0,0,0,0,0,0,0,0,0,0,310,16,0,0,0,0,0,0,0,0,0,1,100
773c0ea0bf89583afb6cb53ce9440dc33aa926b7,3,0,1027,1027,0,3,3,3,15,971,1,1,0.74375085,1027,311,17,0,0,0,0,0,0,0,0,0,1,99.83914209
30b773b5e65e64367ef035223d7a649138224e0b,11,14,73,59,0,0,0,2,22,12,3,5,2.663694152,2878,2,2,286,291,5,17535,17956,421,118,121,3,1,100
ecf373972ab70bc54bc9f8cab002e79b1b82c4ea,0,0,0,0,0,0,0,0,0,0,0,0,0,0,254,5,0,0,0,0,0,0,0,0,0,1,100
4cae42df9e0a6586ea245d6abe3aac61118b9f1d,3,13,16,3,0,0,0,2,14,0,2,2,1.383912263,618,312,17,95,97,2,2885,2891,6,30,30,0,1,100
0af5612289acb6361776039d93e8d27ebab507bb,1,2,1,1,0,0,0,5,45,2,1,1,0,929,313,18,115,115,0,5382,5370,12,20,20,0,1,100
0557abf670e801958edb906b30046990ac27e20d,2,76,57,19,0,0,0,2,6,44,1,2,0.411645571,521,249,19,38,41,3,3443,3301,142,23,23,0,1,96.02984279
9bba71a1066a524190606317b581786ddebc56b1,21,1728,43,1685,8,0,8,3,110,50,3,11,3.496354837,9001,255,5,1110,946,164,61715,51009,10706,369,307,62,1,99.47326837
84374adc7e17c018bf8309b527e3f2f572901ebf,109,524,165,359,0,1,1,2,111,164,5,18,6.172140427,19190,250,20,1711,1714,3,86924,85627,1297,777,780,3,1,99.5261911
0361dd8f2abf25710743a163f30aa5252e6fbb75,26,189,188,1,0,0,0,2,112,67,6,16,3.921610498,11050,251,21,1110,1110,0,60643,60544,99,389,389,0,1,95.07565337
02bf86598aedc27a44e3a0bb7dec66a80997713c,6,199,95,104,0,0,0,3,41,0,2,3,1.280020886,2073,314,18,224,204,20,12857,12404,453,93,91,2,1,100
8daccdb09404a9441a80fba4695b2ed4dd30a6c9,0,0,0,0,0,0,0,0,0,0,0,0,0,0,3,3,0,0,0,0,0,0,0,0,0,1,100
6023b51df8884280640dff11444d3251beddf04a,2,5,5,0,0,0,0,4,52,0,1,2,0.970950594,1568,315,19,117,117,0,6999,6999,0,22,22,0,1,100
8515a0fbab8eb9c08d695b4ff4f913dd5811543d,5,133,5,128,0,0,0,3,76,2,3,4,1.654983378,3200,252,22,436,426,10,18752,17854,898,112,110,2,1,98.41314031
dc27e010f1dcd496273190dc3864fb6f339ffad5,1,10,11,1,0,0,0,4,19,2,1,1,0,722,256,6,79,79,0,2907,2904,3,27,27,0,1,100
2422ca7584353f69bbc3ed2c1ce22374124d68e7,1,11,9,2,0,0,0,2,8,8,1,1,0,310,253,23,10,6,4,2726,2660,66,5,5,0,1,100
bf4f47dd00c9321f09c9bdfd66867f1255c76f72,10,17,24,7,0,0,0,3,16,26,3,5,3.110260163,2859,254,24,248,248,0,17353,17413,60,105,105,0,1,90.22066199
bd4a6049f19a146625eebd7d3c211b38d41eee74,43,280,28,252,7,0,7,4,33,86,4,26,4.885665766,5323,257,7,478,477,1,24742,23784,958,215,215,0,1,92.65996148
ebd14e54bfd1cafe1260381a371d8d8b6a2bbab5,10,147,23,124,1,0,1,3,25,10,4,7,1.78223305,3006,316,17,337,333,4,16612,15803,809,128,125,3,1,99.74293059
cbc385de28681c7ad8902825a7aa8f1a6f790e51,4,120,17,103,0,0,0,1,113,0,2,3,1.107588343,2432,317,18,338,320,18,13984,13403,581,124,116,8,1,99.920745
f2b155dbbf638d83e3b79a865fde40e6dba18aa1,25,102,150,48,0,0,0,3,73,5,4,11,4.328222541,10470,318,19,722,721,1,60045,60479,434,457,457,0,1,99.920745
22d097546a3ed3e8c7c729a8c8945de3f363bb20,1,15,10,5,0,0,0,4,21,0,1,1,0,722,258,8,81,79,2,2952,2916,36,27,27,0,1,100
5d78968efad42710120b5f588160ff76588e3d6b,14,0,28,28,0,0,0,5,37,107,3,13,3.440759833,3119,259,9,340,340,0,16147,16410,263,137,137,0,1,97.0617431
5212b926c2bfd16d0f63d89814e9710a97bc4362,1,9,3,6,0,0,0,3,14,0,1,1,0,423,255,25,43,42,1,2842,2824,18,10,10,0,1,100
4897b25fe2ec0c9b0108f8a8f96b60f7b5f8ad06,1,8,3,5,0,0,0,4,53,2,1,1,0,632,256,26,2,2,0,1592,1567,25,2,2,0,1,100
14f8b36ac4f026c79e272cdf3c45b07d6af5e57b,0,0,0,0,0,0,0,0,0,0,0,0,0,0,8,1,0,0,0,0,0,0,0,0,0,1,100
4a41ccf06ffbcc8103b008f43c23442b5f4e988d,48,435,17,418,9,0,9,1,51,73,2,25,5.141220433,10624,260,10,1186,1186,0,53582,52672,910,562,562,0,1,92.18970737
41f5cd8a2cef0bd78f8208881459c0165f4cb56d,35,134,13,121,1,0,1,1,1,0,2,6,0.890032732,9073,257,27,876,858,18,52175,51560,615,330,327,3,1,90.33722438
40970e68e2aac401367ec36b10d7e18c654e1d9f,0,0,0,0,0,0,0,0,0,0,0,0,0,0,258,28,0,0,0,0,0,0,0,0,0,1,100
4714376e1f098d65cf6d011884ceff7870b85f64,1,2,4,2,0,0,0,4,54,0,1,1,0,637,14,2,2,2,0,1594,1592,2,2,2,0,1,100
469bf9052f7a51e67c82b4db300d71992d5fd874,53,477,366,111,5,0,5,3,40,0,6,28,5.290810374,12351,259,29,1027,1027,0,67330,67185,145,553,553,0,1,96.94708277
98875db09ece09acee71190489d40ce17ba239c3,17,205,60,145,0,0,0,3,10,0,1,2,3.569941851,4108,260,30,310,296,14,19307,18615,692,238,239,1,1,100
8135c57bf25d30dd2cdcf3f88fc3ac6fdc1220ec,6,13,13,0,0,0,0,3,15,0,2,3,2.449311833,1609,261,11,164,164,0,10311,10325,14,59,59,0,1,99.15889975
16fdf1bbbbdf7b315424fd9743d12962c7db375b,14,321,144,177,0,0,0,1,149,52,5,11,2.643250295,8783,261,31,1049,1032,17,50118,49402,716,292,275,17,1,93.53448276
1448b61bb399eb1cce074b3f5dbfa74a83c09c9d,2,9,1,8,0,0,0,3,114,7,2,2,1,2358,262,12,327,326,1,13633,13603,30,111,111,0,1,100
09e250dd2ee3310fe7e8ae42a99e7f05b716279b,2,21,2,19,0,0,0,3,11,85,1,2,0.666578358,1378,263,12,153,152,1,7668,7540,128,67,66,1,1,100
7a61e5b85f44b2e33b87a184c7d0d00e800edf00,23,165,103,62,0,0,0,3,74,0,6,19,4.032390354,11322,319,18,877,871,6,72108,71518,590,464,463,1,1,100
37ac50aed43832a0007d514d60afeb341fc8c04e,1,7,0,7,0,0,0,1,4,9,1,1,0,191,320,19,10,10,0,1295,1214,81,10,10,0,1,100
b526ed5c1f59c83752c50ebf65d8c0d7668412a5,44,447,437,10,0,0,0,3,150,0,6,16,5.07728239,18140,321,20,1836,1836,0,100739,100778,39,732,732,0,1,98.75575251
2b1148c671860e6481d56af8880166703d1c4fff,4,264,72,192,0,0,0,3,56,295,2,1,0.645848692,1455,262,29,126,126,0,6405,6383,22,32,32,0,1,100
3952ecd6c18ce4bf4b2538a723d10da8ec9fa897,16,72,68,4,0,0,0,2,24,12,2,10,3.483061956,4553,263,30,306,306,0,23713,23705,8,172,172,0,1,100
5f94db7864b77779f6b7686d4b6e0f6a5436e770,0,0,0,0,0,0,0,0,0,0,0,0,0,0,264,31,0,0,0,0,0,0,0,0,0,1,100
b30e2bcf828dfde341c5edb1a9c8945548e620a2,110,1448,1202,246,0,0,0,2,151,1,7,41,5.226002884,39516,322,21,3476,3440,36,236455,234675,1780,1584,1548,36,1,100
34adfbb867be77867fd48a1abc9ab2ff53a41867,1,2,2,0,0,0,0,3,7,1,1,1,0,573,15,3,46,46,0,3801,3801,0,27,27,0,1,100
d078f78a357f1e6b9fdc9ae4eb02a8380f94413d,0,0,0,0,0,0,0,0,0,0,0,0,0,0,265,31,0,0,0,0,0,0,0,0,0,1,100
c1dca7ad683a883d3c60bd465ee5bd6423b7feb0,0,0,0,0,0,0,0,0,0,0,0,0,0,0,266,32,0,0,0,0,0,0,0,0,0,1,100
bfa8c1ccbffacf935f66c09569ed3e4b2c08fa1d,5,20,48,28,0,1,1,6,115,6,2,3,1.558240683,3984,267,33,533,533,0,21688,21750,62,157,157,0,1,99.96581197
46995b8582a472b232f64320c9dfaa27885370eb,2,2,5,3,0,0,0,3,12,4,2,2,0.863120569,261,268,34,32,32,0,1227,1234,7,13,13,0,1,100
d1d94c2f4b64f817e6fa2f9b79972db035992d35,2,4,4,0,0,0,0,4,8,5,1,2,1,728,4,4,62,62,0,4935,4935,0,30,30,0,1,100
fbca9f4c0aaef1c9d7b4ab6942f69057882c4c19,10,204,506,302,0,1,1,4,116,6,3,9,1.855585121,6009,264,13,631,654,23,34901,36158,1257,227,236,9,1,99.96578857
b5497d7c1992899f3bc46effb2dcbea3ccf62d82,8,470,364,106,1,1,2,3,18,0,2,2,2.066679724,1928,269,35,190,210,20,12423,14094,1671,74,88,14,1,99.79466119
7ba90e5d4b10fd9831d65e0a499919e0d3dd079f,0,0,0,0,0,0,0,0,0,0,0,0,0,0,265,14,0,0,0,0,0,0,0,0,0,1,100
7ee7165177442c9f7f0ecb14020b69391f37ef37,1,1,1,0,0,0,0,5,7,0,1,1,0,463,9,2,45,45,0,3093,3086,7,21,21,0,1,100
54a429e0bbe64861fdc569fe9c9a39e74b187c80,2,106,3,103,1,0,1,1,11,7,1,2,0.553145318,928,266,15,144,135,9,5676,5106,570,23,19,4,1,99.96578857
57bd9f7e3e1a8c34687f0c48f16bc7d5552c7874,31,122,86,36,0,0,0,2,76,0,6,20,4.616200428,10822,270,36,822,816,6,67766,67389,377,414,414,0,1,100
4b52bc923012566affddb1aa56d924481b13b392,0,0,0,0,0,0,0,0,0,0,0,0,0,0,271,37,0,0,0,0,0,0,0,0,0,1,100
c5f2eac8ded1fc98a88e27a1ea043571b8fa81dc,0,0,0,0,0,0,0,0,0,0,0,0,0,0,272,38,0,0,0,0,0,0,0,0,0,1,100
db6d9b29e07b0337509024cc5ce9bdf9fdc6627b,22,273,210,63,0,0,0,3,152,2,4,11,3.581863734,14937,273,38,1688,1685,3,87032,86516,516,560,555,5,1,100
373793b013877eb5f22965c9d6cf20aac1076a8b,7,37,24,13,0,0,0,3,77,0,4,5,2.658436586,4421,274,39,242,242,0,29184,29220,36,145,145,0,1,100
4842c3a6784f8b20c4f62e52dc220c64614e0045,23,54,47,7,0,0,0,2,29,29,4,8,4.25258884,6374,275,40,610,610,0,24500,24500,0,394,394,0,1,100
c5d3b1b327e9da04aa73a4f65377269c85fdaeb9,1,18,0,18,0,0,0,4,13,33,1,1,0,276,323,18,21,18,3,1663,1571,92,9,9,0,1,100
7422db47587c20c96a600e5e1c06afd37679749d,0,0,0,0,0,0,0,0,0,0,0,0,0,0,267,16,0,0,0,0,0,0,0,0,0,1,100
c534a12c4344b47454d3137fa2010485cb517afd,19,918,431,487,3,1,4,3,25,56,2,9,3.527146736,5453,324,19,591,575,16,31439,28006,3433,222,213,9,1,89.19093851
81a02833cae243a5d2d9b74b21dcfaae38b1b546,1,3,0,3,0,0,0,7,118,5,1,1,0,1916,5,5,282,282,0,10701,10677,24,100,100,0,1,100
b00bde76cb269327f62232f2cd5ba618ad39fb12,4,29,22,7,0,0,0,3,57,15,3,4,1.415107603,1471,16,3,67,67,0,5523,5449,74,44,44,0,1,100
d489dcfc34454c4a487ce13a3c91140d712fdba1,18,67,50,17,0,0,0,2,153,31,7,11,4.00620641,17748,6,6,1909,1906,3,98672,98581,91,682,681,1,1,99.88314344
6e1379664fd5815288c079dba703954ded9f5632,14,71,23,48,0,0,0,2,68,47,5,10,3.312049148,5971,325,19,428,426,2,35090,34749,341,255,253,2,1,100
d2dca46763933d109cd846dc7e2647748a8d70db,0,0,0,0,0,0,0,0,0,0,0,0,0,0,326,20,0,0,0,0,0,0,0,0,0,1,100
5ae13686b3ad9d96656456ab6f6e8c4ba29ffe4b,2,33,29,4,0,0,0,3,18,22,2,2,0.770629069,1187,7,7,174,175,1,7436,7416,20,37,37,0,1,100
f7151e1946908ad037069332f2e78e111e17ef64,1,19,10,9,0,0,0,5,25,15,1,1,0,741,8,6,85,84,1,3075,3014,61,32,31,1,1,100
fc86dbf0a61fa746551a1b4f358eab6f414a77f7,5,206,13,193,0,0,0,6,79,16,2,4,1.288999863,4171,327,21,271,252,19,27884,26817,1067,167,157,10,1,99.36213395
1bef46e76e43291a52b4b4a39cd6f4d371f1bc23,1,1,1,0,0,0,0,2,2,20,1,1,0,364,268,17,31,30,1,2067,2058,9,14,14,0,1,100
89d36629f5c5994da71106770b1fd1adfce7a71f,0,0,0,0,0,0,0,0,0,0,0,0,0,0,269,17,0,0,0,0,0,0,0,0,0,1,100
62e00b70ae96864f35d5bd96045bcdafdfbd52ff,31,76,68,8,0,0,0,2,80,0,5,12,3.772426447,15732,276,32,1182,1181,1,102515,102447,68,527,526,1,1,99.36213395
5018b65b4af314d12649f91e7ba34e3477a0eeae,0,0,0,0,0,0,0,0,0,0,0,0,0,0,277,33,0,0,0,0,0,0,0,0,0,1,100
4cb52efded0b407d4edcf5d6c7ce9fbf6ea59459,24,239,196,43,1,0,1,3,154,22,4,11,3.087804883,18080,270,18,1651,1649,2,105860,105831,29,718,716,2,1,99.82507289
396b9927959ff812f3926c0a9d2b430f070bb09e,1,1,1,0,0,0,0,4,19,3,1,1,0,446,271,17,89,89,0,2458,2463,5,20,20,0,1,100
926faf18217323f1715065ad3519a584ba5cdee1,2,43,3,40,0,0,0,3,46,20,1,1,0.495969072,745,278,32,81,79,2,3958,3864,94,41,39,2,1,100
db732b2fb708fe82cec25fbc31d2b73020ae58d1,4,317,23,294,1,0,1,3,13,8,1,3,1.190648075,1477,17,3,185,159,26,9500,8100,1400,80,73,7,1,99.79645246
ddef389a976793da397856f397398bdddc8db123,1,1,18,17,0,0,0,7,155,4,1,1,0,3745,18,4,533,535,2,20822,20881,59,129,129,0,1,100
eb503c696296f5d9fc1c2ef1ece282d6efc3e275,1,1,1,0,0,0,0,3,6,37,1,1,0,133,19,5,5,5,0,900,900,0,1,1,0,1,100
7731e0044532eaea9b2e4356ceeedf32017c763c,3,386,0,386,2,0,2,1,3,12,1,1,1.012653086,161,328,14,55,18,37,3110,905,2205,17,3,14,1,99.85494633
d782e7ab6ebf6312a6b97408f940edf47476dab4,2,56,3,53,1,0,1,1,58,8,1,2,0.728656167,759,272,16,5,2,3,1688,1489,199,4,2,2,1,95.40329575
c77ed4a1d76652854e1387d26e7ae4c9948cc3da,1,1,1,0,0,0,0,2,8,41,1,1,0,304,273,17,20,20,0,1984,1983,1,9,9,0,1,100
760cf0ca67513465536c42e6079a6b14f6f3e77f,0,0,0,0,0,0,0,0,0,0,0,0,0,0,274,18,0,0,0,0,0,0,0,0,0,1,100
e51b0d8622d75265ed2a8e6c95fce082ccff1c81,8,43,107,64,0,1,1,4,156,244,1,4,2.313849873,6651,329,15,833,833,0,35898,36294,396,267,268,1,1,99.82683983
db4161b03d6535d79ed5c337a190b55f3ea1f198,1,4,2,2,0,0,0,4,59,1,1,1,0,765,279,27,4,4,0,1513,1509,4,3,3,0,1,100
7f70f9ddd433b4d26eb79934396ce5102adf759c,4,57,33,24,0,0,0,2,47,120,2,4,1.689124601,2052,280,28,155,153,2,10026,9794,232,63,63,0,1,100
3dc64aced6e5c806e55fd65faf95315552037f7f,2,72,15,57,0,0,0,2,26,20,1,2,0.995325107,1325,330,14,167,162,5,7474,7127,347,60,57,3,1,100
2576bac5524e9d94120d888e0b3f31cbc3803e5d,0,0,0,0,0,0,0,0,0,0,0,0,0,0,281,26,0,0,0,0,0,0,0,0,0,0,100
6141056fa96fd60d2939e065cbe8f655711128d3,0,0,0,0,0,0,0,0,0,0,0,0,0,0,282,27,0,0,0,0,0,0,0,0,0,0,100
f673a1c99636b3dd4e2d3881338fb38c7dcb8fa3,0,0,0,0,0,0,0,0,0,0,0,0,0,0,283,28,0,0,0,0,0,0,0,0,0,0,100
81cb15780d15209bc137a95ea4e95262bca649e4,0,0,0,0,0,0,0,0,0,0,0,0,0,0,284,29,0,0,0,0,0,0,0,0,0,0,100
bfba46724d043dce22e0b313782b0c9e30bc2094,5,154,35,119,2,1,3,1,16,25,1,3,2.029150599,1007,10,2,147,134,13,6020,5559,461,70,65,5,1,99.71148298
9693ce42451fa4607d4020020d22b88600478ad3,0,0,0,0,0,0,0,0,0,0,0,0,0,0,11,3,0,0,0,0,0,0,0,0,0,1,100
523d6a87db10dce321e1a30f3f1957d21edaccdf,5,35,154,119,1,2,3,0,15,21,1,3,2.029150599,1126,284,29,134,147,13,5499,6093,594,65,70,5,0,99.71148298
0f8d2dc05231176e8298aefafdb4d3ce8f85a33b,5,154,35,119,2,1,3,1,16,25,1,3,2.029150599,1007,282,27,147,134,13,6020,5559,461,70,65,5,0,99.71148298
8e9ee5653781474a22d9e012c88be2b100c3bab7,5,7,115,108,0,1,1,4,4,626,1,1,1.112508674,1080,20,5,145,156,11,4285,4638,353,84,90,6,1,96.60825325
ff359ff353cd95962d093113edd4a479796af59f,5,35,154,119,1,2,3,0,15,21,1,3,2.029150599,1126,20,4,134,147,13,5499,6093,594,65,70,5,1,99.72268441
3f73945e7f87c69e12d2efe8198e3783d205f73a,6,155,36,119,2,1,3,1,20,22,2,4,2.091803933,1453,331,8,236,223,13,8478,8017,461,90,85,5,1,99.72268441
7f1977be0dd0e485aa9a4dd5910fd838ebe8adc6,5,35,154,119,1,2,3,0,15,21,1,3,2.029150599,1126,331,8,134,147,13,5499,6093,594,65,70,5,1,99.72268441
d6e7826c51ef272c010b602954a1592bfcb13d71,6,155,36,119,2,1,3,1,53,25,2,4,2.091803933,1913,275,8,259,246,13,11283,10822,461,91,86,5,1,99.72268441
6b28417e870d4ab4cf7f9541485625ee46ad6918,0,0,0,0,0,0,0,0,0,0,0,0,0,0,276,9,0,0,0,0,0,0,0,0,0,1,100
0be67dd0261e8547db77ab187df3628a2345a7fe,5,35,154,119,1,2,3,0,15,21,1,3,2.029150599,1126,275,8,134,147,13,5499,6093,594,65,70,5,1,99.72268441
3b75159f8ac81564c2293b6fc0a4a5a7cd6fc948,0,0,0,0,0,0,0,0,0,0,0,0,0,0,276,9,0,0,0,0,0,0,0,0,0,1,100
119d5c791006b2247ffb80b088b0961963b2e05f,5,154,35,119,2,1,3,1,16,25,1,3,2.029150599,1007,9,4,147,134,13,6020,5559,461,70,65,5,1,99.72268441
afd32dad79c09c45e10f1b1ac5b03d95d3b2f469,0,0,0,0,0,0,0,0,0,0,0,0,0,0,10,5,0,0,0,0,0,0,0,0,0,1,100
80f2128413d568812c0fa6154a62165c320616a3,5,35,154,119,1,2,3,0,15,21,1,3,2.029150599,1126,9,4,134,147,13,5499,6093,594,65,70,5,1,99.72268441
ca86b6e360fc3d6579e9667cf0f18175edc25ac8,0,0,0,0,0,0,0,0,0,0,0,0,0,0,10,5,0,0,0,0,0,0,0,0,0,1,100
b4cd97295d432e682c66fa25ebe90df68d8e74a3,13,170,35,135,2,1,3,1,16,37,1,5,2.500190563,2625,283,7,292,279,13,14804,14223,581,148,143,5,1,99.72268441
eed2d9ab0c90d82b2c3cf1302b33a0c1acd9fa03,0,0,0,0,0,0,0,0,0,0,0,0,0,0,284,8,0,0,0,0,0,0,0,0,0,1,100
9085e7bb4d3d9a5c1a91aac48048da8127cee17a,16,991,31,960,8,0,8,3,157,26,3,8,3.393119948,10019,332,7,1090,1011,79,63494,58758,4736,407,366,41,1,88.7434555
44e6a77cc5e6e09e97c5b1525428bf67967c1d25,0,0,0,0,0,0,0,0,0,0,0,0,0,0,333,8,0,0,0,0,0,0,0,0,0,1,100
88acd71c49d02eabd746ffc3a554e10ccd65fc02,13,35,170,135,1,2,3,0,15,8,1,5,2.500190563,2760,332,7,279,292,13,14163,14877,714,143,148,5,1,99.75186104
d9ea43537bb9333de5213e56d4367bf0c36cb27a,0,0,0,0,0,0,0,0,0,0,0,0,0,0,333,8,0,0,0,0,0,0,0,0,0,1,100
ee0c96379128947bb44ca6f86f016542045e7254,18,175,40,135,2,1,3,1,83,26,4,9,2.763288873,6938,334,9,513,500,13,42017,41436,581,304,299,5,1,99.75186104
7b52eb8609858d2878a99229e0c2634c6ee77add,1,1,1,0,0,0,0,4,26,59,1,1,0,672,21,4,83,83,0,3053,3053,0,30,30,0,1,100
b9e1d39a01f7a6550029f01617f0cc35fd798eb0,2,0,4,4,0,0,0,8,79,283,1,2,0.811278124,1898,277,8,242,242,0,9950,9956,6,70,70,0,1,100
bfb7b5a87420856f209a67d367c4b4197fc32860,0,0,0,0,0,0,0,0,0,0,0,0,0,0,278,9,0,0,0,0,0,0,0,0,0,1,100
f766493a93588d1112db041c603fac5709f0f19e,19,41,176,135,1,2,3,0,82,18,4,10,2.813374481,7745,277,8,583,596,13,44429,45143,714,329,334,5,1,99.75186104
2cfe0c3ac7d613573fd85894057cf15ca8e8d5a7,0,0,0,0,0,0,0,0,0,0,0,0,0,0,278,9,0,0,0,0,0,0,0,0,0,1,100
57561bc80b01bbebc8bf53096ec8a5b832d9c1db,19,176,41,135,2,1,3,1,83,29,4,10,2.813374481,7610,279,9,596,583,13,45070,44489,581,334,329,5,1,99.75186104
84d9842f2d09dae0c38c87fcec0d82affba4710e,1,1,1,0,0,0,0,5,12,55,1,1,0,440,280,8,38,38,0,2529,2533,4,16,16,0,1,100
15bf80e9cc0f4e681e66060f25861951c2b0f7df,19,41,176,135,1,2,3,0,82,18,4,10,2.813374481,7745,279,7,583,596,13,44429,45143,714,329,334,5,1,99.75186104
176b12cde8421582e05afbf1cb5e1b46f3cf0d38,3,417,66,351,0,0,0,6,83,64,1,2,0.995823661,3895,21,3,218,203,15,27905,25830,2075,133,131,2,1,91.58529581
dfe38490fd24485ddb1ba88df929682d63d555c9,19,176,41,135,2,1,3,1,84,29,4,10,2.813374481,7912,22,4,601,588,13,46916,46335,581,336,331,5,1,99.65986395
43e47bfac239dada7564b6f8e78462143be06ec7,3,684,5,679,1,0,1,1,12,49,2,3,0.463232217,1351,281,9,272,202,70,10983,7434,3549,62,29,33,1,88.61185984
90ef95ad6742fb12de43bcfbb10c3a74af15233c,3,39,35,4,0,0,0,3,60,33,1,3,1.040996439,1977,335,7,136,136,0,8839,8760,79,34,33,1,1,100
fba3a5121d00016fb055f96dbe8acc58d834e134,22,46,860,814,1,3,4,0,83,17,5,13,1.820356736,10077,334,6,790,873,83,53709,57972,4263,360,398,38,1,88.2928475
2bdac27495f6899b766e537576e7edf6df53c7a3,27,1053,66,987,4,1,5,3,158,53,5,14,2.562507001,13882,282,10,1531,1434,97,85227,79884,5343,598,555,43,1,86.51718113
d6589d3accf01ce77adea74b8595f70431611563,5,20,193,173,0,1,1,3,159,0,2,4,2.030236406,4792,283,10,644,658,14,26115,27328,1213,195,200,5,1,89.16811092
f65e65aea8cbdb44dd65c6590fbe38dd84413a5a,9,2243,246,1997,3,0,3,1,160,23,1,2,2.272455899,10257,284,9,1273,1181,92,69007,56627,12380,453,378,75,1,89.97469956
80b5795b13b7483d876b741245708a56794cd771,3,66,417,351,0,0,0,6,85,0,1,2,0.995823661,4246,23,3,203,218,15,25830,27905,2075,131,133,2,1,89.26553672
bf6ac4e7811c2ea5a327cac7d8a109e3c57fd8e7,1,2,2,0,0,0,0,3,5,63,1,1,0,412,24,4,57,57,0,1733,1734,1,23,23,0,1,100
fcc74261a0d76d00580f4d0dca042a1ed014ccec,3,417,66,351,0,0,0,6,86,0,1,2,0.995823661,3895,25,5,218,203,15,27905,25830,2075,133,131,2,1,89.26553672
16a0f57952d554e95ae1346ac3f360998ac7faac,9,176,74,102,0,0,0,1,71,194,3,7,2.314369773,4753,285,10,381,376,5,27920,26915,1005,220,217,3,1,99.909991
fb05aace5062dc441da80f5ac8d4e322ab2a15ef,5,194,19,175,1,0,1,3,161,0,2,4,2.030236406,4639,286,11,660,644,16,27360,26132,1228,200,195,5,1,87.02377542
b4580a7b81ab1a5619987296641ebbf50fda4c55,17,1077,106,971,1,0,1,3,162,32,4,11,2.352053854,14648,336,6,1450,1384,66,94304,88288,6016,541,519,22,1,94.7862069
8d8972e33d199164191a4e671a90fd49171d9053,42,370,3458,3088,1,7,8,3,158,16,5,19,3.380466253,26892,335,5,2326,2522,196,136690,155565,18875,928,1049,121,1,87.28149488
e709d62aaf56115a771a361bc83d9d4bdd7bb924,42,3458,370,3088,7,1,8,3,162,51,5,19,3.380466253,23804,337,7,2522,2326,196,155492,136750,18742,1049,928,121,0,87.28149488
d1ea44d0b4f53f729fc7842b5325d0f941b6dd1c,1,5,1,4,0,0,0,5,55,3,1,1,0,884,338,8,111,109,2,5140,5120,20,21,21,0,1,100
aa8d8053eaf9650b7ff60204020fa6466f857509,42,370,3458,3088,1,7,8,3,158,16,5,19,3.380466253,26892,336,6,2326,2522,196,136690,155565,18875,928,1049,121,1,87.28149488
91df2c84511095b259dbaeb27283a9a11f2956fd,1,2,2,0,0,0,0,3,5,64,1,1,0,412,22,2,57,57,0,1733,1734,1,23,23,0,1,100
486c0b74e6dac853ce3c401a0799ec2d1959bba7,0,0,0,0,0,0,0,0,0,0,0,0,0,0,23,3,0,0,0,0,0,0,0,0,0,1,100
b62298e1054c934e4ee8909b7ba3165ce344ea8b,42,3472,377,3095,7,1,8,3,162,51,5,19,3.406770028,24137,287,12,2550,2354,196,158788,139990,18798,1043,922,121,1,87.28149488
8e382b34d9487faea56ac0a8a31c53745aacdc3d,12,0,2680,2680,0,11,11,2,4,68,1,3,3.348564896,2833,288,13,18,312,294,834,14421,13587,3,142,139,1,99.27293065
5e5683ab5e89f1fd88883ed40574c8fb04316dd1,8,574,8,566,4,0,4,1,119,23,2,4,2.017500121,4828,285,2,707,654,53,28847,25436,3411,250,215,35,1,96.21008654
9dd0cb4d8e933d5f57b3d9ae532e7167978aed68,1,48,13,35,0,0,0,3,7,51,1,1,0,479,289,14,52,49,3,3388,3206,182,8,8,0,1,100
edb841c08de123ff2c5ace0662ae78bf3c58f2c0,3,233,222,11,0,0,0,5,15,69,2,3,0.770955754,797,12,0,93,95,2,6020,5993,27,28,29,1,1,100
7d1303fa606e700bd4d4b2a122a73a5badbbc889,1,201,76,125,0,0,0,2,2,83,1,1,0,247,290,15,19,23,4,2263,1253,1010,6,5,1,1,88.96969697
5d6b8fd5660dbe5828467d5678bbbd58c3702c7a,5,76,34,42,0,0,0,1,56,26,2,4,1.424224368,2916,286,3,342,336,6,16812,16583,229,98,93,5,1,100
18e9a5f22825f3e11a679ac03683f6de9179f9f0,66,3376,4528,1152,12,11,23,3,158,5,5,26,4.756340489,32621,285,0,3245,3197,48,180312,190296,9984,1251,1268,17,1,83.98642394
dbe6a38a5646841fa60e103566d3a54cc8f3065e,74,4566,3390,1176,11,12,23,3,162,36,5,29,4.79684877,34868,339,8,3479,3526,47,212039,202141,9898,1396,1378,18,1,83.98642394
f83387931c191631772e95f0626888a918e2751f,66,3376,4528,1152,12,11,23,3,158,5,5,26,4.756340489,32621,337,6,3245,3197,48,180314,190298,9984,1251,1268,17,1,83.98642394
938097d85f6f943a399c16fa50f07a7e2b05bdb5,66,4535,3376,1159,11,12,23,3,162,39,5,26,4.759872709,31469,26,5,3198,3245,47,190273,180374,9899,1268,1251,17,1,83.98642394
59c0462aa851d30eae934075314a4ad18ae99a88,66,3376,4528,1152,12,11,23,3,158,6,5,26,4.756340489,32628,24,4,3246,3198,48,180362,190346,9984,1251,1268,17,1,83.98642394
915999a146e87b1ecf9b92f88cf66db98eaa4b37,0,0,0,0,0,0,0,0,0,0,0,0,0,0,25,5,0,0,0,0,0,0,0,0,0,1,100
3b34c4182839c63a0fa0dac66b22d8990acb04e0,66,4528,3376,1152,11,12,23,3,162,39,5,26,4.756340489,31476,27,6,3198,3246,48,190273,180422,9851,1268,1251,17,1,83.98642394
8bd2ca352664fab8d248593f60faa6c0ff223920,2,150,18,132,1,0,1,1,5,36,1,2,0.899393971,384,340,9,56,47,9,2731,1927,804,22,19,3,1,96.14450516
10b1f2058c5a8b53b3711f318da70ed23acc1937,66,3376,4528,1152,12,11,23,3,158,6,5,26,4.756340489,32628,338,7,3246,3198,48,180362,190346,9984,1251,1268,17,1,82.65492102
e328055e61a8dcaa1beed25e6da47f4a2279f3b6,73,4552,3388,1164,11,12,23,3,162,34,6,27,4.786869413,33400,28,7,3367,3413,46,202610,192668,9942,1333,1316,17,1,82.65492102
2d04d64aa770d7b1cc646bbe7a75c97dfe50afc3,66,3376,4528,1152,12,11,23,3,158,6,5,26,4.756340489,32628,26,5,3246,3198,48,180362,190346,9984,1251,1268,17,1,82.65492102
625450cf11454fa9697a902ba70367de00cdc170,75,4938,3412,1526,11,12,23,3,162,62,5,30,4.888795064,33944,13,1,3499,3494,5,203998,192252,11746,1378,1347,31,1,82.65492102
82ec16baf890a6914337544ff3f6a7715aa1b86e,2,53,1,52,0,0,0,6,88,20,1,2,0.650022422,4765,29,8,233,232,1,31664,31342,322,138,138,0,1,100
21ef8cd20e327927684e756b041a045df72d1c8f,75,3412,4938,1526,12,11,23,3,158,22,5,30,4.888795064,35515,27,6,3494,3499,5,192455,204334,11879,1347,1378,31,1,82.65492102
4cf6472e39018d8809a945f4ccb39155d8c03220,92,6265,3662,2603,15,12,27,3,163,46,6,38,5.142913282,37185,287,2,3998,3854,144,231029,213014,18015,1545,1467,78,1,84.61758808
7a381304a266c88ee84d936c1960c36a9015a174,75,3412,4938,1526,12,11,23,3,159,26,5,30,4.888795064,35536,286,1,3498,3503,5,192633,204516,11883,1350,1381,31,1,85.3051779
4ab67799f3b7115ebf6117993861dc0cd9634b24,76,4965,3439,1526,11,12,23,3,163,58,5,31,4.913412664,34254,288,3,3522,3517,5,205961,194211,11750,1396,1365,31,1,85.3051779
4e085fa32759445f428493c3df5b55ca235f9089,75,3412,4938,1526,12,11,23,3,159,26,5,30,4.888795064,35536,287,2,3498,3503,5,192633,204516,11883,1350,1381,31,1,85.3051779
c360b517394f858fa73d6737fd0dfbbeffe59c7f,76,4947,3414,1533,11,12,23,3,163,57,5,30,4.896850651,34511,30,9,3566,3558,8,207674,195875,11799,1401,1370,31,1,85.3051779
6a46e11c6a8057d5f713c7acacb63ffa299e38a5,75,3412,4938,1526,12,11,23,3,159,26,5,30,4.888795064,35536,28,7,3498,3503,5,192633,204516,11883,1350,1381,31,1,85.3051779
41fe736ddbbf367add778232799c5d7dfd37c5dc,77,4963,3422,1541,11,12,23,3,163,57,5,31,4.909531702,35337,289,4,3567,3562,5,214275,202338,11937,1422,1391,31,1,85.3051779
f67dcd794cf0e60277d3df14c7530cb647cadd69,75,3412,4938,1526,12,11,23,3,159,26,5,30,4.888795064,35536,288,3,3498,3503,5,192633,204516,11883,1350,1381,31,1,85.3051779
97528e9188a05b323699222e21ed7f22fd7ff8e3,81,5074,3509,1565,12,13,25,3,163,55,6,36,4.972332672,34913,290,5,3568,3566,2,210511,198929,11582,1412,1382,30,1,85.07376338
2b20bd7928f0f4a11291a48e6991f19a130d3b01,75,3412,4938,1526,12,11,23,3,159,27,5,30,4.888795064,35536,289,4,3498,3503,5,192631,204514,11883,1350,1381,31,1,85.3051779
09bd44e76c3e4fd10a474197b7db0f0e1c78541b,75,4954,3413,1541,11,12,23,3,163,57,5,30,4.894205168,34010,291,6,3503,3498,5,204588,192691,11897,1381,1350,31,1,85.3051779
55ae1e57cc4a3311791e4818782787a3b5d3fd18,1,17,3,14,0,0,0,4,17,114,1,1,0,178,292,7,12,10,2,1262,1198,64,10,10,0,1,100
375863f497219fb7e52c1afcf8225ad321ee6786,75,3413,4954,1541,12,11,23,3,159,27,5,30,4.894205168,35551,290,5,3498,3503,5,192631,204661,12030,1350,1381,31,1,85.3051779
4023898c109b8e50e71fa08eacdf294b66d162d1,81,5600,3535,2065,12,12,24,3,163,53,6,31,5.032861754,35546,293,8,3690,3651,39,216875,202340,14535,1452,1406,46,1,85.14021393
9159e11700d3eff722fdda615565528182a619d2,2,145,20,125,0,0,0,4,27,71,1,2,0.945660305,1217,31,9,100,96,4,8631,7748,883,33,33,0,1,100
df9b37c1c8fc2fc1c9c2027620efa9caae2ba48a,81,3534,5599,2065,12,12,24,3,159,23,6,31,5.032654972,37641,29,8,3654,3693,39,202386,217054,14668,1406,1452,46,1,85.14021393
06fa79ae599187d7976ed5e9cccf9c66fc91eff7,92,5943,3686,2257,13,12,25,3,163,38,6,35,5.19616229,41247,294,9,4262,4210,52,254585,238389,16196,1668,1617,51,1,85.09101416
485f675bd3bcb59ee2d31554c2a2b6160cdbcdb7,2,1,3,2,0,0,0,3,15,35,1,1,0.811278124,966,295,10,99,99,0,5802,5816,14,44,44,0,1,100
df375e82f964fb77982d0a8bfad62bab93bdb0eb,1,510,0,510,1,0,1,1,1,0,1,1,0,0,296,11,58,0,58,2921,0,2921,33,0,33,1,99.94363021
d1588c2e26aff66fc78740e71fc7fa091c913f8c,1,15,8,7,0,0,0,3,3,131,1,1,0,341,11,0,46,43,3,1676,1617,59,33,32,1,1,100
2cee9acaa2617bd8e6263f3d42003c98d907edf0,1,68,0,68,1,0,1,1,1,0,1,1,0,0,12,1,5,0,5,249,0,249,3,0,3,1,99.94369369
51c8a8b7187af3791f6985d046b428fcb30666d6,7,135,21,114,0,0,0,3,58,45,2,4,2.334308151,3563,297,12,427,418,9,17629,17252,377,157,153,4,1,100
b6790520ddccb499e590efd3b567751e405a833a,2,135,41,94,0,0,0,6,164,13,1,2,0.969605599,8543,298,13,771,766,5,52997,52606,391,266,261,5,1,100
a156c6eb5a0c88babc221ef83ee7d9e3a173cdc7,2,7,10,3,0,0,0,4,28,8,1,2,0.787126586,1342,299,14,100,100,0,8631,8631,0,33,33,0,1,100
a56f9ef4e81002f64d961a195bd68fd5c10e2bee,1,2,2,0,0,0,0,3,10,46,1,1,0,331,300,15,23,23,0,2206,2206,0,10,10,0,1,100
160a5d80fd108dcf597c734ceb3d0e23ff432f6e,1,62,62,0,0,0,0,4,5,135,1,1,0,2112,32,6,337,337,0,9929,9928,1,99,99,0,1,100
52648442aea4a2d51044131a70b7e86b5fd805fb,102,3773,6818,3045,12,15,27,3,159,23,6,40,5.359924236,47481,30,6,4480,4612,132,255226,275538,20312,1771,1868,97,1,84.99278499
fa2928f6a9fae32fb7edc5dad6374ca625c3b417,104,6823,3771,3052,15,12,27,3,164,35,6,41,5.3669128,45440,33,7,4738,4605,133,280317,260077,20240,1904,1807,97,1,84.99278499
2d35b28baf7c0e0d17641d322c62b61ee0cc0e0c,0,0,0,0,0,0,0,0,0,0,0,0,0,0,34,8,0,0,0,0,0,0,0,0,0,1,100
14cf35b783a43ac7758f1c2f698045d2c739fd26,0,0,0,0,0,0,0,0,0,0,0,0,0,0,301,15,0,0,0,0,0,0,0,0,0,0,100
7511e45a68f96c208483155389722760861a6b8f,0,0,0,0,0,0,0,0,0,0,0,0,0,0,311,22,0,0,0,0,0,0,0,0,0,0,100
f86260fee8217de21d0fa5468dd4be149d69786f,0,0,0,0,0,0,0,0,0,0,0,0,0,0,312,23,0,0,0,0,0,0,0,0,0,0,100
f673a1c99636b3dd4e2d3881338fb38c7dcb8fa3,0,0,0,0,0,0,0,0,0,0,0,0,0,0,283,28,0,0,0,0,0,0,0,0,0,0,100
523d6a87db10dce321e1a30f3f1957d21edaccdf,0,0,0,0,0,0,0,0,0,0,0,0,0,0,284,29,0,0,0,0,0,0,0,0,0,0,100
ff359ff353cd95962d093113edd4a479796af59f,5,7,115,108,0,1,1,4,4,636,1,1,1.112508674,1080,20,4,145,156,11,4285,4638,353,84,90,6,1,96.60441426
7f1977be0dd0e485aa9a4dd5910fd838ebe8adc6,1,1,1,0,0,0,0,4,20,23,1,1,0,446,331,8,89,89,0,2458,2458,0,20,20,0,1,100
0be67dd0261e8547db77ab187df3628a2345a7fe,1,1,1,0,0,0,0,5,53,41,1,1,0,906,275,8,112,112,0,5263,5263,0,21,21,0,1,100
3b75159f8ac81564c2293b6fc0a4a5a7cd6fc948,0,0,0,0,0,0,0,0,0,0,0,0,0,0,276,9,0,0,0,0,0,0,0,0,0,1,100
80f2128413d568812c0fa6154a62165c320616a3,0,0,0,0,0,0,0,0,0,0,0,0,0,0,9,4,0,0,0,0,0,0,0,0,0,1,100
ca86b6e360fc3d6579e9667cf0f18175edc25ac8,0,0,0,0,0,0,0,0,0,0,0,0,0,0,10,5,0,0,0,0,0,0,0,0,0,1,100
88acd71c49d02eabd746ffc3a554e10ccd65fc02,16,991,31,960,8,0,8,3,157,26,3,8,3.393119948,10019,332,7,1090,1011,79,63494,58758,4736,407,366,41,1,88.73165618
d9ea43537bb9333de5213e56d4367bf0c36cb27a,0,0,0,0,0,0,0,0,0,0,0,0,0,0,333,8,0,0,0,0,0,0,0,0,0,1,100
f766493a93588d1112db041c603fac5709f0f19e,2,0,4,4,0,0,0,8,79,283,1,2,0.811278124,1898,277,8,242,242,0,9950,9956,6,70,70,0,1,100
2cfe0c3ac7d613573fd85894057cf15ca8e8d5a7,0,0,0,0,0,0,0,0,0,0,0,0,0,0,278,9,0,0,0,0,0,0,0,0,0,1,100
15bf80e9cc0f4e681e66060f25861951c2b0f7df,1,1,1,0,0,0,0,5,12,55,1,1,0,440,279,7,38,38,0,2529,2533,4,16,16,0,1,100
176b12cde8421582e05afbf1cb5e1b46f3cf0d38,3,417,66,351,0,0,0,6,83,64,1,2,0.995823661,3895,21,3,218,203,15,27905,25830,2075,133,131,2,1,91.58529581
fba3a5121d00016fb055f96dbe8acc58d834e134,3,39,35,4,0,0,0,3,60,33,1,3,1.040996439,1977,334,6,136,136,0,8839,8760,79,34,33,1,1,100
8d8972e33d199164191a4e671a90fd49171d9053,15,1066,95,971,1,0,1,2,158,51,3,10,2.244587432,13090,335,5,1368,1302,66,84444,78428,6016,487,465,22,1,98.89447236
aa8d8053eaf9650b7ff60204020fa6466f857509,1,5,1,4,0,0,0,5,55,3,1,1,0,884,336,6,111,109,2,5140,5120,20,21,21,0,1,100
91df2c84511095b259dbaeb27283a9a11f2956fd,1,2,2,0,0,0,0,3,5,64,1,1,0,412,22,2,57,57,0,1733,1734,1,23,23,0,1,100
486c0b74e6dac853ce3c401a0799ec2d1959bba7,0,0,0,0,0,0,0,0,0,0,0,0,0,0,23,3,0,0,0,0,0,0,0,0,0,1,100
18e9a5f22825f3e11a679ac03683f6de9179f9f0,4,74,32,42,0,0,0,2,56,44,1,3,1.244100756,2713,285,0,330,324,6,15253,15034,219,89,84,5,1,100
f83387931c191631772e95f0626888a918e2751f,9,38,14,24,0,0,0,3,38,60,4,8,2.445470853,4668,337,6,359,358,1,30901,30854,47,163,162,1,1,100
59c0462aa851d30eae934075314a4ad18ae99a88,1,7,0,7,0,0,0,8,119,73,1,1,0,1919,24,4,283,282,1,10749,10701,48,100,100,0,1,100
915999a146e87b1ecf9b92f88cf66db98eaa4b37,0,0,0,0,0,0,0,0,0,0,0,0,0,0,25,5,0,0,0,0,0,0,0,0,0,1,100
10b1f2058c5a8b53b3711f318da70ed23acc1937,2,150,18,132,1,0,1,1,5,36,1,2,0.899393971,384,338,7,56,47,9,2731,1927,804,22,19,3,1,92.86816919
2d04d64aa770d7b1cc646bbe7a75c97dfe50afc3,7,24,12,12,0,0,0,3,9,45,2,2,2.265246528,1924,26,5,169,167,2,12337,12246,91,65,65,0,1,100
21ef8cd20e327927684e756b041a045df72d1c8f,2,53,1,52,0,0,0,6,85,22,1,2,0.650022422,4765,27,6,233,232,1,31664,31342,322,138,138,0,1,100
7a381304a266c88ee84d936c1960c36a9015a174,23,1327,250,1077,4,0,4,3,159,85,3,15,2.635993927,11571,286,1,1634,1495,139,73717,67452,6265,497,450,47,1,90.4398827
4e085fa32759445f428493c3df5b55ca235f9089,1,27,27,0,0,0,0,2,7,87,1,1,0,244,287,2,19,19,0,1518,1518,0,15,15,0,1,100
6a46e11c6a8057d5f713c7acacb63ffa299e38a5,1,9,2,7,0,0,0,2,2,1,1,1,0,501,28,7,63,60,3,3231,3182,49,20,20,0,1,100
f67dcd794cf0e60277d3df14c7530cb647cadd69,2,25,10,15,0,0,0,3,28,15,1,2,0.512709142,1327,288,3,64,64,0,9832,9645,187,41,41,0,1,100
2b20bd7928f0f4a11291a48e6991f19a130d3b01,7,136,97,39,1,1,2,2,10,76,3,7,1.378175715,1211,289,4,110,113,3,7811,7979,168,44,45,1,1,99.76303318
375863f497219fb7e52c1afcf8225ad321ee6786,1,17,3,14,0,0,0,4,17,114,1,1,0,178,290,5,12,10,2,1262,1198,64,10,10,0,1,100
df9b37c1c8fc2fc1c9c2027620efa9caae2ba48a,2,145,20,125,0,0,0,4,26,100,1,2,0.945660305,1217,29,8,100,96,4,8631,7748,883,33,33,0,1,100
52648442aea4a2d51044131a70b7e86b5fd805fb,1,62,62,0,0,0,0,4,5,135,1,1,0,2112,30,6,337,337,0,9929,9928,1,99,99,0,1,100
7511e45a68f96c208483155389722760861a6b8f,104,6823,3771,3052,15,12,27,3,164,35,6,41,5.3669128,45440,311,22,4738,4605,133,280317,260077,20240,1904,1807,97,0,84.99278499
f86260fee8217de21d0fa5468dd4be149d69786f,0,0,0,0,0,0,0,0,0,0,0,0,0,0,312,23,0,0,0,0,0,0,0,0,0,0,100
08bafa987a9ee468aa653ad3b3c171ce1322ea36,5,43,9,34,0,0,0,3,20,57,1,1,0.951612316,1919,302,15,188,184,4,12230,11995,235,73,71,2,1,100
7ebe629f623072a56d48d1ad345bf762211d972c,2,25,24,1,0,0,0,1,6,67,2,2,0.975525951,887,303,16,114,112,2,4838,4781,57,44,44,0,1,100
2103129a28cbcdb2282b3a3e0e2aa230c0b5e756,1,6,8,2,0,0,0,5,14,104,1,1,0,827,14,1,107,107,0,3882,3882,0,40,40,0,1,100
b5aca318bfccb9834031d77e66bdffecd62ba824,0,0,0,0,0,0,0,0,0,0,0,0,0,0,304,17,0,0,0,0,0,0,0,0,0,0,100
e2c7f5de8d9decb0d81abdc716474d0928ffe80c,0,0,0,0,0,0,0,0,0,0,0,0,0,0,305,8,0,0,0,0,0,0,0,0,0,1,100
efa6afd0f3e8a5c2cde8f1c415f6b3f87c194c89,8,29,6,23,0,0,0,3,7,88,2,2,2.816298635,2350,35,3,181,181,0,11312,11342,30,116,116,0,1,100
d24aef4ee6466f484219c93766933a215fd3a348,0,0,0,0,0,0,0,0,0,0,0,0,0,0,36,4,0,0,0,0,0,0,0,0,0,1,100
f0558b797d783357e09c725ff28f6cf5aa3e52f4,0,0,0,0,0,0,0,0,0,0,0,0,0,0,37,5,0,0,0,0,0,0,0,0,0,1,100
e304e24f169f0db4a260924d354d019309e8ab5c,1,12,0,12,0,0,0,4,25,83,1,1,0,264,38,6,34,32,2,1715,1601,114,23,23,0,1,100
6c199033c15767f2251844f91c0942229ed36277,4,185,102,83,0,0,0,3,61,59,1,3,1.430564391,2732,291,0,225,223,2,12599,11937,662,68,66,2,1,100
32c2e9b60549553152f88044fdca7dd06e8e25a2,0,0,0,0,0,0,0,0,0,0,0,0,0,0,292,1,0,0,0,0,0,0,0,0,0,0,100
6d856f9521960c782d4b8c43c14fec16a1d6552c,3,105,21,84,1,0,1,1,62,62,1,3,1.319783159,955,293,2,31,27,4,2996,2591,405,11,9,2,1,99.88754568
e0fe9aaeacb43e8aa3fe1d0a5413b26598d076ed,2,113,9,104,0,0,0,2,26,50,1,2,0.698374793,352,294,3,46,35,11,2802,2192,610,31,24,7,1,100
4b5b20e23638965495f186fb6fc28f5d82346b80,2,190,66,124,0,0,0,2,60,90,1,2,0.942163169,2211,295,4,217,212,5,12937,11938,999,90,86,4,1,100
0ad4a4b889028eb1a31a719b22c33d1feb1721af,2,544,133,411,0,0,0,4,29,54,1,2,0.828922918,1339,39,4,116,100,16,11841,8631,3210,38,33,5,1,100
038ba9b6ab1a8b5ccd4e3f5f13fc5f5413fea9f1,6,26,9,17,0,0,0,2,5,160,1,1,2.489839005,1750,341,0,111,110,1,8796,8676,120,36,35,1,1,99.88764045
156e96dc3485dd94d97cd9623d273d8ac3fec32b,8,39,25,14,0,0,0,5,27,102,1,4,2.855649996,3924,40,5,499,491,8,20603,20514,89,191,191,0,1,100
c04c7b5e5a08c90e5c128885cbd685d0d14e6ae8,1,15,2,13,0,0,0,5,15,159,1,1,0,1115,41,6,124,121,3,5702,5636,66,38,37,1,1,100
62536218271317d8b8e57c7ce172d247a95db3ba,5,390,68,322,1,0,1,1,27,48,1,4,1.934745633,2027,342,1,278,243,35,12018,10390,1628,81,67,14,1,99.71941639
7be5830a908602ff91a07d3020f2dddf7705d48f,52,141,151,10,0,0,0,2,44,37,3,19,5.030767066,13727,343,2,1302,1302,0,76845,76736,109,548,548,0,1,95.0255445
0a31652b9b68f48e936618e2c2edf9a402314da1,11,104,667,563,0,1,1,4,72,598,1,6,2.248948313,6487,306,2,363,403,40,37837,40468,2631,197,210,13,1,99.58570689
71231c892deb40d4c7a0c9f948ea8d40ceb0ec6e,1,1,1,0,0,0,0,1,2,0,1,1,0,804,344,3,93,93,0,4409,4409,0,30,30,0,1,100
1fc98d3335c09169e258851e4fff014819c00c31,1,5,1,4,0,0,0,1,3,93,1,1,0,203,307,2,13,12,1,1577,1558,19,9,9,0,1,100
4186c6dee22f8c8bb705973559c9eee9112cc151,14,150,120,30,0,0,0,3,63,112,4,9,2.539843512,3630,345,4,230,230,0,17327,17203,124,134,134,0,1,100
2600c538886c5864a9248cff04f445cfbde8b203,10,243,44,199,0,0,0,3,165,81,3,10,2.729195292,6855,296,5,836,822,14,44824,43062,1762,233,226,7,1,100
190a74fdc28655f8ca1a3946687aad40c8254ad0,16,101,28,73,0,0,0,3,122,63,3,13,3.561605792,9789,297,6,1007,1000,7,59834,59133,701,410,407,3,1,100
d456a6dd29ebe1d91c0b7223a3bde3739986ede1,1,1,1,0,0,0,0,3,7,0,1,1,0,221,298,7,27,27,0,1830,1819,11,3,3,0,1,100
7ef88b9f369d329ccaf6afbd1ab57739011c1f0d,0,0,0,0,0,0,0,0,0,0,0,0,0,0,0,0,0,0,0,0,0,0,0,0,0,1,100
0a592a07ee993883f0a71d8189868e0ac43e793e,2,13,8,5,0,0,0,2,84,52,1,2,0.702466551,2396,1,1,276,276,0,13388,13280,108,93,93,0,1,100
749062d820b4f602ac44b2ac2884107cdbcc50f7,1,3,3,0,0,0,0,4,64,2,1,1,0,820,346,5,4,4,0,1657,1657,0,3,3,0,1,100
18b29713acb3a01d67f4591eeadd5baafa196484,2,0,2,2,0,0,0,3,3,6,2,2,1,419,299,8,38,38,0,2481,2491,10,13,13,0,1,100
b37ce2cd872155eb1f2e8da56e7afb823b908874,1,5,2,3,0,0,0,2,6,2,1,1,0,794,300,9,38,38,0,5311,5307,4,33,33,0,1,100
9577195f6897d5eb24cf19361a23ca911f7a48cd,0,0,0,0,0,0,0,0,0,0,0,0,0,0,301,10,0,0,0,0,0,0,0,0,0,2,100
c942d0ca730731d07818040b635e98ef7d9ef5da,1,1,1,0,0,0,0,2,7,0,1,1,0,797,302,11,38,38,0,5313,5311,2,33,33,0,1,100
9220170dd87e26542bcfe3bbdc29871625535e1f,2,47,5,42,0,0,0,4,61,60,1,2,0.456683632,2202,347,6,237,231,6,11832,11563,269,110,108,2,1,100
83b0c3db9777dc4ebe76963571d4be4ce6985873,1,2,3,1,0,0,0,2,4,107,1,1,0,237,303,12,60,60,0,1476,1476,0,10,10,0,1,100
583448fb1165b93208df6cbdeedac24529e12ae6,0,0,0,0,0,0,0,0,0,0,0,0,0,0,2,2,0,0,0,0,0,0,0,0,0,1,100
00c5a93f3b250facb957231eb2cee01854bb2369,2,149,0,149,1,0,1,4,6,9,1,1,0.058100748,161,15,0,32,19,13,1963,890,1073,13,4,9,1,99.94813278
244f12f66e9c9f8773102c6d755bf449dfb76cf0,1,1,1,0,0,0,0,2,2,186,1,1,0,95,3,3,7,7,0,531,529,2,4,4,0,1,100
99f2b8ee94cd9ed551fa380ed0411b4cc69f6d77,2,144,0,144,0,0,0,3,21,90,2,2,0.249882293,652,348,7,70,58,12,4880,3911,969,27,19,8,1,97.12306873
63648fba216fc8e1caff629a023c73c2b8584aa3,2,30,3,27,0,0,0,3,22,59,2,2,0.532835063,1127,349,8,120,116,4,7508,7350,158,48,47,1,1,100
fdebd19941c34f3d879a322e11cfe3642876b463,3,108,5,103,0,0,0,2,11,192,1,3,1.163177937,1381,308,3,222,206,16,8168,7646,522,41,34,7,1,90.33647376
7a802b13d19c09ffe7bf0c331e0fac7234d0063b,3,95,5,90,0,0,0,2,12,0,1,3,1.310233267,1484,309,4,234,222,12,8778,8168,610,44,41,3,1,100
1cee45da1be60fd1d0b71a84fe5875920931da5c,3,15,7,8,0,0,0,2,60,102,1,3,1.436545552,1502,310,5,164,164,0,8076,8039,37,55,55,0,1,100
7cc5db92c588cf0712a2f4612708b8d32cfaf1a6,1,14,1,13,0,0,0,5,23,180,1,1,0,405,4,4,45,44,1,2089,2044,45,18,17,1,1,100
f910aca56fb5cd32582d353032b3af9bc58cc030,0,0,0,0,0,0,0,0,0,0,0,0,0,0,13,0,0,0,0,0,0,0,0,0,0,1,100
e9208c0808c2a0649ce336d87534ad6f9cbab818,6,116,9,107,1,0,1,2,123,145,1,4,2.269487613,2901,304,13,417,407,10,16822,16346,476,160,153,7,1,91.06145251
6bc134837915ebe78ed77f02579a92a7d4d4cb40,0,0,0,0,0,0,0,0,0,0,0,0,0,0,42,7,0,0,0,0,0,0,0,0,0,1,100
e530a46c352234459d2aced93e43fcb83c98d450,10,420,361,59,1,1,2,1,124,293,1,6,2.03976782,5156,350,9,525,527,2,31651,33529,1878,211,215,4,1,99.35224481
b4674b485dd4e62c177d87581f302b243f24d797,9,1017,278,739,1,0,1,2,166,303,3,5,1.89627919,9791,5,5,942,880,62,63618,59048,4570,361,332,29,1,91.52907394
bd8634bb46191ac2d5770ba0f7052b322f266126,4,255,3,252,0,0,0,3,10,20,2,4,0.783961876,1793,305,14,171,163,8,15891,13483,2408,51,45,6,1,100
d523db65804a5742ce50824e6fcfb8a04d184c0d,10,104,75,29,0,0,0,3,167,188,4,6,2.741293413,9333,306,15,1123,1125,2,51009,50948,61,368,361,7,1,99.92225965
2266cccf9290601662944bdfa17ef5a2e96e9371,4,72,31,41,0,0,0,8,125,51,3,2,1.740167635,3377,43,4,368,362,6,15680,15304,376,139,136,3,1,100
b8b317237d7f28444d955922ef0d37e2e8b373a0,5,163,70,93,0,0,0,1,2,20,1,2,1.380724085,2804,351,10,363,344,19,14607,14037,570,101,100,1,1,100
9e1eb5277dccfc16bebe07bab86351ff258bdd45,2,65,3,62,0,0,0,2,2,98,1,2,0.322756959,161,352,11,18,11,7,901,523,378,8,6,2,1,100
13f112bc49862d1a782e1cda9c7f0a3901181df2,5,15,15,0,0,0,0,2,4,190,1,1,2.321928095,1924,353,12,198,198,0,7671,7626,45,146,146,0,1,100
92b6b6b6722579eb0d29b43c3174a5c913f303a8,1,5,1,4,0,0,0,2,5,32,1,1,0,203,307,11,13,12,1,1577,1558,19,9,9,0,2,100
f801fa01d81ed0c0b7c1b39fbd551c5f86a8dda0,8,87,53,34,0,0,0,2,5,133,2,6,2.615845501,3952,44,5,462,457,5,20368,20150,218,144,142,2,1,97.71579707
e225b5a4ce2bc0fae3f9ed9b6ac213ac8d2166e5,3,16,35,19,0,0,0,2,4,0,1,3,0.783613882,1711,45,5,200,203,3,8606,8660,54,69,70,1,1,100
bc62d81a78213175464658f58658f89105a027ad,3,146,17,129,0,0,0,3,66,27,1,3,1.420517194,2103,354,12,147,140,7,10253,9652,601,39,36,3,1,100
65b5b8c9c901198b1661110eb91591201a6c7f12,1,6,11,5,0,0,0,5,62,0,1,1,0,908,355,13,114,115,1,5245,5279,34,22,22,0,1,100
4da4071586b53e36700af18b4c0cd62e9c761006,1,1,1,0,0,0,0,4,67,0,1,1,0,838,356,14,4,4,0,1685,1685,0,3,3,0,1,100
6d0a7b3f0fff3ffa45d89fede030eae5d2446535,1,4,1,3,0,0,0,3,8,188,1,1,0,194,308,12,15,15,0,1098,1077,21,10,10,0,1,100
d59b2318dd66ee1784dabca28820e9b8e65f8bf1,14,532,36,496,6,0,6,1,126,29,2,7,3.084552419,5346,309,13,650,601,49,27874,25630,2244,222,202,20,1,99.68694097
f9588210a27bf1d142c8f1da8cd3d22b47d97e3b,12,734,135,599,0,0,0,2,168,63,4,6,2.407400407,16710,6,6,1535,1477,58,105980,101669,4311,605,575,30,1,99.82142857
3a5f6e3bbbea0451004175cbf05fd5fe5dfe7142,0,0,0,0,0,0,0,0,0,0,0,0,0,0,310,14,0,0,0,0,0,0,0,0,0,1,100
9c166076ec7e8ff16deeba22c6c1b2015c2d73e2,1,2,1,1,0,0,0,4,69,0,1,1,0,848,311,15,4,4,0,1712,1703,9,3,3,0,1,100
1ffbc1935646f7c422b551e6e0ffdc001311d074,1,1,1,0,0,0,0,5,43,1,1,1,0,1612,7,7,98,98,0,11824,11824,0,52,52,0,1,100
4e69bed5c7dbc68d17f3d4648838e5acfc52c3eb,13,266,232,34,0,0,0,3,169,104,4,7,2.006994091,13703,357,13,1235,1235,0,88204,88044,160,482,481,1,1,100
06e9f88eb207f00ae2f31f46477001726754115c,6,71,42,29,0,0,0,7,170,32,2,4,1.783863801,11454,311,4,959,957,2,72022,71733,289,364,364,0,1,100
74c7f874d558f933fbf9697c537d204eb56806c9,9,246,59,187,1,0,1,3,75,115,4,8,2.590618223,3990,312,5,453,439,14,23286,21953,1333,175,167,8,1,98.89064976
a6c8006c37334099a8a77befa3b687113514a35c,3,126,46,80,0,0,0,1,70,238,2,3,1.029773292,1167,312,16,50,40,10,3739,3303,436,14,12,2,1,100
ede0e645a9f4fdda44842a46b7fcf9edecdf50b2,19,532,53,479,1,0,1,3,171,122,3,14,3.114571452,12469,313,17,1541,1501,40,79585,75998,3587,514,490,24,1,99.95414947
c570a0e12921fff5787877ceb5612b08115d77a4,3,13,2,11,0,0,0,3,10,0,2,3,1.399581231,1949,314,15,140,140,0,15911,15792,119,48,48,0,1,100
7f8fc7530b39106e238c67b7bd22d5ed5670d449,2,11,12,1,0,0,0,5,172,1,1,2,0.755375413,5652,8,6,677,678,1,34676,34690,14,191,191,0,1,100
4ec29425d63decfd8de4e1528f043271cf7cb3b2,7,361,51,310,0,0,0,2,173,188,3,6,1.920255671,12569,9,7,1257,1231,26,77338,75326,2012,457,447,10,1,99.81676592
4d94652c817d83204ae06d618ade07f15fbed8d7,2,151,0,151,2,0,2,1,1,0,1,2,0.999715251,0,46,4,10,0,10,636,0,636,10,0,10,1,99.88566202
8f8a81f7a17f9018ae4e87bf0fca9d6cdc0a5ba4,1,20,33,13,0,0,0,7,96,0,1,1,0,5383,10,8,246,248,2,35480,35494,14,152,152,0,1,100
81322efc2b8b843008cb3bebe8e5db78af20eb58,2,29,29,0,0,0,0,1,2,0,1,2,0.957553484,151,47,5,10,10,0,636,636,0,10,10,0,1,100
b66ff72cc02d333d36c312562b7f06ac174e9830,1,1,4,3,0,0,0,1,3,0,1,1,0,77,48,6,7,7,0,208,225,17,7,7,0,1,100
b768c0f19be158ce05c62bcc9455b75c92ac8831,1,12,3,9,0,0,0,1,2,25,1,1,0,330,358,12,16,16,0,2638,2518,120,8,8,0,1,100
8433c611932e0e82d6826491d4f1b915cadafc60,0,0,0,0,0,0,0,0,0,0,0,0,0,0,359,11,0,0,0,0,0,0,0,0,0,1,100
57827160a8772858f667aacba65c6589234c641b,8,317,30,287,1,0,1,1,6,294,1,4,1.625691013,2627,360,12,273,258,15,13569,11721,1848,113,103,10,1,98.87463426
db4112cc0019b36c587503ad5673b4a7265cc91a,4,32,3,29,0,0,0,3,48,41,3,4,1.180384941,1907,315,11,235,231,4,12741,12606,135,44,43,1,1,100
dfef97f6cf703d9c1c02f237ce17951f6bcc4a88,2,2,5,3,0,0,0,2,5,12,1,2,0.863120569,1508,361,11,180,180,0,7927,7955,28,45,45,0,1,100
cd0ed751ae502492733738f2d7d7d0ae8e4224e9,19,1003,227,776,2,0,2,2,174,58,5,11,3.391626316,16025,313,3,1301,1249,52,103745,99017,4728,529,502,27,2,83.96253193
93687aeec59263d949e8a66d6d78f812b93f3bdf,1,6,6,0,0,0,0,2,3,6,1,1,0,113,49,6,21,21,0,474,474,0,10,10,0,1,100
f4d50f817ee913cac6055b1f244b948f9fcb4903,0,0,0,0,0,0,0,0,0,0,0,0,0,0,14,0,0,0,0,0,0,0,0,0,0,1,100
7b55e380895203406c01896b2c577fa12e621390,2,291,0,291,2,0,2,1,1,0,1,1,0.948887826,0,50,7,30,0,30,1522,0,1522,18,0,18,1,99.80338183
71ca74e0e8e9e59dd1490961cc15482487cdbec8,2,44,11,33,0,0,0,1,4,22,1,2,0.598347422,381,316,9,51,46,5,2152,1990,162,12,11,1,1,100
31c1de6daa7b6eff1a32a8d10999680084085fc1,6,0,178,178,0,0,0,6,76,308,1,3,1.510003732,3375,11,5,297,312,15,14817,15492,675,131,135,4,1,100
7c6085d24a2e8fa7a58b2fa32c47d283ca2b046f,1,1,1,0,0,0,0,4,10,237,1,1,0,196,51,7,15,15,0,995,995,0,10,10,0,1,100
873b247bbdc930572d08b29aef84d8cb65d4c16d,2,17,17,0,0,0,0,2,98,13,2,2,0.322756959,6339,12,6,375,372,3,41253,41240,13,216,216,0,1,100
b810c7db18dbe7d43d1df517a556af5e56c507fd,1,1,1,0,0,0,0,3,7,217,1,1,0,198,52,8,10,10,0,1304,1304,0,10,10,0,1,100
5df90046c494352b55dbffe2fbd6810516d486e7,3,215,69,146,0,0,0,3,71,161,2,3,1.149870772,4596,314,3,432,415,17,25229,24464,765,110,109,1,1,100
8492f10757f9134016f8149f2cc54061d8ddbb0a,0,0,0,0,0,0,0,0,0,0,0,0,0,0,315,4,0,0,0,0,0,0,0,0,0,1,100
5761dfaf2e9e7e495462a734ebeef3bd49e9b7c6,1,5,7,2,0,0,0,1,2,107,1,1,0,105,327,2,10,10,0,477,484,7,7,7,0,1,100
52318e26fd7cffbaa4ab048cc31e83b2bb1caa4f,0,0,0,0,0,0,0,0,0,0,0,0,0,0,327,2,0,0,0,0,0,0,0,0,0,1,100
20c04e5534cddc20702fd025c407a2ccadc39fe9,1,9,3,6,0,0,0,1,3,93,1,1,0,945,372,0,83,83,0,5013,4966,47,27,27,0,1,100
199ab0198d86344560675d2f46970de0f4053123,0,0,0,0,0,0,0,0,0,0,0,0,0,0,372,0,0,0,0,0,0,0,0,0,0,1,100
043c2c1511f1134add20e98e69a0fab49702667f,0,0,0,0,0,0,0,0,0,0,0,0,0,0,333,1,0,0,0,0,0,0,0,0,0,0,100
1fb43bd29e20b1718e6652c5175ffe9b2d05fac1,1,1,1,0,0,0,0,4,15,168,1,1,0,294,61,0,21,21,0,1668,1663,5,9,9,0,1,100
2cb65281e8cd7d20b187091551a9e14b711d1a26,4,65,23,42,0,0,0,4,18,143,1,3,1.584562649,2626,373,1,296,294,2,14850,14559,291,121,119,2,1,100
7a1b11e52447977f74c174700904e37b7a3338f9,0,0,0,0,0,0,0,0,0,0,0,0,0,0,374,2,0,0,0,0,0,0,0,0,0,0,100
8ddfd18c9e65c8a457826dac803d5f8bcfd4ff74,0,0,0,0,0,0,0,0,0,0,0,0,0,0,375,3,0,0,0,0,0,0,0,0,0,0,100
880df51b016bf94927f8213078e48a6847efaa49,2,122,27,95,1,0,1,4,13,0,1,2,0.682712697,320,376,4,25,23,2,2919,2255,664,13,11,2,1,84.86080701
410ddf1f6430d04a0fdc3e0ef82b5a02726a5a62,4,29,9,20,0,0,0,3,8,204,1,1,1.936737546,1158,377,5,95,95,0,6652,6622,30,44,44,0,1,100
7e6ac40b46cf21affc3a2f514db656bab06f50e2,0,0,0,0,0,0,0,0,0,0,0,0,0,0,378,5,0,0,0,0,0,0,0,0,0,0,100
5972c062376f15288d9dec939a8a0ff2f9bdce03,1,1,1,0,0,0,0,3,4,321,1,1,0,315,379,6,54,54,0,1606,1608,2,28,28,0,1,100
599bb0fe2ee6d80125c10eecc2554ddea8f869ef,10,605,52,553,2,0,2,2,179,153,3,8,2.75652342,12572,380,7,1074,1034,40,77154,73776,3378,371,355,16,1,87.40781207
c89b72e0e59e9d890429a4f47f399e860b3c055c,2,69,4,65,0,0,0,1,180,0,1,2,0.455831458,4480,381,8,619,614,5,26034,25574,460,151,150,1,1,100
5f0ca16fe66e4a67f7be6e561ab98994170134c6,2,70,36,34,0,0,0,5,14,312,1,2,0.905200297,755,382,0,77,69,8,4682,4490,192,31,29,2,1,100
64c01de374cdb62abfa3d060a7125794b4d4c051,1,4,1,3,0,0,0,4,13,501,1,1,0,129,328,0,12,12,0,745,719,26,7,7,0,1,100
cb427d9c300b3d2b4decdc37cf405264baf3761f,2,55,0,55,0,0,0,3,7,363,1,2,0.13110653,397,16,0,26,24,2,2606,2360,246,14,12,2,1,100
4bbd257db9a8085df7f4688ffea3eb40cbd2c174,2,223,3,220,0,0,0,4,14,199,1,2,0.446143182,1222,329,1,94,89,5,13025,10592,2433,35,30,5,1,100
6607e9448bae7dc24a777485dedb2e5cf787ee83,9,72,10,62,0,0,0,4,128,165,3,8,2.720190839,5091,330,2,547,542,5,35926,35506,420,201,197,4,1,100
c033965e7ae582c91884c86e0bc5edadb75c68ea,1,106,75,31,0,0,0,3,8,215,1,1,0,708,20,0,77,72,5,4190,4058,132,40,36,4,1,88.35827988
119003effd4acfcba6f26397fddc8f4d8b0f4671,1,12,6,6,0,0,0,3,9,0,1,1,0,739,21,1,77,77,0,4214,4190,24,40,40,0,1,100
aea2edc7c1c7835a87cef0e614cd23a93fe04976,3,140,16,124,0,0,0,2,181,225,2,3,1.038712749,4723,332,0,651,642,9,28572,27447,1125,161,157,4,1,100
50b24c24961867ec14d92fb6531d03b471a2e4dc,2,78,6,72,0,0,0,7,182,72,1,2,0.591672779,9752,333,1,864,863,1,60947,60377,570,306,305,1,1,100
363249d6455d34605c361480685d41165b9118b1,6,111,242,131,0,1,1,2,183,274,2,5,2.267510508,10538,334,2,902,918,16,65179,65707,528,321,326,5,1,89.99748681
c0b4b8a8225663e82a540f86c872a1623f11ebd0,5,100,7,93,0,0,0,5,184,357,1,3,1.758028773,7809,22,0,941,934,7,46475,45858,617,272,270,2,1,100
fe2163e0dc9544d0d5b053a7ec5bd5d417454e86,2,45,2,43,0,0,0,3,13,417,1,2,0.658191266,250,335,3,22,20,2,2019,1625,394,16,15,1,1,100
a4411195024103b51e3366c5d67f61e23974e8f1,3,50,1,49,0,0,0,3,23,373,2,3,1.211152683,1142,331,0,98,94,4,8347,7964,383,44,43,1,1,100
d7c94da20c8737407a93a6eda8eea8e14d49ae30,3,141,3,138,0,0,0,4,49,282,1,3,1.039932665,2422,23,1,223,202,21,16894,16057,837,73,69,4,1,100
8f756802ee5cae449cf855884bf34ba50861c87d,1,3,0,3,0,0,0,3,12,311,1,1,0,321,332,1,46,46,0,1859,1840,19,14,14,0,1,100
7c24cdf5184f5b8185a6f4df24577fbddab91582,1,9,9,0,0,0,0,3,10,63,1,1,0,745,24,2,77,77,0,4231,4214,17,40,40,0,1,100
45167a4cf67c5550f983172acb62c8e48ab1e090,2,65,2,63,0,0,0,2,76,337,1,2,0.111909909,1819,25,3,154,146,8,9310,8881,429,92,88,4,1,100
0b76d70cf532d0b6c1ff11c6b0e6a527e8a5da7b,1,41,2,39,0,0,0,3,24,35,1,1,0,712,333,2,68,64,4,5077,4809,268,21,20,1,1,100
1fc22c2e338279d55523ba996a513139d6cd5501,0,0,0,0,0,0,0,0,0,0,0,0,0,0,334,3,0,0,0,0,0,0,0,0,0,1,100
a559ec94e8222d4c1cb069c089318d5696c5650e,1,15,8,7,0,0,0,8,129,113,1,1,0,2024,15,0,296,296,0,11284,11263,21,103,103,0,1,100
922b055999fb47e096ac857adebeca1aaea41665,3,264,4,260,0,0,0,3,37,377,1,2,0.573207456,751,26,0,115,91,24,6388,4657,1731,63,44,19,1,99.96738421
60438e312ca3bcb861e09074869493be82a75fca,3,312,10,302,2,0,2,1,37,172,1,2,1.380599139,546,27,1,83,64,19,4706,2750,1956,33,24,9,1,91.61694511
3852f11525d2f7237c571230c4d81e59e7f09af0,2,49,14,35,0,0,0,3,9,608,1,2,0.702466551,931,335,0,76,73,3,5211,5014,197,28,27,1,1,100
4bedbc014dcb73ee8853bc0a78eb43b7804741d3,1,4,5,1,0,0,0,3,25,97,1,1,0,751,336,1,68,68,0,5042,5077,35,21,21,0,1,100
a111a21569cb2308f197fe825f9958ce531689e4,1,29,20,9,0,0,0,2,5,437,1,1,0,483,62,0,51,50,1,2504,2441,63,17,17,0,1,100
4facc6947b1fb887d365bc5b6bfb1e43a4484f66,2,164,11,153,1,0,1,1,32,267,1,2,0.721928095,469,28,2,60,45,15,2322,1349,973,42,39,3,1,89.76533786
a95c2bbacd686d713c139099dee7ea391b0b4cf3,2,41,22,19,0,0,0,2,6,375,1,1,0.341153893,1654,63,1,177,171,6,8621,8527,94,44,42,2,1,100
6123493b5278947db85218776e5c61dd21f429bf,1,23,2,21,0,0,0,2,5,2,1,1,0,968,64,2,92,89,3,5157,5101,56,29,29,0,1,100
0249a4318a022b77d26167bdb1783b763be254f3,2,95,35,60,0,0,0,3,38,412,1,2,0.975272831,3877,336,0,431,429,2,24296,23663,633,108,108,0,1,100
a510f761fc5f237056dbc87481ab7f972c93a108,3,37,3,34,0,0,0,3,37,428,1,2,0.453183732,3846,337,1,435,435,0,22130,21869,261,169,169,0,1,100
0abc8d8746ab129deea6791371282043cf5e9e9a,3,7,5,2,0,0,0,7,102,251,3,3,1.384431504,5937,337,2,321,321,0,38716,38690,26,190,190,0,1,100
1d4bff1a2c514783c2c7550bcd7aab662e4244ee,3,140,32,108,1,0,1,3,11,246,2,3,1.078194257,1199,29,1,155,145,10,7269,6637,632,55,50,5,1,99.8546934
9fad49c7a6d315c9ac8b17dcc3a9a4f20a15e468,1,0,2,2,0,0,0,3,12,0,1,1,0,481,30,2,74,74,0,2508,2534,26,12,12,0,1,100
cee2fe831223dba31d50c481eafffc56379a4c0f,7,306,24,282,0,0,0,3,39,544,1,4,2.047831819,5892,338,1,558,542,16,39316,37311,2005,197,191,6,1,100
78610f884adbe6548228657fa2eacd7fef23379a,1,3,3,0,0,0,0,3,6,610,1,1,0,401,383,0,49,49,0,2016,2013,3,20,20,0,1,100
fec1cf55c997ceb5002cccfa435668a38829eace,1,1,2,1,0,0,0,2,6,444,1,1,0,276,339,2,43,43,0,1425,1445,20,8,8,0,1,100
1d2725b7982d9dec88580eeaf6c6ae38dbd44bd6,2,36,1,35,0,0,0,4,63,524,1,2,0.974024864,2250,338,0,240,237,3,12096,11912,184,111,110,1,1,100
eaa2ba8c6ab3e060198c40a68d927744eb7921e4,1,2,1,1,0,0,0,5,25,530,1,1,0,418,340,2,45,45,0,2093,2089,4,18,18,0,1,100
8b14a12d97e3394dc4e62ca43d52cd0a1347f5a8,4,255,236,19,0,0,0,8,185,183,1,1,1.86934811,9288,31,0,1155,1155,0,49493,49421,72,353,353,0,1,100
d72aab4be532dbc1593b4a0cbe3fd8b32ebe90d1,2,197,3,194,1,0,1,1,38,65,1,2,0.40217919,560,32,1,73,66,7,4458,2822,1636,29,24,5,1,85.50488599
e3b5cd54d8cdd6f141c312328be25e1edc2a3e57,1,17,0,17,0,0,0,3,3,588,1,1,0,202,65,0,18,16,2,994,952,42,8,7,1,1,100
dbf36fb777054fdbff290356ec5488694d77d774,2,123,4,119,0,0,0,4,186,252,1,2,0.116849761,5081,341,1,620,618,2,30080,29452,628,169,167,2,1,100
816ac188a9928cc27bb627dae2c217d32b9fb2cf,2,53,5,48,0,0,0,7,187,45,1,2,0.70074955,9746,33,2,858,853,5,60922,60432,490,306,304,2,1,100
210359641ec79bf95d2193cc2976e8cd9e6ce6a1,3,90,3,87,0,0,0,1,50,368,1,2,1.563627971,1138,34,3,180,165,15,6580,6022,558,41,38,3,1,100
0bceb8e49e4896140b977f0ae5b99dc8a728308e,2,50,10,40,0,0,0,3,27,550,1,2,0.979868757,737,342,2,136,133,3,4856,4580,276,52,50,2,1,100
bac43ea84281f4a928fb7f9bd4887817f55f4e73,2,71,5,66,0,0,0,4,65,37,1,2,0.850382117,2290,343,2,244,240,4,12401,12114,287,114,111,3,1,100
f1ab8dc0c5fa8df4811f64584ee1dfab38ddc981,2,203,1,202,1,0,1,1,10,280,1,2,0.110580845,497,384,0,63,61,2,4595,3070,1525,31,29,2,1,99.92587102
0595d28aa702c5dd0ba9fe950da2be015f854ddf,2,4,29,25,0,0,0,1,51,16,1,2,0.994030211,1073,35,4,153,156,3,5842,6017,175,28,28,0,1,100
4e57a922b4a38a0b2f0e22e0f914a4a8f9698878,1,3,3,0,0,0,0,3,13,305,1,1,0,324,385,0,46,46,0,1863,1859,4,14,14,0,1,100
6f53b8e3df0fd6fbc949683686c5d82b3ae2d8b0,6,52,0,52,0,0,0,4,130,341,1,3,2.168558125,7304,36,0,712,707,5,44873,44407,466,280,278,2,1,99.298116
222b241f201f29328c4f9cf3bb34a5ea9cd9be8d,6,95,56,39,0,0,0,3,78,328,1,2,2.202547504,6050,37,1,461,467,6,35438,34971,467,264,262,2,1,100
66ee8e8f5098b2f304d8df23032dd6212eb6a1ab,1,2,2,0,0,0,0,4,52,878,1,1,0,390,16,0,38,38,0,1620,1610,10,16,16,0,1,100
6c305bfa6b78140cfb8fb60f4b96f4a6c830c841,1,3,5,2,0,0,0,9,131,23,1,1,0,2036,38,2,297,297,0,11299,11296,3,104,104,0,1,100
d58bf5dca15be38e1ec7884cea6565794331e1bb,1,83,72,11,0,0,0,9,132,23,1,1,0,2034,344,0,298,297,1,11346,11299,47,104,104,0,1,100
d100eb43e48cbbd8e53b2d2feccca6e8d2ba52f1,3,52,22,30,0,0,0,5,15,685,1,2,1.229168487,873,386,0,87,83,4,5171,5042,129,35,34,1,1,100
6045f02d7731a643ff18202c322ae26ba0f0c002,2,65,2,63,0,0,0,3,67,44,1,2,0.43497348,2363,39,1,221,216,5,13461,13051,410,94,91,3,1,100
5d0211a381d305b927c956be886b97a274187b20,3,14,4,10,0,0,0,4,15,554,2,3,0.944488534,967,345,1,68,66,2,7023,6992,31,23,22,1,2,100
abca9f0bffd645eb1bab75e226f49f85d50f0a66,6,529,42,487,2,0,2,1,3,415,1,3,1.480662923,1293,0,0,247,200,47,9712,7638,2074,73,51,22,1,99.06407487
0b91397af3d51626fc39f1644661beddaddad0ad,1,3,4,1,0,0,0,4,10,8,1,1,0,868,1,1,43,43,0,5733,5756,23,37,37,0,1,100
9264a598b3f62e900110109521d278f06c7a7b08,3,97,1,96,1,0,1,1,75,505,2,2,0.646832524,1479,40,1,72,63,9,4706,4279,427,27,24,3,1,99.85959986
6f0717e5e36f0d088d41256fe6a24af791692663,0,0,0,0,0,0,0,0,0,0,0,0,0,0,346,2,0,0,0,0,0,0,0,0,0,0,100
967c0b5a4a23e76018dc137b7c99021c8a45cccb,0,0,0,0,0,0,0,0,0,0,0,0,0,0,41,6,0,0,0,0,0,0,0,0,0,1,100
b37dc9ac17848ed13b4750781a43f95c29f27515,0,0,0,0,0,0,0,0,0,0,0,0,0,0,42,7,0,0,0,0,0,0,0,0,0,1,100
25e41bc0f29f5e25adbfc17258b00ad702a17888,0,0,0,0,0,0,0,0,0,0,0,0,0,0,43,8,0,0,0,0,0,0,0,0,0,1,100
c033965e7ae582c91884c86e0bc5edadb75c68ea,192,1178,5976,4798,1,21,22,0,180,45,9,72,6.298343979,72601,20,0,5642,6064,422,400845,430131,29286,2646,2840,194,1,86.14638652
119003effd4acfcba6f26397fddc8f4d8b0f4671,1,12,6,6,0,0,0,3,9,0,1,1,0,739,21,1,77,77,0,4214,4190,24,40,40,0,1,100
aea2edc7c1c7835a87cef0e614cd23a93fe04976,3,140,16,124,0,0,0,2,181,225,2,3,1.038712749,4723,332,0,651,642,9,28572,27447,1125,161,157,4,1,100
50b24c24961867ec14d92fb6531d03b471a2e4dc,2,78,6,72,0,0,0,7,182,72,1,2,0.591672779,9752,333,1,864,863,1,60947,60377,570,306,305,1,1,100
363249d6455d34605c361480685d41165b9118b1,6,111,242,131,0,1,1,2,183,274,2,5,2.267510508,10538,334,2,902,918,16,65179,65707,528,321,326,5,1,89.99748681
c0b4b8a8225663e82a540f86c872a1623f11ebd0,5,100,7,93,0,0,0,5,184,357,1,3,1.758028773,7809,22,0,941,934,7,46475,45858,617,272,270,2,1,100
fe2163e0dc9544d0d5b053a7ec5bd5d417454e86,2,45,2,43,0,0,0,3,13,417,1,2,0.658191266,250,335,3,22,20,2,2019,1625,394,16,15,1,1,100
a4411195024103b51e3366c5d67f61e23974e8f1,3,50,1,49,0,0,0,3,23,373,2,3,1.211152683,1142,331,0,98,94,4,8347,7964,383,44,43,1,1,100
d7c94da20c8737407a93a6eda8eea8e14d49ae30,3,141,3,138,0,0,0,4,49,282,1,3,1.039932665,2422,23,1,223,202,21,16894,16057,837,73,69,4,1,100
8f756802ee5cae449cf855884bf34ba50861c87d,1,3,0,3,0,0,0,3,12,311,1,1,0,321,332,1,46,46,0,1859,1840,19,14,14,0,1,100
7c24cdf5184f5b8185a6f4df24577fbddab91582,1,9,9,0,0,0,0,3,10,63,1,1,0,745,24,2,77,77,0,4231,4214,17,40,40,0,1,100
45167a4cf67c5550f983172acb62c8e48ab1e090,2,65,2,63,0,0,0,2,76,337,1,2,0.111909909,1819,25,3,154,146,8,9310,8881,429,92,88,4,1,100
0b76d70cf532d0b6c1ff11c6b0e6a527e8a5da7b,1,41,2,39,0,0,0,3,24,35,1,1,0,712,333,2,68,64,4,5077,4809,268,21,20,1,1,100
1fc22c2e338279d55523ba996a513139d6cd5501,0,0,0,0,0,0,0,0,0,0,0,0,0,0,334,3,0,0,0,0,0,0,0,0,0,1,100
a559ec94e8222d4c1cb069c089318d5696c5650e,1,15,8,7,0,0,0,8,129,113,1,1,0,2024,15,0,296,296,0,11284,11263,21,103,103,0,1,100
922b055999fb47e096ac857adebeca1aaea41665,3,264,4,260,0,0,0,3,37,377,1,2,0.573207456,751,26,0,115,91,24,6388,4657,1731,63,44,19,1,99.96738421
60438e312ca3bcb861e09074869493be82a75fca,3,312,10,302,2,0,2,1,37,172,1,2,1.380599139,546,27,1,83,64,19,4706,2750,1956,33,24,9,1,91.61694511
3852f11525d2f7237c571230c4d81e59e7f09af0,2,49,14,35,0,0,0,3,9,608,1,2,0.702466551,931,335,0,76,73,3,5211,5014,197,28,27,1,1,100
4bedbc014dcb73ee8853bc0a78eb43b7804741d3,1,4,5,1,0,0,0,3,25,97,1,1,0,751,336,1,68,68,0,5042,5077,35,21,21,0,1,100
a111a21569cb2308f197fe825f9958ce531689e4,1,29,20,9,0,0,0,2,5,437,1,1,0,483,62,0,51,50,1,2504,2441,63,17,17,0,1,100
4facc6947b1fb887d365bc5b6bfb1e43a4484f66,2,164,11,153,1,0,1,1,32,267,1,2,0.721928095,469,28,2,60,45,15,2322,1349,973,42,39,3,1,89.76533786
a95c2bbacd686d713c139099dee7ea391b0b4cf3,2,41,22,19,0,0,0,2,6,375,1,1,0.341153893,1654,63,1,177,171,6,8621,8527,94,44,42,2,1,100
6123493b5278947db85218776e5c61dd21f429bf,1,23,2,21,0,0,0,2,5,2,1,1,0,968,64,2,92,89,3,5157,5101,56,29,29,0,1,100
0249a4318a022b77d26167bdb1783b763be254f3,2,95,35,60,0,0,0,3,38,412,1,2,0.975272831,3877,336,0,431,429,2,24296,23663,633,108,108,0,1,100
a510f761fc5f237056dbc87481ab7f972c93a108,3,37,3,34,0,0,0,3,37,428,1,2,0.453183732,3846,337,1,435,435,0,22130,21869,261,169,169,0,1,100
0abc8d8746ab129deea6791371282043cf5e9e9a,3,7,5,2,0,0,0,7,102,251,3,3,1.384431504,5937,337,2,321,321,0,38716,38690,26,190,190,0,1,100
1d4bff1a2c514783c2c7550bcd7aab662e4244ee,3,140,32,108,1,0,1,3,11,246,2,3,1.078194257,1199,29,1,155,145,10,7269,6637,632,55,50,5,1,99.8546934
9fad49c7a6d315c9ac8b17dcc3a9a4f20a15e468,1,0,2,2,0,0,0,3,12,0,1,1,0,481,30,2,74,74,0,2508,2534,26,12,12,0,1,100
cee2fe831223dba31d50c481eafffc56379a4c0f,7,306,24,282,0,0,0,3,39,544,1,4,2.047831819,5892,338,1,558,542,16,39316,37311,2005,197,191,6,1,100
78610f884adbe6548228657fa2eacd7fef23379a,1,3,3,0,0,0,0,3,6,610,1,1,0,401,383,0,49,49,0,2016,2013,3,20,20,0,1,100
fec1cf55c997ceb5002cccfa435668a38829eace,1,1,2,1,0,0,0,2,6,444,1,1,0,276,339,2,43,43,0,1425,1445,20,8,8,0,1,100
1d2725b7982d9dec88580eeaf6c6ae38dbd44bd6,2,36,1,35,0,0,0,4,63,524,1,2,0.974024864,2250,338,0,240,237,3,12096,11912,184,111,110,1,1,100
eaa2ba8c6ab3e060198c40a68d927744eb7921e4,1,2,1,1,0,0,0,5,25,530,1,1,0,418,340,2,45,45,0,2093,2089,4,18,18,0,1,100
8b14a12d97e3394dc4e62ca43d52cd0a1347f5a8,4,255,236,19,0,0,0,8,185,183,1,1,1.86934811,9288,31,0,1155,1155,0,49493,49421,72,353,353,0,1,100
d72aab4be532dbc1593b4a0cbe3fd8b32ebe90d1,2,197,3,194,1,0,1,1,38,65,1,2,0.40217919,560,32,1,73,66,7,4458,2822,1636,29,24,5,1,85.50488599
e3b5cd54d8cdd6f141c312328be25e1edc2a3e57,1,17,0,17,0,0,0,3,3,588,1,1,0,202,65,0,18,16,2,994,952,42,8,7,1,1,100
dbf36fb777054fdbff290356ec5488694d77d774,2,123,4,119,0,0,0,4,186,252,1,2,0.116849761,5081,341,1,620,618,2,30080,29452,628,169,167,2,1,100
816ac188a9928cc27bb627dae2c217d32b9fb2cf,2,53,5,48,0,0,0,7,187,45,1,2,0.70074955,9746,33,2,858,853,5,60922,60432,490,306,304,2,1,100
210359641ec79bf95d2193cc2976e8cd9e6ce6a1,3,90,3,87,0,0,0,1,50,368,1,2,1.563627971,1138,34,3,180,165,15,6580,6022,558,41,38,3,1,100
0bceb8e49e4896140b977f0ae5b99dc8a728308e,2,50,10,40,0,0,0,3,27,550,1,2,0.979868757,737,342,2,136,133,3,4856,4580,276,52,50,2,1,100
bac43ea84281f4a928fb7f9bd4887817f55f4e73,2,71,5,66,0,0,0,4,65,37,1,2,0.850382117,2290,343,2,244,240,4,12401,12114,287,114,111,3,1,100
f1ab8dc0c5fa8df4811f64584ee1dfab38ddc981,2,203,1,202,1,0,1,1,10,280,1,2,0.110580845,497,384,0,63,61,2,4595,3070,1525,31,29,2,1,99.92587102
0595d28aa702c5dd0ba9fe950da2be015f854ddf,2,4,29,25,0,0,0,1,51,16,1,2,0.994030211,1073,35,4,153,156,3,5842,6017,175,28,28,0,1,100
4e57a922b4a38a0b2f0e22e0f914a4a8f9698878,1,3,3,0,0,0,0,3,13,305,1,1,0,324,385,0,46,46,0,1863,1859,4,14,14,0,1,100
6f53b8e3df0fd6fbc949683686c5d82b3ae2d8b0,6,52,0,52,0,0,0,4,130,341,1,3,2.168558125,7304,36,0,712,707,5,44873,44407,466,280,278,2,1,99.298116
222b241f201f29328c4f9cf3bb34a5ea9cd9be8d,6,95,56,39,0,0,0,3,78,328,1,2,2.202547504,6050,37,1,461,467,6,35438,34971,467,264,262,2,1,100
66ee8e8f5098b2f304d8df23032dd6212eb6a1ab,1,2,2,0,0,0,0,4,52,878,1,1,0,390,16,0,38,38,0,1620,1610,10,16,16,0,1,100
6c305bfa6b78140cfb8fb60f4b96f4a6c830c841,1,3,5,2,0,0,0,9,131,23,1,1,0,2036,38,2,297,297,0,11299,11296,3,104,104,0,1,100
d58bf5dca15be38e1ec7884cea6565794331e1bb,1,83,72,11,0,0,0,9,132,23,1,1,0,2034,344,0,298,297,1,11346,11299,47,104,104,0,1,100
d100eb43e48cbbd8e53b2d2feccca6e8d2ba52f1,3,52,22,30,0,0,0,5,15,685,1,2,1.229168487,874,386,0,87,83,4,5171,5042,129,35,34,1,1,100
6045f02d7731a643ff18202c322ae26ba0f0c002,2,65,2,63,0,0,0,3,67,44,1,2,0.43497348,2363,39,1,221,216,5,13461,13051,410,94,91,3,1,100
5d0211a381d305b927c956be886b97a274187b20,3,14,4,10,0,0,0,4,15,554,2,3,0.944488534,967,345,1,68,66,2,7023,6992,31,23,22,1,2,100
abca9f0bffd645eb1bab75e226f49f85d50f0a66,6,529,42,487,2,0,2,1,3,415,1,3,1.480662923,1293,0,0,247,200,47,9712,7638,2074,73,51,22,1,99.06407487
0b91397af3d51626fc39f1644661beddaddad0ad,1,3,4,1,0,0,0,4,10,8,1,1,0,868,1,1,43,43,0,5733,5756,23,37,37,0,1,100
9264a598b3f62e900110109521d278f06c7a7b08,3,97,1,96,1,0,1,1,75,505,2,2,0.646832524,1479,40,1,72,63,9,4706,4279,427,27,24,3,1,99.85959986
6f0717e5e36f0d088d41256fe6a24af791692663,0,0,0,0,0,0,0,0,0,0,0,0,0,0,346,2,0,0,0,0,0,0,0,0,0,0,100
83e5307dbf5c7417e5b9f8da24c56c6b060ac48f,0,0,0,0,0,0,0,0,0,0,0,0,0,0,40,5,0,0,0,0,0,0,0,0,0,1,100
9361cc03035f838e90b46e886bbcb00f1bab85fd,0,0,0,0,0,0,0,0,0,0,0,0,0,0,41,6,0,0,0,0,0,0,0,0,0,1,100
967c0b5a4a23e76018dc137b7c99021c8a45cccb,0,0,0,0,0,0,0,0,0,0,0,0,0,0,41,6,0,0,0,0,0,0,0,0,0,1,100
b37dc9ac17848ed13b4750781a43f95c29f27515,0,0,0,0,0,0,0,0,0,0,0,0,0,0,42,7,0,0,0,0,0,0,0,0,0,1,100
7d69a6ea976804b5b4e476483be02a74ee16dd94,0,0,0,0,0,0,0,0,0,0,0,0,0,0,42,7,0,0,0,0,0,0,0,0,0,1,100
25e41bc0f29f5e25adbfc17258b00ad702a17888,0,0,0,0,0,0,0,0,0,0,0,0,0,0,43,8,0,0,0,0,0,0,0,0,0,1,100
acb87114976e7fff8bc4b1f6a09c476d08ec067b,0,0,0,0,0,0,0,0,0,0,0,0,0,0,43,8,0,0,0,0,0,0,0,0,0,0,100
b14e639a650f6c57e8ad3bc99d6c9dee9626b0cf,0,0,0,0,0,0,0,0,0,0,0,0,0,0,44,9,0,0,0,0,0,0,0,0,0,1,100
c206223647de57abc1cf3a69c5b0e38a6a634b19,0,0,0,0,0,0,0,0,0,0,0,0,0,0,28,0,0,0,0,0,0,0,0,0,0,2,100
1d561799d325ed99f7dee15f38485f236ad4569b,0,0,0,0,0,0,0,0,0,0,0,0,0,0,67,0,0,0,0,0,0,0,0,0,0,1,100
20689e8afc52d5b15d66e05215afff36a745d208,0,0,0,0,0,0,0,0,0,0,0,0,0,0,68,1,0,0,0,0,0,0,0,0,0,1,100
ef77ff06afb1e8b1feb480129caaa4b0af311163,2,52,15,37,0,0,0,3,7,232,2,2,0.193642805,379,376,2,32,30,2,2470,2268,202,22,20,2,1,100
41994a102d30713f5dc12b14c7b3424c06dc6279,0,0,0,0,0,0,0,0,0,0,0,0,0,0,377,3,0,0,0,0,0,0,0,0,0,1,100
a54a3826f1fa335deb0e30fb87f60e8861215720,0,0,0,0,0,0,0,0,0,0,0,0,0,0,45,5,0,0,0,0,0,0,0,0,0,1,100
239aa1dae0d700649d2da30037dd556a7a136f52,0,0,0,0,0,0,0,0,0,0,0,0,0,0,378,3,0,0,0,0,0,0,0,0,0,1,100
df78a51861092d10dd064fb7c35596f0f1bc619f,0,0,0,0,0,0,0,0,0,0,0,0,0,0,379,4,0,0,0,0,0,0,0,0,0,1,100
d1f331e30c87f3b4b6e6c827d8a8965f4f3ee35d,0,0,0,0,0,0,0,0,0,0,0,0,0,0,46,6,0,0,0,0,0,0,0,0,0,1,100
68c518bd7638f34897bd01cc66bdb2c4cfe57ffc,0,0,0,0,0,0,0,0,0,0,0,0,0,0,380,5,0,0,0,0,0,0,0,0,0,1,100
8e5d18e63e6c98aa4e89f568d159b3c1903b1dae,5,46,8,38,0,0,0,3,32,203,1,4,1.49805065,3063,325,0,199,197,2,18884,18494,390,141,140,1,1,90.88683864
8cdd988b2549f0aec243a40d3bf7b78b2c9fb4e1,3,140,16,124,0,0,0,2,182,225,2,3,1.038712749,4789,326,1,661,652,9,28867,27742,1125,164,160,4,1,100
fbd240f4e08cd47f842a2dd98106835ff5f1954d,2,78,6,72,0,0,0,7,183,76,1,2,0.591672779,9926,327,2,875,874,1,62408,61838,570,310,309,1,1,100
83b5c70145e77bd5b3b5450477b3796d627369cb,6,111,242,131,0,1,1,2,184,253,2,5,2.267510508,10712,328,3,913,929,16,66640,67168,528,325,330,5,1,99.97076023
87a99d022b20d4cc4243c67e89e3b2f508bf673a,1,2,2,0,0,0,0,2,2,167,1,1,0,234,47,2,32,32,0,1283,1281,2,11,11,0,1,100
e0d3599ce1499e85aebdf0163a2940964c830a4a,10,831,12,819,3,0,3,1,131,156,2,5,2.324555766,5560,381,5,567,482,85,34990,30245,4745,255,217,38,1,99.85420615
4ca0bd584c3dd5f2628bf9d1c726f0b1848b6e36,0,0,0,0,0,0,0,0,0,0,0,0,0,0,48,3,0,0,0,0,0,0,0,0,0,1,100
a7be039811193d8219f763f22d1b8dc17d246d64,5,100,7,93,0,0,0,5,185,318,1,3,1.758028773,7892,29,0,953,946,7,46888,46271,617,277,275,2,1,100
5ac89e34edc6aa84726974365c16ac5a73df8670,2,45,2,43,0,0,0,3,13,417,1,2,0.658191266,250,329,4,22,20,2,2019,1625,394,16,15,1,1,94.23711161
646bf9eb0ed45207575266a28b90518de87924c5,0,0,0,0,0,0,0,0,0,0,0,0,0,0,382,6,0,0,0,0,0,0,0,0,0,1,100
3e62ca65e99b1abde8f473f0f6d9140dd0abe9c9,0,0,0,0,0,0,0,0,0,0,0,0,0,0,383,7,0,0,0,0,0,0,0,0,0,1,100
1b3620ecc19c4962d114c3e67327637ee4cb5002,3,50,1,49,0,0,0,3,23,373,2,3,1.211152683,1142,384,8,98,94,4,8347,7964,383,44,43,1,1,100
e69d56b76b85bbf11f4622c41eb1387dd9be66b4,0,0,0,0,0,0,0,0,0,0,0,0,0,0,385,9,0,0,0,0,0,0,0,0,0,1,100
cc93065027dde291657771171f78dbeddf59e215,3,141,3,138,0,0,0,4,52,153,1,3,1.039932665,2492,30,1,233,212,21,17358,16521,837,76,72,4,1,100
9bf99b9a99b713afaccebb538e09ca3e6937fdac,11,151,499,348,0,0,0,3,24,242,2,3,2.985635857,3294,380,0,240,283,43,17314,19481,2167,101,121,20,1,94.93195683
2b4ef1d92b621930f2295015ee7d793cf077a557,1,3,0,3,0,0,0,3,12,311,1,1,0,321,386,10,46,46,0,1859,1840,19,14,14,0,1,100
5c9a37565fff723ae3de9da5cb77a466eb6f390b,0,0,0,0,0,0,0,0,0,0,0,0,0,0,387,11,0,0,0,0,0,0,0,0,0,1,100
f661803cccca222a1bdbba981749d9eb8c3d5a41,0,0,0,0,0,0,0,0,0,0,0,0,0,0,388,12,0,0,0,0,0,0,0,0,0,1,100
e8610693f73454d0fc2deecb16f9026cc86cb43d,0,0,0,0,0,0,0,0,0,0,0,0,0,0,389,13,0,0,0,0,0,0,0,0,0,1,100
3eb60124b1269d0b32f783e07a2ed43e97b275e3,0,0,0,0,0,0,0,0,0,0,0,0,0,0,390,14,0,0,0,0,0,0,0,0,0,1,100
728bcd1c4ed3770b9b8c83084b313a5dd73c8975,1,3,0,3,0,0,0,3,13,5,1,1,0,324,391,15,46,46,0,1872,1859,13,14,14,0,1,100
c1352335c2df1f9f97697b776b36c354a7f2a6db,2,15,1,14,0,0,0,2,60,16,1,2,0.896038233,884,392,16,106,106,0,5637,5574,63,42,42,0,1,100
5739a0fa7f1d7ae1dee423a5f00227828d1019c4,0,0,0,0,0,0,0,0,0,0,0,0,0,0,393,17,0,0,0,0,0,0,0,0,0,1,100
94d00d4839bbbb43c034ffb0197742d6cc189454,0,0,0,0,0,0,0,0,0,0,0,0,0,0,394,18,0,0,0,0,0,0,0,0,0,1,100
9870212f7076d65d0421369a7bb16b7dc0709ac7,0,0,0,0,0,0,0,0,0,0,0,0,0,0,395,19,0,0,0,0,0,0,0,0,0,1,100
2f899a87fdea8141e10758ff0d40d732711dd4d7,1,1,2,1,0,0,0,4,5,546,1,1,0,173,49,4,22,22,0,922,929,7,6,6,0,1,99.82028241
0019ddc02015962c51bbe9eeaee1a62641397307,1,9,9,0,0,0,0,3,9,164,1,1,0,739,31,2,77,77,0,4207,4190,17,40,40,0,1,100
3f81c87152d4bca08605fc71d559931d025f7f3c,1,1,0,1,0,0,0,4,6,0,1,1,0,172,50,5,22,22,0,933,922,11,6,6,0,1,99.82028241
78cd5222f7e5a9e865f5736a7d6153c7a9fc5523,0,0,0,0,0,0,0,0,0,0,0,0,0,0,396,18,0,0,0,0,0,0,0,0,0,1,100
dc2c8dca9effba8a1cf58760c08435f4f6f30535,2,65,2,63,0,0,0,3,82,163,1,2,0.111909909,1808,32,3,164,156,8,9426,8997,429,94,90,4,1,100
d6126aacaff4361a1e2229222e0285b0f23b8e40,3,22,1,21,0,0,0,4,67,124,1,2,1.121177461,2565,33,4,232,227,5,15092,14885,207,102,101,1,1,91.10563766
d26b8b2f2ffe99baa87ae49146989a959e7791f7,0,0,0,0,0,0,0,0,0,0,0,0,0,0,69,0,0,0,0,0,0,0,0,0,0,1,100
7bcc3482a77d89a1d2b000f2993497e431be15ec,2,8,1,7,0,0,0,2,61,4,1,2,0.764204507,898,397,16,106,106,0,5673,5637,36,42,42,0,1,100
84e1b8e847fc1ff9d2a897db2265319d94568214,0,0,0,0,0,0,0,0,0,0,0,0,0,0,398,17,0,0,0,0,0,0,0,0,0,1,100
6bcfda8def168b68fbd5f8ce95608dc34ff3976e,0,0,0,0,0,0,0,0,0,0,0,0,0,0,399,18,0,0,0,0,0,0,0,0,0,1,100
0cf5eb2929f70f4f5370f05cd08a2b422f7292b9,0,0,0,0,0,0,0,0,0,0,0,0,0,0,34,5,0,0,0,0,0,0,0,0,0,1,100
19723e5f093748294e47dd4716b0b19ae93ae731,0,0,0,0,0,0,0,0,0,0,0,0,0,0,400,19,0,0,0,0,0,0,0,0,0,1,100
79f3b36849995977f81355e492bf3dd778656292,2,8,0,8,0,0,0,1,4,96,1,2,1,1473,401,20,97,97,0,13488,13366,122,36,36,0,1,100
7de84bb4f5c7b60539307182f9611a5486c9dbad,0,0,0,0,0,0,0,0,0,0,0,0,0,0,402,21,0,0,0,0,0,0,0,0,0,1,100
32632b460087904d384c46a25762b755312a156d,0,0,0,0,0,0,0,0,0,0,0,0,0,0,403,22,0,0,0,0,0,0,0,0,0,1,100
fa23b096ac4a0577578da1da7aa82f33e617c0f8,1,41,2,39,0,0,0,3,25,26,1,1,0,717,404,23,68,64,4,5133,4865,268,21,20,1,1,99.970726
169639a343dc49ee8ea686fc2ccfd3c0aa5a31f3,0,0,0,0,0,0,0,0,0,0,0,0,0,0,405,24,0,0,0,0,0,0,0,0,0,1,100
e5e2e3d8189f7bde01c517dc9fc1495596e25614,0,0,0,0,0,0,0,0,0,0,0,0,0,0,406,25,0,0,0,0,0,0,0,0,0,1,100
93313451294366a7b1d9b98188be943b3fa5d1c5,3,56,9,47,0,0,0,1,6,110,2,3,1.062850199,759,407,19,116,113,3,4954,4651,303,37,33,4,1,100
295aadaf5f6ebf3d45b6bdc9ef3e9ad6aaeac63a,0,0,0,0,0,0,0,0,0,0,0,0,0,0,408,18,0,0,0,0,0,0,0,0,0,1,100
280d005298298e4cda7e52eac9f61830eb27906c,0,0,0,0,0,0,0,0,0,0,0,0,0,0,409,13,0,0,0,0,0,0,0,0,0,1,100
ff469b491dec5a1011e79d8d4f5104ee0e9044f5,0,0,0,0,0,0,0,0,0,0,0,0,0,0,410,14,0,0,0,0,0,0,0,0,0,1,100
163d8049d9b9107257b1aed707ffe195a41e6dbd,1,15,8,7,0,0,0,8,132,62,1,1,0,2077,51,0,302,302,0,11592,11571,21,106,106,0,1,100
546f87697f4b98ec119f93fa154632dbe608d10a,0,0,0,0,0,0,0,0,0,0,0,0,0,0,52,1,0,0,0,0,0,0,0,0,0,1,100
3dfd555190bcfc276b43964aa4cc09a13092ed86,1,1,1,0,0,0,0,1,3,10,1,1,0,358,411,12,48,48,0,1897,1897,0,19,19,0,1,100
6e540e918a01ee332500a207eb8614e870ed18dc,0,0,0,0,0,0,0,0,0,0,0,0,0,0,412,13,0,0,0,0,0,0,0,0,0,1,100
7a92c581f21d82f1bcb4cb5d7697b1db8fea0ea8,0,0,0,0,0,0,0,0,0,0,0,0,0,0,413,13,0,0,0,0,0,0,0,0,0,1,100
ec50a152a4a9bd980a21b6fd416afb3854cdde8c,1,2,1,1,0,0,0,4,5,271,1,1,0,366,35,0,51,51,0,1812,1796,16,34,34,0,1,100
b68e698fa4eb2bb377c0a61d1102b0abbec2f3d4,0,0,0,0,0,0,0,0,0,0,0,0,0,0,414,7,0,0,0,0,0,0,0,0,0,1,100
200b42b7da3cffdeb0ef2d426981a8a34e0b1007,2,38,4,34,0,0,0,4,53,88,1,2,0.985228136,2061,415,6,204,200,4,13495,13301,194,61,60,1,1,100
3629dbe86583b3e2738652949b9050b83c42606e,6,0,0,0,0,0,0,1,17,207,1,3,0,2446,416,7,197,197,0,19151,19151,0,63,63,0,1,99.32787843
559099ea6144e933f7a386a356e351d680dd8408,1,1,69,68,0,0,0,1,5,0,1,1,0,242,417,8,12,16,4,1148,1587,439,4,6,2,1,100
b649dda68e5e5982276c59bf8df405018d5f6853,2,34,51,17,0,0,0,4,18,4,1,2,0.955511123,1481,418,7,97,97,0,13346,13488,142,36,36,0,1,100
0dde9325e5e5e9361690b865ee05794bc835d3cb,4,26,20,6,0,0,0,3,62,76,1,3,1.407351448,1424,53,0,174,174,0,8460,8405,55,71,72,1,1,100
7c1727a2b3c04b9c5bf0591e9afd9ac775026591,3,264,4,260,0,0,0,3,36,380,1,2,0.573207456,751,36,0,115,91,24,6388,4657,1731,63,44,19,1,91.82836841
97472e2a53526869a23e161585869cbc55e06f83,3,312,10,302,2,0,2,1,38,124,1,2,1.380599139,552,37,1,84,65,19,4754,2798,1956,33,24,9,1,90.01290323
4e2aa2acca5972af07a671a43755c8fe599bb0fc,2,49,14,35,0,0,0,4,9,431,1,2,0.702466551,931,419,5,76,73,3,5226,5029,197,28,27,1,1,100
7733923fef39689eb197b2af86681cd716f60ef4,2,8,0,8,0,0,0,6,67,287,1,1,0.954434003,1793,54,1,224,221,3,9269,9199,70,59,59,0,1,100
e36ff2d2090a68066c16e287bd969fb00288d0ba,1,29,20,9,0,0,0,2,6,292,1,1,0,493,70,0,51,50,1,2572,2509,63,17,17,0,1,100
904e2f94a2c8b81c3f6a7939d2aae2ded38f6665,2,164,11,153,1,0,1,1,33,177,1,2,0.721928095,469,38,2,60,45,15,2328,1355,973,42,39,3,1,93.79469435
dfb78f2eb31f6a3bb7620be2db6f21a2e636f764,2,41,22,19,0,0,0,2,6,376,1,1,0.341153893,1654,71,1,177,171,6,8621,8527,94,44,42,2,1,100
582e438e3abb92fc6403d7571afa78c56c8d5131,1,5,4,1,0,0,0,3,3,35,1,1,0,155,0,0,19,19,0,826,831,5,10,10,0,2,100
66ca9655a4412e1c1db1d37e882a407706dbe3ad,1,23,2,21,0,0,0,2,5,2,1,1,0,968,72,2,92,89,3,5157,5101,56,29,29,0,1,100
65f476ce083ed042532f10b0c38a3074f3be370a,2,95,35,60,0,0,0,4,41,346,1,2,0.975272831,3884,330,0,432,430,2,24335,23702,633,109,109,0,1,100
935b6888307419edfaa4ffa0cb77e888d581c7a6,4,111,7,104,0,0,0,1,10,136,1,4,1.875542648,1028,420,1,132,119,13,6637,6018,619,33,31,2,1,100
05bfdbec51e2d488db2e55e1b1eedd890a99e11c,3,37,3,34,0,0,0,3,40,98,1,2,0.453183732,3856,331,1,436,436,0,22239,21978,261,170,170,0,1,100
ff7883e062928e550568af151e5bd14a9de2cb92,2,64,31,33,0,0,0,5,31,428,1,2,0.861124706,1843,332,2,124,120,4,12901,12802,99,40,39,1,1,100
36a233fbb1baf529878728da930b87e5665e22c5,0,0,0,0,0,0,0,0,0,0,0,0,0,0,1,1,0,0,0,0,0,0,0,0,0,1,100
974588e180ab53ea3e7243f2dea29a5d8ef2416d,3,7,5,2,0,0,0,7,105,262,3,3,1.384431504,6045,421,2,322,322,0,39882,39856,26,191,191,0,1,100
627d508305ed2bbeff9e9c5a4ec1e083a66a554c,3,140,32,108,1,0,1,3,11,246,2,3,1.078194257,1193,39,1,155,145,10,7245,6613,632,55,50,5,1,99.9168572
366583aade76901f93e15e33111ad7586326ce1e,1,0,2,2,0,0,0,3,12,0,1,1,0,481,40,2,74,74,0,2508,2534,26,12,12,0,1,100
3965c7acca7952d0a13ca3172613fdb276887296,7,306,24,282,0,0,0,3,42,544,1,4,2.047831819,5909,422,2,560,544,16,39464,37459,2005,199,193,6,1,100
282e63af187f59700191579d2328cae3b8d2fa9c,1,3,3,0,0,0,0,3,6,610,1,1,0,401,381,0,49,49,0,2016,2013,3,20,20,0,1,100
3b59666fb2b2b9f988c8d39c2bd9127c14519d5b,5,544,421,123,0,0,0,4,18,280,2,4,1.079025477,2510,41,2,325,323,2,15676,14197,1479,84,83,1,1,99.89602828
b0c29d0e0b573730f1544f1eec481564e8233ce2,1,1,2,1,0,0,0,2,11,44,1,1,0,347,423,2,60,60,0,1849,1869,20,8,8,0,1,100
56365c80ef928f61204e21d1ae2bd52d301b985e,1,1,0,1,0,0,0,3,17,482,1,1,0,221,424,2,3,3,0,410,408,2,3,3,0,1,100
72d1e4f98545269b8bff7ebecd5831c099b9da72,0,0,0,0,0,0,0,0,0,0,0,0,0,0,425,3,0,0,0,0,0,0,0,0,0,1,100
51903629d8b36c494091a99822a73c443073bb82,0,0,0,0,0,0,0,0,0,0,0,0,0,0,55,0,0,0,0,0,0,0,0,0,0,1,100
3288225a8ef0807000a98dd087203852efbd4699,2,37,2,35,0,0,0,5,68,265,1,2,0.988110837,2178,333,0,227,224,3,11986,11802,184,108,107,1,1,100
e4e51858b2ddb47057e7478beb1010ebcec0109f,1,2,1,1,0,0,0,5,25,530,1,1,0,418,426,4,45,45,0,2093,2089,4,18,18,0,1,100
26a8dcbd637b47aa372a531e329ad4aac4b27048,1,13,1,12,0,0,0,4,14,212,1,1,0,327,2,0,48,46,2,1908,1872,36,14,14,0,1,100
df42a68bbe441b87b8b3b91795f56cfd7f58d27e,0,0,0,0,0,0,0,0,0,0,0,0,0,0,427,3,0,0,0,0,0,0,0,0,0,1,100
2dc2231cce4e80e39242d631985695fa8cd6883a,13,374,43,331,1,0,1,4,133,270,3,12,2.694539388,8385,428,4,887,852,35,57861,55701,2160,336,315,21,1,99.95841996
86c0e5c09d8ae3438cf87c90b044ff785beea480,4,259,240,19,0,0,0,8,186,123,1,1,1.875035258,9267,42,0,1161,1161,0,49662,49590,72,356,356,0,1,100
a6bfc1ad3f03d09d7f9808ad1cb40b91c4cb4b80,12,508,29,479,1,0,1,2,134,140,3,7,2.134678721,7152,429,4,872,839,33,38504,35228,3276,273,259,14,1,99.95847176
da85ca8cffb01e147532cdb1bf2ec64c7e1a795e,2,197,3,194,1,0,1,1,39,65,1,2,0.40217919,566,43,1,74,67,7,4506,2870,1636,29,24,5,1,89.6611002
a03e1c951782372857a2431c41bef570b3ac8e10,2,24,12,12,0,0,0,4,79,2,1,1,0.309543429,1947,430,4,155,151,4,7214,7106,108,31,30,1,2,100
0c690e39245fd79da51445edd1f292ace9fa6b99,2,9,2,7,0,0,0,2,36,259,1,2,0.994030211,1293,431,5,208,206,2,6078,6021,57,53,53,0,1,100
c5f57ccf67dc7fa499e5095a0bed1f4759d3aa33,2,123,3,120,0,0,0,4,187,193,1,2,0.117594666,5232,432,6,632,630,2,31029,30399,630,174,172,2,1,100
8fbd0ba842293713da27ca8fa39e2376398f9645,1,17,14,3,0,0,0,4,10,588,1,1,0,792,73,0,85,83,2,4584,4577,7,29,29,0,1,100
7fe2dc59253f2f362db899c51f29a1a3f9568173,1,17,0,17,0,0,0,3,3,588,1,1,0,202,74,1,18,16,2,994,952,42,8,7,1,1,100
1d83ece47a2c83bf16579923613cf61652159135,2,54,5,49,0,0,0,7,188,45,1,2,0.693965967,9920,44,2,869,864,5,62398,61893,505,310,308,2,1,100
2dd1cc14414ac92eca89f2ee9733d8ebf69cbd97,3,91,3,88,0,0,0,1,56,288,1,2,1.560612159,1202,45,3,196,181,15,6990,6432,558,45,42,3,1,100
a25a9272b06f33411c9d13ff741d985c96061bca,0,0,0,0,0,0,0,0,0,0,0,0,0,0,56,0,0,0,0,0,0,0,0,0,0,1,100
c85563ef54f9ffdbfac849157d4ff34f66148366,0,0,0,0,0,0,0,0,0,0,0,0,0,0,3,1,0,0,0,0,0,0,0,0,0,1,100
de8ef2ba945b593db66e4e25733c5cb53b217fda,0,0,0,0,0,0,0,0,0,0,0,0,0,0,4,2,0,0,0,0,0,0,0,0,0,1,100
a1f4a30ba1333ef8de722c501d7da6bc55d98560,2,50,10,40,0,0,0,4,27,469,1,2,0.979868757,737,433,7,136,133,3,4861,4585,276,52,50,2,1,100
60dc76c8ff9a46f6bbf4578acfb23a5214cc35b3,2,70,4,66,0,0,0,5,70,37,1,2,0.860555393,2218,434,7,231,227,4,12288,12004,284,111,108,3,1,100
71fa843c0c70abd45c35d95b056c90f4ade258cf,7,343,4,339,4,0,4,1,8,233,1,3,2.590478552,627,382,0,62,48,14,5911,3868,2043,33,25,8,1,90.07423701
4b65376991ae7c64aab10e50848814d7cb848cd8,2,203,1,202,1,0,1,1,10,280,1,2,0.110580845,497,383,1,63,61,2,4595,3070,1525,31,29,2,1,99.94941831
6702d928b7651049b8cec39f558e7891fafe769b,2,4,29,25,0,0,0,1,57,16,1,2,0.994030211,1138,46,4,169,172,3,6252,6427,175,32,32,0,1,100
12b6ed9a6cf579256c9fef1040c121027efa0be5,0,0,0,0,0,0,0,0,0,0,0,0,0,0,435,8,0,0,0,0,0,0,0,0,0,1,100
5d95d998c38a965adaa0c7810ecb57520ef9f110,3,168,27,141,0,0,0,3,4,368,1,2,0.254138803,1156,436,7,199,180,19,7673,6850,823,49,44,5,1,100
711a14142318f674b281a5e0f2966787d2dd94fe,0,0,0,0,0,0,0,0,0,0,0,0,0,0,437,8,0,0,0,0,0,0,0,0,0,1,100
2b8f0c144ef08fe6d873b02c0e5e06e0a9539ffb,3,20,0,20,0,0,0,4,135,387,2,3,1.558871848,3283,57,1,429,429,0,19251,18953,298,151,151,0,1,100
a9f107c4c5b1b1029793c66bd2ef222c52cef976,0,0,0,0,0,0,0,0,0,0,0,0,0,0,438,8,0,0,0,0,0,0,0,0,0,1,100
ba9e3f96ed2ba16aa398f6ec7636e8fc50100b25,0,0,0,0,0,0,0,0,0,0,0,0,0,0,47,3,0,0,0,0,0,0,0,0,0,1,100
d72cd949d52febc741f102d59413d6abe889df2b,3,27,168,141,0,0,0,3,5,6,1,2,0.254138803,1297,48,4,180,199,19,6850,7673,823,44,49,5,1,100
3eb8f60aaf0d0c247097c680982865a6b8bdcd4d,1,0,1,1,0,0,0,5,15,61,1,1,0,339,49,3,48,48,0,1904,1908,4,14,14,0,1,100
ded614164298ba7f6843c1d897ea18a78563ca43,0,0,0,0,0,0,0,0,0,0,0,0,0,0,58,2,0,0,0,0,0,0,0,0,0,1,100
6e588d15184dc691df1c0227f40db91d9bc6d7d6,406,6252,22306,16054,8,42,50,1,188,60,10,122,6.999807245,136771,58,2,11832,13313,1481,680101,781574,101473,5115,5850,735,1,87.7605918
c1d334b4dc1766e83658dafffc58e33c2b8e731d,1,3,3,0,0,0,0,5,16,25,1,1,0,338,384,0,48,48,0,1908,1904,4,14,14,0,1,100
493942d293eb5b4baa29b7dc2db9db2f6a96af2e,6,528,40,488,2,0,2,1,6,172,1,3,1.4580282,1297,5,0,248,202,46,9750,7674,2076,73,51,22,1,99.8738966
a1aaa9de07d027560c7af294080e714174fdb2ae,1,72,0,72,0,0,0,5,33,48,1,1,0,730,50,1,95,87,8,5107,4598,509,29,29,0,1,100
eaa2f2372e971308fc07a0e1b68fb8a468a8ade8,6,52,0,52,0,0,0,4,136,162,1,3,2.168558125,7496,51,1,722,717,5,46442,45976,466,287,285,2,1,97.51278475
41d153a1250ecca2a54f9525939833603bd0ba83,4,117,22,95,0,0,0,4,137,92,1,3,1.215201545,5827,439,0,684,680,4,34662,33960,702,226,224,2,1,100
4f9506c1a56d50fdad63137488ed87d9bf50619e,6,97,57,40,0,0,0,4,84,233,1,2,2.188870392,6239,52,2,466,472,6,37918,37447,471,267,265,2,1,100
21d208f17305e6eaff14fa3856d5b925f3975669,1,2,2,0,0,0,0,5,37,107,1,1,0,831,440,1,98,98,0,3591,3591,0,33,33,0,1,100
557a5118cf5c6b91cf58a321ff435036a711aef5,1,2,2,0,0,0,0,4,52,878,1,1,0,390,59,0,38,38,0,1620,1610,10,16,16,0,1,100
9538b0ff47da68f7c75a78411a932107c15dad0c,1,3,5,2,0,0,0,9,138,5,1,1,0,2129,53,3,304,304,0,12049,12046,3,108,108,0,1,100
72da6b8b4dbbcee53acce9019b16fec0e6aba1be,2,46,5,41,0,0,0,6,9,259,1,2,0.626751137,754,6,1,128,123,5,4887,4640,247,34,30,4,1,97.74647887
23d3cacf72f040b1c2fb69522f45fcf92d49ba1b,2,36,1,35,0,0,0,4,63,258,1,2,0.303374836,917,54,4,108,107,1,6015,5732,283,43,42,1,1,100
b7cc8e8d6e5bfdebc9e11589ee7fd543615526ea,1,5,5,0,0,0,0,4,10,1,1,1,0,332,55,5,12,12,0,2451,2441,10,11,11,0,1,100
a82da8ad4f7ff7a3379c800865f72936f6b3847b,1,22,15,7,0,0,0,3,14,182,1,1,0,481,56,6,75,74,1,2548,2513,35,12,12,0,1,100
36579fa218cc13e603c16faec11b0b4b39867c2e,1,83,72,11,0,0,0,9,139,21,1,1,0,2127,441,2,305,304,1,12096,12049,47,108,108,0,1,100
caab9058a25afebfced4f6c9536d4f36fb28f2c0,3,52,22,30,0,0,0,5,16,569,1,2,1.229168487,882,385,0,87,83,4,5286,5157,129,35,34,1,1,100
6ece4d4bd4a9d34303bb143beeb82b806a6d750f,0,0,0,0,0,0,0,0,0,0,0,0,0,0,386,1,0,0,0,0,0,0,0,0,0,1,100
449a53cb1b5137273d5e98d7041b5ab9dfdc5e8d,2,65,2,63,0,0,0,4,72,44,1,2,0.43497348,2295,57,4,208,203,5,13460,13050,410,91,88,3,1,100
1c9c7f6e4c41d77976726e9f84330008eb39c63d,2,18,9,9,0,0,0,3,14,266,2,2,0.691289869,886,60,0,119,115,4,5943,5876,67,31,31,0,1,100
87c1f06d420e743d4a253f9c9101cfebd437c54d,3,96,1,95,1,0,1,1,80,377,2,2,0.651372519,1562,58,3,72,63,9,4880,4453,427,27,24,3,1,99.8971458
dc0d10bb796cd9c27673a2fd6a00d1034e801664,0,0,0,0,0,0,0,0,0,0,0,0,0,0,442,0,0,0,0,0,0,0,0,0,0,1,100
4e669df16c894f4c265c3195a8f7643b0b91e43f,1,1,1,0,0,0,0,6,73,35,1,1,0,1485,59,2,165,165,0,7506,7502,4,54,54,0,1,100
cacae67a910a4957d982981e72a0d71a6f57dc56,1,4,4,0,0,0,0,7,69,234,1,1,0,1011,7,0,133,133,0,5939,5929,10,27,27,0,1,100
9355ceaa6cc45d42653c4d4bd38a868bc4c84d9c,0,0,0,0,0,0,0,0,0,0,0,0,0,0,8,1,0,0,0,0,0,0,0,0,0,1,100
6b39a4e2490294cfb026f85ed3bced25a6fb0292,0,0,0,0,0,0,0,0,0,0,0,0,0,0,443,0,0,0,0,0,0,0,0,0,0,1,100
aa26fd7974d6dd71f8f7b1cbd5a2043ebd762527,4,136,2,134,1,0,1,3,50,591,1,2,1.708505023,1125,387,0,112,103,9,7067,6326,741,51,49,2,1,99.94863893
b2b6fa7a148ef7cc3a2e0451e6d08a1669ae11c3,3,81,9,72,0,0,0,5,85,151,2,3,1.534640981,3919,75,0,178,177,1,20381,19979,402,110,110,0,1,100
8cbaa40c52b390d2c06c4449a058ebf7d95a9755,0,0,0,0,0,0,0,0,0,0,0,0,0,0,76,1,0,0,0,0,0,0,0,0,0,0,100
68f17cf755e3d6d6f20901689e8e5f0d1303be24,14,520,44,476,1,0,1,4,189,321,2,11,2.806116421,13487,60,0,1638,1588,50,85938,82784,3154,505,481,24,1,99.58984876
abf49328b5535330608f539c9dd74d331c691035,2,34,8,26,0,0,0,2,7,690,1,2,0.829607103,1460,77,2,175,173,2,8100,7996,104,62,62,0,1,100
c04283bf91fd96823eec37056d5c8b1a92728265,0,0,0,0,0,0,0,0,0,0,0,0,0,0,61,0,0,0,0,0,0,0,0,0,0,1,100
bce7ff211f1b557a4aca46db8e839d5c2a0c8890,0,0,0,0,0,0,0,0,0,0,0,0,0,0,465,13,0,0,0,0,0,0,0,0,0,1,100
077b352fbd7ec44a7e5c3224837d5048829f09c4,1,1,0,1,0,0,0,5,38,18,1,1,0,831,466,14,98,98,0,3590,3583,7,33,33,0,1,100
406bba9ac86b8c0e265c2b1850928de477ce0250,2,4,29,25,0,0,0,1,61,16,1,2,0.994030211,1284,66,8,181,184,3,7214,7389,175,37,37,0,1,100
70fda9507040de8da83935445c26111f1c1cd3da,24,210,531,321,0,0,0,2,37,57,2,14,2.919403683,13502,66,8,1361,1412,51,68863,70250,1387,509,523,14,1,100
5c6bbf9f37877788a08932391fa484d4eb379e66,0,0,0,0,0,0,0,0,0,0,0,0,0,0,465,13,0,0,0,0,0,0,0,0,0,1,100
a6f0f1ef2981dc6c84ae6a7de830d79df6c27db0,1,1,0,1,0,0,0,5,38,18,1,1,0,831,466,14,98,98,0,3590,3583,7,33,33,0,1,100
5679b28386a957879eb0443557b0a48c7c95c4d4,23,521,201,320,0,0,0,2,32,118,2,13,2.951460533,12350,412,6,1314,1263,51,66660,65280,1380,490,476,14,1,100
12ef073c205ce7b09827a7ecbeea457d589c1c5f,0,0,0,0,0,0,0,0,0,0,0,0,0,0,23,8,0,0,0,0,0,0,0,0,0,1,100
4bf958c03f268f8e3f23a49e4df071cc5587051d,23,210,530,320,0,0,0,2,31,59,2,13,2.908517674,12670,23,8,1263,1314,51,65280,66660,1380,476,490,14,1,100
6a04fa48cb1113faf640115dcbba9b2270e756f3,26,712,256,456,0,0,0,2,32,107,2,15,3.550769291,13189,24,9,1353,1299,54,74270,71740,2530,514,498,16,2,94.89453972
244c38bb4f421ca41a5851b8a4c777c4f0474da1,23,210,530,320,0,0,0,2,31,76,2,13,2.908517674,12689,24,9,1265,1316,51,65383,66763,1380,477,491,14,2,100
da3fecd53df56b96e29c8608068bf46a1995d611,23,521,201,320,0,0,0,2,32,98,2,13,2.951460533,12369,25,10,1316,1265,51,66763,65383,1380,491,477,14,1,100
9d8f78405c3b555e6a0b93ee47eaf66807277804,23,210,530,320,0,0,0,2,31,76,2,13,2.908517674,12689,25,10,1265,1316,51,65383,66763,1380,477,491,14,1,100
16bbc58ca70c7878696521530dc2c6f454b27019,23,521,201,320,0,0,0,2,32,98,2,13,2.951460533,12369,467,15,1316,1265,51,66763,65383,1380,491,477,14,1,100
128668765290d14c80865018f23a21aed9f02eb9,23,210,530,320,0,0,0,2,31,76,2,13,2.908517674,12689,467,15,1265,1316,51,65383,66763,1380,477,491,14,1,100
7476fae834bafb7a36d17382a08a5385fee0e343,23,521,201,320,0,0,0,2,32,98,2,13,2.951460533,12369,413,7,1316,1265,51,66763,65383,1380,491,477,14,1,100
55308630b6354ce070550d1ea4efbedbbae8e13a,19,245,21,224,2,0,2,1,42,84,2,11,2.978361705,6415,414,8,711,694,17,33740,32612,1128,283,274,9,1,88.71444824
78ca7af63987e6052d8756f9ab827cb10b26dbcf,1,1,1,0,0,0,0,5,90,6,1,1,0,1209,468,16,14,14,0,3125,3125,0,6,6,0,1,100
a0a659a712bbe9e4362c668939c3893196996a0f,36,229,773,544,0,2,2,0,41,139,3,18,3.568769535,15449,468,16,1528,1596,68,77613,80121,2508,584,607,23,1,88.71444824
d5a0f39d98be9ae06be9008c1deee36827c204e6,37,765,221,544,2,0,2,1,42,100,4,19,3.619847025,15215,469,17,1614,1546,68,81542,79034,2508,615,592,23,1,88.71444824
02870f0ac1095d67a85a864860b0c4ce68a1db57,3,30,34,4,0,0,0,3,204,21,1,3,1.378694196,5378,67,7,719,722,3,30614,30579,35,211,212,1,1,100
4405dff238f46981987b57bb67cab32a01f3176f,37,230,774,544,0,2,2,0,41,141,4,19,3.582403064,15759,67,7,1546,1614,68,79034,81542,2508,592,615,23,1,88.71444824
70cd396d27188aa5e79280552199e7c81f7d2822,37,765,221,544,2,0,2,1,42,100,4,19,3.619847025,15215,26,10,1614,1546,68,81542,79034,2508,615,592,23,1,88.71444824
a142c335009350f9bdfae542b1fc360e65563d93,37,230,774,544,0,2,2,0,41,141,4,19,3.582403064,15759,26,10,1546,1614,68,79034,81542,2508,592,615,23,1,88.71444824
a382324c24a30ef7b632ca1f003a90873ac802e3,37,765,221,544,2,0,2,1,42,100,4,19,3.619847025,15215,27,11,1614,1546,68,81542,79034,2508,615,592,23,1,88.71444824
c152ed88e29bacc7542074706ba142e1c1821d99,37,230,774,544,0,2,2,0,41,141,4,19,3.582403064,15759,27,11,1546,1614,68,79034,81542,2508,592,615,23,1,88.71444824
05f77fe2b210341a16ead9fc51e53093c836d860,63,2748,417,2331,5,0,5,3,205,164,7,30,4.669126699,35186,355,5,3662,3411,251,212816,200697,12119,1509,1392,117,1,94.3324937
d6e7f93ec49f84082afc91afc7ae869be1489116,37,230,774,544,0,2,2,0,41,141,4,19,3.582403064,15759,355,5,1546,1614,68,79034,81542,2508,592,615,23,1,94.24688562
4a6808ce4c99458653bbe4328dfcad24649a48fb,40,1241,261,980,2,0,2,1,206,94,5,21,3.491373194,23921,68,6,2680,2579,101,137780,131107,6673,966,933,33,1,94.19471425
c69398509e25ebc8444b690e49022397bf9cb295,37,230,774,544,0,2,2,0,41,141,4,19,3.582403064,15759,68,6,1546,1614,68,79034,81542,2508,592,615,23,1,93.77664109
6e6ad706f5b6611058541c3bf072343bf002ced5,40,794,229,565,2,0,2,1,207,93,5,21,3.760530924,24357,69,7,2683,2612,71,137986,135272,2714,966,943,23,1,93.77664109
8cc874a3c1eeaceba0ac06c5fd69ee7b84c38b1d,37,230,774,544,0,2,2,0,41,141,4,19,3.582403064,15759,69,7,1546,1614,68,79034,81542,2508,592,615,23,1,93.77664109
ce69aa1e2ca3320d33c833a96a158f94bfd73f52,44,926,295,631,2,0,2,1,42,83,5,23,4.011656767,17419,415,6,1862,1785,77,94422,91400,3022,751,728,23,1,93.77664109
9968e569baa680b2ea1c53d0ea71f6378cc7da53,37,230,774,544,0,2,2,0,41,141,4,19,3.582403064,15759,412,3,1546,1614,68,79034,81542,2508,592,615,23,1,93.77664109
ed7f1abbce54093f56f33c35c8ac92d9e433760f,47,1090,378,712,3,0,3,1,208,91,6,24,4.219843073,33450,70,8,3156,3078,78,196520,193180,3340,1278,1247,31,1,91.32543103
d3d4b051d3c896b601a0c492cd6d5a9b27f04cff,37,230,774,544,0,2,2,0,41,141,4,19,3.582403064,15759,70,8,1546,1614,68,79034,81542,2508,592,615,23,1,93.21297989
e00b44a80d911601d8a6409a72f7b3eaa4dc844f,37,765,221,544,2,0,2,1,42,100,4,19,3.619847025,15215,71,9,1614,1546,68,81542,79034,2508,615,592,23,1,93.21297989
5c1b91064e71fc550b5eb77fe263bafbcb8e0ab3,37,230,774,544,0,2,2,0,41,141,4,19,3.582403064,15759,71,9,1546,1614,68,79034,81542,2508,592,615,23,1,93.21297989
f0b9d7ec7472d6c4b932c249f6106c5b6ca85b88,40,933,247,686,2,0,2,1,42,103,4,21,3.711420839,16495,470,15,1837,1750,87,89743,86413,3330,667,639,28,1,93.21297989
db9864c33d5f5a3ffb60b8d03089014235d3133c,37,230,774,544,0,2,2,0,41,141,4,19,3.582403064,15759,469,14,1546,1614,68,79034,81542,2508,592,615,23,1,93.21297989
5f448934429aa70582196c6581ce7e439723f8f5,0,0,0,0,0,0,0,0,0,0,0,0,0,0,470,15,0,0,0,0,0,0,0,0,0,1,100
d99f2b262989079d6f628f91560a8678a2313e73,37,765,221,544,2,0,2,1,42,100,4,19,3.619847025,15215,471,16,1614,1546,68,81542,79034,2508,615,592,23,1,93.21297989
9d582b444b7ba7f862802dbb547b059349e25fcf,3,20,0,20,0,0,0,2,150,50,2,3,1.558871848,3529,58,1,461,461,0,20674,20376,298,167,167,0,1,100
5a0b0265da28b039d6dd3db47982aa12e7ee1389,37,230,774,544,0,2,2,0,41,141,4,19,3.582403064,15759,58,1,1546,1614,68,79034,81542,2508,592,615,23,1,93.21297989
faffae43c5533ce914b4a3d05cc12fb83dfc75fe,37,765,221,544,2,0,2,1,42,100,4,19,3.619847025,15215,472,14,1614,1546,68,81542,79034,2508,615,592,23,1,93.21297989
eec72121a434c7cbc8788ebcba0467316c40f58c,37,230,774,544,0,2,2,0,41,141,4,19,3.582403064,15759,471,13,1546,1614,68,79034,81542,2508,592,615,23,1,93.21297989
7d0ae69e2aff1e76faa5c89a3789e35ac254035c,39,769,600,169,2,1,3,4,42,101,5,20,3.514845898,15751,72,9,1633,1584,49,82439,82205,234,619,602,17,1,93.14128944
ec6bbbf958878d9dfa7e2a32f467e1e6de8c1a9b,0,0,0,0,0,0,0,0,0,0,0,0,0,0,28,12,0,0,0,0,0,0,0,0,0,1,100
c048de1c54413076339e2f0339b1fc40f7d1f24d,2,25,9,16,0,0,0,4,44,9,1,2,0.989992792,1154,416,6,137,134,3,7213,7099,114,61,61,0,1,100
9a8cd4239762779dbb1f52cd3561a4aacf3e69c7,39,609,778,169,1,2,3,3,41,160,5,20,3.495201331,15920,413,3,1584,1633,49,82205,82439,234,602,619,17,1,92.72279445
2df32bffa07d88bf4a0b7f2dced2c17b678006ef,39,769,600,169,2,1,3,4,42,101,5,20,3.514845898,15751,73,9,1633,1584,49,82439,82205,234,619,602,17,1,92.72279445
2467d60896e5c99536fe4e64b58c6f57dc1587ec,3,26,168,142,0,0,0,3,9,6,1,2,0.255176221,1422,74,10,204,223,19,7379,8201,822,47,52,5,1,100
3958733a1d549a22f0046dcc5b4f8774fd5fac9b,42,777,804,27,1,2,3,3,41,153,5,22,3.634719829,17200,72,8,1807,1837,30,90406,89818,588,654,666,12,1,92.72279445
e09b9f65802e4c5dd417399552b6ffe90480a9ff,3,26,168,142,0,0,0,3,9,6,1,2,0.255176221,1422,73,9,204,223,19,7379,8201,822,47,52,5,1,100
1c4cc8a20c81259319c07d34fe496fd94e06dba8,39,769,600,169,2,1,3,4,42,101,5,20,3.514845898,15751,75,11,1633,1584,49,82439,82205,234,619,602,17,0,92.72279445
b4b4d21e28537ac652b553df473ebcbbfae0c8b7,39,609,778,169,1,2,3,3,41,160,5,20,3.495201331,15920,74,10,1584,1633,49,82205,82439,234,602,619,17,0,92.72279445
05cf9a528441b72b3265f80ae7f17daab2c5730f,39,769,600,169,2,1,3,4,42,101,5,20,3.514845898,15751,76,11,1633,1584,49,82439,82205,234,619,602,17,1,92.72279445
cc8c5bbf16c8a5ae835eac00060467cec790a331,39,609,778,169,1,2,3,3,41,160,5,20,3.495201331,15920,75,10,1584,1633,49,82205,82439,234,602,619,17,1,92.72279445
e5c36a91120d330223cb7af2996fcbd12b385540,39,769,600,169,2,1,3,4,42,101,5,20,3.514845898,15751,77,12,1633,1584,49,82439,82205,234,619,602,17,1,92.72279445
587a50230ac17045f4ec467c9b0c80d7235646f5,39,609,778,169,1,2,3,3,41,160,5,20,3.495201331,15920,76,11,1584,1633,49,82205,82439,234,602,619,17,1,92.72279445
282eb724009faffb3a4f7a71b7b464f777fe5c3b,39,769,600,169,2,1,3,4,42,101,5,20,3.514845898,15751,0,0,1633,1584,49,82439,82205,234,619,602,17,1,92.72279445
fac3222c768fbdfc8c1bbe55f94bc106900e6ae4,1,0,1,1,0,0,0,5,20,81,1,1,0,344,78,12,50,50,0,1951,1955,4,14,14,0,1,100
e10aef4e13ff6566e0cf48a6626d4c2b021ef1e8,0,0,0,0,0,0,0,0,0,0,0,0,0,0,79,13,0,0,0,0,0,0,0,0,0,1,100
b6e382edb3b2d89effcbcb07d1e4a8ec67d45216,39,609,778,169,1,2,3,3,41,160,5,20,3.495201331,15920,77,11,1584,1633,49,82205,82439,234,602,619,17,1,92.72279445
025c7ed80f60c9d198765a47fff346fc87435113,0,0,0,0,0,0,0,0,0,0,0,0,0,0,78,12,0,0,0,0,0,0,0,0,0,1,100
d090fc9061c1b0e39d34e2683d59fb9bd3f8e6f8,39,769,600,169,2,1,3,4,42,101,5,20,3.514845898,15751,29,12,1633,1584,49,82439,82205,234,619,602,17,1,92.72279445
09c92662eb8821854c393436f7b41b3f53ddf3cc,39,609,778,169,1,2,3,3,41,160,5,20,3.495201331,15920,28,11,1584,1633,49,82205,82439,234,602,619,17,1,92.72279445
fb4df0d61da1bb576f22e4ebdd47c0000ed2e71f,0,0,0,0,0,0,0,0,0,0,0,0,0,0,79,13,0,0,0,0,0,0,0,0,0,0,100
cea05e361b0c4150aadd91994ad69281d1e80695,39,769,600,169,2,1,3,4,42,101,5,20,3.514845898,15751,30,11,1633,1584,49,82439,82205,234,619,602,17,1,92.72279445
b59b6a9b618575fce17a551f86cc827e8746e6a9,0,0,0,0,0,0,0,0,0,0,0,0,0,0,31,9,0,0,0,0,0,0,0,0,0,1,100
12fc2c70858ac88459436334a34bc69f7ddf9589,0,0,0,0,0,0,0,0,0,0,0,0,0,0,32,10,0,0,0,0,0,0,0,0,0,1,100
11aa17e01f7d72bdea26db2188f8b5cb0c3d84ae,17,3775,0,3775,17,0,17,1,1,0,1,5,3.606585109,0,108,2,420,0,420,19764,0,19764,234,0,234,1,96.24718539
2fc34ed6719b10ee3d8b31d2d105c8be7f62a69a,2,8,8,0,0,0,0,1,2,0,1,2,1,595,109,2,52,52,0,3395,3399,4,18,18,0,1,100
4d891ea767646e10e22fd5d4bb01e264591c891e,0,0,0,0,0,0,0,0,0,0,0,0,0,0,80,14,0,0,0,0,0,0,0,0,0,1,100
6aabbc3b76b9e03ca97fc570c5c6f48df722922a,0,0,0,0,0,0,0,0,0,0,0,0,0,0,81,15,0,0,0,0,0,0,0,0,0,1,100
13e55eb4ecb6f9d2e14dc60c7e86ca5518ea4023,0,0,0,0,0,0,0,0,0,0,0,0,0,0,59,1,0,0,0,0,0,0,0,0,0,1,100
0d8c262355f596c9372b5041e8884427f8bc001f,0,0,0,0,0,0,0,0,0,0,0,0,0,0,60,2,0,0,0,0,0,0,0,0,0,1,100
20ef028f9769dc32b92bbc40e286c5fad58703b3,0,0,0,0,0,0,0,0,0,0,0,0,0,0,61,3,0,0,0,0,0,0,0,0,0,1,100
1f927a55eb0ee13d005b484a4cff4100ff04c0db,0,0,0,0,0,0,0,0,0,0,0,0,0,0,110,2,0,0,0,0,0,0,0,0,0,1,100
a9048bb52c8efc194fca62f8764d97b6d3143147,2,33,2,31,0,0,0,4,91,28,1,2,0.898058793,1794,82,15,153,147,6,6267,6096,171,28,28,0,1,100
70a465dfb73ca3ce97caf1c1427fe6324c1e073f,11,905,384,521,2,0,2,1,17,49,1,4,2.643199976,5475,417,4,645,609,36,33096,29869,3227,220,208,12,1,95.62611012
7c16b10e2a251628c0fba3e61327fe5d464ba231,0,0,0,0,0,0,0,0,0,0,0,0,0,0,418,3,0,0,0,0,0,0,0,0,0,1,100
aa6a84c2ca2ca4c18029c64451752d8b11e53d28,1,1,1,0,0,0,0,8,209,30,1,1,0,4814,83,15,675,675,0,26953,26953,0,184,184,0,1,100
41173aa0a0cc60924902ce9e78a452e2069a2a31,16,220,135,85,0,0,0,2,210,129,2,8,3.01416838,18638,356,0,1722,1704,18,118242,117765,477,711,697,14,1,100
87156be21c18acc210878e23a43e65e021561b66,0,0,0,0,0,0,0,0,0,0,0,0,0,0,419,3,0,0,0,0,0,0,0,0,0,1,100
7be325eab1ad82aa2a2a6ff404a77426b2056599,0,0,0,0,0,0,0,0,0,0,0,0,0,0,33,5,0,0,0,0,0,0,0,0,0,1,100
9dabf94767480750f31d8f3e24d17a89bc036331,19,1362,272,1090,6,0,6,5,18,28,2,11,3.39643842,6807,111,3,768,685,83,41444,36705,4739,272,232,40,1,99.61984794
dac59a2aa71aab5daaa6fabdda9d8f48539e1bda,1,3,2,1,0,0,0,1,2,0,1,1,0,238,112,4,23,23,0,934,950,16,11,11,0,1,100
8710df0d1264a453218220ed48e5d2b5d2923da1,6,528,39,489,2,0,2,1,10,169,1,3,1.454684193,1441,34,5,278,232,46,10418,8343,2075,76,54,22,1,94.01247401
317d45a5d410f2e6afedbe8563c258f4cc667d67,0,0,0,0,0,0,0,0,0,0,0,0,0,0,35,6,0,0,0,0,0,0,0,0,0,1,100
fe74d6b9e896dfe158392ffe91fbad944abba027,1,5,4,1,0,0,0,5,34,63,1,1,0,1141,113,5,153,152,1,6422,6403,19,69,69,0,1,100
02aafb55e9b1adc3384adaccf44cba712a753fac,1,74,4,70,0,0,0,6,45,42,1,1,0,837,84,6,112,104,8,5607,5114,493,35,35,0,1,100
17b6aba9c7f85d710eb97a006b9a42fbe0510cbc,7,55,1,54,0,0,0,4,151,78,1,3,2.384893443,10468,85,5,929,924,5,68969,68460,509,412,410,2,1,100
b9056657a101b33c96195655079b1eb03ebb3c95,10,13,13,0,0,0,0,4,152,318,5,8,3.146348489,5135,420,3,726,728,2,28572,28579,7,233,233,0,1,100
42b7756ebea108f81dbf633c847e2f70cd099e0f,7,196,69,127,0,0,0,1,35,114,3,6,2.423466995,3913,114,6,412,395,17,22130,21256,874,173,165,8,1,100
fafa804c953aa528c839be7a14d0ccbdd35c75f9,0,0,0,0,0,0,0,0,0,0,0,0,0,0,421,4,0,0,0,0,0,0,0,0,0,1,100
413c3cc7991e810d6b49539d71ecc930e838238e,8,203,61,142,1,0,1,3,118,50,3,4,2.017428851,11716,422,5,887,874,13,71395,70577,818,425,415,10,1,99.8914695
7bc35050530206d9c4b6281c4a486fab1a1d730c,0,0,0,0,0,0,0,0,0,0,0,0,0,0,423,6,0,0,0,0,0,0,0,0,0,1,100
87f26a2ed10a097d20f69c5ab0b6e33a0877125e,0,0,0,0,0,0,0,0,0,0,0,0,0,0,424,7,0,0,0,0,0,0,0,0,0,1,100
5a04f06028ea4d3814bab6b044113d6eec559b9a,0,0,0,0,0,0,0,0,0,0,0,0,0,0,86,6,0,0,0,0,0,0,0,0,0,0,100
7fe0a6b7122c31c4d2d274700faa6c04297ce3a7,0,0,0,0,0,0,0,0,0,0,0,0,0,0,36,3,0,0,0,0,0,0,0,0,0,1,100
4c48283eedb75b0105f236735bcd430bbbafc644,1,11,4,7,0,0,0,1,2,18,1,1,0,202,115,6,16,16,0,1111,1070,41,10,10,0,1,100
237d1895d224fc07466e0c4e494960b32d7a69aa,1,4,6,2,0,0,0,5,36,13,1,1,0,1158,116,6,157,157,0,6542,6559,17,70,70,0,1,100
4d5ea0e5151dca5dbf5d6aeb05efbe05bfc2208d,0,0,0,0,0,0,0,0,0,0,0,0,0,0,37,4,0,0,0,0,0,0,0,0,0,1,100
cd068538d7ecc2cf18c606dfcf0bcbebcf2dbe11,0,0,0,0,0,0,0,0,0,0,0,0,0,0,1,0,0,0,0,0,0,0,0,0,0,1,100
631c3e9c627603ac53426d5a0b120b426fb6712c,4,117,22,95,0,0,0,4,153,81,1,3,1.215201545,5964,473,0,700,696,4,35418,34716,702,236,234,2,1,100
44a6bb686b08326b45c232fb7466b43c574fe7c1,6,94,56,38,0,0,0,5,89,68,1,2,2.205069425,6325,87,4,470,476,6,38463,37993,470,270,268,2,1,100
a3950efd204d309a1aa6781d266c1e37e6b81b2a,4,4,107,103,0,1,1,5,90,704,1,3,1.741808348,2458,88,5,198,203,5,11835,12344,509,134,138,4,1,99.93489583
7b2ec39f04519a3869981b4685826e23096d78e8,2,51,5,46,0,0,0,7,119,76,1,2,0.905928216,6374,89,6,326,318,8,43986,43802,184,186,184,2,1,100
d2b274904bb1819cea890224201e37e8f0c67bec,0,0,0,0,0,0,0,0,0,0,0,0,0,0,0,0,0,0,0,0,0,0,0,0,0,1,100
c241f40944e9bafd4c3682b001502b5ea7a5e6e8,1,2,2,0,0,0,0,5,39,89,1,1,0,832,474,1,98,98,0,3590,3590,0,33,33,0,1,100
588a14f04a7f39bffc178fe75cdf5e621c46a5b6,1,2,2,0,0,0,0,4,54,170,1,1,0,408,62,0,40,40,0,1677,1667,10,17,17,0,1,100
fa5ae1ac2b8240e00abedf995b29c43c7af993fd,3,20,3,17,0,0,0,3,30,18,1,3,1.450908284,2024,117,6,206,203,3,11891,11793,98,75,74,1,1,100
56f157ef11cd97c0e4f2de20a9bd7b113104b5db,1,3,5,2,0,0,0,9,154,5,1,1,0,2254,90,6,320,320,0,12777,12774,3,118,118,0,1,100
29260f1777d8ca4aee9e75af19522d87e5eac024,0,0,0,0,0,0,0,0,0,0,0,0,0,0,1,1,0,0,0,0,0,0,0,0,0,1,100
139e3d50848e6895280c921e56015fc8b1703cc9,0,0,0,0,0,0,0,0,0,0,0,0,0,0,2,2,0,0,0,0,0,0,0,0,0,1,100
5e58309d91ba56b7acb51247d3e7948ae4ddb71e,2,34,4,30,0,0,0,6,11,112,1,2,0.74248757,1097,38,5,174,170,4,6649,6449,200,48,45,3,1,100
333edd0f05ce965f796bd4fbb53421090c51ac96,2,36,1,35,0,0,0,5,67,200,1,2,0.303374836,969,91,7,110,109,1,6422,6139,283,45,44,1,1,100
9a2ed82ea047b439de129d8eabe64ef80da917a0,2,2,2,0,0,0,0,2,7,91,1,2,1,361,118,7,49,49,0,1695,1687,8,27,27,0,1,100
26c3c793456323539373e026170e9902c508a815,1,22,15,7,0,0,0,4,15,188,1,1,0,481,92,8,75,74,1,2540,2505,35,12,12,0,1,100
0588c144f6e7c6f53b7fd0954bd0e25dbca7493b,0,0,0,0,0,0,0,0,0,0,0,0,0,0,3,3,0,0,0,0,0,0,0,0,0,1,100
994c7491414737aaede01d21ec86c34d0b3143ae,0,0,0,0,0,0,0,0,0,0,0,0,0,0,4,4,0,0,0,0,0,0,0,0,0,1,100
ce26b3f52761d2a48a612a7613d99b712a320204,9,65,48,17,0,0,0,3,155,253,3,7,2.766921087,6061,93,8,793,791,2,34997,34911,86,278,277,1,1,100
64ca681a29d0cc4fcb505f990bd84ac4c5ae35ea,0,0,0,0,0,0,0,0,0,0,0,0,0,0,63,1,0,0,0,0,0,0,0,0,0,1,100
bb51e4ed65f704f1a03b8420c163d2ee0dffdb81,1,86,75,11,0,0,0,9,156,3,1,1,0,2254,475,2,321,320,1,12824,12777,47,118,118,0,1,100
7f51852b661b6ffc4f275a5c5603892d9424293e,0,0,0,0,0,0,0,0,0,0,0,0,0,0,476,3,0,0,0,0,0,0,0,0,0,1,100
6ae49e99d3c9aadeea76c7497d1e186d19284f8a,0,0,0,0,0,0,0,0,0,0,0,0,0,0,39,2,0,0,0,0,0,0,0,0,0,1,100
be7e63b28b0193dd06d96e73d2a308c5d5b5ef17,3,50,22,28,0,0,0,2,18,175,2,2,1.224902852,926,425,0,88,84,4,5651,5532,119,37,36,1,1,100
886a383669b4c76b0a5dc72c1a5f71fb87c33eb9,0,0,0,0,0,0,0,0,0,0,0,0,0,0,426,1,0,0,0,0,0,0,0,0,0,1,100
742c005d5ce26310cb36eaee1269ae6316bbf3f8,0,0,0,0,0,0,0,0,0,0,0,0,0,0,477,3,0,0,0,0,0,0,0,0,0,1,100
9c2d6256585eff26b041583cb7194cd2e6a4ec3d,0,0,0,0,0,0,0,0,0,0,0,0,0,0,478,4,0,0,0,0,0,0,0,0,0,1,100
d1607816f17bbf9ca8c37713be6a5404d8076cfa,2,14,6,8,0,0,0,1,112,57,1,2,0.468995594,4409,94,4,403,399,4,29905,29868,37,169,168,1,1,100
ccecb9830caf40d23927fcbc4821a80bf1300031,2,65,2,63,0,0,0,5,82,44,1,2,0.43497348,2337,95,5,211,206,5,13656,13246,410,94,91,3,1,100
24fb21e6513786b6ff6a576e133ad274ccfc4b3a,0,0,0,0,0,0,0,0,0,0,0,0,0,0,40,2,0,0,0,0,0,0,0,0,0,1,100
41f8a9737a6d2424f0453db3e93404323b248d85,3,85,9,76,0,0,0,5,93,49,2,3,1.548416713,4110,119,2,188,187,1,21670,21256,414,113,113,0,1,100
5cba084eb7622bf81d9c7bdc3901df4f32d5ce63,0,0,0,0,0,0,0,0,0,0,0,0,0,0,41,3,0,0,0,0,0,0,0,0,0,1,100
43fcf38bc73473cba0b775232d36383b3d332fd8,3,20,11,9,0,0,0,2,15,122,3,3,1.15686934,1045,64,1,136,132,4,6818,6747,71,36,36,0,1,100
4995bccdb0b9b1bd491f21c34f3dbfca82710df9,0,0,0,0,0,0,0,0,0,0,0,0,0,0,5,2,0,0,0,0,0,0,0,0,0,1,100
4b29ece20afed83bd5b715119a0446f02550d9be,3,70,2,68,0,0,0,4,94,63,2,2,0.825724339,2046,96,4,99,90,9,8542,8189,353,43,40,3,1,100
142bd428b44019a5199bec82de5d3d017a5489e7,2,10,4,6,0,0,0,7,211,76,1,2,0.985228136,10891,97,5,972,971,1,68817,68749,68,358,358,0,1,100
d48d9f04df34a4b770587dcba7092ad957b0f29c,2,112,7,105,0,0,0,2,16,148,1,2,0.47165375,1684,120,1,172,161,11,9571,8725,846,83,77,6,1,100
17382381965694d9562e5a5f96fdc1a2bf61874a,1,5,2,3,0,0,0,3,12,85,1,1,0,988,121,2,135,134,1,4937,4931,6,33,33,0,1,100
1fa0c1abc5cf8df2df3a8e188958451330f22c90,0,0,0,0,0,0,0,0,0,0,0,0,0,0,479,4,0,0,0,0,0,0,0,0,0,1,100
7806ae9b4fe16481a92f2133239e01a8ff09ab2a,9,36,15,21,0,0,0,5,31,251,2,2,2.540234917,3099,98,4,253,249,4,18549,18399,150,101,100,1,1,100
0efaae854ed9743f3d07b7ce6fc85279eac14dd5,4,83,21,62,0,0,0,7,212,86,2,4,1.533304301,11409,122,3,995,987,8,71255,70830,425,375,371,4,1,100
665a3ef99b9578b53263eb9b7a28587158f27dfa,0,0,0,0,0,0,0,0,0,0,0,0,0,0,123,4,0,0,0,0,0,0,0,0,0,0,100
47ecb3a0fd6e5fead401e542ab29a1a0169ca521,0,0,0,0,0,0,0,0,0,0,0,0,0,0,480,3,0,0,0,0,0,0,0,0,0,1,100
537b619e8a07e13a002328deda5119f9a16f7ffc,0,0,0,0,0,0,0,0,0,0,0,0,0,0,481,4,0,0,0,0,0,0,0,0,0,1,100
aeca828fcff994149705b40df16c964f0879ee0b,0,0,0,0,0,0,0,0,0,0,0,0,0,0,482,5,0,0,0,0,0,0,0,0,0,1,100
1421f59683b27b04f20e5060b79ef239a1078401,0,0,0,0,0,0,0,0,0,0,0,0,0,0,483,6,0,0,0,0,0,0,0,0,0,1,100
462d18501326bf988e255014d732e4d6bbf82ebf,2,0,21,21,0,0,0,5,41,94,2,2,0.958711883,959,357,0,90,92,2,4107,4194,87,58,59,1,1,100
4a88ee1f0e018c3732f6d33fe7e54ce461663948,1,1,1,0,0,0,0,7,83,35,1,1,0,1527,99,5,168,168,0,7694,7690,4,57,57,0,1,100
2073351ca25bb715d910915b333648165d7c9ab6,6,72,18,54,0,0,0,2,18,165,4,6,1.973833364,2118,484,5,269,261,8,12138,11875,263,82,81,1,1,100
aca83090ed2580d093a1fec59217d78f2e575a6c,3,179,10,169,0,0,0,3,213,108,2,3,0.986711052,11334,358,1,1049,1033,16,72612,71250,1362,375,372,3,1,99.93485342
714461f47e6408ec331acd0ddd640335e6a7a06c,2,207,38,169,0,0,0,2,37,92,1,2,0.993633397,1540,124,4,203,182,21,10216,9178,1038,99,88,11,1,100
cb598513eff75edb1915e58418aae61c7d04589b,1,2,2,0,0,0,0,4,8,227,1,1,0,176,100,4,17,17,0,721,721,0,15,15,0,1,100
fd522cedefbe7d51c7a6a44947d001659e50e293,0,0,0,0,0,0,0,0,0,0,0,0,0,0,485,1,0,0,0,0,0,0,0,0,0,1,100
0804088f0f48f174d366003a090ea11cd0b38500,0,0,0,0,0,0,0,0,0,0,0,0,0,0,486,2,0,0,0,0,0,0,0,0,0,1,100
8c0725775983b34acff3a071a90700de4d014638,1,4,4,0,0,0,0,8,74,104,1,1,0,1011,42,0,130,130,0,5926,5916,10,27,27,0,1,100
be5b1912644efda7b198ce1646b4378c58ddf992,0,0,0,0,0,0,0,0,0,0,0,0,0,0,21,0,0,0,0,0,0,0,0,0,0,1,100
fa2b8c437e7cf1b8801b511828663093a3654a78,14,572,51,521,1,0,1,6,38,189,1,13,2.843602991,7885,125,0,750,687,63,50943,47684,3259,302,283,19,1,99.91313789
9b1d507df7b2427c310908aff340818e3f684973,1,0,1,1,0,0,0,1,2,1,1,1,0,49,126,1,6,6,0,150,163,13,4,4,0,1,100
a00ff88b01ce86ac0370b421bde450bdfb465d96,0,0,0,0,0,0,0,0,0,0,0,0,0,0,487,2,0,0,0,0,0,0,0,0,0,1,100
c7ada820b46c191d4edcf900ecdc0b4cb3e1a944,0,0,0,0,0,0,0,0,0,0,0,0,0,0,488,3,0,0,0,0,0,0,0,0,0,1,100
5dd94ee0ca27eb62fc32aa746c28c28e1d384aaa,0,0,0,0,0,0,0,0,0,0,0,0,0,0,22,1,0,0,0,0,0,0,0,0,0,1,100
19fb440041cf6debe7f7a1e1d1f9f0f914a5671a,3,613,11,602,1,0,1,1,39,4,1,3,0.605317911,1738,127,2,216,210,6,12935,10438,2497,104,100,4,1,99.91325092
b9d5c2056c1026903a30c35a67e5b16aa1b5bb2b,0,0,0,0,0,0,0,0,0,0,0,0,0,0,43,1,0,0,0,0,0,0,0,0,0,1,100
c4dbeeab3fc20ccd75367013f2bbffc2fec7f3a3,0,0,0,0,0,0,0,0,0,0,0,0,0,0,489,3,0,0,0,0,0,0,0,0,0,1,100
57c0d2f36ea1eefafd6c2d649165a0532e28c3fc,0,0,0,0,0,0,0,0,0,0,0,0,0,0,490,4,0,0,0,0,0,0,0,0,0,1,100
424f2e88d4e39b2a091f5efe3512779e11aa53fa,0,0,0,0,0,0,0,0,0,0,0,0,0,0,491,5,0,0,0,0,0,0,0,0,0,1,100
b04676932f1d05634d7b6e5c20175129dfd08266,0,0,0,0,0,0,0,0,0,0,0,0,0,0,492,6,0,0,0,0,0,0,0,0,0,1,100
cf400882bdc2247f3cf923d571c0863c6a556dd1,4,65,1,64,0,0,0,5,95,129,2,4,1.390307962,4086,493,7,284,279,5,22481,22080,401,86,83,3,1,100
e10d80fe6008986900dadc51fc7823582d0dfb1a,13,1725,0,1725,12,0,12,1,3,80,2,3,3.42638237,30,128,3,165,0,165,8733,41,8692,76,0,76,1,91.7919351
73ce1d0e3dec284f15d3a61c4569813cf5ded3cd,3,120,46,74,0,0,0,3,13,107,1,2,1.134918602,1766,129,4,204,199,5,10598,9775,823,56,54,2,1,100
5de0cd3a42e43d9f2ca752b8e51f253c60920ccb,1,2,2,0,0,0,0,1,2,2,1,1,0,113,130,5,14,14,0,517,519,2,9,9,0,1,100
df87125e166675382e7da7a24c18730351c423a3,4,136,2,134,1,0,1,4,53,202,1,2,1.708505023,1148,427,0,114,105,9,7198,6459,739,51,49,2,1,99.94692144
a33a62591eff6d1453e00f5f983f67d35817a6b7,0,0,0,0,0,0,0,0,0,0,0,0,0,0,131,6,0,0,0,0,0,0,0,0,0,0,100
3347c94f863867aab241db34aafa502dc6a1ff1b,2,34,8,26,0,0,0,2,19,194,1,2,0.829607103,2019,132,7,253,251,2,11025,10921,104,81,81,0,1,100
4f66cb4baf926f9dcaf2ca4a47461f3ebf97679e,14,524,35,489,1,0,1,5,214,165,2,11,2.790805443,14663,101,0,1784,1734,50,92956,89865,3091,585,560,25,1,90.51923481
f37699f1aeb18e4047d6278162db03bae088632e,0,0,0,0,0,0,0,0,0,0,0,0,0,0,133,8,0,0,0,0,0,0,0,0,0,0,100
4d381d778f82d8d17ea9f718bbac3938ce4cc40d,15,207,49,158,0,0,0,5,92,354,3,12,3.228171379,9510,359,0,800,781,19,63566,62400,1166,402,392,10,1,100
73da831e8e5acab5e2e044c74a29384bcda4cbc6,2,95,31,64,0,0,0,4,14,206,1,2,0.977895682,1185,134,7,109,104,5,8006,7235,771,28,26,2,1,100
6a99798f250310f8bd819aae89123e6146364983,23,203,50,153,0,0,0,3,215,135,4,15,4.112701608,22873,360,1,2095,2073,22,151552,150383,1169,890,882,8,1,100
1864e4b2315e43542d89cddda1a2ac6adff96f2d,0,0,0,0,0,0,0,0,0,0,0,0,0,0,65,0,0,0,0,0,0,0,0,0,0,1,100
cc1d89cba984a9c43e6a966b2c822355b6c85c07,2,82,3,79,0,0,0,4,124,23,2,2,0.555822738,7351,135,8,461,456,5,49257,48669,588,227,225,2,1,100
7b45e9a142830e7dd8b0263d50dbaaef5fb0da76,27,904,358,546,8,0,8,3,216,218,5,11,4.137658927,20172,361,2,1789,1739,50,131124,129412,1712,779,740,39,1,99.18360257
6970fb01bc7bd8a838dc55c5e38cbad41b1c3140,10,161,115,46,0,0,0,2,217,117,3,5,2.875299667,13996,362,3,1346,1342,4,86876,86535,341,552,550,2,1,100
5ef86035bb812330a542b5be5e1695939cdcb66b,2,6,2,4,0,0,0,2,58,630,1,2,0.811278124,622,494,5,70,70,0,3251,3227,24,27,27,0,1,100
1854cbf916d85890c0d222381a6cb76684fba689,0,0,0,0,0,0,0,0,0,0,0,0,0,0,495,6,0,0,0,0,0,0,0,0,0,2,100
edddea808fd5d62d964b5f2770404a3ba34b70b1,0,0,0,0,0,0,0,0,0,0,0,0,0,0,136,9,0,0,0,0,0,0,0,0,0,0,100
28cd991b86c0e216e80f9246d8c0bddaa5b0f97c,6,375,14,361,2,0,2,4,41,123,2,6,1.464117428,2485,496,7,407,360,47,13997,12496,1501,134,111,23,1,99.89599584
eadbfec4456b5edc318a5c94f90a2a78e172ebf4,4,32,22,10,0,0,0,2,5,0,1,1,1.837797162,1716,363,4,243,243,0,8845,8740,105,153,153,0,1,100
ecd90dc1f79a4b1614174b75030b85feb8842793,15,1194,101,1093,4,0,4,1,4,29,3,7,3.090368051,2743,137,9,448,320,128,22244,15441,6803,209,158,51,1,88.04958678
c0aec00daf59331a3931b4a8b1ff7888c19c0da1,1,7,1,6,0,0,0,2,3,214,1,1,0,209,497,3,16,16,0,1111,1111,0,10,10,0,1,100
ebb96d5e5679f1cc4fce470dfec7025f8e138e0a,0,0,0,0,0,0,0,0,0,0,0,0,0,0,66,1,0,0,0,0,0,0,0,0,0,1,100
c1c6d3eb61739e5d7d87cfda0fea999de174865d,0,0,0,0,0,0,0,0,0,0,0,0,0,0,67,2,0,0,0,0,0,0,0,0,0,1,100
0bb3445c85a24ae4d371c82c379137107df298cc,0,0,0,0,0,0,0,0,0,0,0,0,0,0,68,3,0,0,0,0,0,0,0,0,0,1,100
b8e8bcbd04dad4ca04a0385b79d05d0b36412886,0,0,0,0,0,0,0,0,0,0,0,0,0,0,69,4,0,0,0,0,0,0,0,0,0,1,100
6b67b0bc1eb010f6dc8af2936ae738909e1244ff,15,161,74,87,0,0,0,5,94,108,3,13,3.352230392,10069,364,5,762,755,7,68972,68418,554,421,414,7,1,100
6cb82062d6728120844b6856af139fd49c3a2ddb,4,23,6,17,0,0,0,3,20,481,1,2,1.863231501,2185,138,4,287,282,5,11083,11014,69,95,91,4,1,100
24ca1de0e12da3f9d165f1eda44c7076de0f2f12,0,0,0,0,0,0,0,0,0,0,0,0,0,0,498,4,0,0,0,0,0,0,0,0,0,1,100
5f15a04769f54b60cf9a4368287091c431fc3267,3,64,17,47,0,0,0,4,42,233,1,3,0.701486195,1363,428,0,150,144,6,7640,7374,266,61,58,3,1,93.77725595
9bb01e4f844503f5c125fbf5b633f4149d87835d,0,0,0,0,0,0,0,0,0,0,0,0,0,0,429,1,0,0,0,0,0,0,0,0,0,0,100
663ead2dc5f3778bbdeb0f479811e2d89f506afc,6,288,10,278,0,0,0,4,158,276,1,3,1.119942279,7425,102,0,960,935,25,45567,43700,1867,306,301,5,1,100
2e621ed5067780bb5093851afddfbd571d813fa3,2,108,8,100,0,0,0,3,32,96,1,2,0.751897228,1704,139,2,194,190,4,10044,9584,460,61,59,2,1,100
f9942ccf677b5f6a6e25a83abc10550ab19ee897,0,0,0,0,0,0,0,0,0,0,0,0,0,0,140,3,0,0,0,0,0,0,0,0,0,0,100
c17d4a0a441477caed06d61d2ebe868946ff71a6,1,139,1,138,0,0,0,2,5,324,1,1,0,370,430,2,24,23,1,3533,2474,1059,12,11,1,1,100
5c6d22b04d6301fa971cf0c821ad95b319cd1e46,0,0,0,0,0,0,0,0,0,0,0,0,0,0,141,4,0,0,0,0,0,0,0,0,0,0,100
9d118e54e527245817222e917964801a17a6f2c1,0,0,0,0,0,0,0,0,0,0,0,0,0,0,142,5,0,0,0,0,0,0,0,0,0,0,100
b1ae946c1bae76cb479362931a864f21e1fa73f6,4,69,4,65,0,0,0,2,159,67,3,3,1.526192819,4686,431,3,492,482,10,23268,22826,442,177,177,0,1,93.22421013
0d87102e4bdb9f50425d295d396825a5fbd37dd0,14,986,396,590,5,0,5,4,160,78,1,4,2.235971827,5424,432,4,700,639,61,33508,30797,2711,320,285,35,1,99.75649351
3dc26cf153afda9c8006e8bab42df16a9ce32ea8,26,3672,11,3661,19,0,19,1,97,13,4,12,3.795644314,3383,433,5,630,282,348,35289,14802,20487,269,95,174,1,97.12937475
bf09bd9502469797a926b495cfd47f2c10d49b47,4,123,46,77,1,0,1,4,161,92,1,3,1.164776384,2921,434,6,415,409,6,16937,16600,337,168,162,6,1,99.96178831
028038dcfba6bf5242cc84ab8c69482853b3c4c9,17,455,178,277,0,0,0,1,218,154,3,8,3.174873021,15157,435,7,1603,1561,42,85636,83847,1789,628,615,13,1,100
3d62a3691fa26cef0867ce7a2c567716faf70a3e,38,628,356,272,1,0,1,1,219,497,3,14,4.113837253,27545,436,8,2525,2499,26,172160,170037,2123,1195,1179,16,1,99.82814589
9d67c598a94639af6806c6ce9509ba43fe40c43d,12,203,101,102,1,0,1,2,164,0,3,7,3.014581496,6766,437,9,848,839,9,40245,39778,467,342,336,6,1,99.96183206
486f47f3c6cbcecd5a2b2704c20b708cee39c280,1,7,3,4,0,0,0,1,5,0,1,1,0,301,438,10,20,19,1,1852,1827,25,13,12,1,1,100
a9429a1d3bc52bd886e1d781a71ac084d0fd115c,4,11,4,7,0,0,0,1,220,0,2,4,1.640223929,8289,439,11,1178,1178,0,47056,47018,38,361,361,0,1,100
a0c0ba19892285981b1842f99c4b4d2fa432cd39,0,0,0,0,0,0,0,0,0,0,0,0,0,0,440,12,0,0,0,0,0,0,0,0,0,2,100
f0bd91b000c3d4617c35bdd301698cbdcf450f93,4,7,5,2,0,0,0,1,63,0,2,2,1.887918503,1130,441,13,137,137,0,6056,6039,17,63,63,0,1,100
737e24765d35ffedf830b5da9160a5a24f068602,28,546,80,466,3,0,3,1,97,145,3,12,3.950113637,11874,442,14,1152,1094,58,73889,70954,2935,462,449,13,1,89.96396396
d376dd3e31c4504e420ddf650b30adbb6862c9b4,18,52,47,5,0,0,0,1,65,0,2,10,4.113902989,4973,443,15,533,533,0,28206,28297,91,255,255,0,1,100
35aaa5a1441eaef9bfc32a51b89f989d8e285d99,2,5,7,2,0,0,0,1,47,0,2,2,0.918295834,2001,444,16,70,70,0,15257,15267,10,39,39,0,1,100
bedadc7b4074c8241faf5377515ad284417f15f9,4,61,5,56,1,0,1,1,14,68,1,2,1.294880059,1317,445,17,149,149,0,7389,7141,248,48,48,0,1,99.94882293
952980a1a2c7ee83d85de336d7d64d5f7114f864,3,23,7,16,0,0,0,1,66,0,1,1,1.399581231,987,446,18,127,125,2,5202,5153,49,56,54,2,1,100
f0c8845cb687d6b0af22b5800ca1e8947a34fac9,7,187,36,151,1,0,1,9,114,63,1,3,1.847518043,3474,447,19,437,423,14,19531,18842,689,170,157,13,1,99.93181043
f5c1f47dfec8d4e432c6970fd3267dd13ade8b03,8,144,1,143,0,0,0,7,115,46,1,3,2.295495702,6033,448,20,641,631,10,31174,30632,542,271,261,10,1,100
b1b0a1324ad2bb93b1d937df4aefb455596fbc54,13,102,51,51,0,0,0,1,166,28,2,6,2.880310391,5974,449,21,746,744,2,33651,33432,219,331,331,0,1,99.98295261
96e48c50fb2b7f12a37a09430e557409ee9ba308,2,41,20,21,0,0,0,4,69,0,1,2,0.853657673,810,450,22,81,78,3,5300,5289,11,40,37,3,1,99.60891005
8ba7e44c2db4fc6a8fa9c58e314d055fc8a63b2e,5,18,14,4,0,0,0,3,21,122,1,4,1.974601753,2975,451,23,340,340,0,16801,16730,71,102,102,0,1,100
6dabd8e992c1ace91b3612d39426f3fbd2d8fe2f,3,151,8,143,0,0,0,1,46,176,1,2,1.165902083,1455,452,24,212,188,24,9057,8340,717,74,66,8,1,100
df91ad5832ae0345a80d2ec16bfc9d114805117e,1,1,0,1,0,0,0,1,10,0,1,1,0,449,453,25,68,68,0,2275,2272,3,15,15,0,1,100
4bb342115a5af2c28d5ad99245e861e7f62c4298,5,30,34,4,0,0,0,3,70,0,2,3,2.135158602,1663,454,26,160,162,2,10610,10636,26,80,80,0,1,99.88129557
09f3d9366f20075032e1a0be6f62fde2b6caa1ae,0,0,0,0,0,0,0,0,0,0,0,0,0,0,455,27,0,0,0,0,0,0,0,0,0,1,100
7cf416ae8cb19757e42530d42a7ccc3532d2f927,6,654,10,644,4,0,4,1,15,0,1,1,1.501889628,945,456,28,195,109,86,8096,5268,2828,56,31,25,1,99.59507339
3d795d62c0d471ff866adb9002e8c6fe6ea9536a,5,24,16,8,0,0,0,1,47,0,2,3,2.087459468,1802,457,29,227,226,1,9693,9664,29,79,79,0,1,100
9e6bd7c8025c63cd919b94cf7a99137f2fc253b6,1,7,1,6,0,0,0,1,3,0,1,1,0,436,458,30,64,64,0,2084,2078,6,14,14,0,1,100
971e0957a1302e20fe241b4aeac278dc87111257,1,4,1,3,0,0,0,6,48,0,1,1,0,979,459,31,123,122,1,5965,5957,8,38,38,0,1,100
495ec386f38c86fa073f86908740dcd384d74885,13,185,78,107,1,0,1,1,71,46,4,7,3.37394375,5036,460,32,505,476,29,29827,29152,675,238,237,1,1,99.83145121
5846b8de7c224f771ce335622615aadaeb2376d5,1,52,31,21,0,0,0,1,5,0,1,1,0,456,461,33,69,65,4,2234,2165,69,17,14,3,1,100
fe9b690ffb75dc0f987549b73d45b9eb6e9f16c7,5,20,9,11,0,0,0,6,72,0,2,2,2.19724791,2033,462,34,261,259,2,11459,11406,53,106,104,2,1,100
c716a9f3a4697b30df36bc010af3234dc8c5c2b5,0,0,0,0,0,0,0,0,0,0,0,0,0,0,463,35,0,0,0,0,0,0,0,0,0,1,100
9e9475752f17c0311de2f2bdc0c50d4a144d3a73,2,27,5,22,0,0,0,5,50,0,1,2,0.757878463,1790,464,36,58,58,0,14526,14311,215,44,44,0,1,100
3a143a67187b29f792c43b9acc40feec0dc16697,20,461,235,226,2,0,2,1,116,791,1,7,2.965378112,10289,465,37,1018,988,30,65531,64230,1301,462,442,20,1,86.58971668
eec648d3af68ef1b4967e5c7cfc464a476f308c6,42,836,370,466,8,1,9,1,167,0,4,11,4.381023513,14525,466,38,1601,1564,37,85246,83962,1284,718,681,37,1,90.04889272
cebbb0192602baca4da2352b82f18317595d9247,25,1020,766,254,5,3,8,1,168,16,4,6,4.0362751,12935,467,39,1435,1398,37,78502,78455,47,610,584,26,1,82
25a6a131b95fdeb1b8cdd04f91820ca114531806,15,115,66,49,0,0,0,1,169,0,3,6,3.541925819,6182,468,40,745,738,7,34564,34409,155,337,330,7,1,99.44073326
ec5acd8a6243db277b4145228f34917811984cc6,32,965,307,658,5,0,5,2,221,36,6,16,4.335398919,21642,469,41,2739,2644,95,121607,118667,2940,993,940,53,1,99.45837202
4a18c5d5baaaab4565da9d3c3085d98dfc91d07e,28,293,118,175,0,0,0,1,171,0,3,9,4.45772495,15313,470,42,1653,1633,20,93374,92145,1229,717,715,2,1,97.15673668
9ee4d5dbc96cdf4982fc3633766cb1acf5e581dd,7,1193,404,789,3,0,3,1,17,60,1,2,1.896205423,2156,471,43,282,242,40,16102,11706,4396,117,87,30,1,99.3682548
52f0e5d2a0ec36c781f4f0cca63d2150426add9d,10,505,82,423,0,0,0,9,172,121,2,5,2.782461262,7502,472,44,963,926,37,46557,43727,2830,381,367,14,1,95.15555556
60eb5f594c0a2e2ef7eea25fa7d637b58b779b07,20,49,75,26,0,0,0,1,118,0,4,10,3.708346017,8083,473,45,864,864,0,42544,42537,7,405,405,0,2,100
7ef9dda732f124a234cbe8a665deb08c065f628f,15,1906,326,1580,3,0,3,3,222,48,2,8,3.197353023,11345,474,46,1593,1483,110,76193,66362,9831,644,537,107,1,99.67162115
5ce54b82db20f0eda26841cd8755523029857c93,6,11,9,2,0,0,0,3,79,0,3,4,2.365957321,2933,475,47,272,272,0,19419,19383,36,140,140,0,1,100
fda065536bfb9c7435fe88300ca617ed642a55cf,21,751,110,641,0,0,0,1,82,0,3,7,3.458715641,5766,476,48,714,722,8,26808,26844,36,302,300,2,1,100
80cd3fe9832006c8e11d1509b722fb85b4469798,0,0,0,0,0,0,0,0,0,0,0,0,0,0,103,1,0,0,0,0,0,0,0,0,0,2,100
2ecffa7150da2350bd6d2c8cd9fa3f97bccaf373,44,657,225,432,1,0,1,1,119,3,6,19,4.196500123,26689,477,49,2666,2622,44,162097,159678,2419,1114,1104,10,1,99.91364421
c03a6ff5fc9193909d1087817bdda47a9df7ae47,14,114,123,9,0,0,0,1,174,183,1,6,3.063058049,8029,478,50,798,799,1,46888,47060,172,393,395,2,1,100
4ccdf9362029b2fa21bf91719fd93d40e2b3465f,2,231,52,179,0,0,0,1,8,0,1,2,0.185632987,487,479,51,48,38,10,4606,3356,1250,26,18,8,1,100
74ccd2df417045d5adcf0aae7eff31064560d35e,0,0,0,0,0,0,0,0,0,0,0,0,0,0,480,52,0,0,0,0,0,0,0,0,0,1,100
2ef4626d3b3dfeeb47120f8db8f2809e04e440a0,1,1,1,0,0,0,0,8,102,0,1,1,0,1658,481,53,146,146,0,7840,7842,2,86,86,0,1,100
fbf1fcc2fcc439a640fc2c5ae9f37f807808a3e9,10,44,339,295,0,2,2,1,84,0,3,6,2.292323113,4073,482,54,436,470,34,21723,23119,1396,238,251,13,1,99.93091537
a68917741446bd6fe56b57d0860b71fdc110eb8f,3,9,9,0,0,0,0,1,18,0,2,2,1.224394445,927,483,55,114,114,0,4424,4424,0,69,69,0,1,100
9086d455955b711717a79d59e21119271e491a23,1,11,51,40,0,0,0,1,19,0,1,1,0,517,484,56,64,71,7,2596,2748,152,30,34,4,1,100
e51bcbc3049247f598991533c38e181a7e2d84a4,2,14,14,0,0,0,0,4,85,0,1,2,0.591672779,2739,485,57,214,213,1,19944,19960,16,54,54,0,1,100
2e62e98ec071a8fa3d41cad2c1aca04e3a26f22d,0,0,0,0,0,0,0,0,0,0,0,0,0,0,486,58,0,0,0,0,0,0,0,0,0,1,100
24e17a4e5af7d81a08ca2019052896cf3b97f6a6,8,955,302,653,3,0,3,2,7,26,2,3,2.200335205,1642,365,1,302,218,84,12879,8660,4219,173,143,30,1,87.15808171
a0c0727dda85841417326c319a1bc29fd22c88ab,2,50,0,50,0,0,0,5,45,35,2,2,0.826746372,957,366,2,94,92,2,4145,4045,100,64,63,1,1,100
dc0ee0115cef3d0ad6ea64c3f93042a081d66472,1,11,10,1,0,0,0,3,3,474,1,1,0,109,23,0,14,14,0,431,398,33,12,12,0,1,100
8b278ea84f4c64e7144c07fa79b38a6a719541d2,48,531,1331,800,0,2,2,1,223,9,3,14,3.827027022,43633,487,59,3583,3668,85,274567,279048,4481,1756,1784,28,2,95.38888889
eb70cb7b70c96353fe2d1f4edb0867ecd00a1b2f,2,0,4,4,0,0,0,1,3,6,2,2,1,498,488,60,52,52,0,2229,2250,21,23,23,0,1,100
601fa0156a038d433c9ae03e87e463d5715c6fa4,0,0,0,0,0,0,0,0,0,0,0,0,0,0,489,61,0,0,0,0,0,0,0,0,0,1,100
9a3d8898bf8fbfe90776e6c2d1591d05cca7c47b,0,0,0,0,0,0,0,0,0,0,0,0,0,0,143,5,0,0,0,0,0,0,0,0,0,1,100
de751ec3da9d29fafefa78039450cfffc4fd4d80,1,18,89,71,0,0,0,1,4,14,1,1,0,768,490,62,79,83,4,4365,4728,363,31,31,0,1,99.98122418
6098f1bb9cb8b03a0340ec6edc244a1f1e022440,1,7,3,4,0,0,0,3,5,3,1,1,0,353,491,63,54,52,2,1744,1737,7,32,31,1,1,100
e52effbc0a83c5fa41eace8e770a4a59f70f2516,0,0,0,0,0,0,0,0,0,0,0,0,0,0,492,64,0,0,0,0,0,0,0,0,0,0,100
